date,sid,name,open,high,low,close,amplitude,amplitude_ratio,capacity,transaction,turnover,foreign_dealers_buy,foreign_dealers_sell,foreign_dealers_total,investment_trust_buy,investment_trust_sell,investment_trust_total,dealer_buy,dealer_sell,dealer_total,institutional_investors_total
20200528,0050,元大台灣50,84.90,84.90,83.55,83.85,-0.50,-0.59,7476909,3104,630228694,722000,1302000,-580000,0,0,0,2677000,2674000,3000,-577000
20200528,0051,元大中型100,34.80,35.16,34.63,34.63,-0.19,-0.55,29020,19,1014266,0,0,0,0,0,0,18000,7000,11000,11000
20200528,0052,富邦科技,64.55,64.55,63.55,63.55,-0.65,-1.01,118633,23,7606383,0,0,0,0,0,0,102000,108000,-6000,-6000
20200528,0053,元大電子,39.05,39.14,38.70,38.70,+0.01,0.03,8000,8,311310,1000,0,1000,0,0,0,2000,4000,-2000,-1000
20200528,0054,元大台商50,23.47,23.47,23.47,23.47,+0.28,1.21,2000,1,46940,0,0,0,0,0,0,2000,2000,0,0
20200528,0055,元大MSCI金融,17.23,17.28,17.09,17.09,-0.14,-0.81,25000,17,429620,0,0,0,0,0,0,7000,11000,-4000,-4000
20200528,0056,元大高股息,27.99,28.06,27.79,27.90,+0.05,0.18,17214042,8185,481202663,20000,32000,-12000,0,0,0,4929000,2168000,2761000,2749000
20200528,0057,富邦摩台,56.00,56.00,55.60,55.60,-0.30,-0.54,60150,5,3354400,0,0,0,0,0,0,60000,60000,0,0
20200528,0061,元大寶滬深,17.16,17.20,16.97,17.04,-0.16,-0.93,551551,196,9403722,1000,81000,-80000,0,0,0,235000,169000,66000,-14000
20200528,006203,元大MSCI台灣,39.97,39.97,39.45,39.45,-0.31,-0.78,10000,9,396670,0,1000,-1000,0,0,0,1000,9000,-8000,-9000
20200528,006204,永豐臺灣加權,55.00,55.00,54.60,54.65,-0.30,-0.55,24000,5,1312200,0,0,0,0,0,0,24000,21000,3000,3000
20200528,006205,富邦上証,28.40,28.69,28.22,28.39,-0.01,-0.04,1469015,215,41591011,39000,15000,24000,0,0,0,1089000,1204000,-115000,-91000
20200528,006206,元大上證50,29.72,29.98,29.51,29.69,-0.03,-0.1,1197565,120,35587377,773000,76000,697000,0,0,0,299000,995000,-696000,1000
20200528,006207,FH滬深,22.24,22.38,22.02,22.17,-0.11,-0.49,1095000,111,24209230,271000,0,271000,0,0,0,779000,1033000,-254000,17000
20200528,006208,富邦台50,48.40,48.53,47.89,48.00,-0.28,-0.58,947979,329,45611059,6000,7000,-1000,0,0,0,625000,718000,-93000,-94000
20200528,00625K,富邦上証+R,6.81,6.81,6.81,6.81,+0.01,0.15,50000,2,340500,0,0,0,0,0,0,50000,50000,0,0
20200528,00631L,元大台灣50正2,45.43,45.56,43.94,44.31,-0.56,-1.25,7874000,2700,353227610,743000,529000,214000,0,0,0,1658000,2744000,-1086000,-872000
20200528,00632R,元大台灣50反1,10.10,10.27,10.08,10.22,+0.07,0.69,73170538,7282,744365017,1939000,0,1939000,0,0,0,25429000,15939000,9490000,11429000
20200528,00633L,富邦上証正2,41.04,42.01,40.62,41.13,+0.16,0.39,17297500,2863,714848400,4103000,594000,3509000,0,0,0,7528378,4551000,2977378,6486378
20200528,00634R,富邦上証反1,5.80,5.85,5.74,5.80,-0.01,-0.17,1686022,331,9769488,233000,74000,159000,0,0,0,801000,104000,697000,856000
20200528,00635U,元大S&P黃金,24.18,24.33,24.18,24.33,+0.20,0.83,1284239,394,31163413,0,0,0,0,0,0,490000,255000,235000,235000
20200528,00636,國泰中國A50,19.87,20.07,19.75,19.87,0.00,0.00,925479,267,18374257,98000,146000,-48000,0,0,0,324000,406000,-82000,-130000
20200528,00636K,國泰中國A50+U,6.58,6.58,6.58,6.58,-0.02,-0.3,100,1,658,0,0,0,0,0,0,100,100,0,0
20200528,00637L,元大滬深300正2,15.82,16.22,15.67,15.88,+0.07,0.44,113451250,9807,1804601435,13249000,8203000,5046000,0,0,0,51366000,26535000,24831000,29877000
20200528,00638R,元大滬深300反1,11.65,11.75,11.54,11.67,-0.02,-0.17,2907000,428,33925400,294000,5000,289000,0,0,0,1773000,1187000,586000,875000
20200528,00639,富邦深100,11.06,11.07,10.85,10.93,-0.13,-1.18,1990764,325,21771377,141000,18000,123000,0,0,0,1025464,1419000,-393536,-270536
20200528,00640L,富邦日本正2,18.55,18.78,18.25,18.61,+0.52,2.87,2367000,277,43801930,255000,210000,45000,0,0,0,1315000,866000,449000,494000
20200528,00641R,富邦日本反1,14.05,14.16,13.96,14.01,-0.19,-1.34,1114000,254,15624700,8000,47000,-39000,0,0,0,525000,380000,145000,106000
20200528,00642U,元大S&P石油,9.22,9.22,9.15,9.16,-0.16,-1.72,27940667,8780,256376662,59000,4000,55000,0,0,0,402000,2528000,-2126000,-2071000
20200528,00643,群益深証中小,13.21,13.24,12.92,13.07,-0.15,-1.13,818015,266,10685065,53000,226000,-173000,0,0,0,70000,379000,-309000,-482000
20200528,00643K,群益深証中小+R,,,,,0.00,0.00,0,0,0,0,0,0,0,0,0,0,0,0,0
20200528,00645,富邦日本,20.23,20.36,20.18,20.27,+0.27,1.35,107500,27,2175033,0,0,0,0,0,0,72000,77000,-5000,-5000
20200528,00646,元大S&P500,27.88,27.94,27.74,27.86,+0.27,0.98,1105702,503,30797675,8000,1000,7000,0,0,0,743000,65000,678000,685000
20200528,00647L,元大S&P500正2,34.51,34.66,34.14,34.48,+0.67,1.98,1110000,266,38287070,24000,18000,6000,0,0,0,789000,383000,406000,412000
20200528,00648R,元大S&P500反1,10.80,10.86,10.76,10.80,-0.12,-1.1,4799100,1158,51817861,11000,17000,-6000,0,0,0,2408000,1729000,679000,673000
20200528,00650L,FH香港正2,19.80,20.32,19.25,19.67,-0.29,-1.45,3338000,968,65807600,13000,16000,-3000,0,0,0,1155000,2345000,-1190000,-1193000
20200528,00651R,FH香港反1,9.45,9.50,9.18,9.39,+0.07,0.75,13054000,1793,122436930,19000,409000,-390000,0,0,0,2319000,6694000,-4375000,-4765000
20200528,00652,富邦印度,17.04,17.35,17.04,17.35,+0.51,3.03,1298205,456,22392690,23000,134000,-111000,0,0,0,360000,97000,263000,152000
20200528,00653L,富邦印度正2,15.42,15.85,15.42,15.85,+0.97,6.52,35855000,5621,562056480,3954000,11000,3943000,0,0,0,19125000,1044000,18081000,22024000
20200528,00654R,富邦印度反1,15.93,15.95,15.75,15.77,-0.50,-3.07,337000,129,5336340,0,208000,-208000,0,0,0,0,43000,-43000,-251000
20200528,00655L,國泰中國A50正2,29.87,30.59,29.52,29.91,+0.13,0.44,10927000,1391,325816370,1299000,197000,1102000,0,0,0,7230000,3178000,4052000,5154000
20200528,00656R,國泰中國A50反1,10.59,10.63,10.46,10.58,+0.01,0.09,295000,28,3124310,0,0,0,0,0,0,115000,230000,-115000,-115000
20200528,00657,國泰日經225,27.09,27.21,26.92,27.14,+0.47,1.76,116000,12,3136190,10000,0,10000,0,0,0,104000,112000,-8000,2000
20200528,00657K,國泰日經225+U,8.97,8.97,8.97,8.97,+0.12,1.36,100,1,897,0,0,0,0,0,0,100,100,0,0
20200528,00660,元大歐洲50,21.91,22.01,21.82,21.96,+0.48,2.23,112010,39,2458339,0,0,0,0,0,0,58000,65000,-7000,-7000
20200528,00661,元大日經225,27.58,27.58,27.54,27.54,+0.44,1.62,4000,4,110240,0,0,0,0,0,0,0,4000,-4000,-4000
20200528,00662,富邦NASDAQ,36.63,36.67,36.28,36.48,-0.15,-0.41,444215,150,16233588,1000,48000,-47000,0,0,0,319000,288000,31000,-16000
20200528,00663L,國泰臺灣加權正2,40.88,41.01,39.53,39.88,-0.50,-1.24,372000,75,14950130,2000,20000,-18000,0,0,0,162000,184000,-22000,-40000
20200528,00664R,國泰臺灣加權反1,11.45,11.65,11.44,11.61,+0.07,0.61,2929000,394,33792590,0,0,0,0,0,0,1574000,686000,888000,888000
20200528,00665L,富邦恒生國企正2,19.51,20.11,19.15,19.54,-0.12,-0.61,513000,169,10099040,0,73000,-73000,0,0,0,190000,234000,-44000,-117000
20200528,00666R,富邦恒生國企反1,14.24,14.33,14.00,14.22,+0.08,0.57,432000,41,6145350,0,0,0,0,0,0,357000,147000,210000,210000
20200528,00668,國泰美國道瓊,27.95,28.09,27.87,27.99,+0.55,2.0,389080,182,10893190,0,2000,-2000,0,0,0,142000,98000,44000,42000
20200528,00668K,國泰美國道瓊+U,9.30,9.30,9.30,9.30,+0.17,1.86,100,1,930,0,0,0,0,0,0,100,100,0,0
20200528,00669R,國泰美國道瓊反1,11.64,11.71,11.60,11.64,-0.24,-2.02,15428000,1951,179672230,5000,88000,-83000,0,0,0,3006000,7739000,-4733000,-4816000
20200528,00670L,富邦NASDAQ正2,46.35,46.45,45.28,45.83,-0.62,-1.33,1920000,680,88173970,34000,25000,9000,0,0,0,849000,1052000,-203000,-194000
20200528,00671R,富邦NASDAQ反1,9.23,9.34,9.22,9.29,+0.06,0.65,3257000,284,30208490,52000,0,52000,0,0,0,752000,2342000,-1590000,-1538000
20200528,00672L,元大S&P原油正2,2.33,2.33,2.28,2.28,-0.12,-5.0,23782350,1906,54690356,0,0,0,0,0,0,150000,320000,-170000,-170000
20200528,00673R,元大S&P原油反1,37.88,38.44,37.67,38.12,+1.84,5.07,1209011,341,45929036,12000,0,12000,0,0,0,753000,108000,645000,657000
20200528,00674R,元大S&P黃金反1,14.28,14.28,14.19,14.21,-0.11,-0.77,711000,125,10120390,0,0,0,0,0,0,62000,396000,-334000,-334000
20200528,00675L,富邦臺灣加權正2,17.81,17.87,17.26,17.40,-0.20,-1.14,649000,215,11368950,45000,116000,-71000,0,0,0,121000,283000,-162000,-233000
20200528,00676R,富邦臺灣加權反1,6.21,6.31,6.19,6.28,+0.04,0.64,3714000,347,23224910,0,0,0,0,0,0,1861000,1249000,612000,612000
20200528,00677U,富邦VIX,5.95,6.10,5.94,6.04,+0.01,0.17,264200500,15540,1590677554,5008000,44331000,-39323000,0,0,0,5104000,78630000,-73526000,-112849000
20200528,00678,群益NBI生技,25.77,25.77,25.56,25.70,-0.07,-0.27,493216,79,12637610,103000,0,103000,0,0,0,343000,321196,21804,124804
20200528,00680L,元大美債20正2,31.55,31.69,31.50,31.52,-0.29,-0.91,85000,44,2683930,19000,0,19000,0,0,0,0,70000,-70000,-51000
20200528,00681R,元大美債20反1,12.84,12.87,12.84,12.85,+0.03,0.23,84000,9,1079320,67000,0,67000,0,0,0,10000,72000,-62000,5000
20200528,00682U,元大美元指數,19.66,19.66,19.65,19.65,+0.04,0.2,2156,3,42353,0,0,0,0,0,0,0,2000,-2000,-2000
20200528,00683L,元大美元指數正2,20.02,20.04,19.97,20.04,-0.06,-0.3,7000,4,140150,0,0,0,0,0,0,0,7000,-7000,-7000
20200528,00684R,元大美元指數反1,17.91,17.95,17.91,17.95,+0.07,0.39,3000,3,53780,0,0,0,0,0,0,2000,1000,1000,1000
20200528,00685L,群益臺灣加權正2,15.25,15.25,14.77,14.87,-0.17,-1.13,318000,101,4790460,0,0,0,0,0,0,235000,150000,85000,85000
20200528,00686R,群益臺灣加權反1,6.75,6.86,6.75,6.84,+0.05,0.74,140000,36,954410,0,0,0,0,0,0,100000,33000,67000,67000
20200528,00688L,國泰20年美債正2,32.11,32.22,32.11,32.22,-0.08,-0.25,103000,4,3318330,1000,0,1000,0,0,0,100000,102000,-2000,-1000
20200528,00689R,國泰20年美債反1,13.19,13.19,13.17,13.17,+0.07,0.53,102000,3,1343380,0,0,0,0,0,0,100000,102000,-2000,-2000
20200528,00690,兆豐藍籌30,22.07,22.08,21.74,21.74,-0.20,-0.91,218041,55,4755460,0,0,0,0,0,0,160000,205000,-45000,-45000
20200528,00691R,兆豐藍籌30反1,,,,,0.00,0.00,0,0,0,0,0,0,0,0,0,0,0,0,0
20200528,00692,富邦公司治理,22.12,22.15,21.81,21.92,-0.11,-0.5,2079112,678,45645624,21000,6000,15000,0,0,0,1160000,1248000,-88000,-73000
20200528,00693U,街口S&P黃豆,13.75,13.77,13.69,13.71,+0.02,0.15,1425000,359,19566940,31000,0,31000,0,0,0,51000,17000,34000,65000
20200528,00700,富邦恒生國企,18.04,18.04,17.91,17.91,-0.09,-0.5,108000,8,1934940,0,0,0,0,0,0,104000,100000,4000,4000
20200528,00701,國泰股利精選30,20.29,20.31,20.05,20.11,-0.14,-0.69,1720423,679,34740762,0,0,0,0,0,0,390000,775000,-385000,-385000
20200528,00702,國泰標普低波高息,16.68,16.79,16.66,16.67,+0.32,1.96,39000,15,650240,3000,0,3000,0,0,0,28000,0,28000,31000
20200528,00703,台新MSCI中國,20.15,20.17,19.83,19.99,-0.11,-0.55,291000,67,5823410,0,1000,-1000,0,0,0,152000,161000,-9000,-10000
20200528,00706L,元大S&P日圓正2,17.18,17.21,17.18,17.19,-0.10,-0.58,6000,3,103130,0,0,0,0,0,0,1000,6000,-5000,-5000
20200528,00707R,元大S&P日圓反1,19.62,19.62,19.61,19.61,+0.05,0.26,10000,3,196160,0,0,0,0,0,0,1000,6000,-5000,-5000
20200528,00708L,元大S&P黃金正2,27.17,27.54,27.16,27.51,+0.44,1.63,8758000,1225,239847820,165000,0,165000,0,0,0,2349000,2569000,-220000,-55000
20200528,00709,富邦歐洲,18.20,18.33,18.18,18.28,+0.18,0.99,119000,19,2176770,0,0,0,0,0,0,105000,108000,-3000,-3000
20200528,00710B,FH彭博高收益債,18.62,18.68,18.62,18.68,+0.08,0.43,118000,39,2202010,0,0,0,0,0,0,0,63000,-63000,-63000
20200528,00711B,FH彭博新興債,21.75,21.76,21.73,21.76,+0.03,0.14,166122,19,3614104,0,0,0,0,0,0,100000,100000,0,0
20200528,00712,FH富時不動產,10.35,10.49,10.31,10.49,+0.35,3.45,4480992,1125,46704132,412000,75279,336721,0,0,0,117000,568000,-451000,-114279
20200528,00713,元大台灣高息低波,31.04,31.15,30.80,30.81,-0.12,-0.39,70431,45,2179613,1000,10000,-9000,0,0,0,26000,9000,17000,8000
20200528,00714,群益道瓊美國地產,18.38,18.38,18.24,18.36,+0.27,1.49,20000,15,366640,0,0,0,0,0,0,1000,8000,-7000,-7000
20200528,00715L,街口布蘭特油正2,5.06,5.15,5.06,5.10,-0.18,-3.41,9951380,1052,50741475,0,0,0,0,0,0,10000,396000,-386000,-386000
20200528,00717,富邦美國特別股,16.66,16.72,16.66,16.71,+0.09,0.54,1099282,244,18364293,0,0,0,0,0,0,470000,688000,-218000,-218000
20200528,00728,第一金工業30,19.09,19.12,18.84,18.87,-0.10,-0.53,557422,49,10606993,0,0,0,0,0,0,123000,378000,-255000,-255000
20200528,00730,富邦臺灣優質高息,16.71,16.76,16.60,16.64,-0.07,-0.42,603729,134,10078775,0,0,0,0,0,0,420000,514000,-94000,-94000
20200528,00731,FH富時高息低波,44.63,44.63,44.25,44.26,-0.30,-0.67,208000,29,9213100,1000,1000,0,0,0,0,198000,194000,4000,4000
20200528,00732,國泰RMB短期報酬,37.68,37.79,37.68,37.79,-0.01,-0.03,103000,3,3892040,0,0,0,0,0,0,103000,100000,3000,3000
20200528,00733,富邦臺灣中小,21.00,21.17,20.97,20.97,+0.09,0.43,278500,33,5850154,0,0,0,0,0,0,271000,204000,67000,67000
20200528,00735,國泰臺韓科技,19.79,19.80,19.55,19.64,0.00,0.00,313000,38,6164300,46000,20000,26000,0,0,0,258000,288000,-30000,-4000
20200528,00736,國泰新興市場,17.42,17.44,17.23,17.28,-0.04,-0.23,206000,14,3572160,0,3000,-3000,0,0,0,200000,202000,-2000,-5000
20200528,00737,國泰AI+Robo,22.77,22.89,22.63,22.77,+0.07,0.31,2063721,286,47067738,1148000,0,1148000,0,0,0,552000,1138000,-586000,562000
20200528,00738U,元大道瓊白銀,19.43,19.59,19.37,19.50,+0.34,1.77,2296000,590,44757350,247000,7000,240000,0,0,0,1148000,248000,900000,1140000
20200528,00739,元大MSCI A股,20.30,20.45,20.08,20.21,-0.16,-0.79,727048,92,14720870,5000,5000,0,0,0,0,643000,602000,41000,41000
20200528,00742,新光內需收益,20.54,20.54,20.47,20.47,-0.03,-0.15,110000,3,2252400,0,0,0,0,0,0,100000,110000,-10000,-10000
20200528,00743,國泰中國A150,20.15,20.15,19.82,19.82,-0.34,-1.69,26276,17,525498,0,0,0,0,0,0,0,21000,-21000,-21000
20200528,00752,中信中國50,23.00,23.02,22.72,22.89,-0.04,-0.17,1114834,371,25447969,0,1000,-1000,0,0,0,623000,784000,-161000,-162000
20200528,00753L,中信中國50正2,22.58,22.70,21.78,22.13,-0.45,-1.99,1703000,485,37881090,394000,455000,-61000,0,0,0,927000,1080000,-153000,-214000
20200528,00757,統一FANG+,28.21,28.21,27.89,27.97,-0.48,-1.69,378050,143,10582658,0,65000,-65000,0,0,0,200000,248000,-48000,-113000
20200528,00762,元大全球AI,27.97,28.00,27.65,27.78,-0.37,-1.31,684000,303,19062500,0,0,0,0,0,0,76000,385000,-309000,-309000
20200528,00763U,街口道瓊銅,16.35,16.43,16.34,16.40,-0.08,-0.49,107000,16,1751100,0,0,0,0,0,0,66000,40000,26000,26000
20200528,00766L,台新MSCI中國正2,8.50,8.67,8.34,8.47,-0.07,-0.82,635000,111,5397830,0,0,0,0,0,0,294000,406000,-112000,-112000
20200528,00770,國泰北美科技,26.56,26.56,26.22,26.36,-0.19,-0.72,1031000,292,27177080,221000,0,221000,0,0,0,330000,883000,-553000,-332000
20200528,00771,元大US高息特別股,18.86,18.86,18.65,18.71,+0.06,0.32,511000,86,9551710,1000,0,1000,0,0,0,226000,167000,59000,60000
20200528,00774B,新光中國政金綠債,39.10,39.10,39.10,39.10,-0.10,-0.26,261000,18,10205100,0,0,0,0,0,0,0,0,0,0
20200528,00774C,新光中政金綠債+R,,,,,0.00,0.00,0,0,0,0,0,0,0,0,0,0,0,0,0
20200528,00775B,新光投等債15+,44.61,45.80,44.61,45.80,+0.85,1.89,104000,16,4672430,52000,11000,41000,0,0,0,0,40000,-40000,1000
20200528,00776,新光ICE美國權值,,,,,0.00,0.00,0,0,0,0,0,0,0,0,0,0,0,0,0
20200528,00783,富邦中証500,17.70,17.85,17.53,17.65,-0.20,-1.12,980273,73,17218901,2000,8000,-6000,0,0,0,834000,944000,-110000,-116000
20200528,008201,BP上證50,96.00,96.10,95.05,95.05,-0.50,-0.52,13000,4,1247915,0,0,0,0,0,0,13000,0,13000,13000
20200528,00830,國泰費城半導體,17.55,17.61,17.41,17.53,+0.12,0.69,2856999,446,50101021,1262000,1000,1261000,0,0,0,1059000,1481000,-422000,839000
20200528,00850,元大臺灣ESG永續,21.31,21.35,21.06,21.12,-0.09,-0.42,2013557,811,42679716,0,0,0,0,0,0,682000,964000,-282000,-282000
20200528,00851,台新全球AI,22.63,22.64,22.43,22.53,-0.24,-1.05,46000,20,1037040,0,0,0,0,0,0,14000,24000,-10000,-10000
20200528,00852L,國泰美國道瓊正2,12.39,12.44,12.24,12.40,+0.52,4.38,22385100,2156,276804479,15000,1418000,-1403000,0,0,0,14571000,5565000,9006000,7603000
20200528,00861,元大全球未來通訊,20.29,20.50,20.29,20.33,+0.18,0.89,12810282,3150,261276740,0,2000,-2000,0,0,0,9758000,401000,9357000,9355000
20200528,00865B,國泰US短期公債,39.63,39.69,39.63,39.66,+0.03,0.08,128000,10,5076980,0,0,0,0,0,0,120000,100000,20000,20000
20200528,00866,新光Shiller CAPE,18.95,18.95,18.92,18.93,+0.28,1.5,67000,10,1269010,0,0,0,0,0,0,61000,30000,31000,31000
20200528,00875,國泰網路資安,23.87,23.87,23.62,23.74,-0.10,-0.42,1241287,533,29485418,38000,0,38000,0,0,0,225000,415000,-190000,-152000
20200528,01001T,土銀富邦R1,16.44,16.56,16.44,16.56,+0.12,0.73,138100,128,2283865,0,0,0,0,0,0,0,0,0,0
20200528,01002T,土銀國泰R1,17.00,17.00,16.99,17.00,0.00,0.00,281100,152,4778510,0,0,0,0,0,0,0,0,0,0
20200528,01003T,兆豐新光R1,18.88,18.90,18.88,18.90,+0.02,0.11,442000,19,8345000,438000,0,438000,0,0,0,0,0,0,438000
20200528,01004T,土銀富邦R2,14.45,14.50,14.45,14.50,+0.05,0.35,46000,36,666710,0,0,0,0,0,0,0,0,0,0
20200528,01007T,兆豐國泰R2,17.64,17.70,17.64,17.70,+0.09,0.51,39025,32,689758,0,0,0,0,0,0,0,0,0,0
20200528,01009T,王道圓滿R1,9.30,9.32,9.27,9.32,+0.02,0.22,19000,8,176720,0,0,0,0,0,0,0,0,0,0
20200528,01010T,京城樂富R1,9.95,9.97,9.94,9.97,+0.01,0.1,164000,23,1631270,0,0,0,0,0,0,0,0,0,0
20200528,020000,富邦特選蘋果N,5.01,5.02,4.97,4.98,-0.02,-0.4,39000,6,194120,0,0,0,0,0,0,1000,33000,-32000,-32000
20200528,020002,元富新中國N,,,,,0.00,0.00,0,0,0,0,0,0,0,0,0,0,0,0,0
20200528,020004,兆豐電菁英30N,,,,,0.00,0.00,0,0,0,0,0,0,0,0,0,0,0,0,0
20200528,020006,永昌中小300N,,,,,0.00,0.00,0,0,0,0,0,0,0,0,0,0,0,0,0
20200528,020007,凱基臺灣500N,,,,,0.00,0.00,0,0,0,0,0,0,0,0,0,0,0,0,0
20200528,020008,元大特股高息N,10.33,10.33,10.30,10.30,-0.01,-0.1,11000,6,113520,0,0,0,0,0,0,10000,1000,9000,9000
20200528,020011,統一微波高息20N,4.74,4.74,4.72,4.72,-0.02,-0.42,3000,3,14190,0,0,0,0,0,0,1000,2000,-1000,-1000
20200528,020012,富邦行動通訊N,5.11,5.16,5.06,5.07,0.00,0.00,2739000,197,14064480,0,0,0,0,0,0,2674000,4000,2670000,2670000
20200528,020015,統一MSCI美低波N,12.09,12.12,12.03,12.08,+0.09,0.75,185000,47,2235560,0,0,0,0,0,0,111000,43000,68000,68000
20200528,020016,統一MSCI美科技N,12.63,12.63,12.49,12.57,-0.03,-0.24,558000,124,7018500,0,0,0,0,0,0,168000,256000,-88000,-88000
20200528,02001L,富邦蘋果正二N,5.62,5.62,5.52,5.52,-0.06,-1.08,42000,3,234920,0,0,0,0,0,0,32000,10000,22000,22000
20200528,02001R,富邦蘋果反一N,4.65,4.72,4.65,4.72,+0.05,1.07,296000,14,1378220,0,0,0,0,0,0,20000,46000,-26000,-26000
20200528,03005X,元展05,,,,,0.00,0.00,0,0,0,0,0,0,0,0,0,0,0,0,0
20200528,03006X,元展06,25.60,25.60,25.60,25.60,0.00,0.00,13000,3,332800,0,0,0,0,0,0,13000,0,13000,13000
20200528,03007X,元展07,,,,,0.00,0.00,0,0,0,0,0,0,0,0,0,0,0,0,0
20200528,03009X,元展09,,,,,0.00,0.00,0,0,0,0,0,0,0,0,0,0,0,0,0
20200528,03010X,元展10,,,,,0.00,0.00,0,0,0,0,0,0,0,0,0,0,0,0,0
20200528,03012X,元展12,,,,,0.00,0.00,0,0,0,0,0,0,0,0,0,0,0,0,0
20200528,03013X,元展13,,,,,0.00,0.00,0,0,0,0,0,0,0,0,0,0,0,0,0
20200528,03014X,元展14,,,,,0.00,0.00,0,0,0,0,0,0,0,0,0,0,0,0,0
20200528,03015X,元展15,,,,,0.00,0.00,0,0,0,0,0,0,0,0,0,0,0,0,0
20200528,03016X,元展16,,,,,0.00,0.00,0,0,0,0,0,0,0,0,0,0,0,0,0
20200528,03017X,元展17,,,,,0.00,0.00,0,0,0,0,0,0,0,0,0,0,0,0,0
20200528,03019X,元展19,,,,,0.00,0.00,0,0,0,0,0,0,0,0,0,0,0,0,0
20200528,03020X,元展20,,,,,0.00,0.00,0,0,0,0,0,0,0,0,0,0,0,0,0
20200528,03022X,富展01,13.40,13.40,13.40,13.40,+0.30,2.29,1000,1,13400,0,0,0,0,0,0,0,1000,-1000,-1000
20200528,03025X,元展22,29.60,29.60,29.50,29.50,0.00,0.00,5000,2,147800,0,0,0,0,0,0,5000,0,5000,5000
20200528,03026X,元展23,,,,,0.00,0.00,0,0,0,0,0,0,0,0,0,0,0,0,0
20200528,03027X,元展24,8.00,8.00,8.00,8.00,-0.05,-0.62,1000,1,8000,0,0,0,0,0,0,0,1000,-1000,-1000
20200528,03028X,元展25,,,,,0.00,0.00,0,0,0,0,0,0,0,0,0,0,0,0,0
20200528,03029X,元展26,15.50,15.50,15.10,15.10,-0.20,-1.31,6000,2,91800,0,0,0,0,0,0,3000,3000,0,0
20200528,03033X,元展30,,,,,0.00,0.00,0,0,0,0,0,0,0,0,0,0,0,0,0
20200528,03035X,元展32,,,,,0.00,0.00,0,0,0,0,0,0,0,0,0,0,0,0,0
20200528,03038X,元展35,,,,,0.00,0.00,0,0,0,0,0,0,0,0,0,0,0,0,0
20200528,03039X,元展36,3.86,3.86,3.83,3.83,+0.11,2.96,14000,3,53860,0,0,0,0,0,0,14000,0,14000,14000
20200528,03046X,元展43,,,,,0.00,0.00,0,0,0,0,0,0,0,0,0,0,0,0,0
20200528,03047X,元展44,7.35,7.65,7.35,7.55,+0.60,8.63,160000,4,1207500,0,0,0,0,0,0,160000,0,160000,160000
20200528,03049X,元展46,4.59,4.59,4.58,4.58,-0.03,-0.65,4000,2,18340,0,0,0,0,0,0,4000,0,4000,4000
20200528,03050X,元展47,2.22,2.22,2.16,2.16,-0.03,-1.37,427000,44,939530,0,0,0,0,0,0,0,417000,-417000,-417000
20200528,03052X,元展49,17.00,17.00,17.00,17.00,0.00,0.00,4000,2,68000,0,0,0,0,0,0,0,4000,-4000,-4000
20200528,03060X,元展55,,,,,0.00,0.00,0,0,0,0,0,0,0,0,0,0,0,0,0
20200528,03064X,元展59,4.81,4.81,4.81,4.81,0.00,0.00,2000,1,9620,0,0,0,0,0,0,2000,0,2000,2000
20200528,03071X,元展66,,,,,0.00,0.00,0,0,0,0,0,0,0,0,0,0,0,0,0
20200528,03074X,元展69,,,,,0.00,0.00,0,0,0,0,0,0,0,0,0,0,0,0,0
20200528,03075X,元展70,,,,,0.00,0.00,0,0,0,0,0,0,0,0,0,0,0,0,0
20200528,03078X,元展73,,,,,0.00,0.00,0,0,0,0,0,0,0,0,0,0,0,0,0
20200528,03091X,元展85,9.20,9.20,9.20,9.20,-0.30,-3.16,5000,1,46000,0,0,0,0,0,0,0,0,0,0
20200528,03093X,永豐金元大61展01,,,,,0.00,0.00,0,0,0,0,0,0,0,0,0,0,0,0,0
20200528,03094X,大立光元大68展08,15.60,15.60,15.60,15.60,0.00,0.00,2000,1,31200,0,0,0,0,0,0,0,2000,-2000,-2000
20200528,03111P,元油2X富邦97售01,,,,,0.00,0.00,0,0,0,0,0,0,0,0,0,0,0,0,0
20200528,03162P,華邦電中信96售02,,,,,0.00,0.00,0,0,0,0,0,0,0,0,0,0,0,0,0
20200528,03181P,道瓊指中信96售01,,,,,0.00,0.00,0,0,0,0,0,0,0,0,0,0,0,0,0
20200528,03253P,玉晶光群益96售01,,,,,0.00,0.00,0,0,0,0,0,0,0,0,0,0,0,0,0
20200528,03314P,滬深2X群益96售02,,,,,0.00,0.00,0,0,0,0,0,0,0,0,0,0,0,0,0
20200528,03365P,元油2X富邦98售01,,,,,0.00,0.00,0,0,0,0,0,0,0,0,0,0,0,0,0
20200528,03388P,元油2X元富98售02,,,,,0.00,0.00,0,0,0,0,0,0,0,0,0,0,0,0,0
20200528,03412P,滬深2X群益98售01,,,,,0.00,0.00,0,0,0,0,0,0,0,0,0,0,0,0,0
20200528,03414B,臺股指凱基99熊01,2.11,2.28,2.11,2.26,+0.07,3.2,952000,51,2064230,0,0,0,0,0,0,568000,384000,184000,184000
20200528,03419B,臺股指元富99熊03,,,,,0.00,0.00,0,0,0,0,0,0,0,0,0,0,0,0,0
20200528,03421B,臺股指元大99熊01,,,,,0.00,0.00,0,0,0,0,0,0,0,0,0,0,0,0,0
20200528,03422B,臺股指凱基96熊28,,,,,0.00,0.00,0,0,0,0,0,0,0,0,0,0,0,0,0
20200528,03424B,臺股指元大96熊26,,,,,0.00,0.00,0,0,0,0,0,0,0,0,0,0,0,0,0
20200528,03425B,臺股指元大9A熊01,3.27,3.39,3.25,3.39,0.00,0.00,52000,4,176020,0,0,0,0,0,0,0,52000,-52000,-52000
20200528,03427B,臺股指元大9A熊02,3.56,3.56,3.56,3.56,+0.08,2.3,5000,1,17800,0,0,0,0,0,0,5000,0,5000,5000
20200528,03428B,臺股指凱基97熊18,,,,,0.00,0.00,0,0,0,0,0,0,0,0,0,0,0,0,0
20200528,03429B,臺股指元富97熊07,,,,,0.00,0.00,0,0,0,0,0,0,0,0,0,0,0,0,0
20200528,03430B,臺股指元大9B熊01,2.68,2.77,2.63,2.73,+0.05,1.87,30000,9,79950,0,0,0,0,0,0,27000,2000,25000,25000
20200528,03431B,元油2X凱基9B熊03,,,,,0.00,0.00,0,0,0,0,0,0,0,0,0,0,0,0,0
20200528,03432B,臺股指凱基98熊13,2.58,2.70,2.58,2.70,+0.12,4.65,50000,4,129800,0,0,0,0,0,0,0,50000,-50000,-50000
20200528,03433B,臺股指元大9C熊01,2.64,2.80,2.64,2.80,+0.13,4.87,13000,8,35590,0,0,0,0,0,0,11000,2000,9000,9000
20200528,03434B,臺股指元大99熊10,1.60,1.74,1.60,1.74,0.00,0.00,4000,3,6670,0,0,0,0,0,0,2000,0,2000,2000
20200528,03437B,臺股指元富9C熊01,1.72,1.87,1.72,1.86,+0.08,4.49,31000,7,54560,0,0,0,0,0,0,15000,16000,-1000,-1000
20200528,03438P,群創群益98售03,,,,,0.00,0.00,0,0,0,0,0,0,0,0,0,0,0,0,0
20200528,03442B,臺股指元大9A熊48,1.70,1.88,1.70,1.86,+0.08,4.49,300000,22,541960,0,0,0,0,0,0,132000,166000,-34000,-34000
20200528,03443B,臺股指凱基9A熊27,1.35,1.53,1.34,1.49,+0.06,4.2,3654000,183,5248750,80000,0,80000,0,0,0,1384000,2233000,-849000,-769000
20200528,03444B,臺股指元大9C熊02,2.20,2.30,2.13,2.27,+0.09,4.13,10000,6,22140,0,0,0,0,0,0,1000,9000,-8000,-8000
20200528,03445B,臺股指元大02熊01,2.60,2.77,2.59,2.74,+0.07,2.62,227000,15,623480,0,0,0,0,0,0,56000,171000,-115000,-115000
20200528,03446B,臺股指元大9B熊26,1.97,2.08,1.94,2.08,+0.10,5.05,30000,6,60820,0,0,0,0,0,0,30000,0,30000,30000
20200528,03447B,臺股指凱基9B熊16,1.84,1.98,1.82,1.98,+0.08,4.21,120000,7,221900,0,0,0,0,0,0,10000,110000,-100000,-100000
20200528,03450P,元油2X元富98售05,,,,,0.00,0.00,0,0,0,0,0,0,0,0,0,0,0,0,0
20200528,035274,華新台新97購01,0.23,0.25,0.15,0.16,0.00,0.00,200000,42,40120,0,0,0,0,0,0,70000,130000,-60000,-60000
20200528,035275,台積電台新97購01,19.50,19.50,18.00,18.00,0.00,0.00,27000,5,509500,0,0,0,0,0,0,1000,27000,-26000,-26000
20200528,035276,南亞科台新97購01,1.79,1.82,1.79,1.82,+0.10,5.81,40000,5,72080,0,0,0,0,0,0,0,40000,-40000,-40000
20200528,035277,景碩台新97購01,1.93,1.93,1.93,1.93,0.00,0.00,5000,1,9650,0,0,0,0,0,0,5000,0,5000,5000
20200528,03566P,群創群益96售01,0.59,0.65,0.59,0.65,+0.04,6.56,20000,2,12400,0,0,0,0,0,0,10000,10000,0,0
20200528,03603P,群創凱基98售04,1.46,1.52,1.44,1.52,+0.03,2.01,535000,21,784560,0,0,0,0,0,0,450000,165000,285000,285000
20200528,03604P,群創凱基98售05,0.98,1.01,0.97,1.01,0.00,0.00,334000,16,329300,0,0,0,0,0,0,304000,110000,194000,194000
20200528,036084,台灣50台新98購01,,,,,0.00,0.00,0,0,0,0,0,0,0,0,0,0,0,0,0
20200528,03647C,T50反1元富99牛02,1.95,1.95,1.95,1.95,0.00,0.00,118000,1,230100,0,0,0,0,0,0,0,118000,-118000,-118000
20200528,03648C,T50反1元大96牛07,1.45,1.58,1.45,1.55,+0.08,5.44,150000,4,230800,0,0,0,0,0,0,130000,20000,110000,110000
20200528,03649C,T50反1凱基99牛05,1.39,1.39,1.39,1.39,0.00,0.00,10000,2,13900,0,0,0,0,0,0,8000,0,8000,8000
20200528,03650C,T50反1元大98牛05,,,,,0.00,0.00,0,0,0,0,0,0,0,0,0,0,0,0,0
20200528,03657C,T50反1元大99牛01,1.50,1.61,1.48,1.58,+0.06,3.95,599000,18,927440,0,0,0,0,0,0,160000,439000,-279000,-279000
20200528,03658C,T50反1元大9A牛02,,,,,0.00,0.00,0,0,0,0,0,0,0,0,0,0,0,0,0
20200528,036628,統一台新99購01,,,,,0.00,0.00,0,0,0,0,0,0,0,0,0,0,0,0,0
20200528,036629,智邦台新99購01,,,,,0.00,0.00,0,0,0,0,0,0,0,0,0,0,0,0,0
20200528,03662C,FBVIX凱基03牛01,3.59,3.69,3.59,3.66,+0.02,0.55,258000,12,945810,0,0,0,0,0,0,10000,248000,-238000,-238000
20200528,036630,玉山金台新99購01,,,,,0.00,0.00,0,0,0,0,0,0,0,0,0,0,0,0,0
20200528,03669C,滬深2X元富09牛01,3.30,3.31,3.30,3.31,-0.01,-0.3,12000,2,39620,0,0,0,0,0,0,2000,10000,-8000,-8000
20200528,03670C,元油2X元富99牛01,0.80,0.80,0.77,0.77,0.00,0.00,58000,4,45280,0,0,0,0,0,0,37000,0,37000,37000
20200528,03674C,臺股指元富9C牛02,2.88,2.88,2.74,2.75,-0.08,-2.83,12000,5,33440,0,0,0,0,0,0,8000,4000,4000,4000
20200528,03675C,臺股指元大04牛02,2.95,2.95,2.95,2.95,-0.12,-3.91,10000,1,29500,0,0,0,0,0,0,0,10000,-10000,-10000
20200528,03676C,臺股指元大04牛03,,,,,0.00,0.00,0,0,0,0,0,0,0,0,0,0,0,0,0
20200528,03677C,臺股指元大05牛02,,,,,0.00,0.00,0,0,0,0,0,0,0,0,0,0,0,0,0
20200528,03678C,臺股指凱基01牛02,2.40,2.40,2.27,2.28,-0.09,-3.8,55000,11,128870,0,0,0,0,0,0,35000,20000,15000,15000
20200528,03679C,臺股指元大04牛04,2.67,2.67,2.51,2.51,-0.16,-5.99,3000,2,7690,0,0,0,0,0,0,3000,0,3000,3000
20200528,03680C,臺股指凱基9A牛26,1.76,1.78,1.59,1.62,-0.08,-4.71,1015000,72,1728190,0,0,0,0,0,0,393000,592000,-199000,-199000
20200528,03681C,台灣50凱基02牛02,2.46,2.46,2.39,2.39,-0.03,-1.24,101000,4,248190,0,0,0,0,0,0,0,101000,-101000,-101000
20200528,03682C,臺股指凱基9C牛07,1.51,1.51,1.33,1.36,-0.08,-5.56,249000,25,353810,0,0,0,0,0,0,69000,180000,-111000,-111000
20200528,03686P,大立光統一98售02,0.33,0.40,0.33,0.40,+0.05,14.29,28000,4,10090,0,0,0,0,0,0,23000,0,23000,23000
20200528,03763P,聯發科元富96售01,,,,,0.00,0.00,0,0,0,0,0,0,0,0,0,0,0,0,0
20200528,03765P,大立光元富96售01,,,,,0.00,0.00,0,0,0,0,0,0,0,0,0,0,0,0,0
20200528,03810P,大立光富邦98售01,0.50,0.50,0.50,0.50,0.00,0.00,30000,1,15000,0,0,0,0,0,0,30000,0,30000,30000
20200528,03840P,台積電統一99售02,0.24,0.27,0.24,0.26,+0.01,4.0,463000,28,116630,0,0,0,0,0,0,0,10000,-10000,-10000
20200528,038489,T50反1台新9A購01,0.13,0.18,0.13,0.17,+0.02,13.33,2356000,131,360750,0,0,0,0,0,0,160000,640000,-480000,-480000
20200528,03857P,聯發科元富99售02,0.11,0.11,0.11,0.11,-0.01,-8.33,280000,28,30800,0,0,0,0,0,0,0,218000,-218000,-218000
20200528,03860P,群創元富97售01,,,,,0.00,0.00,0,0,0,0,0,0,0,0,0,0,0,0,0
20200528,03861P,群創元富99售01,,,,,0.00,0.00,0,0,0,0,0,0,0,0,0,0,0,0,0
20200528,03875P,滬深2X國票05售01,0.77,0.83,0.77,0.83,+0.02,2.47,1150000,7,946270,0,0,0,0,0,0,1073000,77000,996000,996000
20200528,03885P,華新科統一96售01,,,,,0.00,0.00,0,0,0,0,0,0,0,0,0,0,0,0,0
20200528,039212,台達電台新9A購01,0.48,0.48,0.48,0.48,0.00,0.00,1000,1,480,0,0,0,0,0,0,0,1000,-1000,-1000
20200528,03959P,義隆元富96售01,,,,,0.00,0.00,0,0,0,0,0,0,0,0,0,0,0,0,0
20200528,03960P,新日興元富96售02,0.45,0.45,0.45,0.45,0.00,0.00,20000,1,9000,0,0,0,0,0,0,20000,0,20000,20000
20200528,04006P,滬深2X國票9B售01,,,,,0.00,0.00,0,0,0,0,0,0,0,0,0,0,0,0,0
20200528,04022P,群創元富96售04,,,,,0.00,0.00,0,0,0,0,0,0,0,0,0,0,0,0,0
20200528,04023P,臺股指元富99售02,0.61,0.86,0.61,0.86,-0.04,-4.44,13000,4,10930,0,0,0,0,0,0,0,0,0,0
20200528,04054P,滬深2X富邦96售02,,,,,0.00,0.00,0,0,0,0,0,0,0,0,0,0,0,0,0
20200528,04137P,元油反國票97售01,,,,,0.00,0.00,0,0,0,0,0,0,0,0,0,0,0,0,0
20200528,04142P,元油反凱基99售01,0.52,0.61,0.40,0.61,-0.02,-3.17,47000,8,23420,0,0,0,0,0,0,0,0,0,0
20200528,041527,T50反1中信96購01,,,,,0.00,0.00,0,0,0,0,0,0,0,0,0,0,0,0,0
20200528,041534,T50反1凱基96購01,,,,,0.00,0.00,0,0,0,0,0,0,0,0,0,0,0,0,0
20200528,04167P,滬深反凱基99售01,,,,,0.00,0.00,0,0,0,0,0,0,0,0,0,0,0,0,0
20200528,04168P,元金2X凱基99售01,,,,,0.00,0.00,0,0,0,0,0,0,0,0,0,0,0,0,0
20200528,041824,元油2X國票96購01,,,,,0.00,0.00,0,0,0,0,0,0,0,0,0,0,0,0,0
20200528,041870,A50正2凱基96購01,,,,,0.00,0.00,0,0,0,0,0,0,0,0,0,0,0,0,0
20200528,041900,元油2X富邦96購01,,,,,0.00,0.00,0,0,0,0,0,0,0,0,0,0,0,0,0
20200528,041990,A50正2國票97購01,0.02,0.02,0.02,0.02,0.00,0.00,50000,1,1000,0,0,0,0,0,0,0,50000,-50000,-50000
20200528,041991,元油2X國票98購01,,,,,0.00,0.00,0,0,0,0,0,0,0,0,0,0,0,0,0
20200528,042116,元油2X國票97購01,,,,,0.00,0.00,0,0,0,0,0,0,0,0,0,0,0,0,0
20200528,042168,台灣50凱基96購01,,,,,0.00,0.00,0,0,0,0,0,0,0,0,0,0,0,0,0
20200528,042280,元石油富邦96購01,,,,,0.00,0.00,0,0,0,0,0,0,0,0,0,0,0,0,0
20200528,042281,元油2X富邦96購02,,,,,0.00,0.00,0,0,0,0,0,0,0,0,0,0,0,0,0
20200528,042315,T50反1台新96購01,,,,,0.00,0.00,0,0,0,0,0,0,0,0,0,0,0,0,0
20200528,042317,台灣50永豐96購01,,,,,0.00,0.00,0,0,0,0,0,0,0,0,0,0,0,0,0
20200528,042433,元油2X永豐96購01,,,,,0.00,0.00,0,0,0,0,0,0,0,0,0,0,0,0,0
20200528,042501,台灣50凱基96購06,,,,,0.00,0.00,0,0,0,0,0,0,0,0,0,0,0,0,0
20200528,042556,台灣50中信96購04,,,,,0.00,0.00,0,0,0,0,0,0,0,0,0,0,0,0,0
20200528,042692,台灣50凱基96購09,,,,,0.00,0.00,0,0,0,0,0,0,0,0,0,0,0,0,0
20200528,04273P,上証反凱基99售01,,,,,0.00,0.00,0,0,0,0,0,0,0,0,0,0,0,0,0
20200528,042752,台灣50元大96購03,0.85,0.85,0.74,0.75,-0.26,-25.74,70000,6,53900,0,0,0,0,0,0,40000,40000,0,0
20200528,042792,T50反1台新9C購01,0.60,0.64,0.60,0.64,+0.09,16.36,33000,2,20000,0,0,0,0,0,0,33000,0,33000,33000
20200528,042793,台積電台新9C購01,12.30,12.60,12.00,12.40,-0.10,-0.8,15000,9,184800,0,0,0,0,0,0,0,0,0,0
20200528,04286P,滬深2X中信96售01,,,,,0.00,0.00,0,0,0,0,0,0,0,0,0,0,0,0,0
20200528,04287P,A50正2中信96售01,,,,,0.00,0.00,0,0,0,0,0,0,0,0,0,0,0,0,0
20200528,04290P,滬深2X富邦96售03,,,,,0.00,0.00,0,0,0,0,0,0,0,0,0,0,0,0,0
20200528,04293P,滬深2X元大96售02,,,,,0.00,0.00,0,0,0,0,0,0,0,0,0,0,0,0,0
20200528,042953,鴻海台新01購01,,,,,0.00,0.00,0,0,0,0,0,0,0,0,0,0,0,0,0
20200528,04311P,奇力新統一95售01,,,,,0.00,0.00,0,0,0,0,0,0,0,0,0,0,0,0,0
20200528,04313P,國巨元富95售03,,,,,0.00,0.00,0,0,0,0,0,0,0,0,0,0,0,0,0
20200528,04327P,台積電國泰95售01,,,,,0.00,0.00,0,0,0,0,0,0,0,0,0,0,0,0,0
20200528,043442,大立光台新01購01,1.40,1.40,1.33,1.33,-0.07,-5.0,65000,5,89100,0,0,0,0,0,0,0,65000,-65000,-65000
20200528,043513,台灣50元大96購05,,,,,0.00,0.00,0,0,0,0,0,0,0,0,0,0,0,0,0
20200528,043538,元石油國票97購01,0.01,0.01,0.01,0.01,0.00,0.00,561000,6,5610,0,0,0,0,0,0,0,0,0,0
20200528,043642,元金2X國票97購01,,,,,0.00,0.00,0,0,0,0,0,0,0,0,0,0,0,0,0
20200528,04373P,滬深2X元大97售01,,,,,0.00,0.00,0,0,0,0,0,0,0,0,0,0,0,0,0
20200528,04384P,上証2X中信96售01,0.43,0.43,0.43,0.43,0.00,0.00,3000,1,1290,0,0,0,0,0,0,0,3000,-3000,-3000
20200528,04411P,智易統一96售01,,,,,0.00,0.00,0,0,0,0,0,0,0,0,0,0,0,0,0
20200528,044247,道瓊反元富97購01,0.35,0.35,0.35,0.35,+0.10,40.0,1000,1,350,0,0,0,0,0,0,0,0,0,0
20200528,04427P,滬深2X元大97售02,,,,,0.00,0.00,0,0,0,0,0,0,0,0,0,0,0,0,0
20200528,04434P,玉晶光國票96售02,,,,,0.00,0.00,0,0,0,0,0,0,0,0,0,0,0,0,0
20200528,04436P,聯發科中信96售02,,,,,0.00,0.00,0,0,0,0,0,0,0,0,0,0,0,0,0
20200528,04437P,滬深2X群益98售03,0.60,0.67,0.54,0.67,+0.07,11.67,83000,8,52520,0,0,0,0,0,0,0,70000,-70000,-70000
20200528,044457,滬深2X國票97購01,,,,,0.00,0.00,0,0,0,0,0,0,0,0,0,0,0,0,0
20200528,044465,元油2X群益97購01,,,,,0.00,0.00,0,0,0,0,0,0,0,0,0,0,0,0,0
20200528,04454P,大立光富邦98售02,,,,,0.00,0.00,0,0,0,0,0,0,0,0,0,0,0,0,0
20200528,04458P,世紀鋼統一96售01,,,,,0.00,0.00,0,0,0,0,0,0,0,0,0,0,0,0,0
20200528,04460P,元油2X元富96售04,,,,,0.00,0.00,0,0,0,0,0,0,0,0,0,0,0,0,0
20200528,04462P,全新元富96售01,,,,,0.00,0.00,0,0,0,0,0,0,0,0,0,0,0,0,0
20200528,044643,滬深2X群益96購01,,,,,0.00,0.00,0,0,0,0,0,0,0,0,0,0,0,0,0
20200528,044784,華邦電中信96購01,,,,,0.00,0.00,0,0,0,0,0,0,0,0,0,0,0,0,0
20200528,04479P,同欣電中信96售02,,,,,0.00,0.00,0,0,0,0,0,0,0,0,0,0,0,0,0
20200528,04483P,元油2X凱基97售04,,,,,0.00,0.00,0,0,0,0,0,0,0,0,0,0,0,0,0
20200528,044864,道瓊反國票96購01,,,,,0.00,0.00,0,0,0,0,0,0,0,0,0,0,0,0,0
20200528,044963,台積電中信96購01,0.47,0.47,0.47,0.47,+0.04,9.3,48000,4,22560,0,0,0,0,0,0,41000,0,41000,41000
20200528,04496P,國巨國泰96售02,,,,,0.00,0.00,0,0,0,0,0,0,0,0,0,0,0,0,0
20200528,044972,元金2X國票96購01,,,,,0.00,0.00,0,0,0,0,0,0,0,0,0,0,0,0,0
20200528,04497P,元油2X富邦97售03,,,,,0.00,0.00,0,0,0,0,0,0,0,0,0,0,0,0,0
20200528,04501P,元油2X元富98售07,,,,,0.00,0.00,0,0,0,0,0,0,0,0,0,0,0,0,0
20200528,04502P,元油2X元富98售08,,,,,0.00,0.00,0,0,0,0,0,0,0,0,0,0,0,0,0
20200528,04503P,元油2X元富98售09,,,,,0.00,0.00,0,0,0,0,0,0,0,0,0,0,0,0,0
20200528,045053,聯發科元富98購01,1.70,1.70,1.48,1.51,0.00,0.00,11000,3,16650,0,0,0,0,0,0,10000,0,10000,10000
20200528,045054,聯發科元富98購02,2.93,2.93,2.93,2.93,+0.11,3.9,2000,1,5860,0,0,0,0,0,0,2000,0,2000,2000
20200528,045055,聯發科元富98購03,,,,,0.00,0.00,0,0,0,0,0,0,0,0,0,0,0,0,0
20200528,04505P,佳世達元富96售03,,,,,0.00,0.00,0,0,0,0,0,0,0,0,0,0,0,0,0
20200528,04514P,元石油中信97售01,,,,,0.00,0.00,0,0,0,0,0,0,0,0,0,0,0,0,0
20200528,04515P,元油2X群益97售02,,,,,0.00,0.00,0,0,0,0,0,0,0,0,0,0,0,0,0
20200528,045189,大立光元富98購01,0.21,0.25,0.21,0.24,-0.01,-4.0,42000,5,9160,0,0,0,0,0,0,0,0,0,0
20200528,045443,群創元富98購01,,,,,0.00,0.00,0,0,0,0,0,0,0,0,0,0,0,0,0
20200528,045444,群創元富98購02,,,,,0.00,0.00,0,0,0,0,0,0,0,0,0,0,0,0,0
20200528,04544P,欣興富邦96售02,,,,,0.00,0.00,0,0,0,0,0,0,0,0,0,0,0,0,0
20200528,045517,元油2X元富98購01,,,,,0.00,0.00,0,0,0,0,0,0,0,0,0,0,0,0,0
20200528,045572,元油2X元大98購01,,,,,0.00,0.00,0,0,0,0,0,0,0,0,0,0,0,0,0
20200528,045618,元油2X永豐98購01,,,,,0.00,0.00,0,0,0,0,0,0,0,0,0,0,0,0,0
20200528,045664,元油2X元富96購01,,,,,0.00,0.00,0,0,0,0,0,0,0,0,0,0,0,0,0
20200528,04578P,微星富邦96售01,,,,,0.00,0.00,0,0,0,0,0,0,0,0,0,0,0,0,0
20200528,045836,群創群益98購01,,,,,0.00,0.00,0,0,0,0,0,0,0,0,0,0,0,0,0
20200528,045837,群創群益98購02,,,,,0.00,0.00,0,0,0,0,0,0,0,0,0,0,0,0,0
20200528,045842,T50反1台新98購01,0.09,0.13,0.09,0.12,+0.02,20.0,169000,15,18840,0,0,0,0,0,0,0,0,0,0
20200528,045870,元油2X元富96購02,,,,,0.00,0.00,0,0,0,0,0,0,0,0,0,0,0,0,0
20200528,045871,元油2X元富96購03,,,,,0.00,0.00,0,0,0,0,0,0,0,0,0,0,0,0,0
20200528,045872,元油2X元富98購03,0.03,0.03,0.03,0.03,0.00,0.00,2165000,50,64950,0,0,0,0,0,0,0,0,0,0
20200528,045873,元油2X元富98購04,0.03,0.05,0.03,0.05,+0.02,66.67,200000,5,6020,0,0,0,0,0,0,0,0,0,0
20200528,04590P,元石油元大97售01,5.85,5.85,5.85,5.85,0.00,0.00,2000,1,11700,0,0,0,0,0,0,0,0,0,0
20200528,046061,中石化凱基98購01,0.45,0.45,0.41,0.41,-0.04,-8.89,348000,3,149480,0,0,0,0,0,0,128000,220000,-92000,-92000
20200528,04606P,高股息中信96售01,,,,,0.00,0.00,0,0,0,0,0,0,0,0,0,0,0,0,0
20200528,04611P,元油2X群益98售02,,,,,0.00,0.00,0,0,0,0,0,0,0,0,0,0,0,0,0
20200528,046147,道瓊指中信96購02,,,,,0.00,0.00,0,0,0,0,0,0,0,0,0,0,0,0,0
20200528,046159,群創群益98購04,,,,,0.00,0.00,0,0,0,0,0,0,0,0,0,0,0,0,0
20200528,046191,新光金凱基98購01,0.50,0.50,0.49,0.49,-0.04,-7.55,68000,4,33800,0,0,0,0,0,0,0,68000,-68000,-68000
20200528,04633P,旺宏群益96售04,,,,,0.00,0.00,0,0,0,0,0,0,0,0,0,0,0,0,0
20200528,046340,滬深2X國票96購01,,,,,0.00,0.00,0,0,0,0,0,0,0,0,0,0,0,0,0
20200528,046375,友達凱基98購01,,,,,0.00,0.00,0,0,0,0,0,0,0,0,0,0,0,0,0
20200528,046383,群創凱基98購01,,,,,0.00,0.00,0,0,0,0,0,0,0,0,0,0,0,0,0
20200528,046384,群創凱基98購02,,,,,0.00,0.00,0,0,0,0,0,0,0,0,0,0,0,0,0
20200528,046385,群創凱基98購03,,,,,0.00,0.00,0,0,0,0,0,0,0,0,0,0,0,0,0
20200528,046476,鴻海統一96購01,0.11,0.11,0.11,0.11,+0.01,10.0,6000,1,660,0,0,0,0,0,0,0,0,0,0
20200528,046480,群創元富96購01,,,,,0.00,0.00,0,0,0,0,0,0,0,0,0,0,0,0,0
20200528,046628,大立光統一98購01,0.95,0.96,0.82,0.85,-0.05,-5.56,483000,26,427430,0,0,0,0,0,0,0,483000,-483000,-483000
20200528,046629,群創統一98購01,0.53,0.53,0.53,0.53,-0.01,-1.85,10000,1,5300,0,0,0,0,0,0,10000,0,10000,10000
20200528,046791,台郡統一96購01,,,,,0.00,0.00,0,0,0,0,0,0,0,0,0,0,0,0,0
20200528,046792,京元電元富96購01,,,,,0.00,0.00,0,0,0,0,0,0,0,0,0,0,0,0,0
20200528,046793,聯發科元富99購01,,,,,0.00,0.00,0,0,0,0,0,0,0,0,0,0,0,0,0
20200528,046797,T50反1元大96購01,,,,,0.00,0.00,0,0,0,0,0,0,0,0,0,0,0,0,0
20200528,046798,元油2X元大96購01,,,,,0.00,0.00,0,0,0,0,0,0,0,0,0,0,0,0,0
20200528,046813,聯電凱基96購01,,,,,0.00,0.00,0,0,0,0,0,0,0,0,0,0,0,0,0
20200528,04682P,臺股指統一96售01,,,,,0.00,0.00,0,0,0,0,0,0,0,0,0,0,0,0,0
20200528,046864,和大統一97購01,,,,,0.00,0.00,0,0,0,0,0,0,0,0,0,0,0,0,0
20200528,046881,智原富邦99購01,0.28,0.28,0.26,0.26,0.00,0.00,30000,3,8000,0,0,0,0,0,0,0,30000,-30000,-30000
20200528,046882,智易富邦97購01,0.01,0.01,0.01,0.01,0.00,0.00,1000,1,10,0,0,0,0,0,0,0,0,0,0
20200528,046903,友達凱基99購01,,,,,0.00,0.00,0,0,0,0,0,0,0,0,0,0,0,0,0
20200528,046905,新光金凱基99購01,,,,,0.00,0.00,0,0,0,0,0,0,0,0,0,0,0,0,0
20200528,046906,新光金凱基99購02,,,,,0.00,0.00,0,0,0,0,0,0,0,0,0,0,0,0,0
20200528,046914,友達台新96購01,,,,,0.00,0.00,0,0,0,0,0,0,0,0,0,0,0,0,0
20200528,046928,奇鋐富邦97購01,0.22,0.22,0.22,0.22,0.00,0.00,150000,1,33000,0,0,0,0,0,0,150000,0,150000,150000
20200528,046934,智邦元富96購01,1.69,1.69,1.69,1.69,+0.79,87.78,1000,1,1690,0,0,0,0,0,0,1000,0,1000,1000
20200528,046937,聯電元大99購01,1.75,1.85,1.75,1.78,+0.05,2.89,274000,9,487130,0,0,0,0,0,0,125000,149000,-24000,-24000
20200528,046939,燿華元大96購01,,,,,0.00,0.00,0,0,0,0,0,0,0,0,0,0,0,0,0
20200528,046942,友達元大99購01,0.87,0.88,0.80,0.81,-0.03,-3.57,185000,8,159750,0,0,0,0,0,0,20000,165000,-145000,-145000
20200528,046944,奇力新元大96購01,,,,,0.00,0.00,0,0,0,0,0,0,0,0,0,0,0,0,0
20200528,046949,群創元大99購01,,,,,0.00,0.00,0,0,0,0,0,0,0,0,0,0,0,0,0
20200528,046999,康控富邦99購01,0.07,0.07,0.07,0.07,0.00,0.00,29000,2,2030,0,0,0,0,0,0,0,0,0,0
20200528,047004,台積電統一99購01,2.00,2.00,1.88,1.89,-0.05,-2.58,47000,12,91020,0,0,0,0,0,0,2000,3000,-1000,-1000
20200528,047013,超眾元富96購01,,,,,0.00,0.00,0,0,0,0,0,0,0,0,0,0,0,0,0
20200528,047014,元油反元大99購01,,,,,0.00,0.00,0,0,0,0,0,0,0,0,0,0,0,0,0
20200528,047096,元油反國泰96購01,,,,,0.00,0.00,0,0,0,0,0,0,0,0,0,0,0,0,0
20200528,047194,世紀鋼元大96購01,,,,,0.00,0.00,0,0,0,0,0,0,0,0,0,0,0,0,0
20200528,047196,上銀統一97購01,1.57,1.64,1.19,1.19,-0.41,-25.63,176000,27,258390,0,0,0,0,0,0,71000,105000,-34000,-34000
20200528,047202,欣興元富96購01,,,,,0.00,0.00,0,0,0,0,0,0,0,0,0,0,0,0,0
20200528,047209,滬深2X富邦96購01,,,,,0.00,0.00,0,0,0,0,0,0,0,0,0,0,0,0,0
20200528,047211,華新科富邦99購01,,,,,0.00,0.00,0,0,0,0,0,0,0,0,0,0,0,0,0
20200528,047212,宏達電富邦97購01,0.05,0.05,0.04,0.04,0.00,0.00,144000,2,6760,0,0,0,0,0,0,0,44000,-44000,-44000
20200528,047213,新日興富邦97購01,0.62,0.71,0.61,0.63,+0.08,14.55,273000,26,180330,0,0,0,0,0,0,62000,211000,-149000,-149000
20200528,047214,啟碁富邦97購01,,,,,0.00,0.00,0,0,0,0,0,0,0,0,0,0,0,0,0
20200528,04727P,臺股指凱基96售03,,,,,0.00,0.00,0,0,0,0,0,0,0,0,0,0,0,0,0
20200528,047289,啟碁統一97購01,,,,,0.00,0.00,0,0,0,0,0,0,0,0,0,0,0,0,0
20200528,047292,台光電元富96購01,,,,,0.00,0.00,0,0,0,0,0,0,0,0,0,0,0,0,0
20200528,047295,欣興元富96購02,,,,,0.00,0.00,0,0,0,0,0,0,0,0,0,0,0,0,0
20200528,047296,日月光元富96購01,,,,,0.00,0.00,0,0,0,0,0,0,0,0,0,0,0,0,0
20200528,047298,聯茂元富96購01,,,,,0.00,0.00,0,0,0,0,0,0,0,0,0,0,0,0,0
20200528,04729P,臺股指中信96售01,,,,,0.00,0.00,0,0,0,0,0,0,0,0,0,0,0,0,0
20200528,047302,為升富邦97購01,,,,,0.00,0.00,0,0,0,0,0,0,0,0,0,0,0,0,0
20200528,047303,寶滬深元大96購01,,,,,0.00,0.00,0,0,0,0,0,0,0,0,0,0,0,0,0
20200528,047304,元油2X元大96購02,,,,,0.00,0.00,0,0,0,0,0,0,0,0,0,0,0,0,0
20200528,04730P,臺股指中信96售02,,,,,0.00,0.00,0,0,0,0,0,0,0,0,0,0,0,0,0
20200528,04731P,臺股指中信96售03,0.60,0.74,0.60,0.72,+0.05,7.46,189000,12,129780,0,0,0,0,0,0,53000,131000,-78000,-78000
20200528,047342,T50反1中信99購01,,,,,0.00,0.00,0,0,0,0,0,0,0,0,0,0,0,0,0
20200528,047379,元油2X元大96購03,,,,,0.00,0.00,0,0,0,0,0,0,0,0,0,0,0,0,0
20200528,047405,香港2X統一96購01,,,,,0.00,0.00,0,0,0,0,0,0,0,0,0,0,0,0,0
20200528,047410,上銀元富96購01,1.20,1.35,0.83,0.83,-0.36,-30.25,272000,11,325900,0,0,0,0,0,0,241000,31000,210000,210000
20200528,047417,台塑富邦97購01,0.07,0.07,0.07,0.07,0.00,0.00,60000,7,4200,0,0,0,0,0,0,0,49000,-49000,-49000
20200528,047418,智邦富邦97購01,,,,,0.00,0.00,0,0,0,0,0,0,0,0,0,0,0,0,0
20200528,047420,全新富邦97購01,0.10,0.10,0.10,0.10,0.00,0.00,101000,5,10100,0,0,0,0,0,0,0,101000,-101000,-101000
20200528,047421,聯茂富邦97購01,,,,,0.00,0.00,0,0,0,0,0,0,0,0,0,0,0,0,0
20200528,047454,滬深2X群益96購03,,,,,0.00,0.00,0,0,0,0,0,0,0,0,0,0,0,0,0
20200528,047482,新光金凱基99購03,,,,,0.00,0.00,0,0,0,0,0,0,0,0,0,0,0,0,0
20200528,047483,新光金凱基99購04,,,,,0.00,0.00,0,0,0,0,0,0,0,0,0,0,0,0,0
20200528,047493,旺宏元富96購01,,,,,0.00,0.00,0,0,0,0,0,0,0,0,0,0,0,0,0
20200528,047494,華邦電元富96購01,,,,,0.00,0.00,0,0,0,0,0,0,0,0,0,0,0,0,0
20200528,047495,新日興元富96購01,,,,,0.00,0.00,0,0,0,0,0,0,0,0,0,0,0,0,0
20200528,047504,滬深2X國票9A購01,0.10,0.10,0.10,0.10,0.00,0.00,9000,1,900,0,0,0,0,0,0,0,0,0,0
20200528,047505,元金2X國票9B購01,,,,,0.00,0.00,0,0,0,0,0,0,0,0,0,0,0,0,0
20200528,047517,元油反元大96購01,,,,,0.00,0.00,0,0,0,0,0,0,0,0,0,0,0,0,0
20200528,047547,友達凱基99購02,0.21,0.21,0.21,0.21,0.00,0.00,1000,1,210,0,0,0,0,0,0,1000,0,1000,1000
20200528,047548,友達凱基99購03,,,,,0.00,0.00,0,0,0,0,0,0,0,0,0,0,0,0,0
20200528,047564,滬深2X國票99購01,0.09,0.10,0.09,0.09,-0.01,-10.0,329000,6,30800,0,0,0,0,0,0,119000,210000,-91000,-91000
20200528,047571,滬深2X群益99購01,0.04,0.04,0.03,0.03,0.00,0.00,209000,5,6670,0,0,0,0,0,0,142000,0,142000,142000
20200528,047595,元石油元富97購01,,,,,0.00,0.00,0,0,0,0,0,0,0,0,0,0,0,0,0
20200528,047596,元油反元富97購01,,,,,0.00,0.00,0,0,0,0,0,0,0,0,0,0,0,0,0
20200528,047629,深中小元大96購01,,,,,0.00,0.00,0,0,0,0,0,0,0,0,0,0,0,0,0
20200528,047630,元油反元大96購02,,,,,0.00,0.00,0,0,0,0,0,0,0,0,0,0,0,0,0
20200528,04763P,臺股指凱基96售05,,,,,0.00,0.00,0,0,0,0,0,0,0,0,0,0,0,0,0
20200528,047661,滬深2X永豐96購01,,,,,0.00,0.00,0,0,0,0,0,0,0,0,0,0,0,0,0
20200528,047673,瑞昱元富96購01,0.39,0.44,0.39,0.41,+0.03,7.89,350000,6,140480,0,0,0,0,0,0,200000,150000,50000,50000
20200528,047674,群創元富96購02,,,,,0.00,0.00,0,0,0,0,0,0,0,0,0,0,0,0,0
20200528,047675,群創元富96購03,0.15,0.15,0.14,0.14,0.00,0.00,130000,2,18500,0,0,0,0,0,0,30000,100000,-70000,-70000
20200528,047676,臺股指元富99購01,,,,,0.00,0.00,0,0,0,0,0,0,0,0,0,0,0,0,0
20200528,047680,上証反中信96購01,,,,,0.00,0.00,0,0,0,0,0,0,0,0,0,0,0,0,0
20200528,047687,元金2X富邦96購01,,,,,0.00,0.00,0,0,0,0,0,0,0,0,0,0,0,0,0
20200528,047689,瑞昱富邦97購01,,,,,0.00,0.00,0,0,0,0,0,0,0,0,0,0,0,0,0
20200528,04768P,大立光國泰96售03,,,,,0.00,0.00,0,0,0,0,0,0,0,0,0,0,0,0,0
20200528,047690,美律富邦97購01,,,,,0.00,0.00,0,0,0,0,0,0,0,0,0,0,0,0,0
20200528,047694,SP黃豆國票9B購01,,,,,0.00,0.00,0,0,0,0,0,0,0,0,0,0,0,0,0
20200528,04771P,友達元大96售02,,,,,0.00,0.00,0,0,0,0,0,0,0,0,0,0,0,0,0
20200528,047760,元油反元大96購03,,,,,0.00,0.00,0,0,0,0,0,0,0,0,0,0,0,0,0
20200528,047769,大立光元大96購01,,,,,0.00,0.00,0,0,0,0,0,0,0,0,0,0,0,0,0
20200528,047773,超眾元大96購01,,,,,0.00,0.00,0,0,0,0,0,0,0,0,0,0,0,0,0
20200528,047780,友達中信96購01,,,,,0.00,0.00,0,0,0,0,0,0,0,0,0,0,0,0,0
20200528,047825,道瓊反元大96購01,,,,,0.00,0.00,0,0,0,0,0,0,0,0,0,0,0,0,0
20200528,04782P,智伸科統一96售01,,,,,0.00,0.00,0,0,0,0,0,0,0,0,0,0,0,0,0
20200528,047854,滬深2X國票96購02,,,,,0.00,0.00,0,0,0,0,0,0,0,0,0,0,0,0,0
20200528,04786P,鴻海永昌96售01,0.01,0.01,0.01,0.01,0.00,0.00,100000,1,1000,0,0,0,0,0,0,100000,0,100000,100000
20200528,04787P,台積電永昌96售04,0.33,0.39,0.33,0.39,+0.02,5.41,241000,5,83780,0,0,0,0,0,0,241000,241000,0,0
20200528,047885,元金2X富邦99購01,1.37,1.60,1.37,1.60,-0.12,-6.98,11000,3,17370,0,0,0,0,0,0,1000,0,1000,1000
20200528,047887,智原富邦97購01,,,,,0.00,0.00,0,0,0,0,0,0,0,0,0,0,0,0,0
20200528,04788P,台積電永昌96售05,0.01,0.01,0.01,0.01,0.00,0.00,10000,1,100,0,0,0,0,0,0,10000,0,10000,10000
20200528,047903,滬深2X元大96購01,,,,,0.00,0.00,0,0,0,0,0,0,0,0,0,0,0,0,0
20200528,047904,臺指反元大96購01,0.14,0.14,0.14,0.14,0.00,0.00,100000,1,14000,0,0,0,0,0,0,0,100000,-100000,-100000
20200528,047905,元油反元大96購04,,,,,0.00,0.00,0,0,0,0,0,0,0,0,0,0,0,0,0
20200528,047937,元金2X國票97購02,,,,,0.00,0.00,0,0,0,0,0,0,0,0,0,0,0,0,0
20200528,047944,中石化元富96購01,,,,,0.00,0.00,0,0,0,0,0,0,0,0,0,0,0,0,0
20200528,04794P,友達元大96售03,,,,,0.00,0.00,0,0,0,0,0,0,0,0,0,0,0,0,0
20200528,047962,T50反1中信96購02,0.16,0.23,0.16,0.21,+0.02,10.53,3203000,38,641070,0,0,0,0,0,0,1167000,1984000,-817000,-817000
20200528,047969,台達電富邦97購01,,,,,0.00,0.00,0,0,0,0,0,0,0,0,0,0,0,0,0
20200528,047978,元油反群益97購01,,,,,0.00,0.00,0,0,0,0,0,0,0,0,0,0,0,0,0
20200528,047989,深中小元大96購02,,,,,0.00,0.00,0,0,0,0,0,0,0,0,0,0,0,0,0
20200528,047990,臺指反元大96購02,0.28,0.31,0.28,0.31,+0.01,3.33,60000,2,17100,0,0,0,0,0,0,10000,50000,-40000,-40000
20200528,047991,元油反元大96購05,,,,,0.00,0.00,0,0,0,0,0,0,0,0,0,0,0,0,0
20200528,047992,東陽元大96購01,,,,,0.00,0.00,0,0,0,0,0,0,0,0,0,0,0,0,0
20200528,047993,鑽全元大96購01,,,,,0.00,0.00,0,0,0,0,0,0,0,0,0,0,0,0,0
20200528,047995,台達電元大96購01,,,,,0.00,0.00,0,0,0,0,0,0,0,0,0,0,0,0,0
20200528,048001,中工元大96購01,0.12,0.12,0.12,0.12,0.00,0.00,1000,1,120,0,0,0,0,0,0,1000,0,1000,1000
20200528,048007,明基材元大96購01,0.02,0.02,0.01,0.01,0.00,0.00,60000,2,700,0,0,0,0,0,0,60000,0,60000,60000
20200528,048010,嘉聯益富邦97購01,,,,,0.00,0.00,0,0,0,0,0,0,0,0,0,0,0,0,0
20200528,048020,滬深2X凱基96購02,,,,,0.00,0.00,0,0,0,0,0,0,0,0,0,0,0,0,0
20200528,048049,滬深反中信96購01,,,,,0.00,0.00,0,0,0,0,0,0,0,0,0,0,0,0,0
20200528,048070,聯發科元富99購03,1.10,1.10,1.10,1.10,0.00,0.00,2000,1,2200,0,0,0,0,0,0,0,0,0,0
20200528,048080,元石油凱基96購01,,,,,0.00,0.00,0,0,0,0,0,0,0,0,0,0,0,0,0
20200528,048081,元油反凱基96購01,,,,,0.00,0.00,0,0,0,0,0,0,0,0,0,0,0,0,0
20200528,048105,滬深2X群益99購02,,,,,0.00,0.00,0,0,0,0,0,0,0,0,0,0,0,0,0
20200528,048119,臺指反元大96購03,,,,,0.00,0.00,0,0,0,0,0,0,0,0,0,0,0,0,0
20200528,048122,台達電元大96購02,,,,,0.00,0.00,0,0,0,0,0,0,0,0,0,0,0,0,0
20200528,048125,和鑫元大96購01,,,,,0.00,0.00,0,0,0,0,0,0,0,0,0,0,0,0,0
20200528,048130,美利達元大96購01,,,,,0.00,0.00,0,0,0,0,0,0,0,0,0,0,0,0,0
20200528,04814P,健策元大96售01,,,,,0.00,0.00,0,0,0,0,0,0,0,0,0,0,0,0,0
20200528,048166,滬深2X永豐96購02,,,,,0.00,0.00,0,0,0,0,0,0,0,0,0,0,0,0,0
20200528,048177,臺指反富邦99購01,0.14,0.14,0.14,0.14,-0.03,-17.65,99000,2,13860,0,0,0,0,0,0,89000,0,89000,89000
20200528,048179,臻鼎富邦97購01,0.40,0.40,0.34,0.34,-0.02,-5.56,24000,6,8400,0,0,0,0,0,0,0,0,0,0
20200528,048186,元黃金元大96購01,,,,,0.00,0.00,0,0,0,0,0,0,0,0,0,0,0,0,0
20200528,048187,臺指反元大96購04,,,,,0.00,0.00,0,0,0,0,0,0,0,0,0,0,0,0,0
20200528,048188,臺指反元大96購05,0.34,0.34,0.34,0.34,-0.04,-10.53,20000,1,6800,0,0,0,0,0,0,0,20000,-20000,-20000
20200528,048189,臺指反元大96購06,0.46,0.46,0.46,0.46,-0.04,-8.0,50000,1,23000,0,0,0,0,0,0,50000,0,50000,50000
20200528,048190,道瓊反元大96購02,,,,,0.00,0.00,0,0,0,0,0,0,0,0,0,0,0,0,0
20200528,048192,華通元大96購01,1.80,2.11,1.75,1.85,+0.31,20.13,145000,16,280160,0,0,0,0,0,0,85000,40000,45000,45000
20200528,048214,滬深2X凱基96購03,,,,,0.00,0.00,0,0,0,0,0,0,0,0,0,0,0,0,0
20200528,048236,A50正2國票97購02,,,,,0.00,0.00,0,0,0,0,0,0,0,0,0,0,0,0,0
20200528,048270,T50反1富邦99購01,0.74,0.74,0.74,0.74,-0.02,-2.63,10000,2,7400,0,0,0,0,0,0,0,10000,-10000,-10000
20200528,048272,新光金富邦98購01,,,,,0.00,0.00,0,0,0,0,0,0,0,0,0,0,0,0,0
20200528,048273,南電富邦97購01,0.95,0.97,0.92,0.97,+0.03,3.19,23000,4,21750,0,0,0,0,0,0,12000,11000,1000,1000
20200528,048303,A50凱基96購01,,,,,0.00,0.00,0,0,0,0,0,0,0,0,0,0,0,0,0
20200528,048305,深100凱基96購01,,,,,0.00,0.00,0,0,0,0,0,0,0,0,0,0,0,0,0
20200528,04831P,聯詠富邦96售01,0.11,0.11,0.11,0.11,0.00,0.00,1000,1,110,0,0,0,0,0,0,1000,0,1000,1000
20200528,048331,臺指反富邦97購01,,,,,0.00,0.00,0,0,0,0,0,0,0,0,0,0,0,0,0
20200528,048334,A50正2元大96購01,,,,,0.00,0.00,0,0,0,0,0,0,0,0,0,0,0,0,0
20200528,048349,美利達元大96購02,,,,,0.00,0.00,0,0,0,0,0,0,0,0,0,0,0,0,0
20200528,048379,台郡元富96購01,0.12,0.12,0.12,0.12,0.00,0.00,14000,1,1680,0,0,0,0,0,0,14000,14000,0,0
20200528,048382,T50反1國票96購01,,,,,0.00,0.00,0,0,0,0,0,0,0,0,0,0,0,0,0
20200528,048383,元金2X國票99購01,2.19,2.27,2.17,2.25,+0.13,6.13,784000,35,1731970,0,0,0,0,0,0,104000,656000,-552000,-552000
20200528,048414,滬深2X統一98購01,,,,,0.00,0.00,0,0,0,0,0,0,0,0,0,0,0,0,0
20200528,048422,瑞昱元富96購02,0.43,0.43,0.43,0.43,0.00,0.00,1000,1,430,0,0,0,0,0,0,0,1000,-1000,-1000
20200528,048425,聯茂元富96購02,,,,,0.00,0.00,0,0,0,0,0,0,0,0,0,0,0,0,0
20200528,04842P,群創元大96售02,,,,,0.00,0.00,0,0,0,0,0,0,0,0,0,0,0,0,0
20200528,048499,達運元大96購01,,,,,0.00,0.00,0,0,0,0,0,0,0,0,0,0,0,0,0
20200528,048504,A50正2中信95購01,,,,,0.00,0.00,0,0,0,0,0,0,0,0,0,0,0,0,0
20200528,048505,滬深2X群益99購03,,,,,0.00,0.00,0,0,0,0,0,0,0,0,0,0,0,0,0
20200528,048509,上証反凱基99購02,,,,,0.00,0.00,0,0,0,0,0,0,0,0,0,0,0,0,0
20200528,048522,A50正2元富95購02,,,,,0.00,0.00,0,0,0,0,0,0,0,0,0,0,0,0,0
20200528,048549,滬深2X元大96購03,,,,,0.00,0.00,0,0,0,0,0,0,0,0,0,0,0,0,0
20200528,04854P,鴻海國泰96售04,0.95,0.95,0.95,0.95,-0.13,-12.04,200000,1,190000,0,0,0,0,0,0,200000,200000,0,0
20200528,048550,中鴻元大96購01,0.02,0.02,0.02,0.02,+0.01,100.0,20000,1,400,0,0,0,0,0,0,20000,0,20000,20000
20200528,048562,宏達電元大95購01,,,,,0.00,0.00,0,0,0,0,0,0,0,0,0,0,0,0,0
20200528,048571,美利達元大96購03,,,,,0.00,0.00,0,0,0,0,0,0,0,0,0,0,0,0,0
20200528,048572,美利達元大96購04,0.88,0.88,0.88,0.88,0.00,0.00,7000,1,6160,0,0,0,0,0,0,0,0,0,0
20200528,048574,台積電國泰95購02,7.75,7.75,6.60,6.60,-0.75,-10.2,310000,4,2391000,0,0,0,0,0,0,310000,310000,0,0
20200528,048576,義隆國泰95購01,,,,,0.00,0.00,0,0,0,0,0,0,0,0,0,0,0,0,0
20200528,048583,智原富邦98購01,,,,,0.00,0.00,0,0,0,0,0,0,0,0,0,0,0,0,0
20200528,048584,欣興富邦95購01,,,,,0.00,0.00,0,0,0,0,0,0,0,0,0,0,0,0,0
20200528,048589,國巨兆豐96購01,3.08,3.08,3.08,3.08,+0.18,6.21,17000,1,52360,0,0,0,0,0,0,17000,17000,0,0
20200528,048595,儒鴻國票96購01,,,,,0.00,0.00,0,0,0,0,0,0,0,0,0,0,0,0,0
20200528,048599,和鑫國票96購01,,,,,0.00,0.00,0,0,0,0,0,0,0,0,0,0,0,0,0
20200528,048602,上緯控國票96購01,,,,,0.00,0.00,0,0,0,0,0,0,0,0,0,0,0,0,0
20200528,048627,T50反1元大96購02,,,,,0.00,0.00,0,0,0,0,0,0,0,0,0,0,0,0,0
20200528,048628,T50反1元大96購03,,,,,0.00,0.00,0,0,0,0,0,0,0,0,0,0,0,0,0
20200528,048629,滬深2X元大96購04,,,,,0.00,0.00,0,0,0,0,0,0,0,0,0,0,0,0,0
20200528,048637,鴻海元大96購01,,,,,0.00,0.00,0,0,0,0,0,0,0,0,0,0,0,0,0
20200528,048651,美利達元大96購05,1.03,1.03,1.01,1.03,+0.22,27.16,215000,4,221250,0,0,0,0,0,0,5000,210000,-205000,-205000
20200528,048652,巨大元大96購01,,,,,0.00,0.00,0,0,0,0,0,0,0,0,0,0,0,0,0
20200528,048653,巨大元大96購02,1.68,1.68,1.68,1.68,-0.03,-1.75,20000,2,33600,0,0,0,0,0,0,0,20000,-20000,-20000
20200528,048655,A50正2元富96購01,,,,,0.00,0.00,0,0,0,0,0,0,0,0,0,0,0,0,0
20200528,048663,聯發科統一96購01,,,,,0.00,0.00,0,0,0,0,0,0,0,0,0,0,0,0,0
20200528,048681,漢唐富邦96購01,,,,,0.00,0.00,0,0,0,0,0,0,0,0,0,0,0,0,0
20200528,048682,奇力新富邦96購01,,,,,0.00,0.00,0,0,0,0,0,0,0,0,0,0,0,0,0
20200528,048687,旺宏群益96購01,,,,,0.00,0.00,0,0,0,0,0,0,0,0,0,0,0,0,0
20200528,048696,台達電國票96購01,,,,,0.00,0.00,0,0,0,0,0,0,0,0,0,0,0,0,0
20200528,048744,儒鴻元富97購01,0.01,0.03,0.01,0.03,0.00,0.00,107000,2,1090,0,0,0,0,0,0,106000,0,106000,106000
20200528,048745,儒鴻元富97購02,,,,,0.00,0.00,0,0,0,0,0,0,0,0,0,0,0,0,0
20200528,048747,華通元富97購01,,,,,0.00,0.00,0,0,0,0,0,0,0,0,0,0,0,0,0
20200528,048748,國巨元富96購01,,,,,0.00,0.00,0,0,0,0,0,0,0,0,0,0,0,0,0
20200528,04874P,高股息中信97售01,,,,,0.00,0.00,0,0,0,0,0,0,0,0,0,0,0,0,0
20200528,048751,京鼎元富96購01,1.83,1.83,1.83,1.83,0.00,0.00,10000,1,18300,0,0,0,0,0,0,10000,0,10000,10000
20200528,048754,瀚宇博元富97購01,,,,,0.00,0.00,0,0,0,0,0,0,0,0,0,0,0,0,0
20200528,048755,志超元富96購01,,,,,0.00,0.00,0,0,0,0,0,0,0,0,0,0,0,0,0
20200528,048756,志超元富96購02,,,,,0.00,0.00,0,0,0,0,0,0,0,0,0,0,0,0,0
20200528,048757,美利達元富96購01,,,,,0.00,0.00,0,0,0,0,0,0,0,0,0,0,0,0,0
20200528,048758,美利達元富96購02,,,,,0.00,0.00,0,0,0,0,0,0,0,0,0,0,0,0,0
20200528,048759,巨大元富96購01,,,,,0.00,0.00,0,0,0,0,0,0,0,0,0,0,0,0,0
20200528,048781,臺股指凱基96購01,,,,,0.00,0.00,0,0,0,0,0,0,0,0,0,0,0,0,0
20200528,048785,台積電元大96購01,2.98,2.98,2.93,2.93,+0.05,1.74,323000,4,955040,0,0,0,0,0,0,323000,323000,0,0
20200528,048794,易華電元大97購01,,,,,0.00,0.00,0,0,0,0,0,0,0,0,0,0,0,0,0
20200528,048801,漢唐富邦96購02,,,,,0.00,0.00,0,0,0,0,0,0,0,0,0,0,0,0,0
20200528,048803,大立光富邦96購01,,,,,0.00,0.00,0,0,0,0,0,0,0,0,0,0,0,0,0
20200528,048812,上証2X凱基96購01,,,,,0.00,0.00,0,0,0,0,0,0,0,0,0,0,0,0,0
20200528,04881P,高股息凱基96售01,0.22,0.22,0.21,0.21,0.00,0.00,24000,3,5080,0,0,0,0,0,0,0,24000,-24000,-24000
20200528,048847,A50群益98購01,0.11,0.11,0.11,0.11,0.00,0.00,9000,1,990,0,0,0,0,0,0,0,0,0,0
20200528,048848,滬深2X群益98購02,0.40,0.40,0.40,0.40,0.00,0.00,10000,1,4000,0,0,0,0,0,0,10000,0,10000,10000
20200528,048850,聯電群益96購01,,,,,0.00,0.00,0,0,0,0,0,0,0,0,0,0,0,0,0
20200528,048852,旺宏群益96購02,,,,,0.00,0.00,0,0,0,0,0,0,0,0,0,0,0,0,0
20200528,048859,玉晶光群益96購02,,,,,0.00,0.00,0,0,0,0,0,0,0,0,0,0,0,0,0
20200528,048860,玉晶光群益96購03,,,,,0.00,0.00,0,0,0,0,0,0,0,0,0,0,0,0,0
20200528,048870,義隆國票96購01,0.01,0.01,0.01,0.01,0.00,0.00,100000,1,1000,0,0,0,0,0,0,100000,0,100000,100000
20200528,048874,玉晶光國票96購01,,,,,0.00,0.00,0,0,0,0,0,0,0,0,0,0,0,0,0
20200528,048882,智原統一96購01,,,,,0.00,0.00,0,0,0,0,0,0,0,0,0,0,0,0,0
20200528,048890,傳奇元富97購01,,,,,0.00,0.00,0,0,0,0,0,0,0,0,0,0,0,0,0
20200528,048891,傳奇元富97購02,,,,,0.00,0.00,0,0,0,0,0,0,0,0,0,0,0,0,0
20200528,048892,台郡元富97購01,,,,,0.00,0.00,0,0,0,0,0,0,0,0,0,0,0,0,0
20200528,048898,晶相光國泰96購01,,,,,0.00,0.00,0,0,0,0,0,0,0,0,0,0,0,0,0
20200528,048902,昇陽半國泰96購01,,,,,0.00,0.00,0,0,0,0,0,0,0,0,0,0,0,0,0
20200528,048905,旺宏富邦96購01,,,,,0.00,0.00,0,0,0,0,0,0,0,0,0,0,0,0,0
20200528,048910,和鑫富邦98購01,,,,,0.00,0.00,0,0,0,0,0,0,0,0,0,0,0,0,0
20200528,048911,玉晶光富邦96購01,,,,,0.00,0.00,0,0,0,0,0,0,0,0,0,0,0,0,0
20200528,049004,聯發科中信96購01,1.78,1.78,1.78,1.78,-0.13,-6.81,5000,1,8900,0,0,0,0,0,0,5000,0,5000,5000
20200528,049007,玉晶光中信96購01,0.11,0.12,0.11,0.12,+0.02,20.0,40000,2,4700,0,0,0,0,0,0,30000,10000,20000,20000
20200528,049017,旺宏群益96購03,0.02,0.02,0.02,0.02,0.00,0.00,11000,1,220,0,0,0,0,0,0,11000,11000,0,0
20200528,049023,玉晶光群益96購04,0.01,0.01,0.01,0.01,0.00,0.00,73000,2,730,0,0,0,0,0,0,73000,0,73000,73000
20200528,049024,玉晶光群益97購01,0.69,0.78,0.69,0.74,+0.08,12.12,35000,4,25520,0,0,0,0,0,0,0,35000,-35000,-35000
20200528,049064,T50反1凱基96購03,,,,,0.00,0.00,0,0,0,0,0,0,0,0,0,0,0,0,0
20200528,049065,T50反1凱基96購04,0.14,0.14,0.14,0.14,0.00,0.00,1000,1,140,0,0,0,0,0,0,0,1000,-1000,-1000
20200528,049066,元石油凱基97購01,,,,,0.00,0.00,0,0,0,0,0,0,0,0,0,0,0,0,0
20200528,049098,國巨國泰96購01,,,,,0.00,0.00,0,0,0,0,0,0,0,0,0,0,0,0,0
20200528,049100,華新科國泰96購01,,,,,0.00,0.00,0,0,0,0,0,0,0,0,0,0,0,0,0
20200528,049102,智伸科國泰96購01,,,,,0.00,0.00,0,0,0,0,0,0,0,0,0,0,0,0,0
20200528,049103,易華電國泰96購01,,,,,0.00,0.00,0,0,0,0,0,0,0,0,0,0,0,0,0
20200528,049104,元油2X富邦97購02,,,,,0.00,0.00,0,0,0,0,0,0,0,0,0,0,0,0,0
20200528,049108,玉晶光富邦96購02,,,,,0.00,0.00,0,0,0,0,0,0,0,0,0,0,0,0,0
20200528,049117,矽格統一96購01,,,,,0.00,0.00,0,0,0,0,0,0,0,0,0,0,0,0,0
20200528,049128,滬深2X元大97購03,,,,,0.00,0.00,0,0,0,0,0,0,0,0,0,0,0,0,0
20200528,049129,S&P反1元大97購01,,,,,0.00,0.00,0,0,0,0,0,0,0,0,0,0,0,0,0
20200528,049130,臺指反元大98購01,,,,,0.00,0.00,0,0,0,0,0,0,0,0,0,0,0,0,0
20200528,049150,新光金元大96購01,,,,,0.00,0.00,0,0,0,0,0,0,0,0,0,0,0,0,0
20200528,049153,大立光元大96購02,,,,,0.00,0.00,0,0,0,0,0,0,0,0,0,0,0,0,0
20200528,049156,緯穎元大96購01,,,,,0.00,0.00,0,0,0,0,0,0,0,0,0,0,0,0,0
20200528,049159,同欣電中信96購01,,,,,0.00,0.00,0,0,0,0,0,0,0,0,0,0,0,0,0
20200528,04915P,鴻海永昌96售02,,,,,0.00,0.00,0,0,0,0,0,0,0,0,0,0,0,0,0
20200528,049165,元油2X凱基97購01,,,,,0.00,0.00,0,0,0,0,0,0,0,0,0,0,0,0,0
20200528,049166,元油2X凱基97購02,,,,,0.00,0.00,0,0,0,0,0,0,0,0,0,0,0,0,0
20200528,049167,元油2X凱基97購03,,,,,0.00,0.00,0,0,0,0,0,0,0,0,0,0,0,0,0
20200528,04916P,大立光永昌96售02,,,,,0.00,0.00,0,0,0,0,0,0,0,0,0,0,0,0,0
20200528,049192,元油2X永豐96購02,,,,,0.00,0.00,0,0,0,0,0,0,0,0,0,0,0,0,0
20200528,049193,元油2X永豐97購01,,,,,0.00,0.00,0,0,0,0,0,0,0,0,0,0,0,0,0
20200528,049200,元黃金群益98購01,,,,,0.00,0.00,0,0,0,0,0,0,0,0,0,0,0,0,0
20200528,049227,元油2X富邦96購03,,,,,0.00,0.00,0,0,0,0,0,0,0,0,0,0,0,0,0
20200528,049230,台達電富邦96購01,,,,,0.00,0.00,0,0,0,0,0,0,0,0,0,0,0,0,0
20200528,049235,元油2X元富96購05,,,,,0.00,0.00,0,0,0,0,0,0,0,0,0,0,0,0,0
20200528,049236,元油2X元富96購06,,,,,0.00,0.00,0,0,0,0,0,0,0,0,0,0,0,0,0
20200528,049237,元油2X元富96購07,,,,,0.00,0.00,0,0,0,0,0,0,0,0,0,0,0,0,0
20200528,049238,元油2X元富96購08,,,,,0.00,0.00,0,0,0,0,0,0,0,0,0,0,0,0,0
20200528,049242,佳世達元富96購01,,,,,0.00,0.00,0,0,0,0,0,0,0,0,0,0,0,0,0
20200528,049243,佳世達元富96購02,,,,,0.00,0.00,0,0,0,0,0,0,0,0,0,0,0,0,0
20200528,049252,國巨元大96購01,5.85,5.85,5.85,5.85,+0.25,4.46,1000,1,5850,0,0,0,0,0,0,1000,1000,0,0
20200528,049254,台積電元大96購02,1.91,1.91,1.91,1.91,0.00,0.00,1000,1,1910,0,0,0,0,0,0,1000,0,1000,1000
20200528,049255,旺宏元大97購02,1.34,1.34,1.23,1.23,-0.13,-9.56,130000,9,170900,0,0,0,0,0,0,18000,112000,-94000,-94000
20200528,049260,華新科元大96購01,,,,,0.00,0.00,0,0,0,0,0,0,0,0,0,0,0,0,0
20200528,049269,超眾元大96購02,,,,,0.00,0.00,0,0,0,0,0,0,0,0,0,0,0,0,0
20200528,049272,世紀鋼元大96購02,1.07,1.26,1.07,1.16,+0.35,43.21,152000,13,176840,0,0,0,0,0,0,117000,15000,102000,102000
20200528,049296,義隆群益96購01,,,,,0.00,0.00,0,0,0,0,0,0,0,0,0,0,0,0,0
20200528,049306,元油2X凱基96購01,,,,,0.00,0.00,0,0,0,0,0,0,0,0,0,0,0,0,0
20200528,04932P,香港2X中信96售01,1.65,1.65,1.65,1.65,0.00,0.00,14000,1,23100,0,0,0,0,0,0,14000,0,14000,14000
20200528,049335,聯電統一97購01,1.22,1.22,1.22,1.22,-0.05,-3.94,50000,1,61000,0,0,0,0,0,0,50000,0,50000,50000
20200528,04933P,中石化中信96售01,,,,,0.00,0.00,0,0,0,0,0,0,0,0,0,0,0,0,0
20200528,049355,元油2X富邦96購04,,,,,0.00,0.00,0,0,0,0,0,0,0,0,0,0,0,0,0
20200528,04935P,鴻海中信96售01,,,,,0.00,0.00,0,0,0,0,0,0,0,0,0,0,0,0,0
20200528,049367,全新元大96購01,,,,,0.00,0.00,0,0,0,0,0,0,0,0,0,0,0,0,0
20200528,049389,元石油中信97購02,0.01,0.02,0.01,0.02,0.00,0.00,289000,5,2900,0,0,0,0,0,0,0,0,0,0
20200528,049390,元油2X中信96購01,,,,,0.00,0.00,0,0,0,0,0,0,0,0,0,0,0,0,0
20200528,049396,元油2X群益97購03,,,,,0.00,0.00,0,0,0,0,0,0,0,0,0,0,0,0,0
20200528,049406,T50反1日盛97購01,,,,,0.00,0.00,0,0,0,0,0,0,0,0,0,0,0,0,0
20200528,049409,滬深2X凱基96購04,,,,,0.00,0.00,0,0,0,0,0,0,0,0,0,0,0,0,0
20200528,049431,光罩國票96購01,,,,,0.00,0.00,0,0,0,0,0,0,0,0,0,0,0,0,0
20200528,049435,S&P反1國泰96購01,,,,,0.00,0.00,0,0,0,0,0,0,0,0,0,0,0,0,0
20200528,049436,義隆國泰96購02,,,,,0.00,0.00,0,0,0,0,0,0,0,0,0,0,0,0,0
20200528,049437,可成國泰96購01,,,,,0.00,0.00,0,0,0,0,0,0,0,0,0,0,0,0,0
20200528,049438,嘉晶國泰96購01,,,,,0.00,0.00,0,0,0,0,0,0,0,0,0,0,0,0,0
20200528,049439,牧德國泰96購01,,,,,0.00,0.00,0,0,0,0,0,0,0,0,0,0,0,0,0
20200528,049442,滬深2X統一99購01,,,,,0.00,0.00,0,0,0,0,0,0,0,0,0,0,0,0,0
20200528,049458,SP黃豆元富96購01,,,,,0.00,0.00,0,0,0,0,0,0,0,0,0,0,0,0,0
20200528,049463,華新科富邦97購01,0.33,0.33,0.30,0.30,-0.05,-14.29,20000,2,6300,0,0,0,0,0,0,0,0,0,0
20200528,049485,台積電元大96購03,1.34,1.34,1.24,1.24,-0.13,-9.49,520000,4,646800,0,0,0,0,0,0,500000,520000,-20000,-20000
20200528,049499,康控元大96購01,,,,,0.00,0.00,0,0,0,0,0,0,0,0,0,0,0,0,0
20200528,04950P,上証2X中信96售02,,,,,0.00,0.00,0,0,0,0,0,0,0,0,0,0,0,0,0
20200528,049537,元石油群益97購01,,,,,0.00,0.00,0,0,0,0,0,0,0,0,0,0,0,0,0
20200528,049538,元油2X群益98購01,0.03,0.03,0.03,0.03,0.00,0.00,80000,2,2400,0,0,0,0,0,0,0,0,0,0
20200528,049539,元油2X群益9A購01,,,,,0.00,0.00,0,0,0,0,0,0,0,0,0,0,0,0,0
20200528,04954P,健策國票96售01,,,,,0.00,0.00,0,0,0,0,0,0,0,0,0,0,0,0,0
20200528,049552,鴻海國泰96購01,,,,,0.00,0.00,0,0,0,0,0,0,0,0,0,0,0,0,0
20200528,049553,鴻海國泰96購02,0.86,0.86,0.86,0.86,+0.08,10.26,32000,1,27520,0,0,0,0,0,0,32000,32000,0,0
20200528,049554,禾伸堂富邦96購01,,,,,0.00,0.00,0,0,0,0,0,0,0,0,0,0,0,0,0
20200528,049561,道瓊銀統一96購01,0.02,0.02,0.02,0.02,0.00,0.00,10000,1,200,0,0,0,0,0,0,0,0,0,0
20200528,04957P,上証2X凱基96售02,,,,,0.00,0.00,0,0,0,0,0,0,0,0,0,0,0,0,0
20200528,049584,台積電元大96購04,,,,,0.00,0.00,0,0,0,0,0,0,0,0,0,0,0,0,0
20200528,049591,開發金元大98購01,,,,,0.00,0.00,0,0,0,0,0,0,0,0,0,0,0,0,0
20200528,049592,欣興元大96購01,,,,,0.00,0.00,0,0,0,0,0,0,0,0,0,0,0,0,0
20200528,049593,群創元大9A購01,,,,,0.00,0.00,0,0,0,0,0,0,0,0,0,0,0,0,0
20200528,049597,泰鼎元大96購01,,,,,0.00,0.00,0,0,0,0,0,0,0,0,0,0,0,0,0
20200528,04960P,大立光凱基96售04,,,,,0.00,0.00,0,0,0,0,0,0,0,0,0,0,0,0,0
20200528,049612,香港反中信96購01,,,,,0.00,0.00,0,0,0,0,0,0,0,0,0,0,0,0,0
20200528,049615,香港2X群益98購01,,,,,0.00,0.00,0,0,0,0,0,0,0,0,0,0,0,0,0
20200528,04962P,易華電凱基96售01,,,,,0.00,0.00,0,0,0,0,0,0,0,0,0,0,0,0,0
20200528,049636,上証反凱基9A購01,,,,,0.00,0.00,0,0,0,0,0,0,0,0,0,0,0,0,0
20200528,049667,大立光國泰96購01,0.01,0.01,0.01,0.01,0.00,0.00,155000,3,1550,0,0,0,0,0,0,135000,150000,-15000,-15000
20200528,049668,大立光國泰96購02,0.01,0.01,0.01,0.01,0.00,0.00,10000,1,100,0,0,0,0,0,0,10000,10000,0,0
20200528,049670,鈺齊國泰96購01,,,,,0.00,0.00,0,0,0,0,0,0,0,0,0,0,0,0,0
20200528,049695,新光金元大9A購01,,,,,0.00,0.00,0,0,0,0,0,0,0,0,0,0,0,0,0
20200528,049697,群創元大98購01,,,,,0.00,0.00,0,0,0,0,0,0,0,0,0,0,0,0,0
20200528,049700,瀚宇博元大97購01,1.38,1.39,1.33,1.38,+0.01,0.73,380000,22,520200,0,0,0,0,0,0,308000,96000,212000,212000
20200528,049726,道瓊反中信96購01,,,,,0.00,0.00,0,0,0,0,0,0,0,0,0,0,0,0,0
20200528,04974P,聯發科凱基96售02,,,,,0.00,0.00,0,0,0,0,0,0,0,0,0,0,0,0,0
20200528,049759,元黃金富邦9A購01,3.63,3.66,3.63,3.66,-0.02,-0.54,4000,2,14550,0,0,0,0,0,0,0,0,0,0
20200528,04975P,華新科凱基96售02,,,,,0.00,0.00,0,0,0,0,0,0,0,0,0,0,0,0,0
20200528,049763,美食國泰96購01,,,,,0.00,0.00,0,0,0,0,0,0,0,0,0,0,0,0,0
20200528,049769,和鑫元富96購01,,,,,0.00,0.00,0,0,0,0,0,0,0,0,0,0,0,0,0
20200528,04977P,力成凱基96售01,,,,,0.00,0.00,0,0,0,0,0,0,0,0,0,0,0,0,0
20200528,049790,滬深2X元大97購04,,,,,0.00,0.00,0,0,0,0,0,0,0,0,0,0,0,0,0
20200528,049795,華通元大96購02,0.11,0.16,0.11,0.16,+0.07,77.78,32000,4,4720,0,0,0,0,0,0,22000,0,22000,22000
20200528,049799,旺宏元大96購01,,,,,0.00,0.00,0,0,0,0,0,0,0,0,0,0,0,0,0
20200528,04979P,臺股指凱基96售07,,,,,0.00,0.00,0,0,0,0,0,0,0,0,0,0,0,0,0
20200528,049807,新光金元大96購02,,,,,0.00,0.00,0,0,0,0,0,0,0,0,0,0,0,0,0
20200528,04980P,臺股指凱基96售08,,,,,0.00,0.00,0,0,0,0,0,0,0,0,0,0,0,0,0
20200528,049813,康控元大96購02,,,,,0.00,0.00,0,0,0,0,0,0,0,0,0,0,0,0,0
20200528,049820,世紀鋼元大96購03,0.81,1.01,0.81,1.01,0.00,0.00,20000,2,18200,0,0,0,0,0,0,10000,10000,0,0
20200528,049837,臺股指凱基96購02,,,,,0.00,0.00,0,0,0,0,0,0,0,0,0,0,0,0,0
20200528,049842,道瓊反中信98購01,1.29,1.30,1.28,1.30,-0.13,-9.09,33000,6,42380,0,0,0,0,0,0,2000,31000,-29000,-29000
20200528,049871,T50反1台新9A購02,0.20,0.34,0.20,0.34,-0.04,-10.53,181000,12,49030,0,0,0,0,0,0,80000,101000,-21000,-21000
20200528,049888,智邦國泰96購01,4.45,4.50,4.45,4.50,0.00,0.00,2000,2,8950,0,0,0,0,0,0,2000,0,2000,2000
20200528,049889,欣興國泰96購01,,,,,0.00,0.00,0,0,0,0,0,0,0,0,0,0,0,0,0
20200528,049892,國巨富邦96購01,0.61,0.61,0.61,0.61,0.00,0.00,50000,1,30500,0,0,0,0,0,0,50000,0,50000,50000
20200528,049893,日月光富邦98購01,,,,,0.00,0.00,0,0,0,0,0,0,0,0,0,0,0,0,0
20200528,049894,嘉聯益富邦98購01,,,,,0.00,0.00,0,0,0,0,0,0,0,0,0,0,0,0,0
20200528,04992P,元油2X富邦97售04,,,,,0.00,0.00,0,0,0,0,0,0,0,0,0,0,0,0,0
20200528,04993P,上銀兆豐96售01,,,,,0.00,0.00,0,0,0,0,0,0,0,0,0,0,0,0,0
20200528,049947,S&P反1中信97購01,,,,,0.00,0.00,0,0,0,0,0,0,0,0,0,0,0,0,0
20200528,049949,燿華群益96購01,,,,,0.00,0.00,0,0,0,0,0,0,0,0,0,0,0,0,0
20200528,04995P,台達電凱基96售03,0.03,0.03,0.03,0.03,0.00,0.00,390000,2,11700,0,0,0,0,0,0,390000,100000,290000,290000
20200528,049973,T50反1日盛9A購01,0.43,0.43,0.43,0.43,-0.10,-18.87,1000,1,430,0,0,0,0,0,0,1000,1000,0,0
20200528,049991,臺股指凱基96購04,,,,,0.00,0.00,0,0,0,0,0,0,0,0,0,0,0,0,0
20200528,050014,國巨富邦98購01,1.63,1.63,1.63,1.63,+0.06,3.82,4000,1,6520,0,0,0,0,0,0,0,4000,-4000,-4000
20200528,050026,友達元大96購01,,,,,0.00,0.00,0,0,0,0,0,0,0,0,0,0,0,0,0
20200528,050049,華通群益96購01,0.24,0.24,0.24,0.24,0.00,0.00,1000,1,240,0,0,0,0,0,0,1000,0,1000,1000
20200528,050077,臺股指凱基99購02,,,,,0.00,0.00,0,0,0,0,0,0,0,0,0,0,0,0,0
20200528,050078,臺指反統一97購01,,,,,0.00,0.00,0,0,0,0,0,0,0,0,0,0,0,0,0
20200528,050097,可成國泰96購02,,,,,0.00,0.00,0,0,0,0,0,0,0,0,0,0,0,0,0
20200528,050099,台積電永昌96購01,1.06,1.06,1.06,1.06,+0.06,6.0,404000,1,428240,0,0,0,0,0,0,404000,404000,0,0
20200528,050100,台積電永昌96購02,,,,,0.00,0.00,0,0,0,0,0,0,0,0,0,0,0,0,0
20200528,050101,台積電永昌96購03,,,,,0.00,0.00,0,0,0,0,0,0,0,0,0,0,0,0,0
20200528,050104,元石油元大97購02,,,,,0.00,0.00,0,0,0,0,0,0,0,0,0,0,0,0,0
20200528,050115,群創元大96購01,,,,,0.00,0.00,0,0,0,0,0,0,0,0,0,0,0,0,0
20200528,050117,麗豐元大96購02,,,,,0.00,0.00,0,0,0,0,0,0,0,0,0,0,0,0,0
20200528,05011P,南電國泰96售01,,,,,0.00,0.00,0,0,0,0,0,0,0,0,0,0,0,0,0
20200528,050122,臺指反凱基96購01,,,,,0.00,0.00,0,0,0,0,0,0,0,0,0,0,0,0,0
20200528,050123,群臺反凱基96購01,0.08,0.08,0.08,0.08,0.00,0.00,1000,1,80,0,0,0,0,0,0,0,0,0,0
20200528,050137,臺指反國票96購01,,,,,0.00,0.00,0,0,0,0,0,0,0,0,0,0,0,0,0
20200528,05013P,台積電元大96售05,,,,,0.00,0.00,0,0,0,0,0,0,0,0,0,0,0,0,0
20200528,050142,聯發科元富9A購01,1.99,2.05,1.99,2.05,-0.05,-2.38,6000,2,12000,0,0,0,0,0,0,5000,0,5000,5000
20200528,050158,上海銀群益96購01,,,,,0.00,0.00,0,0,0,0,0,0,0,0,0,0,0,0,0
20200528,050161,鴻海國泰96購03,0.18,0.18,0.18,0.18,0.00,0.00,10000,1,1800,0,0,0,0,0,0,10000,0,10000,10000
20200528,050167,T50反1富邦96購01,,,,,0.00,0.00,0,0,0,0,0,0,0,0,0,0,0,0,0
20200528,050169,臺指反元大97購01,,,,,0.00,0.00,0,0,0,0,0,0,0,0,0,0,0,0,0
20200528,050170,臺指反元大97購02,0.57,0.64,0.56,0.62,+0.03,5.08,538000,24,316110,0,0,0,0,0,0,158000,370000,-212000,-212000
20200528,050171,臺指反元大97購03,0.94,0.95,0.94,0.95,-0.03,-3.06,300000,4,282500,0,0,0,0,0,0,300000,0,300000,300000
20200528,050172,臺指反元大98購02,,,,,0.00,0.00,0,0,0,0,0,0,0,0,0,0,0,0,0
20200528,050173,旺宏元大96購02,,,,,0.00,0.00,0,0,0,0,0,0,0,0,0,0,0,0,0
20200528,050179,全新元大96購02,,,,,0.00,0.00,0,0,0,0,0,0,0,0,0,0,0,0,0
20200528,050183,奇鋐元大96購01,,,,,0.00,0.00,0,0,0,0,0,0,0,0,0,0,0,0,0
20200528,050188,貿聯元大96購01,0.17,0.17,0.17,0.17,0.00,0.00,31000,2,5270,0,0,0,0,0,0,31000,0,31000,31000
20200528,050192,康控元大97購01,,,,,0.00,0.00,0,0,0,0,0,0,0,0,0,0,0,0,0
20200528,050196,嘉聯益元大97購01,,,,,0.00,0.00,0,0,0,0,0,0,0,0,0,0,0,0,0
20200528,050215,TPK台新96購01,,,,,0.00,0.00,0,0,0,0,0,0,0,0,0,0,0,0,0
20200528,050220,台積電元富96購01,,,,,0.00,0.00,0,0,0,0,0,0,0,0,0,0,0,0,0
20200528,050227,大立光中信96購01,0.03,0.03,0.03,0.03,-0.01,-25.0,20000,2,600,0,0,0,0,0,0,0,20000,-20000,-20000
20200528,050228,中磊中信96購01,,,,,0.00,0.00,0,0,0,0,0,0,0,0,0,0,0,0,0
20200528,050233,香港2X凱基96購01,,,,,0.00,0.00,0,0,0,0,0,0,0,0,0,0,0,0,0
20200528,05024P,華通國票96售01,,,,,0.00,0.00,0,0,0,0,0,0,0,0,0,0,0,0,0
20200528,050253,百和國泰96購01,0.06,0.06,0.06,0.06,0.00,0.00,10000,1,600,0,0,0,0,0,0,10000,10000,0,0
20200528,050254,大立光富邦96購02,,,,,0.00,0.00,0,0,0,0,0,0,0,0,0,0,0,0,0
20200528,050256,臺指反元大98購03,,,,,0.00,0.00,0,0,0,0,0,0,0,0,0,0,0,0,0
20200528,050271,上緯控元大96購01,,,,,0.00,0.00,0,0,0,0,0,0,0,0,0,0,0,0,0
20200528,050282,T50反1凱基97購01,1.10,1.17,1.10,1.17,+0.03,2.63,61000,3,69800,0,0,0,0,0,0,30000,31000,-1000,-1000
20200528,050283,T50反1凱基9A購01,,,,,0.00,0.00,0,0,0,0,0,0,0,0,0,0,0,0,0
20200528,050303,S&P反1中信96購01,,,,,0.00,0.00,0,0,0,0,0,0,0,0,0,0,0,0,0
20200528,050306,聯發科中信97購01,,,,,0.00,0.00,0,0,0,0,0,0,0,0,0,0,0,0,0
20200528,050308,矽創中信97購01,,,,,0.00,0.00,0,0,0,0,0,0,0,0,0,0,0,0,0
20200528,050316,上証2X國票98購01,,,,,0.00,0.00,0,0,0,0,0,0,0,0,0,0,0,0,0
20200528,05032P,台積電國泰96售05,,,,,0.00,0.00,0,0,0,0,0,0,0,0,0,0,0,0,0
20200528,050332,鴻海國泰96購05,,,,,0.00,0.00,0,0,0,0,0,0,0,0,0,0,0,0,0
20200528,050333,鴻海國泰96購06,,,,,0.00,0.00,0,0,0,0,0,0,0,0,0,0,0,0,0
20200528,050334,鴻海國泰96購07,0.03,0.09,0.03,0.09,0.00,0.00,45000,3,3350,0,0,0,0,0,0,45000,35000,10000,10000
20200528,050335,正崴國泰96購01,,,,,0.00,0.00,0,0,0,0,0,0,0,0,0,0,0,0,0
20200528,050338,TPK富邦96購01,,,,,0.00,0.00,0,0,0,0,0,0,0,0,0,0,0,0,0
20200528,05033P,T50反1元大98售01,1.00,1.00,1.00,1.00,+0.02,2.04,1000,1,1000,0,0,0,0,0,0,1000,0,1000,1000
20200528,050344,鴻海元富96購01,0.14,0.14,0.14,0.14,+0.08,133.33,10000,1,1400,0,0,0,0,0,0,10000,10000,0,0
20200528,050347,上証2X群益98購01,,,,,0.00,0.00,0,0,0,0,0,0,0,0,0,0,0,0,0
20200528,050363,臺指反元大98購04,,,,,0.00,0.00,0,0,0,0,0,0,0,0,0,0,0,0,0
20200528,050372,全新元大96購03,,,,,0.00,0.00,0,0,0,0,0,0,0,0,0,0,0,0,0
20200528,050378,上証2X群益98購02,,,,,0.00,0.00,0,0,0,0,0,0,0,0,0,0,0,0,0
20200528,050379,易華電群益96購01,,,,,0.00,0.00,0,0,0,0,0,0,0,0,0,0,0,0,0
20200528,050392,群創統一96購01,,,,,0.00,0.00,0,0,0,0,0,0,0,0,0,0,0,0,0
20200528,050398,上証2X中信97購01,,,,,0.00,0.00,0,0,0,0,0,0,0,0,0,0,0,0,0
20200528,050400,臻鼎中信97購01,0.01,0.01,0.01,0.01,0.00,0.00,13000,3,130,0,0,0,0,0,0,0,0,0,0
20200528,050402,緯穎中信96購01,2.92,2.93,2.63,2.63,-0.17,-6.07,36000,9,102320,0,0,0,0,0,0,16000,20000,-4000,-4000
20200528,050416,高股息凱基96購02,0.03,0.03,0.03,0.03,0.00,0.00,20000,1,600,0,0,0,0,0,0,20000,0,20000,20000
20200528,050422,鴻海凱基96購01,,,,,0.00,0.00,0,0,0,0,0,0,0,0,0,0,0,0,0
20200528,050423,鴻海凱基96購02,,,,,0.00,0.00,0,0,0,0,0,0,0,0,0,0,0,0,0
20200528,050424,鴻海凱基96購03,,,,,0.00,0.00,0,0,0,0,0,0,0,0,0,0,0,0,0
20200528,050481,泰鼎國票96購01,,,,,0.00,0.00,0,0,0,0,0,0,0,0,0,0,0,0,0
20200528,050485,國巨統一96購01,1.58,1.70,1.31,1.31,-0.12,-8.39,310000,44,470100,0,0,0,0,0,0,310000,300000,10000,10000
20200528,050491,旺宏國泰96購01,,,,,0.00,0.00,0,0,0,0,0,0,0,0,0,0,0,0,0
20200528,050492,漢唐國泰96購01,,,,,0.00,0.00,0,0,0,0,0,0,0,0,0,0,0,0,0
20200528,050493,聯發科永昌96購01,,,,,0.00,0.00,0,0,0,0,0,0,0,0,0,0,0,0,0
20200528,050494,可成永昌96購01,,,,,0.00,0.00,0,0,0,0,0,0,0,0,0,0,0,0,0
20200528,050495,大立光永昌96購01,,,,,0.00,0.00,0,0,0,0,0,0,0,0,0,0,0,0,0
20200528,050496,鴻海富邦96購01,0.04,0.06,0.04,0.06,+0.04,200.0,1047000,12,58020,0,0,0,0,0,0,997000,0,997000,997000
20200528,050497,臺指反凱基96購02,,,,,0.00,0.00,0,0,0,0,0,0,0,0,0,0,0,0,0
20200528,050508,上証2X元大97購01,,,,,0.00,0.00,0,0,0,0,0,0,0,0,0,0,0,0,0
20200528,05050P,華通群益96售02,,,,,0.00,0.00,0,0,0,0,0,0,0,0,0,0,0,0,0
20200528,050515,聯電元大96購01,0.47,0.47,0.47,0.47,+0.01,2.17,190000,2,89300,0,0,0,0,0,0,100000,90000,10000,10000
20200528,050527,嘉聯益元大96購01,,,,,0.00,0.00,0,0,0,0,0,0,0,0,0,0,0,0,0
20200528,05052P,友達群益97售01,0.34,0.38,0.34,0.37,+0.01,2.78,388000,9,137840,0,0,0,0,0,0,202000,186000,16000,16000
20200528,050561,上証2X元富97購01,,,,,0.00,0.00,0,0,0,0,0,0,0,0,0,0,0,0,0
20200528,050566,高股息中信97購02,,,,,0.00,0.00,0,0,0,0,0,0,0,0,0,0,0,0,0
20200528,050567,道瓊銀中信96購01,,,,,0.00,0.00,0,0,0,0,0,0,0,0,0,0,0,0,0
20200528,050568,為升中信97購01,,,,,0.00,0.00,0,0,0,0,0,0,0,0,0,0,0,0,0
20200528,050570,聯發科中信97購02,,,,,0.00,0.00,0,0,0,0,0,0,0,0,0,0,0,0,0
20200528,050572,大立光中信97購01,,,,,0.00,0.00,0,0,0,0,0,0,0,0,0,0,0,0,0
20200528,05057P,鴻海國票96售01,,,,,0.00,0.00,0,0,0,0,0,0,0,0,0,0,0,0,0
20200528,05058P,燿華國票97售01,,,,,0.00,0.00,0,0,0,0,0,0,0,0,0,0,0,0,0
20200528,05059P,大立光國票96售02,,,,,0.00,0.00,0,0,0,0,0,0,0,0,0,0,0,0,0
20200528,050601,台表科國泰96購01,1.59,1.61,1.59,1.61,-0.61,-27.48,10000,2,16000,0,0,0,0,0,0,10000,0,10000,10000
20200528,050602,訊芯國泰96購01,,,,,0.00,0.00,0,0,0,0,0,0,0,0,0,0,0,0,0
20200528,050603,致新國泰96購01,,,,,0.00,0.00,0,0,0,0,0,0,0,0,0,0,0,0,0
20200528,050605,上証2X元大97購02,,,,,0.00,0.00,0,0,0,0,0,0,0,0,0,0,0,0,0
20200528,05060P,台達電富邦97售02,,,,,0.00,0.00,0,0,0,0,0,0,0,0,0,0,0,0,0
20200528,05061P,鴻海富邦96售03,,,,,0.00,0.00,0,0,0,0,0,0,0,0,0,0,0,0,0
20200528,050626,A50正2中信96購02,,,,,0.00,0.00,0,0,0,0,0,0,0,0,0,0,0,0,0
20200528,050629,廣宇亞東96購01,,,,,0.00,0.00,0,0,0,0,0,0,0,0,0,0,0,0,0
20200528,05062P,大立光富邦98售03,,,,,0.00,0.00,0,0,0,0,0,0,0,0,0,0,0,0,0
20200528,050630,大立光亞東96購01,0.01,0.01,0.01,0.01,0.00,0.00,10000,2,100,0,0,0,0,0,0,10000,4000,6000,6000
20200528,050633,義隆群益96購02,,,,,0.00,0.00,0,0,0,0,0,0,0,0,0,0,0,0,0
20200528,050634,華新科群益96購01,,,,,0.00,0.00,0,0,0,0,0,0,0,0,0,0,0,0,0
20200528,050639,GIS國票96購01,,,,,0.00,0.00,0,0,0,0,0,0,0,0,0,0,0,0,0
20200528,05063P,聯電元大96售03,,,,,0.00,0.00,0,0,0,0,0,0,0,0,0,0,0,0,0
20200528,050641,上証反凱基96購01,,,,,0.00,0.00,0,0,0,0,0,0,0,0,0,0,0,0,0
20200528,050644,國巨凱基96購01,,,,,0.00,0.00,0,0,0,0,0,0,0,0,0,0,0,0,0
20200528,050646,美律凱基96購01,,,,,0.00,0.00,0,0,0,0,0,0,0,0,0,0,0,0,0
20200528,050647,聯發科凱基96購01,,,,,0.00,0.00,0,0,0,0,0,0,0,0,0,0,0,0,0
20200528,050648,全新凱基96購01,,,,,0.00,0.00,0,0,0,0,0,0,0,0,0,0,0,0,0
20200528,050649,華新科凱基96購01,,,,,0.00,0.00,0,0,0,0,0,0,0,0,0,0,0,0,0
20200528,050650,大立光凱基96購01,,,,,0.00,0.00,0,0,0,0,0,0,0,0,0,0,0,0,0
20200528,050651,大立光凱基96購02,,,,,0.00,0.00,0,0,0,0,0,0,0,0,0,0,0,0,0
20200528,050652,大立光凱基96購03,,,,,0.00,0.00,0,0,0,0,0,0,0,0,0,0,0,0,0
20200528,050653,聯鈞凱基96購01,,,,,0.00,0.00,0,0,0,0,0,0,0,0,0,0,0,0,0
20200528,050654,鎧勝凱基96購01,,,,,0.00,0.00,0,0,0,0,0,0,0,0,0,0,0,0,0
20200528,050655,中磊凱基96購01,,,,,0.00,0.00,0,0,0,0,0,0,0,0,0,0,0,0,0
20200528,050656,瑞儀凱基96購01,,,,,0.00,0.00,0,0,0,0,0,0,0,0,0,0,0,0,0
20200528,050658,台郡麥證96購01,,,,,0.00,0.00,0,0,0,0,0,0,0,0,0,0,0,0,0
20200528,050659,宏達電元大96購01,,,,,0.00,0.00,0,0,0,0,0,0,0,0,0,0,0,0,0
20200528,05065P,燿華元大96售03,,,,,0.00,0.00,0,0,0,0,0,0,0,0,0,0,0,0,0
20200528,050660,欣興元大96購02,,,,,0.00,0.00,0,0,0,0,0,0,0,0,0,0,0,0,0
20200528,050662,智易元大96購01,,,,,0.00,0.00,0,0,0,0,0,0,0,0,0,0,0,0,0
20200528,050663,麗豐元大96購03,,,,,0.00,0.00,0,0,0,0,0,0,0,0,0,0,0,0,0
20200528,050669,嘉晶永豐96購01,,,,,0.00,0.00,0,0,0,0,0,0,0,0,0,0,0,0,0
20200528,050672,上証2X富邦97購01,,,,,0.00,0.00,0,0,0,0,0,0,0,0,0,0,0,0,0
20200528,050673,旺宏富邦96購02,0.53,0.53,0.53,0.53,0.00,0.00,2000,1,1060,0,0,0,0,0,0,0,2000,-2000,-2000
20200528,050675,奇鋐富邦96購01,,,,,0.00,0.00,0,0,0,0,0,0,0,0,0,0,0,0,0
20200528,050676,道瓊銀統一96購02,,,,,0.00,0.00,0,0,0,0,0,0,0,0,0,0,0,0,0
20200528,050679,上証2X元富97購02,,,,,0.00,0.00,0,0,0,0,0,0,0,0,0,0,0,0,0
20200528,05067P,欣興兆豐96售02,,,,,0.00,0.00,0,0,0,0,0,0,0,0,0,0,0,0,0
20200528,050686,欣興兆豐96購01,0.02,0.02,0.02,0.02,0.00,0.00,30000,1,600,0,0,0,0,0,0,30000,30000,0,0
20200528,050690,台達電凱基96購01,,,,,0.00,0.00,0,0,0,0,0,0,0,0,0,0,0,0,0
20200528,050691,楠梓電凱基96購01,,,,,0.00,0.00,0,0,0,0,0,0,0,0,0,0,0,0,0
20200528,050692,鴻海凱基96購04,,,,,0.00,0.00,0,0,0,0,0,0,0,0,0,0,0,0,0
20200528,050693,鴻海凱基96購05,,,,,0.00,0.00,0,0,0,0,0,0,0,0,0,0,0,0,0
20200528,050694,國巨凱基96購03,,,,,0.00,0.00,0,0,0,0,0,0,0,0,0,0,0,0,0
20200528,050696,台光電凱基96購01,,,,,0.00,0.00,0,0,0,0,0,0,0,0,0,0,0,0,0
20200528,050697,冠德凱基96購01,,,,,0.00,0.00,0,0,0,0,0,0,0,0,0,0,0,0,0
20200528,050698,明泰凱基96購01,,,,,0.00,0.00,0,0,0,0,0,0,0,0,0,0,0,0,0
20200528,050699,京鼎凱基96購01,,,,,0.00,0.00,0,0,0,0,0,0,0,0,0,0,0,0,0
20200528,05069P,鴻海統一96售03,,,,,0.00,0.00,0,0,0,0,0,0,0,0,0,0,0,0,0
20200528,050700,健策凱基96購01,,,,,0.00,0.00,0,0,0,0,0,0,0,0,0,0,0,0,0
20200528,050705,南電凱基96購01,,,,,0.00,0.00,0,0,0,0,0,0,0,0,0,0,0,0,0
20200528,050708,臺股指凱基96購06,,,,,0.00,0.00,0,0,0,0,0,0,0,0,0,0,0,0,0
20200528,050709,嘉聯益第一96購01,,,,,0.00,0.00,0,0,0,0,0,0,0,0,0,0,0,0,0
20200528,05070P,鴻海統一96售04,,,,,0.00,0.00,0,0,0,0,0,0,0,0,0,0,0,0,0
20200528,050710,元黃金中信96購01,,,,,0.00,0.00,0,0,0,0,0,0,0,0,0,0,0,0,0
20200528,050714,深中小群益98購01,,,,,0.00,0.00,0,0,0,0,0,0,0,0,0,0,0,0,0
20200528,050715,台積電群益96購01,,,,,0.00,0.00,0,0,0,0,0,0,0,0,0,0,0,0,0
20200528,050716,可成群益96購01,,,,,0.00,0.00,0,0,0,0,0,0,0,0,0,0,0,0,0
20200528,050717,京鼎群益96購01,,,,,0.00,0.00,0,0,0,0,0,0,0,0,0,0,0,0,0
20200528,050719,世紀鋼群益96購01,,,,,0.00,0.00,0,0,0,0,0,0,0,0,0,0,0,0,0
20200528,05071P,鴻海統一96售05,,,,,0.00,0.00,0,0,0,0,0,0,0,0,0,0,0,0,0
20200528,050722,聯電國票96購01,,,,,0.00,0.00,0,0,0,0,0,0,0,0,0,0,0,0,0
20200528,050724,國巨國票96購01,,,,,0.00,0.00,0,0,0,0,0,0,0,0,0,0,0,0,0
20200528,050725,光磊國票96購01,,,,,0.00,0.00,0,0,0,0,0,0,0,0,0,0,0,0,0
20200528,050726,可成國票96購01,,,,,0.00,0.00,0,0,0,0,0,0,0,0,0,0,0,0,0
20200528,050731,昇陽半國票96購01,,,,,0.00,0.00,0,0,0,0,0,0,0,0,0,0,0,0,0
20200528,050749,道瓊銀統一96購03,,,,,0.00,0.00,0,0,0,0,0,0,0,0,0,0,0,0,0
20200528,050754,元金2X元富9B購01,1.10,1.33,1.10,1.33,+0.13,10.83,13000,5,15230,0,0,0,0,0,0,0,0,0,0
20200528,050758,聯發科元富9B購01,1.27,1.28,1.13,1.13,-0.07,-5.83,24000,3,29270,0,0,0,0,0,0,24000,0,24000,24000
20200528,050765,鴻海元大96購02,,,,,0.00,0.00,0,0,0,0,0,0,0,0,0,0,0,0,0
20200528,050766,燿華元大96購02,,,,,0.00,0.00,0,0,0,0,0,0,0,0,0,0,0,0,0
20200528,050767,京元電元大96購01,,,,,0.00,0.00,0,0,0,0,0,0,0,0,0,0,0,0,0
20200528,05076P,深中小群益99售02,0.26,0.29,0.26,0.29,0.00,0.00,30000,2,7950,0,0,0,0,0,0,30000,0,30000,30000
20200528,050774,健策元大96購02,,,,,0.00,0.00,0,0,0,0,0,0,0,0,0,0,0,0,0
20200528,050775,TPK元大96購01,,,,,0.00,0.00,0,0,0,0,0,0,0,0,0,0,0,0,0
20200528,050776,康控元大96購03,,,,,0.00,0.00,0,0,0,0,0,0,0,0,0,0,0,0,0
20200528,050778,瑞儀元大96購01,,,,,0.00,0.00,0,0,0,0,0,0,0,0,0,0,0,0,0
20200528,050779,超眾元大96購03,,,,,0.00,0.00,0,0,0,0,0,0,0,0,0,0,0,0,0
20200528,050780,台表科元大96購01,,,,,0.00,0.00,0,0,0,0,0,0,0,0,0,0,0,0,0
20200528,050782,台積電國泰96購03,0.11,0.11,0.11,0.11,-0.21,-65.62,5000,1,550,0,0,0,0,0,0,5000,0,5000,5000
20200528,050783,旺宏國泰96購02,,,,,0.00,0.00,0,0,0,0,0,0,0,0,0,0,0,0,0
20200528,050784,美律國泰96購01,,,,,0.00,0.00,0,0,0,0,0,0,0,0,0,0,0,0,0
20200528,050785,全新國泰96購01,,,,,0.00,0.00,0,0,0,0,0,0,0,0,0,0,0,0,0
20200528,050786,健策國泰96購01,,,,,0.00,0.00,0,0,0,0,0,0,0,0,0,0,0,0,0
20200528,050787,致伸國泰96購01,,,,,0.00,0.00,0,0,0,0,0,0,0,0,0,0,0,0,0
20200528,050788,台郡國泰96購01,,,,,0.00,0.00,0,0,0,0,0,0,0,0,0,0,0,0,0
20200528,050789,矽創國泰96購01,,,,,0.00,0.00,0,0,0,0,0,0,0,0,0,0,0,0,0
20200528,050790,昇陽半國泰96購02,,,,,0.00,0.00,0,0,0,0,0,0,0,0,0,0,0,0,0
20200528,050791,聯發科富邦96購01,,,,,0.00,0.00,0,0,0,0,0,0,0,0,0,0,0,0,0
20200528,050792,可成富邦96購01,,,,,0.00,0.00,0,0,0,0,0,0,0,0,0,0,0,0,0
20200528,050793,大立光富邦96購03,0.01,0.01,0.01,0.01,0.00,0.00,20000,1,200,0,0,0,0,0,0,20000,0,20000,20000
20200528,050794,大立光富邦96購04,,,,,0.00,0.00,0,0,0,0,0,0,0,0,0,0,0,0,0
20200528,050797,聯發科中信99購01,,,,,0.00,0.00,0,0,0,0,0,0,0,0,0,0,0,0,0
20200528,050798,TPK中信96購01,,,,,0.00,0.00,0,0,0,0,0,0,0,0,0,0,0,0,0
20200528,050799,嘉聯益中信98購01,,,,,0.00,0.00,0,0,0,0,0,0,0,0,0,0,0,0,0
20200528,050801,元金2X群益98購01,2.95,2.95,2.95,2.95,0.00,0.00,2000,1,5900,0,0,0,0,0,0,2000,0,2000,2000
20200528,050803,康控兆豐96購01,,,,,0.00,0.00,0,0,0,0,0,0,0,0,0,0,0,0,0
20200528,050808,台達電凱基96購02,,,,,0.00,0.00,0,0,0,0,0,0,0,0,0,0,0,0,0
20200528,050813,旺宏凱基96購01,0.33,0.33,0.18,0.18,-0.12,-40.0,332000,5,81120,0,0,0,0,0,0,332000,0,332000,332000
20200528,050829,臻鼎凱基96購01,,,,,0.00,0.00,0,0,0,0,0,0,0,0,0,0,0,0,0
20200528,050835,GIS凱基96購01,,,,,0.00,0.00,0,0,0,0,0,0,0,0,0,0,0,0,0
20200528,050838,為升國票96購01,,,,,0.00,0.00,0,0,0,0,0,0,0,0,0,0,0,0,0
20200528,050839,楠梓電國票96購01,,,,,0.00,0.00,0,0,0,0,0,0,0,0,0,0,0,0,0
20200528,050840,中環國票96購01,,,,,0.00,0.00,0,0,0,0,0,0,0,0,0,0,0,0,0
20200528,050841,國巨國票96購02,,,,,0.00,0.00,0,0,0,0,0,0,0,0,0,0,0,0,0
20200528,050842,旺宏國票97購01,1.97,2.03,1.62,1.62,-0.43,-20.98,733000,18,1397010,0,0,0,0,0,0,568000,115000,453000,453000
20200528,050843,富邦金國票96購01,,,,,0.00,0.00,0,0,0,0,0,0,0,0,0,0,0,0,0
20200528,050844,大立光國票96購01,,,,,0.00,0.00,0,0,0,0,0,0,0,0,0,0,0,0,0
20200528,050846,緯創國票96購01,0.32,0.32,0.32,0.32,-0.01,-3.03,500000,3,160000,0,0,0,0,0,0,0,500000,-500000,-500000
20200528,050847,創意國票96購01,,,,,0.00,0.00,0,0,0,0,0,0,0,0,0,0,0,0,0
20200528,050850,訊連國票96購01,,,,,0.00,0.00,0,0,0,0,0,0,0,0,0,0,0,0,0
20200528,050851,羅麗芬國票96購01,,,,,0.00,0.00,0,0,0,0,0,0,0,0,0,0,0,0,0
20200528,050853,南電國票96購01,,,,,0.00,0.00,0,0,0,0,0,0,0,0,0,0,0,0,0
20200528,050854,世紀鋼國票97購01,0.94,1.38,0.91,1.36,+0.52,61.9,85000,11,104150,0,0,0,0,0,0,30000,55000,-25000,-25000
20200528,05087P,GIS國泰96售01,,,,,0.00,0.00,0,0,0,0,0,0,0,0,0,0,0,0,0
20200528,050882,華泰國泰96購01,,,,,0.00,0.00,0,0,0,0,0,0,0,0,0,0,0,0,0
20200528,050883,嘉聯益國泰96購01,,,,,0.00,0.00,0,0,0,0,0,0,0,0,0,0,0,0,0
20200528,050884,聯茂國泰96購01,,,,,0.00,0.00,0,0,0,0,0,0,0,0,0,0,0,0,0
20200528,05088P,大立光富邦99售01,1.13,1.13,0.98,1.00,+0.06,6.38,16000,6,16170,0,0,0,0,0,0,0,6000,-6000,-6000
20200528,050890,南電富邦99購01,0.45,0.45,0.45,0.45,-0.03,-6.25,1000,1,450,0,0,0,0,0,0,0,1000,-1000,-1000
20200528,050892,聯電元大96購02,,,,,0.00,0.00,0,0,0,0,0,0,0,0,0,0,0,0,0
20200528,050893,鴻海元大96購03,,,,,0.00,0.00,0,0,0,0,0,0,0,0,0,0,0,0,0
20200528,050894,旺宏元大96購03,0.55,0.55,0.54,0.54,-0.12,-18.18,55000,2,29760,0,0,0,0,0,0,55000,0,55000,55000
20200528,050895,聯發科元大97購01,,,,,0.00,0.00,0,0,0,0,0,0,0,0,0,0,0,0,0
20200528,050896,華新科元大96購02,,,,,0.00,0.00,0,0,0,0,0,0,0,0,0,0,0,0,0
20200528,050898,智原元大96購01,,,,,0.00,0.00,0,0,0,0,0,0,0,0,0,0,0,0,0
20200528,050902,南電元大96購01,,,,,0.00,0.00,0,0,0,0,0,0,0,0,0,0,0,0,0
20200528,050911,光磊中信98購01,,,,,0.00,0.00,0,0,0,0,0,0,0,0,0,0,0,0,0
20200528,050913,全新中信97購01,,,,,0.00,0.00,0,0,0,0,0,0,0,0,0,0,0,0,0
20200528,050915,健策中信98購01,1.50,1.50,1.16,1.16,-0.12,-9.38,644000,48,900540,0,0,0,0,0,0,570000,74000,496000,496000
20200528,050917,瀚宇博兆豐96購01,,,,,0.00,0.00,0,0,0,0,0,0,0,0,0,0,0,0,0
20200528,050932,台塑國票96購01,,,,,0.00,0.00,0,0,0,0,0,0,0,0,0,0,0,0,0
20200528,050934,喬山國票96購01,,,,,0.00,0.00,0,0,0,0,0,0,0,0,0,0,0,0,0
20200528,050935,劍麟國票96購01,,,,,0.00,0.00,0,0,0,0,0,0,0,0,0,0,0,0,0
20200528,050937,可成國票96購02,,,,,0.00,0.00,0,0,0,0,0,0,0,0,0,0,0,0,0
20200528,050938,智原國票96購01,,,,,0.00,0.00,0,0,0,0,0,0,0,0,0,0,0,0,0
20200528,050939,健鼎國票96購01,,,,,0.00,0.00,0,0,0,0,0,0,0,0,0,0,0,0,0
20200528,050943,楠梓電群益96購01,,,,,0.00,0.00,0,0,0,0,0,0,0,0,0,0,0,0,0
20200528,050949,亞光群益96購01,,,,,0.00,0.00,0,0,0,0,0,0,0,0,0,0,0,0,0
20200528,050950,健鼎群益96購01,,,,,0.00,0.00,0,0,0,0,0,0,0,0,0,0,0,0,0
20200528,050951,緯創群益96購01,,,,,0.00,0.00,0,0,0,0,0,0,0,0,0,0,0,0,0
20200528,050952,健策群益96購01,,,,,0.00,0.00,0,0,0,0,0,0,0,0,0,0,0,0,0
20200528,050955,達方群益97購01,,,,,0.00,0.00,0,0,0,0,0,0,0,0,0,0,0,0,0
20200528,050957,T50反1台新05購01,,,,,0.00,0.00,0,0,0,0,0,0,0,0,0,0,0,0,0
20200528,050965,揚明光永豐96購01,,,,,0.00,0.00,0,0,0,0,0,0,0,0,0,0,0,0,0
20200528,050979,鴻海元富96購02,,,,,0.00,0.00,0,0,0,0,0,0,0,0,0,0,0,0,0
20200528,050982,台積電國泰96購04,0.60,0.60,0.33,0.33,0.00,0.00,67000,2,22650,0,0,0,0,0,0,67000,65000,2000,2000
20200528,050983,新光金國泰97購01,,,,,0.00,0.00,0,0,0,0,0,0,0,0,0,0,0,0,0
20200528,050984,大立光國泰97購01,,,,,0.00,0.00,0,0,0,0,0,0,0,0,0,0,0,0,0
20200528,050985,易華電國泰96購02,,,,,0.00,0.00,0,0,0,0,0,0,0,0,0,0,0,0,0
20200528,050986,上証2X永昌97購01,,,,,0.00,0.00,0,0,0,0,0,0,0,0,0,0,0,0,0
20200528,050991,元油2X元大96購04,,,,,0.00,0.00,0,0,0,0,0,0,0,0,0,0,0,0,0
20200528,050992,台積電元大97購01,0.61,0.61,0.61,0.61,+0.12,24.49,1000,1,610,0,0,0,0,0,0,0,1000,-1000,-1000
20200528,050994,欣興元大96購03,,,,,0.00,0.00,0,0,0,0,0,0,0,0,0,0,0,0,0
20200528,051000,台郡元大96購01,,,,,0.00,0.00,0,0,0,0,0,0,0,0,0,0,0,0,0
20200528,051001,緯穎元大96購02,,,,,0.00,0.00,0,0,0,0,0,0,0,0,0,0,0,0,0
20200528,051002,華邦電亞東96購01,,,,,0.00,0.00,0,0,0,0,0,0,0,0,0,0,0,0,0
20200528,051003,中環中信97購01,0.01,0.01,0.01,0.01,0.00,0.00,1000,1,10,0,0,0,0,0,0,1000,0,1000,1000
20200528,051020,健策凱基96購02,,,,,0.00,0.00,0,0,0,0,0,0,0,0,0,0,0,0,0
20200528,051026,健策統一96購01,,,,,0.00,0.00,0,0,0,0,0,0,0,0,0,0,0,0,0
20200528,05102P,臺股指凱基96售09,,,,,0.00,0.00,0,0,0,0,0,0,0,0,0,0,0,0,0
20200528,05103P,臺股指凱基96售10,,,,,0.00,0.00,0,0,0,0,0,0,0,0,0,0,0,0,0
20200528,051047,深中小群益99購01,1.21,1.27,1.11,1.11,-0.17,-13.28,223000,8,267280,0,0,0,0,0,0,148000,75000,73000,73000
20200528,051048,臺指反群益96購01,1.10,1.10,1.10,1.10,0.00,0.00,1000,1,1100,0,0,0,0,0,0,0,0,0,0
20200528,051055,友達群益98購01,0.64,0.64,0.64,0.64,+0.01,1.59,40000,3,25600,0,0,0,0,0,0,25000,0,25000,25000
20200528,051058,景碩群益96購01,,,,,0.00,0.00,0,0,0,0,0,0,0,0,0,0,0,0,0
20200528,051065,台積電國票96購01,,,,,0.00,0.00,0,0,0,0,0,0,0,0,0,0,0,0,0
20200528,051066,台積電國票96購02,,,,,0.00,0.00,0,0,0,0,0,0,0,0,0,0,0,0,0
20200528,051067,台積電國票96購03,0.38,0.38,0.38,0.38,0.00,0.00,351000,2,133380,0,0,0,0,0,0,351000,350000,1000,1000
20200528,051068,台積電國票97購01,,,,,0.00,0.00,0,0,0,0,0,0,0,0,0,0,0,0,0
20200528,051069,智邦國票96購01,,,,,0.00,0.00,0,0,0,0,0,0,0,0,0,0,0,0,0
20200528,051070,正崴國票96購01,,,,,0.00,0.00,0,0,0,0,0,0,0,0,0,0,0,0,0
20200528,051071,聯發科國票96購01,,,,,0.00,0.00,0,0,0,0,0,0,0,0,0,0,0,0,0
20200528,051073,同欣電國票96購01,,,,,0.00,0.00,0,0,0,0,0,0,0,0,0,0,0,0,0
20200528,051074,矽力國票96購01,,,,,0.00,0.00,0,0,0,0,0,0,0,0,0,0,0,0,0
20200528,051075,智邦國泰97購01,,,,,0.00,0.00,0,0,0,0,0,0,0,0,0,0,0,0,0
20200528,051076,緯創國泰96購01,,,,,0.00,0.00,0,0,0,0,0,0,0,0,0,0,0,0,0
20200528,051077,台郡國泰96購02,,,,,0.00,0.00,0,0,0,0,0,0,0,0,0,0,0,0,0
20200528,051078,力山富邦97購01,0.37,0.39,0.32,0.33,-0.01,-2.94,55000,17,19640,0,0,0,0,0,0,33000,22000,11000,11000
20200528,051079,鴻海富邦96購02,,,,,0.00,0.00,0,0,0,0,0,0,0,0,0,0,0,0,0
20200528,05107P,鴻海兆豐96售02,,,,,0.00,0.00,0,0,0,0,0,0,0,0,0,0,0,0,0
20200528,051080,全新富邦96購01,,,,,0.00,0.00,0,0,0,0,0,0,0,0,0,0,0,0,0
20200528,051081,聯茂富邦96購01,,,,,0.00,0.00,0,0,0,0,0,0,0,0,0,0,0,0,0
20200528,051082,上証2X元大98購01,,,,,0.00,0.00,0,0,0,0,0,0,0,0,0,0,0,0,0
20200528,051083,A50正2元大98購01,,,,,0.00,0.00,0,0,0,0,0,0,0,0,0,0,0,0,0
20200528,051086,鴻海元大96購04,,,,,0.00,0.00,0,0,0,0,0,0,0,0,0,0,0,0,0
20200528,051087,國巨元大97購01,,,,,0.00,0.00,0,0,0,0,0,0,0,0,0,0,0,0,0
20200528,051089,旺宏元大96購04,,,,,0.00,0.00,0,0,0,0,0,0,0,0,0,0,0,0,0
20200528,051090,光磊元大96購01,,,,,0.00,0.00,0,0,0,0,0,0,0,0,0,0,0,0,0
20200528,051094,健策元大96購03,,,,,0.00,0.00,0,0,0,0,0,0,0,0,0,0,0,0,0
20200528,051097,嘉聯益元大96購02,,,,,0.00,0.00,0,0,0,0,0,0,0,0,0,0,0,0,0
20200528,051101,台表科元大96購02,,,,,0.00,0.00,0,0,0,0,0,0,0,0,0,0,0,0,0
20200528,051102,訊芯元大96購01,,,,,0.00,0.00,0,0,0,0,0,0,0,0,0,0,0,0,0
20200528,051103,緯穎元大96購03,,,,,0.00,0.00,0,0,0,0,0,0,0,0,0,0,0,0,0
20200528,051104,鈺齊元大96購01,,,,,0.00,0.00,0,0,0,0,0,0,0,0,0,0,0,0,0
20200528,051105,台光電國票96購01,0.08,0.08,0.08,0.08,0.00,0.00,798000,2,63840,0,0,0,0,0,0,798000,0,798000,798000
20200528,051108,鴻海統一96購02,,,,,0.00,0.00,0,0,0,0,0,0,0,0,0,0,0,0,0
20200528,051115,華通麥證96購01,,,,,0.00,0.00,0,0,0,0,0,0,0,0,0,0,0,0,0
20200528,051121,裕民群益97購01,,,,,0.00,0.00,0,0,0,0,0,0,0,0,0,0,0,0,0
20200528,051130,百和群益96購01,,,,,0.00,0.00,0,0,0,0,0,0,0,0,0,0,0,0,0
20200528,051152,鴻海國泰97購01,0.11,0.11,0.10,0.11,+0.08,266.67,4000,4,430,0,0,0,0,0,0,4000,4000,0,0
20200528,051153,鴻海國泰97購02,,,,,0.00,0.00,0,0,0,0,0,0,0,0,0,0,0,0,0
20200528,051154,國巨國泰96購03,3.15,3.24,3.15,3.24,0.00,0.00,145000,2,468630,0,0,0,0,0,0,145000,145000,0,0
20200528,051155,聯發科國泰96購01,,,,,0.00,0.00,0,0,0,0,0,0,0,0,0,0,0,0,0
20200528,051156,鴻海富邦97購01,0.05,0.05,0.05,0.05,0.00,0.00,15000,1,750,0,0,0,0,0,0,15000,0,15000,15000
20200528,051157,華新科富邦98購01,0.20,0.20,0.20,0.20,0.00,0.00,600000,2,120000,0,0,0,0,0,0,600000,0,600000,600000
20200528,051158,嘉晶富邦96購01,,,,,0.00,0.00,0,0,0,0,0,0,0,0,0,0,0,0,0
20200528,051159,力山元大96購01,0.32,0.32,0.32,0.32,-0.08,-20.0,39000,1,12480,0,0,0,0,0,0,39000,0,39000,39000
20200528,051172,鴻海第一96購01,,,,,0.00,0.00,0,0,0,0,0,0,0,0,0,0,0,0,0
20200528,051173,元油2X凱基98購01,,,,,0.00,0.00,0,0,0,0,0,0,0,0,0,0,0,0,0
20200528,051189,鴻海兆豐96購01,,,,,0.00,0.00,0,0,0,0,0,0,0,0,0,0,0,0,0
20200528,05118P,超眾元大96售04,,,,,0.00,0.00,0,0,0,0,0,0,0,0,0,0,0,0,0
20200528,051191,可成兆豐96購01,,,,,0.00,0.00,0,0,0,0,0,0,0,0,0,0,0,0,0
20200528,051192,緯創兆豐96購01,,,,,0.00,0.00,0,0,0,0,0,0,0,0,0,0,0,0,0
20200528,051193,新日興兆豐96購01,0.51,0.54,0.51,0.54,+0.11,25.58,12000,2,6420,0,0,0,0,0,0,10000,2000,8000,8000
20200528,051194,大立光中信96購02,,,,,0.00,0.00,0,0,0,0,0,0,0,0,0,0,0,0,0
20200528,05119P,聯發科國泰96售02,,,,,0.00,0.00,0,0,0,0,0,0,0,0,0,0,0,0,0
20200528,05120P,聯發科國泰97售01,,,,,0.00,0.00,0,0,0,0,0,0,0,0,0,0,0,0,0
20200528,051210,S&P反1統一97購01,,,,,0.00,0.00,0,0,0,0,0,0,0,0,0,0,0,0,0
20200528,051218,聯發科元富9B購02,,,,,0.00,0.00,0,0,0,0,0,0,0,0,0,0,0,0,0
20200528,05121P,創意國泰96售01,,,,,0.00,0.00,0,0,0,0,0,0,0,0,0,0,0,0,0
20200528,051224,華通群益96購03,,,,,0.00,0.00,0,0,0,0,0,0,0,0,0,0,0,0,0
20200528,051227,技嘉群益97購01,,,,,0.00,0.00,0,0,0,0,0,0,0,0,0,0,0,0,0
20200528,05122P,鴻海永昌96售06,,,,,0.00,0.00,0,0,0,0,0,0,0,0,0,0,0,0,0
20200528,051231,健策群益97購01,1.13,1.13,1.11,1.11,-0.16,-12.6,15000,2,16850,0,0,0,0,0,0,0,15000,-15000,-15000
20200528,051233,力成群益97購01,0.76,0.76,0.76,0.76,0.00,0.00,2000,1,1520,0,0,0,0,0,0,2000,0,2000,2000
20200528,051236,鴻海元大96購05,,,,,0.00,0.00,0,0,0,0,0,0,0,0,0,0,0,0,0
20200528,051237,鴻海元大97購01,,,,,0.00,0.00,0,0,0,0,0,0,0,0,0,0,0,0,0
20200528,051238,中環元大96購01,,,,,0.00,0.00,0,0,0,0,0,0,0,0,0,0,0,0,0
20200528,051239,國巨元大96購02,,,,,0.00,0.00,0,0,0,0,0,0,0,0,0,0,0,0,0
20200528,05123P,鴻海永昌96售07,,,,,0.00,0.00,0,0,0,0,0,0,0,0,0,0,0,0,0
20200528,051242,台積電元大96購06,,,,,0.00,0.00,0,0,0,0,0,0,0,0,0,0,0,0,0
20200528,051246,美律元大96購01,,,,,0.00,0.00,0,0,0,0,0,0,0,0,0,0,0,0,0
20200528,05124P,華新科富邦97售02,,,,,0.00,0.00,0,0,0,0,0,0,0,0,0,0,0,0,0
20200528,051250,大立光元大98購01,,,,,0.00,0.00,0,0,0,0,0,0,0,0,0,0,0,0,0
20200528,051254,健策元大96購04,,,,,0.00,0.00,0,0,0,0,0,0,0,0,0,0,0,0,0
20200528,051255,康控元大96購04,,,,,0.00,0.00,0,0,0,0,0,0,0,0,0,0,0,0,0
20200528,051257,光寶科國泰96購01,,,,,0.00,0.00,0,0,0,0,0,0,0,0,0,0,0,0,0
20200528,051258,鈺齊國泰97購01,,,,,0.00,0.00,0,0,0,0,0,0,0,0,0,0,0,0,0
20200528,051259,鴻海永昌96購03,0.01,0.05,0.01,0.01,0.00,0.00,1263000,7,23230,0,0,0,0,0,0,1263000,788000,475000,475000
20200528,051260,鴻海永昌96購04,,,,,0.00,0.00,0,0,0,0,0,0,0,0,0,0,0,0,0
20200528,051261,鴻海永昌96購05,,,,,0.00,0.00,0,0,0,0,0,0,0,0,0,0,0,0,0
20200528,051262,A50富邦96購01,,,,,0.00,0.00,0,0,0,0,0,0,0,0,0,0,0,0,0
20200528,051263,深中小富邦96購01,,,,,0.00,0.00,0,0,0,0,0,0,0,0,0,0,0,0,0
20200528,051264,道瓊反富邦97購01,,,,,0.00,0.00,0,0,0,0,0,0,0,0,0,0,0,0,0
20200528,051265,鴻海富邦96購04,,,,,0.00,0.00,0,0,0,0,0,0,0,0,0,0,0,0,0
20200528,051266,國巨富邦99購01,1.10,1.20,1.08,1.08,-0.06,-5.26,66000,11,77120,0,0,0,0,0,0,41000,34000,7000,7000
20200528,051267,美律富邦96購01,,,,,0.00,0.00,0,0,0,0,0,0,0,0,0,0,0,0,0
20200528,051268,創意富邦97購01,0.20,0.20,0.18,0.18,-0.01,-5.26,35000,4,6600,0,0,0,0,0,0,0,35000,-35000,-35000
20200528,051269,康友富邦97購01,,,,,0.00,0.00,0,0,0,0,0,0,0,0,0,0,0,0,0
20200528,051274,華新科亞東96購01,,,,,0.00,0.00,0,0,0,0,0,0,0,0,0,0,0,0,0
20200528,051276,SGBR2X中信97購01,,,,,0.00,0.00,0,0,0,0,0,0,0,0,0,0,0,0,0
20200528,051277,聯發科中信9A購01,0.36,0.36,0.30,0.33,-0.03,-8.33,367000,35,118760,0,0,0,0,0,0,0,0,0,0
20200528,051278,臻鼎中信97購02,,,,,0.00,0.00,0,0,0,0,0,0,0,0,0,0,0,0,0
20200528,051279,喬山兆豐96購01,,,,,0.00,0.00,0,0,0,0,0,0,0,0,0,0,0,0,0
20200528,05127P,鴻海亞東96售01,,,,,0.00,0.00,0,0,0,0,0,0,0,0,0,0,0,0,0
20200528,051281,健策兆豐96購01,,,,,0.00,0.00,0,0,0,0,0,0,0,0,0,0,0,0,0
20200528,051286,國巨統一97購01,,,,,0.00,0.00,0,0,0,0,0,0,0,0,0,0,0,0,0
20200528,051289,大立光統一96購01,,,,,0.00,0.00,0,0,0,0,0,0,0,0,0,0,0,0,0
20200528,05128P,聯發科中信97售03,,,,,0.00,0.00,0,0,0,0,0,0,0,0,0,0,0,0,0
20200528,051290,大立光統一96購02,,,,,0.00,0.00,0,0,0,0,0,0,0,0,0,0,0,0,0
20200528,051292,牧德統一97購01,1.86,1.94,1.78,1.78,-0.20,-10.1,191000,5,344840,0,0,0,0,0,0,140000,51000,89000,89000
20200528,051296,鴻海凱基97購01,,,,,0.00,0.00,0,0,0,0,0,0,0,0,0,0,0,0,0
20200528,051300,台光電凱基96購02,,,,,0.00,0.00,0,0,0,0,0,0,0,0,0,0,0,0,0
20200528,051304,緯創凱基96購01,,,,,0.00,0.00,0,0,0,0,0,0,0,0,0,0,0,0,0
20200528,051305,訊連凱基96購01,,,,,0.00,0.00,0,0,0,0,0,0,0,0,0,0,0,0,0
20200528,051306,嘉聯益凱基96購01,,,,,0.00,0.00,0,0,0,0,0,0,0,0,0,0,0,0,0
20200528,051314,嘉聯益麥證96購01,,,,,0.00,0.00,0,0,0,0,0,0,0,0,0,0,0,0,0
20200528,051317,亞德客國票96購01,1.88,1.88,1.24,1.24,-0.25,-16.78,308000,4,517320,0,240000,-240000,0,0,0,240000,68000,172000,-68000
20200528,051318,上銀國票96購01,,,,,0.00,0.00,0,0,0,0,0,0,0,0,0,0,0,0,0
20200528,051319,光磊國票96購02,,,,,0.00,0.00,0,0,0,0,0,0,0,0,0,0,0,0,0
20200528,05131P,聯詠統一97售01,1.23,1.29,1.23,1.29,+0.02,1.57,117000,4,149250,0,0,0,0,0,0,32000,93000,-61000,-61000
20200528,051320,燿華國票96購01,,,,,0.00,0.00,0,0,0,0,0,0,0,0,0,0,0,0,0
20200528,051321,建準國票96購01,,,,,0.00,0.00,0,0,0,0,0,0,0,0,0,0,0,0,0
20200528,051322,國泰金國票96購01,0.01,0.01,0.01,0.01,0.00,0.00,3316000,8,33160,0,0,0,0,0,0,3316000,0,3316000,3316000
20200528,051323,康控國票96購01,,,,,0.00,0.00,0,0,0,0,0,0,0,0,0,0,0,0,0
20200528,051324,康友國票96購01,,,,,0.00,0.00,0,0,0,0,0,0,0,0,0,0,0,0,0
20200528,051325,台光電台新96購01,0.54,0.54,0.54,0.54,-0.12,-18.18,5000,1,2700,0,0,0,0,0,0,5000,0,5000,5000
20200528,051331,全新永豐96購01,,,,,0.00,0.00,0,0,0,0,0,0,0,0,0,0,0,0,0
20200528,05134P,鴻海凱基96售06,,,,,0.00,0.00,0,0,0,0,0,0,0,0,0,0,0,0,0
20200528,051355,聯發科元大96購01,,,,,0.00,0.00,0,0,0,0,0,0,0,0,0,0,0,0,0
20200528,051356,全新元大96購04,,,,,0.00,0.00,0,0,0,0,0,0,0,0,0,0,0,0,0
20200528,05135P,鴻海凱基96售07,,,,,0.00,0.00,0,0,0,0,0,0,0,0,0,0,0,0,0
20200528,051364,鴻海國泰97購03,0.01,0.01,0.01,0.01,0.00,0.00,20000,1,200,0,0,0,0,0,0,0,0,0,0
20200528,051365,瀚宇博國泰97購01,,,,,0.00,0.00,0,0,0,0,0,0,0,0,0,0,0,0,0
20200528,051366,康友國泰97購01,,,,,0.00,0.00,0,0,0,0,0,0,0,0,0,0,0,0,0
20200528,051367,可成富邦97購01,0.01,0.01,0.01,0.01,0.00,0.00,40000,2,400,0,0,0,0,0,0,0,0,0,0
20200528,051368,國泰金富邦97購01,,,,,0.00,0.00,0,0,0,0,0,0,0,0,0,0,0,0,0
20200528,051369,新光金富邦9A購01,,,,,0.00,0.00,0,0,0,0,0,0,0,0,0,0,0,0,0
20200528,051370,聯詠富邦97購01,,,,,0.00,0.00,0,0,0,0,0,0,0,0,0,0,0,0,0
20200528,051372,樺漢富邦96購01,,,,,0.00,0.00,0,0,0,0,0,0,0,0,0,0,0,0,0
20200528,051375,道瓊反群益9A購01,1.82,1.85,1.81,1.85,-0.12,-6.09,213000,5,387450,0,0,0,0,0,0,50000,163000,-113000,-113000
20200528,05137P,華新科凱基96售03,,,,,0.00,0.00,0,0,0,0,0,0,0,0,0,0,0,0,0
20200528,051381,玉晶光群益98購01,2.40,2.40,2.31,2.31,+0.17,7.94,12000,2,28620,0,0,0,0,0,0,10000,2000,8000,8000
20200528,051382,玉晶光群益98購02,2.87,2.87,2.87,2.87,+0.25,9.54,4000,1,11480,0,0,0,0,0,0,0,4000,-4000,-4000
20200528,051383,京鼎群益96購02,,,,,0.00,0.00,0,0,0,0,0,0,0,0,0,0,0,0,0
20200528,051386,富邦金麥證96購01,,,,,0.00,0.00,0,0,0,0,0,0,0,0,0,0,0,0,0
20200528,051387,新光金麥證96購01,,,,,0.00,0.00,0,0,0,0,0,0,0,0,0,0,0,0,0
20200528,05138P,嘉聯益凱基96售02,,,,,0.00,0.00,0,0,0,0,0,0,0,0,0,0,0,0,0
20200528,051393,新光金兆豐96購01,,,,,0.00,0.00,0,0,0,0,0,0,0,0,0,0,0,0,0
20200528,051399,玉晶光台新96購01,,,,,0.00,0.00,0,0,0,0,0,0,0,0,0,0,0,0,0
20200528,051404,牧德永豐96購01,,,,,0.00,0.00,0,0,0,0,0,0,0,0,0,0,0,0,0
20200528,051406,泰鼎永豐96購01,,,,,0.00,0.00,0,0,0,0,0,0,0,0,0,0,0,0,0
20200528,051409,美律國票96購01,,,,,0.00,0.00,0,0,0,0,0,0,0,0,0,0,0,0,0
20200528,05140P,台表科國票96售01,,,,,0.00,0.00,0,0,0,0,0,0,0,0,0,0,0,0,0
20200528,051410,京元電國票96購01,,,,,0.00,0.00,0,0,0,0,0,0,0,0,0,0,0,0,0
20200528,051412,奇力新國票96購01,,,,,0.00,0.00,0,0,0,0,0,0,0,0,0,0,0,0,0
20200528,051413,富邦金國票96購02,,,,,0.00,0.00,0,0,0,0,0,0,0,0,0,0,0,0,0
20200528,051415,晶技國票96購01,,,,,0.00,0.00,0,0,0,0,0,0,0,0,0,0,0,0,0
20200528,051416,創意國票96購02,,,,,0.00,0.00,0,0,0,0,0,0,0,0,0,0,0,0,0
20200528,051417,揚明光國票96購01,,,,,0.00,0.00,0,0,0,0,0,0,0,0,0,0,0,0,0
20200528,051418,智易國票97購01,,,,,0.00,0.00,0,0,0,0,0,0,0,0,0,0,0,0,0
20200528,051419,麗豐國票96購01,,,,,0.00,0.00,0,0,0,0,0,0,0,0,0,0,0,0,0
20200528,05141P,華通台新96售01,,,,,0.00,0.00,0,0,0,0,0,0,0,0,0,0,0,0,0
20200528,051422,超眾國票96購01,,,,,0.00,0.00,0,0,0,0,0,0,0,0,0,0,0,0,0
20200528,051423,GIS國票97購01,1.44,1.44,1.19,1.19,-0.06,-4.8,68000,5,90080,0,0,0,0,0,0,49000,19000,30000,30000
20200528,051424,緯穎國票97購01,,,,,0.00,0.00,0,0,0,0,0,0,0,0,0,0,0,0,0
20200528,051425,昇陽半國票97購01,0.03,0.03,0.03,0.03,0.00,0.00,10000,1,300,0,0,0,0,0,0,0,10000,-10000,-10000
20200528,051428,玉晶光統一96購01,0.81,0.81,0.68,0.70,+0.05,7.69,236000,8,167460,0,0,0,0,0,0,80000,156000,-76000,-76000
20200528,051431,群創元富99購02,,,,,0.00,0.00,0,0,0,0,0,0,0,0,0,0,0,0,0
20200528,051432,群創元富99購03,,,,,0.00,0.00,0,0,0,0,0,0,0,0,0,0,0,0,0
20200528,051446,中壽元大96購01,,,,,0.00,0.00,0,0,0,0,0,0,0,0,0,0,0,0,0
20200528,051447,新光金元大97購01,,,,,0.00,0.00,0,0,0,0,0,0,0,0,0,0,0,0,0
20200528,051449,玉晶光元大96購01,,,,,0.00,0.00,0,0,0,0,0,0,0,0,0,0,0,0,0
20200528,051455,樺漢元大96購01,,,,,0.00,0.00,0,0,0,0,0,0,0,0,0,0,0,0,0
20200528,05145P,道瓊反元大98售01,0.45,0.45,0.45,0.45,0.00,0.00,1000,1,450,0,0,0,0,0,0,1000,0,1000,1000
20200528,051460,S&P反1國泰97購01,0.34,0.34,0.34,0.34,0.00,0.00,150000,3,51000,0,0,0,0,0,0,0,150000,-150000,-150000
20200528,051461,聯詠國泰96購01,0.25,0.25,0.25,0.25,-0.08,-24.24,99000,1,24750,0,0,0,0,0,0,99000,99000,0,0
20200528,051462,世芯國泰97購01,,,,,0.00,0.00,0,0,0,0,0,0,0,0,0,0,0,0,0
20200528,051463,世芯國泰97購02,6.70,6.70,6.70,6.70,0.00,0.00,5000,1,33500,0,0,0,0,0,0,0,5000,-5000,-5000
20200528,051464,彩晶國泰96購01,,,,,0.00,0.00,0,0,0,0,0,0,0,0,0,0,0,0,0
20200528,051465,鴻海富邦97購02,0.01,0.01,0.01,0.01,0.00,0.00,320000,2,3200,0,0,0,0,0,0,0,0,0,0
20200528,051466,玉晶光富邦97購01,,,,,0.00,0.00,0,0,0,0,0,0,0,0,0,0,0,0,0
20200528,051467,GIS富邦96購01,,,,,0.00,0.00,0,0,0,0,0,0,0,0,0,0,0,0,0
20200528,051469,友達日盛9B購01,,,,,0.00,0.00,0,0,0,0,0,0,0,0,0,0,0,0,0
20200528,051471,國巨凱基97購01,,,,,0.00,0.00,0,0,0,0,0,0,0,0,0,0,0,0,0
20200528,051480,大立光凱基97購01,,,,,0.00,0.00,0,0,0,0,0,0,0,0,0,0,0,0,0
20200528,051482,玉晶光凱基96購01,0.30,0.30,0.30,0.30,0.00,0.00,1000,1,300,0,0,0,0,0,0,1000,0,1000,1000
20200528,051483,玉晶光凱基96購02,,,,,0.00,0.00,0,0,0,0,0,0,0,0,0,0,0,0,0
20200528,051484,玉晶光凱基97購01,0.42,0.47,0.42,0.47,0.00,0.00,8000,4,3560,0,0,0,0,0,0,0,8000,-8000,-8000
20200528,051485,玉晶光凱基97購02,,,,,0.00,0.00,0,0,0,0,0,0,0,0,0,0,0,0,0
20200528,051486,玉晶光凱基97購03,0.46,0.55,0.45,0.45,+0.03,7.14,104000,10,49020,0,0,0,0,0,0,62000,42000,20000,20000
20200528,051487,健策凱基96購03,,,,,0.00,0.00,0,0,0,0,0,0,0,0,0,0,0,0,0
20200528,051488,健策凱基96購04,0.46,0.62,0.37,0.37,-0.24,-39.34,35000,5,13980,0,0,0,0,0,0,32000,8000,24000,24000
20200528,051490,世芯凱基96購01,3.06,3.18,3.06,3.18,0.00,0.00,4000,2,12480,0,0,0,0,0,0,0,4000,-4000,-4000
20200528,051497,中磊亞東96購01,,,,,0.00,0.00,0,0,0,0,0,0,0,0,0,0,0,0,0
20200528,051498,智易群益96購01,,,,,0.00,0.00,0,0,0,0,0,0,0,0,0,0,0,0,0
20200528,05149P,緯穎國泰96售01,,,,,0.00,0.00,0,0,0,0,0,0,0,0,0,0,0,0,0
20200528,051503,玉晶光統一97購01,2.17,2.34,2.13,2.13,+0.09,4.41,179000,16,398200,0,0,0,0,0,0,23000,161000,-138000,-138000
20200528,051508,元黃金中信97購01,2.22,2.22,2.22,2.22,+0.02,0.91,1000,1,2220,0,0,0,0,0,0,1000,0,1000,1000
20200528,051509,鴻海中信97購01,,,,,0.00,0.00,0,0,0,0,0,0,0,0,0,0,0,0,0
20200528,051510,新光金中信97購01,0.04,0.04,0.04,0.04,0.00,0.00,499000,3,19960,0,0,0,0,0,0,0,499000,-499000,-499000
20200528,051511,鈺齊中信97購01,,,,,0.00,0.00,0,0,0,0,0,0,0,0,0,0,0,0,0
20200528,051516,全新凱基96購02,,,,,0.00,0.00,0,0,0,0,0,0,0,0,0,0,0,0,0
20200528,051520,新光金凱基97購01,,,,,0.00,0.00,0,0,0,0,0,0,0,0,0,0,0,0,0
20200528,051521,大立光凱基96購07,,,,,0.00,0.00,0,0,0,0,0,0,0,0,0,0,0,0,0
20200528,051528,亞泥國票96購01,,,,,0.00,0.00,0,0,0,0,0,0,0,0,0,0,0,0,0
20200528,051529,東元國票96購01,,,,,0.00,0.00,0,0,0,0,0,0,0,0,0,0,0,0,0
20200528,05152P,玉晶光群益96售05,0.12,0.12,0.12,0.12,0.00,0.00,10000,1,1200,0,0,0,0,0,0,10000,0,10000,10000
20200528,051530,鴻海國票97購01,0.01,0.02,0.01,0.02,0.00,0.00,531000,2,6020,0,0,0,0,0,0,0,0,0,0
20200528,051531,國巨國票96購04,,,,,0.00,0.00,0,0,0,0,0,0,0,0,0,0,0,0,0
20200528,051532,潤泰全國票96購01,,,,,0.00,0.00,0,0,0,0,0,0,0,0,0,0,0,0,0
20200528,051533,健鼎國票96購02,,,,,0.00,0.00,0,0,0,0,0,0,0,0,0,0,0,0,0
20200528,051534,景碩國票97購01,,,,,0.00,0.00,0,0,0,0,0,0,0,0,0,0,0,0,0
20200528,051535,新日興國票96購01,,,,,0.00,0.00,0,0,0,0,0,0,0,0,0,0,0,0,0
20200528,051536,玉晶光國票97購01,1.46,1.66,1.40,1.50,+0.19,14.5,56000,27,85390,0,0,0,0,0,0,46000,31000,15000,15000
20200528,051537,牧德國票96購01,,,,,0.00,0.00,0,0,0,0,0,0,0,0,0,0,0,0,0
20200528,051538,和碩國票96購01,,,,,0.00,0.00,0,0,0,0,0,0,0,0,0,0,0,0,0
20200528,051539,瀚宇博國票97購01,,,,,0.00,0.00,0,0,0,0,0,0,0,0,0,0,0,0,0
20200528,05153P,台表科群益96售01,,,,,0.00,0.00,0,0,0,0,0,0,0,0,0,0,0,0,0
20200528,051541,GIS國票96購02,,,,,0.00,0.00,0,0,0,0,0,0,0,0,0,0,0,0,0
20200528,051542,南茂國票96購01,,,,,0.00,0.00,0,0,0,0,0,0,0,0,0,0,0,0,0
20200528,051543,鈺齊國票96購01,,,,,0.00,0.00,0,0,0,0,0,0,0,0,0,0,0,0,0
20200528,051544,T50反1康和98購01,0.46,0.52,0.46,0.52,+0.03,6.12,412000,12,200180,0,0,0,0,0,0,292000,120000,172000,172000
20200528,051553,牧德永豐96購02,,,,,0.00,0.00,0,0,0,0,0,0,0,0,0,0,0,0,0
20200528,051556,台表科永豐96購01,,,,,0.00,0.00,0,0,0,0,0,0,0,0,0,0,0,0,0
20200528,051557,昇陽半永豐96購01,,,,,0.00,0.00,0,0,0,0,0,0,0,0,0,0,0,0,0
20200528,051558,元金2X國泰97購01,5.20,5.20,5.20,5.20,+0.33,6.78,1000,1,5200,0,0,0,0,0,0,1000,0,1000,1000
20200528,051559,宏達電國泰96購01,,,,,0.00,0.00,0,0,0,0,0,0,0,0,0,0,0,0,0
20200528,051560,玉晶光國泰97購03,,,,,0.00,0.00,0,0,0,0,0,0,0,0,0,0,0,0,0
20200528,051561,玉晶光國泰97購04,1.50,1.64,1.50,1.53,+0.09,6.25,511000,21,786160,0,0,0,0,0,0,91000,421000,-330000,-330000
20200528,051562,玉晶光國泰97購05,,,,,0.00,0.00,0,0,0,0,0,0,0,0,0,0,0,0,0
20200528,051563,泰鼎國泰96購01,,,,,0.00,0.00,0,0,0,0,0,0,0,0,0,0,0,0,0
20200528,051564,和碩國泰96購01,,,,,0.00,0.00,0,0,0,0,0,0,0,0,0,0,0,0,0
20200528,051565,玉晶光永昌96購01,,,,,0.00,0.00,0,0,0,0,0,0,0,0,0,0,0,0,0
20200528,051570,和碩富邦97購01,0.09,0.09,0.09,0.09,0.00,0.00,13000,2,1170,0,0,0,0,0,0,13000,0,13000,13000
20200528,051574,鴻海元大96購06,,,,,0.00,0.00,0,0,0,0,0,0,0,0,0,0,0,0,0
20200528,051575,國巨元大96購03,,,,,0.00,0.00,0,0,0,0,0,0,0,0,0,0,0,0,0
20200528,051576,台積電元大97購02,,,,,0.00,0.00,0,0,0,0,0,0,0,0,0,0,0,0,0
20200528,051577,台積電元大97購03,,,,,0.00,0.00,0,0,0,0,0,0,0,0,0,0,0,0,0
20200528,051578,智邦元大96購01,4.20,4.20,3.55,3.55,0.00,0.00,14000,5,56440,0,0,0,0,0,0,0,14000,-14000,-14000
20200528,05157P,全新台新96售01,,,,,0.00,0.00,0,0,0,0,0,0,0,0,0,0,0,0,0
20200528,051582,聯發科元大97購02,,,,,0.00,0.00,0,0,0,0,0,0,0,0,0,0,0,0,0
20200528,051586,國泰金元大96購01,,,,,0.00,0.00,0,0,0,0,0,0,0,0,0,0,0,0,0
20200528,051590,玉晶光元大96購02,0.46,0.46,0.46,0.46,0.00,0.00,1000,1,460,0,0,0,0,0,0,1000,0,1000,1000
20200528,051591,玉晶光元大97購01,,,,,0.00,0.00,0,0,0,0,0,0,0,0,0,0,0,0,0
20200528,051592,健策元大96購05,1.20,1.20,0.87,0.87,-0.13,-13.0,24000,2,24180,0,0,0,0,0,0,24000,0,24000,24000
20200528,051594,和碩元大96購01,0.30,0.30,0.30,0.30,-0.05,-14.29,318000,2,95400,0,0,0,0,0,0,300000,18000,282000,282000
20200528,051597,T50反1中信99購02,,,,,0.00,0.00,0,0,0,0,0,0,0,0,0,0,0,0,0
20200528,051600,新日興兆豐96購02,,,,,0.00,0.00,0,0,0,0,0,0,0,0,0,0,0,0,0
20200528,051602,南茂兆豐96購01,0.05,0.05,0.05,0.05,0.00,0.00,100000,1,5000,0,0,0,0,0,0,100000,0,100000,100000
20200528,051603,深中小群益99購03,0.91,0.91,0.79,0.79,0.00,0.00,30000,3,25200,0,0,0,0,0,0,0,30000,-30000,-30000
20200528,051607,緯創群益96購02,,,,,0.00,0.00,0,0,0,0,0,0,0,0,0,0,0,0,0
20200528,051608,新日興群益96購01,,,,,0.00,0.00,0,0,0,0,0,0,0,0,0,0,0,0,0
20200528,05160P,國巨國票96售03,0.09,0.09,0.09,0.09,-0.04,-30.77,10000,1,900,0,0,0,0,0,0,10000,0,10000,10000
20200528,051613,S&P反1凱基96購01,,,,,0.00,0.00,0,0,0,0,0,0,0,0,0,0,0,0,0
20200528,051614,元金2X凱基97購01,1.18,1.21,1.17,1.19,+0.12,11.21,26000,5,30970,0,0,0,0,0,0,0,19000,-19000,-19000
20200528,051615,華通凱基96購01,,,,,0.00,0.00,0,0,0,0,0,0,0,0,0,0,0,0,0
20200528,051616,鴻海凱基96購08,,,,,0.00,0.00,0,0,0,0,0,0,0,0,0,0,0,0,0
20200528,05161P,華新科國票96售01,0.30,0.30,0.30,0.30,0.00,0.00,1000,1,300,0,0,0,0,0,0,1000,0,1000,1000
20200528,051622,和碩凱基96購01,,,,,0.00,0.00,0,0,0,0,0,0,0,0,0,0,0,0,0
20200528,051623,和碩凱基96購02,,,,,0.00,0.00,0,0,0,0,0,0,0,0,0,0,0,0,0
20200528,05162P,玉晶光國票96售03,,,,,0.00,0.00,0,0,0,0,0,0,0,0,0,0,0,0,0
20200528,051630,力山國票96購01,0.93,0.93,0.93,0.93,+0.06,6.9,1000,1,930,0,0,0,0,0,0,1000,0,1000,1000
20200528,051631,國巨國票96購06,,,,,0.00,0.00,0,0,0,0,0,0,0,0,0,0,0,0,0
20200528,051632,全新國票96購01,,,,,0.00,0.00,0,0,0,0,0,0,0,0,0,0,0,0,0
20200528,051633,可成國票96購03,,,,,0.00,0.00,0,0,0,0,0,0,0,0,0,0,0,0,0
20200528,051634,大立光國票96購03,,,,,0.00,0.00,0,0,0,0,0,0,0,0,0,0,0,0,0
20200528,051635,大立光國票96購04,,,,,0.00,0.00,0,0,0,0,0,0,0,0,0,0,0,0,0
20200528,051637,嘉聯益國票96購01,,,,,0.00,0.00,0,0,0,0,0,0,0,0,0,0,0,0,0
20200528,051638,聯茂國票96購01,,,,,0.00,0.00,0,0,0,0,0,0,0,0,0,0,0,0,0
20200528,051639,康友國票96購02,,,,,0.00,0.00,0,0,0,0,0,0,0,0,0,0,0,0,0
20200528,05163P,聯發科統一96售02,,,,,0.00,0.00,0,0,0,0,0,0,0,0,0,0,0,0,0
20200528,051640,GIS國票96購03,,,,,0.00,0.00,0,0,0,0,0,0,0,0,0,0,0,0,0
20200528,051641,矽創國票96購01,,,,,0.00,0.00,0,0,0,0,0,0,0,0,0,0,0,0,0
20200528,051646,華通永豐96購01,,,,,0.00,0.00,0,0,0,0,0,0,0,0,0,0,0,0,0
20200528,051652,昇陽半永豐96購02,,,,,0.00,0.00,0,0,0,0,0,0,0,0,0,0,0,0,0
20200528,051657,台郡元富98購01,,,,,0.00,0.00,0,0,0,0,0,0,0,0,0,0,0,0,0
20200528,051658,深中小國泰97購01,,,,,0.00,0.00,0,0,0,0,0,0,0,0,0,0,0,0,0
20200528,051659,力山國泰97購01,0.75,0.80,0.75,0.80,+0.05,6.67,19000,2,14500,0,0,0,0,0,0,14000,5000,9000,9000
20200528,051660,緯穎國泰96購02,,,,,0.00,0.00,0,0,0,0,0,0,0,0,0,0,0,0,0
20200528,051661,華新科永昌96購01,,,,,0.00,0.00,0,0,0,0,0,0,0,0,0,0,0,0,0
20200528,051662,大立光永昌96購03,,,,,0.00,0.00,0,0,0,0,0,0,0,0,0,0,0,0,0
20200528,051664,鴻海元大96購07,,,,,0.00,0.00,0,0,0,0,0,0,0,0,0,0,0,0,0
20200528,051665,台積電元大96購07,,,,,0.00,0.00,0,0,0,0,0,0,0,0,0,0,0,0,0
20200528,051666,旺宏元大96購05,,,,,0.00,0.00,0,0,0,0,0,0,0,0,0,0,0,0,0
20200528,051667,光磊元大96購02,,,,,0.00,0.00,0,0,0,0,0,0,0,0,0,0,0,0,0
20200528,051671,和鑫元大96購02,,,,,0.00,0.00,0,0,0,0,0,0,0,0,0,0,0,0,0
20200528,051672,玉晶光元大96購03,,,,,0.00,0.00,0,0,0,0,0,0,0,0,0,0,0,0,0
20200528,051673,玉晶光元大96購04,,,,,0.00,0.00,0,0,0,0,0,0,0,0,0,0,0,0,0
20200528,051675,瑞儀元大96購02,,,,,0.00,0.00,0,0,0,0,0,0,0,0,0,0,0,0,0
20200528,051682,元黃金凱基97購01,,,,,0.00,0.00,0,0,0,0,0,0,0,0,0,0,0,0,0
20200528,051683,A50正2凱基97購01,,,,,0.00,0.00,0,0,0,0,0,0,0,0,0,0,0,0,0
20200528,051688,大立光凱基97購02,0.10,0.10,0.10,0.10,0.00,0.00,5000,1,500,0,0,0,0,0,0,0,5000,-5000,-5000
20200528,051694,A50正2中信96購03,,,,,0.00,0.00,0,0,0,0,0,0,0,0,0,0,0,0,0
20200528,051695,元金2X中信98購01,,,,,0.00,0.00,0,0,0,0,0,0,0,0,0,0,0,0,0
20200528,051696,新日興中信96購01,,,,,0.00,0.00,0,0,0,0,0,0,0,0,0,0,0,0,0
20200528,051700,深中小群益99購04,,,,,0.00,0.00,0,0,0,0,0,0,0,0,0,0,0,0,0
20200528,051701,華通群益97購01,,,,,0.00,0.00,0,0,0,0,0,0,0,0,0,0,0,0,0
20200528,051705,富邦金群益97購01,,,,,0.00,0.00,0,0,0,0,0,0,0,0,0,0,0,0,0
20200528,051721,玉晶光永豐96購02,1.33,1.48,1.33,1.48,0.00,0.00,11000,2,14780,0,0,0,0,0,0,10000,1000,9000,9000
20200528,051722,玉晶光永豐97購01,1.49,1.62,1.44,1.44,+0.05,3.6,141000,11,215040,0,0,0,0,0,0,81000,60000,21000,21000
20200528,051727,S&P反1國票97購01,0.62,0.63,0.62,0.62,-0.07,-10.14,115000,9,71800,0,0,0,0,0,0,55000,60000,-5000,-5000
20200528,051728,道瓊反國票97購01,0.67,0.69,0.66,0.68,-0.11,-13.92,161000,7,107490,0,0,0,0,0,0,115000,46000,69000,69000
20200528,051729,華新國票96購01,0.66,0.70,0.50,0.50,+0.20,66.67,125000,5,76600,0,0,0,0,0,0,0,125000,-125000,-125000
20200528,051730,為升國票96購02,,,,,0.00,0.00,0,0,0,0,0,0,0,0,0,0,0,0,0
20200528,051731,聯電國票96購02,1.09,1.09,1.09,1.09,+0.06,5.83,10000,1,10900,0,0,0,0,0,0,10000,0,10000,10000
20200528,051732,華通國票97購01,,,,,0.00,0.00,0,0,0,0,0,0,0,0,0,0,0,0,0
20200528,051733,中環國票96購02,,,,,0.00,0.00,0,0,0,0,0,0,0,0,0,0,0,0,0
20200528,051735,台積電國票96購06,,,,,0.00,0.00,0,0,0,0,0,0,0,0,0,0,0,0,0
20200528,051736,旺宏國票96購01,2.71,2.71,2.71,2.71,-0.25,-8.45,30000,1,81300,0,0,0,0,0,0,30000,0,30000,30000
20200528,051737,瑞昱國票96購01,,,,,0.00,0.00,0,0,0,0,0,0,0,0,0,0,0,0,0
20200528,051738,全新國票96購02,,,,,0.00,0.00,0,0,0,0,0,0,0,0,0,0,0,0,0
20200528,051739,奇力新國票97購01,1.36,1.36,1.36,1.36,0.00,0.00,1000,1,1360,0,0,0,0,0,0,0,1000,-1000,-1000
20200528,051740,可成國票96購04,,,,,0.00,0.00,0,0,0,0,0,0,0,0,0,0,0,0,0
20200528,051741,可成國票97購01,,,,,0.00,0.00,0,0,0,0,0,0,0,0,0,0,0,0,0
20200528,051742,欣興國票96購01,,,,,0.00,0.00,0,0,0,0,0,0,0,0,0,0,0,0,0
20200528,051743,揚明光國票96購02,,,,,0.00,0.00,0,0,0,0,0,0,0,0,0,0,0,0,0
20200528,051744,嘉聯益國票97購01,,,,,0.00,0.00,0,0,0,0,0,0,0,0,0,0,0,0,0
20200528,051745,玉晶光國泰97購06,1.54,1.71,1.52,1.52,+0.05,3.4,210000,18,341680,0,0,0,0,0,0,17000,195000,-178000,-178000
20200528,051746,玉晶光國泰97購07,,,,,0.00,0.00,0,0,0,0,0,0,0,0,0,0,0,0,0
20200528,051747,貿聯國泰96購01,,,,,0.00,0.00,0,0,0,0,0,0,0,0,0,0,0,0,0
20200528,051748,超眾國泰96購01,,,,,0.00,0.00,0,0,0,0,0,0,0,0,0,0,0,0,0
20200528,051749,矽力國泰97購01,,,,,0.00,0.00,0,0,0,0,0,0,0,0,0,0,0,0,0
20200528,05174P,元金2X富邦9B售01,,,,,0.00,0.00,0,0,0,0,0,0,0,0,0,0,0,0,0
20200528,051750,華通富邦96購01,,,,,0.00,0.00,0,0,0,0,0,0,0,0,0,0,0,0,0
20200528,051752,緯穎富邦96購01,,,,,0.00,0.00,0,0,0,0,0,0,0,0,0,0,0,0,0
20200528,051753,華通元大96購03,,,,,0.00,0.00,0,0,0,0,0,0,0,0,0,0,0,0,0
20200528,051755,台積電元大96購08,,,,,0.00,0.00,0,0,0,0,0,0,0,0,0,0,0,0,0
20200528,051756,台積電元大97購04,,,,,0.00,0.00,0,0,0,0,0,0,0,0,0,0,0,0,0
20200528,05175P,TPK富邦99售01,,,,,0.00,0.00,0,0,0,0,0,0,0,0,0,0,0,0,0
20200528,051761,富邦金元大96購01,,,,,0.00,0.00,0,0,0,0,0,0,0,0,0,0,0,0,0
20200528,051763,新光金元大98購01,,,,,0.00,0.00,0,0,0,0,0,0,0,0,0,0,0,0,0
20200528,051774,聯茂中信96購01,,,,,0.00,0.00,0,0,0,0,0,0,0,0,0,0,0,0,0
20200528,051776,上証2X群益99購01,,,,,0.00,0.00,0,0,0,0,0,0,0,0,0,0,0,0,0
20200528,051781,緯穎群益96購01,,,,,0.00,0.00,0,0,0,0,0,0,0,0,0,0,0,0,0
20200528,051785,臻鼎兆豐96購01,,,,,0.00,0.00,0,0,0,0,0,0,0,0,0,0,0,0,0
20200528,051787,燿華國票96購02,,,,,0.00,0.00,0,0,0,0,0,0,0,0,0,0,0,0,0
20200528,051788,奇力新國票97購02,,,,,0.00,0.00,0,0,0,0,0,0,0,0,0,0,0,0,0
20200528,051789,嘉澤國票96購01,,,,,0.00,0.00,0,0,0,0,0,0,0,0,0,0,0,0,0
20200528,05178P,大立光凱基96售05,,,,,0.00,0.00,0,0,0,0,0,0,0,0,0,0,0,0,0
20200528,051791,智伸科國票96購01,,,,,0.00,0.00,0,0,0,0,0,0,0,0,0,0,0,0,0
20200528,051792,泰鼎國票96購02,,,,,0.00,0.00,0,0,0,0,0,0,0,0,0,0,0,0,0
20200528,051794,臻鼎國票96購02,,,,,0.00,0.00,0,0,0,0,0,0,0,0,0,0,0,0,0
20200528,051795,T50反1台新05購02,0.70,0.72,0.70,0.72,+0.01,1.41,107000,4,75040,0,0,0,0,0,0,7000,107000,-100000,-100000
20200528,051799,台積電永豐96購01,0.35,0.35,0.35,0.35,+0.02,6.06,5000,1,1750,0,0,0,0,0,0,5000,0,5000,5000
20200528,05179P,大立光凱基96售06,,,,,0.00,0.00,0,0,0,0,0,0,0,0,0,0,0,0,0
20200528,051805,元黃金凱基97購02,,,,,0.00,0.00,0,0,0,0,0,0,0,0,0,0,0,0,0
20200528,051806,華通凱基96購02,,,,,0.00,0.00,0,0,0,0,0,0,0,0,0,0,0,0,0
20200528,051808,美律凱基96購02,,,,,0.00,0.00,0,0,0,0,0,0,0,0,0,0,0,0,0
20200528,051809,義隆凱基96購01,,,,,0.00,0.00,0,0,0,0,0,0,0,0,0,0,0,0,0
20200528,051813,GIS凱基96購02,,,,,0.00,0.00,0,0,0,0,0,0,0,0,0,0,0,0,0
20200528,051815,百和凱基96購01,,,,,0.00,0.00,0,0,0,0,0,0,0,0,0,0,0,0,0
20200528,051819,燿華統一96購01,,,,,0.00,0.00,0,0,0,0,0,0,0,0,0,0,0,0,0
20200528,051829,玉晶光元大98購02,,,,,0.00,0.00,0,0,0,0,0,0,0,0,0,0,0,0,0
20200528,051830,健策元大97購01,1.62,1.62,1.62,1.62,-0.38,-19.0,1000,1,1620,0,0,0,0,0,0,1000,1000,0,0
20200528,051831,緯穎元大96購04,,,,,0.00,0.00,0,0,0,0,0,0,0,0,0,0,0,0,0
20200528,051833,昇陽半元大96購01,,,,,0.00,0.00,0,0,0,0,0,0,0,0,0,0,0,0,0
20200528,051834,南電元大96購02,,,,,0.00,0.00,0,0,0,0,0,0,0,0,0,0,0,0,0
20200528,051837,國巨國泰96購04,,,,,0.00,0.00,0,0,0,0,0,0,0,0,0,0,0,0,0
20200528,051838,國巨國泰97購01,1.32,1.33,1.32,1.33,+0.06,4.72,20000,2,26500,0,0,0,0,0,0,20000,20000,0,0
20200528,051839,和鑫國泰96購01,,,,,0.00,0.00,0,0,0,0,0,0,0,0,0,0,0,0,0
20200528,051840,康友國泰97購02,,,,,0.00,0.00,0,0,0,0,0,0,0,0,0,0,0,0,0
20200528,051841,南茂國泰96購01,,,,,0.00,0.00,0,0,0,0,0,0,0,0,0,0,0,0,0
20200528,051842,大成鋼富邦97購01,,,,,0.00,0.00,0,0,0,0,0,0,0,0,0,0,0,0,0
20200528,051843,聯發科富邦99購01,,,,,0.00,0.00,0,0,0,0,0,0,0,0,0,0,0,0,0
20200528,051844,宏達電富邦96購01,,,,,0.00,0.00,0,0,0,0,0,0,0,0,0,0,0,0,0
20200528,051845,世紀鋼富邦96購01,0.66,0.66,0.63,0.63,+0.08,14.55,118000,6,75780,0,0,0,0,0,0,103000,0,103000,103000
20200528,051846,S&P反1中信96購02,0.34,0.35,0.34,0.35,0.00,0.00,10000,2,3440,0,0,0,0,0,0,0,10000,-10000,-10000
20200528,051847,香港反中信99購01,0.90,1.09,0.80,1.05,+0.17,19.32,1671000,253,1502470,0,0,0,0,0,0,45000,862000,-817000,-817000
20200528,051848,元金2X中信98購02,,,,,0.00,0.00,0,0,0,0,0,0,0,0,0,0,0,0,0
20200528,051849,旺宏中信98購01,0.68,0.68,0.51,0.52,-0.09,-14.75,1624000,65,877990,0,0,0,0,0,0,930000,684000,246000,246000
20200528,051850,臻鼎中信96購01,,,,,0.00,0.00,0,0,0,0,0,0,0,0,0,0,0,0,0
20200528,051855,道瓊反凱基97購01,0.18,0.18,0.18,0.18,0.00,0.00,10000,1,1800,0,0,0,0,0,0,0,10000,-10000,-10000
20200528,051859,劍麟凱基96購01,,,,,0.00,0.00,0,0,0,0,0,0,0,0,0,0,0,0,0
20200528,051861,鴻海凱基98購01,0.02,0.02,0.02,0.02,0.00,0.00,10000,1,200,0,0,0,0,0,0,0,0,0,0
20200528,051864,聯發科凱基96購03,,,,,0.00,0.00,0,0,0,0,0,0,0,0,0,0,0,0,0
20200528,051865,聯發科凱基96購04,0.47,0.47,0.47,0.47,+0.02,4.44,6000,1,2820,0,0,0,0,0,0,6000,0,6000,6000
20200528,051866,聯發科凱基96購05,,,,,0.00,0.00,0,0,0,0,0,0,0,0,0,0,0,0,0
20200528,051868,貿聯凱基96購01,,,,,0.00,0.00,0,0,0,0,0,0,0,0,0,0,0,0,0
20200528,051869,康控凱基96購01,,,,,0.00,0.00,0,0,0,0,0,0,0,0,0,0,0,0,0
20200528,051872,矽力凱基96購01,3.32,3.97,3.32,3.59,+0.49,15.81,127000,16,454920,0,0,0,0,0,0,77000,50000,27000,27000
20200528,051876,宏達電國票96購01,,,,,0.00,0.00,0,0,0,0,0,0,0,0,0,0,0,0,0
20200528,051877,嘉聯益國票97購02,,,,,0.00,0.00,0,0,0,0,0,0,0,0,0,0,0,0,0
20200528,051878,鴻海台新96購01,0.01,0.01,0.01,0.01,0.00,0.00,200000,1,2000,0,0,0,0,0,0,200000,0,200000,200000
20200528,051879,健策台新96購01,,,,,0.00,0.00,0,0,0,0,0,0,0,0,0,0,0,0,0
20200528,051887,上証2X元富98購01,,,,,0.00,0.00,0,0,0,0,0,0,0,0,0,0,0,0,0
20200528,051897,台光電國泰97購01,,,,,0.00,0.00,0,0,0,0,0,0,0,0,0,0,0,0,0
20200528,051898,富邦金國泰97購01,0.81,0.81,0.81,0.81,+0.05,6.58,80000,1,64800,0,0,0,0,0,0,80000,0,80000,80000
20200528,051899,欣興國泰97購01,,,,,0.00,0.00,0,0,0,0,0,0,0,0,0,0,0,0,0
20200528,05189P,新光金凱基97售02,1.09,1.09,1.09,1.09,0.00,0.00,5000,1,5450,0,0,0,0,0,0,5000,0,5000,5000
20200528,051901,嘉聯益富邦96購01,,,,,0.00,0.00,0,0,0,0,0,0,0,0,0,0,0,0,0
20200528,051902,T50反1元大97購01,,,,,0.00,0.00,0,0,0,0,0,0,0,0,0,0,0,0,0
20200528,051903,T50反1元大97購02,0.84,0.84,0.84,0.84,0.00,0.00,10000,1,8400,0,0,0,0,0,0,0,10000,-10000,-10000
20200528,051907,台積電元大97購05,0.44,0.44,0.44,0.44,-0.08,-15.38,263000,1,115720,0,0,0,0,0,0,263000,263000,0,0
20200528,051908,國泰金元大96購02,,,,,0.00,0.00,0,0,0,0,0,0,0,0,0,0,0,0,0
20200528,05190P,鴻海國票96售02,,,,,0.00,0.00,0,0,0,0,0,0,0,0,0,0,0,0,0
20200528,051910,大立光元大97購01,,,,,0.00,0.00,0,0,0,0,0,0,0,0,0,0,0,0,0
20200528,051911,大立光元大98購02,0.26,0.26,0.26,0.26,0.00,0.00,10000,2,2600,0,0,0,0,0,0,5000,0,5000,5000
20200528,051912,健鼎元大96購01,,,,,0.00,0.00,0,0,0,0,0,0,0,0,0,0,0,0,0
20200528,051913,緯創元大96購01,,,,,0.00,0.00,0,0,0,0,0,0,0,0,0,0,0,0,0
20200528,051914,健策元大96購06,,,,,0.00,0.00,0,0,0,0,0,0,0,0,0,0,0,0,0
20200528,051915,日月光元大96購01,,,,,0.00,0.00,0,0,0,0,0,0,0,0,0,0,0,0,0
20200528,051919,台郡元大96購02,,,,,0.00,0.00,0,0,0,0,0,0,0,0,0,0,0,0,0
20200528,051922,鴻海亞東96購02,,,,,0.00,0.00,0,0,0,0,0,0,0,0,0,0,0,0,0
20200528,051926,聯電中信97購01,,,,,0.00,0.00,0,0,0,0,0,0,0,0,0,0,0,0,0
20200528,051927,國巨中信96購01,,,,,0.00,0.00,0,0,0,0,0,0,0,0,0,0,0,0,0
20200528,051928,大立光中信96購03,,,,,0.00,0.00,0,0,0,0,0,0,0,0,0,0,0,0,0
20200528,051929,GIS中信96購01,0.46,0.46,0.44,0.44,-0.02,-4.35,400000,4,181000,0,0,0,0,0,0,0,400000,-400000,-400000
20200528,05192P,玉晶光台新96售02,0.02,0.02,0.02,0.02,0.00,0.00,30000,1,600,0,0,0,0,0,0,30000,0,30000,30000
20200528,051930,國泰金兆豐97購01,,,,,0.00,0.00,0,0,0,0,0,0,0,0,0,0,0,0,0
20200528,051931,美律國票96購02,,,,,0.00,0.00,0,0,0,0,0,0,0,0,0,0,0,0,0
20200528,051932,康控國票96購02,,,,,0.00,0.00,0,0,0,0,0,0,0,0,0,0,0,0,0
20200528,051933,嘉聯益國票97購03,,,,,0.00,0.00,0,0,0,0,0,0,0,0,0,0,0,0,0
20200528,051934,緯穎國票96購01,,,,,0.00,0.00,0,0,0,0,0,0,0,0,0,0,0,0,0
20200528,051939,同欣電群益97購01,1.05,1.05,1.05,1.05,-0.43,-29.05,5000,2,5250,0,0,0,0,0,0,5000,0,5000,5000
20200528,051946,健策統一98購01,0.83,0.83,0.68,0.71,-0.11,-13.41,84000,11,61050,0,0,0,0,0,0,80000,4000,76000,76000
20200528,051948,滬深2X元富9B購01,,,,,0.00,0.00,0,0,0,0,0,0,0,0,0,0,0,0,0
20200528,051956,滬深2X台新96購01,,,,,0.00,0.00,0,0,0,0,0,0,0,0,0,0,0,0,0
20200528,051970,元黃金凱基98購01,0.76,0.76,0.76,0.76,+0.01,1.33,1000,1,760,0,0,0,0,0,0,1000,0,1000,1000
20200528,051971,元金2X凱基97購02,0.56,0.80,0.56,0.76,+0.01,1.33,161000,9,105310,0,0,0,0,0,0,0,0,0,0
20200528,051973,華新科凱基96購04,0.44,0.44,0.44,0.44,0.00,0.00,140000,3,61600,0,0,0,0,0,0,140000,140000,0,0
20200528,051974,華新科凱基96購05,,,,,0.00,0.00,0,0,0,0,0,0,0,0,0,0,0,0,0
20200528,051978,泰碩凱基96購01,0.01,0.01,0.01,0.01,0.00,0.00,7000,3,70,0,0,0,0,0,0,7000,0,7000,7000
20200528,051979,群創凱基97購01,0.35,0.35,0.31,0.32,-0.02,-5.88,180000,6,57800,0,0,0,0,0,0,120000,60000,60000,60000
20200528,051980,樺漢凱基96購01,,,,,0.00,0.00,0,0,0,0,0,0,0,0,0,0,0,0,0
20200528,051981,南茂凱基96購01,,,,,0.00,0.00,0,0,0,0,0,0,0,0,0,0,0,0,0
20200528,051986,燿華元大96購04,,,,,0.00,0.00,0,0,0,0,0,0,0,0,0,0,0,0,0
20200528,051994,瀚宇博元大96購01,,,,,0.00,0.00,0,0,0,0,0,0,0,0,0,0,0,0,0
20200528,051998,昇陽半元大96購02,,,,,0.00,0.00,0,0,0,0,0,0,0,0,0,0,0,0,0
20200528,052002,滬深2X國泰96購01,,,,,0.00,0.00,0,0,0,0,0,0,0,0,0,0,0,0,0
20200528,052003,泰碩國泰97購02,0.79,0.79,0.76,0.76,-0.15,-16.48,450000,5,353870,0,0,0,0,0,0,347000,103000,244000,244000
20200528,052004,泰碩國泰97購03,0.54,0.54,0.54,0.54,-0.09,-14.29,110000,1,59400,0,0,0,0,0,0,110000,0,110000,110000
20200528,052005,矽力國泰97購02,7.45,7.45,7.45,7.45,0.00,0.00,5000,4,37250,0,0,0,0,0,0,5000,0,5000,5000
20200528,052006,康友富邦98購01,,,,,0.00,0.00,0,0,0,0,0,0,0,0,0,0,0,0,0
20200528,052011,欣興中信96購01,,,,,0.00,0.00,0,0,0,0,0,0,0,0,0,0,0,0,0
20200528,05201P,玉晶光國泰97售02,,,,,0.00,0.00,0,0,0,0,0,0,0,0,0,0,0,0,0
20200528,052025,國巨群益96購01,2.21,2.27,1.94,1.94,-0.18,-8.49,78000,13,170150,0,0,0,0,0,0,4000,78000,-74000,-74000
20200528,052037,全新國泰96購02,,,,,0.00,0.00,0,0,0,0,0,0,0,0,0,0,0,0,0
20200528,052038,國巨永昌96購01,1.99,2.07,1.99,2.07,+0.16,8.38,20000,2,40600,0,0,0,0,0,0,20000,20000,0,0
20200528,052039,聯詠永昌96購01,,,,,0.00,0.00,0,0,0,0,0,0,0,0,0,0,0,0,0
20200528,052044,華通凱基97購01,0.01,0.01,0.01,0.01,0.00,0.00,2294000,11,22940,0,0,0,0,0,0,1794000,0,1794000,1794000
20200528,052045,瑞昱凱基96購01,0.55,0.55,0.54,0.55,+0.05,10.0,24000,3,13160,0,0,0,0,0,0,14000,10000,4000,4000
20200528,052046,漢唐凱基96購01,,,,,0.00,0.00,0,0,0,0,0,0,0,0,0,0,0,0,0
20200528,052047,建準凱基96購01,1.15,1.61,1.15,1.34,0.00,0.00,167000,28,241030,0,0,0,0,0,0,0,167000,-167000,-167000
20200528,052049,緯創凱基97購01,,,,,0.00,0.00,0,0,0,0,0,0,0,0,0,0,0,0,0
20200528,052053,泰鼎凱基96購01,,,,,0.00,0.00,0,0,0,0,0,0,0,0,0,0,0,0,0
20200528,052054,台表科凱基96購01,,,,,0.00,0.00,0,0,0,0,0,0,0,0,0,0,0,0,0
20200528,052060,旺宏國票96購02,,,,,0.00,0.00,0,0,0,0,0,0,0,0,0,0,0,0,0
20200528,052061,樺漢國票96購01,,,,,0.00,0.00,0,0,0,0,0,0,0,0,0,0,0,0,0
20200528,052066,華邦電兆豐96購01,0.21,0.21,0.11,0.18,+0.08,80.0,69000,4,9500,0,0,0,0,0,0,46000,13000,33000,33000
20200528,052067,中磊兆豐96購01,0.40,0.40,0.40,0.40,0.00,0.00,5000,1,2000,0,0,0,0,0,0,5000,0,5000,5000
20200528,052068,瑞儀兆豐96購01,,,,,0.00,0.00,0,0,0,0,0,0,0,0,0,0,0,0,0
20200528,052069,聯茂兆豐96購01,0.27,0.27,0.26,0.26,0.00,0.00,80000,4,21400,0,0,0,0,0,0,0,80000,-80000,-80000
20200528,052076,可成元富98購01,0.79,0.79,0.75,0.75,-0.04,-5.06,5000,2,3830,0,0,0,0,0,0,5000,0,5000,5000
20200528,052077,可成元富98購02,,,,,0.00,0.00,0,0,0,0,0,0,0,0,0,0,0,0,0
20200528,052079,康友元富98購01,,,,,0.00,0.00,0,0,0,0,0,0,0,0,0,0,0,0,0
20200528,05207P,高股息中信97售03,0.53,0.57,0.53,0.57,-0.02,-3.39,220000,5,120900,0,0,0,0,0,0,220000,0,220000,220000
20200528,052080,康友元富98購02,,,,,0.00,0.00,0,0,0,0,0,0,0,0,0,0,0,0,0
20200528,052083,S&P反1元大97購02,,,,,0.00,0.00,0,0,0,0,0,0,0,0,0,0,0,0,0
20200528,052086,鴻海元大96購08,,,,,0.00,0.00,0,0,0,0,0,0,0,0,0,0,0,0,0
20200528,052087,鴻海元大96購09,,,,,0.00,0.00,0,0,0,0,0,0,0,0,0,0,0,0,0
20200528,052089,聯發科元大96購02,,,,,0.00,0.00,0,0,0,0,0,0,0,0,0,0,0,0,0
20200528,052090,聯發科元大97購03,,,,,0.00,0.00,0,0,0,0,0,0,0,0,0,0,0,0,0
20200528,052092,貿聯元大96購02,,,,,0.00,0.00,0,0,0,0,0,0,0,0,0,0,0,0,0
20200528,052093,麗豐元大96購04,,,,,0.00,0.00,0,0,0,0,0,0,0,0,0,0,0,0,0
20200528,052094,瀚宇博元大96購02,,,,,0.00,0.00,0,0,0,0,0,0,0,0,0,0,0,0,0
20200528,052095,彩晶元大97購01,,,,,0.00,0.00,0,0,0,0,0,0,0,0,0,0,0,0,0
20200528,05209P,鴻海凱基96售09,0.16,0.16,0.16,0.16,0.00,0.00,1000,1,160,0,0,0,0,0,0,1000,1000,0,0
20200528,052100,滬深2X永昌96購01,,,,,0.00,0.00,0,0,0,0,0,0,0,0,0,0,0,0,0
20200528,052101,滬深2X兆豐96購01,,,,,0.00,0.00,0,0,0,0,0,0,0,0,0,0,0,0,0
20200528,052102,台泥兆豐96購01,,,,,0.00,0.00,0,0,0,0,0,0,0,0,0,0,0,0,0
20200528,052104,英業達兆豐96購01,0.56,0.56,0.48,0.51,-0.03,-5.56,773000,8,419510,0,0,0,0,0,0,339000,434000,-95000,-95000
20200528,052112,滬深2X中信99購01,0.08,0.08,0.08,0.08,0.00,0.00,20000,2,1600,0,0,0,0,0,0,0,20000,-20000,-20000
20200528,052113,漢唐中信98購01,0.55,0.55,0.48,0.48,-0.07,-12.73,632000,9,329210,0,0,0,0,0,0,594000,28000,566000,566000
20200528,052116,T50反1國票97購01,,,,,0.00,0.00,0,0,0,0,0,0,0,0,0,0,0,0,0
20200528,052117,鴻海國票96購03,,,,,0.00,0.00,0,0,0,0,0,0,0,0,0,0,0,0,0
20200528,052118,鴻海國票96購04,,,,,0.00,0.00,0,0,0,0,0,0,0,0,0,0,0,0,0
20200528,052119,漢唐國票96購01,,,,,0.00,0.00,0,0,0,0,0,0,0,0,0,0,0,0,0
20200528,05211P,國巨國票96售05,,,,,0.00,0.00,0,0,0,0,0,0,0,0,0,0,0,0,0
20200528,052120,友達國票96購01,,,,,0.00,0.00,0,0,0,0,0,0,0,0,0,0,0,0,0
20200528,052121,全新國票96購03,,,,,0.00,0.00,0,0,0,0,0,0,0,0,0,0,0,0,0
20200528,052122,新光金國票96購01,,,,,0.00,0.00,0,0,0,0,0,0,0,0,0,0,0,0,0
20200528,052126,群創國票97購01,,,,,0.00,0.00,0,0,0,0,0,0,0,0,0,0,0,0,0
20200528,052127,日月光國票96購01,,,,,0.00,0.00,0,0,0,0,0,0,0,0,0,0,0,0,0
20200528,052129,鴻海凱基97購02,,,,,0.00,0.00,0,0,0,0,0,0,0,0,0,0,0,0,0
20200528,05212P,台積電國票96售04,1.88,1.99,1.88,1.99,0.00,0.00,48000,6,94510,0,0,0,0,0,0,5000,43000,-38000,-38000
20200528,052130,國巨凱基9B購01,1.47,1.47,1.47,1.47,+0.08,5.76,2000,1,2940,0,0,0,0,0,0,2000,0,2000,2000
20200528,052131,台積電凱基96購01,,,,,0.00,0.00,0,0,0,0,0,0,0,0,0,0,0,0,0
20200528,052132,旺宏凱基9B購01,,,,,0.00,0.00,0,0,0,0,0,0,0,0,0,0,0,0,0
20200528,052133,華邦電凱基9B購01,0.32,0.32,0.32,0.32,0.00,0.00,10000,1,3200,0,0,0,0,0,0,0,0,0,0
20200528,052135,聯發科凱基9B購01,,,,,0.00,0.00,0,0,0,0,0,0,0,0,0,0,0,0,0
20200528,052137,台表科凱基96購02,0.63,0.73,0.59,0.59,-0.23,-28.05,26000,7,15980,0,0,0,0,0,0,4000,22000,-18000,-18000
20200528,052138,易華電凱基97購01,,,,,0.00,0.00,0,0,0,0,0,0,0,0,0,0,0,0,0
20200528,05213P,台積電國票96售05,,,,,0.00,0.00,0,0,0,0,0,0,0,0,0,0,0,0,0
20200528,052142,滬深2X群益99購04,,,,,0.00,0.00,0,0,0,0,0,0,0,0,0,0,0,0,0
20200528,05214P,台積電國票97售02,,,,,0.00,0.00,0,0,0,0,0,0,0,0,0,0,0,0,0
20200528,052151,義隆富邦96購01,,,,,0.00,0.00,0,0,0,0,0,0,0,0,0,0,0,0,0
20200528,052152,創意富邦98購01,,,,,0.00,0.00,0,0,0,0,0,0,0,0,0,0,0,0,0
20200528,052153,GIS富邦96購02,,,,,0.00,0.00,0,0,0,0,0,0,0,0,0,0,0,0,0
20200528,052167,亞泥元大96購01,0.46,0.46,0.42,0.42,-0.07,-14.29,211000,3,89660,0,0,0,0,0,0,211000,0,211000,211000
20200528,052168,鴻海元大96購10,,,,,0.00,0.00,0,0,0,0,0,0,0,0,0,0,0,0,0
20200528,052169,鴻海元大97購02,,,,,0.00,0.00,0,0,0,0,0,0,0,0,0,0,0,0,0
20200528,052176,景碩元大96購01,,,,,0.00,0.00,0,0,0,0,0,0,0,0,0,0,0,0,0
20200528,052178,台郡元大96購03,,,,,0.00,0.00,0,0,0,0,0,0,0,0,0,0,0,0,0
20200528,052180,緯穎元大96購05,5.70,5.70,5.70,5.70,-0.20,-3.39,2000,1,11400,0,0,0,0,0,0,2000,0,2000,2000
20200528,052182,鴻海群益96購01,,,,,0.00,0.00,0,0,0,0,0,0,0,0,0,0,0,0,0
20200528,052189,玉晶光群益96購06,,,,,0.00,0.00,0,0,0,0,0,0,0,0,0,0,0,0,0
20200528,05218P,大立光永昌96售04,,,,,0.00,0.00,0,0,0,0,0,0,0,0,0,0,0,0,0
20200528,052191,超眾群益96購01,,,,,0.00,0.00,0,0,0,0,0,0,0,0,0,0,0,0,0
20200528,052201,超眾統一96購01,2.89,2.89,2.89,2.89,-0.36,-11.08,21000,3,60690,0,0,0,0,0,0,21000,0,21000,21000
20200528,052202,矽力統一96購01,4.76,4.86,4.68,4.86,+0.30,6.58,21000,13,100080,0,0,0,0,0,0,20000,1000,19000,19000
20200528,052203,T50反1中信99購03,0.86,0.92,0.85,0.90,+0.02,2.27,285000,11,251000,0,0,0,0,0,0,100000,185000,-85000,-85000
20200528,052204,台泥中信96購01,,,,,0.00,0.00,0,0,0,0,0,0,0,0,0,0,0,0,0
20200528,052214,智伸科元大96購01,,,,,0.00,0.00,0,0,0,0,0,0,0,0,0,0,0,0,0
20200528,052215,樺漢元大96購02,,,,,0.00,0.00,0,0,0,0,0,0,0,0,0,0,0,0,0
20200528,052216,康友元大96購01,,,,,0.00,0.00,0,0,0,0,0,0,0,0,0,0,0,0,0
20200528,052220,T50反1凱基98購01,1.12,1.14,1.12,1.14,0.00,0.00,10000,2,11300,0,0,0,0,0,0,10000,0,10000,10000
20200528,052223,聯電凱基96購02,0.25,0.28,0.25,0.28,0.00,0.00,300000,12,78000,0,0,0,0,0,0,200000,100000,100000,100000
20200528,052224,楠梓電凱基97購01,,,,,0.00,0.00,0,0,0,0,0,0,0,0,0,0,0,0,0
20200528,052225,台積電凱基96購03,,,,,0.00,0.00,0,0,0,0,0,0,0,0,0,0,0,0,0
20200528,052228,聯發科凱基96購06,,,,,0.00,0.00,0,0,0,0,0,0,0,0,0,0,0,0,0
20200528,052229,奇力新凱基96購01,0.34,0.34,0.34,0.34,-0.06,-15.0,10000,1,3400,0,0,0,0,0,0,10000,0,10000,10000
20200528,052230,大立光凱基96購09,0.59,0.59,0.59,0.59,0.00,0.00,49000,1,28910,0,0,0,0,0,0,49000,0,49000,49000
20200528,052231,景碩凱基96購01,,,,,0.00,0.00,0,0,0,0,0,0,0,0,0,0,0,0,0
20200528,052232,貿聯凱基96購02,,,,,0.00,0.00,0,0,0,0,0,0,0,0,0,0,0,0,0
20200528,052233,台郡凱基96購01,,,,,0.00,0.00,0,0,0,0,0,0,0,0,0,0,0,0,0
20200528,052234,GIS凱基97購01,,,,,0.00,0.00,0,0,0,0,0,0,0,0,0,0,0,0,0
20200528,052235,聯發科國票96購02,1.36,1.42,1.33,1.42,-0.40,-21.98,48000,6,66190,0,0,0,0,0,0,15000,33000,-18000,-18000
20200528,052236,聯發科國票96購03,,,,,0.00,0.00,0,0,0,0,0,0,0,0,0,0,0,0,0
20200528,052237,嘉澤國票96購02,4.61,4.61,4.61,4.61,0.00,0.00,10000,1,46100,0,0,0,0,0,0,10000,0,10000,10000
20200528,052238,智易國票96購01,0.20,0.20,0.20,0.20,0.00,0.00,50000,1,10000,0,0,0,0,0,0,0,50000,-50000,-50000
20200528,052239,泰鼎國票97購01,,,,,0.00,0.00,0,0,0,0,0,0,0,0,0,0,0,0,0
20200528,052240,臻鼎國票96購03,,,,,0.00,0.00,0,0,0,0,0,0,0,0,0,0,0,0,0
20200528,052241,台郡國票96購01,,,,,0.00,0.00,0,0,0,0,0,0,0,0,0,0,0,0,0
20200528,052242,台達電台新96購01,,,,,0.00,0.00,0,0,0,0,0,0,0,0,0,0,0,0,0
20200528,052255,T50反1國泰96購01,,,,,0.00,0.00,0,0,0,0,0,0,0,0,0,0,0,0,0
20200528,052256,台泥國泰96購01,,,,,0.00,0.00,0,0,0,0,0,0,0,0,0,0,0,0,0
20200528,052257,燿華國泰96購01,,,,,0.00,0.00,0,0,0,0,0,0,0,0,0,0,0,0,0
20200528,052258,滬深2X富邦96購04,,,,,0.00,0.00,0,0,0,0,0,0,0,0,0,0,0,0,0
20200528,052260,為升富邦97購02,,,,,0.00,0.00,0,0,0,0,0,0,0,0,0,0,0,0,0
20200528,052264,台達電亞東96購01,,,,,0.00,0.00,0,0,0,0,0,0,0,0,0,0,0,0,0
20200528,052268,新光金亞東96購01,,,,,0.00,0.00,0,0,0,0,0,0,0,0,0,0,0,0,0
20200528,052269,T50反1日盛9B購01,0.65,0.65,0.65,0.65,0.00,0.00,1000,1,650,0,0,0,0,0,0,0,0,0,0
20200528,052276,力成群益96購01,,,,,0.00,0.00,0,0,0,0,0,0,0,0,0,0,0,0,0
20200528,052277,台達電凱基97購01,,,,,0.00,0.00,0,0,0,0,0,0,0,0,0,0,0,0,0
20200528,052281,全新凱基97購01,,,,,0.00,0.00,0,0,0,0,0,0,0,0,0,0,0,0,0
20200528,052283,TPK凱基97購01,,,,,0.00,0.00,0,0,0,0,0,0,0,0,0,0,0,0,0
20200528,052284,日月光凱基96購01,,,,,0.00,0.00,0,0,0,0,0,0,0,0,0,0,0,0,0
20200528,052290,鴻海元富97購01,,,,,0.00,0.00,0,0,0,0,0,0,0,0,0,0,0,0,0
20200528,052291,鴻海元富97購02,,,,,0.00,0.00,0,0,0,0,0,0,0,0,0,0,0,0,0
20200528,052294,創意國票96購03,,,,,0.00,0.00,0,0,0,0,0,0,0,0,0,0,0,0,0
20200528,052295,揚明光國票96購03,0.32,0.32,0.32,0.32,-0.07,-17.95,88000,1,28160,0,0,0,0,0,0,88000,0,88000,88000
20200528,052296,TPK國票96購01,,,,,0.00,0.00,0,0,0,0,0,0,0,0,0,0,0,0,0
20200528,052297,旭富國票96購01,,,,,0.00,0.00,0,0,0,0,0,0,0,0,0,0,0,0,0
20200528,052298,易華電國票96購01,,,,,0.00,0.00,0,0,0,0,0,0,0,0,0,0,0,0,0
20200528,052299,T50反1台新05購03,,,,,0.00,0.00,0,0,0,0,0,0,0,0,0,0,0,0,0
20200528,052306,鴻海國泰97購05,,,,,0.00,0.00,0,0,0,0,0,0,0,0,0,0,0,0,0
20200528,052307,潤泰全國泰96購01,,,,,0.00,0.00,0,0,0,0,0,0,0,0,0,0,0,0,0
20200528,052308,大立光國泰97購02,,,,,0.00,0.00,0,0,0,0,0,0,0,0,0,0,0,0,0
20200528,052309,健策國泰97購01,,,,,0.00,0.00,0,0,0,0,0,0,0,0,0,0,0,0,0
20200528,052312,美律富邦96購02,0.08,0.08,0.08,0.08,0.00,0.00,1000,1,80,0,0,0,0,0,0,1000,0,1000,1000
20200528,052313,聯電元大98購01,0.58,0.63,0.58,0.59,+0.02,3.51,103000,7,61110,0,0,0,0,0,0,27000,56000,-29000,-29000
20200528,052314,鴻海元大96購11,,,,,0.00,0.00,0,0,0,0,0,0,0,0,0,0,0,0,0
20200528,052316,台積電元大96購10,0.10,0.10,0.10,0.10,0.00,0.00,5000,1,500,0,0,0,0,0,0,0,0,0,0
20200528,052317,台積電元大96購11,0.23,0.23,0.23,0.23,0.00,0.00,9000,2,2070,0,0,0,0,0,0,4000,5000,-1000,-1000
20200528,052318,友達元大98購01,,,,,0.00,0.00,0,0,0,0,0,0,0,0,0,0,0,0,0
20200528,052322,力成元大96購01,,,,,0.00,0.00,0,0,0,0,0,0,0,0,0,0,0,0,0
20200528,052324,康友元大96購02,,,,,0.00,0.00,0,0,0,0,0,0,0,0,0,0,0,0,0
20200528,052325,高股息中信99購01,2.08,2.10,2.08,2.10,+0.02,0.96,11000,2,22900,0,0,0,0,0,0,11000,0,11000,11000
20200528,052326,滬深反中信99購01,0.58,0.64,0.58,0.64,+0.03,4.92,13000,3,7630,0,0,0,0,0,0,0,1000,-1000,-1000
20200528,052328,台表科中信99購01,0.55,0.55,0.48,0.48,-0.20,-29.41,107000,18,53740,11000,0,11000,0,0,0,29000,0,29000,40000
20200528,052329,台積電亞東96購01,,,,,0.00,0.00,0,0,0,0,0,0,0,0,0,0,0,0,0
20200528,052331,漢唐亞東97購01,1.91,1.91,1.91,1.91,0.00,0.00,90000,2,171900,0,0,0,0,0,0,90000,0,90000,90000
20200528,052332,美律亞東96購01,,,,,0.00,0.00,0,0,0,0,0,0,0,0,0,0,0,0,0
20200528,052333,嘉聯益兆豐96購01,,,,,0.00,0.00,0,0,0,0,0,0,0,0,0,0,0,0,0
20200528,052338,道瓊反凱基97購02,,,,,0.00,0.00,0,0,0,0,0,0,0,0,0,0,0,0,0
20200528,052340,燿華凱基96購01,,,,,0.00,0.00,0,0,0,0,0,0,0,0,0,0,0,0,0
20200528,052341,泰鼎凱基96購02,,,,,0.00,0.00,0,0,0,0,0,0,0,0,0,0,0,0,0
20200528,052342,茂林凱基96購01,0.74,0.76,0.64,0.64,-0.08,-11.11,157000,32,112260,0,0,0,0,0,0,155000,2000,153000,153000
20200528,052344,台表科凱基98購01,,,,,0.00,0.00,0,0,0,0,0,0,0,0,0,0,0,0,0
20200528,052350,鴻海統一96購06,,,,,0.00,0.00,0,0,0,0,0,0,0,0,0,0,0,0,0
20200528,052353,高鐵群益97購01,,,,,0.00,0.00,0,0,0,0,0,0,0,0,0,0,0,0,0
20200528,052354,健策群益96購02,1.38,1.38,1.38,1.38,-0.29,-17.37,10000,1,13800,0,0,0,0,0,0,10000,0,10000,10000
20200528,052360,FB上証國票96購01,,,,,0.00,0.00,0,0,0,0,0,0,0,0,0,0,0,0,0
20200528,052361,大成鋼國票96購01,,,,,0.00,0.00,0,0,0,0,0,0,0,0,0,0,0,0,0
20200528,052362,瑞昱國票96購02,1.33,1.33,1.31,1.31,0.00,0.00,61000,2,80370,0,0,0,0,0,0,0,61000,-61000,-61000
20200528,052363,廣達國票96購01,,,,,0.00,0.00,0,0,0,0,0,0,0,0,0,0,0,0,0
20200528,052366,聯詠國票96購01,,,,,0.00,0.00,0,0,0,0,0,0,0,0,0,0,0,0,0
20200528,052367,聯茂國票96購02,0.61,0.61,0.61,0.61,+0.07,12.96,75000,4,45750,0,0,0,0,0,0,0,75000,-75000,-75000
20200528,052368,力成國票96購01,,,,,0.00,0.00,0,0,0,0,0,0,0,0,0,0,0,0,0
20200528,052369,矽力國票96購02,,,,,0.00,0.00,0,0,0,0,0,0,0,0,0,0,0,0,0
20200528,052375,奇力新元大96購02,,,,,0.00,0.00,0,0,0,0,0,0,0,0,0,0,0,0,0
20200528,052377,景碩元大96購02,,,,,0.00,0.00,0,0,0,0,0,0,0,0,0,0,0,0,0
20200528,052378,矽力元大96購01,12.90,12.90,12.90,12.90,0.00,0.00,4000,1,51600,0,0,0,0,0,0,0,4000,-4000,-4000
20200528,052385,滬深2X群益99購05,,,,,0.00,0.00,0,0,0,0,0,0,0,0,0,0,0,0,0
20200528,052386,鴻海群益96購02,,,,,0.00,0.00,0,0,0,0,0,0,0,0,0,0,0,0,0
20200528,052388,旺宏群益96購05,1.70,1.70,1.45,1.45,-0.24,-14.2,220000,7,332490,0,0,0,0,0,0,192000,18000,174000,174000
20200528,052392,台表科群益96購02,,,,,0.00,0.00,0,0,0,0,0,0,0,0,0,0,0,0,0
20200528,052395,上証2X凱基97購01,,,,,0.00,0.00,0,0,0,0,0,0,0,0,0,0,0,0,0
20200528,052396,台積電凱基97購01,,,,,0.00,0.00,0,0,0,0,0,0,0,0,0,0,0,0,0
20200528,052397,燿華凱基96購02,,,,,0.00,0.00,0,0,0,0,0,0,0,0,0,0,0,0,0
20200528,052400,聯詠凱基97購01,,,,,0.00,0.00,0,0,0,0,0,0,0,0,0,0,0,0,0
20200528,052402,健策凱基97購01,,,,,0.00,0.00,0,0,0,0,0,0,0,0,0,0,0,0,0
20200528,052403,麗豐凱基96購01,,,,,0.00,0.00,0,0,0,0,0,0,0,0,0,0,0,0,0
20200528,05240P,玉晶光永豐96售01,0.07,0.07,0.07,0.07,0.00,0.00,93000,1,6510,0,0,0,0,0,0,93000,0,93000,93000
20200528,052410,智邦亞東96購01,,,,,0.00,0.00,0,0,0,0,0,0,0,0,0,0,0,0,0
20200528,052412,上証2X中信98購01,,,,,0.00,0.00,0,0,0,0,0,0,0,0,0,0,0,0,0
20200528,052413,上証反中信97購01,0.92,0.92,0.89,0.90,-0.03,-3.23,139000,3,126670,0,0,0,0,0,0,95000,44000,51000,51000
20200528,052416,滬深2X兆豐96購02,,,,,0.00,0.00,0,0,0,0,0,0,0,0,0,0,0,0,0
20200528,052417,聯發科兆豐9B購01,,,,,0.00,0.00,0,0,0,0,0,0,0,0,0,0,0,0,0
20200528,052418,玉晶光兆豐96購01,1.40,1.43,1.36,1.36,+0.07,5.43,16000,3,22090,0,0,0,0,0,0,3000,10000,-7000,-7000
20200528,052419,上証2X國票96購02,,,,,0.00,0.00,0,0,0,0,0,0,0,0,0,0,0,0,0
20200528,05241P,鴻海國泰97售04,2.50,2.50,2.43,2.43,-0.16,-6.18,90000,9,221500,0,0,0,0,0,0,90000,90000,0,0
20200528,052420,道瓊反國票9B購01,,,,,0.00,0.00,0,0,0,0,0,0,0,0,0,0,0,0,0
20200528,052421,元油反國票9B購01,,,,,0.00,0.00,0,0,0,0,0,0,0,0,0,0,0,0,0
20200528,052422,聯電國票96購03,,,,,0.00,0.00,0,0,0,0,0,0,0,0,0,0,0,0,0
20200528,052423,宏達電國票96購02,,,,,0.00,0.00,0,0,0,0,0,0,0,0,0,0,0,0,0
20200528,052424,泰碩國票97購01,0.77,0.77,0.77,0.77,-0.05,-6.1,1000,1,770,0,0,0,0,0,0,0,1000,-1000,-1000
20200528,052426,國巨台新96購01,,,,,0.00,0.00,0,0,0,0,0,0,0,0,0,0,0,0,0
20200528,052427,上証2X永豐96購01,,,,,0.00,0.00,0,0,0,0,0,0,0,0,0,0,0,0,0
20200528,05242P,群創國泰97售01,0.76,0.83,0.76,0.83,+0.04,5.06,329000,14,263190,0,0,0,0,0,0,65000,264000,-199000,-199000
20200528,052433,滬深2X國泰96購02,0.15,0.15,0.11,0.11,0.00,0.00,25000,2,3150,0,0,0,0,0,0,10000,15000,-5000,-5000
20200528,052434,茂林國泰97購01,1.66,1.66,1.48,1.50,-0.16,-9.64,136000,18,211560,0,0,0,0,0,0,106000,30000,76000,76000
20200528,052435,滬深2X富邦96購05,,,,,0.00,0.00,0,0,0,0,0,0,0,0,0,0,0,0,0
20200528,052437,聯發科富邦99購02,,,,,0.00,0.00,0,0,0,0,0,0,0,0,0,0,0,0,0
20200528,052439,寶成富邦97購01,,,,,0.00,0.00,0,0,0,0,0,0,0,0,0,0,0,0,0
20200528,052446,聯發科元大96購03,,,,,0.00,0.00,0,0,0,0,0,0,0,0,0,0,0,0,0
20200528,052447,聯發科元大96購04,3.00,3.00,2.62,2.75,-0.14,-4.84,169000,12,455920,0,0,0,0,0,0,11000,159000,-148000,-148000
20200528,052448,新光金元大96購03,,,,,0.00,0.00,0,0,0,0,0,0,0,0,0,0,0,0,0
20200528,052455,樺漢元大96購03,,,,,0.00,0.00,0,0,0,0,0,0,0,0,0,0,0,0,0
20200528,052456,滬深2X元富9B購03,0.26,0.26,0.26,0.26,0.00,0.00,3000,1,780,0,0,0,0,0,0,3000,0,3000,3000
20200528,052458,T50反1統一97購01,0.65,0.73,0.65,0.73,0.00,0.00,529000,4,346250,0,0,0,0,0,0,499000,30000,469000,469000
20200528,052463,聯電統一96購01,0.43,0.43,0.43,0.43,+0.02,4.88,14000,1,6020,0,0,0,0,0,0,0,14000,-14000,-14000
20200528,052467,嘉聯益統一96購01,0.02,0.02,0.02,0.02,0.00,0.00,93000,1,1860,0,0,0,0,0,0,93000,0,93000,93000
20200528,052468,超眾統一96購02,0.98,1.01,0.93,1.01,-0.10,-9.01,594000,18,576940,0,0,0,0,0,0,422000,172000,250000,250000
20200528,052470,華新科亞東97購01,2.10,2.10,2.10,2.10,0.00,0.00,20000,1,42000,0,0,0,0,0,0,20000,20000,0,0
20200528,052475,滬深2X群益99購06,,,,,0.00,0.00,0,0,0,0,0,0,0,0,0,0,0,0,0
20200528,052476,台光電群益98購01,0.99,0.99,0.99,0.99,-0.15,-13.16,10000,1,9900,0,0,0,0,0,0,10000,0,10000,10000
20200528,052477,美律群益98購01,,,,,0.00,0.00,0,0,0,0,0,0,0,0,0,0,0,0,0
20200528,052485,深中小國票96購01,,,,,0.00,0.00,0,0,0,0,0,0,0,0,0,0,0,0,0
20200528,052486,元油反國票96購01,,,,,0.00,0.00,0,0,0,0,0,0,0,0,0,0,0,0,0
20200528,052487,國巨國票96購07,,,,,0.00,0.00,0,0,0,0,0,0,0,0,0,0,0,0,0
20200528,052488,旺宏國票96購03,1.89,1.95,1.89,1.95,+0.07,3.72,88000,9,169370,0,0,0,0,0,0,88000,0,88000,88000
20200528,052489,義隆國票96購02,1.32,1.32,1.32,1.32,+0.10,8.2,29000,1,38280,0,0,0,0,0,0,29000,0,29000,29000
20200528,05248P,矽創群益96售01,,,,,0.00,0.00,0,0,0,0,0,0,0,0,0,0,0,0,0
20200528,052491,泰碩國票99購01,,,,,0.00,0.00,0,0,0,0,0,0,0,0,0,0,0,0,0
20200528,052492,易華電國票96購02,,,,,0.00,0.00,0,0,0,0,0,0,0,0,0,0,0,0,0
20200528,052493,上証2X中信97購02,,,,,0.00,0.00,0,0,0,0,0,0,0,0,0,0,0,0,0
20200528,052496,華通台新96購02,,,,,0.00,0.00,0,0,0,0,0,0,0,0,0,0,0,0,0
20200528,052497,楠梓電永豐96購01,,,,,0.00,0.00,0,0,0,0,0,0,0,0,0,0,0,0,0
20200528,052505,友達日盛9B購02,,,,,0.00,0.00,0,0,0,0,0,0,0,0,0,0,0,0,0
20200528,052509,鴻海凱基96購10,,,,,0.00,0.00,0,0,0,0,0,0,0,0,0,0,0,0,0
20200528,05250P,臻鼎國票96售01,,,,,0.00,0.00,0,0,0,0,0,0,0,0,0,0,0,0,0
20200528,052512,全新凱基96購03,,,,,0.00,0.00,0,0,0,0,0,0,0,0,0,0,0,0,0
20200528,052514,嘉澤凱基96購01,,,,,0.00,0.00,0,0,0,0,0,0,0,0,0,0,0,0,0
20200528,052521,友達元大9B購01,,,,,0.00,0.00,0,0,0,0,0,0,0,0,0,0,0,0,0
20200528,052522,聯發科元大96購05,,,,,0.00,0.00,0,0,0,0,0,0,0,0,0,0,0,0,0
20200528,052523,奇力新元大97購01,0.50,0.50,0.50,0.50,0.00,0.00,1000,1,500,0,0,0,0,0,0,0,1000,-1000,-1000
20200528,052524,新光金元大9B購01,,,,,0.00,0.00,0,0,0,0,0,0,0,0,0,0,0,0,0
20200528,052526,智伸科元大96購02,,,,,0.00,0.00,0,0,0,0,0,0,0,0,0,0,0,0,0
20200528,052527,泰鼎元大96購02,,,,,0.00,0.00,0,0,0,0,0,0,0,0,0,0,0,0,0
20200528,052530,台郡元大96購04,,,,,0.00,0.00,0,0,0,0,0,0,0,0,0,0,0,0,0
20200528,052531,台積電國泰96購06,,,,,0.00,0.00,0,0,0,0,0,0,0,0,0,0,0,0,0
20200528,052532,台積電國泰96購07,,,,,0.00,0.00,0,0,0,0,0,0,0,0,0,0,0,0,0
20200528,052533,聯發科國泰96購03,,,,,0.00,0.00,0,0,0,0,0,0,0,0,0,0,0,0,0
20200528,052534,貿聯國泰96購02,,,,,0.00,0.00,0,0,0,0,0,0,0,0,0,0,0,0,0
20200528,052535,日月光國泰96購01,,,,,0.00,0.00,0,0,0,0,0,0,0,0,0,0,0,0,0
20200528,052536,聯茂國泰97購01,,,,,0.00,0.00,0,0,0,0,0,0,0,0,0,0,0,0,0
20200528,052542,友達元富98購01,,,,,0.00,0.00,0,0,0,0,0,0,0,0,0,0,0,0,0
20200528,052546,友達中信98購01,,,,,0.00,0.00,0,0,0,0,0,0,0,0,0,0,0,0,0
20200528,052547,光磊兆豐96購01,,,,,0.00,0.00,0,0,0,0,0,0,0,0,0,0,0,0,0
20200528,052548,旺宏亞東96購01,,,,,0.00,0.00,0,0,0,0,0,0,0,0,0,0,0,0,0
20200528,052549,喬山國票97購01,,,,,0.00,0.00,0,0,0,0,0,0,0,0,0,0,0,0,0
20200528,052550,鴻海國票97購02,,,,,0.00,0.00,0,0,0,0,0,0,0,0,0,0,0,0,0
20200528,052551,台積電國票97購03,,,,,0.00,0.00,0,0,0,0,0,0,0,0,0,0,0,0,0
20200528,052552,智邦國票97購01,,,,,0.00,0.00,0,0,0,0,0,0,0,0,0,0,0,0,0
20200528,052553,技嘉國票96購01,,,,,0.00,0.00,0,0,0,0,0,0,0,0,0,0,0,0,0
20200528,052554,正崴國票97購01,,,,,0.00,0.00,0,0,0,0,0,0,0,0,0,0,0,0,0
20200528,052555,漢唐國票97購01,,,,,0.00,0.00,0,0,0,0,0,0,0,0,0,0,0,0,0
20200528,052556,聯發科國票97購01,,,,,0.00,0.00,0,0,0,0,0,0,0,0,0,0,0,0,0
20200528,052557,群創國票97購02,,,,,0.00,0.00,0,0,0,0,0,0,0,0,0,0,0,0,0
20200528,052558,新唐國票97購01,,,,,0.00,0.00,0,0,0,0,0,0,0,0,0,0,0,0,0
20200528,052559,茂林國票97購01,,,,,0.00,0.00,0,0,0,0,0,0,0,0,0,0,0,0,0
20200528,052560,康舒國票97購01,,,,,0.00,0.00,0,0,0,0,0,0,0,0,0,0,0,0,0
20200528,052561,矽創國票97購01,0.59,0.69,0.59,0.59,+0.05,9.26,249000,5,154940,0,0,0,0,0,0,103000,146000,-43000,-43000
20200528,052562,南亞科日盛96購01,0.01,0.01,0.01,0.01,0.00,0.00,20000,1,200,0,0,0,0,0,0,20000,0,20000,20000
20200528,052563,京元電日盛96購01,,,,,0.00,0.00,0,0,0,0,0,0,0,0,0,0,0,0,0
20200528,052564,美食日盛96購01,,,,,0.00,0.00,0,0,0,0,0,0,0,0,0,0,0,0,0
20200528,052565,上銀凱基96購01,1.08,1.08,1.01,1.01,0.00,0.00,175000,4,180000,0,0,0,0,0,0,175000,175000,0,0
20200528,052566,國巨凱基96購04,0.10,0.10,0.10,0.10,0.00,0.00,220000,1,22000,0,0,0,0,0,0,220000,220000,0,0
20200528,052567,台積電凱基96購05,,,,,0.00,0.00,0,0,0,0,0,0,0,0,0,0,0,0,0
20200528,052568,漢唐凱基96購02,,,,,0.00,0.00,0,0,0,0,0,0,0,0,0,0,0,0,0
20200528,052569,聯發科凱基96購08,,,,,0.00,0.00,0,0,0,0,0,0,0,0,0,0,0,0,0
20200528,052570,華新科凱基96購06,,,,,0.00,0.00,0,0,0,0,0,0,0,0,0,0,0,0,0
20200528,052571,新光金凱基98購02,,,,,0.00,0.00,0,0,0,0,0,0,0,0,0,0,0,0,0
20200528,052572,群創凱基99購01,,,,,0.00,0.00,0,0,0,0,0,0,0,0,0,0,0,0,0
20200528,052573,智伸科凱基97購01,,,,,0.00,0.00,0,0,0,0,0,0,0,0,0,0,0,0,0
20200528,052574,茂林凱基96購02,,,,,0.00,0.00,0,0,0,0,0,0,0,0,0,0,0,0,0
20200528,052575,茂林凱基96購04,,,,,0.00,0.00,0,0,0,0,0,0,0,0,0,0,0,0,0
20200528,052576,聯茂凱基96購01,,,,,0.00,0.00,0,0,0,0,0,0,0,0,0,0,0,0,0
20200528,052577,台積電統一96購01,,,,,0.00,0.00,0,0,0,0,0,0,0,0,0,0,0,0,0
20200528,052578,大立光統一97購01,,,,,0.00,0.00,0,0,0,0,0,0,0,0,0,0,0,0,0
20200528,052579,亞泥元富96購01,,,,,0.00,0.00,0,0,0,0,0,0,0,0,0,0,0,0,0
20200528,052580,高鐵元富96購01,,,,,0.00,0.00,0,0,0,0,0,0,0,0,0,0,0,0,0
20200528,052581,訊芯元富98購01,,,,,0.00,0.00,0,0,0,0,0,0,0,0,0,0,0,0,0
20200528,052582,喬山台新96購01,,,,,0.00,0.00,0,0,0,0,0,0,0,0,0,0,0,0,0
20200528,052583,友達台新96購02,,,,,0.00,0.00,0,0,0,0,0,0,0,0,0,0,0,0,0
20200528,052584,喬山永豐96購01,,,,,0.00,0.00,0,0,0,0,0,0,0,0,0,0,0,0,0
20200528,052585,友達永豐97購01,0.03,0.03,0.03,0.03,-0.02,-40.0,40000,1,1200,0,0,0,0,0,0,40000,0,40000,40000
20200528,052586,晶豪科永豐96購01,,,,,0.00,0.00,0,0,0,0,0,0,0,0,0,0,0,0,0
20200528,052587,景碩永豐97購01,,,,,0.00,0.00,0,0,0,0,0,0,0,0,0,0,0,0,0
20200528,052588,玉晶光永豐98購01,,,,,0.00,0.00,0,0,0,0,0,0,0,0,0,0,0,0,0
20200528,052589,群創永豐97購01,,,,,0.00,0.00,0,0,0,0,0,0,0,0,0,0,0,0,0
20200528,05258P,臺股指凱基96售11,,,,,0.00,0.00,0,0,0,0,0,0,0,0,0,0,0,0,0
20200528,052590,祥碩永豐96購01,,,,,0.00,0.00,0,0,0,0,0,0,0,0,0,0,0,0,0
20200528,052591,康友永豐97購01,,,,,0.00,0.00,0,0,0,0,0,0,0,0,0,0,0,0,0
20200528,052592,華通群益98購01,,,,,0.00,0.00,0,0,0,0,0,0,0,0,0,0,0,0,0
20200528,052593,台積電群益96購02,,,,,0.00,0.00,0,0,0,0,0,0,0,0,0,0,0,0,0
20200528,052594,友訊群益98購01,,,,,0.00,0.00,0,0,0,0,0,0,0,0,0,0,0,0,0
20200528,052595,奇力新群益96購01,,,,,0.00,0.00,0,0,0,0,0,0,0,0,0,0,0,0,0
20200528,052596,群創群益98購05,,,,,0.00,0.00,0,0,0,0,0,0,0,0,0,0,0,0,0
20200528,052597,茂林群益96購01,,,,,0.00,0.00,0,0,0,0,0,0,0,0,0,0,0,0,0
20200528,052598,滬深2X元大96購05,,,,,0.00,0.00,0,0,0,0,0,0,0,0,0,0,0,0,0
20200528,052599,S&P反1元大96購01,,,,,0.00,0.00,0,0,0,0,0,0,0,0,0,0,0,0,0
20200528,05259P,臺股指凱基96售12,,,,,0.00,0.00,0,0,0,0,0,0,0,0,0,0,0,0,0
20200528,052600,力山元大97購01,,,,,0.00,0.00,0,0,0,0,0,0,0,0,0,0,0,0,0
20200528,052601,大成鋼元大96購01,,,,,0.00,0.00,0,0,0,0,0,0,0,0,0,0,0,0,0
20200528,052602,聯電元大97購01,0.10,0.12,0.10,0.12,+0.01,9.09,2006000,66,200800,0,0,0,0,0,0,2006000,0,2006000,2006000
20200528,052603,鴻海元大96購15,,,,,0.00,0.00,0,0,0,0,0,0,0,0,0,0,0,0,0
20200528,052604,建準元大97購01,,,,,0.00,0.00,0,0,0,0,0,0,0,0,0,0,0,0,0
20200528,052605,聯發科元大96購06,,,,,0.00,0.00,0,0,0,0,0,0,0,0,0,0,0,0,0
20200528,052606,聯發科元大97購04,,,,,0.00,0.00,0,0,0,0,0,0,0,0,0,0,0,0,0
20200528,052607,大立光元大96購03,,,,,0.00,0.00,0,0,0,0,0,0,0,0,0,0,0,0,0
20200528,052608,欣興元大97購01,,,,,0.00,0.00,0,0,0,0,0,0,0,0,0,0,0,0,0
20200528,052609,智易元大97購01,,,,,0.00,0.00,0,0,0,0,0,0,0,0,0,0,0,0,0
20200528,052610,貿聯元大97購01,,,,,0.00,0.00,0,0,0,0,0,0,0,0,0,0,0,0,0
20200528,052611,力成元大96購02,0.30,0.30,0.30,0.30,0.00,0.00,25000,1,7500,0,0,0,0,0,0,25000,0,25000,25000
20200528,052612,康舒元大97購01,,,,,0.00,0.00,0,0,0,0,0,0,0,0,0,0,0,0,0
20200528,052613,易華電元大96購01,,,,,0.00,0.00,0,0,0,0,0,0,0,0,0,0,0,0,0
20200528,052614,聯電國泰97購01,0.39,0.47,0.39,0.43,0.00,0.00,189000,7,79070,0,0,0,0,0,0,100000,89000,11000,11000
20200528,052615,鴻海國泰98購01,,,,,0.00,0.00,0,0,0,0,0,0,0,0,0,0,0,0,0
20200528,052616,鴻海國泰98購02,,,,,0.00,0.00,0,0,0,0,0,0,0,0,0,0,0,0,0
20200528,052617,景碩國泰98購01,0.44,0.44,0.44,0.44,-0.05,-10.2,5000,1,2200,0,0,0,0,0,0,0,5000,-5000,-5000
20200528,052618,群創國泰98購01,,,,,0.00,0.00,0,0,0,0,0,0,0,0,0,0,0,0,0
20200528,052619,茂林國泰99購01,1.30,1.31,1.29,1.30,+0.07,5.69,104000,10,135190,0,0,0,0,0,0,104000,0,104000,104000
20200528,052620,上証2X富邦97購02,,,,,0.00,0.00,0,0,0,0,0,0,0,0,0,0,0,0,0
20200528,052621,台郡富邦97購01,0.04,0.04,0.04,0.04,0.00,0.00,1000,1,40,0,0,0,0,0,0,1000,0,1000,1000
20200528,052622,貿聯兆豐97購01,,,,,0.00,0.00,0,0,0,0,0,0,0,0,0,0,0,0,0
20200528,052623,台郡兆豐96購01,,,,,0.00,0.00,0,0,0,0,0,0,0,0,0,0,0,0,0
20200528,052624,微星亞東97購01,1.75,1.85,1.75,1.85,+0.10,5.71,16000,2,28600,0,0,0,0,0,0,0,16000,-16000,-16000
20200528,052625,南電亞東97購01,,,,,0.00,0.00,0,0,0,0,0,0,0,0,0,0,0,0,0
20200528,052626,上証2X中信9A購01,,,,,0.00,0.00,0,0,0,0,0,0,0,0,0,0,0,0,0
20200528,052627,中壽中信98購01,,,,,0.00,0.00,0,0,0,0,0,0,0,0,0,0,0,0,0
20200528,052628,樺漢中信96購01,,,,,0.00,0.00,0,0,0,0,0,0,0,0,0,0,0,0,0
20200528,052629,訊芯中信99購01,0.04,0.04,0.04,0.04,0.00,0.00,2000,2,80,0,0,0,0,0,0,2000,0,2000,2000
20200528,052630,滬深2X日盛96購01,,,,,0.00,0.00,0,0,0,0,0,0,0,0,0,0,0,0,0
20200528,052631,T50反1凱基98購02,,,,,0.00,0.00,0,0,0,0,0,0,0,0,0,0,0,0,0
20200528,052632,喬山凱基96購01,,,,,0.00,0.00,0,0,0,0,0,0,0,0,0,0,0,0,0
20200528,052633,國巨凱基96購05,,,,,0.00,0.00,0,0,0,0,0,0,0,0,0,0,0,0,0
20200528,052634,華邦電凱基96購01,,,,,0.00,0.00,0,0,0,0,0,0,0,0,0,0,0,0,0
20200528,052635,奇力新凱基98購01,,,,,0.00,0.00,0,0,0,0,0,0,0,0,0,0,0,0,0
20200528,052636,大立光凱基96購10,,,,,0.00,0.00,0,0,0,0,0,0,0,0,0,0,0,0,0
20200528,052637,欣興凱基97購01,,,,,0.00,0.00,0,0,0,0,0,0,0,0,0,0,0,0,0
20200528,052638,緯創凱基96購02,,,,,0.00,0.00,0,0,0,0,0,0,0,0,0,0,0,0,0
20200528,052639,康控凱基96購02,,,,,0.00,0.00,0,0,0,0,0,0,0,0,0,0,0,0,0
20200528,05263P,台積電元大96售09,0.77,0.77,0.69,0.69,0.00,0.00,152000,2,105040,0,0,0,0,0,0,150000,152000,-2000,-2000
20200528,052640,台表科凱基97購01,,,,,0.00,0.00,0,0,0,0,0,0,0,0,0,0,0,0,0
20200528,052641,聯詠台新96購01,,,,,0.00,0.00,0,0,0,0,0,0,0,0,0,0,0,0,0
20200528,052642,滬深2X永豐96購03,,,,,0.00,0.00,0,0,0,0,0,0,0,0,0,0,0,0,0
20200528,052643,華通永豐96購02,,,,,0.00,0.00,0,0,0,0,0,0,0,0,0,0,0,0,0
20200528,052644,聯發科永豐96購01,,,,,0.00,0.00,0,0,0,0,0,0,0,0,0,0,0,0,0
20200528,052645,美食永豐96購01,,,,,0.00,0.00,0,0,0,0,0,0,0,0,0,0,0,0,0
20200528,052646,淘帝永豐96購01,,,,,0.00,0.00,0,0,0,0,0,0,0,0,0,0,0,0,0
20200528,052647,晶技永豐97購01,3.34,3.35,3.32,3.34,-0.40,-10.7,58000,8,193440,0,0,0,0,0,0,58000,0,58000,58000
20200528,052648,茂林永豐96購01,,,,,0.00,0.00,0,0,0,0,0,0,0,0,0,0,0,0,0
20200528,052649,康控永豐96購01,,,,,0.00,0.00,0,0,0,0,0,0,0,0,0,0,0,0,0
20200528,052650,台郡永豐96購01,,,,,0.00,0.00,0,0,0,0,0,0,0,0,0,0,0,0,0
20200528,052651,台表科永豐96購02,,,,,0.00,0.00,0,0,0,0,0,0,0,0,0,0,0,0,0
20200528,052652,台虹永豐96購01,,,,,0.00,0.00,0,0,0,0,0,0,0,0,0,0,0,0,0
20200528,052653,臺股指永豐97購01,,,,,0.00,0.00,0,0,0,0,0,0,0,0,0,0,0,0,0
20200528,052654,友達統一97購01,,,,,0.00,0.00,0,0,0,0,0,0,0,0,0,0,0,0,0
20200528,052655,群創統一97購01,,,,,0.00,0.00,0,0,0,0,0,0,0,0,0,0,0,0,0
20200528,052656,力山元富96購01,,,,,0.00,0.00,0,0,0,0,0,0,0,0,0,0,0,0,0
20200528,052657,友達元富96購01,,,,,0.00,0.00,0,0,0,0,0,0,0,0,0,0,0,0,0
20200528,052658,友達元富9C購01,,,,,0.00,0.00,0,0,0,0,0,0,0,0,0,0,0,0,0
20200528,052659,上証2X國票99購01,0.55,0.55,0.55,0.55,-0.05,-8.33,5000,1,2750,0,0,0,0,0,0,0,5000,-5000,-5000
20200528,052660,京元電國票97購01,,,,,0.00,0.00,0,0,0,0,0,0,0,0,0,0,0,0,0
20200528,052661,奇力新國票97購03,,,,,0.00,0.00,0,0,0,0,0,0,0,0,0,0,0,0,0
20200528,052662,華新科國票97購01,0.77,0.77,0.77,0.77,0.00,0.00,15000,1,11550,0,0,0,0,0,0,15000,15000,0,0
20200528,052663,奇鋐國票97購01,,,,,0.00,0.00,0,0,0,0,0,0,0,0,0,0,0,0,0
20200528,052664,麗豐國票96購02,,,,,0.00,0.00,0,0,0,0,0,0,0,0,0,0,0,0,0
20200528,052665,緯穎國票96購03,,,,,0.00,0.00,0,0,0,0,0,0,0,0,0,0,0,0,0
20200528,052666,瑞昱群益96購01,,,,,0.00,0.00,0,0,0,0,0,0,0,0,0,0,0,0,0
20200528,052667,漢唐群益96購01,,,,,0.00,0.00,0,0,0,0,0,0,0,0,0,0,0,0,0
20200528,052668,聯發科群益97購01,,,,,0.00,0.00,0,0,0,0,0,0,0,0,0,0,0,0,0
20200528,052669,群創群益98購06,,,,,0.00,0.00,0,0,0,0,0,0,0,0,0,0,0,0,0
20200528,052670,茂林群益96購02,,,,,0.00,0.00,0,0,0,0,0,0,0,0,0,0,0,0,0
20200528,052671,祥碩群益96購01,,,,,0.00,0.00,0,0,0,0,0,0,0,0,0,0,0,0,0
20200528,052672,世紀鋼群益96購02,,,,,0.00,0.00,0,0,0,0,0,0,0,0,0,0,0,0,0
20200528,052673,T50反1國泰97購01,,,,,0.00,0.00,0,0,0,0,0,0,0,0,0,0,0,0,0
20200528,052674,智邦國泰98購01,,,,,0.00,0.00,0,0,0,0,0,0,0,0,0,0,0,0,0
20200528,052675,新光金國泰98購01,,,,,0.00,0.00,0,0,0,0,0,0,0,0,0,0,0,0,0
20200528,052676,聯發科永昌98購01,2.85,2.85,2.85,2.85,-0.35,-10.94,50000,2,142500,0,0,0,0,0,0,50000,50000,0,0
20200528,052677,景碩富邦97購01,0.01,0.01,0.01,0.01,0.00,0.00,1000,1,10,0,0,0,0,0,0,0,0,0,0
20200528,052678,群創富邦96購01,,,,,0.00,0.00,0,0,0,0,0,0,0,0,0,0,0,0,0
20200528,052679,致伸富邦98購01,,,,,0.00,0.00,0,0,0,0,0,0,0,0,0,0,0,0,0
20200528,052680,T50反1元大96購04,,,,,0.00,0.00,0,0,0,0,0,0,0,0,0,0,0,0,0
20200528,052681,T50反1元大98購02,0.91,0.98,0.90,0.97,+0.02,2.11,176000,10,164720,0,0,0,0,0,0,116000,60000,56000,56000
20200528,052682,上銀元大97購01,,,,,0.00,0.00,0,0,0,0,0,0,0,0,0,0,0,0,0
20200528,052683,鴻海元大97購03,,,,,0.00,0.00,0,0,0,0,0,0,0,0,0,0,0,0,0
20200528,052684,旺宏元大98購01,0.36,0.36,0.36,0.36,-0.09,-20.0,10000,1,3600,0,0,0,0,0,0,0,0,0,0
20200528,052685,技嘉元大96購01,,,,,0.00,0.00,0,0,0,0,0,0,0,0,0,0,0,0,0
20200528,052686,華新科元大96購03,0.80,0.80,0.70,0.70,-0.18,-20.45,99000,2,74300,0,0,0,0,0,0,99000,0,99000,99000
20200528,052687,國泰金元大96購03,,,,,0.00,0.00,0,0,0,0,0,0,0,0,0,0,0,0,0
20200528,052688,新日興元大96購01,,,,,0.00,0.00,0,0,0,0,0,0,0,0,0,0,0,0,0
20200528,052689,玉晶光元大98購03,,,,,0.00,0.00,0,0,0,0,0,0,0,0,0,0,0,0,0
20200528,05268P,玉晶光元大98售01,0.52,0.70,0.52,0.68,-0.02,-2.86,8000,4,5000,0,0,0,0,0,0,0,0,0,0
20200528,052690,台表科元大97購01,,,,,0.00,0.00,0,0,0,0,0,0,0,0,0,0,0,0,0
20200528,052691,GIS元大96購01,,,,,0.00,0.00,0,0,0,0,0,0,0,0,0,0,0,0,0
20200528,052692,滬深2X中信99購02,,,,,0.00,0.00,0,0,0,0,0,0,0,0,0,0,0,0,0
20200528,052693,微星中信96購01,,,,,0.00,0.00,0,0,0,0,0,0,0,0,0,0,0,0,0
20200528,052694,開發金中信98購01,0.19,0.19,0.19,0.19,-0.02,-9.52,30000,3,5700,0,0,0,0,0,0,0,30000,-30000,-30000
20200528,052695,台表科中信98購01,0.13,0.13,0.13,0.13,0.00,0.00,15000,1,1950,0,0,0,0,0,0,0,0,0,0
20200528,052696,玉晶光麥證97購01,2.68,2.92,2.61,2.61,+0.12,4.82,49000,25,135570,1000,48000,-47000,0,0,0,22000,49000,-27000,-27000
20200528,052697,滬深2X國票98購01,,,,,0.00,0.00,0,0,0,0,0,0,0,0,0,0,0,0,0
20200528,052698,深中小國票99購01,,,,,0.00,0.00,0,0,0,0,0,0,0,0,0,0,0,0,0
20200528,052699,友達國票97購01,,,,,0.00,0.00,0,0,0,0,0,0,0,0,0,0,0,0,0
20200528,052700,奇鋐國票97購02,0.33,0.39,0.29,0.29,+0.04,16.0,568000,11,189930,0,0,0,0,0,0,370000,198000,172000,172000
20200528,052701,群創國票96購01,,,,,0.00,0.00,0,0,0,0,0,0,0,0,0,0,0,0,0
20200528,052702,群創國票97購03,0.05,0.05,0.05,0.05,-0.03,-37.5,150000,1,7500,0,0,0,0,0,0,150000,0,150000,150000
20200528,052703,貿聯國票97購01,0.46,0.46,0.46,0.46,-0.01,-2.13,74000,1,34040,0,0,0,0,0,0,74000,0,74000,74000
20200528,052704,TPK國票97購01,0.06,0.06,0.04,0.05,-0.01,-16.67,81000,4,3950,0,0,0,0,0,0,30000,51000,-21000,-21000
20200528,052705,超眾國票97購01,1.70,1.70,1.70,1.70,-0.12,-6.59,10000,1,17000,0,0,0,0,0,0,10000,0,10000,10000
20200528,052706,台虹國票97購01,,,,,0.00,0.00,0,0,0,0,0,0,0,0,0,0,0,0,0
20200528,052707,景碩台新96購01,,,,,0.00,0.00,0,0,0,0,0,0,0,0,0,0,0,0,0
20200528,052708,楠梓電永豐97購01,,,,,0.00,0.00,0,0,0,0,0,0,0,0,0,0,0,0,0
20200528,052709,光寶科日盛96購01,,,,,0.00,0.00,0,0,0,0,0,0,0,0,0,0,0,0,0
20200528,052710,玉晶光日盛96購01,,,,,0.00,0.00,0,0,0,0,0,0,0,0,0,0,0,0,0
20200528,052711,滬深2X凱基97購01,,,,,0.00,0.00,0,0,0,0,0,0,0,0,0,0,0,0,0
20200528,052712,旺宏凱基96購02,0.11,0.11,0.11,0.11,0.00,0.00,40000,1,4400,0,0,0,0,0,0,40000,0,40000,40000
20200528,052713,智邦凱基96購01,,,,,0.00,0.00,0,0,0,0,0,0,0,0,0,0,0,0,0
20200528,052714,義隆凱基96購02,,,,,0.00,0.00,0,0,0,0,0,0,0,0,0,0,0,0,0
20200528,052715,可成凱基96購01,,,,,0.00,0.00,0,0,0,0,0,0,0,0,0,0,0,0,0
20200528,052716,欣興凱基96購01,,,,,0.00,0.00,0,0,0,0,0,0,0,0,0,0,0,0,0
20200528,052717,正文凱基96購01,,,,,0.00,0.00,0,0,0,0,0,0,0,0,0,0,0,0,0
20200528,052718,新唐凱基96購01,,,,,0.00,0.00,0,0,0,0,0,0,0,0,0,0,0,0,0
20200528,052719,致新凱基96購01,,,,,0.00,0.00,0,0,0,0,0,0,0,0,0,0,0,0,0
20200528,05271P,國巨富邦97售01,0.14,0.15,0.14,0.15,+0.06,66.67,22000,4,3190,0,0,0,0,0,0,0,22000,-22000,-22000
20200528,052720,鴻海統一96購07,,,,,0.00,0.00,0,0,0,0,0,0,0,0,0,0,0,0,0
20200528,052721,友達統一96購01,,,,,0.00,0.00,0,0,0,0,0,0,0,0,0,0,0,0,0
20200528,052722,群創統一97購02,,,,,0.00,0.00,0,0,0,0,0,0,0,0,0,0,0,0,0
20200528,052723,新唐統一97購01,,,,,0.00,0.00,0,0,0,0,0,0,0,0,0,0,0,0,0
20200528,052724,力成統一97購01,0.91,0.96,0.91,0.96,+0.04,4.35,40000,6,36900,0,0,0,0,0,0,30000,10000,20000,20000
20200528,052725,為升元富96購01,,,,,0.00,0.00,0,0,0,0,0,0,0,0,0,0,0,0,0
20200528,052726,鴻海元富96購03,,,,,0.00,0.00,0,0,0,0,0,0,0,0,0,0,0,0,0
20200528,052727,仁寶元富96購01,,,,,0.00,0.00,0,0,0,0,0,0,0,0,0,0,0,0,0
20200528,052728,上証2X國泰97購01,0.23,0.23,0.23,0.23,0.00,0.00,60000,1,13800,0,0,0,0,0,0,60000,0,60000,60000
20200528,052729,國巨國泰97購03,1.37,1.37,1.37,1.37,0.00,0.00,20000,2,27400,0,0,0,0,0,0,0,20000,-20000,-20000
20200528,05272P,臻鼎中信97售03,0.15,0.19,0.15,0.19,+0.01,5.56,485000,7,82430,0,0,0,0,0,0,332000,151000,181000,181000
20200528,052730,華新科國泰98購01,,,,,0.00,0.00,0,0,0,0,0,0,0,0,0,0,0,0,0
20200528,052731,宏達電國泰98購01,0.22,0.22,0.22,0.22,-0.08,-26.67,10000,2,2200,0,0,0,0,0,0,0,0,0,0
20200528,052732,新唐國泰97購01,,,,,0.00,0.00,0,0,0,0,0,0,0,0,0,0,0,0,0
20200528,052733,台郡國泰97購01,,,,,0.00,0.00,0,0,0,0,0,0,0,0,0,0,0,0,0
20200528,052734,台表科國泰98購02,,,,,0.00,0.00,0,0,0,0,0,0,0,0,0,0,0,0,0
20200528,052735,燿華富邦98購01,,,,,0.00,0.00,0,0,0,0,0,0,0,0,0,0,0,0,0
20200528,052736,T50反1元大96購05,,,,,0.00,0.00,0,0,0,0,0,0,0,0,0,0,0,0,0
20200528,052737,滬深2X元大96購06,,,,,0.00,0.00,0,0,0,0,0,0,0,0,0,0,0,0,0
20200528,052738,聯電元大98購02,0.56,0.60,0.56,0.60,+0.03,5.26,461000,3,270160,0,0,0,0,0,0,0,461000,-461000,-461000
20200528,052739,國巨元大96購04,1.05,1.05,1.05,1.05,+0.01,0.96,10000,1,10500,0,0,0,0,0,0,10000,0,10000,10000
20200528,052740,聯發科元大96購07,,,,,0.00,0.00,0,0,0,0,0,0,0,0,0,0,0,0,0
20200528,052741,聯發科元大96購08,,,,,0.00,0.00,0,0,0,0,0,0,0,0,0,0,0,0,0
20200528,052742,可成元大96購01,,,,,0.00,0.00,0,0,0,0,0,0,0,0,0,0,0,0,0
20200528,052743,華新科元大97購01,,,,,0.00,0.00,0,0,0,0,0,0,0,0,0,0,0,0,0
20200528,052744,聯詠元大97購01,,,,,0.00,0.00,0,0,0,0,0,0,0,0,0,0,0,0,0
20200528,052745,欣興元大96購04,0.01,0.01,0.01,0.01,0.00,0.00,20000,1,200,0,0,0,0,0,0,20000,20000,0,0
20200528,052746,泰碩元大97購01,,,,,0.00,0.00,0,0,0,0,0,0,0,0,0,0,0,0,0
20200528,052747,京鼎元大97購01,,,,,0.00,0.00,0,0,0,0,0,0,0,0,0,0,0,0,0
20200528,052748,群創元大9A購02,,,,,0.00,0.00,0,0,0,0,0,0,0,0,0,0,0,0,0
20200528,052749,日月光元大96購02,,,,,0.00,0.00,0,0,0,0,0,0,0,0,0,0,0,0,0
20200528,052750,臺股指元大96購04,,,,,0.00,0.00,0,0,0,0,0,0,0,0,0,0,0,0,0
20200528,052751,臺股指元大96購05,,,,,0.00,0.00,0,0,0,0,0,0,0,0,0,0,0,0,0
20200528,052752,臺股指元大96購06,,,,,0.00,0.00,0,0,0,0,0,0,0,0,0,0,0,0,0
20200528,052753,電子類元大96購02,,,,,0.00,0.00,0,0,0,0,0,0,0,0,0,0,0,0,0
20200528,052754,上証2X群益9A購01,,,,,0.00,0.00,0,0,0,0,0,0,0,0,0,0,0,0,0
20200528,052755,滬深2X群益9A購01,,,,,0.00,0.00,0,0,0,0,0,0,0,0,0,0,0,0,0
20200528,052756,國巨群益96購02,,,,,0.00,0.00,0,0,0,0,0,0,0,0,0,0,0,0,0
20200528,052757,華邦電群益96購01,,,,,0.00,0.00,0,0,0,0,0,0,0,0,0,0,0,0,0
20200528,052758,友達群益99購01,,,,,0.00,0.00,0,0,0,0,0,0,0,0,0,0,0,0,0
20200528,052759,京元電群益96購01,,,,,0.00,0.00,0,0,0,0,0,0,0,0,0,0,0,0,0
20200528,052760,盟立群益96購01,,,,,0.00,0.00,0,0,0,0,0,0,0,0,0,0,0,0,0
20200528,052761,可成群益96購02,,,,,0.00,0.00,0,0,0,0,0,0,0,0,0,0,0,0,0
20200528,052762,欣興群益96購01,,,,,0.00,0.00,0,0,0,0,0,0,0,0,0,0,0,0,0
20200528,052763,晶技群益97購01,,,,,0.00,0.00,0,0,0,0,0,0,0,0,0,0,0,0,0
20200528,052764,景碩群益98購01,0.66,0.73,0.66,0.68,+0.02,3.03,227000,4,155770,0,0,0,0,0,0,89000,138000,-49000,-49000
20200528,052765,新日興群益97購01,,,,,0.00,0.00,0,0,0,0,0,0,0,0,0,0,0,0,0
20200528,052766,玉晶光群益9A購01,3.83,3.83,3.61,3.61,+0.14,4.03,12000,12,43820,0,0,0,0,0,0,12000,12000,0,0
20200528,052767,智伸科群益98購01,,,,,0.00,0.00,0,0,0,0,0,0,0,0,0,0,0,0,0
20200528,052768,泰鼎群益96購01,4.53,5.00,4.21,4.42,-0.03,-0.67,9000,9,41400,0,0,0,0,0,0,9000,0,9000,9000
20200528,052769,達興群益96購01,,,,,0.00,0.00,0,0,0,0,0,0,0,0,0,0,0,0,0
20200528,052770,聯茂群益96購02,,,,,0.00,0.00,0,0,0,0,0,0,0,0,0,0,0,0,0
20200528,052771,GIS群益96購01,,,,,0.00,0.00,0,0,0,0,0,0,0,0,0,0,0,0,0
20200528,052772,台虹群益96購01,,,,,0.00,0.00,0,0,0,0,0,0,0,0,0,0,0,0,0
20200528,052773,大成鋼亞東97購01,,,,,0.00,0.00,0,0,0,0,0,0,0,0,0,0,0,0,0
20200528,052774,京元電亞東96購01,,,,,0.00,0.00,0,0,0,0,0,0,0,0,0,0,0,0,0
20200528,052775,滬深2X國票99購02,0.57,0.66,0.56,0.56,-0.02,-3.45,36000,5,21020,0,0,0,0,0,0,0,36000,-36000,-36000
20200528,052776,力山國票97購01,,,,,0.00,0.00,0,0,0,0,0,0,0,0,0,0,0,0,0
20200528,052777,燿華國票98購01,,,,,0.00,0.00,0,0,0,0,0,0,0,0,0,0,0,0,0
20200528,052778,智原國票97購01,,,,,0.00,0.00,0,0,0,0,0,0,0,0,0,0,0,0,0
20200528,052779,欣興國票97購01,,,,,0.00,0.00,0,0,0,0,0,0,0,0,0,0,0,0,0
20200528,052780,玉晶光國票96購04,,,,,0.00,0.00,0,0,0,0,0,0,0,0,0,0,0,0,0
20200528,052781,瀚宇博國票97購03,0.99,1.02,0.99,1.02,-0.02,-1.92,138000,4,139720,0,0,0,0,0,0,100000,38000,62000,62000
20200528,052782,超眾國票96購02,,,,,0.00,0.00,0,0,0,0,0,0,0,0,0,0,0,0,0
20200528,052783,台郡國票97購01,,,,,0.00,0.00,0,0,0,0,0,0,0,0,0,0,0,0,0
20200528,052784,緯穎國票97購02,,,,,0.00,0.00,0,0,0,0,0,0,0,0,0,0,0,0,0
20200528,052785,滬深2X中信99購03,,,,,0.00,0.00,0,0,0,0,0,0,0,0,0,0,0,0,0
20200528,052786,S&P500中信96購01,,,,,0.00,0.00,0,0,0,0,0,0,0,0,0,0,0,0,0
20200528,052787,國巨中信96購02,,,,,0.00,0.00,0,0,0,0,0,0,0,0,0,0,0,0,0
20200528,052788,開發金中信98購02,,,,,0.00,0.00,0,0,0,0,0,0,0,0,0,0,0,0,0
20200528,052789,台積電麥證96購01,0.61,0.61,0.42,0.42,-0.15,-26.32,35000,5,18880,0,20000,-20000,0,0,0,35000,35000,0,0
20200528,052790,智邦兆豐97購01,,,,,0.00,0.00,0,0,0,0,0,0,0,0,0,0,0,0,0
20200528,052791,友達兆豐97購01,,,,,0.00,0.00,0,0,0,0,0,0,0,0,0,0,0,0,0
20200528,052792,大立光兆豐96購01,,,,,0.00,0.00,0,0,0,0,0,0,0,0,0,0,0,0,0
20200528,052793,健鼎兆豐96購01,,,,,0.00,0.00,0,0,0,0,0,0,0,0,0,0,0,0,0
20200528,052794,群創兆豐97購01,,,,,0.00,0.00,0,0,0,0,0,0,0,0,0,0,0,0,0
20200528,052795,健策兆豐97購01,2.12,2.14,1.76,1.76,-0.44,-20.0,118000,23,241980,0,0,0,0,0,0,103000,15000,88000,88000
20200528,052796,和碩兆豐96購01,,,,,0.00,0.00,0,0,0,0,0,0,0,0,0,0,0,0,0
20200528,052797,樺漢兆豐96購01,,,,,0.00,0.00,0,0,0,0,0,0,0,0,0,0,0,0,0
20200528,052798,滬深2X元大96購07,,,,,0.00,0.00,0,0,0,0,0,0,0,0,0,0,0,0,0
20200528,052799,上銀元大96購01,3.36,3.36,3.36,3.36,-0.84,-20.0,8000,1,26880,0,0,0,0,0,0,0,8000,-8000,-8000
20200528,052800,國巨元大96購05,,,,,0.00,0.00,0,0,0,0,0,0,0,0,0,0,0,0,0
20200528,052801,友達元大9A購01,,,,,0.00,0.00,0,0,0,0,0,0,0,0,0,0,0,0,0
20200528,052802,華新科元大97購02,,,,,0.00,0.00,0,0,0,0,0,0,0,0,0,0,0,0,0
20200528,052803,冠德元大96購01,,,,,0.00,0.00,0,0,0,0,0,0,0,0,0,0,0,0,0
20200528,052804,淘帝元大96購01,,,,,0.00,0.00,0,0,0,0,0,0,0,0,0,0,0,0,0
20200528,052805,晶技元大97購01,,,,,0.00,0.00,0,0,0,0,0,0,0,0,0,0,0,0,0
20200528,052806,玉晶光元大98購04,,,,,0.00,0.00,0,0,0,0,0,0,0,0,0,0,0,0,0
20200528,052807,貿聯元大98購01,0.29,0.39,0.29,0.39,+0.01,2.63,55000,2,20950,0,0,0,0,0,0,5000,0,5000,5000
20200528,052808,矽力元大96購02,,,,,0.00,0.00,0,0,0,0,0,0,0,0,0,0,0,0,0
20200528,052809,訊芯元大97購01,,,,,0.00,0.00,0,0,0,0,0,0,0,0,0,0,0,0,0
20200528,052810,易華電元大96購02,,,,,0.00,0.00,0,0,0,0,0,0,0,0,0,0,0,0,0
20200528,052811,玉晶光台新96購03,,,,,0.00,0.00,0,0,0,0,0,0,0,0,0,0,0,0,0
20200528,052812,致伸康和96購01,,,,,0.00,0.00,0,0,0,0,0,0,0,0,0,0,0,0,0
20200528,052813,T50正2永豐96購01,,,,,0.00,0.00,0,0,0,0,0,0,0,0,0,0,0,0,0
20200528,052814,上証2X永豐96購02,,,,,0.00,0.00,0,0,0,0,0,0,0,0,0,0,0,0,0
20200528,052815,滬深2X永豐97購01,,,,,0.00,0.00,0,0,0,0,0,0,0,0,0,0,0,0,0
20200528,052816,上銀永豐96購01,,,,,0.00,0.00,0,0,0,0,0,0,0,0,0,0,0,0,0
20200528,052817,楠梓電永豐96購02,,,,,0.00,0.00,0,0,0,0,0,0,0,0,0,0,0,0,0
20200528,052818,智邦永豐96購01,,,,,0.00,0.00,0,0,0,0,0,0,0,0,0,0,0,0,0
20200528,052819,義隆永豐96購01,0.91,1.00,0.86,0.86,+0.06,7.5,55000,5,49750,0,0,0,0,0,0,30000,25000,5000,5000
20200528,052820,宏達電永豐96購01,,,,,0.00,0.00,0,0,0,0,0,0,0,0,0,0,0,0,0
20200528,052821,晶技永豐96購01,,,,,0.00,0.00,0,0,0,0,0,0,0,0,0,0,0,0,0
20200528,052822,泰碩永豐97購01,,,,,0.00,0.00,0,0,0,0,0,0,0,0,0,0,0,0,0
20200528,052823,創意永豐96購02,,,,,0.00,0.00,0,0,0,0,0,0,0,0,0,0,0,0,0
20200528,052824,揚明光永豐96購02,,,,,0.00,0.00,0,0,0,0,0,0,0,0,0,0,0,0,0
20200528,052825,TPK永豐96購01,,,,,0.00,0.00,0,0,0,0,0,0,0,0,0,0,0,0,0
20200528,052826,嘉聯益永豐96購01,,,,,0.00,0.00,0,0,0,0,0,0,0,0,0,0,0,0,0
20200528,052827,昇陽半永豐97購01,0.06,0.06,0.05,0.05,0.00,0.00,20000,2,1100,0,0,0,0,0,0,0,20000,-20000,-20000
20200528,052828,滬深2X群益9A購02,,,,,0.00,0.00,0,0,0,0,0,0,0,0,0,0,0,0,0
20200528,052829,上銀群益96購01,,,,,0.00,0.00,0,0,0,0,0,0,0,0,0,0,0,0,0
20200528,052830,台光電群益96購01,,,,,0.00,0.00,0,0,0,0,0,0,0,0,0,0,0,0,0
20200528,052831,華固群益96購01,,,,,0.00,0.00,0,0,0,0,0,0,0,0,0,0,0,0,0
20200528,052832,益航群益96購01,,,,,0.00,0.00,0,0,0,0,0,0,0,0,0,0,0,0,0
20200528,052833,康控群益96購01,,,,,0.00,0.00,0,0,0,0,0,0,0,0,0,0,0,0,0
20200528,052834,彩晶群益96購01,,,,,0.00,0.00,0,0,0,0,0,0,0,0,0,0,0,0,0
20200528,052835,滬深2X國泰98購01,,,,,0.00,0.00,0,0,0,0,0,0,0,0,0,0,0,0,0
20200528,052836,旺宏國泰98購01,0.73,0.73,0.59,0.59,-0.03,-4.84,40000,2,26400,0,0,0,0,0,0,0,40000,-40000,-40000
20200528,052837,友達國泰97購01,,,,,0.00,0.00,0,0,0,0,0,0,0,0,0,0,0,0,0
20200528,052838,新唐國泰98購01,0.23,0.27,0.23,0.25,+0.03,13.64,430000,25,108450,0,0,0,0,0,0,200000,230000,-30000,-30000
20200528,052839,上海銀國泰97購01,,,,,0.00,0.00,0,0,0,0,0,0,0,0,0,0,0,0,0
20200528,052840,友達富邦96購01,,,,,0.00,0.00,0,0,0,0,0,0,0,0,0,0,0,0,0
20200528,052841,群創富邦96購02,,,,,0.00,0.00,0,0,0,0,0,0,0,0,0,0,0,0,0
20200528,052842,滬深2X統一96購01,,,,,0.00,0.00,0,0,0,0,0,0,0,0,0,0,0,0,0
20200528,052843,鴻海統一96購09,,,,,0.00,0.00,0,0,0,0,0,0,0,0,0,0,0,0,0
20200528,052844,台積電統一96購02,,,,,0.00,0.00,0,0,0,0,0,0,0,0,0,0,0,0,0
20200528,052845,旺宏統一97購01,,,,,0.00,0.00,0,0,0,0,0,0,0,0,0,0,0,0,0
20200528,052846,智邦統一97購01,,,,,0.00,0.00,0,0,0,0,0,0,0,0,0,0,0,0,0
20200528,052847,漢唐統一99購01,0.82,0.82,0.77,0.77,-0.04,-4.94,104000,5,80750,0,0,0,0,0,0,85000,19000,66000,66000
20200528,052848,聯發科統一96購03,,,,,0.00,0.00,0,0,0,0,0,0,0,0,0,0,0,0,0
20200528,052849,可成統一97購01,0.14,0.14,0.13,0.13,-0.02,-13.33,83000,3,11590,0,0,0,0,0,0,73000,10000,63000,63000
20200528,052850,華新科統一96購02,,,,,0.00,0.00,0,0,0,0,0,0,0,0,0,0,0,0,0
20200528,052851,滬深2X元富96購02,,,,,0.00,0.00,0,0,0,0,0,0,0,0,0,0,0,0,0
20200528,052852,國巨元富96購02,,,,,0.00,0.00,0,0,0,0,0,0,0,0,0,0,0,0,0
20200528,052853,友達日盛99購01,,,,,0.00,0.00,0,0,0,0,0,0,0,0,0,0,0,0,0
20200528,052854,聯詠日盛96購01,,,,,0.00,0.00,0,0,0,0,0,0,0,0,0,0,0,0,0
20200528,052855,群創日盛99購01,,,,,0.00,0.00,0,0,0,0,0,0,0,0,0,0,0,0,0
20200528,052856,滬深2X凱基98購01,0.04,0.04,0.04,0.04,0.00,0.00,60000,1,2400,0,0,0,0,0,0,60000,0,60000,60000
20200528,052857,大成鋼凱基96購01,,,,,0.00,0.00,0,0,0,0,0,0,0,0,0,0,0,0,0
20200528,052858,華通凱基97購02,0.37,0.37,0.34,0.34,0.00,0.00,170000,3,59300,0,0,0,0,0,0,100000,70000,30000,30000
20200528,052859,國巨凱基96購07,0.01,0.01,0.01,0.01,0.00,0.00,240000,1,2400,0,0,0,0,0,0,240000,240000,0,0
20200528,052860,旺宏凱基96購03,,,,,0.00,0.00,0,0,0,0,0,0,0,0,0,0,0,0,0
20200528,052861,台光電凱基96購03,,,,,0.00,0.00,0,0,0,0,0,0,0,0,0,0,0,0,0
20200528,052862,正崴凱基96購01,,,,,0.00,0.00,0,0,0,0,0,0,0,0,0,0,0,0,0
20200528,052863,友達凱基98購02,,,,,0.00,0.00,0,0,0,0,0,0,0,0,0,0,0,0,0
20200528,052864,奇力新凱基96購02,,,,,0.00,0.00,0,0,0,0,0,0,0,0,0,0,0,0,0
20200528,052865,大立光凱基96購11,,,,,0.00,0.00,0,0,0,0,0,0,0,0,0,0,0,0,0
20200528,052866,大立光凱基96購12,,,,,0.00,0.00,0,0,0,0,0,0,0,0,0,0,0,0,0
20200528,052867,晶技凱基96購01,,,,,0.00,0.00,0,0,0,0,0,0,0,0,0,0,0,0,0
20200528,052868,緯創凱基96購03,,,,,0.00,0.00,0,0,0,0,0,0,0,0,0,0,0,0,0
20200528,052869,新日興凱基96購01,,,,,0.00,0.00,0,0,0,0,0,0,0,0,0,0,0,0,0
20200528,052870,玉晶光凱基96購03,,,,,0.00,0.00,0,0,0,0,0,0,0,0,0,0,0,0,0
20200528,052871,群創凱基98購07,,,,,0.00,0.00,0,0,0,0,0,0,0,0,0,0,0,0,0
20200528,052872,智易凱基96購01,,,,,0.00,0.00,0,0,0,0,0,0,0,0,0,0,0,0,0
20200528,052873,新唐凱基96購02,,,,,0.00,0.00,0,0,0,0,0,0,0,0,0,0,0,0,0
20200528,052874,超眾凱基96購01,,,,,0.00,0.00,0,0,0,0,0,0,0,0,0,0,0,0,0
20200528,052875,樺漢凱基96購02,,,,,0.00,0.00,0,0,0,0,0,0,0,0,0,0,0,0,0
20200528,052876,GIS凱基96購03,,,,,0.00,0.00,0,0,0,0,0,0,0,0,0,0,0,0,0
20200528,052877,矽創凱基96購01,,,,,0.00,0.00,0,0,0,0,0,0,0,0,0,0,0,0,0
20200528,052878,台虹凱基96購01,,,,,0.00,0.00,0,0,0,0,0,0,0,0,0,0,0,0,0
20200528,052879,滬深2X凱基97購02,,,,,0.00,0.00,0,0,0,0,0,0,0,0,0,0,0,0,0
20200528,052880,台積電凱基96購06,0.01,0.01,0.01,0.01,0.00,0.00,111000,1,1110,0,0,0,0,0,0,111000,111000,0,0
20200528,052881,康控凱基97購01,,,,,0.00,0.00,0,0,0,0,0,0,0,0,0,0,0,0,0
20200528,052882,南電凱基96購02,,,,,0.00,0.00,0,0,0,0,0,0,0,0,0,0,0,0,0
20200528,052883,百和亞東97購01,,,,,0.00,0.00,0,0,0,0,0,0,0,0,0,0,0,0,0
20200528,052884,台積電兆豐96購01,0.10,0.10,0.07,0.07,-0.03,-30.0,30000,3,2400,0,0,0,0,0,0,30000,0,30000,30000
20200528,052885,高鐵兆豐98購01,1.19,1.19,0.93,0.93,-0.30,-24.39,131000,16,147060,14000,0,14000,0,0,0,17000,84000,-67000,-53000
20200528,052886,世紀鋼兆豐96購01,1.76,2.01,1.76,2.01,+0.02,1.01,44000,6,85290,0,0,0,0,0,0,24000,0,24000,24000
20200528,052887,華通中信96購01,,,,,0.00,0.00,0,0,0,0,0,0,0,0,0,0,0,0,0
20200528,052888,台表科中信9A購01,0.34,0.34,0.34,0.34,0.00,0.00,482000,1,163880,0,0,0,0,0,0,482000,0,482000,482000
20200528,052889,致伸麥證97購01,,,,,0.00,0.00,0,0,0,0,0,0,0,0,0,0,0,0,0
20200528,052890,FB上証群益9B購01,0.42,0.48,0.42,0.48,+0.03,6.67,3000,3,1350,0,0,0,0,0,0,2000,1000,1000,1000
20200528,052891,台泥群益96購01,,,,,0.00,0.00,0,0,0,0,0,0,0,0,0,0,0,0,0
20200528,052892,大成鋼群益96購01,,,,,0.00,0.00,0,0,0,0,0,0,0,0,0,0,0,0,0
20200528,052893,聯電群益98購01,0.39,0.43,0.39,0.42,+0.04,10.53,99000,6,39980,0,0,0,0,0,0,18000,81000,-63000,-63000
20200528,052894,國巨群益96購03,,,,,0.00,0.00,0,0,0,0,0,0,0,0,0,0,0,0,0
20200528,052895,台積電群益96購04,1.25,1.25,1.25,1.25,-0.26,-17.22,10000,1,12500,0,0,0,0,0,0,10000,0,10000,10000
20200528,052896,宏達電群益96購01,,,,,0.00,0.00,0,0,0,0,0,0,0,0,0,0,0,0,0
20200528,052897,緯創群益96購03,,,,,0.00,0.00,0,0,0,0,0,0,0,0,0,0,0,0,0
20200528,052898,樺漢群益96購01,,,,,0.00,0.00,0,0,0,0,0,0,0,0,0,0,0,0,0
20200528,052899,和大國票97購01,,,,,0.00,0.00,0,0,0,0,0,0,0,0,0,0,0,0,0
20200528,052900,大成鋼國票97購01,,,,,0.00,0.00,0,0,0,0,0,0,0,0,0,0,0,0,0
20200528,052901,台達電國票97購01,,,,,0.00,0.00,0,0,0,0,0,0,0,0,0,0,0,0,0
20200528,052902,鴻海國票97購04,,,,,0.00,0.00,0,0,0,0,0,0,0,0,0,0,0,0,0
20200528,052903,致茂國票97購01,,,,,0.00,0.00,0,0,0,0,0,0,0,0,0,0,0,0,0
20200528,052904,冠德國票97購01,0.14,0.14,0.14,0.14,+0.01,7.69,35000,2,4900,0,0,0,0,0,0,35000,0,35000,35000
20200528,052905,潤泰全國票97購01,,,,,0.00,0.00,0,0,0,0,0,0,0,0,0,0,0,0,0
20200528,052906,緯創國票97購01,,,,,0.00,0.00,0,0,0,0,0,0,0,0,0,0,0,0,0
20200528,052907,嘉澤國票97購01,,,,,0.00,0.00,0,0,0,0,0,0,0,0,0,0,0,0,0
20200528,052908,大成鋼統一96購01,,,,,0.00,0.00,0,0,0,0,0,0,0,0,0,0,0,0,0
20200528,052909,上銀統一96購01,,,,,0.00,0.00,0,0,0,0,0,0,0,0,0,0,0,0,0
20200528,052910,鴻海統一96購10,,,,,0.00,0.00,0,0,0,0,0,0,0,0,0,0,0,0,0
20200528,052911,友達統一97購02,,,,,0.00,0.00,0,0,0,0,0,0,0,0,0,0,0,0,0
20200528,052912,日月光統一96購01,,,,,0.00,0.00,0,0,0,0,0,0,0,0,0,0,0,0,0
20200528,052913,鴻海元富96購05,,,,,0.00,0.00,0,0,0,0,0,0,0,0,0,0,0,0,0
20200528,052914,奇力新元富96購01,,,,,0.00,0.00,0,0,0,0,0,0,0,0,0,0,0,0,0
20200528,052915,創意元富96購01,,,,,0.00,0.00,0,0,0,0,0,0,0,0,0,0,0,0,0
20200528,052916,華新科富邦96購01,1.10,1.10,1.10,1.10,0.00,0.00,20000,1,22000,0,0,0,0,0,0,20000,0,20000,20000
20200528,052917,大立光富邦99購02,0.34,0.34,0.34,0.34,0.00,0.00,20000,1,6800,0,0,0,0,0,0,0,0,0,0
20200528,052918,智易富邦97購02,,,,,0.00,0.00,0,0,0,0,0,0,0,0,0,0,0,0,0
20200528,052919,鈺齊富邦98購01,,,,,0.00,0.00,0,0,0,0,0,0,0,0,0,0,0,0,0
20200528,052920,景碩台新96購02,,,,,0.00,0.00,0,0,0,0,0,0,0,0,0,0,0,0,0
20200528,052921,大成鋼永豐96購01,,,,,0.00,0.00,0,0,0,0,0,0,0,0,0,0,0,0,0
20200528,052922,國巨永豐96購01,,,,,0.00,0.00,0,0,0,0,0,0,0,0,0,0,0,0,0
20200528,052923,台積電永豐96購02,,,,,0.00,0.00,0,0,0,0,0,0,0,0,0,0,0,0,0
20200528,052924,旺宏永豐96購01,,,,,0.00,0.00,0,0,0,0,0,0,0,0,0,0,0,0,0
20200528,052925,日電貿永豐96購01,,,,,0.00,0.00,0,0,0,0,0,0,0,0,0,0,0,0,0
20200528,052926,旺宏元大98購02,0.36,0.36,0.36,0.36,-0.04,-10.0,5000,1,1800,0,0,0,0,0,0,0,5000,-5000,-5000
20200528,052927,友達元大98購02,,,,,0.00,0.00,0,0,0,0,0,0,0,0,0,0,0,0,0
20200528,052928,美律元大98購01,,,,,0.00,0.00,0,0,0,0,0,0,0,0,0,0,0,0,0
20200528,052929,可成元大96購02,,,,,0.00,0.00,0,0,0,0,0,0,0,0,0,0,0,0,0
20200528,052930,華新科元大97購03,1.05,1.05,1.05,1.05,0.00,0.00,3000,1,3150,0,0,0,0,0,0,0,3000,-3000,-3000
20200528,052931,麗豐元大97購01,,,,,0.00,0.00,0,0,0,0,0,0,0,0,0,0,0,0,0
20200528,052932,正文元大97購01,,,,,0.00,0.00,0,0,0,0,0,0,0,0,0,0,0,0,0
20200528,052933,祥碩元大96購01,,,,,0.00,0.00,0,0,0,0,0,0,0,0,0,0,0,0,0
20200528,052934,中磊元大96購01,,,,,0.00,0.00,0,0,0,0,0,0,0,0,0,0,0,0,0
20200528,052935,康友元大96購03,,,,,0.00,0.00,0,0,0,0,0,0,0,0,0,0,0,0,0
20200528,052936,華通兆豐98購01,0.25,0.33,0.25,0.26,0.00,0.00,159000,11,43650,0,0,0,0,0,0,129000,0,129000,129000
20200528,052937,國巨兆豐97購01,,,,,0.00,0.00,0,0,0,0,0,0,0,0,0,0,0,0,0
20200528,052938,華新科兆豐96購01,,,,,0.00,0.00,0,0,0,0,0,0,0,0,0,0,0,0,0
20200528,052939,富邦金兆豐96購01,,,,,0.00,0.00,0,0,0,0,0,0,0,0,0,0,0,0,0
20200528,052940,玉晶光兆豐97購01,,,,,0.00,0.00,0,0,0,0,0,0,0,0,0,0,0,0,0
20200528,052941,康控兆豐97購01,,,,,0.00,0.00,0,0,0,0,0,0,0,0,0,0,0,0,0
20200528,052942,聯發科中信97購04,,,,,0.00,0.00,0,0,0,0,0,0,0,0,0,0,0,0,0
20200528,052943,奇力新國票96購02,,,,,0.00,0.00,0,0,0,0,0,0,0,0,0,0,0,0,0
20200528,052944,宏達電國票97購01,,,,,0.00,0.00,0,0,0,0,0,0,0,0,0,0,0,0,0
20200528,052945,嘉晶國票97購01,3.65,3.65,3.04,3.04,-1.06,-25.85,53000,10,181250,0,0,0,0,0,0,34000,17000,17000,17000
20200528,052946,智原國票97購02,,,,,0.00,0.00,0,0,0,0,0,0,0,0,0,0,0,0,0
20200528,052947,晶技國票97購01,,,,,0.00,0.00,0,0,0,0,0,0,0,0,0,0,0,0,0
20200528,052948,景碩國票97購02,,,,,0.00,0.00,0,0,0,0,0,0,0,0,0,0,0,0,0
20200528,052949,智易國票97購02,,,,,0.00,0.00,0,0,0,0,0,0,0,0,0,0,0,0,0
20200528,052950,超眾國票98購01,,,,,0.00,0.00,0,0,0,0,0,0,0,0,0,0,0,0,0
20200528,052951,GIS國票97購02,,,,,0.00,0.00,0,0,0,0,0,0,0,0,0,0,0,0,0
20200528,052952,矽創國票97購02,,,,,0.00,0.00,0,0,0,0,0,0,0,0,0,0,0,0,0
20200528,052953,百和國票97購01,,,,,0.00,0.00,0,0,0,0,0,0,0,0,0,0,0,0,0
20200528,052954,大成鋼日盛96購01,,,,,0.00,0.00,0,0,0,0,0,0,0,0,0,0,0,0,0
20200528,052955,國巨日盛96購01,,,,,0.00,0.00,0,0,0,0,0,0,0,0,0,0,0,0,0
20200528,052956,聯發科日盛96購01,,,,,0.00,0.00,0,0,0,0,0,0,0,0,0,0,0,0,0
20200528,052957,T50反1凱基99購01,0.28,0.29,0.28,0.29,+0.04,16.0,85000,2,24200,0,0,0,0,0,0,85000,0,85000,85000
20200528,052958,T50反1凱基99購02,,,,,0.00,0.00,0,0,0,0,0,0,0,0,0,0,0,0,0
20200528,052959,聯電凱基97購01,0.13,0.13,0.13,0.13,0.00,0.00,1834000,7,238420,0,0,0,0,0,0,0,1834000,-1834000,-1834000
20200528,052960,中環凱基96購01,,,,,0.00,0.00,0,0,0,0,0,0,0,0,0,0,0,0,0
20200528,052961,國巨凱基97購02,,,,,0.00,0.00,0,0,0,0,0,0,0,0,0,0,0,0,0
20200528,052962,台積電凱基97購03,,,,,0.00,0.00,0,0,0,0,0,0,0,0,0,0,0,0,0
20200528,052963,智邦凱基96購02,,,,,0.00,0.00,0,0,0,0,0,0,0,0,0,0,0,0,0
20200528,052964,台表科凱基96購03,,,,,0.00,0.00,0,0,0,0,0,0,0,0,0,0,0,0,0
20200528,052965,廣宇群益97購01,,,,,0.00,0.00,0,0,0,0,0,0,0,0,0,0,0,0,0
20200528,052966,光磊群益96購01,,,,,0.00,0.00,0,0,0,0,0,0,0,0,0,0,0,0,0
20200528,052967,智邦群益96購01,,,,,0.00,0.00,0,0,0,0,0,0,0,0,0,0,0,0,0
20200528,052968,燿華群益98購01,0.31,0.31,0.31,0.31,-0.02,-6.06,100000,1,31000,0,0,0,0,0,0,0,100000,-100000,-100000
20200528,052969,建準群益97購01,3.10,3.10,2.50,2.50,+0.10,4.17,9000,5,25740,0,0,0,0,0,0,9000,0,9000,9000
20200528,05296P,牧德凱基96售01,,,,,0.00,0.00,0,0,0,0,0,0,0,0,0,0,0,0,0
20200528,052970,美律群益96購01,,,,,0.00,0.00,0,0,0,0,0,0,0,0,0,0,0,0,0
20200528,052971,京元電群益98購01,,,,,0.00,0.00,0,0,0,0,0,0,0,0,0,0,0,0,0
20200528,052972,義隆群益96購04,,,,,0.00,0.00,0,0,0,0,0,0,0,0,0,0,0,0,0
20200528,052973,冠德群益96購01,,,,,0.00,0.00,0,0,0,0,0,0,0,0,0,0,0,0,0
20200528,052974,瀚宇博群益96購01,,,,,0.00,0.00,0,0,0,0,0,0,0,0,0,0,0,0,0
20200528,052975,嘉聯益群益96購01,,,,,0.00,0.00,0,0,0,0,0,0,0,0,0,0,0,0,0
20200528,052976,台表科群益96購03,,,,,0.00,0.00,0,0,0,0,0,0,0,0,0,0,0,0,0
20200528,052977,奇力新麥證97購01,,,,,0.00,0.00,0,0,0,0,0,0,0,0,0,0,0,0,0
20200528,052978,貿聯麥證97購01,,,,,0.00,0.00,0,0,0,0,0,0,0,0,0,0,0,0,0
20200528,052979,上銀元大96購02,,,,,0.00,0.00,0,0,0,0,0,0,0,0,0,0,0,0,0
20200528,052980,上銀元大96購03,,,,,0.00,0.00,0,0,0,0,0,0,0,0,0,0,0,0,0
20200528,052981,鴻海元大97購05,,,,,0.00,0.00,0,0,0,0,0,0,0,0,0,0,0,0,0
20200528,052982,鴻海元大97購06,,,,,0.00,0.00,0,0,0,0,0,0,0,0,0,0,0,0,0
20200528,052983,國巨元大96購07,,,,,0.00,0.00,0,0,0,0,0,0,0,0,0,0,0,0,0
20200528,052984,漢唐元大96購01,2.31,2.31,2.31,2.31,0.00,0.00,6000,1,13860,0,0,0,0,0,0,6000,0,6000,6000
20200528,052985,美律元大96購02,,,,,0.00,0.00,0,0,0,0,0,0,0,0,0,0,0,0,0
20200528,052986,聯發科元大97購05,,,,,0.00,0.00,0,0,0,0,0,0,0,0,0,0,0,0,0
20200528,052987,華新科元大99購01,,,,,0.00,0.00,0,0,0,0,0,0,0,0,0,0,0,0,0
20200528,052988,智易元大96購02,,,,,0.00,0.00,0,0,0,0,0,0,0,0,0,0,0,0,0
20200528,052989,麗豐元大98購01,0.22,0.22,0.22,0.22,0.00,0.00,25000,1,5500,0,0,0,0,0,0,25000,0,25000,25000
20200528,052990,超眾元大97購01,1.82,1.91,1.73,1.91,-0.15,-7.28,81000,11,146050,0,0,0,0,0,0,81000,4000,77000,77000
20200528,052991,台積電台新96購01,0.03,0.03,0.03,0.03,-0.02,-40.0,519000,2,15570,0,0,0,0,0,0,519000,519000,0,0
20200528,052992,冠德台新96購01,,,,,0.00,0.00,0,0,0,0,0,0,0,0,0,0,0,0,0
20200528,052993,欣興台新97購01,0.65,0.66,0.65,0.66,+0.05,8.2,2000,2,1310,0,0,0,0,0,0,2000,0,2000,2000
20200528,052994,群創台新99購01,,,,,0.00,0.00,0,0,0,0,0,0,0,0,0,0,0,0,0
20200528,052995,上銀康和96購01,,,,,0.00,0.00,0,0,0,0,0,0,0,0,0,0,0,0,0
20200528,052996,聯電康和96購01,,,,,0.00,0.00,0,0,0,0,0,0,0,0,0,0,0,0,0
20200528,052997,國巨康和96購01,0.36,0.36,0.36,0.36,+0.01,2.86,100000,1,36000,0,0,0,0,0,0,0,100000,-100000,-100000
20200528,052998,拓凱康和96購01,,,,,0.00,0.00,0,0,0,0,0,0,0,0,0,0,0,0,0
20200528,052999,臺股指康和96購01,,,,,0.00,0.00,0,0,0,0,0,0,0,0,0,0,0,0,0
20200528,053000,臺股指康和96購02,,,,,0.00,0.00,0,0,0,0,0,0,0,0,0,0,0,0,0
20200528,053001,力山永豐96購01,0.31,0.31,0.31,0.31,0.00,0.00,200000,2,62000,0,0,0,0,0,0,200000,0,200000,200000
20200528,053002,鴻海永豐96購01,,,,,0.00,0.00,0,0,0,0,0,0,0,0,0,0,0,0,0
20200528,053003,國巨永豐96購02,,,,,0.00,0.00,0,0,0,0,0,0,0,0,0,0,0,0,0
20200528,053004,燿華永豐96購01,,,,,0.00,0.00,0,0,0,0,0,0,0,0,0,0,0,0,0
20200528,053005,微星永豐96購01,0.15,0.15,0.15,0.15,-0.02,-11.76,27000,1,4050,0,0,0,0,0,0,27000,0,27000,27000
20200528,053006,玉晶光永豐96購03,,,,,0.00,0.00,0,0,0,0,0,0,0,0,0,0,0,0,0
20200528,053007,致伸永豐96購01,,,,,0.00,0.00,0,0,0,0,0,0,0,0,0,0,0,0,0
20200528,053008,達方永豐96購01,,,,,0.00,0.00,0,0,0,0,0,0,0,0,0,0,0,0,0
20200528,053009,大成鋼統一96購02,,,,,0.00,0.00,0,0,0,0,0,0,0,0,0,0,0,0,0
20200528,053010,鴻海統一96購11,,,,,0.00,0.00,0,0,0,0,0,0,0,0,0,0,0,0,0
20200528,053011,鴻海統一98購01,,,,,0.00,0.00,0,0,0,0,0,0,0,0,0,0,0,0,0
20200528,053012,國巨統一96購03,,,,,0.00,0.00,0,0,0,0,0,0,0,0,0,0,0,0,0
20200528,053013,台積電統一97購01,,,,,0.00,0.00,0,0,0,0,0,0,0,0,0,0,0,0,0
20200528,053014,旺宏統一97購02,0.25,0.26,0.20,0.20,-0.05,-20.0,180000,35,39830,0,0,0,0,0,0,60000,120000,-60000,-60000
20200528,053015,緯創統一96購01,,,,,0.00,0.00,0,0,0,0,0,0,0,0,0,0,0,0,0
20200528,053016,鈺齊統一96購01,,,,,0.00,0.00,0,0,0,0,0,0,0,0,0,0,0,0,0
20200528,053017,世紀鋼統一96購02,,,,,0.00,0.00,0,0,0,0,0,0,0,0,0,0,0,0,0
20200528,053018,旺宏元富96購02,,,,,0.00,0.00,0,0,0,0,0,0,0,0,0,0,0,0,0
20200528,053019,禾伸堂元富96購01,,,,,0.00,0.00,0,0,0,0,0,0,0,0,0,0,0,0,0
20200528,053020,貿聯元富96購01,,,,,0.00,0.00,0,0,0,0,0,0,0,0,0,0,0,0,0
20200528,053021,國巨國泰97購04,,,,,0.00,0.00,0,0,0,0,0,0,0,0,0,0,0,0,0
20200528,053022,欣興國泰98購01,,,,,0.00,0.00,0,0,0,0,0,0,0,0,0,0,0,0,0
20200528,053023,泰鼎國泰97購01,,,,,0.00,0.00,0,0,0,0,0,0,0,0,0,0,0,0,0
20200528,053024,國巨富邦97購02,,,,,0.00,0.00,0,0,0,0,0,0,0,0,0,0,0,0,0
20200528,053025,燿華富邦98購02,,,,,0.00,0.00,0,0,0,0,0,0,0,0,0,0,0,0,0
20200528,053026,奇力新富邦98購01,0.13,0.13,0.13,0.13,0.00,0.00,1000,1,130,0,0,0,0,0,0,1000,0,1000,1000
20200528,053027,玉晶光富邦98購01,0.84,0.84,0.84,0.84,0.00,0.00,10000,1,8400,0,0,0,0,0,0,0,10000,-10000,-10000
20200528,053028,康控富邦98購01,0.06,0.06,0.06,0.06,0.00,0.00,1000,1,60,0,0,0,0,0,0,0,0,0,0
20200528,053029,國巨第一96購01,0.03,0.03,0.03,0.03,-0.02,-40.0,20000,1,600,0,0,0,0,0,0,20000,0,20000,20000
20200528,05302P,華通國泰96售01,,,,,0.00,0.00,0,0,0,0,0,0,0,0,0,0,0,0,0
20200528,053030,南亞科第一96購01,,,,,0.00,0.00,0,0,0,0,0,0,0,0,0,0,0,0,0
20200528,053031,華新科第一96購01,,,,,0.00,0.00,0,0,0,0,0,0,0,0,0,0,0,0,0
20200528,053032,國巨兆豐97購02,0.09,0.09,0.09,0.09,0.00,0.00,2000,2,180,0,0,0,0,0,0,1000,1000,0,0
20200528,053033,智易兆豐97購01,0.36,0.40,0.33,0.33,+0.02,6.45,1654000,23,588060,0,0,0,0,0,0,198000,1456000,-1258000,-1258000
20200528,053034,上海銀兆豐96購01,,,,,0.00,0.00,0,0,0,0,0,0,0,0,0,0,0,0,0
20200528,053035,台表科兆豐97購01,0.60,0.60,0.43,0.43,-0.10,-18.87,57000,5,30210,0,0,0,0,0,0,10000,47000,-37000,-37000
20200528,053036,聯電凱基98購01,,,,,0.00,0.00,0,0,0,0,0,0,0,0,0,0,0,0,0
20200528,053037,國巨凱基96購08,,,,,0.00,0.00,0,0,0,0,0,0,0,0,0,0,0,0,0
20200528,053038,華邦電凱基97購01,,,,,0.00,0.00,0,0,0,0,0,0,0,0,0,0,0,0,0
20200528,053039,聯發科凱基96購11,,,,,0.00,0.00,0,0,0,0,0,0,0,0,0,0,0,0,0
20200528,05303P,華通國泰97售01,,,,,0.00,0.00,0,0,0,0,0,0,0,0,0,0,0,0,0
20200528,053040,全新凱基98購01,,,,,0.00,0.00,0,0,0,0,0,0,0,0,0,0,0,0,0
20200528,053041,可成凱基96購02,,,,,0.00,0.00,0,0,0,0,0,0,0,0,0,0,0,0,0
20200528,053042,大立光凱基97購03,,,,,0.00,0.00,0,0,0,0,0,0,0,0,0,0,0,0,0
20200528,053043,嘉晶凱基96購01,1.91,1.91,1.59,1.59,-0.57,-26.39,20000,3,34900,0,0,0,0,0,0,10000,10000,0,0
20200528,053044,南茂凱基96購02,,,,,0.00,0.00,0,0,0,0,0,0,0,0,0,0,0,0,0
20200528,053045,國巨中信97購01,,,,,0.00,0.00,0,0,0,0,0,0,0,0,0,0,0,0,0
20200528,053046,智易中信96購01,,,,,0.00,0.00,0,0,0,0,0,0,0,0,0,0,0,0,0
20200528,053047,寶成中信97購01,,,,,0.00,0.00,0,0,0,0,0,0,0,0,0,0,0,0,0
20200528,053048,同欣電麥證96購01,0.07,0.07,0.06,0.06,0.00,0.00,178000,4,11480,178000,0,178000,0,0,0,178000,0,178000,178000
20200528,053049,T50反1國票98購01,0.61,0.61,0.61,0.61,+0.03,5.17,100000,4,61000,0,0,0,0,0,0,0,100000,-100000,-100000
20200528,05304P,國巨國泰97售02,,,,,0.00,0.00,0,0,0,0,0,0,0,0,0,0,0,0,0
20200528,053050,華通國票97購02,0.74,0.78,0.74,0.78,+0.22,39.29,236000,3,176460,0,0,0,0,0,0,188000,48000,140000,140000
20200528,053051,楠梓電國票97購01,,,,,0.00,0.00,0,0,0,0,0,0,0,0,0,0,0,0,0
20200528,053052,旺宏國票97購02,,,,,0.00,0.00,0,0,0,0,0,0,0,0,0,0,0,0,0
20200528,053053,京元電國票97購02,3.38,3.38,3.38,3.38,+0.39,13.04,5000,1,16900,0,0,0,0,0,0,0,0,0,0
20200528,053054,禾伸堂國票97購01,,,,,0.00,0.00,0,0,0,0,0,0,0,0,0,0,0,0,0
20200528,053055,聯詠國票97購01,,,,,0.00,0.00,0,0,0,0,0,0,0,0,0,0,0,0,0
20200528,053056,同欣電國票97購01,0.39,0.39,0.36,0.36,-0.13,-26.53,132000,4,51160,0,0,0,0,0,0,132000,0,132000,132000
20200528,053057,聯電國泰97購02,0.16,0.18,0.16,0.17,0.00,0.00,1020000,68,176400,0,0,0,0,0,0,1020000,920000,100000,100000
20200528,053058,台光電永昌99購01,1.88,1.88,1.88,1.88,-0.31,-14.16,10000,1,18800,0,0,0,0,0,0,0,10000,-10000,-10000
20200528,053059,聯發科永昌99購01,,,,,0.00,0.00,0,0,0,0,0,0,0,0,0,0,0,0,0
20200528,05305P,華新科國泰97售01,0.24,0.27,0.23,0.27,+0.02,8.0,100000,10,24800,0,0,0,0,0,0,70000,90000,-20000,-20000
20200528,053060,大立光永昌96購05,,,,,0.00,0.00,0,0,0,0,0,0,0,0,0,0,0,0,0
20200528,053061,GIS富邦97購01,,,,,0.00,0.00,0,0,0,0,0,0,0,0,0,0,0,0,0
20200528,053062,緯穎富邦97購01,,,,,0.00,0.00,0,0,0,0,0,0,0,0,0,0,0,0,0
20200528,053063,力山群益98購01,1.45,1.54,1.40,1.53,+0.11,7.75,173000,15,255180,0,0,0,0,0,0,73000,100000,-27000,-27000
20200528,053064,國巨群益96購04,,,,,0.00,0.00,0,0,0,0,0,0,0,0,0,0,0,0,0
20200528,053065,大立光群益96購01,,,,,0.00,0.00,0,0,0,0,0,0,0,0,0,0,0,0,0
20200528,053066,欣興群益96購02,,,,,0.00,0.00,0,0,0,0,0,0,0,0,0,0,0,0,0
20200528,053067,牧德群益96購01,0.60,0.60,0.60,0.60,0.00,0.00,50000,1,30000,0,0,0,0,0,0,50000,0,50000,50000
20200528,053068,智伸科群益96購01,,,,,0.00,0.00,0,0,0,0,0,0,0,0,0,0,0,0,0
20200528,053069,同欣電群益98購01,,,,,0.00,0.00,0,0,0,0,0,0,0,0,0,0,0,0,0
20200528,05306P,泰碩國泰97售01,0.59,0.63,0.59,0.63,+0.02,3.28,95000,6,58150,0,0,0,0,0,0,30000,45000,-15000,-15000
20200528,053070,訊芯群益96購01,,,,,0.00,0.00,0,0,0,0,0,0,0,0,0,0,0,0,0
20200528,053071,南電群益96購01,,,,,0.00,0.00,0,0,0,0,0,0,0,0,0,0,0,0,0
20200528,053072,國巨台新97購01,1.17,1.17,1.01,1.01,-0.16,-13.68,986000,12,1099140,0,0,0,0,0,0,904000,82000,822000,822000
20200528,053073,技嘉康和96購01,,,,,0.00,0.00,0,0,0,0,0,0,0,0,0,0,0,0,0
20200528,053074,嘉晶永豐96購02,,,,,0.00,0.00,0,0,0,0,0,0,0,0,0,0,0,0,0
20200528,053075,欣興永豐96購01,,,,,0.00,0.00,0,0,0,0,0,0,0,0,0,0,0,0,0
20200528,053076,貿聯永豐96購01,,,,,0.00,0.00,0,0,0,0,0,0,0,0,0,0,0,0,0
20200528,053077,同欣電永豐96購01,,,,,0.00,0.00,0,0,0,0,0,0,0,0,0,0,0,0,0
20200528,053078,昇陽半永豐97購02,,,,,0.00,0.00,0,0,0,0,0,0,0,0,0,0,0,0,0
20200528,053079,世紀鋼永豐96購01,,,,,0.00,0.00,0,0,0,0,0,0,0,0,0,0,0,0,0
20200528,053080,力山元大96購02,0.92,0.97,0.82,0.82,-0.12,-12.77,102000,9,89500,0,0,0,0,0,0,102000,38000,64000,64000
20200528,053081,上銀元大97購02,3.30,3.30,2.68,2.68,-0.80,-22.99,12000,2,36500,0,0,0,0,0,0,12000,0,12000,12000
20200528,053082,聯電元大98購03,0.17,0.18,0.17,0.18,+0.01,5.88,1449000,20,260750,0,0,0,0,0,0,207000,1242000,-1035000,-1035000
20200528,053083,中環元大99購01,0.11,0.11,0.11,0.11,-0.01,-8.33,10000,1,1100,0,0,0,0,0,0,10000,0,10000,10000
20200528,053084,國巨元大98購01,,,,,0.00,0.00,0,0,0,0,0,0,0,0,0,0,0,0,0
20200528,053085,華新科元大97購04,,,,,0.00,0.00,0,0,0,0,0,0,0,0,0,0,0,0,0
20200528,053086,宏達電元大97購01,,,,,0.00,0.00,0,0,0,0,0,0,0,0,0,0,0,0,0
20200528,053087,冠德元大96購02,0.10,0.10,0.10,0.10,0.00,0.00,80000,1,8000,0,0,0,0,0,0,80000,0,80000,80000
20200528,053088,奇鋐元大98購01,0.46,0.51,0.46,0.51,+0.08,18.6,309000,4,154790,0,0,0,0,0,0,288000,21000,267000,267000
20200528,053089,貿聯元大97購02,,,,,0.00,0.00,0,0,0,0,0,0,0,0,0,0,0,0,0
20200528,053090,新唐元大96購01,,,,,0.00,0.00,0,0,0,0,0,0,0,0,0,0,0,0,0
20200528,053091,同欣電元大96購01,,,,,0.00,0.00,0,0,0,0,0,0,0,0,0,0,0,0,0
20200528,053092,台表科元大97購02,2.07,2.07,1.71,1.71,-0.33,-16.18,112000,5,215520,0,0,0,0,0,0,32000,80000,-48000,-48000
20200528,053093,緯穎元大96購06,,,,,0.00,0.00,0,0,0,0,0,0,0,0,0,0,0,0,0
20200528,053094,聯電統一97購02,,,,,0.00,0.00,0,0,0,0,0,0,0,0,0,0,0,0,0
20200528,053095,台光電統一98購01,1.67,1.67,1.48,1.50,-0.26,-14.77,55000,4,87840,0,0,0,0,0,0,28000,27000,1000,1000
20200528,053096,康控統一96購01,,,,,0.00,0.00,0,0,0,0,0,0,0,0,0,0,0,0,0
20200528,053097,超眾統一96購03,1.06,1.06,1.06,1.06,-0.02,-1.85,108000,2,114480,0,0,0,0,0,0,0,108000,-108000,-108000
20200528,053098,國巨元富96購04,,,,,0.00,0.00,0,0,0,0,0,0,0,0,0,0,0,0,0
20200528,053099,正崴元富96購01,,,,,0.00,0.00,0,0,0,0,0,0,0,0,0,0,0,0,0
20200528,053100,美律元富96購01,,,,,0.00,0.00,0,0,0,0,0,0,0,0,0,0,0,0,0
20200528,053101,創意元富96購03,,,,,0.00,0.00,0,0,0,0,0,0,0,0,0,0,0,0,0
20200528,053102,祥碩元富96購01,,,,,0.00,0.00,0,0,0,0,0,0,0,0,0,0,0,0,0
20200528,053103,瀚宇博元富96購01,,,,,0.00,0.00,0,0,0,0,0,0,0,0,0,0,0,0,0
20200528,053104,台表科元富96購02,0.41,0.41,0.41,0.41,-0.24,-36.92,20000,1,8200,0,0,0,0,0,0,20000,0,20000,20000
20200528,053105,鴻海兆豐97購01,,,,,0.00,0.00,0,0,0,0,0,0,0,0,0,0,0,0,0
20200528,053106,鴻海兆豐98購01,,,,,0.00,0.00,0,0,0,0,0,0,0,0,0,0,0,0,0
20200528,053107,旺宏兆豐97購01,0.41,0.41,0.35,0.35,-0.05,-12.5,85000,9,31850,0,0,0,0,0,0,5000,80000,-75000,-75000
20200528,053108,南亞科兆豐96購01,,,,,0.00,0.00,0,0,0,0,0,0,0,0,0,0,0,0,0
20200528,053109,聯發科兆豐96購01,,,,,0.00,0.00,0,0,0,0,0,0,0,0,0,0,0,0,0
20200528,053110,大立光兆豐97購01,0.07,0.07,0.07,0.07,0.00,0.00,30000,3,2100,0,0,0,0,0,0,0,30000,-30000,-30000
20200528,053111,緯創兆豐97購01,0.99,0.99,0.99,0.99,+0.06,6.45,1000,1,990,0,0,0,0,0,0,1000,0,1000,1000
20200528,053112,中磊兆豐97購01,,,,,0.00,0.00,0,0,0,0,0,0,0,0,0,0,0,0,0
20200528,053113,瀚宇博兆豐97購01,,,,,0.00,0.00,0,0,0,0,0,0,0,0,0,0,0,0,0
20200528,053114,聯茂兆豐97購01,0.24,0.29,0.23,0.27,+0.03,12.5,539000,20,145810,0,0,0,0,0,0,389000,150000,239000,239000
20200528,053115,滬深2X中信97購01,0.24,0.24,0.24,0.24,+0.01,4.35,60000,1,14400,0,0,0,0,0,0,60000,0,60000,60000
20200528,053116,華新科中信96購01,,,,,0.00,0.00,0,0,0,0,0,0,0,0,0,0,0,0,0
20200528,053117,大立光中信9A購02,0.08,0.08,0.07,0.07,-0.01,-12.5,140000,14,10600,0,0,0,0,0,0,0,140000,-140000,-140000
20200528,053118,大立光中信9C購01,0.25,0.25,0.21,0.22,-0.01,-4.35,1025000,12,224490,0,0,0,0,0,0,15000,1010000,-995000,-995000
20200528,053119,日月光中信97購01,,,,,0.00,0.00,0,0,0,0,0,0,0,0,0,0,0,0,0
20200528,053120,復盛中信9A購01,,,,,0.00,0.00,0,0,0,0,0,0,0,0,0,0,0,0,0
20200528,053121,上証2X凱基9C購01,1.01,1.01,1.01,1.01,0.00,0.00,80000,1,80800,0,0,0,0,0,0,80000,0,80000,80000
20200528,053122,美律凱基98購01,0.12,0.12,0.11,0.11,0.00,0.00,75000,2,8500,0,0,0,0,0,0,0,50000,-50000,-50000
20200528,053123,京元電凱基96購01,,,,,0.00,0.00,0,0,0,0,0,0,0,0,0,0,0,0,0
20200528,053124,聯發科凱基96購12,,,,,0.00,0.00,0,0,0,0,0,0,0,0,0,0,0,0,0
20200528,053125,宏達電凱基96購01,,,,,0.00,0.00,0,0,0,0,0,0,0,0,0,0,0,0,0
20200528,053126,健策凱基97購02,0.99,0.99,0.99,0.99,-0.13,-11.61,5000,1,4950,0,0,0,0,0,0,5000,0,5000,5000
20200528,053127,貿聯凱基97購01,,,,,0.00,0.00,0,0,0,0,0,0,0,0,0,0,0,0,0
20200528,053128,瀚宇博凱基96購01,,,,,0.00,0.00,0,0,0,0,0,0,0,0,0,0,0,0,0
20200528,053129,緯穎凱基96購01,3.65,3.65,3.65,3.65,0.00,0.00,3000,1,10950,0,0,0,0,0,0,3000,0,3000,3000
20200528,053130,聯發科麥證96購01,,,,,0.00,0.00,0,0,0,0,0,0,0,0,0,0,0,0,0
20200528,053131,華通國票97購03,,,,,0.00,0.00,0,0,0,0,0,0,0,0,0,0,0,0,0
20200528,053132,國巨國票97購02,,,,,0.00,0.00,0,0,0,0,0,0,0,0,0,0,0,0,0
20200528,053133,華邦電國票97購01,,,,,0.00,0.00,0,0,0,0,0,0,0,0,0,0,0,0,0
20200528,053134,南亞科國票97購01,,,,,0.00,0.00,0,0,0,0,0,0,0,0,0,0,0,0,0
20200528,053135,信邦國票96購01,,,,,0.00,0.00,0,0,0,0,0,0,0,0,0,0,0,0,0
20200528,053136,彩晶國票97購01,,,,,0.00,0.00,0,0,0,0,0,0,0,0,0,0,0,0,0
20200528,053137,旺宏富邦98購01,,,,,0.00,0.00,0,0,0,0,0,0,0,0,0,0,0,0,0
20200528,053138,華邦電富邦96購01,,,,,0.00,0.00,0,0,0,0,0,0,0,0,0,0,0,0,0
20200528,053139,滬深2X永豐98購01,,,,,0.00,0.00,0,0,0,0,0,0,0,0,0,0,0,0,0
20200528,053140,燿華永豐96購02,,,,,0.00,0.00,0,0,0,0,0,0,0,0,0,0,0,0,0
20200528,053141,景碩永豐96購02,,,,,0.00,0.00,0,0,0,0,0,0,0,0,0,0,0,0,0
20200528,053142,緯穎永豐96購01,,,,,0.00,0.00,0,0,0,0,0,0,0,0,0,0,0,0,0
20200528,053143,昇陽半永豐96購03,,,,,0.00,0.00,0,0,0,0,0,0,0,0,0,0,0,0,0
20200528,053144,上証2X元大96購01,,,,,0.00,0.00,0,0,0,0,0,0,0,0,0,0,0,0,0
20200528,053145,元黃金元大96購02,,,,,0.00,0.00,0,0,0,0,0,0,0,0,0,0,0,0,0
20200528,053146,滬深2X元大96購08,,,,,0.00,0.00,0,0,0,0,0,0,0,0,0,0,0,0,0
20200528,053147,楠梓電元大98購01,,,,,0.00,0.00,0,0,0,0,0,0,0,0,0,0,0,0,0
20200528,053148,華邦電元大96購01,,,,,0.00,0.00,0,0,0,0,0,0,0,0,0,0,0,0,0
20200528,053149,京元電元大96購02,,,,,0.00,0.00,0,0,0,0,0,0,0,0,0,0,0,0,0
20200528,053150,聯發科元大96購11,,,,,0.00,0.00,0,0,0,0,0,0,0,0,0,0,0,0,0
20200528,053151,華新科元大96購04,2.44,2.48,2.44,2.44,+0.07,2.95,50000,3,122400,0,0,0,0,0,0,50000,0,50000,50000
20200528,053152,大立光元大99購01,,,,,0.00,0.00,0,0,0,0,0,0,0,0,0,0,0,0,0
20200528,053153,大立光元大99購02,,,,,0.00,0.00,0,0,0,0,0,0,0,0,0,0,0,0,0
20200528,053154,聯詠元大96購01,,,,,0.00,0.00,0,0,0,0,0,0,0,0,0,0,0,0,0
20200528,053155,晶技元大97購02,,,,,0.00,0.00,0,0,0,0,0,0,0,0,0,0,0,0,0
20200528,053156,緯創元大96購02,,,,,0.00,0.00,0,0,0,0,0,0,0,0,0,0,0,0,0
20200528,053157,日月光元大96購03,,,,,0.00,0.00,0,0,0,0,0,0,0,0,0,0,0,0,0
20200528,053158,茂林元大96購01,0.68,0.68,0.63,0.63,-0.34,-35.05,63000,2,40290,0,0,0,0,0,0,12000,51000,-39000,-39000
20200528,053159,同欣電元大96購02,,,,,0.00,0.00,0,0,0,0,0,0,0,0,0,0,0,0,0
20200528,05315P,鴻海永昌96售08,,,,,0.00,0.00,0,0,0,0,0,0,0,0,0,0,0,0,0
20200528,053160,台表科元大96購03,,,,,0.00,0.00,0,0,0,0,0,0,0,0,0,0,0,0,0
20200528,053161,康友元大96購04,,,,,0.00,0.00,0,0,0,0,0,0,0,0,0,0,0,0,0
20200528,053162,緯穎元大97購01,,,,,0.00,0.00,0,0,0,0,0,0,0,0,0,0,0,0,0
20200528,053163,上証2X群益9A購02,,,,,0.00,0.00,0,0,0,0,0,0,0,0,0,0,0,0,0
20200528,053164,台光電群益96購02,,,,,0.00,0.00,0,0,0,0,0,0,0,0,0,0,0,0,0
20200528,053165,大立光群益96購03,,,,,0.00,0.00,0,0,0,0,0,0,0,0,0,0,0,0,0
20200528,053166,聯詠群益96購02,,,,,0.00,0.00,0,0,0,0,0,0,0,0,0,0,0,0,0
20200528,053167,欣興群益96購03,,,,,0.00,0.00,0,0,0,0,0,0,0,0,0,0,0,0,0
20200528,053168,晶技群益98購01,4.08,4.08,4.08,4.08,-0.43,-9.53,6000,3,24480,0,0,0,0,0,0,6000,0,6000,6000
20200528,053169,貿聯群益97購01,,,,,0.00,0.00,0,0,0,0,0,0,0,0,0,0,0,0,0
20200528,05316P,台積電永昌96售06,0.09,0.09,0.09,0.09,0.00,0.00,139000,1,12510,0,0,0,0,0,0,139000,139000,0,0
20200528,053170,茂林群益96購04,,,,,0.00,0.00,0,0,0,0,0,0,0,0,0,0,0,0,0
20200528,053171,中磊群益96購01,,,,,0.00,0.00,0,0,0,0,0,0,0,0,0,0,0,0,0
20200528,053172,瑞儀群益97購01,0.03,0.03,0.03,0.03,+0.01,50.0,100000,1,3000,0,0,0,0,0,0,0,0,0,0
20200528,053173,矽格群益97購01,0.69,0.69,0.60,0.60,-0.12,-16.67,26000,2,16500,0,0,0,0,0,0,0,26000,-26000,-26000
20200528,053174,同欣電群益98購02,1.24,1.24,1.24,1.24,0.00,0.00,1000,1,1240,0,0,0,0,0,0,0,1000,-1000,-1000
20200528,053175,矽力群益96購01,,,,,0.00,0.00,0,0,0,0,0,0,0,0,0,0,0,0,0
20200528,053176,矽力群益96購02,12.00,12.00,10.70,10.70,+1.70,18.89,18000,2,199100,0,0,0,0,0,0,18000,0,18000,18000
20200528,053177,華邦電統一96購01,,,,,0.00,0.00,0,0,0,0,0,0,0,0,0,0,0,0,0
20200528,053178,南亞科統一98購01,,,,,0.00,0.00,0,0,0,0,0,0,0,0,0,0,0,0,0
20200528,053179,大立光統一96購04,,,,,0.00,0.00,0,0,0,0,0,0,0,0,0,0,0,0,0
20200528,053180,同欣電統一96購01,,,,,0.00,0.00,0,0,0,0,0,0,0,0,0,0,0,0,0
20200528,053181,滬深2X元富99購02,,,,,0.00,0.00,0,0,0,0,0,0,0,0,0,0,0,0,0
20200528,053182,大立光元富96購02,,,,,0.00,0.00,0,0,0,0,0,0,0,0,0,0,0,0,0
20200528,053183,大立光元富96購03,,,,,0.00,0.00,0,0,0,0,0,0,0,0,0,0,0,0,0
20200528,053184,世紀鋼元富96購01,,,,,0.00,0.00,0,0,0,0,0,0,0,0,0,0,0,0,0
20200528,053185,友達中信99購01,,,,,0.00,0.00,0,0,0,0,0,0,0,0,0,0,0,0,0
20200528,053186,健策中信9C購01,1.11,1.11,0.94,0.94,-0.05,-5.05,308000,48,322430,0,0,0,0,0,0,223000,85000,138000,138000
20200528,053187,國巨統一96購05,0.27,0.27,0.27,0.27,0.00,0.00,25000,1,6750,0,0,0,0,0,0,25000,0,25000,25000
20200528,053188,旺宏統一97購03,0.10,0.10,0.10,0.10,0.00,0.00,20000,1,2000,0,0,0,0,0,0,20000,0,20000,20000
20200528,053189,聯發科統一96購05,,,,,0.00,0.00,0,0,0,0,0,0,0,0,0,0,0,0,0
20200528,053190,聯發科統一99購01,,,,,0.00,0.00,0,0,0,0,0,0,0,0,0,0,0,0,0
20200528,053191,奇鋐統一96購01,,,,,0.00,0.00,0,0,0,0,0,0,0,0,0,0,0,0,0
20200528,053192,創意統一96購01,,,,,0.00,0.00,0,0,0,0,0,0,0,0,0,0,0,0,0
20200528,053193,超眾統一97購01,1.90,1.90,1.90,1.90,-0.25,-11.63,1000,1,1900,0,0,0,0,0,0,1000,0,1000,1000
20200528,053194,緯穎統一99購01,,,,,0.00,0.00,0,0,0,0,0,0,0,0,0,0,0,0,0
20200528,053195,玉晶光元富96購02,,,,,0.00,0.00,0,0,0,0,0,0,0,0,0,0,0,0,0
20200528,053196,康控元富96購01,,,,,0.00,0.00,0,0,0,0,0,0,0,0,0,0,0,0,0
20200528,053197,超眾元富96購02,,,,,0.00,0.00,0,0,0,0,0,0,0,0,0,0,0,0,0
20200528,053198,亞德客日盛96購01,2.90,2.90,2.72,2.72,+0.51,23.08,3000,3,8520,0,0,0,0,0,0,2000,3000,-1000,-1000
20200528,053199,旺宏日盛96購01,,,,,0.00,0.00,0,0,0,0,0,0,0,0,0,0,0,0,0
20200528,053200,華邦電日盛96購01,,,,,0.00,0.00,0,0,0,0,0,0,0,0,0,0,0,0,0
20200528,053201,美律日盛96購01,,,,,0.00,0.00,0,0,0,0,0,0,0,0,0,0,0,0,0
20200528,053202,聯發科日盛96購02,,,,,0.00,0.00,0,0,0,0,0,0,0,0,0,0,0,0,0
20200528,053203,智易日盛96購01,,,,,0.00,0.00,0,0,0,0,0,0,0,0,0,0,0,0,0
20200528,053204,旺宏麥證96購01,,,,,0.00,0.00,0,0,0,0,0,0,0,0,0,0,0,0,0
20200528,053205,台光電麥證96購01,2.38,2.38,2.38,2.38,0.00,0.00,10000,1,23800,10000,0,10000,0,0,0,10000,10000,0,0
20200528,053206,聯發科麥證96購02,,,,,0.00,0.00,0,0,0,0,0,0,0,0,0,0,0,0,0
20200528,053207,SP黃豆凱基96購01,,,,,0.00,0.00,0,0,0,0,0,0,0,0,0,0,0,0,0
20200528,053208,鴻海凱基96購13,,,,,0.00,0.00,0,0,0,0,0,0,0,0,0,0,0,0,0
20200528,053209,台積電凱基96購07,,,,,0.00,0.00,0,0,0,0,0,0,0,0,0,0,0,0,0
20200528,05320P,華通凱基96售03,,,,,0.00,0.00,0,0,0,0,0,0,0,0,0,0,0,0,0
20200528,053210,華邦電凱基97購02,,,,,0.00,0.00,0,0,0,0,0,0,0,0,0,0,0,0,0
20200528,053211,漢唐凱基96購03,,,,,0.00,0.00,0,0,0,0,0,0,0,0,0,0,0,0,0
20200528,053212,友達凱基99購04,,,,,0.00,0.00,0,0,0,0,0,0,0,0,0,0,0,0,0
20200528,053213,建準凱基96購02,,,,,0.00,0.00,0,0,0,0,0,0,0,0,0,0,0,0,0
20200528,053214,冠德凱基96購02,,,,,0.00,0.00,0,0,0,0,0,0,0,0,0,0,0,0,0
20200528,053215,禾伸堂凱基96購01,,,,,0.00,0.00,0,0,0,0,0,0,0,0,0,0,0,0,0
20200528,053216,京鼎凱基96購02,,,,,0.00,0.00,0,0,0,0,0,0,0,0,0,0,0,0,0
20200528,053217,群創凱基99購02,,,,,0.00,0.00,0,0,0,0,0,0,0,0,0,0,0,0,0
20200528,053218,TPK凱基96購01,,,,,0.00,0.00,0,0,0,0,0,0,0,0,0,0,0,0,0
20200528,053219,祥碩凱基96購01,,,,,0.00,0.00,0,0,0,0,0,0,0,0,0,0,0,0,0
20200528,053220,瀚宇博凱基98購01,,,,,0.00,0.00,0,0,0,0,0,0,0,0,0,0,0,0,0
20200528,053221,彩晶凱基98購01,,,,,0.00,0.00,0,0,0,0,0,0,0,0,0,0,0,0,0
20200528,053222,聯茂凱基96購03,,,,,0.00,0.00,0,0,0,0,0,0,0,0,0,0,0,0,0
20200528,053223,台郡凱基96購02,,,,,0.00,0.00,0,0,0,0,0,0,0,0,0,0,0,0,0
20200528,053224,矽力凱基96購02,,,,,0.00,0.00,0,0,0,0,0,0,0,0,0,0,0,0,0
20200528,053225,昇陽半凱基96購01,,,,,0.00,0.00,0,0,0,0,0,0,0,0,0,0,0,0,0
20200528,053226,國巨台新97購02,0.44,0.45,0.36,0.36,-0.06,-14.29,340000,34,139400,0,0,0,0,0,0,330000,340000,-10000,-10000
20200528,053227,晶技台新96購01,,,,,0.00,0.00,0,0,0,0,0,0,0,0,0,0,0,0,0
20200528,053228,康友台新97購01,,,,,0.00,0.00,0,0,0,0,0,0,0,0,0,0,0,0,0
20200528,053229,南電台新97購01,,,,,0.00,0.00,0,0,0,0,0,0,0,0,0,0,0,0,0
20200528,053230,達方台新97購01,,,,,0.00,0.00,0,0,0,0,0,0,0,0,0,0,0,0,0
20200528,053231,奇力新康和96購01,,,,,0.00,0.00,0,0,0,0,0,0,0,0,0,0,0,0,0
20200528,053232,友達永豐97購02,,,,,0.00,0.00,0,0,0,0,0,0,0,0,0,0,0,0,0
20200528,053233,大立光永豐96購01,,,,,0.00,0.00,0,0,0,0,0,0,0,0,0,0,0,0,0
20200528,053234,奇鋐永豐96購01,,,,,0.00,0.00,0,0,0,0,0,0,0,0,0,0,0,0,0
20200528,053235,智原永豐96購01,,,,,0.00,0.00,0,0,0,0,0,0,0,0,0,0,0,0,0
20200528,053236,群創永豐97購02,,,,,0.00,0.00,0,0,0,0,0,0,0,0,0,0,0,0,0
20200528,053237,揚明光永豐96購03,,,,,0.00,0.00,0,0,0,0,0,0,0,0,0,0,0,0,0
20200528,053238,麗豐永豐96購01,,,,,0.00,0.00,0,0,0,0,0,0,0,0,0,0,0,0,0
20200528,053239,崇越永豐96購01,,,,,0.00,0.00,0,0,0,0,0,0,0,0,0,0,0,0,0
20200528,05323P,瑞昱凱基96售02,,,,,0.00,0.00,0,0,0,0,0,0,0,0,0,0,0,0,0
20200528,053240,巨路永豐96購01,,,,,0.00,0.00,0,0,0,0,0,0,0,0,0,0,0,0,0
20200528,053241,元油反國票9A購01,,,,,0.00,0.00,0,0,0,0,0,0,0,0,0,0,0,0,0
20200528,053242,聯電國票96購04,,,,,0.00,0.00,0,0,0,0,0,0,0,0,0,0,0,0,0
20200528,053243,楠梓電國票97購02,,,,,0.00,0.00,0,0,0,0,0,0,0,0,0,0,0,0,0
20200528,053244,光磊國票97購01,,,,,0.00,0.00,0,0,0,0,0,0,0,0,0,0,0,0,0
20200528,053245,全新國票97購01,,,,,0.00,0.00,0,0,0,0,0,0,0,0,0,0,0,0,0
20200528,053246,聯詠國票97購02,,,,,0.00,0.00,0,0,0,0,0,0,0,0,0,0,0,0,0
20200528,053247,麗豐國票97購01,,,,,0.00,0.00,0,0,0,0,0,0,0,0,0,0,0,0,0
20200528,053248,智伸科國票97購01,0.31,0.31,0.28,0.28,-0.03,-9.68,153000,4,44980,0,0,0,0,0,0,103000,50000,53000,53000
20200528,053249,致伸國票97購02,,,,,0.00,0.00,0,0,0,0,0,0,0,0,0,0,0,0,0
20200528,053250,百和國票97購02,1.00,1.02,0.93,0.93,-0.03,-3.12,201000,4,200000,0,0,0,0,0,0,201000,0,201000,201000
20200528,053251,世紀鋼國票97購02,,,,,0.00,0.00,0,0,0,0,0,0,0,0,0,0,0,0,0
20200528,053252,華邦電國泰98購01,,,,,0.00,0.00,0,0,0,0,0,0,0,0,0,0,0,0,0
20200528,053253,友達國泰97購02,0.28,0.28,0.28,0.28,-0.03,-9.68,95000,1,26600,0,0,0,0,0,0,95000,0,95000,95000
20200528,053254,群創國泰98購02,0.07,0.07,0.07,0.07,+0.02,40.0,55000,1,3850,0,0,0,0,0,0,0,55000,-55000,-55000
20200528,053255,貿聯國泰97購01,0.48,0.52,0.47,0.47,-0.02,-4.08,118000,23,59980,0,0,0,0,0,0,5000,103000,-98000,-98000
20200528,053256,上銀富邦98購01,1.12,1.12,1.12,1.12,-0.23,-17.04,21000,1,23520,0,0,0,0,0,0,21000,0,21000,21000
20200528,053257,華通富邦97購01,0.04,0.04,0.03,0.03,0.00,0.00,122000,5,4680,0,0,0,0,0,0,122000,0,122000,122000
20200528,053258,上証2X群益9A購03,0.61,0.61,0.61,0.61,-0.05,-7.58,33000,1,20130,0,0,0,0,0,0,33000,33000,0,0
20200528,053259,卜蜂群益97購01,0.42,0.44,0.42,0.44,-0.01,-2.22,90000,2,39000,0,0,0,0,0,0,90000,0,90000,90000
20200528,053260,喬山群益96購01,,,,,0.00,0.00,0,0,0,0,0,0,0,0,0,0,0,0,0
20200528,053261,國巨群益96購05,,,,,0.00,0.00,0,0,0,0,0,0,0,0,0,0,0,0,0
20200528,053262,華邦電群益96購02,,,,,0.00,0.00,0,0,0,0,0,0,0,0,0,0,0,0,0
20200528,053263,華邦電群益96購03,,,,,0.00,0.00,0,0,0,0,0,0,0,0,0,0,0,0,0
20200528,053264,南亞科群益96購01,,,,,0.00,0.00,0,0,0,0,0,0,0,0,0,0,0,0,0
20200528,053265,南亞科群益96購02,,,,,0.00,0.00,0,0,0,0,0,0,0,0,0,0,0,0,0
20200528,053266,全新群益98購01,,,,,0.00,0.00,0,0,0,0,0,0,0,0,0,0,0,0,0
20200528,053267,華新科群益96購02,,,,,0.00,0.00,0,0,0,0,0,0,0,0,0,0,0,0,0
20200528,053268,日月光群益96購01,,,,,0.00,0.00,0,0,0,0,0,0,0,0,0,0,0,0,0
20200528,053269,同欣電群益96購01,,,,,0.00,0.00,0,0,0,0,0,0,0,0,0,0,0,0,0
20200528,053270,台塑元大96購01,,,,,0.00,0.00,0,0,0,0,0,0,0,0,0,0,0,0,0
20200528,053271,喬山元大97購01,,,,,0.00,0.00,0,0,0,0,0,0,0,0,0,0,0,0,0
20200528,053272,鴻海元大96購17,,,,,0.00,0.00,0,0,0,0,0,0,0,0,0,0,0,0,0
20200528,053273,國巨元大96購08,,,,,0.00,0.00,0,0,0,0,0,0,0,0,0,0,0,0,0
20200528,053274,旺宏元大98購03,,,,,0.00,0.00,0,0,0,0,0,0,0,0,0,0,0,0,0
20200528,053275,燿華元大97購01,,,,,0.00,0.00,0,0,0,0,0,0,0,0,0,0,0,0,0
20200528,053276,友達元大9C購01,0.70,0.70,0.70,0.70,-0.04,-5.41,10000,1,7000,0,0,0,0,0,0,10000,0,10000,10000
20200528,053277,大立光元大96購04,,,,,0.00,0.00,0,0,0,0,0,0,0,0,0,0,0,0,0
20200528,053278,禾伸堂元大96購01,1.62,1.62,1.62,1.62,-0.07,-4.14,50000,1,81000,0,0,0,0,0,0,50000,50000,0,0
20200528,053279,景碩元大97購01,0.83,0.83,0.81,0.81,0.00,0.00,180000,4,148300,0,0,0,0,0,0,0,180000,-180000,-180000
20200528,053280,群創元大9C購01,,,,,0.00,0.00,0,0,0,0,0,0,0,0,0,0,0,0,0
20200528,053281,茂林元大96購02,1.18,1.18,1.18,1.18,-0.04,-3.28,33000,1,38940,0,0,0,0,0,0,33000,0,33000,33000
20200528,053282,彩晶元大9C購01,,,,,0.00,0.00,0,0,0,0,0,0,0,0,0,0,0,0,0
20200528,053283,同欣電元大96購03,,,,,0.00,0.00,0,0,0,0,0,0,0,0,0,0,0,0,0
20200528,053284,樺漢元大97購01,,,,,0.00,0.00,0,0,0,0,0,0,0,0,0,0,0,0,0
20200528,053285,臺股指元大96購08,,,,,0.00,0.00,0,0,0,0,0,0,0,0,0,0,0,0,0
20200528,053286,臺股指元大96購14,,,,,0.00,0.00,0,0,0,0,0,0,0,0,0,0,0,0,0
20200528,053287,臺股指元大96購15,,,,,0.00,0.00,0,0,0,0,0,0,0,0,0,0,0,0,0
20200528,053288,臺股指元大96購16,,,,,0.00,0.00,0,0,0,0,0,0,0,0,0,0,0,0,0
20200528,053289,臺股指元大96購17,,,,,0.00,0.00,0,0,0,0,0,0,0,0,0,0,0,0,0
20200528,053290,元油反中信97購01,,,,,0.00,0.00,0,0,0,0,0,0,0,0,0,0,0,0,0
20200528,053291,旺宏中信9A購01,0.16,0.19,0.16,0.19,0.00,0.00,37000,3,6100,31000,0,31000,0,0,0,0,37000,-37000,-6000
20200528,053292,美律中信98購01,0.45,0.45,0.43,0.43,0.00,0.00,65000,3,28950,0,0,0,0,0,0,65000,0,65000,65000
20200528,053293,聯發科中信9B購01,0.65,0.65,0.62,0.62,-0.08,-11.43,21000,4,13320,0,0,0,0,0,0,9000,12000,-3000,-3000
20200528,053294,聯發科中信9C購01,0.70,0.71,0.61,0.64,-0.04,-5.88,315000,31,203200,0,0,0,0,0,0,107000,207000,-100000,-100000
20200528,053295,奇力新中信96購01,,,,,0.00,0.00,0,0,0,0,0,0,0,0,0,0,0,0,0
20200528,053296,貿聯中信98購01,,,,,0.00,0.00,0,0,0,0,0,0,0,0,0,0,0,0,0
20200528,053297,鎧勝中信98購01,0.15,0.15,0.15,0.15,0.00,0.00,30000,1,4500,0,0,0,0,0,0,0,30000,-30000,-30000
20200528,053298,SP黃豆凱基99購01,0.20,0.20,0.20,0.20,0.00,0.00,20000,1,4000,0,0,0,0,0,0,0,0,0,0
20200528,053299,台泥凱基96購01,0.01,0.01,0.01,0.01,0.00,0.00,100000,1,1000,0,0,0,0,0,0,100000,0,100000,100000
20200528,053300,大成鋼凱基96購02,,,,,0.00,0.00,0,0,0,0,0,0,0,0,0,0,0,0,0
20200528,053301,華通凱基96購04,,,,,0.00,0.00,0,0,0,0,0,0,0,0,0,0,0,0,0
20200528,053302,國巨凱基96購10,,,,,0.00,0.00,0,0,0,0,0,0,0,0,0,0,0,0,0
20200528,053303,建準凱基96購03,,,,,0.00,0.00,0,0,0,0,0,0,0,0,0,0,0,0,0
20200528,053304,可成凱基96購03,,,,,0.00,0.00,0,0,0,0,0,0,0,0,0,0,0,0,0
20200528,053305,聯詠凱基96購02,,,,,0.00,0.00,0,0,0,0,0,0,0,0,0,0,0,0,0
20200528,053306,晶技凱基97購01,0.93,0.93,0.93,0.93,-0.14,-13.08,3000,1,2790,0,0,0,0,0,0,3000,3000,0,0
20200528,053307,泰碩凱基97購01,,,,,0.00,0.00,0,0,0,0,0,0,0,0,0,0,0,0,0
20200528,053308,智易凱基96購02,,,,,0.00,0.00,0,0,0,0,0,0,0,0,0,0,0,0,0
20200528,053309,泰鼎凱基96購03,,,,,0.00,0.00,0,0,0,0,0,0,0,0,0,0,0,0,0
20200528,053310,彩晶凱基98購02,,,,,0.00,0.00,0,0,0,0,0,0,0,0,0,0,0,0,0
20200528,053311,同欣電凱基96購01,,,,,0.00,0.00,0,0,0,0,0,0,0,0,0,0,0,0,0
20200528,053312,緯穎凱基96購02,,,,,0.00,0.00,0,0,0,0,0,0,0,0,0,0,0,0,0
20200528,053313,世紀鋼凱基96購01,1.95,1.95,1.95,1.95,+0.53,37.32,3000,1,5850,0,0,0,0,0,0,3000,0,3000,3000
20200528,053314,A50正2群益9A購01,,,,,0.00,0.00,0,0,0,0,0,0,0,0,0,0,0,0,0
20200528,053315,漢唐群益96購02,,,,,0.00,0.00,0,0,0,0,0,0,0,0,0,0,0,0,0
20200528,053316,友達群益9A購01,0.69,0.70,0.68,0.69,-0.02,-2.82,209000,4,144380,0,0,0,0,0,0,173000,36000,137000,137000
20200528,053317,友達群益9A購02,0.11,0.11,0.11,0.11,0.00,0.00,64000,6,7040,0,0,0,0,0,0,64000,64000,0,0
20200528,053318,全新群益99購01,,,,,0.00,0.00,0,0,0,0,0,0,0,0,0,0,0,0,0
20200528,053319,可成群益96購04,,,,,0.00,0.00,0,0,0,0,0,0,0,0,0,0,0,0,0
20200528,05331P,上証2X國票96售01,1.08,1.08,1.08,1.08,-0.03,-2.7,1000,1,1080,0,0,0,0,0,0,1000,0,1000,1000
20200528,053320,華新科群益97購01,2.47,2.51,2.35,2.35,-0.24,-9.27,29000,10,71350,0,0,0,0,0,0,20000,9000,11000,11000
20200528,053321,智原群益96購02,,,,,0.00,0.00,0,0,0,0,0,0,0,0,0,0,0,0,0
20200528,053322,京鼎群益97購01,,,,,0.00,0.00,0,0,0,0,0,0,0,0,0,0,0,0,0
20200528,053323,群創群益98購07,,,,,0.00,0.00,0,0,0,0,0,0,0,0,0,0,0,0,0
20200528,053324,康舒群益96購01,,,,,0.00,0.00,0,0,0,0,0,0,0,0,0,0,0,0,0
20200528,053325,GIS群益96購02,,,,,0.00,0.00,0,0,0,0,0,0,0,0,0,0,0,0,0
20200528,053326,瀚宇博台新96購01,,,,,0.00,0.00,0,0,0,0,0,0,0,0,0,0,0,0,0
20200528,053327,彩晶台新97購01,,,,,0.00,0.00,0,0,0,0,0,0,0,0,0,0,0,0,0
20200528,053328,滬深2X永豐99購01,,,,,0.00,0.00,0,0,0,0,0,0,0,0,0,0,0,0,0
20200528,053329,元油反永豐97購01,,,,,0.00,0.00,0,0,0,0,0,0,0,0,0,0,0,0,0
20200528,053330,燿華永豐96購03,,,,,0.00,0.00,0,0,0,0,0,0,0,0,0,0,0,0,0
20200528,053331,玉晶光永豐97購02,0.79,0.89,0.74,0.76,0.00,0.00,343000,10,279560,0,0,0,0,0,0,193000,150000,43000,43000
20200528,053332,創意永豐96購03,0.27,0.27,0.27,0.27,+0.01,3.85,10000,1,2700,0,0,0,0,0,0,0,10000,-10000,-10000
20200528,053333,新唐永豐96購01,,,,,0.00,0.00,0,0,0,0,0,0,0,0,0,0,0,0,0
20200528,053334,訊芯永豐96購01,,,,,0.00,0.00,0,0,0,0,0,0,0,0,0,0,0,0,0
20200528,053335,易華電永豐96購01,,,,,0.00,0.00,0,0,0,0,0,0,0,0,0,0,0,0,0
20200528,053336,元油反國票9B購02,,,,,0.00,0.00,0,0,0,0,0,0,0,0,0,0,0,0,0
20200528,053337,聯電國票97購01,0.41,0.44,0.41,0.44,0.00,0.00,215000,5,90900,0,0,0,0,0,0,38000,177000,-139000,-139000
20200528,053338,台光電國票97購01,,,,,0.00,0.00,0,0,0,0,0,0,0,0,0,0,0,0,0
20200528,053339,友達國票97購02,0.11,0.11,0.11,0.11,0.00,0.00,10000,1,1100,0,0,0,0,0,0,10000,0,10000,10000
20200528,053340,建準國票97購01,3.34,3.93,3.20,3.20,-0.59,-15.57,171000,6,605570,0,0,0,0,0,0,45000,126000,-81000,-81000
20200528,053341,聯發科國票97購03,0.18,0.18,0.18,0.18,0.00,0.00,10000,1,1800,0,0,0,0,0,0,0,0,0,0
20200528,053342,全新國票99購01,0.14,0.14,0.14,0.14,0.00,0.00,20000,1,2800,0,0,0,0,0,0,0,20000,-20000,-20000
20200528,053343,宏達電國票97購02,,,,,0.00,0.00,0,0,0,0,0,0,0,0,0,0,0,0,0
20200528,053344,嘉晶國票97購02,,,,,0.00,0.00,0,0,0,0,0,0,0,0,0,0,0,0,0
20200528,053345,欣興國票97購02,,,,,0.00,0.00,0,0,0,0,0,0,0,0,0,0,0,0,0
20200528,053346,群創國票97購04,,,,,0.00,0.00,0,0,0,0,0,0,0,0,0,0,0,0,0
20200528,053347,茂林國票98購01,,,,,0.00,0.00,0,0,0,0,0,0,0,0,0,0,0,0,0
20200528,053348,彩晶國票97購02,,,,,0.00,0.00,0,0,0,0,0,0,0,0,0,0,0,0,0
20200528,053349,台郡國票97購02,,,,,0.00,0.00,0,0,0,0,0,0,0,0,0,0,0,0,0
20200528,053350,台表科國票97購02,0.96,0.96,0.90,0.93,-0.42,-31.11,148000,3,139290,0,0,0,0,0,0,35000,113000,-78000,-78000
20200528,053351,A50正2兆豐97購01,,,,,0.00,0.00,0,0,0,0,0,0,0,0,0,0,0,0,0
20200528,053352,義隆兆豐96購01,,,,,0.00,0.00,0,0,0,0,0,0,0,0,0,0,0,0,0
20200528,053353,玉晶光兆豐97購03,0.88,0.88,0.87,0.87,+0.12,16.0,9000,2,7900,0,0,0,0,0,0,0,9000,-9000,-9000
20200528,053354,康控兆豐97購02,0.07,0.07,0.07,0.07,-0.02,-22.22,20000,1,1400,0,0,0,0,0,0,20000,0,20000,20000
20200528,053355,超眾兆豐97購01,1.17,1.17,1.17,1.17,+0.01,0.86,20000,1,23400,0,0,0,0,0,0,0,20000,-20000,-20000
20200528,053356,聯發科統一96購07,,,,,0.00,0.00,0,0,0,0,0,0,0,0,0,0,0,0,0
20200528,053357,可成統一96購02,,,,,0.00,0.00,0,0,0,0,0,0,0,0,0,0,0,0,0
20200528,053358,晶技統一98購01,,,,,0.00,0.00,0,0,0,0,0,0,0,0,0,0,0,0,0
20200528,053359,矽力統一96購02,,,,,0.00,0.00,0,0,0,0,0,0,0,0,0,0,0,0,0
20200528,053360,上証2X元富96購01,,,,,0.00,0.00,0,0,0,0,0,0,0,0,0,0,0,0,0
20200528,053361,友達元富99購01,,,,,0.00,0.00,0,0,0,0,0,0,0,0,0,0,0,0,0
20200528,053362,元油反國泰98購01,,,,,0.00,0.00,0,0,0,0,0,0,0,0,0,0,0,0,0
20200528,053363,旺宏國泰98購02,,,,,0.00,0.00,0,0,0,0,0,0,0,0,0,0,0,0,0
20200528,053364,友達國泰98購01,,,,,0.00,0.00,0,0,0,0,0,0,0,0,0,0,0,0,0
20200528,053365,彩晶國泰98購01,,,,,0.00,0.00,0,0,0,0,0,0,0,0,0,0,0,0,0
20200528,053366,樺漢國泰98購01,0.05,0.05,0.05,0.05,0.00,0.00,10000,1,500,0,0,0,0,0,0,10000,0,10000,10000
20200528,053367,元油反富邦97購01,,,,,0.00,0.00,0,0,0,0,0,0,0,0,0,0,0,0,0
20200528,053368,京元電富邦98購01,,,,,0.00,0.00,0,0,0,0,0,0,0,0,0,0,0,0,0
20200528,053369,T50反1元大96購06,,,,,0.00,0.00,0,0,0,0,0,0,0,0,0,0,0,0,0
20200528,053370,上証2X元大97購03,,,,,0.00,0.00,0,0,0,0,0,0,0,0,0,0,0,0,0
20200528,053371,滬深2X元大99購01,,,,,0.00,0.00,0,0,0,0,0,0,0,0,0,0,0,0,0
20200528,053372,元油反元大98購01,,,,,0.00,0.00,0,0,0,0,0,0,0,0,0,0,0,0,0
20200528,053373,台泥元大96購01,,,,,0.00,0.00,0,0,0,0,0,0,0,0,0,0,0,0,0
20200528,053374,台達電元大96購03,,,,,0.00,0.00,0,0,0,0,0,0,0,0,0,0,0,0,0
20200528,053375,鴻海元大96購18,,,,,0.00,0.00,0,0,0,0,0,0,0,0,0,0,0,0,0
20200528,053376,鴻海元大96購19,,,,,0.00,0.00,0,0,0,0,0,0,0,0,0,0,0,0,0
20200528,053377,台積電元大98購01,0.11,0.48,0.11,0.48,0.00,0.00,41000,5,7080,0,0,0,0,0,0,10000,20000,-10000,-10000
20200528,053378,台積電元大98購02,0.60,0.70,0.60,0.65,0.00,0.00,15000,4,9600,0,0,0,0,0,0,5000,10000,-5000,-5000
20200528,053379,南亞科元大96購01,,,,,0.00,0.00,0,0,0,0,0,0,0,0,0,0,0,0,0
20200528,053380,南亞科元大97購01,,,,,0.00,0.00,0,0,0,0,0,0,0,0,0,0,0,0,0
20200528,053381,友達元大9A購02,,,,,0.00,0.00,0,0,0,0,0,0,0,0,0,0,0,0,0
20200528,053382,友達元大9C購02,,,,,0.00,0.00,0,0,0,0,0,0,0,0,0,0,0,0,0
20200528,053383,京元電元大97購01,,,,,0.00,0.00,0,0,0,0,0,0,0,0,0,0,0,0,0
20200528,053384,聯發科元大96購13,,,,,0.00,0.00,0,0,0,0,0,0,0,0,0,0,0,0,0
20200528,053385,聯詠元大96購02,,,,,0.00,0.00,0,0,0,0,0,0,0,0,0,0,0,0,0
20200528,053386,聯詠元大96購03,,,,,0.00,0.00,0,0,0,0,0,0,0,0,0,0,0,0,0
20200528,053387,緯創元大97購01,0.34,0.44,0.34,0.34,0.00,0.00,186000,4,63840,0,0,0,0,0,0,180000,6000,174000,174000
20200528,053388,群創元大9C購02,,,,,0.00,0.00,0,0,0,0,0,0,0,0,0,0,0,0,0
20200528,053389,彩晶元大98購01,,,,,0.00,0.00,0,0,0,0,0,0,0,0,0,0,0,0,0
20200528,053390,彩晶元大9A購01,,,,,0.00,0.00,0,0,0,0,0,0,0,0,0,0,0,0,0
20200528,053391,嘉聯益元大99購01,,,,,0.00,0.00,0,0,0,0,0,0,0,0,0,0,0,0,0
20200528,053392,致新元大96購01,1.86,1.86,1.80,1.85,0.00,0.00,65000,4,118450,0,0,0,0,0,0,45000,0,45000,45000
20200528,053393,元油反中信98購01,,,,,0.00,0.00,0,0,0,0,0,0,0,0,0,0,0,0,0
20200528,053394,鴻海中信9A購01,,,,,0.00,0.00,0,0,0,0,0,0,0,0,0,0,0,0,0
20200528,053395,致茂中信96購01,,,,,0.00,0.00,0,0,0,0,0,0,0,0,0,0,0,0,0
20200528,053396,漢唐中信9A購01,0.52,0.52,0.52,0.52,-0.02,-3.7,11000,1,5720,0,0,0,0,0,0,11000,0,11000,11000
20200528,053397,國泰金中信96購01,,,,,0.00,0.00,0,0,0,0,0,0,0,0,0,0,0,0,0
20200528,053398,和鑫中信99購01,0.07,0.07,0.06,0.06,-0.01,-14.29,150000,13,9500,0,0,0,0,0,0,0,120000,-120000,-120000
20200528,053399,創意中信96購01,,,,,0.00,0.00,0,0,0,0,0,0,0,0,0,0,0,0,0
20200528,053400,緯穎中信9A購01,1.92,2.07,1.81,1.81,-0.12,-6.22,89000,14,170310,0,0,0,0,0,0,21000,68000,-47000,-47000
20200528,053401,臺股指中信99購01,0.14,0.14,0.14,0.14,-0.01,-6.67,20000,1,2800,0,0,0,0,0,0,20000,0,20000,20000
20200528,053402,A50正2群益9A購02,,,,,0.00,0.00,0,0,0,0,0,0,0,0,0,0,0,0,0
20200528,053403,彩晶群益98購01,,,,,0.00,0.00,0,0,0,0,0,0,0,0,0,0,0,0,0
20200528,053404,致新群益96購01,2.74,3.10,2.74,3.10,+0.72,30.25,15000,2,42900,0,0,0,0,0,0,5000,10000,-5000,-5000
20200528,053405,台達電兆豐96購01,,,,,0.00,0.00,0,0,0,0,0,0,0,0,0,0,0,0,0
20200528,053406,國巨兆豐96購02,,,,,0.00,0.00,0,0,0,0,0,0,0,0,0,0,0,0,0
20200528,053407,台積電兆豐96購02,0.85,0.87,0.62,0.68,-0.15,-18.07,115000,6,83500,0,0,0,0,0,0,115000,10000,105000,105000
20200528,053408,友達兆豐98購01,,,,,0.00,0.00,0,0,0,0,0,0,0,0,0,0,0,0,0
20200528,053409,和碩兆豐96購02,,,,,0.00,0.00,0,0,0,0,0,0,0,0,0,0,0,0,0
20200528,053410,啟碁兆豐96購01,,,,,0.00,0.00,0,0,0,0,0,0,0,0,0,0,0,0,0
20200528,053411,深中小國票9B購01,0.83,0.83,0.74,0.74,-0.18,-19.57,54000,7,40880,0,0,0,0,0,0,0,54000,-54000,-54000
20200528,053412,台達電國票97購02,,,,,0.00,0.00,0,0,0,0,0,0,0,0,0,0,0,0,0
20200528,053413,台積電國票99購01,0.21,0.39,0.18,0.39,0.00,0.00,635000,6,129980,0,0,0,0,0,0,499000,635000,-136000,-136000
20200528,053414,臻鼎國票97購01,,,,,0.00,0.00,0,0,0,0,0,0,0,0,0,0,0,0,0
20200528,053415,聯茂國票97購01,,,,,0.00,0.00,0,0,0,0,0,0,0,0,0,0,0,0,0
20200528,053416,光磊台新97購01,,,,,0.00,0.00,0,0,0,0,0,0,0,0,0,0,0,0,0
20200528,053417,上銀永豐96購02,,,,,0.00,0.00,0,0,0,0,0,0,0,0,0,0,0,0,0
20200528,053418,旺宏永豐96購02,0.02,0.02,0.01,0.01,0.00,0.00,113000,3,1260,0,0,0,0,0,0,0,0,0,0
20200528,053419,光罩永豐96購01,,,,,0.00,0.00,0,0,0,0,0,0,0,0,0,0,0,0,0
20200528,053420,華邦電永豐96購01,,,,,0.00,0.00,0,0,0,0,0,0,0,0,0,0,0,0,0
20200528,053421,南亞科永豐96購01,,,,,0.00,0.00,0,0,0,0,0,0,0,0,0,0,0,0,0
20200528,053422,可成永豐96購01,,,,,0.00,0.00,0,0,0,0,0,0,0,0,0,0,0,0,0
20200528,053423,亞光永豐96購01,,,,,0.00,0.00,0,0,0,0,0,0,0,0,0,0,0,0,0
20200528,053424,欣興永豐96購02,,,,,0.00,0.00,0,0,0,0,0,0,0,0,0,0,0,0,0
20200528,053425,京鼎永豐96購01,,,,,0.00,0.00,0,0,0,0,0,0,0,0,0,0,0,0,0
20200528,053426,創意永豐96購04,,,,,0.00,0.00,0,0,0,0,0,0,0,0,0,0,0,0,0
20200528,053427,鎧勝永豐96購02,,,,,0.00,0.00,0,0,0,0,0,0,0,0,0,0,0,0,0
20200528,053428,中磊永豐96購02,0.41,0.41,0.41,0.41,0.00,0.00,33000,1,13530,0,0,0,0,0,0,0,33000,-33000,-33000
20200528,053429,彩晶永豐96購01,,,,,0.00,0.00,0,0,0,0,0,0,0,0,0,0,0,0,0
20200528,053430,樺漢永豐96購01,,,,,0.00,0.00,0,0,0,0,0,0,0,0,0,0,0,0,0
20200528,053431,志超永豐96購01,0.41,0.41,0.41,0.41,0.00,0.00,42000,5,17220,0,0,0,0,0,0,0,42000,-42000,-42000
20200528,053432,世紀鋼永豐96購02,2.58,2.75,2.58,2.75,0.00,0.00,30000,3,80400,0,0,0,0,0,0,0,30000,-30000,-30000
20200528,053433,友達日盛99購06,,,,,0.00,0.00,0,0,0,0,0,0,0,0,0,0,0,0,0
20200528,053434,國泰金日盛96購01,,,,,0.00,0.00,0,0,0,0,0,0,0,0,0,0,0,0,0
20200528,053435,新光金日盛96購01,,,,,0.00,0.00,0,0,0,0,0,0,0,0,0,0,0,0,0
20200528,053436,聯茂日盛96購01,,,,,0.00,0.00,0,0,0,0,0,0,0,0,0,0,0,0,0
20200528,053437,啟碁日盛96購01,,,,,0.00,0.00,0,0,0,0,0,0,0,0,0,0,0,0,0
20200528,053438,玉晶光麥證97購02,0.39,0.39,0.39,0.39,0.00,0.00,11000,2,4290,0,10000,-10000,0,0,0,0,10000,-10000,-10000
20200528,053439,台積電凱基96購11,,,,,0.00,0.00,0,0,0,0,0,0,0,0,0,0,0,0,0
20200528,053440,台積電凱基96購12,,,,,0.00,0.00,0,0,0,0,0,0,0,0,0,0,0,0,0
20200528,053441,旺宏凱基98購01,,,,,0.00,0.00,0,0,0,0,0,0,0,0,0,0,0,0,0
20200528,053442,光罩凱基96購01,,,,,0.00,0.00,0,0,0,0,0,0,0,0,0,0,0,0,0
20200528,053443,智邦凱基97購01,11.20,11.20,9.40,9.40,0.00,0.00,6000,2,58200,0,0,0,0,0,0,0,6000,-6000,-6000
20200528,053444,奇力新凱基96購03,,,,,0.00,0.00,0,0,0,0,0,0,0,0,0,0,0,0,0
20200528,053445,可成凱基96購04,,,,,0.00,0.00,0,0,0,0,0,0,0,0,0,0,0,0,0
20200528,053446,欣興凱基96購02,,,,,0.00,0.00,0,0,0,0,0,0,0,0,0,0,0,0,0
20200528,053447,京鼎凱基96購03,,,,,0.00,0.00,0,0,0,0,0,0,0,0,0,0,0,0,0
20200528,053448,智易凱基96購03,,,,,0.00,0.00,0,0,0,0,0,0,0,0,0,0,0,0,0
20200528,053449,超眾凱基98購01,,,,,0.00,0.00,0,0,0,0,0,0,0,0,0,0,0,0,0
20200528,053450,同欣電凱基96購02,0.19,0.19,0.19,0.19,0.00,0.00,40000,1,7600,0,0,0,0,0,0,40000,0,40000,40000
20200528,053451,致新凱基96購02,0.84,0.84,0.84,0.84,+0.10,13.51,10000,1,8400,0,0,0,0,0,0,10000,0,10000,10000
20200528,053452,臺股指凱基97購01,0.04,0.04,0.04,0.04,0.00,0.00,1000,1,40,0,0,0,0,0,0,0,0,0,0
20200528,053453,新光金統一98購01,,,,,0.00,0.00,0,0,0,0,0,0,0,0,0,0,0,0,0
20200528,053454,創意統一96購02,,,,,0.00,0.00,0,0,0,0,0,0,0,0,0,0,0,0,0
20200528,053455,台光電元富96購02,0.94,0.94,0.69,0.69,-0.35,-33.65,102000,2,70880,0,0,0,0,0,0,0,102000,-102000,-102000
20200528,053456,大立光元富96購04,,,,,0.00,0.00,0,0,0,0,0,0,0,0,0,0,0,0,0
20200528,053457,旺宏國泰98購03,,,,,0.00,0.00,0,0,0,0,0,0,0,0,0,0,0,0,0
20200528,053458,聯詠國泰97購01,,,,,0.00,0.00,0,0,0,0,0,0,0,0,0,0,0,0,0
20200528,053459,康控國泰97購01,,,,,0.00,0.00,0,0,0,0,0,0,0,0,0,0,0,0,0
20200528,053460,緯穎國泰97購01,,,,,0.00,0.00,0,0,0,0,0,0,0,0,0,0,0,0,0
20200528,053461,台郡永昌99購01,0.30,7.40,0.30,7.40,+3.51,90.23,11000,2,10400,0,0,0,0,0,0,0,10000,-10000,-10000
20200528,053462,元油反富邦97購02,,,,,0.00,0.00,0,0,0,0,0,0,0,0,0,0,0,0,0
20200528,053463,可成富邦98購01,,,,,0.00,0.00,0,0,0,0,0,0,0,0,0,0,0,0,0
20200528,053464,喬山元大96購01,,,,,0.00,0.00,0,0,0,0,0,0,0,0,0,0,0,0,0
20200528,053465,聯電元大96購05,,,,,0.00,0.00,0,0,0,0,0,0,0,0,0,0,0,0,0
20200528,053466,華通元大98購01,,,,,0.00,0.00,0,0,0,0,0,0,0,0,0,0,0,0,0
20200528,053467,鴻海元大96購20,,,,,0.00,0.00,0,0,0,0,0,0,0,0,0,0,0,0,0
20200528,053468,鴻海元大98購01,0.05,0.05,0.05,0.05,+0.02,66.67,6000,2,300,0,0,0,0,0,0,5000,0,5000,5000
20200528,053469,光磊元大97購01,,,,,0.00,0.00,0,0,0,0,0,0,0,0,0,0,0,0,0
20200528,053470,華邦電元大96購02,,,,,0.00,0.00,0,0,0,0,0,0,0,0,0,0,0,0,0
20200528,053471,正崴元大96購01,,,,,0.00,0.00,0,0,0,0,0,0,0,0,0,0,0,0,0
20200528,053472,漢唐元大96購02,,,,,0.00,0.00,0,0,0,0,0,0,0,0,0,0,0,0,0
20200528,053473,聯發科元大96購15,,,,,0.00,0.00,0,0,0,0,0,0,0,0,0,0,0,0,0
20200528,053474,聯發科元大97購06,,,,,0.00,0.00,0,0,0,0,0,0,0,0,0,0,0,0,0
20200528,053475,華新科元大96購05,,,,,0.00,0.00,0,0,0,0,0,0,0,0,0,0,0,0,0
20200528,053476,冠德元大96購03,0.03,0.03,0.03,0.03,0.00,0.00,2000,1,60,0,0,0,0,0,0,2000,0,2000,2000
20200528,053477,大立光元大97購03,,,,,0.00,0.00,0,0,0,0,0,0,0,0,0,0,0,0,0
20200528,053478,京鼎元大96購01,,,,,0.00,0.00,0,0,0,0,0,0,0,0,0,0,0,0,0
20200528,053479,達興元大96購01,,,,,0.00,0.00,0,0,0,0,0,0,0,0,0,0,0,0,0
20200528,05347P,滬深2X元富9B售02,1.60,1.60,1.60,1.60,+0.14,9.59,5000,1,8000,0,0,0,0,0,0,0,5000,-5000,-5000
20200528,053480,祥碩元大96購02,,,,,0.00,0.00,0,0,0,0,0,0,0,0,0,0,0,0,0
20200528,053481,同欣電元大97購01,,,,,0.00,0.00,0,0,0,0,0,0,0,0,0,0,0,0,0
20200528,053482,矽力元大96購03,,,,,0.00,0.00,0,0,0,0,0,0,0,0,0,0,0,0,0
20200528,053483,嘉澤第一96購01,,,,,0.00,0.00,0,0,0,0,0,0,0,0,0,0,0,0,0
20200528,053484,國巨國票97購03,,,,,0.00,0.00,0,0,0,0,0,0,0,0,0,0,0,0,0
20200528,053485,矽創國票97購04,0.48,0.66,0.48,0.54,+0.11,25.58,1430000,34,801190,0,0,0,0,0,0,500000,930000,-430000,-430000
20200528,053486,T50反1兆豐96購01,0.74,0.74,0.74,0.74,+0.05,7.25,90000,3,66600,0,0,0,0,0,0,90000,0,90000,90000
20200528,053487,台泥兆豐97購01,2.82,2.82,2.82,2.82,-0.03,-1.05,30000,1,84600,0,0,0,0,0,0,30000,0,30000,30000
20200528,053488,中石化兆豐97購01,,,,,0.00,0.00,0,0,0,0,0,0,0,0,0,0,0,0,0
20200528,053489,上銀兆豐97購01,4.70,4.84,4.70,4.84,+0.04,0.83,19000,7,90200,0,0,0,0,0,0,19000,0,19000,19000
20200528,05348P,美律元富98售01,0.86,0.87,0.86,0.87,-0.05,-5.43,70000,2,60700,0,0,0,0,0,0,0,70000,-70000,-70000
20200528,053490,為升兆豐97購01,0.11,0.11,0.10,0.10,0.00,0.00,20000,2,2100,0,0,0,0,0,0,0,20000,-20000,-20000
20200528,053491,鴻海兆豐97購02,,,,,0.00,0.00,0,0,0,0,0,0,0,0,0,0,0,0,0
20200528,053492,華邦電兆豐97購01,0.40,0.42,0.34,0.34,+0.02,6.25,465000,38,191410,0,0,0,0,0,0,330000,85000,245000,245000
20200528,053493,智邦兆豐97購02,,,,,0.00,0.00,0,0,0,0,0,0,0,0,0,0,0,0,0
20200528,053494,南亞科兆豐96購02,0.28,0.28,0.20,0.20,-0.02,-9.09,240000,15,57000,0,0,0,0,0,0,100000,140000,-40000,-40000
20200528,053495,聯發科兆豐96購02,,,,,0.00,0.00,0,0,0,0,0,0,0,0,0,0,0,0,0
20200528,053496,義隆兆豐96購02,2.19,2.24,2.08,2.12,+0.16,8.16,325000,35,705820,0,0,0,0,0,0,206000,119000,87000,87000
20200528,053497,新光金兆豐97購01,0.04,0.04,0.04,0.04,0.00,0.00,10000,1,400,0,0,0,0,0,0,0,10000,-10000,-10000
20200528,053498,大立光兆豐96購03,,,,,0.00,0.00,0,0,0,0,0,0,0,0,0,0,0,0,0
20200528,053499,禾伸堂兆豐96購01,,,,,0.00,0.00,0,0,0,0,0,0,0,0,0,0,0,0,0
20200528,05349P,可成元富98售03,,,,,0.00,0.00,0,0,0,0,0,0,0,0,0,0,0,0,0
20200528,053500,新日興兆豐97購01,2.21,2.28,2.12,2.12,+0.16,8.16,94000,8,207450,0,0,0,0,0,0,93000,1000,92000,92000
20200528,053501,明泰兆豐96購01,2.59,2.59,2.46,2.46,-0.09,-3.53,80000,13,201230,0,0,0,0,0,0,30000,50000,-20000,-20000
20200528,053502,智伸科兆豐97購01,0.81,0.82,0.70,0.70,-0.14,-16.67,355000,26,272990,0,0,0,0,0,0,303000,52000,251000,251000
20200528,053503,臻鼎兆豐97購01,1.25,1.25,1.25,1.25,-0.22,-14.97,1000,1,1250,0,0,0,0,0,0,0,1000,-1000,-1000
20200528,053504,祥碩兆豐96購01,,,,,0.00,0.00,0,0,0,0,0,0,0,0,0,0,0,0,0
20200528,053505,瑞儀兆豐97購01,,,,,0.00,0.00,0,0,0,0,0,0,0,0,0,0,0,0,0
20200528,053506,南茂兆豐97購01,1.39,1.39,1.39,1.39,-0.10,-6.71,50000,1,69500,0,0,0,0,0,0,50000,0,50000,50000
20200528,053507,百和兆豐96購01,0.44,0.44,0.44,0.44,+0.04,10.0,152000,2,66880,0,0,0,0,0,0,152000,0,152000,152000
20200528,053508,元油反群益9A購01,,,,,0.00,0.00,0,0,0,0,0,0,0,0,0,0,0,0,0
20200528,053509,華新群益98購01,0.53,0.54,0.45,0.45,+0.20,80.0,66000,8,31400,0,0,0,0,0,0,0,56000,-56000,-56000
20200528,05350P,可成元富98售04,,,,,0.00,0.00,0,0,0,0,0,0,0,0,0,0,0,0,0
20200528,053510,聯電群益97購01,,,,,0.00,0.00,0,0,0,0,0,0,0,0,0,0,0,0,0
20200528,053511,鴻海群益96購04,,,,,0.00,0.00,0,0,0,0,0,0,0,0,0,0,0,0,0
20200528,053512,台積電群益96購06,,,,,0.00,0.00,0,0,0,0,0,0,0,0,0,0,0,0,0
20200528,053513,義隆群益96購05,,,,,0.00,0.00,0,0,0,0,0,0,0,0,0,0,0,0,0
20200528,053514,麗豐群益96購01,,,,,0.00,0.00,0,0,0,0,0,0,0,0,0,0,0,0,0
20200528,053515,致伸群益96購02,,,,,0.00,0.00,0,0,0,0,0,0,0,0,0,0,0,0,0
20200528,053516,茂林群益96購05,,,,,0.00,0.00,0,0,0,0,0,0,0,0,0,0,0,0,0
20200528,053517,崇越群益97購01,,,,,0.00,0.00,0,0,0,0,0,0,0,0,0,0,0,0,0
20200528,053518,聯茂群益96購03,,,,,0.00,0.00,0,0,0,0,0,0,0,0,0,0,0,0,0
20200528,053519,力成群益96購02,,,,,0.00,0.00,0,0,0,0,0,0,0,0,0,0,0,0,0
20200528,053520,康友群益96購01,,,,,0.00,0.00,0,0,0,0,0,0,0,0,0,0,0,0,0
20200528,053521,緯穎群益96購02,8.20,8.20,8.20,8.20,0.00,0.00,5000,1,41000,0,0,0,0,0,0,5000,0,5000,5000
20200528,053522,臺股指群益99購01,,,,,0.00,0.00,0,0,0,0,0,0,0,0,0,0,0,0,0
20200528,053523,T50反1中信9A購01,,,,,0.00,0.00,0,0,0,0,0,0,0,0,0,0,0,0,0
20200528,053524,聯電中信97購02,,,,,0.00,0.00,0,0,0,0,0,0,0,0,0,0,0,0,0
20200528,053525,台積電中信96購04,,,,,0.00,0.00,0,0,0,0,0,0,0,0,0,0,0,0,0
20200528,053526,正崴中信96購01,,,,,0.00,0.00,0,0,0,0,0,0,0,0,0,0,0,0,0
20200528,053527,創意中信97購01,0.15,0.17,0.14,0.14,0.00,0.00,115000,5,17400,0,0,0,0,0,0,5000,110000,-105000,-105000
20200528,053528,南電中信9A購01,0.48,0.48,0.48,0.48,-0.02,-4.0,5000,1,2400,0,0,0,0,0,0,0,0,0,0
20200528,053529,國巨麥證96購01,,,,,0.00,0.00,0,0,0,0,0,0,0,0,0,0,0,0,0
20200528,053530,聯發科康和96購01,,,,,0.00,0.00,0,0,0,0,0,0,0,0,0,0,0,0,0
20200528,053531,國泰金康和96購01,,,,,0.00,0.00,0,0,0,0,0,0,0,0,0,0,0,0,0
20200528,053532,台積電永豐96購03,,,,,0.00,0.00,0,0,0,0,0,0,0,0,0,0,0,0,0
20200528,053533,光罩永豐96購03,,,,,0.00,0.00,0,0,0,0,0,0,0,0,0,0,0,0,0
20200528,053534,微星永豐96購02,,,,,0.00,0.00,0,0,0,0,0,0,0,0,0,0,0,0,0
20200528,053535,宏達電永豐96購02,,,,,0.00,0.00,0,0,0,0,0,0,0,0,0,0,0,0,0
20200528,053536,明泰永豐96購01,,,,,0.00,0.00,0,0,0,0,0,0,0,0,0,0,0,0,0
20200528,053537,玉晶光永豐98購02,0.35,0.35,0.35,0.35,0.00,0.00,6000,1,2100,0,0,0,0,0,0,6000,0,6000,6000
20200528,053538,京鼎永豐96購03,,,,,0.00,0.00,0,0,0,0,0,0,0,0,0,0,0,0,0
20200528,053539,智易永豐96購01,,,,,0.00,0.00,0,0,0,0,0,0,0,0,0,0,0,0,0
20200528,053540,健策永豐96購01,,,,,0.00,0.00,0,0,0,0,0,0,0,0,0,0,0,0,0
20200528,053541,泰鼎永豐96購02,,,,,0.00,0.00,0,0,0,0,0,0,0,0,0,0,0,0,0
20200528,053542,超眾永豐96購01,,,,,0.00,0.00,0,0,0,0,0,0,0,0,0,0,0,0,0
20200528,053543,臺股指永豐96購02,,,,,0.00,0.00,0,0,0,0,0,0,0,0,0,0,0,0,0
20200528,053544,華新凱基96購01,0.01,0.01,0.01,0.01,0.00,0.00,2000,1,20,0,0,0,0,0,0,2000,0,2000,2000
20200528,053545,上銀凱基96購03,0.88,0.88,0.88,0.88,+0.58,193.33,3000,1,2640,0,0,0,0,0,0,3000,0,3000,3000
20200528,053546,台積電凱基96購13,,,,,0.00,0.00,0,0,0,0,0,0,0,0,0,0,0,0,0
20200528,053547,台積電凱基96購14,,,,,0.00,0.00,0,0,0,0,0,0,0,0,0,0,0,0,0
20200528,053548,旺宏凱基96購04,,,,,0.00,0.00,0,0,0,0,0,0,0,0,0,0,0,0,0
20200528,053549,南亞科凱基96購02,,,,,0.00,0.00,0,0,0,0,0,0,0,0,0,0,0,0,0
20200528,053550,聯發科凱基96購15,,,,,0.00,0.00,0,0,0,0,0,0,0,0,0,0,0,0,0
20200528,053551,可成凱基96購05,,,,,0.00,0.00,0,0,0,0,0,0,0,0,0,0,0,0,0
20200528,053552,華新科凱基96購08,,,,,0.00,0.00,0,0,0,0,0,0,0,0,0,0,0,0,0
20200528,053553,聯詠凱基96購03,,,,,0.00,0.00,0,0,0,0,0,0,0,0,0,0,0,0,0
20200528,053554,欣興凱基97購02,,,,,0.00,0.00,0,0,0,0,0,0,0,0,0,0,0,0,0
20200528,053555,日月光凱基97購01,,,,,0.00,0.00,0,0,0,0,0,0,0,0,0,0,0,0,0
20200528,053556,康控凱基97購02,,,,,0.00,0.00,0,0,0,0,0,0,0,0,0,0,0,0,0
20200528,053557,聯茂凱基96購04,,,,,0.00,0.00,0,0,0,0,0,0,0,0,0,0,0,0,0
20200528,053558,訊芯凱基96購02,,,,,0.00,0.00,0,0,0,0,0,0,0,0,0,0,0,0,0
20200528,053559,台積電國泰98購01,,,,,0.00,0.00,0,0,0,0,0,0,0,0,0,0,0,0,0
20200528,053560,漢唐國泰98購01,1.74,1.74,1.61,1.61,0.00,0.00,16000,3,27310,0,0,0,0,0,0,16000,5000,11000,11000
20200528,053561,玉晶光國泰98購01,,,,,0.00,0.00,0,0,0,0,0,0,0,0,0,0,0,0,0
20200528,053562,玉晶光國泰98購02,,,,,0.00,0.00,0,0,0,0,0,0,0,0,0,0,0,0,0
20200528,053563,台積電富邦97購01,,,,,0.00,0.00,0,0,0,0,0,0,0,0,0,0,0,0,0
20200528,053564,台積電富邦99購01,0.12,0.12,0.11,0.11,-0.01,-8.33,2977000,67,330910,0,0,0,0,0,0,0,2166000,-2166000,-2166000
20200528,053565,台光電富邦98購01,0.84,0.84,0.79,0.79,-0.13,-14.13,56000,3,45590,0,0,0,0,0,0,51000,56000,-5000,-5000
20200528,053566,大立光富邦99購03,,,,,0.00,0.00,0,0,0,0,0,0,0,0,0,0,0,0,0
20200528,053567,群創富邦97購01,,,,,0.00,0.00,0,0,0,0,0,0,0,0,0,0,0,0,0
20200528,053568,智伸科富邦98購01,0.17,0.17,0.17,0.17,0.00,0.00,10000,1,1700,0,0,0,0,0,0,0,10000,-10000,-10000
20200528,053569,漢唐統一98購01,0.64,0.64,0.64,0.64,-0.04,-5.88,60000,2,38400,0,0,0,0,0,0,10000,50000,-40000,-40000
20200528,053570,京元電統一96購01,,,,,0.00,0.00,0,0,0,0,0,0,0,0,0,0,0,0,0
20200528,053571,奇鋐統一96購02,,,,,0.00,0.00,0,0,0,0,0,0,0,0,0,0,0,0,0
20200528,053572,彩晶統一96購01,,,,,0.00,0.00,0,0,0,0,0,0,0,0,0,0,0,0,0
20200528,053573,臺股指統一99購01,0.53,0.54,0.41,0.45,-0.05,-10.0,353000,38,173510,0,0,0,0,0,0,128000,225000,-97000,-97000
20200528,053574,奇力新元富99購01,,,,,0.00,0.00,0,0,0,0,0,0,0,0,0,0,0,0,0
20200528,053575,聯詠元富96購01,,,,,0.00,0.00,0,0,0,0,0,0,0,0,0,0,0,0,0
20200528,053576,智原元富96購01,,,,,0.00,0.00,0,0,0,0,0,0,0,0,0,0,0,0,0
20200528,053577,上証2X元大96購02,,,,,0.00,0.00,0,0,0,0,0,0,0,0,0,0,0,0,0
20200528,053578,華新元大98購01,0.54,0.66,0.54,0.61,0.00,0.00,120000,11,74200,0,0,0,0,0,0,20000,100000,-80000,-80000
20200528,053579,華通元大97購01,,,,,0.00,0.00,0,0,0,0,0,0,0,0,0,0,0,0,0
20200528,053580,國巨元大96購10,,,,,0.00,0.00,0,0,0,0,0,0,0,0,0,0,0,0,0
20200528,053581,台積電元大96購14,,,,,0.00,0.00,0,0,0,0,0,0,0,0,0,0,0,0,0
20200528,053582,英業達元大97購01,1.36,1.36,1.25,1.25,-0.07,-5.3,13000,4,17330,0,0,0,0,0,0,9000,4000,5000,5000
20200528,053583,漢唐元大96購03,1.06,1.06,0.95,0.95,-0.14,-12.84,150000,4,154800,0,0,0,0,0,0,50000,100000,-50000,-50000
20200528,053584,友達元大9B購02,0.76,0.77,0.75,0.75,-0.03,-3.85,144000,4,110340,0,0,0,0,0,0,44000,100000,-56000,-56000
20200528,053585,友達元大9C購03,,,,,0.00,0.00,0,0,0,0,0,0,0,0,0,0,0,0,0
20200528,053586,建準元大96購01,2.55,2.55,2.55,2.55,+0.03,1.19,20000,2,51000,0,0,0,0,0,0,0,0,0,0
20200528,053587,京元電元大98購01,,,,,0.00,0.00,0,0,0,0,0,0,0,0,0,0,0,0,0
20200528,053588,聯發科元大97購07,,,,,0.00,0.00,0,0,0,0,0,0,0,0,0,0,0,0,0
20200528,053589,宏達電元大97購02,,,,,0.00,0.00,0,0,0,0,0,0,0,0,0,0,0,0,0
20200528,053590,新光金元大9A購02,,,,,0.00,0.00,0,0,0,0,0,0,0,0,0,0,0,0,0
20200528,053591,大立光元大99購03,,,,,0.00,0.00,0,0,0,0,0,0,0,0,0,0,0,0,0
20200528,053592,亞光元大96購01,,,,,0.00,0.00,0,0,0,0,0,0,0,0,0,0,0,0,0
20200528,053593,晶技元大98購01,2.20,2.20,2.05,2.07,-0.14,-6.33,563000,24,1193910,0,0,0,0,0,0,315000,228000,87000,87000
20200528,053594,京鼎元大96購02,,,,,0.00,0.00,0,0,0,0,0,0,0,0,0,0,0,0,0
20200528,053595,創意元大96購02,0.25,0.25,0.25,0.25,-0.02,-7.41,14000,2,3500,0,0,0,0,0,0,4000,10000,-6000,-6000
20200528,053596,嘉澤元大96購01,,,,,0.00,0.00,0,0,0,0,0,0,0,0,0,0,0,0,0
20200528,053597,牧德元大99購01,,,,,0.00,0.00,0,0,0,0,0,0,0,0,0,0,0,0,0
20200528,053598,日月光元大96購04,,,,,0.00,0.00,0,0,0,0,0,0,0,0,0,0,0,0,0
20200528,053599,崇越元大96購01,,,,,0.00,0.00,0,0,0,0,0,0,0,0,0,0,0,0,0
20200528,053600,同欣電元大96購04,,,,,0.00,0.00,0,0,0,0,0,0,0,0,0,0,0,0,0
20200528,053601,台表科元大98購01,,,,,0.00,0.00,0,0,0,0,0,0,0,0,0,0,0,0,0
20200528,053602,台虹元大96購01,0.33,0.33,0.33,0.33,-0.09,-21.43,75000,1,24750,0,0,0,0,0,0,75000,0,75000,75000
20200528,053603,臺股指元大96購20,,,,,0.00,0.00,0,0,0,0,0,0,0,0,0,0,0,0,0
20200528,053604,臺股指元大96購21,,,,,0.00,0.00,0,0,0,0,0,0,0,0,0,0,0,0,0
20200528,053605,臺股指永昌96購01,,,,,0.00,0.00,0,0,0,0,0,0,0,0,0,0,0,0,0
20200528,053606,臺股指永昌96購02,,,,,0.00,0.00,0,0,0,0,0,0,0,0,0,0,0,0,0
20200528,053607,大立光第一96購01,,,,,0.00,0.00,0,0,0,0,0,0,0,0,0,0,0,0,0
20200528,053608,彩晶第一96購01,,,,,0.00,0.00,0,0,0,0,0,0,0,0,0,0,0,0,0
20200528,053609,華新中信9A購01,0.16,0.25,0.12,0.12,-0.02,-14.29,216000,35,41100,0,0,0,0,0,0,40000,102000,-62000,-62000
20200528,053610,矽力中信98購01,2.18,2.52,2.18,2.42,+0.33,15.79,81000,16,200520,0,0,0,0,0,0,18000,50000,-32000,-32000
20200528,053611,聯茂麥證96購01,,,,,0.00,0.00,0,0,0,0,0,0,0,0,0,0,0,0,0
20200528,053612,T50反1群益96購01,0.45,0.45,0.45,0.45,0.00,0.00,20000,1,9000,0,0,0,0,0,0,20000,0,20000,20000
20200528,053613,元油反群益9A購02,,,,,0.00,0.00,0,0,0,0,0,0,0,0,0,0,0,0,0
20200528,053614,台積電群益96購08,,,,,0.00,0.00,0,0,0,0,0,0,0,0,0,0,0,0,0
20200528,053615,光罩群益96購01,,,,,0.00,0.00,0,0,0,0,0,0,0,0,0,0,0,0,0
20200528,053616,奇力新群益97購01,,,,,0.00,0.00,0,0,0,0,0,0,0,0,0,0,0,0,0
20200528,053617,宏達電群益96購02,,,,,0.00,0.00,0,0,0,0,0,0,0,0,0,0,0,0,0
20200528,053618,新唐群益96購01,,,,,0.00,0.00,0,0,0,0,0,0,0,0,0,0,0,0,0
20200528,053619,和碩群益96購01,,,,,0.00,0.00,0,0,0,0,0,0,0,0,0,0,0,0,0
20200528,05361P,聯發科富邦97售01,0.48,0.56,0.48,0.53,0.00,0.00,652000,23,360400,0,0,0,0,0,0,65000,587000,-522000,-522000
20200528,053620,臺股指群益96購06,0.02,0.02,0.02,0.02,0.00,0.00,6000,1,120,0,0,0,0,0,0,6000,0,6000,6000
20200528,053621,臺股指群益96購07,0.84,0.84,0.84,0.84,-0.18,-17.65,1000,1,840,0,0,0,0,0,0,0,1000,-1000,-1000
20200528,053622,臺股指群益96購08,,,,,0.00,0.00,0,0,0,0,0,0,0,0,0,0,0,0,0
20200528,053623,臺股指群益96購09,,,,,0.00,0.00,0,0,0,0,0,0,0,0,0,0,0,0,0
20200528,053624,A50正2兆豐97購02,,,,,0.00,0.00,0,0,0,0,0,0,0,0,0,0,0,0,0
20200528,053625,國巨兆豐96購03,,,,,0.00,0.00,0,0,0,0,0,0,0,0,0,0,0,0,0
20200528,053626,台積電兆豐96購03,,,,,0.00,0.00,0,0,0,0,0,0,0,0,0,0,0,0,0
20200528,053627,宏碁兆豐97購01,,,,,0.00,0.00,0,0,0,0,0,0,0,0,0,0,0,0,0
20200528,053628,微星兆豐96購01,4.26,4.26,4.26,4.26,-0.34,-7.39,2000,1,8520,0,0,0,0,0,0,2000,0,2000,2000
20200528,053629,玉山金兆豐96購01,,,,,0.00,0.00,0,0,0,0,0,0,0,0,0,0,0,0,0
20200528,05362P,可成富邦97售02,1.58,1.59,1.58,1.59,0.00,0.00,30000,3,47500,0,0,0,0,0,0,0,30000,-30000,-30000
20200528,053630,奇鋐兆豐97購01,0.92,1.08,0.92,0.97,+0.06,6.59,654000,47,651840,0,0,0,0,0,0,12000,642000,-630000,-630000
20200528,053631,欣興兆豐97購01,1.06,1.09,1.03,1.03,+0.08,8.42,78000,4,83230,0,0,0,0,0,0,5000,73000,-68000,-68000
20200528,053632,新唐兆豐96購01,0.23,0.23,0.23,0.23,+0.06,35.29,5000,1,1150,0,0,0,0,0,0,5000,0,5000,5000
20200528,053633,臺股指兆豐96購01,,,,,0.00,0.00,0,0,0,0,0,0,0,0,0,0,0,0,0
20200528,053634,劍麟永豐96購01,,,,,0.00,0.00,0,0,0,0,0,0,0,0,0,0,0,0,0
20200528,053635,技嘉永豐96購01,,,,,0.00,0.00,0,0,0,0,0,0,0,0,0,0,0,0,0
20200528,053636,全新永豐96購02,,,,,0.00,0.00,0,0,0,0,0,0,0,0,0,0,0,0,0
20200528,053637,強茂永豐96購01,0.28,0.28,0.28,0.28,-0.03,-9.68,100000,1,28000,0,0,0,0,0,0,100000,0,100000,100000
20200528,053638,信邦永豐96購01,0.31,0.31,0.31,0.31,-0.05,-13.89,1000,1,310,0,0,0,0,0,0,1000,0,1000,1000
20200528,053639,禾伸堂永豐96購01,,,,,0.00,0.00,0,0,0,0,0,0,0,0,0,0,0,0,0
20200528,053640,上緯控永豐96購01,0.82,0.82,0.58,0.64,-0.06,-8.57,125000,7,80400,0,0,0,0,0,0,90000,35000,55000,55000
20200528,053641,正文永豐96購01,,,,,0.00,0.00,0,0,0,0,0,0,0,0,0,0,0,0,0
20200528,053642,瀚宇博永豐96購01,,,,,0.00,0.00,0,0,0,0,0,0,0,0,0,0,0,0,0
20200528,053643,漢唐國票97購02,4.73,4.73,4.73,4.73,-0.32,-6.34,5000,2,23650,0,0,0,0,0,0,2000,3000,-1000,-1000
20200528,053644,台表科國票97購03,1.16,1.16,1.16,1.16,-0.70,-37.63,60000,1,69600,0,0,0,0,0,0,60000,0,60000,60000
20200528,053645,臺股指國票96購08,,,,,0.00,0.00,0,0,0,0,0,0,0,0,0,0,0,0,0
20200528,053646,臺股指國票96購09,,,,,0.00,0.00,0,0,0,0,0,0,0,0,0,0,0,0,0
20200528,053647,臺股指國票96購10,,,,,0.00,0.00,0,0,0,0,0,0,0,0,0,0,0,0,0
20200528,053648,台積電凱基97購04,0.31,0.31,0.30,0.30,0.00,0.00,216000,2,64960,0,0,0,0,0,0,200000,16000,184000,184000
20200528,053649,台積電凱基97購05,0.05,0.05,0.05,0.05,-0.01,-16.67,10000,2,500,0,0,0,0,0,0,0,0,0,0
20200528,053650,華邦電凱基98購01,,,,,0.00,0.00,0,0,0,0,0,0,0,0,0,0,0,0,0
20200528,053651,台光電凱基98購01,,,,,0.00,0.00,0,0,0,0,0,0,0,0,0,0,0,0,0
20200528,053652,友達凱基98購04,,,,,0.00,0.00,0,0,0,0,0,0,0,0,0,0,0,0,0
20200528,053653,京元電凱基96購02,,,,,0.00,0.00,0,0,0,0,0,0,0,0,0,0,0,0,0
20200528,053654,聯發科凱基98購01,,,,,0.00,0.00,0,0,0,0,0,0,0,0,0,0,0,0,0
20200528,053655,全新凱基98購02,,,,,0.00,0.00,0,0,0,0,0,0,0,0,0,0,0,0,0
20200528,053656,可成凱基96購06,,,,,0.00,0.00,0,0,0,0,0,0,0,0,0,0,0,0,0
20200528,053657,元大金凱基96購01,,,,,0.00,0.00,0,0,0,0,0,0,0,0,0,0,0,0,0
20200528,053658,亞光凱基96購01,,,,,0.00,0.00,0,0,0,0,0,0,0,0,0,0,0,0,0
20200528,053659,智原凱基97購01,,,,,0.00,0.00,0,0,0,0,0,0,0,0,0,0,0,0,0
20200528,053660,群創凱基98購08,,,,,0.00,0.00,0,0,0,0,0,0,0,0,0,0,0,0,0
20200528,053661,嘉澤凱基97購01,,,,,0.00,0.00,0,0,0,0,0,0,0,0,0,0,0,0,0
20200528,053662,矽力凱基97購01,6.75,7.50,6.75,6.95,+0.65,10.32,77000,27,537650,0,0,0,0,0,0,31000,46000,-15000,-15000
20200528,053663,臺股指凱基96購24,,,,,0.00,0.00,0,0,0,0,0,0,0,0,0,0,0,0,0
20200528,053664,臺股指凱基96購25,,,,,0.00,0.00,0,0,0,0,0,0,0,0,0,0,0,0,0
20200528,053665,臺股指凱基96購26,,,,,0.00,0.00,0,0,0,0,0,0,0,0,0,0,0,0,0
20200528,053666,臺股指凱基96購29,,,,,0.00,0.00,0,0,0,0,0,0,0,0,0,0,0,0,0
20200528,053667,鴻海統一96購12,,,,,0.00,0.00,0,0,0,0,0,0,0,0,0,0,0,0,0
20200528,053668,鴻海統一97購01,,,,,0.00,0.00,0,0,0,0,0,0,0,0,0,0,0,0,0
20200528,053669,台積電統一96購08,,,,,0.00,0.00,0,0,0,0,0,0,0,0,0,0,0,0,0
20200528,053670,台積電統一96購09,,,,,0.00,0.00,0,0,0,0,0,0,0,0,0,0,0,0,0
20200528,053671,可成統一96購03,,,,,0.00,0.00,0,0,0,0,0,0,0,0,0,0,0,0,0
20200528,053672,嘉澤元富96購02,,,,,0.00,0.00,0,0,0,0,0,0,0,0,0,0,0,0,0
20200528,053673,超眾元富96購03,,,,,0.00,0.00,0,0,0,0,0,0,0,0,0,0,0,0,0
20200528,053674,臺股指元富96購01,,,,,0.00,0.00,0,0,0,0,0,0,0,0,0,0,0,0,0
20200528,053675,臺股指元富96購02,,,,,0.00,0.00,0,0,0,0,0,0,0,0,0,0,0,0,0
20200528,053676,新光金國泰98購02,0.05,0.05,0.05,0.05,+0.04,400.0,31000,1,1550,0,0,0,0,0,0,0,0,0,0
20200528,053677,同欣電國泰97購01,0.62,0.62,0.54,0.58,-0.14,-19.44,33000,4,18440,0,0,0,0,0,0,25000,8000,17000,17000
20200528,053678,南亞科富邦97購01,,,,,0.00,0.00,0,0,0,0,0,0,0,0,0,0,0,0,0
20200528,053679,緯創富邦96購01,,,,,0.00,0.00,0,0,0,0,0,0,0,0,0,0,0,0,0
20200528,053680,臺股指富邦96購01,,,,,0.00,0.00,0,0,0,0,0,0,0,0,0,0,0,0,0
20200528,053681,臺股指富邦96購02,,,,,0.00,0.00,0,0,0,0,0,0,0,0,0,0,0,0,0
20200528,053682,臺股指富邦96購03,,,,,0.00,0.00,0,0,0,0,0,0,0,0,0,0,0,0,0
20200528,053683,上証2X元大96購03,,,,,0.00,0.00,0,0,0,0,0,0,0,0,0,0,0,0,0
20200528,053684,台積電元大96購17,,,,,0.00,0.00,0,0,0,0,0,0,0,0,0,0,0,0,0
20200528,053685,台積電元大96購18,,,,,0.00,0.00,0,0,0,0,0,0,0,0,0,0,0,0,0
20200528,053686,台積電元大97購08,,,,,0.00,0.00,0,0,0,0,0,0,0,0,0,0,0,0,0
20200528,053687,智邦元大96購02,,,,,0.00,0.00,0,0,0,0,0,0,0,0,0,0,0,0,0
20200528,053688,燿華元大96購05,,,,,0.00,0.00,0,0,0,0,0,0,0,0,0,0,0,0,0
20200528,053689,台光電元大96購01,,,,,0.00,0.00,0,0,0,0,0,0,0,0,0,0,0,0,0
20200528,053690,南亞科元大96購02,,,,,0.00,0.00,0,0,0,0,0,0,0,0,0,0,0,0,0
20200528,053691,聯發科元大96購16,,,,,0.00,0.00,0,0,0,0,0,0,0,0,0,0,0,0,0
20200528,053692,聯詠元大96購04,,,,,0.00,0.00,0,0,0,0,0,0,0,0,0,0,0,0,0
20200528,053693,欣興元大96購05,,,,,0.00,0.00,0,0,0,0,0,0,0,0,0,0,0,0,0
20200528,053694,創意元大96購03,0.63,0.68,0.59,0.59,-0.03,-4.84,303000,17,188900,0,0,0,0,0,0,50000,253000,-203000,-203000
20200528,053695,智易元大97購02,,,,,0.00,0.00,0,0,0,0,0,0,0,0,0,0,0,0,0
20200528,053696,日月光元大96購05,,,,,0.00,0.00,0,0,0,0,0,0,0,0,0,0,0,0,0
20200528,053697,臻鼎元大96購02,,,,,0.00,0.00,0,0,0,0,0,0,0,0,0,0,0,0,0
20200528,053698,中磊元大96購02,,,,,0.00,0.00,0,0,0,0,0,0,0,0,0,0,0,0,0
20200528,053699,臺股指元大96購22,0.01,0.01,0.01,0.01,0.00,0.00,10000,10,100,0,0,0,0,0,0,0,0,0,0
20200528,053700,臺股指元大96購23,,,,,0.00,0.00,0,0,0,0,0,0,0,0,0,0,0,0,0
20200528,053701,台積電兆豐96購05,,,,,0.00,0.00,0,0,0,0,0,0,0,0,0,0,0,0,0
20200528,053702,智易兆豐97購02,,,,,0.00,0.00,0,0,0,0,0,0,0,0,0,0,0,0,0
20200528,053703,緯穎兆豐96購01,,,,,0.00,0.00,0,0,0,0,0,0,0,0,0,0,0,0,0
20200528,053704,國巨群益96購06,0.08,0.08,0.08,0.08,0.00,0.00,2000,1,160,0,0,0,0,0,0,2000,0,2000,2000
20200528,053705,滬深2X凱基99購01,,,,,0.00,0.00,0,0,0,0,0,0,0,0,0,0,0,0,0
20200528,053706,S&P反1凱基99購01,,,,,0.00,0.00,0,0,0,0,0,0,0,0,0,0,0,0,0
20200528,053707,A50正2凱基99購02,,,,,0.00,0.00,0,0,0,0,0,0,0,0,0,0,0,0,0
20200528,053708,道瓊反凱基98購01,,,,,0.00,0.00,0,0,0,0,0,0,0,0,0,0,0,0,0
20200528,053709,台達電凱基96購04,,,,,0.00,0.00,0,0,0,0,0,0,0,0,0,0,0,0,0
20200528,053710,華通凱基96購05,,,,,0.00,0.00,0,0,0,0,0,0,0,0,0,0,0,0,0
20200528,053711,鴻海凱基96購14,,,,,0.00,0.00,0,0,0,0,0,0,0,0,0,0,0,0,0
20200528,053712,台光電凱基96購04,3.47,3.47,3.47,3.47,-0.40,-10.34,10000,1,34700,0,0,0,0,0,0,0,10000,-10000,-10000
20200528,053713,漢唐凱基96購04,1.69,1.69,1.69,1.69,-0.14,-7.65,20000,1,33800,0,0,0,0,0,0,20000,0,20000,20000
20200528,053714,南亞科凱基96購03,,,,,0.00,0.00,0,0,0,0,0,0,0,0,0,0,0,0,0
20200528,053715,美律凱基96購04,,,,,0.00,0.00,0,0,0,0,0,0,0,0,0,0,0,0,0
20200528,053716,京元電凱基97購01,,,,,0.00,0.00,0,0,0,0,0,0,0,0,0,0,0,0,0
20200528,053717,聯發科凱基96購17,,,,,0.00,0.00,0,0,0,0,0,0,0,0,0,0,0,0,0
20200528,053718,全新凱基97購02,,,,,0.00,0.00,0,0,0,0,0,0,0,0,0,0,0,0,0
20200528,053719,可成凱基96購08,,,,,0.00,0.00,0,0,0,0,0,0,0,0,0,0,0,0,0
20200528,053720,宏達電凱基97購01,,,,,0.00,0.00,0,0,0,0,0,0,0,0,0,0,0,0,0
20200528,053721,國泰金凱基97購01,,,,,0.00,0.00,0,0,0,0,0,0,0,0,0,0,0,0,0
20200528,053722,新光金凱基9C購01,,,,,0.00,0.00,0,0,0,0,0,0,0,0,0,0,0,0,0
20200528,053723,奇鋐凱基98購01,0.28,0.28,0.27,0.27,+0.04,17.39,70000,4,19500,0,0,0,0,0,0,0,70000,-70000,-70000
20200528,053724,聯詠凱基96購04,,,,,0.00,0.00,0,0,0,0,0,0,0,0,0,0,0,0,0
20200528,053725,晶相光凱基96購01,,,,,0.00,0.00,0,0,0,0,0,0,0,0,0,0,0,0,0
20200528,053726,TPK凱基96購02,,,,,0.00,0.00,0,0,0,0,0,0,0,0,0,0,0,0,0
20200528,053727,麗豐凱基97購01,,,,,0.00,0.00,0,0,0,0,0,0,0,0,0,0,0,0,0
20200528,053728,茂林凱基97購01,3.36,3.36,3.31,3.31,-0.80,-19.46,94000,24,313040,0,0,0,0,0,0,94000,0,94000,94000
20200528,053729,聯茂凱基96購05,0.57,0.61,0.57,0.61,+0.03,5.17,11000,2,6310,0,0,0,0,0,0,1000,10000,-9000,-9000
20200528,053730,樺漢凱基98購01,,,,,0.00,0.00,0,0,0,0,0,0,0,0,0,0,0,0,0
20200528,053731,矽創凱基96購03,,,,,0.00,0.00,0,0,0,0,0,0,0,0,0,0,0,0,0
20200528,053732,S&P反1中信9C購01,,,,,0.00,0.00,0,0,0,0,0,0,0,0,0,0,0,0,0
20200528,053733,華邦電中信98購01,,,,,0.00,0.00,0,0,0,0,0,0,0,0,0,0,0,0,0
20200528,053734,友達中信98購02,,,,,0.00,0.00,0,0,0,0,0,0,0,0,0,0,0,0,0
20200528,053735,矽力中信97購01,4.70,4.84,4.70,4.84,+0.30,6.61,34000,18,160950,0,0,0,0,0,0,30000,4000,26000,26000
20200528,053736,友達麥證96購01,,,,,0.00,0.00,0,0,0,0,0,0,0,0,0,0,0,0,0
20200528,053737,華新科麥證96購01,,,,,0.00,0.00,0,0,0,0,0,0,0,0,0,0,0,0,0
20200528,053738,群創麥證96購01,,,,,0.00,0.00,0,0,0,0,0,0,0,0,0,0,0,0,0
20200528,053739,A50正2國票9A購01,,,,,0.00,0.00,0,0,0,0,0,0,0,0,0,0,0,0,0
20200528,053740,元油反國票99購01,,,,,0.00,0.00,0,0,0,0,0,0,0,0,0,0,0,0,0
20200528,053741,漢唐國票97購03,,,,,0.00,0.00,0,0,0,0,0,0,0,0,0,0,0,0,0
20200528,053742,創意國票97購01,1.00,1.00,0.95,0.95,-0.01,-1.04,2000,2,1950,0,0,0,0,0,0,2000,0,2000,2000
20200528,053743,康控國票97購02,,,,,0.00,0.00,0,0,0,0,0,0,0,0,0,0,0,0,0
20200528,053744,台郡國票97購03,0.45,0.45,0.45,0.45,-0.03,-6.25,8000,2,3600,0,0,0,0,0,0,7000,1000,6000,6000
20200528,053745,康友國票97購01,,,,,0.00,0.00,0,0,0,0,0,0,0,0,0,0,0,0,0
20200528,053746,彰銀康和96購01,,,,,0.00,0.00,0,0,0,0,0,0,0,0,0,0,0,0,0
20200528,053747,滬深2X永豐96購05,,,,,0.00,0.00,0,0,0,0,0,0,0,0,0,0,0,0,0
20200528,053748,燿華永豐96購04,,,,,0.00,0.00,0,0,0,0,0,0,0,0,0,0,0,0,0
20200528,053749,揚明光永豐97購01,0.10,0.10,0.10,0.10,-0.02,-16.67,50000,5,5000,0,0,0,0,0,0,0,50000,-50000,-50000
20200528,05374P,台積電國票96售07,,,,,0.00,0.00,0,0,0,0,0,0,0,0,0,0,0,0,0
20200528,053750,致伸永豐96購02,,,,,0.00,0.00,0,0,0,0,0,0,0,0,0,0,0,0,0
20200528,053751,康控永豐96購02,,,,,0.00,0.00,0,0,0,0,0,0,0,0,0,0,0,0,0
20200528,053752,超眾永豐96購02,,,,,0.00,0.00,0,0,0,0,0,0,0,0,0,0,0,0,0
20200528,053753,啟碁永豐96購01,0.11,0.11,0.11,0.11,0.00,0.00,1000,1,110,0,0,0,0,0,0,1000,1000,0,0
20200528,053754,英業達元富96購02,0.34,0.34,0.33,0.33,+0.02,6.45,159000,4,53460,0,0,0,0,0,0,149000,10000,139000,139000
20200528,053755,亞光元富96購01,,,,,0.00,0.00,0,0,0,0,0,0,0,0,0,0,0,0,0
20200528,053756,亞光元富96購02,,,,,0.00,0.00,0,0,0,0,0,0,0,0,0,0,0,0,0
20200528,053757,聯發科國泰96購04,,,,,0.00,0.00,0,0,0,0,0,0,0,0,0,0,0,0,0
20200528,053758,華新科國泰97購02,1.88,1.90,1.84,1.87,-0.08,-4.1,30000,25,55850,0,0,0,0,0,0,30000,0,30000,30000
20200528,053759,晶相光國泰98購01,,,,,0.00,0.00,0,0,0,0,0,0,0,0,0,0,0,0,0
20200528,05375P,健策國票96售02,,,,,0.00,0.00,0,0,0,0,0,0,0,0,0,0,0,0,0
20200528,053760,牧德國泰98購01,1.09,1.56,1.09,1.56,-0.02,-1.27,21000,3,23460,0,0,0,0,0,0,0,20000,-20000,-20000
20200528,053761,健策國泰98購01,1.40,1.40,1.13,1.13,-0.26,-18.71,49000,9,66670,0,0,0,0,0,0,47000,7000,40000,40000
20200528,053762,T50反1富邦97購01,,,,,0.00,0.00,0,0,0,0,0,0,0,0,0,0,0,0,0
20200528,053763,T50反1富邦98購01,,,,,0.00,0.00,0,0,0,0,0,0,0,0,0,0,0,0,0
20200528,053764,A50正2富邦99購01,,,,,0.00,0.00,0,0,0,0,0,0,0,0,0,0,0,0,0
20200528,053765,智邦富邦96購01,,,,,0.00,0.00,0,0,0,0,0,0,0,0,0,0,0,0,0
20200528,053766,友達富邦97購01,0.03,0.03,0.03,0.03,0.00,0.00,100000,1,3000,0,0,0,0,0,0,0,0,0,0
20200528,053767,臻鼎富邦97購02,,,,,0.00,0.00,0,0,0,0,0,0,0,0,0,0,0,0,0
20200528,053768,S&P反1元大99購01,,,,,0.00,0.00,0,0,0,0,0,0,0,0,0,0,0,0,0
20200528,053769,香港反元大99購01,1.99,1.99,1.99,1.99,+0.59,42.14,10000,1,19900,0,0,0,0,0,0,0,0,0,0
20200528,053770,元金2X元大98購01,2.73,2.73,2.71,2.71,+0.30,12.45,171000,18,466020,0,0,0,0,0,0,0,161000,-161000,-161000
20200528,053771,華新元大97購01,0.45,0.45,0.45,0.45,-0.02,-4.26,2000,1,900,0,0,0,0,0,0,0,2000,-2000,-2000
20200528,053772,大成鋼元大96購02,,,,,0.00,0.00,0,0,0,0,0,0,0,0,0,0,0,0,0
20200528,053773,上銀元大96購04,,,,,0.00,0.00,0,0,0,0,0,0,0,0,0,0,0,0,0
20200528,053774,台達電元大96購04,0.08,0.08,0.08,0.08,0.00,0.00,6000,1,480,0,0,0,0,0,0,6000,6000,0,0
20200528,053775,鴻海元大96購21,,,,,0.00,0.00,0,0,0,0,0,0,0,0,0,0,0,0,0
20200528,053776,台積電元大96購19,,,,,0.00,0.00,0,0,0,0,0,0,0,0,0,0,0,0,0
20200528,053777,台積電元大96購20,,,,,0.00,0.00,0,0,0,0,0,0,0,0,0,0,0,0,0
20200528,053778,旺宏元大97購03,,,,,0.00,0.00,0,0,0,0,0,0,0,0,0,0,0,0,0
20200528,053779,台光電元大96購02,,,,,0.00,0.00,0,0,0,0,0,0,0,0,0,0,0,0,0
20200528,053780,南亞科元大96購03,0.18,0.18,0.18,0.18,0.00,0.00,30000,1,5400,0,0,0,0,0,0,0,30000,-30000,-30000
20200528,053781,友達元大9B購03,,,,,0.00,0.00,0,0,0,0,0,0,0,0,0,0,0,0,0
20200528,053782,京元電元大98購02,,,,,0.00,0.00,0,0,0,0,0,0,0,0,0,0,0,0,0
20200528,053783,聯發科元大96購17,2.64,2.67,2.64,2.67,-0.12,-4.3,21000,2,55770,0,0,0,0,0,0,0,21000,-21000,-21000
20200528,053784,奇力新元大97購02,1.09,1.09,0.94,0.94,-0.15,-13.76,62000,5,61950,0,0,0,0,0,0,61000,1000,60000,60000
20200528,053785,聯詠元大96購05,,,,,0.00,0.00,0,0,0,0,0,0,0,0,0,0,0,0,0
20200528,053786,新日興元大96購02,,,,,0.00,0.00,0,0,0,0,0,0,0,0,0,0,0,0,0
20200528,053787,健策元大97購02,,,,,0.00,0.00,0,0,0,0,0,0,0,0,0,0,0,0,0
20200528,053788,泰鼎元大97購01,,,,,0.00,0.00,0,0,0,0,0,0,0,0,0,0,0,0,0
20200528,053789,彩晶元大9C購02,,,,,0.00,0.00,0,0,0,0,0,0,0,0,0,0,0,0,0
20200528,05378P,台積電凱基96售02,,,,,0.00,0.00,0,0,0,0,0,0,0,0,0,0,0,0,0
20200528,053790,嘉聯益元大99購02,,,,,0.00,0.00,0,0,0,0,0,0,0,0,0,0,0,0,0
20200528,053791,同欣電元大96購05,,,,,0.00,0.00,0,0,0,0,0,0,0,0,0,0,0,0,0
20200528,053792,百和元大96購01,0.19,0.19,0.19,0.19,0.00,0.00,20000,1,3800,0,0,0,0,0,0,20000,20000,0,0
20200528,053793,致伸兆豐96購01,,,,,0.00,0.00,0,0,0,0,0,0,0,0,0,0,0,0,0
20200528,053794,燿華亞東96購01,,,,,0.00,0.00,0,0,0,0,0,0,0,0,0,0,0,0,0
20200528,053795,群創亞東96購01,,,,,0.00,0.00,0,0,0,0,0,0,0,0,0,0,0,0,0
20200528,053796,華通中信96購02,,,,,0.00,0.00,0,0,0,0,0,0,0,0,0,0,0,0,0
20200528,053797,台積電中信98購01,0.09,0.09,0.09,0.09,0.00,0.00,10000,1,900,0,0,0,0,0,0,0,10000,-10000,-10000
20200528,053798,台積電中信98購02,,,,,0.00,0.00,0,0,0,0,0,0,0,0,0,0,0,0,0
20200528,053799,矽創中信9A購01,0.22,0.25,0.20,0.20,+0.03,17.65,2341000,54,538890,0,0,0,0,0,0,445000,1838000,-1393000,-1393000
20200528,053800,華通凱基97購03,0.84,0.91,0.82,0.84,+0.15,21.74,64000,7,55440,0,0,0,0,0,0,0,64000,-64000,-64000
20200528,053801,台積電凱基96購18,,,,,0.00,0.00,0,0,0,0,0,0,0,0,0,0,0,0,0
20200528,053802,南亞科凱基96購04,,,,,0.00,0.00,0,0,0,0,0,0,0,0,0,0,0,0,0
20200528,053803,聯發科凱基96購18,,,,,0.00,0.00,0,0,0,0,0,0,0,0,0,0,0,0,0
20200528,053804,富邦金凱基96購01,0.52,0.52,0.46,0.46,0.00,0.00,20000,2,9800,0,0,0,0,0,0,0,20000,-20000,-20000
20200528,053805,奇鋐凱基98購02,0.22,0.24,0.22,0.23,+0.03,15.0,127000,7,29080,0,0,0,0,0,0,0,127000,-127000,-127000
20200528,053806,鎧勝凱基96購02,0.12,0.12,0.12,0.12,0.00,0.00,10000,1,1200,0,0,0,0,0,0,10000,0,10000,10000
20200528,053807,T50反1群益96購02,,,,,0.00,0.00,0,0,0,0,0,0,0,0,0,0,0,0,0
20200528,053808,大成鋼群益97購01,,,,,0.00,0.00,0,0,0,0,0,0,0,0,0,0,0,0,0
20200528,053809,上銀群益96購02,2.74,2.95,2.74,2.76,+0.07,2.6,16000,6,44250,0,0,0,0,0,0,16000,0,16000,16000
20200528,053810,台達電群益96購01,,,,,0.00,0.00,0,0,0,0,0,0,0,0,0,0,0,0,0
20200528,053811,國巨群益98購02,2.09,2.09,2.03,2.03,+0.17,9.14,20000,2,41200,0,0,0,0,0,0,10000,20000,-10000,-10000
20200528,053812,台積電群益96購09,,,,,0.00,0.00,0,0,0,0,0,0,0,0,0,0,0,0,0
20200528,053813,友達群益9A購03,,,,,0.00,0.00,0,0,0,0,0,0,0,0,0,0,0,0,0
20200528,053814,美律群益97購02,0.10,0.10,0.10,0.10,0.00,0.00,110000,1,11000,0,0,0,0,0,0,110000,0,110000,110000
20200528,053815,聯發科群益96購01,,,,,0.00,0.00,0,0,0,0,0,0,0,0,0,0,0,0,0
20200528,053816,聯發科群益96購02,,,,,0.00,0.00,0,0,0,0,0,0,0,0,0,0,0,0,0
20200528,053817,華新科群益97購02,1.87,1.94,1.87,1.94,-0.08,-3.96,20000,5,37960,0,0,0,0,0,0,20000,0,20000,20000
20200528,053818,富邦金群益98購01,,,,,0.00,0.00,0,0,0,0,0,0,0,0,0,0,0,0,0
20200528,053819,大立光群益96購04,,,,,0.00,0.00,0,0,0,0,0,0,0,0,0,0,0,0,0
20200528,053820,大立光群益96購05,,,,,0.00,0.00,0,0,0,0,0,0,0,0,0,0,0,0,0
20200528,053821,群創群益98購08,,,,,0.00,0.00,0,0,0,0,0,0,0,0,0,0,0,0,0
20200528,053822,正文群益97購01,,,,,0.00,0.00,0,0,0,0,0,0,0,0,0,0,0,0,0
20200528,053823,茂林群益96購06,,,,,0.00,0.00,0,0,0,0,0,0,0,0,0,0,0,0,0
20200528,053824,樺漢群益96購02,,,,,0.00,0.00,0,0,0,0,0,0,0,0,0,0,0,0,0
20200528,053825,南電群益96購02,,,,,0.00,0.00,0,0,0,0,0,0,0,0,0,0,0,0,0
20200528,053826,光磊麥證97購01,,,,,0.00,0.00,0,0,0,0,0,0,0,0,0,0,0,0,0
20200528,053827,漢唐麥證9A購01,1.11,1.11,1.04,1.06,-0.09,-7.83,235000,5,246200,25000,210000,-185000,0,0,0,25000,210000,-185000,-185000
20200528,053828,貿聯麥證96購01,,,,,0.00,0.00,0,0,0,0,0,0,0,0,0,0,0,0,0
20200528,053829,力成麥證96購01,,,,,0.00,0.00,0,0,0,0,0,0,0,0,0,0,0,0,0
20200528,053830,台積電台新96購02,,,,,0.00,0.00,0,0,0,0,0,0,0,0,0,0,0,0,0
20200528,053831,台積電台新97購02,,,,,0.00,0.00,0,0,0,0,0,0,0,0,0,0,0,0,0
20200528,053832,聯發科台新96購01,,,,,0.00,0.00,0,0,0,0,0,0,0,0,0,0,0,0,0
20200528,053833,彩晶台新97購02,,,,,0.00,0.00,0,0,0,0,0,0,0,0,0,0,0,0,0
20200528,053834,卜蜂永豐96購01,0.73,0.80,0.73,0.76,+0.03,4.11,50000,5,37900,0,0,0,0,0,0,10000,40000,-30000,-30000
20200528,053835,南亞科永豐96購02,,,,,0.00,0.00,0,0,0,0,0,0,0,0,0,0,0,0,0
20200528,053836,亞光永豐96購02,,,,,0.00,0.00,0,0,0,0,0,0,0,0,0,0,0,0,0
20200528,053837,貿聯永豐96購02,,,,,0.00,0.00,0,0,0,0,0,0,0,0,0,0,0,0,0
20200528,053838,正文永豐96購02,,,,,0.00,0.00,0,0,0,0,0,0,0,0,0,0,0,0,0
20200528,053839,華通統一96購01,,,,,0.00,0.00,0,0,0,0,0,0,0,0,0,0,0,0,0
20200528,053840,燿華統一96購02,,,,,0.00,0.00,0,0,0,0,0,0,0,0,0,0,0,0,0
20200528,053841,美律統一96購01,,,,,0.00,0.00,0,0,0,0,0,0,0,0,0,0,0,0,0
20200528,053842,聯發科統一96購08,0.10,0.10,0.08,0.09,-0.11,-55.0,1600000,8,150000,0,0,0,0,0,0,1600000,1600000,0,0
20200528,053843,訊芯統一96購01,,,,,0.00,0.00,0,0,0,0,0,0,0,0,0,0,0,0,0
20200528,053844,GIS統一96購01,0.75,0.75,0.53,0.53,-0.21,-28.38,233000,8,158290,0,0,0,0,0,0,233000,0,233000,233000
20200528,053845,和大元富96購01,,,,,0.00,0.00,0,0,0,0,0,0,0,0,0,0,0,0,0
20200528,053846,友達元富99購02,,,,,0.00,0.00,0,0,0,0,0,0,0,0,0,0,0,0,0
20200528,053847,美律元富96購02,0.04,0.04,0.04,0.04,0.00,0.00,250000,1,10000,0,0,0,0,0,0,250000,0,250000,250000
20200528,053848,聯發科元富96購03,,,,,0.00,0.00,0,0,0,0,0,0,0,0,0,0,0,0,0
20200528,053849,聯發科元富96購04,0.99,0.99,0.80,0.80,-0.18,-18.37,399000,12,361300,0,0,0,0,0,0,196000,203000,-7000,-7000
20200528,053850,嘉澤元富96購03,3.48,3.48,3.48,3.48,-0.76,-17.92,5000,1,17400,0,0,0,0,0,0,5000,0,5000,5000
20200528,053851,鴻海國泰98購03,,,,,0.00,0.00,0,0,0,0,0,0,0,0,0,0,0,0,0
20200528,053852,南亞科國泰98購01,0.03,0.11,0.03,0.11,+0.08,266.67,13000,2,630,0,0,0,0,0,0,0,3000,-3000,-3000
20200528,053853,康控國泰97購02,,,,,0.00,0.00,0,0,0,0,0,0,0,0,0,0,0,0,0
20200528,053854,聯茂國泰97購02,,,,,0.00,0.00,0,0,0,0,0,0,0,0,0,0,0,0,0
20200528,053855,康友國泰98購01,0.12,0.12,0.12,0.12,0.00,0.00,20000,1,2400,0,0,0,0,0,0,20000,0,20000,20000
20200528,053856,台積電富邦98購01,0.02,0.02,0.02,0.02,+0.01,100.0,2169000,45,43380,0,0,0,0,0,0,0,0,0,0
20200528,053857,宏達電富邦97購02,0.03,0.03,0.03,0.03,0.00,0.00,30000,2,900,0,0,0,0,0,0,0,0,0,0
20200528,053858,台達電元大96購05,0.11,0.11,0.11,0.11,0.00,0.00,10000,1,1100,0,0,0,0,0,0,10000,10000,0,0
20200528,053859,台積電元大97購09,,,,,0.00,0.00,0,0,0,0,0,0,0,0,0,0,0,0,0
20200528,053860,台積電元大98購03,0.31,0.31,0.30,0.30,0.00,0.00,2000,2,610,0,0,0,0,0,0,0,0,0,0
20200528,053861,台光電元大98購01,2.03,2.03,2.03,2.03,0.00,0.00,10000,1,20300,0,0,0,0,0,0,10000,0,10000,10000
20200528,053862,南亞科元大97購02,,,,,0.00,0.00,0,0,0,0,0,0,0,0,0,0,0,0,0
20200528,053863,聯發科元大96購18,,,,,0.00,0.00,0,0,0,0,0,0,0,0,0,0,0,0,0
20200528,053864,義隆元大96購01,1.20,1.23,1.11,1.13,+0.08,7.62,177000,20,206490,0,0,0,0,0,0,129000,48000,81000,81000
20200528,053865,欣興元大97購02,1.18,1.38,1.18,1.23,+0.04,3.36,460000,17,594270,0,0,0,0,0,0,11000,460000,-449000,-449000
20200528,053866,景碩元大97購02,,,,,0.00,0.00,0,0,0,0,0,0,0,0,0,0,0,0,0
20200528,053867,創意元大96購04,0.95,0.95,0.86,0.87,-0.06,-6.45,123000,27,109700,0,0,0,0,0,0,0,123000,-123000,-123000
20200528,053868,群創元大99購02,,,,,0.00,0.00,0,0,0,0,0,0,0,0,0,0,0,0,0
20200528,053869,嘉澤元大96購02,,,,,0.00,0.00,0,0,0,0,0,0,0,0,0,0,0,0,0
20200528,053870,正文元大96購01,,,,,0.00,0.00,0,0,0,0,0,0,0,0,0,0,0,0,0
20200528,053871,臻鼎元大96購03,0.47,0.47,0.47,0.47,-0.03,-6.0,100000,2,47000,0,0,0,0,0,0,1000,99000,-98000,-98000
20200528,053872,臻鼎元大96購04,,,,,0.00,0.00,0,0,0,0,0,0,0,0,0,0,0,0,0
20200528,053873,力成元大96購03,,,,,0.00,0.00,0,0,0,0,0,0,0,0,0,0,0,0,0
20200528,053874,台表科元大96購05,,,,,0.00,0.00,0,0,0,0,0,0,0,0,0,0,0,0,0
20200528,053875,GIS元大97購01,2.46,2.46,2.28,2.28,0.00,0.00,48000,3,115980,0,0,0,0,0,0,0,48000,-48000,-48000
20200528,053876,可成永昌98購01,,,,,0.00,0.00,0,0,0,0,0,0,0,0,0,0,0,0,0
20200528,053877,奇力新亞東96購01,,,,,0.00,0.00,0,0,0,0,0,0,0,0,0,0,0,0,0
20200528,053878,台表科亞東96購01,,,,,0.00,0.00,0,0,0,0,0,0,0,0,0,0,0,0,0
20200528,053879,元油反中信98購02,,,,,0.00,0.00,0,0,0,0,0,0,0,0,0,0,0,0,0
20200528,053880,智邦中信96購01,,,,,0.00,0.00,0,0,0,0,0,0,0,0,0,0,0,0,0
20200528,053881,南亞科中信97購01,0.01,0.01,0.01,0.01,0.00,0.00,13000,1,130,0,0,0,0,0,0,13000,0,13000,13000
20200528,053882,聯發科中信98購02,,,,,0.00,0.00,0,0,0,0,0,0,0,0,0,0,0,0,0
20200528,053883,大立光中信98購02,0.05,0.05,0.05,0.05,0.00,0.00,20000,1,1000,0,0,0,0,0,0,0,0,0,0
20200528,053884,緯穎第一96購01,,,,,0.00,0.00,0,0,0,0,0,0,0,0,0,0,0,0,0
20200528,053885,全新兆豐96購01,,,,,0.00,0.00,0,0,0,0,0,0,0,0,0,0,0,0,0
20200528,053886,亞光兆豐96購01,,,,,0.00,0.00,0,0,0,0,0,0,0,0,0,0,0,0,0
20200528,053887,聯茂兆豐97購02,0.82,0.91,0.81,0.83,0.00,0.00,128000,15,112060,0,0,0,0,0,0,48000,80000,-32000,-32000
20200528,053888,和大群益97購01,,,,,0.00,0.00,0,0,0,0,0,0,0,0,0,0,0,0,0
20200528,053889,致茂群益97購01,0.73,0.73,0.73,0.73,-0.08,-9.88,18000,1,13140,0,0,0,0,0,0,18000,0,18000,18000
20200528,053890,華新科群益98購01,,,,,0.00,0.00,0,0,0,0,0,0,0,0,0,0,0,0,0
20200528,053891,欣興群益98購01,,,,,0.00,0.00,0,0,0,0,0,0,0,0,0,0,0,0,0
20200528,053892,景碩群益96購02,,,,,0.00,0.00,0,0,0,0,0,0,0,0,0,0,0,0,0
20200528,053893,京鼎群益97購02,,,,,0.00,0.00,0,0,0,0,0,0,0,0,0,0,0,0,0
20200528,053894,創意群益96購01,1.31,1.38,1.31,1.38,-0.02,-1.43,37000,3,49660,0,0,0,0,0,0,20000,17000,3000,3000
20200528,053895,智易群益96購02,0.37,0.37,0.36,0.36,0.00,0.00,40000,2,14600,0,0,0,0,0,0,40000,0,40000,40000
20200528,053896,麗豐群益97購01,,,,,0.00,0.00,0,0,0,0,0,0,0,0,0,0,0,0,0
20200528,053897,台郡群益96購01,,,,,0.00,0.00,0,0,0,0,0,0,0,0,0,0,0,0,0
20200528,053898,康友群益97購01,,,,,0.00,0.00,0,0,0,0,0,0,0,0,0,0,0,0,0
20200528,053899,矽創群益96購02,,,,,0.00,0.00,0,0,0,0,0,0,0,0,0,0,0,0,0
20200528,053900,T50反1日盛99購01,0.50,0.50,0.50,0.50,+0.01,2.04,75000,6,37500,0,0,0,0,0,0,0,65000,-65000,-65000
20200528,053901,T50反1凱基99購03,1.66,1.73,1.66,1.73,+0.02,1.17,54000,5,90820,0,0,0,0,0,0,34000,20000,14000,14000
20200528,053902,S&P反1凱基97購01,,,,,0.00,0.00,0,0,0,0,0,0,0,0,0,0,0,0,0
20200528,053903,燿華凱基97購01,,,,,0.00,0.00,0,0,0,0,0,0,0,0,0,0,0,0,0
20200528,053904,漢唐凱基97購01,0.97,0.97,0.97,0.97,-0.12,-11.01,306000,2,296820,0,0,0,0,0,0,306000,0,306000,306000
20200528,053905,華新科凱基96購10,,,,,0.00,0.00,0,0,0,0,0,0,0,0,0,0,0,0,0
20200528,053906,宏達電凱基96購02,,,,,0.00,0.00,0,0,0,0,0,0,0,0,0,0,0,0,0
20200528,053907,揚明光凱基96購01,,,,,0.00,0.00,0,0,0,0,0,0,0,0,0,0,0,0,0
20200528,053908,貿聯凱基98購01,,,,,0.00,0.00,0,0,0,0,0,0,0,0,0,0,0,0,0
20200528,053909,致伸凱基97購01,0.04,0.04,0.04,0.04,0.00,0.00,9000,1,360,0,0,0,0,0,0,0,0,0,0
20200528,053910,嘉聯益凱基98購01,,,,,0.00,0.00,0,0,0,0,0,0,0,0,0,0,0,0,0
20200528,053911,臺股指凱基96購31,,,,,0.00,0.00,0,0,0,0,0,0,0,0,0,0,0,0,0
20200528,053912,T50反1國票97購02,,,,,0.00,0.00,0,0,0,0,0,0,0,0,0,0,0,0,0
20200528,053913,華新國票97購01,1.15,1.17,0.86,0.88,+0.11,14.29,269000,13,268350,0,0,0,0,0,0,106000,163000,-57000,-57000
20200528,053914,國巨國票96購08,,,,,0.00,0.00,0,0,0,0,0,0,0,0,0,0,0,0,0
20200528,053915,光罩國票96購02,,,,,0.00,0.00,0,0,0,0,0,0,0,0,0,0,0,0,0
20200528,053916,漢唐國票97購04,,,,,0.00,0.00,0,0,0,0,0,0,0,0,0,0,0,0,0
20200528,053917,友達國票97購03,,,,,0.00,0.00,0,0,0,0,0,0,0,0,0,0,0,0,0
20200528,053918,美律國票97購01,,,,,0.00,0.00,0,0,0,0,0,0,0,0,0,0,0,0,0
20200528,053919,可成國票97購02,0.73,0.73,0.67,0.67,-0.04,-5.63,95000,3,69080,0,0,0,0,0,0,89000,6000,83000,83000
20200528,053920,新光金國票98購01,,,,,0.00,0.00,0,0,0,0,0,0,0,0,0,0,0,0,0
20200528,053921,嘉晶國票97購03,4.57,4.57,4.57,4.57,0.00,0.00,3000,1,13710,0,0,0,0,0,0,3000,0,3000,3000
20200528,053922,亞光國票96購01,,,,,0.00,0.00,0,0,0,0,0,0,0,0,0,0,0,0,0
20200528,053923,亞光國票97購01,,,,,0.00,0.00,0,0,0,0,0,0,0,0,0,0,0,0,0
20200528,053924,京鼎國票97購01,,,,,0.00,0.00,0,0,0,0,0,0,0,0,0,0,0,0,0
20200528,053925,群創國票98購01,0.02,0.02,0.02,0.02,0.00,0.00,58000,2,1160,0,0,0,0,0,0,0,0,0,0
20200528,053926,晶相光國票97購01,,,,,0.00,0.00,0,0,0,0,0,0,0,0,0,0,0,0,0
20200528,053927,牧德國票97購01,,,,,0.00,0.00,0,0,0,0,0,0,0,0,0,0,0,0,0
20200528,053928,智易國票97購03,1.68,1.81,1.68,1.76,0.00,0.00,95000,3,168760,0,0,0,0,0,0,0,95000,-95000,-95000
20200528,053929,正文國票97購01,0.31,0.31,0.31,0.31,-0.02,-6.06,144000,1,44640,0,0,0,0,0,0,144000,0,144000,144000
20200528,053930,S&P反1統一98購01,,,,,0.00,0.00,0,0,0,0,0,0,0,0,0,0,0,0,0
20200528,053931,楠梓電統一96購01,,,,,0.00,0.00,0,0,0,0,0,0,0,0,0,0,0,0,0
20200528,053932,華新科統一96購03,2.00,2.03,1.94,1.94,-0.14,-6.73,216000,16,435120,0,0,0,0,0,0,216000,0,216000,216000
20200528,053933,大立光統一96購06,,,,,0.00,0.00,0,0,0,0,0,0,0,0,0,0,0,0,0
20200528,053934,A50正2元富96購02,,,,,0.00,0.00,0,0,0,0,0,0,0,0,0,0,0,0,0
20200528,053935,華通元富96購02,0.32,0.32,0.32,0.32,0.00,0.00,10000,1,3200,0,0,0,0,0,0,0,10000,-10000,-10000
20200528,053936,旺宏元富96購04,,,,,0.00,0.00,0,0,0,0,0,0,0,0,0,0,0,0,0
20200528,053937,光磊元富96購01,,,,,0.00,0.00,0,0,0,0,0,0,0,0,0,0,0,0,0
20200528,053938,彩晶元富96購01,,,,,0.00,0.00,0,0,0,0,0,0,0,0,0,0,0,0,0
20200528,053939,台表科元富96購03,0.35,0.35,0.35,0.35,-0.12,-25.53,50000,1,17500,0,0,0,0,0,0,50000,0,50000,50000
20200528,053940,康友元富96購01,,,,,0.00,0.00,0,0,0,0,0,0,0,0,0,0,0,0,0
20200528,053941,國巨國泰96購05,0.46,0.46,0.46,0.46,+0.12,35.29,15000,1,6900,0,0,0,0,0,0,15000,15000,0,0
20200528,053942,超眾國泰96購02,0.37,0.37,0.32,0.36,-0.10,-21.74,18000,3,6590,0,0,0,0,0,0,15000,3000,12000,12000
20200528,053943,元油反富邦97購03,,,,,0.00,0.00,0,0,0,0,0,0,0,0,0,0,0,0,0
20200528,053944,亞泥富邦97購01,,,,,0.00,0.00,0,0,0,0,0,0,0,0,0,0,0,0,0
20200528,053945,國巨富邦98購02,0.55,0.55,0.24,0.24,-0.35,-59.32,28000,5,7230,0,0,0,0,0,0,0,27000,-27000,-27000
20200528,053946,全新富邦97購02,0.02,0.02,0.02,0.02,0.00,0.00,1000,1,20,0,0,0,0,0,0,1000,0,1000,1000
20200528,053947,義隆富邦97購01,1.06,1.10,1.00,1.02,+0.06,6.25,884000,77,914940,0,0,0,0,0,0,618000,268000,350000,350000
20200528,053948,大立光富邦99購04,0.06,0.06,0.06,0.06,-0.04,-40.0,10000,1,600,0,0,0,0,0,0,0,0,0,0
20200528,053949,康控富邦9A購01,,,,,0.00,0.00,0,0,0,0,0,0,0,0,0,0,0,0,0
20200528,053950,緯穎富邦97購02,3.02,3.02,3.02,3.02,-0.21,-6.5,3000,1,9060,0,0,0,0,0,0,3000,0,3000,3000
20200528,053951,T50反1台新06購02,0.80,0.80,0.80,0.80,-0.13,-13.98,17000,1,13600,0,0,0,0,0,0,0,0,0,0
20200528,053952,南亞科台新96購01,,,,,0.00,0.00,0,0,0,0,0,0,0,0,0,0,0,0,0
20200528,053953,群創台新97購01,,,,,0.00,0.00,0,0,0,0,0,0,0,0,0,0,0,0,0
20200528,053954,貿聯康和96購01,,,,,0.00,0.00,0,0,0,0,0,0,0,0,0,0,0,0,0
20200528,053955,華通永豐96購04,,,,,0.00,0.00,0,0,0,0,0,0,0,0,0,0,0,0,0
20200528,053956,旺宏永豐96購04,,,,,0.00,0.00,0,0,0,0,0,0,0,0,0,0,0,0,0
20200528,053957,瑞昱永豐96購01,,,,,0.00,0.00,0,0,0,0,0,0,0,0,0,0,0,0,0
20200528,053958,京元電永豐96購01,,,,,0.00,0.00,0,0,0,0,0,0,0,0,0,0,0,0,0
20200528,053959,晶豪科永豐96購02,0.09,0.09,0.07,0.07,-0.01,-12.5,100000,2,8000,0,0,0,0,0,0,0,100000,-100000,-100000
20200528,05395P,旺宏元大96售06,0.20,0.22,0.20,0.22,0.00,0.00,9000,3,1820,0,0,0,0,0,0,9000,0,9000,9000
20200528,053960,晶技永豐96購02,1.44,1.44,1.44,1.44,0.00,0.00,2000,1,2880,0,0,0,0,0,0,0,2000,-2000,-2000
20200528,053961,揚明光永豐96購04,,,,,0.00,0.00,0,0,0,0,0,0,0,0,0,0,0,0,0
20200528,053962,聯茂永豐96購01,,,,,0.00,0.00,0,0,0,0,0,0,0,0,0,0,0,0,0
20200528,053963,百和永豐96購01,,,,,0.00,0.00,0,0,0,0,0,0,0,0,0,0,0,0,0
20200528,053964,上銀元大96購05,,,,,0.00,0.00,0,0,0,0,0,0,0,0,0,0,0,0,0
20200528,053965,聯電元大98購04,0.12,0.12,0.12,0.12,0.00,0.00,354000,3,42480,0,0,0,0,0,0,354000,0,354000,354000
20200528,053966,旺宏元大96購08,,,,,0.00,0.00,0,0,0,0,0,0,0,0,0,0,0,0,0
20200528,053967,華邦電元大96購03,,,,,0.00,0.00,0,0,0,0,0,0,0,0,0,0,0,0,0
20200528,053968,華邦電元大97購01,,,,,0.00,0.00,0,0,0,0,0,0,0,0,0,0,0,0,0
20200528,053969,瑞昱元大97購01,,,,,0.00,0.00,0,0,0,0,0,0,0,0,0,0,0,0,0
20200528,053970,聯發科元大97購08,,,,,0.00,0.00,0,0,0,0,0,0,0,0,0,0,0,0,0
20200528,053971,聯發科元大97購09,,,,,0.00,0.00,0,0,0,0,0,0,0,0,0,0,0,0,0
20200528,053972,華新科元大96購06,,,,,0.00,0.00,0,0,0,0,0,0,0,0,0,0,0,0,0
20200528,053973,晶豪科元大96購01,1.52,1.55,1.38,1.38,0.00,0.00,230000,13,348400,0,0,0,0,0,0,0,230000,-230000,-230000
20200528,053974,大立光元大96購10,,,,,0.00,0.00,0,0,0,0,0,0,0,0,0,0,0,0,0
20200528,053975,大立光元大98購04,,,,,0.00,0.00,0,0,0,0,0,0,0,0,0,0,0,0,0
20200528,053976,亞光元大96購02,,,,,0.00,0.00,0,0,0,0,0,0,0,0,0,0,0,0,0
20200528,053977,新日興元大96購03,1.53,1.53,1.53,1.53,0.00,0.00,1000,1,1530,0,0,0,0,0,0,1000,0,1000,1000
20200528,053978,創意元大96購05,,,,,0.00,0.00,0,0,0,0,0,0,0,0,0,0,0,0,0
20200528,053979,健策元大98購01,3.98,3.98,3.50,3.50,-0.50,-12.5,30000,5,111020,0,0,0,0,0,0,10000,20000,-10000,-10000
20200528,05397P,大立光凱基96售08,,,,,0.00,0.00,0,0,0,0,0,0,0,0,0,0,0,0,0
20200528,053980,泰鼎元大97購02,,,,,0.00,0.00,0,0,0,0,0,0,0,0,0,0,0,0,0
20200528,053981,康控元大96購05,,,,,0.00,0.00,0,0,0,0,0,0,0,0,0,0,0,0,0
20200528,053982,臻鼎元大96購05,,,,,0.00,0.00,0,0,0,0,0,0,0,0,0,0,0,0,0
20200528,053983,樺漢元大97購02,,,,,0.00,0.00,0,0,0,0,0,0,0,0,0,0,0,0,0
20200528,053984,康友元大96購05,,,,,0.00,0.00,0,0,0,0,0,0,0,0,0,0,0,0,0
20200528,053985,矽創元大96購02,,,,,0.00,0.00,0,0,0,0,0,0,0,0,0,0,0,0,0
20200528,053986,矽創第一96購01,,,,,0.00,0.00,0,0,0,0,0,0,0,0,0,0,0,0,0
20200528,053987,宏碁亞東96購01,,,,,0.00,0.00,0,0,0,0,0,0,0,0,0,0,0,0,0
20200528,053988,友達亞東96購01,,,,,0.00,0.00,0,0,0,0,0,0,0,0,0,0,0,0,0
20200528,053989,奇力新兆豐97購01,,,,,0.00,0.00,0,0,0,0,0,0,0,0,0,0,0,0,0
20200528,05398P,康控國票96售03,,,,,0.00,0.00,0,0,0,0,0,0,0,0,0,0,0,0,0
20200528,053990,晶技兆豐96購01,,,,,0.00,0.00,0,0,0,0,0,0,0,0,0,0,0,0,0
20200528,053991,鴻海群益96購05,,,,,0.00,0.00,0,0,0,0,0,0,0,0,0,0,0,0,0
20200528,053992,中環群益96購01,,,,,0.00,0.00,0,0,0,0,0,0,0,0,0,0,0,0,0
20200528,053993,旺宏群益98購02,,,,,0.00,0.00,0,0,0,0,0,0,0,0,0,0,0,0,0
20200528,053994,微星群益96購01,0.87,0.87,0.87,0.87,0.00,0.00,6000,1,5220,0,0,0,0,0,0,0,6000,-6000,-6000
20200528,053995,奇力新群益97購02,,,,,0.00,0.00,0,0,0,0,0,0,0,0,0,0,0,0,0
20200528,053996,晶相光群益97購01,,,,,0.00,0.00,0,0,0,0,0,0,0,0,0,0,0,0,0
20200528,053997,健策群益97購02,2.42,2.42,1.99,1.99,-0.40,-16.74,170000,18,354000,0,0,0,0,0,0,104000,66000,38000,38000
20200528,053998,泰鼎群益98購01,7.30,7.30,7.20,7.20,0.00,0.00,66000,5,478100,0,0,0,0,0,0,2000,64000,-62000,-62000
20200528,053999,台表科群益96購06,,,,,0.00,0.00,0,0,0,0,0,0,0,0,0,0,0,0,0
20200528,054000,訊芯群益96購02,,,,,0.00,0.00,0,0,0,0,0,0,0,0,0,0,0,0,0
20200528,054001,康友群益96購02,,,,,0.00,0.00,0,0,0,0,0,0,0,0,0,0,0,0,0
20200528,054002,GIS群益96購03,0.83,0.83,0.83,0.83,+0.10,13.7,10000,1,8300,0,0,0,0,0,0,10000,0,10000,10000
20200528,054003,鴻海統一96購13,,,,,0.00,0.00,0,0,0,0,0,0,0,0,0,0,0,0,0
20200528,054004,鴻海統一96購14,,,,,0.00,0.00,0,0,0,0,0,0,0,0,0,0,0,0,0
20200528,054005,旺宏統一97購04,0.65,0.65,0.65,0.65,+0.01,1.56,60000,19,39000,0,0,0,0,0,0,60000,0,60000,60000
20200528,054006,智易統一97購01,,,,,0.00,0.00,0,0,0,0,0,0,0,0,0,0,0,0,0
20200528,054007,貿聯統一96購01,,,,,0.00,0.00,0,0,0,0,0,0,0,0,0,0,0,0,0
20200528,054008,大立光元富96購06,,,,,0.00,0.00,0,0,0,0,0,0,0,0,0,0,0,0,0
20200528,054009,欣興元富96購03,,,,,0.00,0.00,0,0,0,0,0,0,0,0,0,0,0,0,0
20200528,054010,致伸元富96購01,,,,,0.00,0.00,0,0,0,0,0,0,0,0,0,0,0,0,0
20200528,054011,旺宏永豐96購05,,,,,0.00,0.00,0,0,0,0,0,0,0,0,0,0,0,0,0
20200528,054012,廣達永豐96購01,,,,,0.00,0.00,0,0,0,0,0,0,0,0,0,0,0,0,0
20200528,054013,聯發科永豐96購02,,,,,0.00,0.00,0,0,0,0,0,0,0,0,0,0,0,0,0
20200528,054014,宏達電永豐96購04,,,,,0.00,0.00,0,0,0,0,0,0,0,0,0,0,0,0,0
20200528,054015,晶豪科永豐96購03,,,,,0.00,0.00,0,0,0,0,0,0,0,0,0,0,0,0,0
20200528,054016,嘉晶永豐96購04,1.11,1.11,1.11,1.11,-0.14,-11.2,12000,1,13320,0,0,0,0,0,0,12000,0,12000,12000
20200528,054017,茂林永豐96購02,0.45,0.45,0.43,0.44,-0.02,-4.35,313000,31,136310,0,0,0,0,0,0,311000,2000,309000,309000
20200528,054018,華新台新96購01,0.32,0.38,0.32,0.33,+0.11,50.0,76000,35,25510,0,0,0,0,0,0,56000,20000,36000,36000
20200528,054019,燿華台新96購01,,,,,0.00,0.00,0,0,0,0,0,0,0,0,0,0,0,0,0
20200528,054020,技嘉台新97購01,2.71,2.71,2.71,2.71,0.00,0.00,10000,2,27100,0,0,0,0,0,0,10000,0,10000,10000
20200528,054021,義隆台新96購01,0.80,0.84,0.80,0.84,+0.26,44.83,14000,3,11680,0,0,0,0,0,0,0,14000,-14000,-14000
20200528,054022,南亞康和96購01,,,,,0.00,0.00,0,0,0,0,0,0,0,0,0,0,0,0,0
20200528,054023,和大康和96購01,,,,,0.00,0.00,0,0,0,0,0,0,0,0,0,0,0,0,0
20200528,054024,中鋼康和96購01,,,,,0.00,0.00,0,0,0,0,0,0,0,0,0,0,0,0,0
20200528,054025,鴻海凱基96購17,,,,,0.00,0.00,0,0,0,0,0,0,0,0,0,0,0,0,0
20200528,054026,台積電凱基97購08,,,,,0.00,0.00,0,0,0,0,0,0,0,0,0,0,0,0,0
20200528,054027,欣興凱基96購04,,,,,0.00,0.00,0,0,0,0,0,0,0,0,0,0,0,0,0
20200528,054028,臻鼎凱基96購03,,,,,0.00,0.00,0,0,0,0,0,0,0,0,0,0,0,0,0
20200528,054029,瀚宇博凱基96購02,,,,,0.00,0.00,0,0,0,0,0,0,0,0,0,0,0,0,0
20200528,054030,台苯中信98購01,,,,,0.00,0.00,0,0,0,0,0,0,0,0,0,0,0,0,0
20200528,054031,中鋼中信98購01,,,,,0.00,0.00,0,0,0,0,0,0,0,0,0,0,0,0,0
20200528,054032,上銀中信96購01,0.12,0.12,0.12,0.12,-0.09,-42.86,40000,1,4800,0,0,0,0,0,0,40000,0,40000,40000
20200528,054033,欣興中信96購02,,,,,0.00,0.00,0,0,0,0,0,0,0,0,0,0,0,0,0
20200528,054034,景碩中信96購01,,,,,0.00,0.00,0,0,0,0,0,0,0,0,0,0,0,0,0
20200528,054035,聯詠麥證96購01,,,,,0.00,0.00,0,0,0,0,0,0,0,0,0,0,0,0,0
20200528,054036,T50反1元大96購08,1.01,1.01,1.01,1.01,0.00,0.00,10000,2,10100,0,0,0,0,0,0,0,10000,-10000,-10000
20200528,054037,T50反1元大96購09,,,,,0.00,0.00,0,0,0,0,0,0,0,0,0,0,0,0,0
20200528,054038,T50反1元大98購04,,,,,0.00,0.00,0,0,0,0,0,0,0,0,0,0,0,0,0
20200528,054039,元油反元大96購08,,,,,0.00,0.00,0,0,0,0,0,0,0,0,0,0,0,0,0
20200528,054040,中石化元大9C購01,,,,,0.00,0.00,0,0,0,0,0,0,0,0,0,0,0,0,0
20200528,054041,鴻海元大96購22,,,,,0.00,0.00,0,0,0,0,0,0,0,0,0,0,0,0,0
20200528,054042,華泰元大96購01,,,,,0.00,0.00,0,0,0,0,0,0,0,0,0,0,0,0,0
20200528,054043,漢唐元大97購01,2.68,2.68,2.39,2.39,-0.23,-8.78,58000,7,148660,0,0,0,0,0,0,0,58000,-58000,-58000
20200528,054044,京元電元大96購03,,,,,0.00,0.00,0,0,0,0,0,0,0,0,0,0,0,0,0
20200528,054045,奇力新元大97購03,,,,,0.00,0.00,0,0,0,0,0,0,0,0,0,0,0,0,0
20200528,054046,義隆元大96購02,,,,,0.00,0.00,0,0,0,0,0,0,0,0,0,0,0,0,0
20200528,054047,富邦金元大97購01,,,,,0.00,0.00,0,0,0,0,0,0,0,0,0,0,0,0,0
20200528,054048,國泰金元大96購04,,,,,0.00,0.00,0,0,0,0,0,0,0,0,0,0,0,0,0
20200528,054049,亞光元大96購03,,,,,0.00,0.00,0,0,0,0,0,0,0,0,0,0,0,0,0
20200528,054050,創意元大96購06,0.43,0.47,0.42,0.42,-0.05,-10.64,85000,5,35830,0,0,0,0,0,0,7000,78000,-71000,-71000
20200528,054051,貿聯元大97購03,,,,,0.00,0.00,0,0,0,0,0,0,0,0,0,0,0,0,0
20200528,054052,日月光元大96購06,,,,,0.00,0.00,0,0,0,0,0,0,0,0,0,0,0,0,0
20200528,054053,聯茂元大96購01,1.17,1.17,1.17,1.17,-0.03,-2.5,14000,2,16380,0,0,0,0,0,0,14000,0,14000,14000
20200528,054054,光磊國票97購02,,,,,0.00,0.00,0,0,0,0,0,0,0,0,0,0,0,0,0
20200528,054055,全新國票99購02,,,,,0.00,0.00,0,0,0,0,0,0,0,0,0,0,0,0,0
20200528,054056,華新科國票96購02,,,,,0.00,0.00,0,0,0,0,0,0,0,0,0,0,0,0,0
20200528,054057,晶豪科國票97購01,,,,,0.00,0.00,0,0,0,0,0,0,0,0,0,0,0,0,0
20200528,054058,晶豪科國票98購01,1.40,1.40,1.24,1.24,-0.09,-6.77,67000,2,87080,0,0,0,0,0,0,42000,25000,17000,17000
20200528,054059,欣興國票97購03,1.00,1.09,1.00,1.09,+0.11,11.22,247000,3,264340,0,0,0,0,0,0,0,247000,-247000,-247000
20200528,054060,晶技國票97購02,1.19,1.27,1.15,1.15,-0.18,-13.53,57000,7,67430,0,0,0,0,0,0,0,57000,-57000,-57000
20200528,054061,晶技國票97購03,5.60,5.60,5.40,5.45,-0.70,-11.38,114000,24,629750,0,0,0,0,0,0,81000,33000,48000,48000
20200528,054062,TPK國票96購02,0.14,0.14,0.11,0.11,0.00,0.00,60000,6,7900,0,0,0,0,0,0,0,60000,-60000,-60000
20200528,054063,聯茂國票97購02,2.44,2.52,2.44,2.52,+0.12,5.0,56000,4,139840,0,0,0,0,0,0,40000,16000,24000,24000
20200528,054064,台郡國票97購04,,,,,0.00,0.00,0,0,0,0,0,0,0,0,0,0,0,0,0
20200528,054065,樺漢國票97購01,0.57,0.62,0.57,0.59,-0.04,-6.35,132000,3,78800,0,0,0,0,0,0,38000,94000,-56000,-56000
20200528,054066,緯穎國票97購03,11.60,11.60,11.40,11.40,-1.30,-10.24,26000,4,299400,0,0,0,0,0,0,16000,10000,6000,6000
20200528,054067,百和國票97購03,0.09,0.09,0.09,0.09,0.00,0.00,25000,1,2250,0,0,0,0,0,0,25000,25000,0,0
20200528,054068,華通國泰96購02,,,,,0.00,0.00,0,0,0,0,0,0,0,0,0,0,0,0,0
20200528,054069,亞光國泰98購01,,,,,0.00,0.00,0,0,0,0,0,0,0,0,0,0,0,0,0
20200528,054070,創意國泰96購02,,,,,0.00,0.00,0,0,0,0,0,0,0,0,0,0,0,0,0
20200528,054071,泰鼎國泰97購02,,,,,0.00,0.00,0,0,0,0,0,0,0,0,0,0,0,0,0
20200528,054072,台積電富邦98購02,0.09,0.09,0.09,0.09,0.00,0.00,13000,1,1170,0,0,0,0,0,0,0,0,0,0
20200528,054073,群創富邦96購03,,,,,0.00,0.00,0,0,0,0,0,0,0,0,0,0,0,0,0
20200528,054074,健策富邦98購01,0.90,0.90,0.76,0.76,-0.13,-14.61,76000,19,67340,0,0,0,0,0,0,76000,0,76000,76000
20200528,054075,GIS富邦97購02,0.30,0.30,0.21,0.21,-0.05,-19.23,125000,7,32460,0,0,0,0,0,0,57000,68000,-11000,-11000
20200528,054076,義隆第一96購01,,,,,0.00,0.00,0,0,0,0,0,0,0,0,0,0,0,0,0
20200528,054077,中石化中信98購01,,,,,0.00,0.00,0,0,0,0,0,0,0,0,0,0,0,0,0
20200528,054078,鴻海中信98購01,0.10,0.10,0.10,0.10,0.00,0.00,10000,1,1000,0,0,0,0,0,0,10000,0,10000,10000
20200528,054079,鴻海中信98購02,0.12,0.16,0.11,0.16,0.00,0.00,149000,9,21280,0,0,0,0,0,0,93000,0,93000,93000
20200528,054080,微星中信98購01,1.19,1.30,1.19,1.30,-0.06,-4.41,78000,4,95400,0,0,0,0,0,0,20000,58000,-38000,-38000
20200528,054081,聯電元富96購01,,,,,0.00,0.00,0,0,0,0,0,0,0,0,0,0,0,0,0
20200528,054082,楠梓電元富96購01,,,,,0.00,0.00,0,0,0,0,0,0,0,0,0,0,0,0,0
20200528,054083,智伸科元富96購01,,,,,0.00,0.00,0,0,0,0,0,0,0,0,0,0,0,0,0
20200528,054084,旺宏統一97購05,,,,,0.00,0.00,0,0,0,0,0,0,0,0,0,0,0,0,0
20200528,054085,華新科統一96購04,,,,,0.00,0.00,0,0,0,0,0,0,0,0,0,0,0,0,0
20200528,054086,日月光亞東98購01,,,,,0.00,0.00,0,0,0,0,0,0,0,0,0,0,0,0,0
20200528,054087,矽創亞東96購01,,,,,0.00,0.00,0,0,0,0,0,0,0,0,0,0,0,0,0
20200528,054088,華新群益98購02,0.74,0.81,0.56,0.58,-0.04,-6.45,1258000,71,892710,0,0,0,0,0,0,539000,469000,70000,70000
20200528,054089,台積電群益96購11,,,,,0.00,0.00,0,0,0,0,0,0,0,0,0,0,0,0,0
20200528,054090,瑞昱群益97購01,2.39,2.39,2.39,2.39,+0.10,4.37,135000,3,322650,0,0,0,0,0,0,0,135000,-135000,-135000
20200528,054091,晶豪科群益96購01,,,,,0.00,0.00,0,0,0,0,0,0,0,0,0,0,0,0,0
20200528,054092,大立光群益97購01,,,,,0.00,0.00,0,0,0,0,0,0,0,0,0,0,0,0,0
20200528,054093,智原群益97購01,,,,,0.00,0.00,0,0,0,0,0,0,0,0,0,0,0,0,0
20200528,054094,創意群益96購02,,,,,0.00,0.00,0,0,0,0,0,0,0,0,0,0,0,0,0
20200528,054095,同欣電群益98購03,,,,,0.00,0.00,0,0,0,0,0,0,0,0,0,0,0,0,0
20200528,054096,佳世達國票97購01,,,,,0.00,0.00,0,0,0,0,0,0,0,0,0,0,0,0,0
20200528,054097,淘帝國票97購01,,,,,0.00,0.00,0,0,0,0,0,0,0,0,0,0,0,0,0
20200528,054098,嘉晶國票97購04,5.10,5.15,5.10,5.15,-0.70,-11.97,271000,3,1382300,0,0,0,0,0,0,267000,4000,263000,263000
20200528,054099,TPK國票98購01,,,,,0.00,0.00,0,0,0,0,0,0,0,0,0,0,0,0,0
20200528,054100,致伸國票97購03,,,,,0.00,0.00,0,0,0,0,0,0,0,0,0,0,0,0,0
20200528,054101,茂林國票97購04,0.91,0.93,0.89,0.89,-0.43,-32.58,70000,13,63080,0,0,0,0,0,0,60000,10000,50000,50000
20200528,054102,百和國票97購04,0.53,0.54,0.47,0.47,-0.05,-9.62,245000,6,125580,0,0,0,0,0,0,204000,41000,163000,163000
20200528,054103,T50反1凱基99購04,,,,,0.00,0.00,0,0,0,0,0,0,0,0,0,0,0,0,0
20200528,054104,T50反1凱基9A購02,,,,,0.00,0.00,0,0,0,0,0,0,0,0,0,0,0,0,0
20200528,054105,元油反凱基9A購01,,,,,0.00,0.00,0,0,0,0,0,0,0,0,0,0,0,0,0
20200528,054106,元油反凱基9C購01,,,,,0.00,0.00,0,0,0,0,0,0,0,0,0,0,0,0,0
20200528,054107,上銀凱基97購01,,,,,0.00,0.00,0,0,0,0,0,0,0,0,0,0,0,0,0
20200528,054108,台積電凱基96購22,,,,,0.00,0.00,0,0,0,0,0,0,0,0,0,0,0,0,0
20200528,054109,南亞科凱基96購05,,,,,0.00,0.00,0,0,0,0,0,0,0,0,0,0,0,0,0
20200528,054110,群創凱基98購09,,,,,0.00,0.00,0,0,0,0,0,0,0,0,0,0,0,0,0
20200528,054111,緯穎凱基97購01,4.47,4.47,4.47,4.47,-0.17,-3.66,10000,1,44700,0,0,0,0,0,0,10000,0,10000,10000
20200528,054112,台積電麥證96購02,,,,,0.00,0.00,0,0,0,0,0,0,0,0,0,0,0,0,0
20200528,054113,奇力新台新97購01,,,,,0.00,0.00,0,0,0,0,0,0,0,0,0,0,0,0,0
20200528,054114,新光金台新97購01,,,,,0.00,0.00,0,0,0,0,0,0,0,0,0,0,0,0,0
20200528,054115,台塑康和96購01,,,,,0.00,0.00,0,0,0,0,0,0,0,0,0,0,0,0,0
20200528,054116,順德康和96購01,,,,,0.00,0.00,0,0,0,0,0,0,0,0,0,0,0,0,0
20200528,054117,宏全康和96購01,,,,,0.00,0.00,0,0,0,0,0,0,0,0,0,0,0,0,0
20200528,054118,國巨永豐96購04,0.05,0.05,0.05,0.05,0.00,0.00,5000,1,250,0,0,0,0,0,0,5000,0,5000,5000
20200528,054119,燿華永豐96購05,,,,,0.00,0.00,0,0,0,0,0,0,0,0,0,0,0,0,0
20200528,05411P,台積電國票96售08,0.18,0.18,0.18,0.18,0.00,0.00,10000,2,1800,0,0,0,0,0,0,0,10000,-10000,-10000
20200528,054120,奇力新永豐96購01,,,,,0.00,0.00,0,0,0,0,0,0,0,0,0,0,0,0,0
20200528,054121,奇鋐永豐96購02,0.43,0.44,0.42,0.42,+0.11,35.48,81000,16,34970,0,0,0,0,0,0,0,81000,-81000,-81000
20200528,054122,康友永豐96購01,,,,,0.00,0.00,0,0,0,0,0,0,0,0,0,0,0,0,0
20200528,054123,易華電永豐96購03,,,,,0.00,0.00,0,0,0,0,0,0,0,0,0,0,0,0,0
20200528,054124,達方永豐96購02,,,,,0.00,0.00,0,0,0,0,0,0,0,0,0,0,0,0,0
20200528,054125,元油反元大96購09,,,,,0.00,0.00,0,0,0,0,0,0,0,0,0,0,0,0,0
20200528,054126,和大元大96購02,,,,,0.00,0.00,0,0,0,0,0,0,0,0,0,0,0,0,0
20200528,054127,台積電元大96購21,,,,,0.00,0.00,0,0,0,0,0,0,0,0,0,0,0,0,0
20200528,054128,台積電元大97購10,,,,,0.00,0.00,0,0,0,0,0,0,0,0,0,0,0,0,0
20200528,054129,技嘉元大96購02,,,,,0.00,0.00,0,0,0,0,0,0,0,0,0,0,0,0,0
20200528,054130,漢唐元大97購02,1.63,1.63,1.45,1.50,-0.12,-7.41,865000,24,1314040,0,0,0,0,0,0,212000,653000,-441000,-441000
20200528,054131,南亞科元大96購04,,,,,0.00,0.00,0,0,0,0,0,0,0,0,0,0,0,0,0
20200528,054132,聯發科元大97購10,,,,,0.00,0.00,0,0,0,0,0,0,0,0,0,0,0,0,0
20200528,054133,奇力新元大97購04,,,,,0.00,0.00,0,0,0,0,0,0,0,0,0,0,0,0,0
20200528,054134,強茂元大96購01,0.53,0.53,0.50,0.50,+0.02,4.17,284000,5,146170,0,0,0,0,0,0,139000,145000,-6000,-6000
20200528,054135,大立光元大97購04,0.63,0.63,0.63,0.63,-0.11,-14.86,68000,1,42840,0,0,0,0,0,0,0,68000,-68000,-68000
20200528,054136,亞光元大96購04,0.03,0.03,0.03,0.03,0.00,0.00,1000,1,30,0,0,0,0,0,0,1000,0,1000,1000
20200528,054137,聯詠元大97購02,0.79,0.79,0.75,0.75,-0.03,-3.85,25000,3,18950,0,0,0,0,0,0,0,25000,-25000,-25000
20200528,054138,晶技元大98購02,,,,,0.00,0.00,0,0,0,0,0,0,0,0,0,0,0,0,0
20200528,054139,揚明光元大96購01,,,,,0.00,0.00,0,0,0,0,0,0,0,0,0,0,0,0,0
20200528,05413P,台郡國票96售02,,,,,0.00,0.00,0,0,0,0,0,0,0,0,0,0,0,0,0
20200528,054140,智易元大97購03,0.52,0.60,0.52,0.60,0.00,0.00,68000,4,38040,0,0,0,0,0,0,68000,0,68000,68000
20200528,054141,TPK元大96購02,,,,,0.00,0.00,0,0,0,0,0,0,0,0,0,0,0,0,0
20200528,054142,致伸元大97購01,,,,,0.00,0.00,0,0,0,0,0,0,0,0,0,0,0,0,0
20200528,054143,茂林元大96購04,2.44,2.44,2.44,2.44,-0.10,-3.94,36000,1,87840,0,0,0,0,0,0,36000,0,36000,36000
20200528,054144,康控元大97購02,,,,,0.00,0.00,0,0,0,0,0,0,0,0,0,0,0,0,0
20200528,054145,嘉聯益元大98購01,,,,,0.00,0.00,0,0,0,0,0,0,0,0,0,0,0,0,0
20200528,054146,康友元大96購06,,,,,0.00,0.00,0,0,0,0,0,0,0,0,0,0,0,0,0
20200528,054147,GIS元大96購02,1.69,1.69,1.52,1.52,-0.13,-7.88,50000,4,79700,0,0,0,0,0,0,50000,0,50000,50000
20200528,054148,矽創元大96購03,0.57,0.73,0.56,0.60,+0.06,11.11,330000,12,230790,0,0,0,0,0,0,135000,189000,-54000,-54000
20200528,054149,達方元大96購01,,,,,0.00,0.00,0,0,0,0,0,0,0,0,0,0,0,0,0
20200528,05414P,台表科國票96售02,,,,,0.00,0.00,0,0,0,0,0,0,0,0,0,0,0,0,0
20200528,054150,國巨國泰97購05,,,,,0.00,0.00,0,0,0,0,0,0,0,0,0,0,0,0,0
20200528,054151,瑞昱國泰97購01,3.27,3.30,3.21,3.28,+0.22,7.19,59000,5,193040,0,0,0,0,0,0,18000,41000,-23000,-23000
20200528,054152,漢唐國泰98購02,1.37,1.37,1.29,1.29,-0.03,-2.27,4000,2,5320,0,0,0,0,0,0,0,4000,-4000,-4000
20200528,054153,宏達電國泰97購01,,,,,0.00,0.00,0,0,0,0,0,0,0,0,0,0,0,0,0
20200528,054154,智易國泰97購01,0.36,0.40,0.36,0.37,+0.07,23.33,222000,3,80750,0,0,0,0,0,0,199000,23000,176000,176000
20200528,054155,美律第一96購01,,,,,0.00,0.00,0,0,0,0,0,0,0,0,0,0,0,0,0
20200528,054156,聯電亞東98購01,,,,,0.00,0.00,0,0,0,0,0,0,0,0,0,0,0,0,0
20200528,054157,國巨亞東96購01,0.30,0.30,0.30,0.30,-0.01,-3.23,80000,1,24000,0,0,0,0,0,0,80000,80000,0,0
20200528,054158,國巨日盛99購01,0.42,0.42,0.39,0.39,-0.05,-11.36,63000,8,24650,0,0,0,0,0,0,1000,63000,-62000,-62000
20200528,054159,T50正2凱基99購01,0.39,0.39,0.39,0.39,0.00,0.00,20000,1,7800,0,0,0,0,0,0,0,0,0,0
20200528,054160,華泰凱基98購01,0.59,0.63,0.59,0.63,+0.07,12.5,50000,3,30200,0,0,0,0,0,0,0,50000,-50000,-50000
20200528,054161,友訊凱基98購01,1.33,1.33,1.33,1.33,0.00,0.00,40000,4,53200,0,0,0,0,0,0,0,40000,-40000,-40000
20200528,054162,光罩凱基98購01,,,,,0.00,0.00,0,0,0,0,0,0,0,0,0,0,0,0,0
20200528,054163,燿華凱基97購02,0.24,0.24,0.24,0.24,0.00,0.00,5000,1,1200,0,0,0,0,0,0,0,5000,-5000,-5000
20200528,054164,強茂凱基98購01,0.85,0.85,0.81,0.81,-0.06,-6.9,188000,6,156700,0,0,0,0,0,0,188000,0,188000,188000
20200528,054165,亞光凱基96購02,,,,,0.00,0.00,0,0,0,0,0,0,0,0,0,0,0,0,0
20200528,054166,日電貿凱基98購01,0.61,0.63,0.59,0.59,-0.04,-6.35,231000,12,142010,0,0,0,0,0,0,23000,208000,-185000,-185000
20200528,054167,揚明光凱基98購01,0.18,0.18,0.16,0.17,-0.06,-26.09,70000,5,11900,0,0,0,0,0,0,0,70000,-70000,-70000
20200528,054168,貿聯凱基97購02,,,,,0.00,0.00,0,0,0,0,0,0,0,0,0,0,0,0,0
20200528,054169,上緯控凱基98購01,0.94,0.95,0.80,0.80,-0.05,-5.88,191000,16,171310,0,0,0,0,0,0,95000,91000,4000,4000
20200528,054170,泰鼎凱基98購01,,,,,0.00,0.00,0,0,0,0,0,0,0,0,0,0,0,0,0
20200528,054171,台郡凱基97購01,,,,,0.00,0.00,0,0,0,0,0,0,0,0,0,0,0,0,0
20200528,054172,易華電凱基98購01,,,,,0.00,0.00,0,0,0,0,0,0,0,0,0,0,0,0,0
20200528,054173,奇力新台新97購02,,,,,0.00,0.00,0,0,0,0,0,0,0,0,0,0,0,0,0
20200528,054174,宏達電台新97購01,,,,,0.00,0.00,0,0,0,0,0,0,0,0,0,0,0,0,0
20200528,054175,高鐵台新97購01,,,,,0.00,0.00,0,0,0,0,0,0,0,0,0,0,0,0,0
20200528,054176,亞光台新96購01,,,,,0.00,0.00,0,0,0,0,0,0,0,0,0,0,0,0,0
20200528,054177,牧德台新97購01,,,,,0.00,0.00,0,0,0,0,0,0,0,0,0,0,0,0,0
20200528,054178,中磊台新97購01,0.49,0.49,0.42,0.44,-0.05,-10.2,1108000,10,502240,0,0,0,0,0,0,558000,550000,8000,8000
20200528,054179,上海銀台新97購01,,,,,0.00,0.00,0,0,0,0,0,0,0,0,0,0,0,0,0
20200528,054180,亞泥康和96購01,,,,,0.00,0.00,0,0,0,0,0,0,0,0,0,0,0,0,0
20200528,054181,華新康和96購01,,,,,0.00,0.00,0,0,0,0,0,0,0,0,0,0,0,0,0
20200528,054182,台積電康和96購01,,,,,0.00,0.00,0,0,0,0,0,0,0,0,0,0,0,0,0
20200528,054183,亞光康和96購01,,,,,0.00,0.00,0,0,0,0,0,0,0,0,0,0,0,0,0
20200528,054184,A50正2永豐96購01,,,,,0.00,0.00,0,0,0,0,0,0,0,0,0,0,0,0,0
20200528,054185,喬山永豐96購02,0.23,0.24,0.17,0.17,-0.08,-32.0,180000,11,36000,0,0,0,0,0,0,30000,150000,-120000,-120000
20200528,054186,高鐵永豐96購01,,,,,0.00,0.00,0,0,0,0,0,0,0,0,0,0,0,0,0
20200528,054187,亞光永豐96購03,,,,,0.00,0.00,0,0,0,0,0,0,0,0,0,0,0,0,0
20200528,054188,欣興永豐96購03,0.42,0.58,0.42,0.44,+0.02,4.76,171000,28,87630,0,0,0,0,0,0,7000,159000,-152000,-152000
20200528,054189,貿聯永豐96購03,,,,,0.00,0.00,0,0,0,0,0,0,0,0,0,0,0,0,0
20200528,054190,矽創永豐96購01,,,,,0.00,0.00,0,0,0,0,0,0,0,0,0,0,0,0,0
20200528,054191,香港2X中信98購01,,,,,0.00,0.00,0,0,0,0,0,0,0,0,0,0,0,0,0
20200528,054192,國巨中信98購01,,,,,0.00,0.00,0,0,0,0,0,0,0,0,0,0,0,0,0
20200528,054193,鴻海麥證96購02,,,,,0.00,0.00,0,0,0,0,0,0,0,0,0,0,0,0,0
20200528,054194,國巨麥證96購02,,,,,0.00,0.00,0,0,0,0,0,0,0,0,0,0,0,0,0
20200528,054195,亞泥國泰98購01,,,,,0.00,0.00,0,0,0,0,0,0,0,0,0,0,0,0,0
20200528,054196,台光電國泰97購02,,,,,0.00,0.00,0,0,0,0,0,0,0,0,0,0,0,0,0
20200528,054197,台積電永昌96購07,,,,,0.00,0.00,0,0,0,0,0,0,0,0,0,0,0,0,0
20200528,054198,台積電永昌96購08,,,,,0.00,0.00,0,0,0,0,0,0,0,0,0,0,0,0,0
20200528,054199,大立光永昌96購07,,,,,0.00,0.00,0,0,0,0,0,0,0,0,0,0,0,0,0
20200528,054200,美律富邦97購02,,,,,0.00,0.00,0,0,0,0,0,0,0,0,0,0,0,0,0
20200528,054201,聯詠富邦97購02,0.41,0.43,0.37,0.43,+0.03,7.5,882000,15,349030,0,0,0,0,0,0,458000,352000,106000,106000
20200528,054202,樺漢富邦97購01,,,,,0.00,0.00,0,0,0,0,0,0,0,0,0,0,0,0,0
20200528,054203,滬深2X國票96購03,,,,,0.00,0.00,0,0,0,0,0,0,0,0,0,0,0,0,0
20200528,054204,元金2X國票9B購02,1.70,1.70,1.70,1.70,-0.08,-4.49,1000,1,1700,0,0,0,0,0,0,1000,0,1000,1000
20200528,054205,華新國票97購02,0.53,0.58,0.37,0.37,+0.01,2.78,176000,9,89440,0,0,0,0,0,0,78000,98000,-20000,-20000
20200528,054206,鴻海國票99購01,,,,,0.00,0.00,0,0,0,0,0,0,0,0,0,0,0,0,0
20200528,054207,國巨國票98購01,,,,,0.00,0.00,0,0,0,0,0,0,0,0,0,0,0,0,0
20200528,054208,台積電國票97購07,,,,,0.00,0.00,0,0,0,0,0,0,0,0,0,0,0,0,0
20200528,054209,台積電國票97購08,,,,,0.00,0.00,0,0,0,0,0,0,0,0,0,0,0,0,0
20200528,05420P,大立光國泰97售03,,,,,0.00,0.00,0,0,0,0,0,0,0,0,0,0,0,0,0
20200528,054210,台光電國票97購03,6.70,6.70,5.80,5.80,-1.00,-14.71,5000,2,30800,0,0,0,0,0,0,0,5000,-5000,-5000
20200528,054211,奇鋐國票97購03,0.69,0.69,0.64,0.64,+0.01,1.59,355000,2,229350,0,0,0,0,0,0,312000,355000,-43000,-43000
20200528,054212,聯詠國票97購03,0.80,0.80,0.80,0.80,-0.09,-10.11,12000,2,9600,0,0,0,0,0,0,12000,0,12000,12000
20200528,054213,欣興國票97購04,1.91,2.04,1.91,2.04,+0.19,10.27,48000,3,94230,0,0,0,0,0,0,0,48000,-48000,-48000
20200528,054214,京鼎國票97購02,0.19,0.19,0.16,0.16,-0.02,-11.11,156000,3,29460,0,0,0,0,0,0,0,156000,-156000,-156000
20200528,054215,創意國票97購02,1.72,1.72,1.71,1.71,+0.11,6.88,34000,2,58300,0,0,0,0,0,0,16000,18000,-2000,-2000
20200528,054216,聯茂國票97購03,,,,,0.00,0.00,0,0,0,0,0,0,0,0,0,0,0,0,0
20200528,054217,台表科國票97購05,1.70,1.74,1.62,1.74,-0.20,-10.31,45000,5,75460,0,0,0,0,0,0,22000,23000,-1000,-1000
20200528,054218,S&P反1統一98購02,,,,,0.00,0.00,0,0,0,0,0,0,0,0,0,0,0,0,0
20200528,054219,楠梓電統一97購01,,,,,0.00,0.00,0,0,0,0,0,0,0,0,0,0,0,0,0
20200528,05421P,鴻海元大96售12,,,,,0.00,0.00,0,0,0,0,0,0,0,0,0,0,0,0,0
20200528,054220,國巨統一97購02,0.30,0.30,0.26,0.28,-0.03,-9.68,65000,6,18100,0,0,0,0,0,0,50000,35000,15000,15000
20200528,054221,華新科統一96購05,1.02,1.02,0.99,0.99,-0.09,-8.33,114000,11,115980,0,0,0,0,0,0,56000,58000,-2000,-2000
20200528,054222,大立光統一98購03,,,,,0.00,0.00,0,0,0,0,0,0,0,0,0,0,0,0,0
20200528,054223,大立光統一98購04,,,,,0.00,0.00,0,0,0,0,0,0,0,0,0,0,0,0,0
20200528,054224,亞光統一98購01,,,,,0.00,0.00,0,0,0,0,0,0,0,0,0,0,0,0,0
20200528,054225,華新元富96購01,,,,,0.00,0.00,0,0,0,0,0,0,0,0,0,0,0,0,0
20200528,054226,燿華元富96購02,,,,,0.00,0.00,0,0,0,0,0,0,0,0,0,0,0,0,0
20200528,054227,宏達電元富96購02,,,,,0.00,0.00,0,0,0,0,0,0,0,0,0,0,0,0,0
20200528,054228,貿聯元富96購03,,,,,0.00,0.00,0,0,0,0,0,0,0,0,0,0,0,0,0
20200528,054229,超眾元富96購05,0.65,0.75,0.62,0.74,-0.03,-3.9,381000,7,257230,0,0,0,0,0,0,171000,210000,-39000,-39000
20200528,05422P,大立光中信97售02,,,,,0.00,0.00,0,0,0,0,0,0,0,0,0,0,0,0,0
20200528,054230,上銀群益96購03,,,,,0.00,0.00,0,0,0,0,0,0,0,0,0,0,0,0,0
20200528,054231,國巨群益98購03,5.95,5.95,5.45,5.50,-0.35,-5.98,32000,15,185450,0,0,0,0,0,0,32000,18000,14000,14000
20200528,054232,台積電群益96購12,,,,,0.00,0.00,0,0,0,0,0,0,0,0,0,0,0,0,0
20200528,054233,聯發科群益96購04,,,,,0.00,0.00,0,0,0,0,0,0,0,0,0,0,0,0,0
20200528,054234,可成群益96購05,,,,,0.00,0.00,0,0,0,0,0,0,0,0,0,0,0,0,0
20200528,054235,欣興群益96購06,1.11,1.39,1.11,1.39,+0.24,20.87,181000,9,227770,0,0,0,0,0,0,35000,146000,-111000,-111000
20200528,054236,貿聯群益96購01,,,,,0.00,0.00,0,0,0,0,0,0,0,0,0,0,0,0,0
20200528,054237,茂林群益97購01,0.99,0.99,0.92,0.92,-0.50,-35.21,117000,11,110780,0,0,0,0,0,0,17000,100000,-83000,-83000
20200528,054238,聯茂群益96購04,,,,,0.00,0.00,0,0,0,0,0,0,0,0,0,0,0,0,0
20200528,054239,台郡群益96購02,0.57,0.57,0.57,0.57,-0.02,-3.39,75000,3,42750,0,0,0,0,0,0,15000,50000,-35000,-35000
20200528,054240,訊芯群益96購03,,,,,0.00,0.00,0,0,0,0,0,0,0,0,0,0,0,0,0
20200528,054241,深中小元大98購01,0.77,0.78,0.77,0.78,-0.03,-3.7,40000,2,31000,0,0,0,0,0,0,20000,20000,0,0
20200528,054242,元油反元大98購02,,,,,0.00,0.00,0,0,0,0,0,0,0,0,0,0,0,0,0
20200528,054243,國喬元大96購01,,,,,0.00,0.00,0,0,0,0,0,0,0,0,0,0,0,0,0
20200528,054244,華新元大96購01,0.59,0.72,0.47,0.47,-0.04,-7.84,536000,19,334560,0,0,0,0,0,0,468000,68000,400000,400000
20200528,054245,鴻海元大96購23,0.07,0.07,0.07,0.07,0.00,0.00,20000,1,1400,0,0,0,0,0,0,20000,0,20000,20000
20200528,054246,國巨元大96購12,,,,,0.00,0.00,0,0,0,0,0,0,0,0,0,0,0,0,0
20200528,054247,華邦電元大96購04,,,,,0.00,0.00,0,0,0,0,0,0,0,0,0,0,0,0,0
20200528,054248,燿華元大97購02,,,,,0.00,0.00,0,0,0,0,0,0,0,0,0,0,0,0,0
20200528,054249,技嘉元大96購03,,,,,0.00,0.00,0,0,0,0,0,0,0,0,0,0,0,0,0
20200528,05424P,台達電亞東96售02,0.29,0.29,0.29,0.29,0.00,0.00,262000,3,75980,0,0,0,0,0,0,262000,0,262000,262000
20200528,054250,漢唐元大96購04,1.00,1.00,0.82,0.82,-0.17,-17.17,97000,5,91240,0,0,0,0,0,0,50000,47000,3000,3000
20200528,054251,聯發科元大96購21,,,,,0.00,0.00,0,0,0,0,0,0,0,0,0,0,0,0,0
20200528,054252,奇力新元大96購04,0.40,0.40,0.40,0.40,0.00,0.00,68000,1,27200,0,0,0,0,0,0,0,68000,-68000,-68000
20200528,054253,宏達電元大97購03,,,,,0.00,0.00,0,0,0,0,0,0,0,0,0,0,0,0,0
20200528,054254,晶豪科元大96購02,0.88,0.88,0.88,0.88,0.00,0.00,10000,1,8800,0,0,0,0,0,0,10000,0,10000,10000
20200528,054255,亞光元大96購05,,,,,0.00,0.00,0,0,0,0,0,0,0,0,0,0,0,0,0
20200528,054256,創意元大96購07,0.47,0.48,0.47,0.48,+0.05,11.63,100000,10,47900,0,0,0,0,0,0,0,100000,-100000,-100000
20200528,054257,揚明光元大96購02,,,,,0.00,0.00,0,0,0,0,0,0,0,0,0,0,0,0,0
20200528,054258,牧德元大97購01,2.27,2.27,2.27,2.27,-0.31,-12.02,15000,1,34050,0,0,0,0,0,0,0,15000,-15000,-15000
20200528,054259,健策元大97購03,2.24,2.24,2.24,2.24,+0.09,4.19,2000,1,4480,0,0,0,0,0,0,2000,0,2000,2000
20200528,05425P,華邦電亞東96售02,,,,,0.00,0.00,0,0,0,0,0,0,0,0,0,0,0,0,0
20200528,054260,貿聯元大96購03,0.56,0.60,0.54,0.54,-0.08,-12.9,218000,3,122720,0,0,0,0,0,0,68000,150000,-82000,-82000
20200528,054261,智伸科元大96購03,,,,,0.00,0.00,0,0,0,0,0,0,0,0,0,0,0,0,0
20200528,054262,瀚宇博元大96購03,,,,,0.00,0.00,0,0,0,0,0,0,0,0,0,0,0,0,0
20200528,054263,聯茂元大96購02,1.08,1.08,1.08,1.08,0.00,0.00,175000,2,189000,0,0,0,0,0,0,175000,0,175000,175000
20200528,054264,超眾元大97購02,,,,,0.00,0.00,0,0,0,0,0,0,0,0,0,0,0,0,0
20200528,054265,GIS元大96購03,1.57,1.61,1.19,1.19,-0.23,-16.2,129000,9,193830,0,0,0,0,0,0,109000,36000,73000,73000
20200528,054266,緯穎元大96購07,,,,,0.00,0.00,0,0,0,0,0,0,0,0,0,0,0,0,0
20200528,054267,上銀第一96購01,,,,,0.00,0.00,0,0,0,0,0,0,0,0,0,0,0,0,0
20200528,054268,健策第一96購01,0.36,0.36,0.36,0.36,-0.14,-28.0,45000,1,16200,0,0,0,0,0,0,45000,0,45000,45000
20200528,054269,台光電亞東98購01,,,,,0.00,0.00,0,0,0,0,0,0,0,0,0,0,0,0,0
20200528,054270,寶滬深中信98購01,,,,,0.00,0.00,0,0,0,0,0,0,0,0,0,0,0,0,0
20200528,054271,中石化中信99購01,,,,,0.00,0.00,0,0,0,0,0,0,0,0,0,0,0,0,0
20200528,054272,華通中信98購01,0.43,0.43,0.43,0.43,0.00,0.00,1000,1,430,0,0,0,0,0,0,1000,1000,0,0
20200528,054273,宏達電中信98購01,0.49,0.49,0.49,0.49,0.00,0.00,4000,1,1960,0,0,0,0,0,0,4000,0,4000,4000
20200528,054274,智易中信96購02,0.56,0.56,0.56,0.56,0.00,0.00,19000,1,10640,0,0,0,0,0,0,0,19000,-19000,-19000
20200528,054275,華通群益97購03,,,,,0.00,0.00,0,0,0,0,0,0,0,0,0,0,0,0,0
20200528,054276,國巨群益96購07,,,,,0.00,0.00,0,0,0,0,0,0,0,0,0,0,0,0,0
20200528,054277,亞光群益97購01,,,,,0.00,0.00,0,0,0,0,0,0,0,0,0,0,0,0,0
20200528,054278,晶技群益97購02,3.56,3.56,3.53,3.53,-0.25,-6.61,20000,4,71140,0,0,0,0,0,0,20000,0,20000,20000
20200528,054279,揚明光群益98購01,0.15,0.15,0.15,0.15,-0.03,-16.67,100000,2,15000,0,0,0,0,0,0,0,100000,-100000,-100000
20200528,05427P,聯發科凱基96售07,,,,,0.00,0.00,0,0,0,0,0,0,0,0,0,0,0,0,0
20200528,054280,牧德群益98購01,,,,,0.00,0.00,0,0,0,0,0,0,0,0,0,0,0,0,0
20200528,054281,世芯群益97購01,,,,,0.00,0.00,0,0,0,0,0,0,0,0,0,0,0,0,0
20200528,054282,泰鼎群益98購02,,,,,0.00,0.00,0,0,0,0,0,0,0,0,0,0,0,0,0
20200528,054283,元油反元大99購02,,,,,0.00,0.00,0,0,0,0,0,0,0,0,0,0,0,0,0
20200528,054284,和大元大96購03,,,,,0.00,0.00,0,0,0,0,0,0,0,0,0,0,0,0,0
20200528,054285,國巨元大98購02,,,,,0.00,0.00,0,0,0,0,0,0,0,0,0,0,0,0,0
20200528,054286,台積電元大96購22,,,,,0.00,0.00,0,0,0,0,0,0,0,0,0,0,0,0,0
20200528,054287,台積電元大97購11,,,,,0.00,0.00,0,0,0,0,0,0,0,0,0,0,0,0,0
20200528,054288,華邦電元大96購05,,,,,0.00,0.00,0,0,0,0,0,0,0,0,0,0,0,0,0
20200528,054289,聯發科元大97購11,,,,,0.00,0.00,0,0,0,0,0,0,0,0,0,0,0,0,0
20200528,054290,奇力新元大96購05,,,,,0.00,0.00,0,0,0,0,0,0,0,0,0,0,0,0,0
20200528,054291,高鐵元大97購01,0.90,0.91,0.60,0.60,-0.19,-24.05,788000,35,581080,0,0,0,0,0,0,686000,103000,583000,583000
20200528,054292,欣興元大96購06,0.69,0.76,0.69,0.69,+0.04,6.15,35000,7,24460,0,0,0,0,0,0,2000,18000,-16000,-16000
20200528,054293,健策元大98購02,,,,,0.00,0.00,0,0,0,0,0,0,0,0,0,0,0,0,0
20200528,054294,世芯元大96購02,,,,,0.00,0.00,0,0,0,0,0,0,0,0,0,0,0,0,0
20200528,054295,世芯元大96購03,,,,,0.00,0.00,0,0,0,0,0,0,0,0,0,0,0,0,0
20200528,054296,世芯元大97購01,,,,,0.00,0.00,0,0,0,0,0,0,0,0,0,0,0,0,0
20200528,054297,台郡元大98購01,,,,,0.00,0.00,0,0,0,0,0,0,0,0,0,0,0,0,0
20200528,054298,台表科元大97購03,2.55,2.55,2.28,2.28,-0.81,-26.21,52000,2,125040,0,0,0,0,0,0,28000,24000,4000,4000
20200528,054299,南電元大96購03,,,,,0.00,0.00,0,0,0,0,0,0,0,0,0,0,0,0,0
20200528,054300,華通凱基96購07,1.40,1.57,1.40,1.53,+0.34,28.57,196000,7,289400,0,0,0,0,0,0,97000,99000,-2000,-2000
20200528,054301,楠梓電凱基98購01,0.51,0.51,0.51,0.51,+0.02,4.08,100000,1,51000,0,0,0,0,0,0,0,100000,-100000,-100000
20200528,054302,鴻海凱基96購18,,,,,0.00,0.00,0,0,0,0,0,0,0,0,0,0,0,0,0
20200528,054303,國巨凱基96購15,,,,,0.00,0.00,0,0,0,0,0,0,0,0,0,0,0,0,0
20200528,054304,台積電凱基96購23,,,,,0.00,0.00,0,0,0,0,0,0,0,0,0,0,0,0,0
20200528,054305,光磊凱基98購01,,,,,0.00,0.00,0,0,0,0,0,0,0,0,0,0,0,0,0
20200528,054306,聯發科凱基96購23,,,,,0.00,0.00,0,0,0,0,0,0,0,0,0,0,0,0,0
20200528,054307,高鐵凱基98購01,0.59,0.59,0.40,0.42,-0.13,-23.64,338000,40,175310,0,0,0,0,0,0,210000,128000,82000,82000
20200528,054308,嘉晶凱基98購01,2.84,2.90,2.56,2.56,-0.54,-17.42,12000,4,32920,0,0,0,0,0,0,12000,7000,5000,5000
20200528,054309,禾伸堂凱基98購01,3.57,3.57,3.57,3.57,+0.01,0.28,20000,1,71400,0,0,0,0,0,0,20000,0,20000,20000
20200528,054310,牧德凱基98購01,,,,,0.00,0.00,0,0,0,0,0,0,0,0,0,0,0,0,0
20200528,054311,世芯凱基96購02,1.66,1.71,1.66,1.71,-0.05,-2.84,59000,3,99190,0,0,0,0,0,0,30000,29000,1000,1000
20200528,054312,TPK凱基98購01,,,,,0.00,0.00,0,0,0,0,0,0,0,0,0,0,0,0,0
20200528,054313,麗豐凱基96購02,,,,,0.00,0.00,0,0,0,0,0,0,0,0,0,0,0,0,0
20200528,054314,嘉聯益凱基97購01,,,,,0.00,0.00,0,0,0,0,0,0,0,0,0,0,0,0,0
20200528,054315,訊芯凱基98購01,,,,,0.00,0.00,0,0,0,0,0,0,0,0,0,0,0,0,0
20200528,054316,矽創凱基97購01,0.83,0.93,0.83,0.85,+0.18,26.87,93000,12,81510,0,0,0,0,0,0,32000,61000,-29000,-29000
20200528,054317,昇陽半凱基98購01,0.23,0.24,0.23,0.23,0.00,0.00,40000,3,9300,0,0,0,0,0,0,0,40000,-40000,-40000
20200528,054318,台虹凱基98購01,0.92,0.93,0.82,0.82,-0.12,-12.77,408000,21,358760,0,0,0,0,0,0,258000,256000,2000,2000
20200528,054319,世紀鋼凱基96購02,0.71,1.03,0.71,1.01,+0.23,29.49,278000,33,256620,0,0,0,0,0,0,76000,202000,-126000,-126000
20200528,05431P,台光電統一97售01,0.24,0.25,0.24,0.25,+0.02,8.7,13000,4,3140,0,0,0,0,0,0,10000,3000,7000,7000
20200528,054320,國喬台新96購01,,,,,0.00,0.00,0,0,0,0,0,0,0,0,0,0,0,0,0
20200528,054321,上銀台新96購01,,,,,0.00,0.00,0,0,0,0,0,0,0,0,0,0,0,0,0
20200528,054322,國巨台新96購02,,,,,0.00,0.00,0,0,0,0,0,0,0,0,0,0,0,0,0
20200528,054323,旺宏台新96購02,,,,,0.00,0.00,0,0,0,0,0,0,0,0,0,0,0,0,0
20200528,054324,美律台新97購01,,,,,0.00,0.00,0,0,0,0,0,0,0,0,0,0,0,0,0
20200528,054325,奇力新台新97購03,,,,,0.00,0.00,0,0,0,0,0,0,0,0,0,0,0,0,0
20200528,054326,宏達電台新97購02,,,,,0.00,0.00,0,0,0,0,0,0,0,0,0,0,0,0,0
20200528,054327,亞光台新96購02,,,,,0.00,0.00,0,0,0,0,0,0,0,0,0,0,0,0,0
20200528,054328,台化康和96購01,,,,,0.00,0.00,0,0,0,0,0,0,0,0,0,0,0,0,0
20200528,054329,華新科永豐96購02,,,,,0.00,0.00,0,0,0,0,0,0,0,0,0,0,0,0,0
20200528,054330,世芯永豐96購02,0.63,0.66,0.54,0.65,-0.04,-5.8,113000,13,68020,0,0,0,0,0,0,33000,80000,-47000,-47000
20200528,054331,世芯永豐96購03,,,,,0.00,0.00,0,0,0,0,0,0,0,0,0,0,0,0,0
20200528,054332,世芯永豐97購01,1.28,1.30,1.18,1.28,+0.04,3.23,137000,13,171110,0,0,0,0,0,0,84000,53000,31000,31000
20200528,054333,茂林永豐96購03,0.17,0.17,0.17,0.17,-0.03,-15.0,34000,16,5780,0,0,0,0,0,0,34000,0,34000,34000
20200528,054334,超眾永豐96購04,,,,,0.00,0.00,0,0,0,0,0,0,0,0,0,0,0,0,0
20200528,054335,緯穎永豐96購02,1.70,1.74,1.54,1.54,-0.25,-13.97,40000,12,64610,0,0,0,0,0,0,20000,20000,0,0
20200528,054336,台積電統一96購11,,,,,0.00,0.00,0,0,0,0,0,0,0,0,0,0,0,0,0
20200528,054337,智邦統一96購01,,,,,0.00,0.00,0,0,0,0,0,0,0,0,0,0,0,0,0
20200528,054338,全新統一96購01,,,,,0.00,0.00,0,0,0,0,0,0,0,0,0,0,0,0,0
20200528,054339,聯詠統一96購02,0.57,0.57,0.57,0.57,-0.06,-9.52,4000,2,2280,0,0,0,0,0,0,0,4000,-4000,-4000
20200528,054340,大成鋼元富96購01,,,,,0.00,0.00,0,0,0,0,0,0,0,0,0,0,0,0,0
20200528,054341,燿華元富96購03,,,,,0.00,0.00,0,0,0,0,0,0,0,0,0,0,0,0,0
20200528,054342,亞光元富99購01,,,,,0.00,0.00,0,0,0,0,0,0,0,0,0,0,0,0,0
20200528,054343,世紀鋼元富96購02,1.38,2.15,0.40,1.85,+0.42,29.37,1206000,99,2119240,0,0,0,0,0,0,316000,885000,-569000,-569000
20200528,054344,景碩國票97購04,0.10,0.10,0.10,0.10,0.00,0.00,15000,1,1500,0,0,0,0,0,0,0,0,0,0
20200528,054345,世芯國票96購02,,,,,0.00,0.00,0,0,0,0,0,0,0,0,0,0,0,0,0
20200528,054346,世芯國票97購01,4.46,4.73,4.46,4.73,+0.21,4.65,10000,2,47030,0,0,0,0,0,0,0,10000,-10000,-10000
20200528,054347,上緯控國票96購02,0.55,0.57,0.39,0.39,-0.12,-23.53,750000,47,375570,0,0,0,0,0,0,374000,362000,12000,12000
20200528,054348,康控國票97購03,,,,,0.00,0.00,0,0,0,0,0,0,0,0,0,0,0,0,0
20200528,054349,同欣電國票97購02,0.44,0.45,0.37,0.40,-0.17,-29.82,294000,7,119880,0,0,0,0,0,0,30000,264000,-234000,-234000
20200528,054350,美律國泰98購01,,,,,0.00,0.00,0,0,0,0,0,0,0,0,0,0,0,0,0
20200528,054351,華新科國泰97購03,1.26,1.26,1.08,1.08,-0.17,-13.6,111000,27,133950,0,0,0,0,0,0,81000,30000,51000,51000
20200528,054352,世芯國泰98購01,10.10,10.10,10.10,10.10,-1.20,-10.62,2000,1,20200,0,0,0,0,0,0,0,2000,-2000,-2000
20200528,054353,世紀鋼國泰98購01,,,,,0.00,0.00,0,0,0,0,0,0,0,0,0,0,0,0,0
20200528,054354,技嘉富邦97購01,1.18,1.18,1.18,1.18,-0.08,-6.35,10000,1,11800,0,0,0,0,0,0,10000,0,10000,10000
20200528,054355,上海銀富邦98購01,,,,,0.00,0.00,0,0,0,0,0,0,0,0,0,0,0,0,0
20200528,054356,可成兆豐97購01,,,,,0.00,0.00,0,0,0,0,0,0,0,0,0,0,0,0,0
20200528,054357,可成兆豐97購02,0.45,0.45,0.41,0.41,-0.02,-4.65,115000,6,50250,0,0,0,0,0,0,35000,80000,-45000,-45000
20200528,054358,矽創兆豐96購01,0.54,0.54,0.49,0.49,0.00,0.00,22000,3,11280,0,0,0,0,0,0,10000,12000,-2000,-2000
20200528,054359,南亞科日盛96購02,0.01,0.01,0.01,0.01,0.00,0.00,100000,1,1000,0,0,0,0,0,0,100000,100000,0,0
20200528,054360,智邦凱基96購03,,,,,0.00,0.00,0,0,0,0,0,0,0,0,0,0,0,0,0
20200528,054361,技嘉凱基96購01,1.33,1.33,1.02,1.02,-0.43,-29.66,25000,4,27880,0,0,0,0,0,0,23000,2000,21000,21000
20200528,054362,亞光凱基96購03,,,,,0.00,0.00,0,0,0,0,0,0,0,0,0,0,0,0,0
20200528,054363,世芯凱基97購01,5.15,5.40,4.88,5.40,-0.05,-0.92,78000,6,400500,0,0,0,0,0,0,10000,68000,-58000,-58000
20200528,054364,智伸科凱基96購01,,,,,0.00,0.00,0,0,0,0,0,0,0,0,0,0,0,0,0
20200528,054365,遠東新中信96購01,,,,,0.00,0.00,0,0,0,0,0,0,0,0,0,0,0,0,0
20200528,054366,和大中信98購01,,,,,0.00,0.00,0,0,0,0,0,0,0,0,0,0,0,0,0
20200528,054367,鴻海中信98購03,,,,,0.00,0.00,0,0,0,0,0,0,0,0,0,0,0,0,0
20200528,054368,鴻海中信9A購02,0.04,0.04,0.04,0.04,0.00,0.00,1000,1,40,0,0,0,0,0,0,0,0,0,0
20200528,054369,鴻海中信9C購01,0.16,0.16,0.12,0.12,-0.03,-20.0,708000,32,89420,0,0,0,0,0,0,0,701000,-701000,-701000
20200528,054370,台積電中信9A購01,,,,,0.00,0.00,0,0,0,0,0,0,0,0,0,0,0,0,0
20200528,054371,台積電中信9C購01,0.35,0.35,0.35,0.35,+0.03,9.38,10000,1,3500,0,0,0,0,0,0,0,0,0,0
20200528,054372,南亞科中信96購01,,,,,0.00,0.00,0,0,0,0,0,0,0,0,0,0,0,0,0
20200528,054373,富邦金中信97購01,,,,,0.00,0.00,0,0,0,0,0,0,0,0,0,0,0,0,0
20200528,054374,信邦中信96購01,0.47,0.47,0.47,0.47,+0.02,4.44,20000,1,9400,0,0,0,0,0,0,20000,0,20000,20000
20200528,054375,貿聯中信99購01,,,,,0.00,0.00,0,0,0,0,0,0,0,0,0,0,0,0,0
20200528,054376,聯茂中信97購01,,,,,0.00,0.00,0,0,0,0,0,0,0,0,0,0,0,0,0
20200528,054377,臺股指中信99購09,0.14,0.14,0.13,0.13,-0.01,-7.14,453000,5,62890,0,0,0,0,0,0,0,0,0,0
20200528,054378,楠梓電群益98購01,1.28,1.28,1.15,1.15,-0.11,-8.73,170000,2,207200,0,0,0,0,0,0,80000,90000,-10000,-10000
20200528,054379,光磊群益98購01,,,,,0.00,0.00,0,0,0,0,0,0,0,0,0,0,0,0,0
20200528,054380,世芯群益97購02,,,,,0.00,0.00,0,0,0,0,0,0,0,0,0,0,0,0,0
20200528,054381,世芯群益98購01,4.25,4.33,4.08,4.21,+0.02,0.48,126000,15,528430,0,0,0,0,0,0,64000,62000,2000,2000
20200528,054382,康控群益96購03,,,,,0.00,0.00,0,0,0,0,0,0,0,0,0,0,0,0,0
20200528,054383,傳奇群益97購01,0.16,0.18,0.16,0.17,+0.03,21.43,60000,3,10100,0,0,0,0,0,0,40000,20000,20000,20000
20200528,054384,瀚宇博群益96購02,,,,,0.00,0.00,0,0,0,0,0,0,0,0,0,0,0,0,0
20200528,054385,矽創群益98購01,0.98,1.01,0.93,0.96,0.00,0.00,50000,5,48400,0,0,0,0,0,0,0,50000,-50000,-50000
20200528,054386,鴻海統一98購03,,,,,0.00,0.00,0,0,0,0,0,0,0,0,0,0,0,0,0
20200528,054387,台積電統一98購02,,,,,0.00,0.00,0,0,0,0,0,0,0,0,0,0,0,0,0
20200528,054388,漢唐統一97購02,,,,,0.00,0.00,0,0,0,0,0,0,0,0,0,0,0,0,0
20200528,054389,為升元富96購02,,,,,0.00,0.00,0,0,0,0,0,0,0,0,0,0,0,0,0
20200528,054390,智邦元富96購03,,,,,0.00,0.00,0,0,0,0,0,0,0,0,0,0,0,0,0
20200528,054391,宏達電元富96購04,,,,,0.00,0.00,0,0,0,0,0,0,0,0,0,0,0,0,0
20200528,054392,華通永豐96購05,,,,,0.00,0.00,0,0,0,0,0,0,0,0,0,0,0,0,0
20200528,054393,漢唐永豐96購01,,,,,0.00,0.00,0,0,0,0,0,0,0,0,0,0,0,0,0
20200528,054394,奇力新永豐96購03,,,,,0.00,0.00,0,0,0,0,0,0,0,0,0,0,0,0,0
20200528,054395,華新科永豐96購03,,,,,0.00,0.00,0,0,0,0,0,0,0,0,0,0,0,0,0
20200528,054396,日電貿永豐96購02,,,,,0.00,0.00,0,0,0,0,0,0,0,0,0,0,0,0,0
20200528,054397,創意永豐96購05,,,,,0.00,0.00,0,0,0,0,0,0,0,0,0,0,0,0,0
20200528,054398,牧德永豐96購03,,,,,0.00,0.00,0,0,0,0,0,0,0,0,0,0,0,0,0
20200528,054399,智易永豐96購03,,,,,0.00,0.00,0,0,0,0,0,0,0,0,0,0,0,0,0
20200528,054400,健策永豐96購02,0.03,0.04,0.03,0.04,-0.03,-42.86,110000,11,3800,0,0,0,0,0,0,110000,110000,0,0
20200528,054401,康普永豐96購01,,,,,0.00,0.00,0,0,0,0,0,0,0,0,0,0,0,0,0
20200528,054402,康控永豐96購03,,,,,0.00,0.00,0,0,0,0,0,0,0,0,0,0,0,0,0
20200528,054403,同欣電永豐96購02,,,,,0.00,0.00,0,0,0,0,0,0,0,0,0,0,0,0,0
20200528,054404,新日興康和96購01,0.30,0.33,0.30,0.33,0.00,0.00,90000,4,27660,0,0,0,0,0,0,0,90000,-90000,-90000
20200528,054405,樺漢康和96購01,,,,,0.00,0.00,0,0,0,0,0,0,0,0,0,0,0,0,0
20200528,054406,旺宏國票98購01,0.96,0.96,0.84,0.84,-0.16,-16.0,38000,5,35940,0,0,0,0,0,0,31000,7000,24000,24000
20200528,054407,美律國票97購02,,,,,0.00,0.00,0,0,0,0,0,0,0,0,0,0,0,0,0
20200528,054408,義隆國票98購01,1.83,1.92,1.80,1.86,+0.09,5.08,98000,9,183820,0,0,0,0,0,0,39000,59000,-20000,-20000
20200528,054409,亞光國票97購02,,,,,0.00,0.00,0,0,0,0,0,0,0,0,0,0,0,0,0
20200528,05440P,緯穎國票96售02,,,,,0.00,0.00,0,0,0,0,0,0,0,0,0,0,0,0,0
20200528,054410,國巨元大96購14,,,,,0.00,0.00,0,0,0,0,0,0,0,0,0,0,0,0,0
20200528,054411,光磊元大97購02,0.62,0.65,0.61,0.65,+0.02,3.17,194000,4,120760,0,0,0,0,0,0,68000,126000,-58000,-58000
20200528,054412,智邦元大96購03,,,,,0.00,0.00,0,0,0,0,0,0,0,0,0,0,0,0,0
20200528,054413,台光電元大96購03,,,,,0.00,0.00,0,0,0,0,0,0,0,0,0,0,0,0,0
20200528,054414,全新元大97購02,,,,,0.00,0.00,0,0,0,0,0,0,0,0,0,0,0,0,0
20200528,054415,奇力新元大96購06,,,,,0.00,0.00,0,0,0,0,0,0,0,0,0,0,0,0,0
20200528,054416,禾伸堂元大97購01,,,,,0.00,0.00,0,0,0,0,0,0,0,0,0,0,0,0,0
20200528,054417,牧德元大96購01,,,,,0.00,0.00,0,0,0,0,0,0,0,0,0,0,0,0,0
20200528,054418,茂林元大97購01,2.79,2.79,2.79,2.79,-1.21,-30.25,9000,1,25110,0,0,0,0,0,0,9000,0,9000,9000
20200528,054419,嘉聯益元大98購02,,,,,0.00,0.00,0,0,0,0,0,0,0,0,0,0,0,0,0
20200528,054420,緯穎元大96購08,7.20,7.35,6.20,6.20,-0.75,-10.79,125000,22,869350,0,0,0,0,0,0,57000,68000,-11000,-11000
20200528,054421,臺股指元大99購03,0.45,0.45,0.44,0.44,-0.01,-2.22,2000,2,890,0,0,0,0,0,0,0,2000,-2000,-2000
20200528,054422,T50反1富邦9A購01,,,,,0.00,0.00,0,0,0,0,0,0,0,0,0,0,0,0,0
20200528,054423,華新富邦96購01,,,,,0.00,0.00,0,0,0,0,0,0,0,0,0,0,0,0,0
20200528,054424,大成鋼富邦97購02,,,,,0.00,0.00,0,0,0,0,0,0,0,0,0,0,0,0,0
20200528,054425,聯發科富邦99購03,,,,,0.00,0.00,0,0,0,0,0,0,0,0,0,0,0,0,0
20200528,054426,國泰金富邦97購02,0.31,0.31,0.27,0.27,-0.05,-15.62,113000,9,33120,0,0,0,0,0,0,0,113000,-113000,-113000
20200528,054427,潤泰全富邦97購01,,,,,0.00,0.00,0,0,0,0,0,0,0,0,0,0,0,0,0
20200528,054428,禾伸堂富邦98購01,,,,,0.00,0.00,0,0,0,0,0,0,0,0,0,0,0,0,0
20200528,054429,中石化台新97購01,,,,,0.00,0.00,0,0,0,0,0,0,0,0,0,0,0,0,0
20200528,05442P,鴻海元大96售13,,,,,0.00,0.00,0,0,0,0,0,0,0,0,0,0,0,0,0
20200528,054430,上銀台新96購02,,,,,0.00,0.00,0,0,0,0,0,0,0,0,0,0,0,0,0
20200528,054431,鴻海台新96購03,,,,,0.00,0.00,0,0,0,0,0,0,0,0,0,0,0,0,0
20200528,054432,台積電台新96購05,0.02,0.02,0.02,0.02,0.00,0.00,70000,1,1400,0,0,0,0,0,0,70000,0,70000,70000
20200528,054433,南亞科台新96購02,,,,,0.00,0.00,0,0,0,0,0,0,0,0,0,0,0,0,0
20200528,054434,友達台新96購03,,,,,0.00,0.00,0,0,0,0,0,0,0,0,0,0,0,0,0
20200528,054435,華新科台新97購02,,,,,0.00,0.00,0,0,0,0,0,0,0,0,0,0,0,0,0
20200528,054436,高鐵台新97購02,1.23,1.23,1.02,1.02,0.00,0.00,150000,2,163500,0,0,0,0,0,0,150000,150000,0,0
20200528,054437,欣興台新97購02,0.52,0.52,0.52,0.52,0.00,0.00,110000,3,57200,0,0,0,0,0,0,0,110000,-110000,-110000
20200528,054438,群創台新96購01,,,,,0.00,0.00,0,0,0,0,0,0,0,0,0,0,0,0,0
20200528,054439,健策台新96購03,1.73,1.80,1.36,1.36,-0.21,-13.38,121000,28,214500,0,0,0,0,0,0,113000,8000,105000,105000
20200528,054440,TPK台新98購01,,,,,0.00,0.00,0,0,0,0,0,0,0,0,0,0,0,0,0
20200528,054441,力成台新96購01,,,,,0.00,0.00,0,0,0,0,0,0,0,0,0,0,0,0,0
20200528,054442,啟碁台新96購01,,,,,0.00,0.00,0,0,0,0,0,0,0,0,0,0,0,0,0
20200528,054443,樺漢台新96購02,,,,,0.00,0.00,0,0,0,0,0,0,0,0,0,0,0,0,0
20200528,054444,緯穎台新97購01,,,,,0.00,0.00,0,0,0,0,0,0,0,0,0,0,0,0,0
20200528,054445,技嘉兆豐96購01,,,,,0.00,0.00,0,0,0,0,0,0,0,0,0,0,0,0,0
20200528,054446,美食兆豐97購01,0.39,0.39,0.35,0.35,-0.04,-10.26,182000,4,67980,0,0,0,0,0,0,65000,110000,-45000,-45000
20200528,054447,國泰金兆豐96購01,,,,,0.00,0.00,0,0,0,0,0,0,0,0,0,0,0,0,0
20200528,054448,矽力兆豐96購01,,,,,0.00,0.00,0,0,0,0,0,0,0,0,0,0,0,0,0
20200528,054449,中環第一96購01,0.01,0.01,0.01,0.01,0.00,0.00,50000,1,500,0,0,0,0,0,0,50000,0,50000,50000
20200528,054450,聯茂第一96購01,,,,,0.00,0.00,0,0,0,0,0,0,0,0,0,0,0,0,0
20200528,054451,上銀亞東98購01,3.52,3.52,3.52,3.52,+0.24,7.32,9000,1,31680,0,0,0,0,0,0,0,9000,-9000,-9000
20200528,054452,華通亞東96購01,,,,,0.00,0.00,0,0,0,0,0,0,0,0,0,0,0,0,0
20200528,054453,上海銀亞東96購01,,,,,0.00,0.00,0,0,0,0,0,0,0,0,0,0,0,0,0
20200528,054454,滬深2X群益96購04,,,,,0.00,0.00,0,0,0,0,0,0,0,0,0,0,0,0,0
20200528,054455,楠梓電群益98購02,0.84,0.84,0.84,0.84,0.00,0.00,280000,1,235200,0,0,0,0,0,0,280000,0,280000,280000
20200528,054456,華泰群益99購01,,,,,0.00,0.00,0,0,0,0,0,0,0,0,0,0,0,0,0
20200528,054457,強茂群益96購01,0.64,0.64,0.58,0.58,-0.11,-15.94,332000,4,200500,0,0,0,0,0,0,172000,160000,12000,12000
20200528,054458,復盛群益96購01,0.98,0.98,0.98,0.98,0.00,0.00,60000,1,58800,0,0,0,0,0,0,0,60000,-60000,-60000
20200528,054459,鈺齊群益96購01,,,,,0.00,0.00,0,0,0,0,0,0,0,0,0,0,0,0,0
20200528,054460,和大凱基97購01,,,,,0.00,0.00,0,0,0,0,0,0,0,0,0,0,0,0,0
20200528,054461,台積電凱基97購09,,,,,0.00,0.00,0,0,0,0,0,0,0,0,0,0,0,0,0
20200528,054462,旺宏凱基96購08,,,,,0.00,0.00,0,0,0,0,0,0,0,0,0,0,0,0,0
20200528,054463,瑞昱凱基97購01,4.81,4.81,4.81,4.81,0.00,0.00,7000,1,33670,0,0,0,0,0,0,0,7000,-7000,-7000
20200528,054464,奇力新凱基98購02,,,,,0.00,0.00,0,0,0,0,0,0,0,0,0,0,0,0,0
20200528,054465,亞光凱基97購01,,,,,0.00,0.00,0,0,0,0,0,0,0,0,0,0,0,0,0
20200528,054466,欣興凱基97購03,1.47,1.49,1.45,1.49,-0.02,-1.32,65000,6,95850,0,0,0,0,0,0,65000,0,65000,65000
20200528,054467,隆達凱基97購01,0.69,0.72,0.57,0.58,-0.12,-17.14,339000,15,211450,0,0,0,0,0,0,237000,92000,145000,145000
20200528,054468,台郡凱基98購01,,,,,0.00,0.00,0,0,0,0,0,0,0,0,0,0,0,0,0
20200528,054469,同欣電凱基97購01,,,,,0.00,0.00,0,0,0,0,0,0,0,0,0,0,0,0,0
20200528,054470,緯穎國票97購04,17.50,17.50,15.70,15.70,-2.20,-12.29,9000,3,155300,0,0,0,0,0,0,1000,8000,-7000,-7000
20200528,054471,T50反1中信9C購01,1.84,1.93,1.84,1.92,+0.04,2.13,331000,9,627080,0,0,0,0,0,0,165000,163000,2000,2000
20200528,054472,道瓊反中信9A購01,1.26,1.29,1.24,1.26,0.00,0.00,253000,17,322380,0,0,0,0,0,0,0,253000,-253000,-253000
20200528,054473,鴻海中信96購02,,,,,0.00,0.00,0,0,0,0,0,0,0,0,0,0,0,0,0
20200528,054474,鴻海中信96購03,,,,,0.00,0.00,0,0,0,0,0,0,0,0,0,0,0,0,0
20200528,054475,鴻海中信96購04,,,,,0.00,0.00,0,0,0,0,0,0,0,0,0,0,0,0,0
20200528,054476,聯發科中信96購03,,,,,0.00,0.00,0,0,0,0,0,0,0,0,0,0,0,0,0
20200528,054477,聯發科中信9C購02,0.46,0.46,0.46,0.46,0.00,0.00,20000,1,9200,0,0,0,0,0,0,20000,0,20000,20000
20200528,054478,可成中信97購01,0.10,0.10,0.10,0.10,-0.01,-9.09,10000,1,1000,0,0,0,0,0,0,10000,0,10000,10000
20200528,054479,緯創中信98購01,2.63,2.66,2.63,2.65,+0.11,4.33,40000,5,105880,0,0,0,0,0,0,18000,22000,-4000,-4000
20200528,054480,和碩中信98購01,,,,,0.00,0.00,0,0,0,0,0,0,0,0,0,0,0,0,0
20200528,054481,鎧勝中信96購01,,,,,0.00,0.00,0,0,0,0,0,0,0,0,0,0,0,0,0
20200528,054482,大成鋼台新96購01,,,,,0.00,0.00,0,0,0,0,0,0,0,0,0,0,0,0,0
20200528,054483,聯電台新96購01,,,,,0.00,0.00,0,0,0,0,0,0,0,0,0,0,0,0,0
20200528,054484,仁寶台新96購01,,,,,0.00,0.00,0,0,0,0,0,0,0,0,0,0,0,0,0
20200528,054485,華邦電台新96購01,,,,,0.00,0.00,0,0,0,0,0,0,0,0,0,0,0,0,0
20200528,054486,漢唐台新96購01,,,,,0.00,0.00,0,0,0,0,0,0,0,0,0,0,0,0,0
20200528,054487,京元電台新97購01,,,,,0.00,0.00,0,0,0,0,0,0,0,0,0,0,0,0,0
20200528,054488,禾伸堂台新96購01,,,,,0.00,0.00,0,0,0,0,0,0,0,0,0,0,0,0,0
20200528,054489,牧德台新97購02,,,,,0.00,0.00,0,0,0,0,0,0,0,0,0,0,0,0,0
20200528,054490,臻鼎台新96購02,,,,,0.00,0.00,0,0,0,0,0,0,0,0,0,0,0,0,0
20200528,054491,瀚宇博台新96購02,,,,,0.00,0.00,0,0,0,0,0,0,0,0,0,0,0,0,0
20200528,054492,嘉聯益台新96購01,,,,,0.00,0.00,0,0,0,0,0,0,0,0,0,0,0,0,0
20200528,054493,同欣電台新96購01,,,,,0.00,0.00,0,0,0,0,0,0,0,0,0,0,0,0,0
20200528,054494,訊芯台新96購01,,,,,0.00,0.00,0,0,0,0,0,0,0,0,0,0,0,0,0
20200528,054495,滬深2X永豐97購02,,,,,0.00,0.00,0,0,0,0,0,0,0,0,0,0,0,0,0
20200528,054496,為升永豐96購01,,,,,0.00,0.00,0,0,0,0,0,0,0,0,0,0,0,0,0
20200528,054497,國巨永豐96購05,,,,,0.00,0.00,0,0,0,0,0,0,0,0,0,0,0,0,0
20200528,054498,燿華永豐96購06,,,,,0.00,0.00,0,0,0,0,0,0,0,0,0,0,0,0,0
20200528,054499,台光電永豐96購02,,,,,0.00,0.00,0,0,0,0,0,0,0,0,0,0,0,0,0
20200528,054500,美律永豐96購02,,,,,0.00,0.00,0,0,0,0,0,0,0,0,0,0,0,0,0
20200528,054501,強茂永豐96購02,,,,,0.00,0.00,0,0,0,0,0,0,0,0,0,0,0,0,0
20200528,054502,泰碩永豐96購01,,,,,0.00,0.00,0,0,0,0,0,0,0,0,0,0,0,0,0
20200528,054503,京鼎永豐96購04,0.02,0.02,0.02,0.02,0.00,0.00,21000,1,420,0,0,0,0,0,0,21000,0,21000,21000
20200528,054504,聯鈞永豐96購01,,,,,0.00,0.00,0,0,0,0,0,0,0,0,0,0,0,0,0
20200528,054505,揚明光永豐97購02,,,,,0.00,0.00,0,0,0,0,0,0,0,0,0,0,0,0,0
20200528,054506,矽格永豐96購01,0.08,0.08,0.08,0.08,-0.01,-11.11,440000,1,35200,0,0,0,0,0,0,440000,0,440000,440000
20200528,054507,鈺齊永豐96購01,,,,,0.00,0.00,0,0,0,0,0,0,0,0,0,0,0,0,0
20200528,054508,臺股指永豐96購04,,,,,0.00,0.00,0,0,0,0,0,0,0,0,0,0,0,0,0
20200528,054509,上証反元大99購01,,,,,0.00,0.00,0,0,0,0,0,0,0,0,0,0,0,0,0
20200528,054510,S&P反1元大98購01,,,,,0.00,0.00,0,0,0,0,0,0,0,0,0,0,0,0,0
20200528,054511,香港反元大98購01,1.62,1.88,1.55,1.88,0.00,0.00,36000,7,62630,0,0,0,0,0,0,0,0,0,0
20200528,054512,元油反元大99購03,,,,,0.00,0.00,0,0,0,0,0,0,0,0,0,0,0,0,0
20200528,054513,元金2X元大96購01,,,,,0.00,0.00,0,0,0,0,0,0,0,0,0,0,0,0,0
20200528,054514,道瓊銀元大98購01,0.53,0.53,0.53,0.53,0.00,0.00,5000,1,2650,0,0,0,0,0,0,5000,0,5000,5000
20200528,054515,華通元大98購02,,,,,0.00,0.00,0,0,0,0,0,0,0,0,0,0,0,0,0
20200528,054516,國巨元大97購02,,,,,0.00,0.00,0,0,0,0,0,0,0,0,0,0,0,0,0
20200528,054517,高鐵元大96購01,1.30,1.30,0.81,0.81,-0.33,-28.95,687000,35,771800,0,0,0,0,0,0,490000,247000,243000,243000
20200528,054518,亞光元大97購01,,,,,0.00,0.00,0,0,0,0,0,0,0,0,0,0,0,0,0
20200528,054519,禾伸堂元大97購02,,,,,0.00,0.00,0,0,0,0,0,0,0,0,0,0,0,0,0
20200528,054520,健鼎元大96購02,,,,,0.00,0.00,0,0,0,0,0,0,0,0,0,0,0,0,0
20200528,054521,TPK元大96購03,,,,,0.00,0.00,0,0,0,0,0,0,0,0,0,0,0,0,0
20200528,054522,康友元大96購07,,,,,0.00,0.00,0,0,0,0,0,0,0,0,0,0,0,0,0
20200528,054523,GIS元大96購05,1.22,1.22,0.87,0.87,-0.16,-15.53,136000,2,142120,0,0,0,0,0,0,68000,68000,0,0
20200528,054524,華通元富96購03,0.01,0.01,0.01,0.01,0.00,0.00,1000,1,10,0,0,0,0,0,0,1000,1000,0,0
20200528,054525,奇鋐元富96購01,,,,,0.00,0.00,0,0,0,0,0,0,0,0,0,0,0,0,0
20200528,054526,道瓊反統一98購01,1.13,1.13,1.13,1.13,0.00,0.00,41000,5,46330,0,0,0,0,0,0,0,41000,-41000,-41000
20200528,054527,國巨統一97購03,1.20,1.22,1.07,1.07,-0.09,-7.76,206000,6,246820,0,0,0,0,0,0,31000,176000,-145000,-145000
20200528,054528,台光電統一96購02,1.87,1.87,1.57,1.57,-0.27,-14.67,38000,3,70560,0,0,0,0,0,0,3000,35000,-32000,-32000
20200528,054529,T50反1國泰97購02,,,,,0.00,0.00,0,0,0,0,0,0,0,0,0,0,0,0,0
20200528,054530,台光電國泰97購03,,,,,0.00,0.00,0,0,0,0,0,0,0,0,0,0,0,0,0
20200528,054531,聯發科國泰97購02,2.80,2.80,2.80,2.80,+0.03,1.08,22000,1,61600,0,0,0,0,0,0,22000,0,22000,22000
20200528,054532,強茂國泰98購01,0.41,0.41,0.41,0.41,-0.06,-12.77,70000,2,28700,0,0,0,0,0,0,70000,0,70000,70000
20200528,054533,泰碩國泰98購01,1.00,1.02,0.93,0.93,-0.08,-7.92,335000,14,334300,0,0,0,0,0,0,198000,137000,61000,61000
20200528,054534,台積電富邦98購03,,,,,0.00,0.00,0,0,0,0,0,0,0,0,0,0,0,0,0
20200528,054535,旺宏富邦97購02,,,,,0.00,0.00,0,0,0,0,0,0,0,0,0,0,0,0,0
20200528,054536,宏達電富邦97購03,,,,,0.00,0.00,0,0,0,0,0,0,0,0,0,0,0,0,0
20200528,054537,南亞科亞東97購01,,,,,0.00,0.00,0,0,0,0,0,0,0,0,0,0,0,0,0
20200528,054538,台光電國票98購01,,,,,0.00,0.00,0,0,0,0,0,0,0,0,0,0,0,0,0
20200528,054539,欣興國票98購01,,,,,0.00,0.00,0,0,0,0,0,0,0,0,0,0,0,0,0
20200528,054540,泰鼎國票99購01,3.93,3.93,3.78,3.83,-0.03,-0.78,25000,3,96950,0,0,0,0,0,0,19000,6000,13000,13000
20200528,054541,康控國票98購01,,,,,0.00,0.00,0,0,0,0,0,0,0,0,0,0,0,0,0
20200528,054542,台表科國票98購01,,,,,0.00,0.00,0,0,0,0,0,0,0,0,0,0,0,0,0
20200528,054543,元金2X中信01購01,,,,,0.00,0.00,0,0,0,0,0,0,0,0,0,0,0,0,0
20200528,054544,統一中信97購01,0.04,0.04,0.04,0.04,-0.01,-20.0,1000,1,40,0,0,0,0,0,0,0,0,0,0
20200528,054545,奇力新中信98購01,0.09,0.09,0.09,0.09,0.00,0.00,1000,1,90,0,0,0,0,0,0,0,0,0,0
20200528,054546,玉晶光中信9B購01,0.18,0.21,0.17,0.17,0.00,0.00,5791000,89,1086590,0,0,0,0,0,0,3451000,1606000,1845000,1845000
20200528,054547,鴻海凱基98購02,1.16,1.16,1.11,1.11,-0.05,-4.31,8000,5,9230,0,0,0,0,0,0,8000,8000,0,0
20200528,054548,鴻海凱基98購03,,,,,0.00,0.00,0,0,0,0,0,0,0,0,0,0,0,0,0
20200528,054549,台積電凱基98購01,,,,,0.00,0.00,0,0,0,0,0,0,0,0,0,0,0,0,0
20200528,054550,旺宏凱基98購02,0.57,0.58,0.52,0.52,-0.08,-13.33,260000,6,145000,0,0,0,0,0,0,140000,120000,20000,20000
20200528,054551,聯發科凱基98購02,,,,,0.00,0.00,0,0,0,0,0,0,0,0,0,0,0,0,0
20200528,054552,聯發科凱基98購03,,,,,0.00,0.00,0,0,0,0,0,0,0,0,0,0,0,0,0
20200528,054553,宏達電凱基99購01,,,,,0.00,0.00,0,0,0,0,0,0,0,0,0,0,0,0,0
20200528,054554,大立光凱基98購02,,,,,0.00,0.00,0,0,0,0,0,0,0,0,0,0,0,0,0
20200528,054555,欣興凱基98購01,,,,,0.00,0.00,0,0,0,0,0,0,0,0,0,0,0,0,0
20200528,054556,世芯凱基99購01,0.57,0.69,0.57,0.69,+0.06,9.52,11000,2,6390,0,0,0,0,0,0,10000,1000,9000,9000
20200528,054557,臻鼎凱基98購01,,,,,0.00,0.00,0,0,0,0,0,0,0,0,0,0,0,0,0
20200528,054558,劍麟群益99購01,0.19,0.19,0.17,0.17,-0.01,-5.56,728000,11,135340,0,0,0,0,0,0,0,629000,-629000,-629000
20200528,054559,台光電群益99購01,,,,,0.00,0.00,0,0,0,0,0,0,0,0,0,0,0,0,0
20200528,054560,全新群益98購03,,,,,0.00,0.00,0,0,0,0,0,0,0,0,0,0,0,0,0
20200528,054561,奇力新群益97購03,,,,,0.00,0.00,0,0,0,0,0,0,0,0,0,0,0,0,0
20200528,054562,亞光群益98購01,,,,,0.00,0.00,0,0,0,0,0,0,0,0,0,0,0,0,0
20200528,054563,泰碩群益99購01,0.71,0.73,0.64,0.64,-0.08,-11.11,390000,10,263250,0,0,0,0,0,0,330000,60000,270000,270000
20200528,054564,玉晶光群益99購01,0.71,0.71,0.71,0.71,0.00,0.00,15000,1,10650,0,0,0,0,0,0,0,15000,-15000,-15000
20200528,054565,玉晶光群益99購02,0.63,0.63,0.63,0.63,0.00,0.00,5000,1,3150,0,0,0,0,0,0,0,5000,-5000,-5000
20200528,054566,貿聯群益97購02,,,,,0.00,0.00,0,0,0,0,0,0,0,0,0,0,0,0,0
20200528,054567,拓凱群益98購01,0.26,0.26,0.21,0.23,-0.05,-17.86,1095000,20,252020,0,0,0,0,0,0,675000,405000,270000,270000
20200528,054568,訊芯群益97購01,,,,,0.00,0.00,0,0,0,0,0,0,0,0,0,0,0,0,0
20200528,054569,GIS群益98購01,0.77,0.77,0.70,0.70,-0.09,-11.39,46000,3,34690,0,0,0,0,0,0,35000,11000,24000,24000
20200528,054570,易華電群益98購01,,,,,0.00,0.00,0,0,0,0,0,0,0,0,0,0,0,0,0
20200528,054571,楠梓電元大99購01,,,,,0.00,0.00,0,0,0,0,0,0,0,0,0,0,0,0,0
20200528,054572,國巨元大98購03,,,,,0.00,0.00,0,0,0,0,0,0,0,0,0,0,0,0,0
20200528,054573,漢唐元大98購01,0.90,0.90,0.73,0.73,-0.14,-16.09,25000,2,21650,0,0,0,0,0,0,25000,0,25000,25000
20200528,054574,美律元大99購01,0.13,0.13,0.13,0.13,+0.04,44.44,1000,1,130,0,0,0,0,0,0,0,0,0,0
20200528,054575,聯鈞元大97購01,,,,,0.00,0.00,0,0,0,0,0,0,0,0,0,0,0,0,0
20200528,054576,健策元大98購03,0.91,0.91,0.91,0.91,-0.29,-24.17,120000,1,109200,0,0,0,0,0,0,120000,120000,0,0
20200528,054577,世芯元大98購01,,,,,0.00,0.00,0,0,0,0,0,0,0,0,0,0,0,0,0
20200528,054578,世芯元大99購01,2.18,2.19,2.18,2.19,+0.57,35.19,45000,4,98450,0,0,0,0,0,0,0,45000,-45000,-45000
20200528,054579,聯茂元大97購01,,,,,0.00,0.00,0,0,0,0,0,0,0,0,0,0,0,0,0
20200528,054580,樺漢元大98購01,,,,,0.00,0.00,0,0,0,0,0,0,0,0,0,0,0,0,0
20200528,054581,訊芯元大97購02,,,,,0.00,0.00,0,0,0,0,0,0,0,0,0,0,0,0,0
20200528,054582,致新元大97購01,1.86,2.11,1.86,2.11,+0.22,11.64,94000,11,185340,0,0,0,0,0,0,92000,0,92000,92000
20200528,054583,玉晶光統一97購02,,,,,0.00,0.00,0,0,0,0,0,0,0,0,0,0,0,0,0
20200528,054584,貿聯元富97購01,,,,,0.00,0.00,0,0,0,0,0,0,0,0,0,0,0,0,0
20200528,054585,禾伸堂國泰99購01,,,,,0.00,0.00,0,0,0,0,0,0,0,0,0,0,0,0,0
20200528,054586,健鼎國泰99購01,0.41,0.41,0.41,0.41,+0.07,20.59,2000,1,820,0,0,0,0,0,0,2000,0,2000,2000
20200528,054587,玉晶光國泰99購01,,,,,0.00,0.00,0,0,0,0,0,0,0,0,0,0,0,0,0
20200528,054588,玉晶光國泰99購02,,,,,0.00,0.00,0,0,0,0,0,0,0,0,0,0,0,0,0
20200528,054589,聯鈞國泰99購01,1.09,1.09,1.02,1.02,-0.01,-0.97,15000,2,16000,0,0,0,0,0,0,15000,0,15000,15000
20200528,05458P,台積電凱基97售02,0.66,0.66,0.66,0.66,0.00,0.00,10000,1,6600,0,0,0,0,0,0,10000,10000,0,0
20200528,054590,嘉聯益國泰98購01,,,,,0.00,0.00,0,0,0,0,0,0,0,0,0,0,0,0,0
20200528,054591,GIS國泰98購01,0.72,0.72,0.72,0.72,0.00,0.00,1000,1,720,0,0,0,0,0,0,0,1000,-1000,-1000
20200528,054592,美律永昌9A購01,,,,,0.00,0.00,0,0,0,0,0,0,0,0,0,0,0,0,0
20200528,054593,滬深2X永昌9A購01,,,,,0.00,0.00,0,0,0,0,0,0,0,0,0,0,0,0,0
20200528,054594,國巨麥證97購01,,,,,0.00,0.00,0,0,0,0,0,0,0,0,0,0,0,0,0
20200528,054595,正崴麥證97購01,,,,,0.00,0.00,0,0,0,0,0,0,0,0,0,0,0,0,0
20200528,054596,聯發科麥證97購01,,,,,0.00,0.00,0,0,0,0,0,0,0,0,0,0,0,0,0
20200528,054597,南亞台新97購01,,,,,0.00,0.00,0,0,0,0,0,0,0,0,0,0,0,0,0
20200528,054598,鴻海台新98購01,,,,,0.00,0.00,0,0,0,0,0,0,0,0,0,0,0,0,0
20200528,054599,正崴台新97購01,,,,,0.00,0.00,0,0,0,0,0,0,0,0,0,0,0,0,0
20200528,054600,中壽台新97購01,,,,,0.00,0.00,0,0,0,0,0,0,0,0,0,0,0,0,0
20200528,054601,奇鋐台新98購01,,,,,0.00,0.00,0,0,0,0,0,0,0,0,0,0,0,0,0
20200528,054602,聯詠台新97購01,,,,,0.00,0.00,0,0,0,0,0,0,0,0,0,0,0,0,0
20200528,054603,智易台新98購01,,,,,0.00,0.00,0,0,0,0,0,0,0,0,0,0,0,0,0
20200528,054604,麗豐台新98購01,,,,,0.00,0.00,0,0,0,0,0,0,0,0,0,0,0,0,0
20200528,054605,鴻海永豐97購01,,,,,0.00,0.00,0,0,0,0,0,0,0,0,0,0,0,0,0
20200528,054606,台積電永豐97購02,,,,,0.00,0.00,0,0,0,0,0,0,0,0,0,0,0,0,0
20200528,054607,台積電永豐97購03,,,,,0.00,0.00,0,0,0,0,0,0,0,0,0,0,0,0,0
20200528,054608,致茂永豐97購01,0.02,0.02,0.02,0.02,0.00,0.00,50000,5,1000,0,0,0,0,0,0,0,50000,-50000,-50000
20200528,054609,正崴永豐97購01,,,,,0.00,0.00,0,0,0,0,0,0,0,0,0,0,0,0,0
20200528,054610,聯發科永豐97購01,,,,,0.00,0.00,0,0,0,0,0,0,0,0,0,0,0,0,0
20200528,054611,全新永豐97購01,,,,,0.00,0.00,0,0,0,0,0,0,0,0,0,0,0,0,0
20200528,054612,慧洋永豐97購01,,,,,0.00,0.00,0,0,0,0,0,0,0,0,0,0,0,0,0
20200528,054613,大立光永豐97購02,,,,,0.00,0.00,0,0,0,0,0,0,0,0,0,0,0,0,0
20200528,054614,玉晶光永豐97購03,,,,,0.00,0.00,0,0,0,0,0,0,0,0,0,0,0,0,0
20200528,054615,牧德永豐98購01,,,,,0.00,0.00,0,0,0,0,0,0,0,0,0,0,0,0,0
20200528,054616,智伸科永豐97購01,,,,,0.00,0.00,0,0,0,0,0,0,0,0,0,0,0,0,0
20200528,054617,超眾永豐97購01,,,,,0.00,0.00,0,0,0,0,0,0,0,0,0,0,0,0,0
20200528,054618,訊芯永豐97購01,,,,,0.00,0.00,0,0,0,0,0,0,0,0,0,0,0,0,0
20200528,054619,昇陽半永豐97購03,,,,,0.00,0.00,0,0,0,0,0,0,0,0,0,0,0,0,0
20200528,05461P,台積電亞東97售01,,,,,0.00,0.00,0,0,0,0,0,0,0,0,0,0,0,0,0
20200528,054620,南茂永豐97購01,,,,,0.00,0.00,0,0,0,0,0,0,0,0,0,0,0,0,0
20200528,054621,華新科兆豐98購01,0.06,0.06,0.06,0.06,0.00,0.00,20000,2,1200,0,0,0,0,0,0,0,10000,-10000,-10000
20200528,054622,漢唐第一97購01,,,,,0.00,0.00,0,0,0,0,0,0,0,0,0,0,0,0,0
20200528,054623,華新科第一97購01,,,,,0.00,0.00,0,0,0,0,0,0,0,0,0,0,0,0,0
20200528,054624,台積電凱基98購03,,,,,0.00,0.00,0,0,0,0,0,0,0,0,0,0,0,0,0
20200528,054625,旺宏凱基98購03,,,,,0.00,0.00,0,0,0,0,0,0,0,0,0,0,0,0,0
20200528,054626,建準凱基98購01,1.04,1.04,0.79,0.79,0.00,0.00,126000,5,124990,0,0,0,0,0,0,115000,11000,104000,104000
20200528,054627,義隆凱基98購01,0.75,0.85,0.73,0.76,+0.08,11.76,446000,37,342660,0,0,0,0,0,0,172000,294000,-122000,-122000
20200528,054628,可成凱基98購01,,,,,0.00,0.00,0,0,0,0,0,0,0,0,0,0,0,0,0
20200528,054629,華新科凱基98購01,,,,,0.00,0.00,0,0,0,0,0,0,0,0,0,0,0,0,0
20200528,05462P,美律亞東97售01,,,,,0.00,0.00,0,0,0,0,0,0,0,0,0,0,0,0,0
20200528,054630,聯鈞凱基98購01,,,,,0.00,0.00,0,0,0,0,0,0,0,0,0,0,0,0,0
20200528,054631,台郡凱基98購02,,,,,0.00,0.00,0,0,0,0,0,0,0,0,0,0,0,0,0
20200528,054632,緯穎凱基9A購01,,,,,0.00,0.00,0,0,0,0,0,0,0,0,0,0,0,0,0
20200528,054633,臺股指凱基9A購02,0.11,0.11,0.08,0.11,0.00,0.00,271000,13,26380,0,0,0,0,0,0,0,0,0,0
20200528,054634,FB上証中信99購01,0.12,0.12,0.11,0.12,0.00,0.00,102000,3,12140,0,0,0,0,0,0,91000,11000,80000,80000
20200528,054635,台達電中信98購01,,,,,0.00,0.00,0,0,0,0,0,0,0,0,0,0,0,0,0
20200528,054636,華通中信97購01,0.03,0.03,0.03,0.03,0.00,0.00,20000,1,600,0,0,0,0,0,0,20000,0,20000,20000
20200528,054637,智邦中信98購01,,,,,0.00,0.00,0,0,0,0,0,0,0,0,0,0,0,0,0
20200528,054638,國泰金中信99購01,0.23,0.23,0.20,0.20,-0.03,-13.04,51000,6,11550,0,0,0,0,0,0,45000,6000,39000,39000
20200528,054639,台新金中信99購01,,,,,0.00,0.00,0,0,0,0,0,0,0,0,0,0,0,0,0
20200528,05463P,創意國票96售04,,,,,0.00,0.00,0,0,0,0,0,0,0,0,0,0,0,0,0
20200528,054640,健策中信9B購01,0.65,0.66,0.50,0.50,-0.09,-15.25,320000,34,186050,0,0,0,0,0,0,237000,78000,159000,159000
20200528,054641,祥碩中信98購01,3.77,4.66,3.72,4.52,-0.16,-3.42,92000,13,368950,0,0,0,0,0,0,40000,52000,-12000,-12000
20200528,054642,訊芯中信9A購01,0.03,0.03,0.03,0.03,0.00,0.00,140000,14,4200,0,0,0,0,0,0,0,140000,-140000,-140000
20200528,054643,上証2X群益9B購01,,,,,0.00,0.00,0,0,0,0,0,0,0,0,0,0,0,0,0
20200528,054644,A50正2群益9B購01,,,,,0.00,0.00,0,0,0,0,0,0,0,0,0,0,0,0,0
20200528,054645,奇力新群益97購04,,,,,0.00,0.00,0,0,0,0,0,0,0,0,0,0,0,0,0
20200528,054646,華新科群益97購03,,,,,0.00,0.00,0,0,0,0,0,0,0,0,0,0,0,0,0
20200528,054647,禾伸堂群益99購01,,,,,0.00,0.00,0,0,0,0,0,0,0,0,0,0,0,0,0
20200528,054648,智原群益98購01,,,,,0.00,0.00,0,0,0,0,0,0,0,0,0,0,0,0,0
20200528,054649,聯茂群益97購01,1.17,1.17,1.17,1.17,0.00,0.00,12000,1,14040,0,0,0,0,0,0,0,12000,-12000,-12000
20200528,054650,南亞麥證97購01,,,,,0.00,0.00,0,0,0,0,0,0,0,0,0,0,0,0,0
20200528,054651,台化麥證97購01,,,,,0.00,0.00,0,0,0,0,0,0,0,0,0,0,0,0,0
20200528,054652,裕隆麥證97購01,0.43,0.44,0.35,0.35,+0.05,16.67,14000,3,5240,4000,0,4000,0,0,0,4000,0,4000,4000
20200528,054653,聯發科麥證97購02,,,,,0.00,0.00,0,0,0,0,0,0,0,0,0,0,0,0,0
20200528,054654,全新麥證99購01,,,,,0.00,0.00,0,0,0,0,0,0,0,0,0,0,0,0,0
20200528,054655,貿聯麥證98購01,0.28,0.28,0.28,0.28,-0.02,-6.67,60000,1,16800,60000,0,60000,0,0,0,60000,0,60000,60000
20200528,054656,深中小元大97購01,0.99,1.04,0.98,0.98,-0.10,-9.26,140000,6,140390,0,0,0,0,0,0,140000,140000,0,0
20200528,054657,道瓊銀元大97購01,,,,,0.00,0.00,0,0,0,0,0,0,0,0,0,0,0,0,0
20200528,054658,道瓊銀元大9A購01,,,,,0.00,0.00,0,0,0,0,0,0,0,0,0,0,0,0,0
20200528,054659,亞光元大97購02,,,,,0.00,0.00,0,0,0,0,0,0,0,0,0,0,0,0,0
20200528,054660,禾伸堂元大97購03,,,,,0.00,0.00,0,0,0,0,0,0,0,0,0,0,0,0,0
20200528,054661,嘉聯益元大97購03,,,,,0.00,0.00,0,0,0,0,0,0,0,0,0,0,0,0,0
20200528,054662,同欣電元大97購02,0.30,0.30,0.29,0.29,-0.03,-9.38,84000,2,24760,0,0,0,0,0,0,44000,40000,4000,4000
20200528,054663,同欣電元大97購03,,,,,0.00,0.00,0,0,0,0,0,0,0,0,0,0,0,0,0
20200528,054664,台表科元大97購04,,,,,0.00,0.00,0,0,0,0,0,0,0,0,0,0,0,0,0
20200528,054665,華通元富97購02,,,,,0.00,0.00,0,0,0,0,0,0,0,0,0,0,0,0,0
20200528,054666,強茂元富97購01,,,,,0.00,0.00,0,0,0,0,0,0,0,0,0,0,0,0,0
20200528,054667,神基元富97購01,,,,,0.00,0.00,0,0,0,0,0,0,0,0,0,0,0,0,0
20200528,054668,傳奇元富97購03,,,,,0.00,0.00,0,0,0,0,0,0,0,0,0,0,0,0,0
20200528,054669,凌華元富97購01,,,,,0.00,0.00,0,0,0,0,0,0,0,0,0,0,0,0,0
20200528,05466P,旺宏富邦97售01,0.63,0.68,0.63,0.68,+0.05,7.94,49000,4,31770,0,0,0,0,0,0,25000,24000,1000,1000
20200528,054670,康友元富97購01,,,,,0.00,0.00,0,0,0,0,0,0,0,0,0,0,0,0,0
20200528,054671,國巨國泰98購01,0.41,0.42,0.41,0.42,+0.04,10.53,20000,2,8300,0,0,0,0,0,0,20000,20000,0,0
20200528,054672,華新科國泰99購01,,,,,0.00,0.00,0,0,0,0,0,0,0,0,0,0,0,0,0
20200528,054673,京鼎國泰98購01,0.96,0.96,0.87,0.87,-0.10,-10.31,65000,2,57990,0,0,0,0,0,0,65000,0,65000,65000
20200528,054674,台光電台新97購01,0.67,0.69,0.61,0.61,-0.12,-16.44,47000,4,31130,0,0,0,0,0,0,37000,10000,27000,27000
20200528,054675,美律台新98購01,,,,,0.00,0.00,0,0,0,0,0,0,0,0,0,0,0,0,0
20200528,054676,牧德台新98購01,0.20,0.20,0.15,0.15,0.00,0.00,4000,2,650,0,0,0,0,0,0,3000,0,3000,3000
20200528,054677,智易台新98購02,,,,,0.00,0.00,0,0,0,0,0,0,0,0,0,0,0,0,0
20200528,054678,麗豐台新98購02,,,,,0.00,0.00,0,0,0,0,0,0,0,0,0,0,0,0,0
20200528,054679,台積電康和99購01,1.07,1.07,1.07,1.07,-0.07,-6.14,3000,2,3210,0,0,0,0,0,0,3000,3000,0,0
20200528,054680,華新科康和97購02,,,,,0.00,0.00,0,0,0,0,0,0,0,0,0,0,0,0,0
20200528,054681,味全永豐97購01,,,,,0.00,0.00,0,0,0,0,0,0,0,0,0,0,0,0,0
20200528,054682,東元永豐97購01,0.54,0.54,0.54,0.54,-0.12,-18.18,27000,1,14580,0,0,0,0,0,0,27000,0,27000,27000
20200528,054683,川湖永豐97購01,0.03,0.03,0.03,0.03,0.00,0.00,5000,1,150,0,0,0,0,0,0,5000,0,5000,5000
20200528,054684,裕隆永豐97購01,0.41,0.41,0.41,0.41,0.00,0.00,10000,1,4100,0,0,0,0,0,0,10000,0,10000,10000
20200528,054685,國巨永豐97購02,,,,,0.00,0.00,0,0,0,0,0,0,0,0,0,0,0,0,0
20200528,054686,順德永豐97購01,,,,,0.00,0.00,0,0,0,0,0,0,0,0,0,0,0,0,0
20200528,054687,建準永豐97購02,0.83,0.85,0.61,0.61,-0.10,-14.08,62000,5,47370,0,0,0,0,0,0,0,62000,-62000,-62000
20200528,054688,兆赫永豐97購01,0.02,0.02,0.02,0.02,-0.03,-60.0,20000,1,400,0,0,0,0,0,0,0,0,0,0
20200528,054689,華新科永豐97購01,,,,,0.00,0.00,0,0,0,0,0,0,0,0,0,0,0,0,0
20200528,05468P,鴻海元大96售14,1.28,1.28,1.28,1.28,0.00,0.00,1000,1,1280,0,0,0,0,0,0,1000,0,1000,1000
20200528,054690,新興永豐97購01,,,,,0.00,0.00,0,0,0,0,0,0,0,0,0,0,0,0,0
20200528,054691,裕民永豐97購01,,,,,0.00,0.00,0,0,0,0,0,0,0,0,0,0,0,0,0
20200528,054692,台航永豐97購01,,,,,0.00,0.00,0,0,0,0,0,0,0,0,0,0,0,0,0
20200528,054693,神基永豐97購01,0.08,0.09,0.08,0.08,+0.02,33.33,362000,5,31720,0,0,0,0,0,0,20000,342000,-322000,-322000
20200528,054694,聯鈞永豐97購01,,,,,0.00,0.00,0,0,0,0,0,0,0,0,0,0,0,0,0
20200528,054695,世芯永豐98購01,0.95,1.00,0.87,1.00,+0.03,3.09,52000,11,49470,0,0,0,0,0,0,7000,45000,-38000,-38000
20200528,054696,嘉聯益永豐97購01,,,,,0.00,0.00,0,0,0,0,0,0,0,0,0,0,0,0,0
20200528,054697,凌華永豐97購01,1.52,1.57,1.52,1.52,+0.05,3.4,40000,4,61300,0,0,0,0,0,0,0,40000,-40000,-40000
20200528,054698,同欣電永豐97購01,0.05,0.05,0.05,0.05,-0.02,-28.57,60000,1,3000,0,0,0,0,0,0,60000,0,60000,60000
20200528,054699,復盛永豐97購01,0.09,0.09,0.09,0.09,0.00,0.00,10000,1,900,0,0,0,0,0,0,10000,0,10000,10000
20200528,054700,致新永豐97購01,0.33,0.33,0.32,0.33,+0.06,22.22,28000,4,9230,0,0,0,0,0,0,0,28000,-28000,-28000
20200528,054701,宏全永豐97購01,,,,,0.00,0.00,0,0,0,0,0,0,0,0,0,0,0,0,0
20200528,054702,智邦第一97購01,,,,,0.00,0.00,0,0,0,0,0,0,0,0,0,0,0,0,0
20200528,054703,聯發科第一97購01,,,,,0.00,0.00,0,0,0,0,0,0,0,0,0,0,0,0,0
20200528,054704,玉晶光第一97購01,0.07,0.07,0.07,0.07,0.00,0.00,6000,1,420,0,0,0,0,0,0,0,0,0,0
20200528,054705,欣興亞東97購01,,,,,0.00,0.00,0,0,0,0,0,0,0,0,0,0,0,0,0
20200528,054706,TPK亞東97購01,,,,,0.00,0.00,0,0,0,0,0,0,0,0,0,0,0,0,0
20200528,054707,聯茂亞東97購01,,,,,0.00,0.00,0,0,0,0,0,0,0,0,0,0,0,0,0
20200528,054708,華通統一97購02,0.30,0.30,0.28,0.28,+0.09,47.37,533000,3,159200,0,0,0,0,0,0,0,533000,-533000,-533000
20200528,054709,宏達電統一97購01,0.20,0.20,0.20,0.20,-0.03,-13.04,334000,4,66800,0,0,0,0,0,0,10000,324000,-314000,-314000
20200528,054710,東元元富97購01,1.75,2.08,1.67,1.69,-0.08,-4.52,553000,80,978770,0,0,0,0,0,0,259000,274000,-15000,-15000
20200528,054711,禾伸堂元富97購01,,,,,0.00,0.00,0,0,0,0,0,0,0,0,0,0,0,0,0
20200528,054712,上証2X中信98購02,,,,,0.00,0.00,0,0,0,0,0,0,0,0,0,0,0,0,0
20200528,054713,國巨中信9B購01,0.35,0.36,0.29,0.30,-0.05,-14.29,3291000,261,1048320,0,0,0,0,0,0,0,1832000,-1832000,-1832000
20200528,054714,和鑫台新98購01,,,,,0.00,0.00,0,0,0,0,0,0,0,0,0,0,0,0,0
20200528,054715,中橡康和97購01,,,,,0.00,0.00,0,0,0,0,0,0,0,0,0,0,0,0,0
20200528,054716,緯穎康和97購01,,,,,0.00,0.00,0,0,0,0,0,0,0,0,0,0,0,0,0
20200528,054717,亞德客永豐97購01,1.90,2.04,1.90,2.04,+0.18,9.68,245000,16,484200,0,0,0,0,0,0,235000,10000,225000,225000
20200528,054718,可成永豐97購01,0.45,0.45,0.45,0.45,-0.04,-8.16,2000,1,900,0,0,0,0,0,0,2000,0,2000,2000
20200528,054719,亞光永豐97購01,,,,,0.00,0.00,0,0,0,0,0,0,0,0,0,0,0,0,0
20200528,054720,禾伸堂永豐97購01,0.18,0.18,0.18,0.18,0.00,0.00,50000,1,9000,0,0,0,0,0,0,50000,0,50000,50000
20200528,054721,揚明光永豐97購03,,,,,0.00,0.00,0,0,0,0,0,0,0,0,0,0,0,0,0
20200528,054722,傳奇永豐97購01,0.02,0.02,0.02,0.02,0.00,0.00,109000,1,2180,0,0,0,0,0,0,0,0,0,0
20200528,054723,鴻海日盛97購01,,,,,0.00,0.00,0,0,0,0,0,0,0,0,0,0,0,0,0
20200528,054724,鴻海日盛97購02,,,,,0.00,0.00,0,0,0,0,0,0,0,0,0,0,0,0,0
20200528,054725,國巨日盛97購01,0.04,0.04,0.03,0.03,0.00,0.00,650000,25,19700,0,0,0,0,0,0,630000,600000,30000,30000
20200528,054726,台積電日盛97購01,0.01,0.01,0.01,0.01,0.00,0.00,1963000,11,19630,0,0,0,0,0,0,1363000,0,1363000,1363000
20200528,054727,台積電日盛97購02,,,,,0.00,0.00,0,0,0,0,0,0,0,0,0,0,0,0,0
20200528,054728,聯發科日盛97購01,,,,,0.00,0.00,0,0,0,0,0,0,0,0,0,0,0,0,0
20200528,054729,聯發科日盛97購02,,,,,0.00,0.00,0,0,0,0,0,0,0,0,0,0,0,0,0
20200528,05472P,國巨統一96售02,0.11,0.11,0.11,0.11,+0.03,37.5,5000,1,550,0,0,0,0,0,0,0,5000,-5000,-5000
20200528,054730,上証2X凱基98購02,,,,,0.00,0.00,0,0,0,0,0,0,0,0,0,0,0,0,0
20200528,054731,S&P反1凱基98購01,,,,,0.00,0.00,0,0,0,0,0,0,0,0,0,0,0,0,0
20200528,054732,台化凱基98購01,,,,,0.00,0.00,0,0,0,0,0,0,0,0,0,0,0,0,0
20200528,054733,鴻海凱基98購04,,,,,0.00,0.00,0,0,0,0,0,0,0,0,0,0,0,0,0
20200528,054734,燿華凱基97購03,,,,,0.00,0.00,0,0,0,0,0,0,0,0,0,0,0,0,0
20200528,054735,漢唐凱基98購01,1.49,1.49,1.49,1.49,-0.07,-4.49,1000,1,1490,0,0,0,0,0,0,1000,0,1000,1000
20200528,054736,南亞科凱基98購01,,,,,0.00,0.00,0,0,0,0,0,0,0,0,0,0,0,0,0
20200528,054737,京元電凱基99購01,,,,,0.00,0.00,0,0,0,0,0,0,0,0,0,0,0,0,0
20200528,054738,聯發科凱基97購01,2.41,2.41,2.09,2.09,-0.25,-10.68,20000,6,44800,0,0,0,0,0,0,9000,11000,-2000,-2000
20200528,054739,義隆凱基98購02,,,,,0.00,0.00,0,0,0,0,0,0,0,0,0,0,0,0,0
20200528,05473P,聯詠統一97售02,,,,,0.00,0.00,0,0,0,0,0,0,0,0,0,0,0,0,0
20200528,054740,強茂凱基99購01,0.21,0.21,0.21,0.21,0.00,0.00,3000,1,630,0,0,0,0,0,0,3000,0,3000,3000
20200528,054741,亞光凱基99購01,,,,,0.00,0.00,0,0,0,0,0,0,0,0,0,0,0,0,0
20200528,054742,京鼎凱基99購01,1.30,1.30,1.23,1.23,-0.06,-4.65,163000,9,209980,0,0,0,0,0,0,3000,163000,-160000,-160000
20200528,054743,聯鈞凱基99購01,,,,,0.00,0.00,0,0,0,0,0,0,0,0,0,0,0,0,0
20200528,054744,晶相光凱基99購01,,,,,0.00,0.00,0,0,0,0,0,0,0,0,0,0,0,0,0
20200528,054745,智易凱基97購01,,,,,0.00,0.00,0,0,0,0,0,0,0,0,0,0,0,0,0
20200528,054746,貿聯凱基98購02,,,,,0.00,0.00,0,0,0,0,0,0,0,0,0,0,0,0,0
20200528,054747,麗豐凱基98購01,,,,,0.00,0.00,0,0,0,0,0,0,0,0,0,0,0,0,0
20200528,054748,正文凱基98購01,,,,,0.00,0.00,0,0,0,0,0,0,0,0,0,0,0,0,0
20200528,054749,聯茂凱基98購01,2.72,2.72,2.72,2.72,0.00,0.00,1000,1,2720,0,0,0,0,0,0,1000,0,1000,1000
20200528,054750,聯茂凱基98購02,,,,,0.00,0.00,0,0,0,0,0,0,0,0,0,0,0,0,0
20200528,054751,GIS凱基98購01,2.54,2.54,1.94,1.94,-0.30,-13.39,47000,7,100960,0,0,0,0,0,0,11000,36000,-25000,-25000
20200528,054752,易華電凱基97購02,,,,,0.00,0.00,0,0,0,0,0,0,0,0,0,0,0,0,0
20200528,054753,復盛凱基98購01,0.39,0.42,0.39,0.42,+0.02,5.0,35000,2,14550,0,0,0,0,0,0,5000,30000,-25000,-25000
20200528,054754,昇陽半凱基98購02,,,,,0.00,0.00,0,0,0,0,0,0,0,0,0,0,0,0,0
20200528,054755,世紀鋼凱基98購01,2.12,2.67,2.10,2.67,+0.51,23.61,346000,61,804860,0,0,0,0,0,0,183000,225000,-42000,-42000
20200528,054756,世紀鋼凱基99購01,1.49,1.88,1.49,1.88,+0.41,27.89,261000,46,437520,0,0,0,0,0,0,59000,245000,-186000,-186000
20200528,054757,南亞國票98購01,,,,,0.00,0.00,0,0,0,0,0,0,0,0,0,0,0,0,0
20200528,054758,南亞國票9A購01,,,,,0.00,0.00,0,0,0,0,0,0,0,0,0,0,0,0,0
20200528,054759,台化國票98購01,0.16,0.16,0.16,0.16,-0.03,-15.79,50000,1,8000,0,0,0,0,0,0,50000,0,50000,50000
20200528,054760,台化國票9A購01,,,,,0.00,0.00,0,0,0,0,0,0,0,0,0,0,0,0,0
20200528,054761,台光電國票98購02,1.90,1.90,1.90,1.90,0.00,0.00,70000,1,133000,0,0,0,0,0,0,70000,70000,0,0
20200528,054762,奇力新國票99購01,,,,,0.00,0.00,0,0,0,0,0,0,0,0,0,0,0,0,0
20200528,054763,宏達電國票99購01,,,,,0.00,0.00,0,0,0,0,0,0,0,0,0,0,0,0,0
20200528,054764,亞光國票98購01,,,,,0.00,0.00,0,0,0,0,0,0,0,0,0,0,0,0,0
20200528,054765,亞光國票98購02,,,,,0.00,0.00,0,0,0,0,0,0,0,0,0,0,0,0,0
20200528,054766,智原國票98購01,,,,,0.00,0.00,0,0,0,0,0,0,0,0,0,0,0,0,0
20200528,054767,日電貿國票98購01,1.46,1.46,1.44,1.44,-0.04,-2.7,73000,3,106040,0,0,0,0,0,0,73000,0,73000,73000
20200528,054768,泰碩國票99購02,1.47,1.47,1.39,1.39,-0.08,-5.44,34000,2,48460,0,0,0,0,0,0,19000,34000,-15000,-15000
20200528,054769,創意國票98購01,,,,,0.00,0.00,0,0,0,0,0,0,0,0,0,0,0,0,0
20200528,054770,健策國票98購01,,,,,0.00,0.00,0,0,0,0,0,0,0,0,0,0,0,0,0
20200528,054771,茂林國票98購02,1.54,1.56,1.45,1.51,-0.06,-3.82,631000,10,965930,0,0,0,0,0,0,629000,2000,627000,627000
20200528,054772,康控國票98購02,,,,,0.00,0.00,0,0,0,0,0,0,0,0,0,0,0,0,0
20200528,054773,台郡國票98購01,,,,,0.00,0.00,0,0,0,0,0,0,0,0,0,0,0,0,0
20200528,054774,同欣電國票98購01,,,,,0.00,0.00,0,0,0,0,0,0,0,0,0,0,0,0,0
20200528,054775,復盛國票98購01,,,,,0.00,0.00,0,0,0,0,0,0,0,0,0,0,0,0,0
20200528,054776,矽創國票98購01,1.30,1.30,1.20,1.20,+0.10,9.09,48000,2,58600,0,0,0,0,0,0,48000,0,48000,48000
20200528,054777,昇陽半國票98購01,,,,,0.00,0.00,0,0,0,0,0,0,0,0,0,0,0,0,0
20200528,054778,世紀鋼國票99購01,4.58,5.75,4.49,5.55,+0.93,20.13,143000,16,741580,0,0,0,0,0,0,128000,15000,113000,113000
20200528,054779,台塑群益98購01,,,,,0.00,0.00,0,0,0,0,0,0,0,0,0,0,0,0,0
20200528,054780,中石化群益99購01,,,,,0.00,0.00,0,0,0,0,0,0,0,0,0,0,0,0,0
20200528,054781,台化群益99購01,,,,,0.00,0.00,0,0,0,0,0,0,0,0,0,0,0,0,0
20200528,054782,國巨群益97購01,,,,,0.00,0.00,0,0,0,0,0,0,0,0,0,0,0,0,0
20200528,054783,國巨群益98購04,,,,,0.00,0.00,0,0,0,0,0,0,0,0,0,0,0,0,0
20200528,054784,順德群益9A購01,0.22,0.22,0.22,0.22,0.00,0.00,10000,1,2200,0,0,0,0,0,0,0,10000,-10000,-10000
20200528,054785,建準群益98購01,2.68,3.33,2.49,2.49,-0.12,-4.6,69000,7,202630,0,0,0,0,0,0,15000,49000,-34000,-34000
20200528,054786,全新群益99購02,,,,,0.00,0.00,0,0,0,0,0,0,0,0,0,0,0,0,0
20200528,054787,華新科群益97購04,,,,,0.00,0.00,0,0,0,0,0,0,0,0,0,0,0,0,0
20200528,054788,華新科群益98購02,,,,,0.00,0.00,0,0,0,0,0,0,0,0,0,0,0,0,0
20200528,054789,高鐵群益98購01,0.39,0.58,0.39,0.43,-0.12,-21.82,412000,29,208850,0,0,0,0,0,0,279000,132000,147000,147000
20200528,05478P,智伸科國票96售02,0.82,0.82,0.80,0.80,0.00,0.00,20000,2,16200,0,0,0,0,0,0,0,20000,-20000,-20000
20200528,054790,禾伸堂群益98購01,,,,,0.00,0.00,0,0,0,0,0,0,0,0,0,0,0,0,0
20200528,054791,泰碩群益99購02,0.79,0.81,0.71,0.71,-0.12,-14.46,178000,14,133480,0,0,0,0,0,0,83000,95000,-12000,-12000
20200528,054792,揚明光群益97購01,0.46,0.46,0.46,0.46,-0.04,-8.0,200000,1,92000,0,0,0,0,0,0,200000,0,200000,200000
20200528,054793,牧德群益9A購01,,,,,0.00,0.00,0,0,0,0,0,0,0,0,0,0,0,0,0
20200528,054794,貿聯群益98購01,,,,,0.00,0.00,0,0,0,0,0,0,0,0,0,0,0,0,0
20200528,054795,合勤控群益98購01,0.56,0.60,0.52,0.52,-0.12,-18.75,640000,20,366540,0,0,0,0,0,0,298000,342000,-44000,-44000
20200528,054796,康普群益98購01,,,,,0.00,0.00,0,0,0,0,0,0,0,0,0,0,0,0,0
20200528,054797,臻鼎群益97購01,,,,,0.00,0.00,0,0,0,0,0,0,0,0,0,0,0,0,0
20200528,054798,超眾群益97購01,,,,,0.00,0.00,0,0,0,0,0,0,0,0,0,0,0,0,0
20200528,054799,超眾群益98購01,0.79,0.79,0.79,0.79,-0.07,-8.14,79000,1,62410,0,0,0,0,0,0,0,79000,-79000,-79000
20200528,05479P,華新科台新96售01,,,,,0.00,0.00,0,0,0,0,0,0,0,0,0,0,0,0,0
20200528,054800,訊芯群益99購01,,,,,0.00,0.00,0,0,0,0,0,0,0,0,0,0,0,0,0
20200528,054801,康友群益97購02,,,,,0.00,0.00,0,0,0,0,0,0,0,0,0,0,0,0,0
20200528,054802,高股息元大97購01,,,,,0.00,0.00,0,0,0,0,0,0,0,0,0,0,0,0,0
20200528,054803,味全元大9A購01,0.82,0.86,0.80,0.84,+0.04,5.0,496000,8,412120,0,0,0,0,0,0,68000,428000,-360000,-360000
20200528,054804,南亞元大9A購01,,,,,0.00,0.00,0,0,0,0,0,0,0,0,0,0,0,0,0
20200528,054805,台苯元大9A購01,0.44,0.44,0.44,0.44,0.00,0.00,100000,2,44000,0,0,0,0,0,0,0,100000,-100000,-100000
20200528,054806,台化元大9A購01,0.33,0.33,0.33,0.33,0.00,0.00,1000,1,330,0,0,0,0,0,0,1000,0,1000,1000
20200528,054807,台化元大9A購02,1.67,1.67,1.67,1.67,-0.10,-5.65,50000,1,83500,0,0,0,0,0,0,50000,0,50000,50000
20200528,054808,東元元大9A購01,1.67,1.80,1.62,1.65,+0.02,1.23,792000,49,1342990,0,0,0,0,0,0,763000,0,763000,763000
20200528,054809,大成鋼元大97購01,,,,,0.00,0.00,0,0,0,0,0,0,0,0,0,0,0,0,0
20200528,05480P,滬深2X凱基96售05,,,,,0.00,0.00,0,0,0,0,0,0,0,0,0,0,0,0,0
20200528,054810,中橡元大9A購01,,,,,0.00,0.00,0,0,0,0,0,0,0,0,0,0,0,0,0
20200528,054811,裕隆元大9A購01,1.21,1.21,1.17,1.21,+0.17,16.35,31000,5,37110,0,0,0,0,0,0,1000,25000,-24000,-24000
20200528,054812,鴻海元大97購08,,,,,0.00,0.00,0,0,0,0,0,0,0,0,0,0,0,0,0
20200528,054813,鴻海元大97購09,,,,,0.00,0.00,0,0,0,0,0,0,0,0,0,0,0,0,0
20200528,054814,台積電元大97購13,,,,,0.00,0.00,0,0,0,0,0,0,0,0,0,0,0,0,0
20200528,054815,台積電元大97購14,,,,,0.00,0.00,0,0,0,0,0,0,0,0,0,0,0,0,0
20200528,054816,聯發科元大97購12,,,,,0.00,0.00,0,0,0,0,0,0,0,0,0,0,0,0,0
20200528,054817,聯發科元大97購13,,,,,0.00,0.00,0,0,0,0,0,0,0,0,0,0,0,0,0
20200528,054818,奇力新元大97購05,,,,,0.00,0.00,0,0,0,0,0,0,0,0,0,0,0,0,0
20200528,054819,裕民元大9A購01,0.76,0.78,0.73,0.74,-0.02,-2.63,689000,13,523100,0,0,0,0,0,0,220000,469000,-249000,-249000
20200528,054820,新日興元大97購01,,,,,0.00,0.00,0,0,0,0,0,0,0,0,0,0,0,0,0
20200528,054821,貿聯元大9A購01,0.28,0.28,0.28,0.28,0.00,0.00,2000,1,560,0,0,0,0,0,0,0,0,0,0
20200528,054822,祥碩元大97購01,,,,,0.00,0.00,0,0,0,0,0,0,0,0,0,0,0,0,0
20200528,054823,祥碩元大97購02,,,,,0.00,0.00,0,0,0,0,0,0,0,0,0,0,0,0,0
20200528,054824,同欣電元大97購04,,,,,0.00,0.00,0,0,0,0,0,0,0,0,0,0,0,0,0
20200528,054825,康友元大97購01,,,,,0.00,0.00,0,0,0,0,0,0,0,0,0,0,0,0,0
20200528,054826,復盛元大9A購01,2.46,2.60,2.42,2.42,-0.09,-3.59,344000,21,868690,0,0,0,0,0,0,47000,297000,-250000,-250000
20200528,054827,宏全元大9A購01,,,,,0.00,0.00,0,0,0,0,0,0,0,0,0,0,0,0,0
20200528,054828,正崴國泰99購01,0.54,0.54,0.54,0.54,-0.03,-5.26,1000,1,540,0,0,0,0,0,0,0,1000,-1000,-1000
20200528,054829,亞光國泰99購01,0.03,0.03,0.03,0.03,0.00,0.00,5000,1,150,0,0,0,0,0,0,5000,0,5000,5000
20200528,054830,世芯國泰99購01,,,,,0.00,0.00,0,0,0,0,0,0,0,0,0,0,0,0,0
20200528,054831,緯穎國泰98購01,,,,,0.00,0.00,0,0,0,0,0,0,0,0,0,0,0,0,0
20200528,054832,興勤中信97購01,,,,,0.00,0.00,0,0,0,0,0,0,0,0,0,0,0,0,0
20200528,054833,京鼎中信97購01,,,,,0.00,0.00,0,0,0,0,0,0,0,0,0,0,0,0,0
20200528,054834,帆宣中信97購01,,,,,0.00,0.00,0,0,0,0,0,0,0,0,0,0,0,0,0
20200528,054835,致新中信97購01,0.38,0.53,0.38,0.50,+0.11,28.21,418000,59,203200,0,0,0,0,0,0,35000,383000,-348000,-348000
20200528,054836,勤誠中信97購01,,,,,0.00,0.00,0,0,0,0,0,0,0,0,0,0,0,0,0
20200528,054837,欣興第一97購01,,,,,0.00,0.00,0,0,0,0,0,0,0,0,0,0,0,0,0
20200528,054838,京鼎第一97購01,,,,,0.00,0.00,0,0,0,0,0,0,0,0,0,0,0,0,0
20200528,054839,中石化亞東98購01,,,,,0.00,0.00,0,0,0,0,0,0,0,0,0,0,0,0,0
20200528,054840,T50反1兆豐98購01,,,,,0.00,0.00,0,0,0,0,0,0,0,0,0,0,0,0,0
20200528,054841,亞德客兆豐97購01,2.26,2.26,2.26,2.26,0.00,0.00,210000,15,474600,0,0,0,0,0,0,210000,210000,0,0
20200528,054842,台達電兆豐98購01,,,,,0.00,0.00,0,0,0,0,0,0,0,0,0,0,0,0,0
20200528,054843,中環兆豐97購01,,,,,0.00,0.00,0,0,0,0,0,0,0,0,0,0,0,0,0
20200528,054844,華邦電兆豐98購01,0.46,0.50,0.35,0.35,+0.03,9.38,97000,15,47070,0,0,0,0,0,0,60000,37000,23000,23000
20200528,054845,智邦兆豐98購01,,,,,0.00,0.00,0,0,0,0,0,0,0,0,0,0,0,0,0
20200528,054846,瑞昱兆豐97購01,2.89,2.89,2.89,2.89,+0.10,3.58,9000,1,26010,0,0,0,0,0,0,0,9000,-9000,-9000
20200528,054847,創意兆豐97購01,,,,,0.00,0.00,0,0,0,0,0,0,0,0,0,0,0,0,0
20200528,054848,群創兆豐98購01,0.01,0.01,0.01,0.01,0.00,0.00,10000,1,100,0,0,0,0,0,0,0,10000,-10000,-10000
20200528,054849,日月光兆豐97購01,,,,,0.00,0.00,0,0,0,0,0,0,0,0,0,0,0,0,0
20200528,054850,上海銀兆豐97購01,0.01,0.01,0.01,0.01,0.00,0.00,10000,1,100,0,0,0,0,0,0,0,10000,-10000,-10000
20200528,054851,樺漢兆豐97購01,,,,,0.00,0.00,0,0,0,0,0,0,0,0,0,0,0,0,0
20200528,054852,奇鋐國票98購01,,,,,0.00,0.00,0,0,0,0,0,0,0,0,0,0,0,0,0
20200528,054853,TPK國票98購02,,,,,0.00,0.00,0,0,0,0,0,0,0,0,0,0,0,0,0
20200528,054854,台積電麥證97購01,,,,,0.00,0.00,0,0,0,0,0,0,0,0,0,0,0,0,0
20200528,054855,得力群益98購01,0.53,0.53,0.50,0.50,-0.08,-13.79,158000,3,81940,0,0,0,0,0,0,98000,60000,38000,38000
20200528,054856,得力群益99購01,0.57,0.57,0.53,0.53,-0.07,-11.67,128000,2,71760,0,0,0,0,0,0,98000,30000,68000,68000
20200528,054857,信錦群益97購01,,,,,0.00,0.00,0,0,0,0,0,0,0,0,0,0,0,0,0
20200528,054858,台肥群益97購01,0.19,0.19,0.19,0.19,-0.03,-13.64,125000,1,23750,0,0,0,0,0,0,125000,0,125000,125000
20200528,054859,鴻海群益97購02,,,,,0.00,0.00,0,0,0,0,0,0,0,0,0,0,0,0,0
20200528,054860,台積電群益98購01,0.01,0.03,0.01,0.03,0.00,0.00,634000,8,6360,0,0,0,0,0,0,0,633000,-633000,-633000
20200528,054861,智邦群益97購01,,,,,0.00,0.00,0,0,0,0,0,0,0,0,0,0,0,0,0
20200528,054862,群光群益97購01,0.35,0.35,0.35,0.35,+0.02,6.06,10000,1,3500,0,0,0,0,0,0,10000,0,10000,10000
20200528,054863,億光群益97購01,,,,,0.00,0.00,0,0,0,0,0,0,0,0,0,0,0,0,0
20200528,054864,聯發科群益97購02,,,,,0.00,0.00,0,0,0,0,0,0,0,0,0,0,0,0,0
20200528,054865,可成群益97購01,,,,,0.00,0.00,0,0,0,0,0,0,0,0,0,0,0,0,0
20200528,054866,宏盛群益98購01,,,,,0.00,0.00,0,0,0,0,0,0,0,0,0,0,0,0,0
20200528,054867,華航群益99購01,0.29,0.29,0.29,0.29,0.00,0.00,2000,1,580,0,0,0,0,0,0,0,0,0,0
20200528,054868,國泰金群益9A購01,,,,,0.00,0.00,0,0,0,0,0,0,0,0,0,0,0,0,0
20200528,054869,新光金群益97購01,,,,,0.00,0.00,0,0,0,0,0,0,0,0,0,0,0,0,0
20200528,054870,新日興群益98購01,,,,,0.00,0.00,0,0,0,0,0,0,0,0,0,0,0,0,0
20200528,054871,明泰群益98購01,1.49,1.49,1.49,1.49,0.00,0.00,2000,1,2980,0,0,0,0,0,0,2000,0,2000,2000
20200528,054872,瀚宇博群益98購01,1.10,1.10,1.09,1.09,+0.11,11.22,124000,2,135540,0,0,0,0,0,0,86000,38000,48000,48000
20200528,054873,帆宣群益99購01,0.87,0.87,0.80,0.80,+0.06,8.11,141000,7,116550,0,0,0,0,0,0,123000,18000,105000,105000
20200528,054874,帆宣群益99購02,0.98,0.98,0.90,0.90,+0.04,4.65,76000,4,72500,0,0,0,0,0,0,46000,30000,16000,16000
20200528,054875,群電群益97購01,,,,,0.00,0.00,0,0,0,0,0,0,0,0,0,0,0,0,0
20200528,054876,群電群益97購02,0.75,0.75,0.75,0.75,0.00,0.00,145000,1,108750,0,0,0,0,0,0,0,145000,-145000,-145000
20200528,054877,百和群益98購01,,,,,0.00,0.00,0,0,0,0,0,0,0,0,0,0,0,0,0
20200528,054878,和大統一97購02,,,,,0.00,0.00,0,0,0,0,0,0,0,0,0,0,0,0,0
20200528,054879,大成鋼統一97購01,,,,,0.00,0.00,0,0,0,0,0,0,0,0,0,0,0,0,0
20200528,054880,華泰統一97購01,0.31,0.31,0.31,0.31,0.00,0.00,48000,1,14880,0,0,0,0,0,0,0,48000,-48000,-48000
20200528,054881,光罩統一97購01,,,,,0.00,0.00,0,0,0,0,0,0,0,0,0,0,0,0,0
20200528,054882,台光電統一97購02,,,,,0.00,0.00,0,0,0,0,0,0,0,0,0,0,0,0,0
20200528,054883,億光統一97購01,0.97,0.97,0.89,0.90,-0.11,-10.89,100000,5,91600,0,0,0,0,0,0,0,100000,-100000,-100000
20200528,054884,友達統一99購01,,,,,0.00,0.00,0,0,0,0,0,0,0,0,0,0,0,0,0
20200528,054885,建準統一98購01,,,,,0.00,0.00,0,0,0,0,0,0,0,0,0,0,0,0,0
20200528,054886,大毅統一97購01,3.68,3.70,3.66,3.66,-0.06,-1.61,66000,6,242850,0,0,0,0,0,0,25000,41000,-16000,-16000
20200528,054887,大毅統一98購01,,,,,0.00,0.00,0,0,0,0,0,0,0,0,0,0,0,0,0
20200528,054888,泰碩統一97購01,,,,,0.00,0.00,0,0,0,0,0,0,0,0,0,0,0,0,0
20200528,054889,京鼎統一99購01,,,,,0.00,0.00,0,0,0,0,0,0,0,0,0,0,0,0,0
20200528,054890,聯鈞統一99購01,,,,,0.00,0.00,0,0,0,0,0,0,0,0,0,0,0,0,0
20200528,054891,聯鈞統一99購02,0.16,0.16,0.16,0.16,0.00,0.00,1000,1,160,0,0,0,0,0,0,1000,0,1000,1000
20200528,054892,彩晶統一99購01,,,,,0.00,0.00,0,0,0,0,0,0,0,0,0,0,0,0,0
20200528,054893,帆宣統一99購01,0.31,0.32,0.25,0.27,+0.03,12.5,128000,6,35860,0,0,0,0,0,0,65000,53000,12000,12000
20200528,054894,GIS統一97購01,0.52,0.52,0.30,0.30,-0.10,-25.0,1196000,32,475140,0,0,0,0,0,0,680000,506000,174000,174000
20200528,054895,南電統一97購01,2.25,2.25,2.17,2.17,-0.26,-10.7,10000,2,22100,0,0,0,0,0,0,5000,5000,0,0
20200528,054896,聯茂日盛97購01,,,,,0.00,0.00,0,0,0,0,0,0,0,0,0,0,0,0,0
20200528,054897,信錦康和97購01,,,,,0.00,0.00,0,0,0,0,0,0,0,0,0,0,0,0,0
20200528,054898,台肥康和97購01,,,,,0.00,0.00,0,0,0,0,0,0,0,0,0,0,0,0,0
20200528,054899,南港康和97購01,,,,,0.00,0.00,0,0,0,0,0,0,0,0,0,0,0,0,0
20200528,054900,金寶康和97購01,,,,,0.00,0.00,0,0,0,0,0,0,0,0,0,0,0,0,0
20200528,054901,群光康和97購01,,,,,0.00,0.00,0,0,0,0,0,0,0,0,0,0,0,0,0
20200528,054902,億光康和97購01,,,,,0.00,0.00,0,0,0,0,0,0,0,0,0,0,0,0,0
20200528,054903,億光康和97購02,,,,,0.00,0.00,0,0,0,0,0,0,0,0,0,0,0,0,0
20200528,054904,興勤康和97購01,,,,,0.00,0.00,0,0,0,0,0,0,0,0,0,0,0,0,0
20200528,054905,國揚康和97購01,,,,,0.00,0.00,0,0,0,0,0,0,0,0,0,0,0,0,0
20200528,054906,神達康和97購01,,,,,0.00,0.00,0,0,0,0,0,0,0,0,0,0,0,0,0
20200528,054907,帆宣康和97購01,,,,,0.00,0.00,0,0,0,0,0,0,0,0,0,0,0,0,0
20200528,054908,群電康和97購01,1.42,1.48,1.42,1.48,+0.08,5.71,67000,3,95800,0,0,0,0,0,0,54000,13000,41000,41000
20200528,054909,福懋科康和97購01,,,,,0.00,0.00,0,0,0,0,0,0,0,0,0,0,0,0,0
20200528,054910,信錦凱基97購01,,,,,0.00,0.00,0,0,0,0,0,0,0,0,0,0,0,0,0
20200528,054911,敬鵬凱基97購01,,,,,0.00,0.00,0,0,0,0,0,0,0,0,0,0,0,0,0
20200528,054912,群光凱基97購01,0.49,0.56,0.49,0.51,+0.01,2.0,165000,13,85380,0,0,0,0,0,0,135000,30000,105000,105000
20200528,054913,億光凱基97購01,,,,,0.00,0.00,0,0,0,0,0,0,0,0,0,0,0,0,0
20200528,054914,億光凱基98購01,,,,,0.00,0.00,0,0,0,0,0,0,0,0,0,0,0,0,0
20200528,054915,興勤凱基97購01,,,,,0.00,0.00,0,0,0,0,0,0,0,0,0,0,0,0,0
20200528,054916,聯發科凱基98購04,1.97,1.97,1.72,1.77,-0.16,-8.29,151000,13,273150,0,0,0,0,0,0,61000,90000,-29000,-29000
20200528,054917,聯發科凱基98購05,,,,,0.00,0.00,0,0,0,0,0,0,0,0,0,0,0,0,0
20200528,054918,華新科凱基98購02,,,,,0.00,0.00,0,0,0,0,0,0,0,0,0,0,0,0,0
20200528,054919,興富發凱基97購01,0.69,0.69,0.69,0.69,0.00,0.00,50000,1,34500,0,0,0,0,0,0,0,50000,-50000,-50000
20200528,054920,智原凱基98購01,,,,,0.00,0.00,0,0,0,0,0,0,0,0,0,0,0,0,0
20200528,054921,文曄凱基97購01,,,,,0.00,0.00,0,0,0,0,0,0,0,0,0,0,0,0,0
20200528,054922,文曄凱基98購01,,,,,0.00,0.00,0,0,0,0,0,0,0,0,0,0,0,0,0
20200528,054923,晶技凱基98購01,4.56,4.77,4.46,4.46,-0.42,-8.61,37000,16,169320,0,0,0,0,0,0,34000,3000,31000,31000
20200528,054924,景碩凱基98購01,,,,,0.00,0.00,0,0,0,0,0,0,0,0,0,0,0,0,0
20200528,054925,神達凱基97購01,1.55,1.59,1.50,1.50,-0.05,-3.23,162000,8,252090,0,0,0,0,0,0,93000,93000,0,0
20200528,054926,神達凱基98購01,,,,,0.00,0.00,0,0,0,0,0,0,0,0,0,0,0,0,0
20200528,054927,帆宣凱基97購01,,,,,0.00,0.00,0,0,0,0,0,0,0,0,0,0,0,0,0
20200528,054928,帆宣凱基98購01,1.05,1.05,0.94,0.94,+0.05,5.62,240000,8,233750,0,0,0,0,0,0,215000,25000,190000,190000
20200528,054929,群電凱基97購01,1.14,1.22,0.91,0.97,-0.07,-6.73,103000,23,116800,0,0,0,0,0,0,54000,39000,15000,15000
20200528,054930,群電凱基98購01,2.56,2.63,2.32,2.32,-0.13,-5.31,105000,15,260550,0,0,0,0,0,0,65000,50000,15000,15000
20200528,054931,緯穎凱基98購01,,,,,0.00,0.00,0,0,0,0,0,0,0,0,0,0,0,0,0
20200528,054932,台肥元大97購01,0.72,0.72,0.70,0.70,0.00,0.00,171000,5,122060,0,0,0,0,0,0,0,171000,-171000,-171000
20200528,054933,南港元大97購01,0.58,0.58,0.17,0.52,+0.29,126.09,13000,5,3070,0,0,0,0,0,0,0,10000,-10000,-10000
20200528,054934,金寶元大97購01,,,,,0.00,0.00,0,0,0,0,0,0,0,0,0,0,0,0,0
20200528,054935,華通元大98購03,1.22,1.38,1.22,1.38,+0.22,18.97,94000,4,125280,0,0,0,0,0,0,10000,84000,-74000,-74000
20200528,054936,鴻海元大97購10,0.15,0.15,0.15,0.15,0.00,0.00,15000,1,2250,0,0,0,0,0,0,15000,0,15000,15000
20200528,054937,國巨元大97購03,,,,,0.00,0.00,0,0,0,0,0,0,0,0,0,0,0,0,0
20200528,054938,國巨元大97購04,,,,,0.00,0.00,0,0,0,0,0,0,0,0,0,0,0,0,0
20200528,054939,台積電元大97購15,,,,,0.00,0.00,0,0,0,0,0,0,0,0,0,0,0,0,0
20200528,05493P,華新科富邦99售02,0.27,0.27,0.27,0.27,0.00,0.00,1000,1,270,0,0,0,0,0,0,1000,0,1000,1000
20200528,054940,台積電元大97購16,,,,,0.00,0.00,0,0,0,0,0,0,0,0,0,0,0,0,0
20200528,054941,凱美元大97購01,0.35,0.39,0.35,0.39,0.00,0.00,51000,2,19850,0,0,0,0,0,0,1000,50000,-49000,-49000
20200528,054942,凱美元大97購02,,,,,0.00,0.00,0,0,0,0,0,0,0,0,0,0,0,0,0
20200528,054943,群光元大97購01,1.09,1.13,1.01,1.03,-0.02,-1.9,635000,43,668200,0,0,0,0,0,0,410000,225000,185000,185000
20200528,054944,精元元大97購01,,,,,0.00,0.00,0,0,0,0,0,0,0,0,0,0,0,0,0
20200528,054945,正崴元大97購01,,,,,0.00,0.00,0,0,0,0,0,0,0,0,0,0,0,0,0
20200528,054946,億光元大97購01,,,,,0.00,0.00,0,0,0,0,0,0,0,0,0,0,0,0,0
20200528,054947,興勤元大97購01,0.62,0.62,0.56,0.58,-0.07,-10.77,246000,7,145740,0,0,0,0,0,0,146000,100000,46000,46000
20200528,054948,聯發科元大97購14,,,,,0.00,0.00,0,0,0,0,0,0,0,0,0,0,0,0,0
20200528,054949,奇力新元大98購01,,,,,0.00,0.00,0,0,0,0,0,0,0,0,0,0,0,0,0
20200528,054950,奇力新元大98購02,,,,,0.00,0.00,0,0,0,0,0,0,0,0,0,0,0,0,0
20200528,054951,大毅元大97購01,4.10,4.10,4.10,4.10,-0.07,-1.68,27000,1,110700,0,0,0,0,0,0,27000,0,27000,27000
20200528,054952,大毅元大97購02,,,,,0.00,0.00,0,0,0,0,0,0,0,0,0,0,0,0,0
20200528,054953,華新科元大97購05,,,,,0.00,0.00,0,0,0,0,0,0,0,0,0,0,0,0,0
20200528,054954,華新科元大97購06,,,,,0.00,0.00,0,0,0,0,0,0,0,0,0,0,0,0,0
20200528,054955,宏達電元大98購01,,,,,0.00,0.00,0,0,0,0,0,0,0,0,0,0,0,0,0
20200528,054956,宏盛元大97購01,,,,,0.00,0.00,0,0,0,0,0,0,0,0,0,0,0,0,0
20200528,054957,興富發元大97購01,1.59,1.63,1.50,1.50,0.00,0.00,171000,6,262740,0,0,0,0,0,0,107000,64000,43000,43000
20200528,054958,亞光元大97購03,,,,,0.00,0.00,0,0,0,0,0,0,0,0,0,0,0,0,0
20200528,054959,禾伸堂元大98購01,,,,,0.00,0.00,0,0,0,0,0,0,0,0,0,0,0,0,0
20200528,054960,新日興元大97購02,,,,,0.00,0.00,0,0,0,0,0,0,0,0,0,0,0,0,0
20200528,054961,玉晶光元大99購01,,,,,0.00,0.00,0,0,0,0,0,0,0,0,0,0,0,0,0
20200528,054962,玉晶光元大99購02,,,,,0.00,0.00,0,0,0,0,0,0,0,0,0,0,0,0,0
20200528,054963,牧德元大97購02,,,,,0.00,0.00,0,0,0,0,0,0,0,0,0,0,0,0,0
20200528,054964,智易元大99購01,,,,,0.00,0.00,0,0,0,0,0,0,0,0,0,0,0,0,0
20200528,054965,健策元大98購04,0.81,0.81,0.81,0.81,0.00,0.00,5000,1,4050,0,0,0,0,0,0,0,0,0,0
20200528,054966,貿聯元大98購02,,,,,0.00,0.00,0,0,0,0,0,0,0,0,0,0,0,0,0
20200528,054967,神達元大97購01,2.30,2.30,2.30,2.30,+0.02,0.88,1000,1,2300,0,0,0,0,0,0,1000,0,1000,1000
20200528,054968,佐登元大97購01,,,,,0.00,0.00,0,0,0,0,0,0,0,0,0,0,0,0,0
20200528,054969,亞翔元大97購01,,,,,0.00,0.00,0,0,0,0,0,0,0,0,0,0,0,0,0
20200528,054970,帆宣元大97購01,0.79,0.79,0.67,0.67,+0.05,8.06,570000,11,421020,0,0,0,0,0,0,339000,426000,-87000,-87000
20200528,054971,帆宣元大97購02,0.71,0.71,0.58,0.58,+0.04,7.41,75000,3,45150,0,0,0,0,0,0,75000,0,75000,75000
20200528,054972,聯茂元大97購02,,,,,0.00,0.00,0,0,0,0,0,0,0,0,0,0,0,0,0
20200528,054973,台郡元大98購02,,,,,0.00,0.00,0,0,0,0,0,0,0,0,0,0,0,0,0
20200528,054974,台表科元大98購02,2.38,2.38,2.06,2.06,-0.32,-13.45,16000,2,34880,0,0,0,0,0,0,10000,6000,4000,4000
20200528,054975,福懋科元大97購01,0.70,0.70,0.65,0.65,-0.06,-8.45,80000,5,53710,0,0,0,0,0,0,20000,60000,-40000,-40000
20200528,054976,上証2X元富9A購01,,,,,0.00,0.00,0,0,0,0,0,0,0,0,0,0,0,0,0
20200528,054977,SP黃豆元富9B購01,,,,,0.00,0.00,0,0,0,0,0,0,0,0,0,0,0,0,0
20200528,054978,堤維西元富97購01,,,,,0.00,0.00,0,0,0,0,0,0,0,0,0,0,0,0,0
20200528,054979,南港元富97購01,,,,,0.00,0.00,0,0,0,0,0,0,0,0,0,0,0,0,0
20200528,05497P,聯詠統一96售01,,,,,0.00,0.00,0,0,0,0,0,0,0,0,0,0,0,0,0
20200528,054980,國巨元富97購01,0.05,0.05,0.05,0.05,-0.01,-16.67,141000,2,7050,0,0,0,0,0,0,141000,0,141000,141000
20200528,054981,國巨元富97購02,,,,,0.00,0.00,0,0,0,0,0,0,0,0,0,0,0,0,0
20200528,054982,國巨元富97購03,0.02,0.02,0.01,0.01,0.00,0.00,323000,2,3360,0,0,0,0,0,0,310000,0,310000,310000
20200528,054983,國巨元富97購04,0.01,0.01,0.01,0.01,-0.02,-66.67,754000,6,7540,0,0,0,0,0,0,385000,0,385000,385000
20200528,054984,華泰元富97購01,,,,,0.00,0.00,0,0,0,0,0,0,0,0,0,0,0,0,0
20200528,054985,光罩元富97購01,,,,,0.00,0.00,0,0,0,0,0,0,0,0,0,0,0,0,0
20200528,054986,藍天元富97購01,,,,,0.00,0.00,0,0,0,0,0,0,0,0,0,0,0,0,0
20200528,054987,凱美元富97購01,,,,,0.00,0.00,0,0,0,0,0,0,0,0,0,0,0,0,0
20200528,054988,凱美元富97購02,,,,,0.00,0.00,0,0,0,0,0,0,0,0,0,0,0,0,0
20200528,054989,精元元富97購01,0.69,0.84,0.68,0.84,+0.14,20.0,90000,9,67300,0,0,0,0,0,0,20000,70000,-50000,-50000
20200528,054990,凌陽元富97購01,,,,,0.00,0.00,0,0,0,0,0,0,0,0,0,0,0,0,0
20200528,054991,南亞科元富97購01,,,,,0.00,0.00,0,0,0,0,0,0,0,0,0,0,0,0,0
20200528,054992,南亞科元富97購02,,,,,0.00,0.00,0,0,0,0,0,0,0,0,0,0,0,0,0
20200528,054993,南亞科元富97購03,,,,,0.00,0.00,0,0,0,0,0,0,0,0,0,0,0,0,0
20200528,054994,建準元富97購01,2.30,2.79,2.26,2.71,+0.36,15.32,361000,23,945800,0,0,0,0,0,0,40000,321000,-281000,-281000
20200528,054995,宏盛元富97購01,,,,,0.00,0.00,0,0,0,0,0,0,0,0,0,0,0,0,0
20200528,054996,聯陽元富97購01,4.22,4.22,4.12,4.15,-0.15,-3.49,70000,12,291300,0,0,0,0,0,0,70000,0,70000,70000
20200528,054997,文曄元富97購01,,,,,0.00,0.00,0,0,0,0,0,0,0,0,0,0,0,0,0
20200528,054998,玉晶光元富97購02,,,,,0.00,0.00,0,0,0,0,0,0,0,0,0,0,0,0,0
20200528,054999,玉晶光元富97購03,,,,,0.00,0.00,0,0,0,0,0,0,0,0,0,0,0,0,0
20200528,055000,玉晶光元富97購04,,,,,0.00,0.00,0,0,0,0,0,0,0,0,0,0,0,0,0
20200528,055001,京鼎元富97購01,0.22,0.22,0.22,0.22,0.00,0.00,69000,1,15180,0,0,0,0,0,0,69000,0,69000,69000
20200528,055002,群創元富99購04,,,,,0.00,0.00,0,0,0,0,0,0,0,0,0,0,0,0,0
20200528,055003,群創元富99購05,,,,,0.00,0.00,0,0,0,0,0,0,0,0,0,0,0,0,0
20200528,055004,群創元富99購06,,,,,0.00,0.00,0,0,0,0,0,0,0,0,0,0,0,0,0
20200528,055005,晶相光元富97購01,,,,,0.00,0.00,0,0,0,0,0,0,0,0,0,0,0,0,0
20200528,055006,晶相光元富9A購01,,,,,0.00,0.00,0,0,0,0,0,0,0,0,0,0,0,0,0
20200528,055007,晶相光元富9A購02,,,,,0.00,0.00,0,0,0,0,0,0,0,0,0,0,0,0,0
20200528,055008,隆達元富97購01,1.00,1.00,1.00,1.00,-0.03,-2.91,5000,1,5000,0,0,0,0,0,0,0,5000,-5000,-5000
20200528,055009,合勤控元富97購01,,,,,0.00,0.00,0,0,0,0,0,0,0,0,0,0,0,0,0
20200528,05500P,臺股指中信96售04,0.05,0.05,0.05,0.05,-0.06,-54.55,2000,1,100,0,0,0,0,0,0,2000,0,2000,2000
20200528,055010,佐登元富97購01,,,,,0.00,0.00,0,0,0,0,0,0,0,0,0,0,0,0,0
20200528,055011,元翎元富97購01,,,,,0.00,0.00,0,0,0,0,0,0,0,0,0,0,0,0,0
20200528,055012,茂林元富97購01,,,,,0.00,0.00,0,0,0,0,0,0,0,0,0,0,0,0,0
20200528,055013,訊連元富97購01,,,,,0.00,0.00,0,0,0,0,0,0,0,0,0,0,0,0,0
20200528,055014,達興元富97購01,0.54,0.54,0.47,0.47,-0.08,-14.55,130000,2,64600,0,0,0,0,0,0,130000,0,130000,130000
20200528,055015,帆宣元富97購01,,,,,0.00,0.00,0,0,0,0,0,0,0,0,0,0,0,0,0
20200528,055016,群電元富97購01,,,,,0.00,0.00,0,0,0,0,0,0,0,0,0,0,0,0,0
20200528,055017,緯穎元富97購01,,,,,0.00,0.00,0,0,0,0,0,0,0,0,0,0,0,0,0
20200528,055018,緯穎元富97購02,,,,,0.00,0.00,0,0,0,0,0,0,0,0,0,0,0,0,0
20200528,055019,福懋科元富97購01,1.16,1.16,1.16,1.16,-0.03,-2.52,40000,7,46400,0,0,0,0,0,0,10000,30000,-20000,-20000
20200528,05501P,健策國票97售01,,,,,0.00,0.00,0,0,0,0,0,0,0,0,0,0,0,0,0
20200528,055020,上証2X國泰98購01,,,,,0.00,0.00,0,0,0,0,0,0,0,0,0,0,0,0,0
20200528,055021,亞德客國泰98購01,3.60,3.74,3.60,3.71,+0.15,4.21,34000,8,126190,0,0,0,0,0,0,34000,8000,26000,26000
20200528,055022,精元國泰99購01,0.57,0.68,0.57,0.66,+0.12,22.22,53000,4,33380,0,0,0,0,0,0,53000,0,53000,53000
20200528,055023,億光國泰98購01,,,,,0.00,0.00,0,0,0,0,0,0,0,0,0,0,0,0,0
20200528,055024,興勤國泰98購01,,,,,0.00,0.00,0,0,0,0,0,0,0,0,0,0,0,0,0
20200528,055025,華新科國泰98購02,0.75,0.75,0.66,0.66,-0.15,-18.52,161000,27,109870,0,0,0,0,0,0,161000,0,161000,161000
20200528,055026,健和興國泰98購01,0.91,0.91,0.42,0.45,-1.35,-75.0,122000,22,67120,0,0,0,0,0,0,15000,107000,-92000,-92000
20200528,055027,牧德國泰99購01,,,,,0.00,0.00,0,0,0,0,0,0,0,0,0,0,0,0,0
20200528,055028,佐登國泰98購01,0.18,0.18,0.18,0.18,-0.02,-10.0,50000,1,9000,0,0,0,0,0,0,50000,0,50000,50000
20200528,055029,帆宣國泰99購01,0.91,0.91,0.80,0.80,+0.08,11.11,267000,20,223270,0,0,0,0,0,0,160000,107000,53000,53000
20200528,05502P,台表科國票97售01,0.41,0.41,0.40,0.40,0.00,0.00,55000,3,22300,0,0,0,0,0,0,55000,0,55000,55000
20200528,055030,帆宣國泰99購02,1.44,1.44,1.24,1.24,+0.10,8.77,494000,18,679250,0,0,0,0,0,0,440000,54000,386000,386000
20200528,055031,南港富邦99購01,,,,,0.00,0.00,0,0,0,0,0,0,0,0,0,0,0,0,0
20200528,055032,億光富邦99購01,0.33,0.33,0.29,0.29,-0.03,-9.38,121000,13,37510,0,0,0,0,0,0,0,121000,-121000,-121000
20200528,055033,漢唐富邦98購01,,,,,0.00,0.00,0,0,0,0,0,0,0,0,0,0,0,0,0
20200528,055034,建準富邦99購01,0.60,0.72,0.53,0.53,-0.07,-11.67,97000,10,56710,0,0,0,0,0,0,65000,29000,36000,36000
20200528,055035,興勤富邦98購01,,,,,0.00,0.00,0,0,0,0,0,0,0,0,0,0,0,0,0
20200528,055036,中工富邦9B購01,0.46,0.46,0.44,0.44,0.00,0.00,190000,10,84900,0,0,0,0,0,0,110000,80000,30000,30000
20200528,055037,宏盛富邦99購01,,,,,0.00,0.00,0,0,0,0,0,0,0,0,0,0,0,0,0
20200528,055038,華航富邦99購01,0.31,0.31,0.29,0.29,0.00,0.00,11000,3,3350,0,0,0,0,0,0,3000,0,3000,3000
20200528,055039,神達富邦99購01,1.06,1.06,1.06,1.06,+0.01,0.95,100000,1,106000,0,0,0,0,0,0,0,100000,-100000,-100000
20200528,05503P,智邦日盛96售01,,,,,0.00,0.00,0,0,0,0,0,0,0,0,0,0,0,0,0
20200528,055040,台虹富邦99購01,,,,,0.00,0.00,0,0,0,0,0,0,0,0,0,0,0,0,0
20200528,055041,致新富邦97購01,,,,,0.00,0.00,0,0,0,0,0,0,0,0,0,0,0,0,0
20200528,055042,得力永豐97購01,,,,,0.00,0.00,0,0,0,0,0,0,0,0,0,0,0,0,0
20200528,055043,中砂永豐97購01,,,,,0.00,0.00,0,0,0,0,0,0,0,0,0,0,0,0,0
20200528,055044,信錦永豐97購01,,,,,0.00,0.00,0,0,0,0,0,0,0,0,0,0,0,0,0
20200528,055045,台肥永豐97購01,,,,,0.00,0.00,0,0,0,0,0,0,0,0,0,0,0,0,0
20200528,055046,上銀永豐97購01,,,,,0.00,0.00,0,0,0,0,0,0,0,0,0,0,0,0,0
20200528,055047,南港永豐97購01,,,,,0.00,0.00,0,0,0,0,0,0,0,0,0,0,0,0,0
20200528,055048,台積電永豐97購04,,,,,0.00,0.00,0,0,0,0,0,0,0,0,0,0,0,0,0
20200528,055049,智邦永豐97購01,0.97,1.33,0.95,0.95,+0.12,14.46,223000,27,264070,0,0,0,0,0,0,133000,58000,75000,75000
20200528,05504P,台積電凱基96售04,,,,,0.00,0.00,0,0,0,0,0,0,0,0,0,0,0,0,0
20200528,055050,敬鵬永豐97購01,,,,,0.00,0.00,0,0,0,0,0,0,0,0,0,0,0,0,0
20200528,055051,藍天永豐97購01,,,,,0.00,0.00,0,0,0,0,0,0,0,0,0,0,0,0,0
20200528,055052,凱美永豐97購01,0.14,0.14,0.14,0.14,0.00,0.00,30000,1,4200,0,0,0,0,0,0,0,30000,-30000,-30000
20200528,055053,瑞昱永豐97購01,0.14,0.14,0.14,0.14,-0.02,-12.5,15000,1,2100,0,0,0,0,0,0,15000,0,15000,15000
20200528,055054,群光永豐97購01,0.28,0.28,0.28,0.28,0.00,0.00,35000,1,9800,0,0,0,0,0,0,35000,0,35000,35000
20200528,055055,精元永豐97購01,,,,,0.00,0.00,0,0,0,0,0,0,0,0,0,0,0,0,0
20200528,055056,億光永豐97購01,,,,,0.00,0.00,0,0,0,0,0,0,0,0,0,0,0,0,0
20200528,055057,興勤永豐97購01,,,,,0.00,0.00,0,0,0,0,0,0,0,0,0,0,0,0,0
20200528,055058,大毅永豐97購01,1.43,1.44,1.38,1.39,-0.04,-2.8,95000,11,134540,0,0,0,0,0,0,50000,42000,8000,8000
20200528,055059,健和興永豐97購01,0.25,0.25,0.25,0.25,0.00,0.00,4000,1,1000,0,0,0,0,0,0,0,4000,-4000,-4000
20200528,05505P,聯發科凱基96售09,,,,,0.00,0.00,0,0,0,0,0,0,0,0,0,0,0,0,0
20200528,055060,聯陽永豐97購01,1.59,1.59,1.39,1.39,-0.16,-10.32,100000,23,152990,0,0,0,0,0,0,89000,11000,78000,78000
20200528,055061,聯詠永豐97購01,,,,,0.00,0.00,0,0,0,0,0,0,0,0,0,0,0,0,0
20200528,055062,文曄永豐97購01,,,,,0.00,0.00,0,0,0,0,0,0,0,0,0,0,0,0,0
20200528,055063,玉晶光永豐99購01,0.18,0.19,0.16,0.17,+0.02,13.33,2083000,13,344190,0,0,0,0,0,0,1648000,435000,1213000,1213000
20200528,055064,碩天永豐97購01,,,,,0.00,0.00,0,0,0,0,0,0,0,0,0,0,0,0,0
20200528,055065,神達永豐97購01,0.21,0.22,0.20,0.22,+0.01,4.76,37000,4,7840,0,0,0,0,0,0,0,37000,-37000,-37000
20200528,055066,佐登永豐97購01,,,,,0.00,0.00,0,0,0,0,0,0,0,0,0,0,0,0,0
20200528,055067,禾聯碩永豐97購01,,,,,0.00,0.00,0,0,0,0,0,0,0,0,0,0,0,0,0
20200528,055068,亞翔永豐97購01,,,,,0.00,0.00,0,0,0,0,0,0,0,0,0,0,0,0,0
20200528,055069,帆宣永豐97購01,,,,,0.00,0.00,0,0,0,0,0,0,0,0,0,0,0,0,0
20200528,05506P,茂林凱基96售03,,,,,0.00,0.00,0,0,0,0,0,0,0,0,0,0,0,0,0
20200528,055070,聯茂永豐97購01,,,,,0.00,0.00,0,0,0,0,0,0,0,0,0,0,0,0,0
20200528,055071,群電永豐97購01,1.02,1.09,0.96,0.96,-0.05,-4.95,271000,9,275880,0,0,0,0,0,0,202000,69000,133000,133000
20200528,055072,康友永豐97購02,,,,,0.00,0.00,0,0,0,0,0,0,0,0,0,0,0,0,0
20200528,055073,易華電永豐97購01,,,,,0.00,0.00,0,0,0,0,0,0,0,0,0,0,0,0,0
20200528,055074,台虹永豐97購01,,,,,0.00,0.00,0,0,0,0,0,0,0,0,0,0,0,0,0
20200528,055075,南電永豐97購01,2.09,2.14,1.93,1.93,-0.16,-7.66,67000,6,137210,0,0,0,0,0,0,22000,45000,-23000,-23000
20200528,055076,福懋科永豐97購01,,,,,0.00,0.00,0,0,0,0,0,0,0,0,0,0,0,0,0
20200528,055077,臺股指永豐97購02,,,,,0.00,0.00,0,0,0,0,0,0,0,0,0,0,0,0,0
20200528,055078,亞泥中信98購01,,,,,0.00,0.00,0,0,0,0,0,0,0,0,0,0,0,0,0
20200528,055079,台光電中信97購01,0.40,0.40,0.37,0.37,-0.10,-21.28,130000,13,49300,0,0,0,0,0,0,0,130000,-130000,-130000
20200528,05507P,聯茂凱基96售02,,,,,0.00,0.00,0,0,0,0,0,0,0,0,0,0,0,0,0
20200528,055080,正崴中信99購01,0.06,0.06,0.05,0.05,-0.01,-16.67,40000,4,2200,0,0,0,0,0,0,0,20000,-20000,-20000
20200528,055081,健鼎中信97購01,,,,,0.00,0.00,0,0,0,0,0,0,0,0,0,0,0,0,0
20200528,055082,台郡中信97購01,,,,,0.00,0.00,0,0,0,0,0,0,0,0,0,0,0,0,0
20200528,055083,康友中信97購01,,,,,0.00,0.00,0,0,0,0,0,0,0,0,0,0,0,0,0
20200528,055084,國巨第一97購01,0.04,0.04,0.04,0.04,0.00,0.00,1000,1,40,0,0,0,0,0,0,1000,0,1000,1000
20200528,055085,大毅國票97購01,2.87,2.93,2.55,2.55,-0.28,-9.89,68000,4,196940,0,0,0,0,0,0,68000,1000,67000,67000
20200528,055086,華邦電亞東98購01,,,,,0.00,0.00,0,0,0,0,0,0,0,0,0,0,0,0,0
20200528,055087,瑞昱亞東97購01,,,,,0.00,0.00,0,0,0,0,0,0,0,0,0,0,0,0,0
20200528,055088,聯詠亞東97購01,,,,,0.00,0.00,0,0,0,0,0,0,0,0,0,0,0,0,0
20200528,055089,金寶群益98購01,,,,,0.00,0.00,0,0,0,0,0,0,0,0,0,0,0,0,0
20200528,05508P,華通統一97售01,,,,,0.00,0.00,0,0,0,0,0,0,0,0,0,0,0,0,0
20200528,055090,國巨群益97購03,0.91,0.91,0.91,0.91,0.00,0.00,46000,1,41860,0,0,0,0,0,0,46000,0,46000,46000
20200528,055091,微星群益97購01,0.67,0.71,0.67,0.71,+0.06,9.23,106000,2,73660,0,0,0,0,0,0,106000,0,106000,106000
20200528,055092,開發金群益9B購01,1.08,1.08,1.07,1.07,-0.03,-2.73,298000,8,320780,0,0,0,0,0,0,298000,35000,263000,263000
20200528,055093,京鼎群益98購01,0.91,0.91,0.89,0.89,0.00,0.00,100000,2,89040,0,0,0,0,0,0,100000,2000,98000,98000
20200528,055094,智易群益98購01,0.61,0.69,0.58,0.59,0.00,0.00,751000,16,471610,0,0,0,0,0,0,213000,538000,-325000,-325000
20200528,055095,啟碁群益98購01,,,,,0.00,0.00,0,0,0,0,0,0,0,0,0,0,0,0,0
20200528,055096,緯穎群益97購01,,,,,0.00,0.00,0,0,0,0,0,0,0,0,0,0,0,0,0
20200528,055097,福懋科群益97購01,,,,,0.00,0.00,0,0,0,0,0,0,0,0,0,0,0,0,0
20200528,055098,臺股指群益97購01,0.71,0.71,0.63,0.63,-0.09,-12.5,250000,3,164300,0,0,0,0,0,0,160000,90000,70000,70000
20200528,055099,可成日盛97購01,,,,,0.00,0.00,0,0,0,0,0,0,0,0,0,0,0,0,0
20200528,05509P,智邦元富96售02,,,,,0.00,0.00,0,0,0,0,0,0,0,0,0,0,0,0,0
20200528,055100,得力凱基97購01,,,,,0.00,0.00,0,0,0,0,0,0,0,0,0,0,0,0,0
20200528,055101,台肥凱基97購01,,,,,0.00,0.00,0,0,0,0,0,0,0,0,0,0,0,0,0
20200528,055102,上銀凱基98購01,2.35,2.35,2.35,2.35,0.00,0.00,10000,2,23500,0,0,0,0,0,0,2000,0,2000,2000
20200528,055103,南港凱基97購01,,,,,0.00,0.00,0,0,0,0,0,0,0,0,0,0,0,0,0
20200528,055104,台達電凱基98購01,0.43,0.43,0.43,0.43,-0.02,-4.44,42000,1,18060,0,0,0,0,0,0,42000,0,42000,42000
20200528,055105,鴻海凱基98購05,,,,,0.00,0.00,0,0,0,0,0,0,0,0,0,0,0,0,0
20200528,055106,台積電凱基98購05,,,,,0.00,0.00,0,0,0,0,0,0,0,0,0,0,0,0,0
20200528,055107,旺宏凱基98購04,0.19,0.19,0.19,0.19,-0.06,-24.0,12000,2,2280,0,0,0,0,0,0,0,0,0,0
20200528,055108,智邦凱基98購01,6.45,7.30,5.80,5.80,+0.60,11.54,66000,11,414650,0,0,0,0,0,0,42000,24000,18000,18000
20200528,055109,正崴凱基98購01,,,,,0.00,0.00,0,0,0,0,0,0,0,0,0,0,0,0,0
20200528,05510P,燿華元富96售01,,,,,0.00,0.00,0,0,0,0,0,0,0,0,0,0,0,0,0
20200528,055110,美律凱基98購02,,,,,0.00,0.00,0,0,0,0,0,0,0,0,0,0,0,0,0
20200528,055111,宏盛凱基97購01,,,,,0.00,0.00,0,0,0,0,0,0,0,0,0,0,0,0,0
20200528,055112,晶豪科凱基98購01,1.96,1.96,1.96,1.96,+0.07,3.7,12000,4,23520,0,0,0,0,0,0,0,12000,-12000,-12000
20200528,055113,大立光凱基98購06,,,,,0.00,0.00,0,0,0,0,0,0,0,0,0,0,0,0,0
20200528,055114,新日興凱基98購01,0.82,0.93,0.82,0.89,+0.13,17.11,140000,4,127640,0,0,0,0,0,0,47000,93000,-46000,-46000
20200528,055115,日月光凱基98購01,,,,,0.00,0.00,0,0,0,0,0,0,0,0,0,0,0,0,0
20200528,055116,康控凱基98購01,,,,,0.00,0.00,0,0,0,0,0,0,0,0,0,0,0,0,0
20200528,055117,臻鼎凱基98購02,,,,,0.00,0.00,0,0,0,0,0,0,0,0,0,0,0,0,0
20200528,055118,嘉聯益凱基98購02,0.24,0.24,0.24,0.24,0.00,0.00,20000,1,4800,0,0,0,0,0,0,0,20000,-20000,-20000
20200528,055119,力成凱基98購01,0.79,0.82,0.72,0.72,-0.08,-10.0,160000,12,126700,0,0,0,0,0,0,50000,110000,-60000,-60000
20200528,05511P,T50反1台新06售01,0.74,0.75,0.74,0.75,0.00,0.00,20000,2,14900,0,0,0,0,0,0,20000,10000,10000,10000
20200528,055120,南港兆豐97購01,0.28,0.35,0.28,0.35,+0.06,20.69,13000,3,3710,0,0,0,0,0,0,0,0,0,0
20200528,055121,鴻海兆豐97購03,,,,,0.00,0.00,0,0,0,0,0,0,0,0,0,0,0,0,0
20200528,055122,國巨兆豐98購01,,,,,0.00,0.00,0,0,0,0,0,0,0,0,0,0,0,0,0
20200528,055123,億光兆豐97購01,,,,,0.00,0.00,0,0,0,0,0,0,0,0,0,0,0,0,0
20200528,055124,建準兆豐97購01,2.47,2.86,2.24,2.24,-0.32,-12.5,61000,14,160850,0,0,0,0,0,0,2000,59000,-57000,-57000
20200528,055125,智原兆豐97購01,,,,,0.00,0.00,0,0,0,0,0,0,0,0,0,0,0,0,0
20200528,055126,嘉澤兆豐97購01,1.35,1.36,1.30,1.36,-0.17,-11.11,110000,8,145160,0,0,0,0,0,0,110000,0,110000,110000
20200528,055127,台虹兆豐97購01,0.72,0.73,0.70,0.70,-0.06,-7.89,358000,6,255380,0,0,0,0,0,0,358000,0,358000,358000
20200528,055128,致新兆豐97購01,,,,,0.00,0.00,0,0,0,0,0,0,0,0,0,0,0,0,0
20200528,055129,鈺齊兆豐97購01,,,,,0.00,0.00,0,0,0,0,0,0,0,0,0,0,0,0,0
20200528,05512P,華新科台新97售01,,,,,0.00,0.00,0,0,0,0,0,0,0,0,0,0,0,0,0
20200528,055130,京鼎康和97購01,,,,,0.00,0.00,0,0,0,0,0,0,0,0,0,0,0,0,0
20200528,055131,茂林康和97購01,0.53,0.53,0.50,0.50,-0.08,-13.79,344000,15,175710,0,0,0,0,0,0,344000,0,344000,344000
20200528,055132,台虹康和97購01,,,,,0.00,0.00,0,0,0,0,0,0,0,0,0,0,0,0,0
20200528,055133,致新康和97購01,1.03,1.06,0.96,0.98,+0.10,11.36,94000,9,98390,0,0,0,0,0,0,6000,88000,-82000,-82000
20200528,055134,元油反國泰99購01,,,,,0.00,0.00,0,0,0,0,0,0,0,0,0,0,0,0,0
20200528,055135,聯發科富邦99購05,,,,,0.00,0.00,0,0,0,0,0,0,0,0,0,0,0,0,0
20200528,055136,聯發科富邦99購06,2.97,2.99,2.83,2.83,-0.11,-3.74,85000,8,252610,0,0,0,0,0,0,84000,1000,83000,83000
20200528,055137,GIS富邦98購01,0.36,0.36,0.28,0.28,-0.03,-9.68,1013000,28,334480,0,0,0,0,0,0,682000,270000,412000,412000
20200528,055138,大毅永豐97購02,0.93,0.94,0.88,0.88,-0.07,-7.37,33000,4,29600,0,0,0,0,0,0,10000,23000,-13000,-13000
20200528,055139,欣興永豐97購01,,,,,0.00,0.00,0,0,0,0,0,0,0,0,0,0,0,0,0
20200528,05513P,玉山金台新96售01,,,,,0.00,0.00,0,0,0,0,0,0,0,0,0,0,0,0,0
20200528,055140,晶相光永豐97購01,,,,,0.00,0.00,0,0,0,0,0,0,0,0,0,0,0,0,0
20200528,055141,牧德永豐98購02,,,,,0.00,0.00,0,0,0,0,0,0,0,0,0,0,0,0,0
20200528,055142,健策永豐98購01,1.17,1.19,0.99,0.99,-0.20,-16.81,393000,29,450150,0,0,0,0,0,0,393000,0,393000,393000
20200528,055143,臻鼎永豐97購01,,,,,0.00,0.00,0,0,0,0,0,0,0,0,0,0,0,0,0
20200528,055144,T50反1元大97購03,,,,,0.00,0.00,0,0,0,0,0,0,0,0,0,0,0,0,0
20200528,055145,T50反1元大97購04,,,,,0.00,0.00,0,0,0,0,0,0,0,0,0,0,0,0,0
20200528,055146,華通元大98購04,,,,,0.00,0.00,0,0,0,0,0,0,0,0,0,0,0,0,0
20200528,055147,鴻海元大97購11,,,,,0.00,0.00,0,0,0,0,0,0,0,0,0,0,0,0,0
20200528,055148,鴻海元大98購02,,,,,0.00,0.00,0,0,0,0,0,0,0,0,0,0,0,0,0
20200528,055149,國巨元大97購06,,,,,0.00,0.00,0,0,0,0,0,0,0,0,0,0,0,0,0
20200528,05514P,康舒永豐96售01,,,,,0.00,0.00,0,0,0,0,0,0,0,0,0,0,0,0,0
20200528,055150,台積電元大98購04,,,,,0.00,0.00,0,0,0,0,0,0,0,0,0,0,0,0,0
20200528,055151,台積電元大98購05,,,,,0.00,0.00,0,0,0,0,0,0,0,0,0,0,0,0,0
20200528,055152,旺宏元大98購04,,,,,0.00,0.00,0,0,0,0,0,0,0,0,0,0,0,0,0
20200528,055153,台光電元大98購02,1.87,1.87,1.77,1.77,-0.05,-2.75,58000,4,105660,0,0,0,0,0,0,3000,55000,-52000,-52000
20200528,055154,聯發科元大98購01,,,,,0.00,0.00,0,0,0,0,0,0,0,0,0,0,0,0,0
20200528,055155,奇力新元大99購01,,,,,0.00,0.00,0,0,0,0,0,0,0,0,0,0,0,0,0
20200528,055156,華新科元大99購02,,,,,0.00,0.00,0,0,0,0,0,0,0,0,0,0,0,0,0
20200528,055157,晶豪科元大97購01,,,,,0.00,0.00,0,0,0,0,0,0,0,0,0,0,0,0,0
20200528,055158,亞光元大99購01,0.05,0.05,0.05,0.05,0.00,0.00,1000,1,50,0,0,0,0,0,0,1000,0,1000,1000
20200528,055159,玉晶光元大98購05,,,,,0.00,0.00,0,0,0,0,0,0,0,0,0,0,0,0,0
20200528,05515P,台積電群益96售03,,,,,0.00,0.00,0,0,0,0,0,0,0,0,0,0,0,0,0
20200528,055160,玉晶光元大99購03,0.33,0.33,0.33,0.33,+0.03,10.0,5000,1,1650,0,0,0,0,0,0,5000,0,5000,5000
20200528,055161,貿聯元大98購03,,,,,0.00,0.00,0,0,0,0,0,0,0,0,0,0,0,0,0
20200528,055162,新唐元大97購01,,,,,0.00,0.00,0,0,0,0,0,0,0,0,0,0,0,0,0
20200528,055163,訊芯元大98購01,,,,,0.00,0.00,0,0,0,0,0,0,0,0,0,0,0,0,0
20200528,055164,矽創元大98購01,0.55,0.58,0.55,0.56,+0.18,47.37,69000,5,39100,0,0,0,0,0,0,30000,11000,19000,19000
20200528,055165,元油反統一98購01,,,,,0.00,0.00,0,0,0,0,0,0,0,0,0,0,0,0,0
20200528,055166,台積電統一97購05,0.04,0.04,0.04,0.04,-0.01,-20.0,40000,2,1600,0,0,0,0,0,0,30000,0,30000,30000
20200528,055167,友訊統一97購01,,,,,0.00,0.00,0,0,0,0,0,0,0,0,0,0,0,0,0
20200528,055168,光罩統一98購01,0.53,0.53,0.53,0.53,0.00,0.00,2000,1,1060,0,0,0,0,0,0,2000,0,2000,2000
20200528,055169,光罩統一99購01,,,,,0.00,0.00,0,0,0,0,0,0,0,0,0,0,0,0,0
20200528,05516P,台積電元大96售12,,,,,0.00,0.00,0,0,0,0,0,0,0,0,0,0,0,0,0
20200528,055170,光磊統一97購01,,,,,0.00,0.00,0,0,0,0,0,0,0,0,0,0,0,0,0
20200528,055171,凱美統一97購01,,,,,0.00,0.00,0,0,0,0,0,0,0,0,0,0,0,0,0
20200528,055172,凱美統一97購02,0.39,0.47,0.39,0.44,+0.04,10.0,523000,7,217740,0,0,0,0,0,0,275000,248000,27000,27000
20200528,055173,瑞昱統一97購01,2.55,2.66,2.55,2.60,0.00,0.00,124000,6,321820,0,0,0,0,0,0,0,124000,-124000,-124000
20200528,055174,精元統一97購01,0.55,0.68,0.53,0.64,+0.09,16.36,1663000,70,998260,0,0,0,0,0,0,1005000,594000,411000,411000
20200528,055175,建準統一97購01,,,,,0.00,0.00,0,0,0,0,0,0,0,0,0,0,0,0,0
20200528,055176,大毅統一98購02,4.25,4.25,4.14,4.14,-0.18,-4.17,60000,4,252560,0,0,0,0,0,0,48000,12000,36000,36000
20200528,055177,宏達電統一99購01,0.34,0.34,0.34,0.34,0.00,0.00,100000,1,34000,0,0,0,0,0,0,100000,0,100000,100000
20200528,055178,晶豪科統一97購01,1.76,1.76,1.73,1.73,-0.04,-2.26,85000,3,148700,0,0,0,0,0,0,0,85000,-85000,-85000
20200528,055179,大立光統一97購04,,,,,0.00,0.00,0,0,0,0,0,0,0,0,0,0,0,0,0
20200528,05517P,臻鼎元大96售01,0.10,0.10,0.10,0.10,0.00,0.00,6000,1,600,0,0,0,0,0,0,6000,0,6000,6000
20200528,055180,文曄統一97購01,,,,,0.00,0.00,0,0,0,0,0,0,0,0,0,0,0,0,0
20200528,055181,日電貿統一97購01,0.63,0.63,0.57,0.57,-0.03,-5.0,234000,9,136180,0,0,0,0,0,0,35000,199000,-164000,-164000
20200528,055182,京鼎統一98購01,,,,,0.00,0.00,0,0,0,0,0,0,0,0,0,0,0,0,0
20200528,055183,聯鈞統一97購01,,,,,0.00,0.00,0,0,0,0,0,0,0,0,0,0,0,0,0
20200528,055184,群創統一98購02,,,,,0.00,0.00,0,0,0,0,0,0,0,0,0,0,0,0,0
20200528,055185,晶相光統一97購01,,,,,0.00,0.00,0,0,0,0,0,0,0,0,0,0,0,0,0
20200528,055186,正文統一97購01,,,,,0.00,0.00,0,0,0,0,0,0,0,0,0,0,0,0,0
20200528,055187,彩晶統一98購01,,,,,0.00,0.00,0,0,0,0,0,0,0,0,0,0,0,0,0
20200528,055188,亞翔統一97購01,,,,,0.00,0.00,0,0,0,0,0,0,0,0,0,0,0,0,0
20200528,055189,台虹統一97購01,,,,,0.00,0.00,0,0,0,0,0,0,0,0,0,0,0,0,0
20200528,05518P,T50反1凱基98售03,0.87,0.88,0.87,0.88,0.00,0.00,2000,2,1750,0,0,0,0,0,0,2000,0,2000,2000
20200528,055190,華新科元富97購01,,,,,0.00,0.00,0,0,0,0,0,0,0,0,0,0,0,0,0
20200528,055191,牧德元富97購01,,,,,0.00,0.00,0,0,0,0,0,0,0,0,0,0,0,0,0
20200528,055192,世芯元富97購01,,,,,0.00,0.00,0,0,0,0,0,0,0,0,0,0,0,0,0
20200528,055193,世芯元富97購02,,,,,0.00,0.00,0,0,0,0,0,0,0,0,0,0,0,0,0
20200528,055194,昇陽半元富97購01,,,,,0.00,0.00,0,0,0,0,0,0,0,0,0,0,0,0,0
20200528,055195,昇陽半元富97購02,,,,,0.00,0.00,0,0,0,0,0,0,0,0,0,0,0,0,0
20200528,055196,致新元富97購01,1.96,2.23,1.96,2.20,+0.35,18.92,897000,61,1881370,0,0,0,0,0,0,428000,439000,-11000,-11000
20200528,055197,致新元富97購02,2.28,2.66,2.28,2.62,+0.26,11.02,657000,81,1620820,0,0,0,0,0,0,183000,474000,-291000,-291000
20200528,055198,奇力新第一97購01,0.02,0.02,0.02,0.02,0.00,0.00,50000,1,1000,0,0,0,0,0,0,0,0,0,0
20200528,055199,國喬群益97購01,,,,,0.00,0.00,0,0,0,0,0,0,0,0,0,0,0,0,0
20200528,05519P,上証2X凱基98售01,2.75,2.77,2.75,2.77,0.00,0.00,200000,2,552000,0,0,0,0,0,0,0,200000,-200000,-200000
20200528,055200,和大群益98購01,,,,,0.00,0.00,0,0,0,0,0,0,0,0,0,0,0,0,0
20200528,055201,興勤群益98購01,,,,,0.00,0.00,0,0,0,0,0,0,0,0,0,0,0,0,0
20200528,055202,神達群益97購01,,,,,0.00,0.00,0,0,0,0,0,0,0,0,0,0,0,0,0
20200528,055203,建準中信97購01,0.71,0.97,0.68,0.68,+0.01,1.49,412000,25,349990,0,0,0,0,0,0,177000,235000,-58000,-58000
20200528,055204,宏達電中信99購01,,,,,0.00,0.00,0,0,0,0,0,0,0,0,0,0,0,0,0
20200528,055205,京鼎中信99購01,,,,,0.00,0.00,0,0,0,0,0,0,0,0,0,0,0,0,0
20200528,055206,台虹中信97購01,0.06,0.06,0.05,0.05,-0.01,-16.67,290000,6,17000,0,0,0,0,0,0,250000,40000,210000,210000
20200528,055207,致新中信99購01,0.65,0.76,0.64,0.76,+0.14,22.58,256000,34,180840,0,0,0,0,0,0,6000,250000,-244000,-244000
20200528,055208,京鼎康和97購02,,,,,0.00,0.00,0,0,0,0,0,0,0,0,0,0,0,0,0
20200528,055209,勤誠康和97購01,0.48,0.48,0.48,0.48,-0.05,-9.43,40000,1,19200,0,0,0,0,0,0,40000,0,40000,40000
20200528,05520P,聯詠凱基96售01,,,,,0.00,0.00,0,0,0,0,0,0,0,0,0,0,0,0,0
20200528,055210,S&P正2凱基97購01,,,,,0.00,0.00,0,0,0,0,0,0,0,0,0,0,0,0,0
20200528,055211,A50反1凱基9A購01,0.66,0.67,0.66,0.66,0.00,0.00,30000,3,19900,0,0,0,0,0,0,0,30000,-30000,-30000
20200528,055212,和大凱基97購02,,,,,0.00,0.00,0,0,0,0,0,0,0,0,0,0,0,0,0
20200528,055213,大成鋼凱基98購01,,,,,0.00,0.00,0,0,0,0,0,0,0,0,0,0,0,0,0
20200528,055214,聯電凱基97購02,,,,,0.00,0.00,0,0,0,0,0,0,0,0,0,0,0,0,0
20200528,055215,智邦凱基98購02,7.75,7.75,7.75,7.75,+0.55,7.64,16000,1,124000,0,0,0,0,0,0,16000,0,16000,16000
20200528,055216,友達凱基98購05,,,,,0.00,0.00,0,0,0,0,0,0,0,0,0,0,0,0,0
20200528,055217,緯創凱基97購02,1.80,1.80,1.80,1.80,+0.09,5.26,10000,1,18000,0,0,0,0,0,0,10000,0,10000,10000
20200528,055218,彩晶凱基99購01,,,,,0.00,0.00,0,0,0,0,0,0,0,0,0,0,0,0,0
20200528,055219,啟碁凱基98購01,,,,,0.00,0.00,0,0,0,0,0,0,0,0,0,0,0,0,0
20200528,05521P,創意永豐96售01,,,,,0.00,0.00,0,0,0,0,0,0,0,0,0,0,0,0,0
20200528,055220,緯穎凱基98購02,,,,,0.00,0.00,0,0,0,0,0,0,0,0,0,0,0,0,0
20200528,055221,矽創凱基97購02,0.75,0.84,0.69,0.70,+0.15,27.27,138000,27,105650,0,0,0,0,0,0,0,138000,-138000,-138000
20200528,055222,臺股指凱基97購05,,,,,0.00,0.00,0,0,0,0,0,0,0,0,0,0,0,0,0
20200528,055223,和大國票98購01,,,,,0.00,0.00,0,0,0,0,0,0,0,0,0,0,0,0,0
20200528,055224,鴻海國票99購02,,,,,0.00,0.00,0,0,0,0,0,0,0,0,0,0,0,0,0
20200528,055225,華邦電國票99購01,0.14,0.15,0.14,0.15,+0.04,36.36,14000,3,2030,0,0,0,0,0,0,14000,0,14000,14000
20200528,055226,聯發科國票97購05,,,,,0.00,0.00,0,0,0,0,0,0,0,0,0,0,0,0,0
20200528,055227,聯發科國票98購02,2.88,2.88,2.88,2.88,0.00,0.00,10000,1,28800,0,0,0,0,0,0,0,10000,-10000,-10000
20200528,055228,聯發科國票98購03,,,,,0.00,0.00,0,0,0,0,0,0,0,0,0,0,0,0,0
20200528,055229,大毅國票97購02,3.03,3.03,2.65,2.65,-0.35,-11.67,50000,8,140630,0,0,0,0,0,0,47000,6000,41000,41000
20200528,05522P,友達元富96售02,,,,,0.00,0.00,0,0,0,0,0,0,0,0,0,0,0,0,0
20200528,055230,大毅國票98購01,5.35,5.35,5.05,5.25,-0.25,-4.55,28000,4,149400,0,0,0,0,0,0,28000,2000,26000,26000
20200528,055231,大毅國票98購02,,,,,0.00,0.00,0,0,0,0,0,0,0,0,0,0,0,0,0
20200528,055232,泰碩國票98購01,1.46,1.49,1.40,1.40,-0.17,-10.83,86000,5,123610,0,0,0,0,0,0,0,86000,-86000,-86000
20200528,055233,康友國票98購01,,,,,0.00,0.00,0,0,0,0,0,0,0,0,0,0,0,0,0
20200528,055234,昇陽半國票98購02,,,,,0.00,0.00,0,0,0,0,0,0,0,0,0,0,0,0,0
20200528,055235,金寶台新98購01,0.46,0.52,0.43,0.43,-0.03,-6.52,708000,10,332640,0,0,0,0,0,0,200000,498000,-298000,-298000
20200528,055236,建準台新98購01,,,,,0.00,0.00,0,0,0,0,0,0,0,0,0,0,0,0,0
20200528,055237,晶豪科台新97購01,,,,,0.00,0.00,0,0,0,0,0,0,0,0,0,0,0,0,0
20200528,055238,茂林台新97購01,1.10,1.10,1.10,1.10,0.00,0.00,40000,2,44000,0,0,0,0,0,0,40000,40000,0,0
20200528,055239,帆宣台新97購01,0.34,0.34,0.34,0.34,+0.06,21.43,10000,1,3400,0,0,0,0,0,0,10000,0,10000,10000
20200528,05523P,聯發科國票96售04,0.25,0.25,0.25,0.25,-0.01,-3.85,200000,1,50000,0,0,0,0,0,0,200000,0,200000,200000
20200528,055240,京元電元富97購01,,,,,0.00,0.00,0,0,0,0,0,0,0,0,0,0,0,0,0
20200528,055241,T50反1統一99購01,,,,,0.00,0.00,0,0,0,0,0,0,0,0,0,0,0,0,0
20200528,055242,道瓊銀統一98購01,,,,,0.00,0.00,0,0,0,0,0,0,0,0,0,0,0,0,0
20200528,055243,國巨統一97購04,0.04,0.04,0.03,0.03,0.00,0.00,1593000,7,48780,0,0,0,0,0,0,1593000,1494000,99000,99000
20200528,055244,國巨統一98購01,,,,,0.00,0.00,0,0,0,0,0,0,0,0,0,0,0,0,0
20200528,055245,凱美統一99購01,0.49,0.57,0.49,0.57,+0.08,16.33,617000,12,324510,0,0,0,0,0,0,26000,591000,-565000,-565000
20200528,055246,美律統一98購01,,,,,0.00,0.00,0,0,0,0,0,0,0,0,0,0,0,0,0
20200528,055247,聯發科統一98購01,,,,,0.00,0.00,0,0,0,0,0,0,0,0,0,0,0,0,0
20200528,055248,可成統一97購02,0.28,0.30,0.28,0.30,0.00,0.00,230000,2,67400,0,0,0,0,0,0,230000,0,230000,230000
20200528,055249,大毅統一99購01,,,,,0.00,0.00,0,0,0,0,0,0,0,0,0,0,0,0,0
20200528,05524P,瀚宇博國票97售02,1.43,1.43,1.40,1.40,-0.21,-13.04,47000,2,66910,0,0,0,0,0,0,47000,0,47000,47000
20200528,055250,華新科統一97購02,,,,,0.00,0.00,0,0,0,0,0,0,0,0,0,0,0,0,0
20200528,055251,華新科統一99購01,,,,,0.00,0.00,0,0,0,0,0,0,0,0,0,0,0,0,0
20200528,055252,新光金統一98購02,,,,,0.00,0.00,0,0,0,0,0,0,0,0,0,0,0,0,0
20200528,055253,大立光統一97購06,,,,,0.00,0.00,0,0,0,0,0,0,0,0,0,0,0,0,0
20200528,055254,聯詠統一97購03,1.13,1.13,1.13,1.13,-0.03,-2.59,2000,1,2260,0,0,0,0,0,0,2000,0,2000,2000
20200528,055255,欣興統一97購02,,,,,0.00,0.00,0,0,0,0,0,0,0,0,0,0,0,0,0
20200528,055256,日電貿統一99購01,1.31,1.32,1.30,1.31,+0.01,0.77,111000,5,144990,0,0,0,0,0,0,103000,8000,95000,95000
20200528,055257,景碩統一97購01,1.16,1.33,1.16,1.30,+0.12,10.17,525000,20,649230,0,0,0,0,0,0,87000,438000,-351000,-351000
20200528,055258,玉晶光統一97購03,0.11,0.11,0.11,0.11,0.00,0.00,10000,1,1100,0,0,0,0,0,0,10000,0,10000,10000
20200528,055259,玉晶光統一9A購01,0.45,0.50,0.45,0.45,+0.03,7.14,254000,5,119980,0,0,0,0,0,0,0,254000,-254000,-254000
20200528,05525P,奇力新群益96售02,,,,,0.00,0.00,0,0,0,0,0,0,0,0,0,0,0,0,0
20200528,055260,晶相光統一98購01,,,,,0.00,0.00,0,0,0,0,0,0,0,0,0,0,0,0,0
20200528,055261,帆宣統一98購01,1.28,1.35,1.25,1.27,+0.17,15.45,384000,8,488160,0,0,0,0,0,0,335000,47000,288000,288000
20200528,055262,台虹國泰98購01,,,,,0.00,0.00,0,0,0,0,0,0,0,0,0,0,0,0,0
20200528,055263,華新科富邦9A購01,0.21,0.25,0.18,0.24,-0.03,-11.11,50000,8,10550,0,0,0,0,0,0,0,9000,-9000,-9000
20200528,055264,國巨永豐98購01,,,,,0.00,0.00,0,0,0,0,0,0,0,0,0,0,0,0,0
20200528,055265,玉晶光永豐98購03,0.14,0.14,0.14,0.14,+0.02,16.67,127000,3,17780,0,0,0,0,0,0,0,127000,-127000,-127000
20200528,055266,京鼎永豐97購01,,,,,0.00,0.00,0,0,0,0,0,0,0,0,0,0,0,0,0
20200528,055267,百和永豐97購01,,,,,0.00,0.00,0,0,0,0,0,0,0,0,0,0,0,0,0
20200528,055268,和大元大97購01,,,,,0.00,0.00,0,0,0,0,0,0,0,0,0,0,0,0,0
20200528,055269,和大元大97購02,,,,,0.00,0.00,0,0,0,0,0,0,0,0,0,0,0,0,0
20200528,05526P,茂林群益96售03,,,,,0.00,0.00,0,0,0,0,0,0,0,0,0,0,0,0,0
20200528,055270,上銀元大97購03,4.00,4.00,4.00,4.00,0.00,0.00,2000,1,8000,0,0,0,0,0,0,2000,0,2000,2000
20200528,055271,鴻海元大98購03,0.65,0.65,0.59,0.61,-0.01,-1.61,36000,6,22000,0,0,0,0,0,0,14000,22000,-8000,-8000
20200528,055272,國巨元大98購04,0.87,0.87,0.87,0.87,-0.16,-15.53,1000,1,870,0,0,0,0,0,0,0,0,0,0
20200528,055273,華泰元大97購01,,,,,0.00,0.00,0,0,0,0,0,0,0,0,0,0,0,0,0
20200528,055274,華泰元大97購02,,,,,0.00,0.00,0,0,0,0,0,0,0,0,0,0,0,0,0
20200528,055275,台積電元大97購19,,,,,0.00,0.00,0,0,0,0,0,0,0,0,0,0,0,0,0
20200528,055276,台積電元大97購20,0.13,0.14,0.13,0.14,0.00,0.00,25000,2,3300,0,0,0,0,0,0,0,0,0,0
20200528,055277,旺宏元大97購04,,,,,0.00,0.00,0,0,0,0,0,0,0,0,0,0,0,0,0
20200528,055278,旺宏元大98購05,,,,,0.00,0.00,0,0,0,0,0,0,0,0,0,0,0,0,0
20200528,055279,華邦電元大97購02,,,,,0.00,0.00,0,0,0,0,0,0,0,0,0,0,0,0,0
20200528,05527P,聯茂群益96售01,,,,,0.00,0.00,0,0,0,0,0,0,0,0,0,0,0,0,0
20200528,055280,智邦元大97購01,10.00,10.00,10.00,10.00,0.00,0.00,1000,1,10000,0,0,0,0,0,0,0,1000,-1000,-1000
20200528,055281,台光電元大98購03,,,,,0.00,0.00,0,0,0,0,0,0,0,0,0,0,0,0,0
20200528,055282,聯發科元大97購15,,,,,0.00,0.00,0,0,0,0,0,0,0,0,0,0,0,0,0
20200528,055283,聯發科元大97購16,,,,,0.00,0.00,0,0,0,0,0,0,0,0,0,0,0,0,0
20200528,055284,全新元大99購01,,,,,0.00,0.00,0,0,0,0,0,0,0,0,0,0,0,0,0
20200528,055285,華新科元大99購03,,,,,0.00,0.00,0,0,0,0,0,0,0,0,0,0,0,0,0
20200528,055286,晶技元大98購03,,,,,0.00,0.00,0,0,0,0,0,0,0,0,0,0,0,0,0
20200528,055287,日電貿元大97購01,1.41,1.41,1.38,1.38,-0.07,-4.83,36000,4,50080,0,0,0,0,0,0,36000,0,36000,36000
20200528,055288,日電貿元大97購02,1.48,1.49,1.44,1.44,-0.06,-4.0,117000,7,170130,0,0,0,0,0,0,112000,5000,107000,107000
20200528,055289,泰碩元大98購01,,,,,0.00,0.00,0,0,0,0,0,0,0,0,0,0,0,0,0
20200528,05528P,臺股指群益96售01,,,,,0.00,0.00,0,0,0,0,0,0,0,0,0,0,0,0,0
20200528,055290,玉晶光元大98購08,,,,,0.00,0.00,0,0,0,0,0,0,0,0,0,0,0,0,0
20200528,055291,京鼎元大97購02,1.45,1.45,1.31,1.31,-0.14,-9.66,52000,4,69520,0,0,0,0,0,0,52000,42000,10000,10000
20200528,055292,聯鈞元大97購02,,,,,0.00,0.00,0,0,0,0,0,0,0,0,0,0,0,0,0
20200528,055293,晶相光元大97購01,,,,,0.00,0.00,0,0,0,0,0,0,0,0,0,0,0,0,0
20200528,055294,智易元大98購01,,,,,0.00,0.00,0,0,0,0,0,0,0,0,0,0,0,0,0
20200528,055295,瀚宇博元大97購02,0.87,0.87,0.84,0.84,-0.04,-4.55,196000,7,167950,0,0,0,0,0,0,146000,51000,95000,95000
20200528,055296,康舒元大97購02,,,,,0.00,0.00,0,0,0,0,0,0,0,0,0,0,0,0,0
20200528,055297,啟碁元大97購01,0.75,0.78,0.70,0.70,-0.04,-5.41,173000,7,127350,0,0,0,0,0,0,105000,68000,37000,37000
20200528,055298,啟碁元大97購02,0.13,0.13,0.13,0.13,0.00,0.00,1000,1,130,0,0,0,0,0,0,1000,1000,0,0
20200528,055299,康友元大97購02,,,,,0.00,0.00,0,0,0,0,0,0,0,0,0,0,0,0,0
20200528,05529P,臺股指群益96售02,,,,,0.00,0.00,0,0,0,0,0,0,0,0,0,0,0,0,0
20200528,055300,緯穎元大98購01,,,,,0.00,0.00,0,0,0,0,0,0,0,0,0,0,0,0,0
20200528,055301,台虹元大97購01,0.93,0.94,0.80,0.80,-0.19,-19.19,376000,17,325800,0,0,0,0,0,0,180000,240000,-60000,-60000
20200528,055302,達方元大97購01,0.38,0.38,0.38,0.38,0.00,0.00,15000,1,5700,0,0,0,0,0,0,0,15000,-15000,-15000
20200528,055303,鈺齊元大97購01,0.01,0.01,0.01,0.01,0.00,0.00,70000,1,700,0,0,0,0,0,0,70000,0,70000,70000
20200528,055304,瑞昱第一98購01,0.70,0.70,0.70,0.70,0.00,0.00,8000,1,5600,0,0,0,0,0,0,0,8000,-8000,-8000
20200528,055305,旺宏群益99購01,1.89,1.89,1.89,1.89,+0.01,0.53,32000,1,60480,0,0,0,0,0,0,32000,0,32000,32000
20200528,055306,燿華群益97購01,,,,,0.00,0.00,0,0,0,0,0,0,0,0,0,0,0,0,0
20200528,055307,瑞昱群益97購02,,,,,0.00,0.00,0,0,0,0,0,0,0,0,0,0,0,0,0
20200528,055308,聯發科群益97購04,,,,,0.00,0.00,0,0,0,0,0,0,0,0,0,0,0,0,0
20200528,055309,冠德群益97購01,0.06,0.06,0.06,0.06,0.00,0.00,2000,1,120,0,0,0,0,0,0,2000,0,2000,2000
20200528,05530P,臺股指群益96售03,,,,,0.00,0.00,0,0,0,0,0,0,0,0,0,0,0,0,0
20200528,055310,聯詠群益97購02,,,,,0.00,0.00,0,0,0,0,0,0,0,0,0,0,0,0,0
20200528,055311,健策群益98購02,1.67,1.69,1.30,1.35,-0.12,-8.16,258000,17,376300,0,0,0,0,0,0,199000,59000,140000,140000
20200528,055312,台虹群益99購01,,,,,0.00,0.00,0,0,0,0,0,0,0,0,0,0,0,0,0
20200528,055313,南電群益97購01,,,,,0.00,0.00,0,0,0,0,0,0,0,0,0,0,0,0,0
20200528,055314,華邦電中信99購01,,,,,0.00,0.00,0,0,0,0,0,0,0,0,0,0,0,0,0
20200528,055315,晶技麥證97購01,,,,,0.00,0.00,0,0,0,0,0,0,0,0,0,0,0,0,0
20200528,055316,上銀國票98購01,1.01,1.01,1.01,1.01,-0.34,-25.19,10000,1,10100,0,0,0,0,0,0,10000,0,10000,10000
20200528,055317,金寶國票98購01,,,,,0.00,0.00,0,0,0,0,0,0,0,0,0,0,0,0,0
20200528,055318,華通國票98購01,1.33,1.64,1.33,1.44,+0.21,17.07,280000,19,431230,0,0,0,0,0,0,177000,103000,74000,74000
20200528,055319,國巨國票98購03,,,,,0.00,0.00,0,0,0,0,0,0,0,0,0,0,0,0,0
20200528,05531P,臺股指群益96售04,,,,,0.00,0.00,0,0,0,0,0,0,0,0,0,0,0,0,0
20200528,055320,建準國票98購01,4.63,4.99,4.63,4.85,+0.51,11.75,84000,3,398940,0,0,0,0,0,0,0,84000,-84000,-84000
20200528,055321,大立光國票98購02,,,,,0.00,0.00,0,0,0,0,0,0,0,0,0,0,0,0,0
20200528,055322,欣興國票97購06,0.49,0.49,0.49,0.49,0.00,0.00,20000,2,9800,0,0,0,0,0,0,0,20000,-20000,-20000
20200528,055323,貿聯國票98購01,0.88,0.89,0.88,0.89,+0.04,4.71,74000,2,65460,0,0,0,0,0,0,0,74000,-74000,-74000
20200528,055324,TPK國票98購03,0.59,0.59,0.59,0.59,+0.02,3.51,16000,1,9440,0,0,0,0,0,0,16000,0,16000,16000
20200528,055325,佐登國票98購01,,,,,0.00,0.00,0,0,0,0,0,0,0,0,0,0,0,0,0
20200528,055326,緯穎國票97購06,,,,,0.00,0.00,0,0,0,0,0,0,0,0,0,0,0,0,0
20200528,055327,致新國票98購01,5.30,5.95,5.30,5.70,+0.25,4.59,153000,15,855200,0,0,0,0,0,0,140000,45000,95000,95000
20200528,055328,鈺齊國票98購01,0.02,0.02,0.02,0.02,0.00,0.00,100000,2,2000,0,0,0,0,0,0,0,0,0,0
20200528,055329,百和國票98購01,,,,,0.00,0.00,0,0,0,0,0,0,0,0,0,0,0,0,0
20200528,05532P,臺股指群益96售05,,,,,0.00,0.00,0,0,0,0,0,0,0,0,0,0,0,0,0
20200528,055330,上銀兆豐98購02,3.78,3.87,3.51,3.51,-0.15,-4.1,36000,17,133650,0,0,0,0,0,0,26000,10000,16000,16000
20200528,055331,國巨兆豐99購01,1.18,1.18,1.11,1.11,-0.01,-0.89,30000,3,34300,0,0,0,0,0,0,15000,15000,0,0
20200528,055332,奇力新兆豐98購01,,,,,0.00,0.00,0,0,0,0,0,0,0,0,0,0,0,0,0
20200528,055333,晶豪科兆豐97購01,2.21,2.21,2.20,2.20,+0.16,7.84,64000,3,140860,0,0,0,0,0,0,0,64000,-64000,-64000
20200528,055334,禾伸堂兆豐97購01,1.50,1.50,1.50,1.50,0.00,0.00,1000,1,1500,0,0,0,0,0,0,1000,0,1000,1000
20200528,055335,健策兆豐98購01,2.07,2.07,2.02,2.03,-0.04,-1.93,60000,21,122320,0,0,0,0,0,0,60000,0,60000,60000
20200528,055336,茂林兆豐98購01,1.41,1.43,1.35,1.35,-0.21,-13.46,95000,26,133430,0,0,0,0,0,0,95000,0,95000,95000
20200528,055337,超眾兆豐98購01,0.58,0.58,0.58,0.58,-0.03,-4.92,80000,5,46400,0,0,0,0,0,0,0,80000,-80000,-80000
20200528,055338,GIS兆豐97購01,0.84,0.84,0.59,0.59,-0.10,-14.49,334000,18,238550,0,0,0,0,0,0,143000,191000,-48000,-48000
20200528,055339,緯穎兆豐98購01,,,,,0.00,0.00,0,0,0,0,0,0,0,0,0,0,0,0,0
20200528,05533P,滬深2X富邦97售01,,,,,0.00,0.00,0,0,0,0,0,0,0,0,0,0,0,0,0
20200528,055340,華新科日盛97購01,0.02,0.02,0.02,0.02,0.00,0.00,100000,1,2000,0,0,0,0,0,0,0,100000,-100000,-100000
20200528,055341,台達電凱基97購02,,,,,0.00,0.00,0,0,0,0,0,0,0,0,0,0,0,0,0
20200528,055342,鴻海凱基97購04,,,,,0.00,0.00,0,0,0,0,0,0,0,0,0,0,0,0,0
20200528,055343,國巨凱基97購03,0.33,0.34,0.31,0.31,-0.02,-6.06,294000,6,97380,0,0,0,0,0,0,180000,114000,66000,66000
20200528,055344,國巨凱基97購04,,,,,0.00,0.00,0,0,0,0,0,0,0,0,0,0,0,0,0
20200528,055345,國巨凱基98購01,,,,,0.00,0.00,0,0,0,0,0,0,0,0,0,0,0,0,0
20200528,055346,國巨凱基98購02,,,,,0.00,0.00,0,0,0,0,0,0,0,0,0,0,0,0,0
20200528,055347,台積電凱基97購10,,,,,0.00,0.00,0,0,0,0,0,0,0,0,0,0,0,0,0
20200528,055348,旺宏凱基97購01,0.24,0.24,0.24,0.24,-0.03,-11.11,100000,1,24000,0,0,0,0,0,0,0,100000,-100000,-100000
20200528,055349,京元電凱基97購02,,,,,0.00,0.00,0,0,0,0,0,0,0,0,0,0,0,0,0
20200528,05534P,元油反元大96售06,,,,,0.00,0.00,0,0,0,0,0,0,0,0,0,0,0,0,0
20200528,055350,聯發科凱基97購02,2.70,2.70,2.41,2.48,-0.14,-5.34,154000,12,392050,0,0,0,0,0,0,154000,0,154000,154000
20200528,055351,聯發科凱基97購03,5.90,5.90,5.60,5.60,0.00,0.00,15000,2,85500,0,0,0,0,0,0,0,15000,-15000,-15000
20200528,055352,奇力新凱基97購01,,,,,0.00,0.00,0,0,0,0,0,0,0,0,0,0,0,0,0
20200528,055353,華新科凱基98購03,,,,,0.00,0.00,0,0,0,0,0,0,0,0,0,0,0,0,0
20200528,055354,宏達電凱基98購01,,,,,0.00,0.00,0,0,0,0,0,0,0,0,0,0,0,0,0
20200528,055355,大立光凱基97購05,,,,,0.00,0.00,0,0,0,0,0,0,0,0,0,0,0,0,0
20200528,055356,大立光凱基97購06,,,,,0.00,0.00,0,0,0,0,0,0,0,0,0,0,0,0,0
20200528,055357,欣興凱基97購04,1.36,1.36,1.36,1.36,+0.03,2.26,50000,1,68000,0,0,0,0,0,0,0,50000,-50000,-50000
20200528,055358,臻鼎凱基97購01,0.98,0.98,0.98,0.98,-0.15,-13.27,5000,1,4900,0,0,0,0,0,0,5000,0,5000,5000
20200528,055359,超眾凱基97購01,,,,,0.00,0.00,0,0,0,0,0,0,0,0,0,0,0,0,0
20200528,05535P,台積電元大97售06,0.40,0.40,0.40,0.40,0.00,0.00,150000,15,60000,0,0,0,0,0,0,0,150000,-150000,-150000
20200528,055360,台表科凱基97購02,,,,,0.00,0.00,0,0,0,0,0,0,0,0,0,0,0,0,0
20200528,055361,樺漢凱基97購01,,,,,0.00,0.00,0,0,0,0,0,0,0,0,0,0,0,0,0
20200528,055362,GIS凱基97購03,,,,,0.00,0.00,0,0,0,0,0,0,0,0,0,0,0,0,0
20200528,055363,緯穎凱基98購03,,,,,0.00,0.00,0,0,0,0,0,0,0,0,0,0,0,0,0
20200528,055364,矽創凱基97購03,,,,,0.00,0.00,0,0,0,0,0,0,0,0,0,0,0,0,0
20200528,055365,華通元大97購03,1.52,1.52,1.30,1.30,+0.30,30.0,115000,13,160040,0,0,0,0,0,0,31000,84000,-53000,-53000
20200528,055366,國巨元大98購05,,,,,0.00,0.00,0,0,0,0,0,0,0,0,0,0,0,0,0
20200528,055367,台積電元大97購23,,,,,0.00,0.00,0,0,0,0,0,0,0,0,0,0,0,0,0
20200528,055368,台積電元大97購24,,,,,0.00,0.00,0,0,0,0,0,0,0,0,0,0,0,0,0
20200528,055369,友訊元大97購01,,,,,0.00,0.00,0,0,0,0,0,0,0,0,0,0,0,0,0
20200528,05536P,奇力新元大96售03,,,,,0.00,0.00,0,0,0,0,0,0,0,0,0,0,0,0,0
20200528,055370,旺宏元大97購05,,,,,0.00,0.00,0,0,0,0,0,0,0,0,0,0,0,0,0
20200528,055371,正崴元大97購02,0.31,0.31,0.31,0.31,0.00,0.00,3000,1,930,0,0,0,0,0,0,3000,0,3000,3000
20200528,055372,宏達電元大97購04,,,,,0.00,0.00,0,0,0,0,0,0,0,0,0,0,0,0,0
20200528,055373,聯詠元大97購03,1.12,1.17,1.12,1.17,0.00,0.00,140000,4,157300,0,0,0,0,0,0,30000,110000,-80000,-80000
20200528,055374,明泰元大97購01,,,,,0.00,0.00,0,0,0,0,0,0,0,0,0,0,0,0,0
20200528,055375,京鼎元大97購03,,,,,0.00,0.00,0,0,0,0,0,0,0,0,0,0,0,0,0
20200528,055376,群創元大01購01,,,,,0.00,0.00,0,0,0,0,0,0,0,0,0,0,0,0,0
20200528,055377,揚明光元大98購01,0.53,0.53,0.53,0.53,-0.15,-22.06,3000,1,1590,0,0,0,0,0,0,3000,0,3000,3000
20200528,055378,晶相光元大97購02,,,,,0.00,0.00,0,0,0,0,0,0,0,0,0,0,0,0,0
20200528,055379,牧德元大97購03,,,,,0.00,0.00,0,0,0,0,0,0,0,0,0,0,0,0,0
20200528,05537P,群創中信98售01,1.20,1.20,1.20,1.20,0.00,0.00,25000,1,30000,0,0,0,0,0,0,0,25000,-25000,-25000
20200528,055380,智易元大98購02,1.45,1.65,1.40,1.40,-0.02,-1.41,105000,10,159470,0,0,0,0,0,0,27000,78000,-51000,-51000
20200528,055381,茂林元大97購02,3.24,3.24,2.92,3.00,-0.17,-5.36,67000,7,202520,0,0,0,0,0,0,17000,50000,-33000,-33000
20200528,055382,台郡元大99購01,,,,,0.00,0.00,0,0,0,0,0,0,0,0,0,0,0,0,0
20200528,055383,GIS元大97購02,,,,,0.00,0.00,0,0,0,0,0,0,0,0,0,0,0,0,0
20200528,055384,緯穎元大98購02,3.39,3.63,3.39,3.63,+0.21,6.14,18000,2,63420,0,0,0,0,0,0,18000,0,18000,18000
20200528,055385,昇陽半元大98購01,,,,,0.00,0.00,0,0,0,0,0,0,0,0,0,0,0,0,0
20200528,055386,致新元大97購02,1.93,1.93,1.93,1.93,0.00,0.00,10000,1,19300,0,0,0,0,0,0,0,10000,-10000,-10000
20200528,055387,世紀鋼元大97購01,2.10,2.60,2.10,2.60,0.00,0.00,8000,4,19960,0,0,0,0,0,0,3000,0,3000,3000
20200528,055388,華通統一97購03,1.86,2.06,1.71,1.71,+0.17,11.04,128000,12,251880,0,0,0,0,0,0,20000,108000,-88000,-88000
20200528,055389,國巨統一98購02,0.47,0.47,0.45,0.45,-0.01,-2.17,116000,2,52500,0,0,0,0,0,0,116000,0,116000,116000
20200528,05538P,玉晶光國票97售02,0.89,0.89,0.75,0.87,-0.13,-13.0,168000,13,141770,0,0,0,0,0,0,18000,150000,-132000,-132000
20200528,055390,國巨統一98購03,,,,,0.00,0.00,0,0,0,0,0,0,0,0,0,0,0,0,0
20200528,055391,光罩統一97購02,,,,,0.00,0.00,0,0,0,0,0,0,0,0,0,0,0,0,0
20200528,055392,凱美統一97購03,,,,,0.00,0.00,0,0,0,0,0,0,0,0,0,0,0,0,0
20200528,055393,華新科統一97購03,0.52,0.52,0.45,0.45,-0.11,-19.64,71000,3,36710,0,0,0,0,0,0,71000,0,71000,71000
20200528,055394,健策統一97購01,1.49,1.49,1.26,1.26,-0.27,-17.65,26000,6,35080,0,0,0,0,0,0,26000,0,26000,26000
20200528,055395,泰鼎統一97購01,,,,,0.00,0.00,0,0,0,0,0,0,0,0,0,0,0,0,0
20200528,055396,瑞儀統一97購01,,,,,0.00,0.00,0,0,0,0,0,0,0,0,0,0,0,0,0
20200528,055397,超眾統一97購02,0.12,0.12,0.12,0.12,0.00,0.00,50000,1,6000,0,0,0,0,0,0,50000,0,50000,50000
20200528,055398,超眾統一97購03,0.97,1.01,0.92,0.99,-0.13,-11.61,259000,7,251950,0,0,0,0,0,0,216000,43000,173000,173000
20200528,055399,超眾統一99購01,0.26,0.28,0.26,0.28,0.00,0.00,18000,3,4790,0,0,0,0,0,0,18000,0,18000,18000
20200528,05539P,鎧勝永豐96售01,,,,,0.00,0.00,0,0,0,0,0,0,0,0,0,0,0,0,0
20200528,055400,緯穎統一97購01,,,,,0.00,0.00,0,0,0,0,0,0,0,0,0,0,0,0,0
20200528,055401,亞光元富9A購01,,,,,0.00,0.00,0,0,0,0,0,0,0,0,0,0,0,0,0
20200528,055402,正文元富97購02,0.66,0.67,0.62,0.62,-0.03,-4.62,90000,6,58600,0,0,0,0,0,0,40000,50000,-10000,-10000
20200528,055403,泰鼎元富97購01,,,,,0.00,0.00,0,0,0,0,0,0,0,0,0,0,0,0,0
20200528,055404,超眾元富97購01,0.25,0.25,0.25,0.25,-0.03,-10.71,6000,1,1500,0,0,0,0,0,0,6000,0,6000,6000
20200528,055405,華泰國泰98購01,,,,,0.00,0.00,0,0,0,0,0,0,0,0,0,0,0,0,0
20200528,055406,大毅國泰99購01,,,,,0.00,0.00,0,0,0,0,0,0,0,0,0,0,0,0,0
20200528,055407,祥碩國泰98購01,,,,,0.00,0.00,0,0,0,0,0,0,0,0,0,0,0,0,0
20200528,055408,力成國泰98購01,1.53,1.53,1.24,1.24,-0.11,-8.15,53000,4,68620,0,0,0,0,0,0,43000,53000,-10000,-10000
20200528,055409,元黃金富邦01購01,1.54,1.54,1.54,1.54,+0.10,6.94,2000,2,3080,0,0,0,0,0,0,0,2000,-2000,-2000
20200528,05540P,亞德客凱基96售01,,,,,0.00,0.00,0,0,0,0,0,0,0,0,0,0,0,0,0
20200528,055410,元油反富邦9A購01,,,,,0.00,0.00,0,0,0,0,0,0,0,0,0,0,0,0,0
20200528,055411,國巨富邦9A購02,0.20,0.20,0.15,0.18,-0.02,-10.0,170000,11,28260,0,0,0,0,0,0,0,90000,-90000,-90000
20200528,055412,旺宏富邦99購01,,,,,0.00,0.00,0,0,0,0,0,0,0,0,0,0,0,0,0
20200528,055413,全新富邦98購01,,,,,0.00,0.00,0,0,0,0,0,0,0,0,0,0,0,0,0
20200528,055414,奇力新富邦9B購01,0.11,0.13,0.11,0.13,0.00,0.00,30000,2,3700,0,0,0,0,0,0,10000,0,10000,10000
20200528,055415,禾伸堂富邦9B購01,0.60,0.60,0.60,0.60,0.00,0.00,4000,1,2400,0,0,0,0,0,0,0,4000,-4000,-4000
20200528,055416,欣興富邦98購01,,,,,0.00,0.00,0,0,0,0,0,0,0,0,0,0,0,0,0
20200528,055417,健策富邦98購02,0.46,0.56,0.27,0.27,-0.05,-15.62,777000,15,244530,0,0,0,0,0,0,689000,310000,379000,379000
20200528,055418,華通永豐97購01,,,,,0.00,0.00,0,0,0,0,0,0,0,0,0,0,0,0,0
20200528,055419,國巨永豐97購03,,,,,0.00,0.00,0,0,0,0,0,0,0,0,0,0,0,0,0
20200528,05541P,鴻海統一96售08,,,,,0.00,0.00,0,0,0,0,0,0,0,0,0,0,0,0,0
20200528,055420,欣興永豐98購01,,,,,0.00,0.00,0,0,0,0,0,0,0,0,0,0,0,0,0
20200528,055421,玉晶光永豐98購04,0.51,0.51,0.51,0.51,+0.01,2.0,10000,1,5100,0,0,0,0,0,0,0,10000,-10000,-10000
20200528,055422,康控永豐97購01,,,,,0.00,0.00,0,0,0,0,0,0,0,0,0,0,0,0,0
20200528,055423,亞光亞東99購01,,,,,0.00,0.00,0,0,0,0,0,0,0,0,0,0,0,0,0
20200528,055424,聚陽群益98購01,0.39,0.39,0.38,0.38,-0.04,-9.52,88000,2,34040,0,0,0,0,0,0,88000,0,88000,88000
20200528,055425,聚陽群益99購01,0.57,0.57,0.57,0.57,-0.04,-6.56,50000,1,28500,0,0,0,0,0,0,50000,0,50000,50000
20200528,055426,旺宏群益99購02,1.34,1.35,1.20,1.20,-0.13,-9.77,41000,6,54300,0,0,0,0,0,0,30000,11000,19000,19000
20200528,055427,技嘉群益98購01,,,,,0.00,0.00,0,0,0,0,0,0,0,0,0,0,0,0,0
20200528,055428,友達群益9C購01,,,,,0.00,0.00,0,0,0,0,0,0,0,0,0,0,0,0,0
20200528,055429,華新科群益99購01,,,,,0.00,0.00,0,0,0,0,0,0,0,0,0,0,0,0,0
20200528,05542P,滬深2X元富96售01,,,,,0.00,0.00,0,0,0,0,0,0,0,0,0,0,0,0,0
20200528,055430,宏達電群益97購01,0.37,0.37,0.37,0.37,-0.11,-22.92,104000,1,38480,0,0,0,0,0,0,104000,0,104000,104000
20200528,055431,和鑫群益98購01,,,,,0.00,0.00,0,0,0,0,0,0,0,0,0,0,0,0,0
20200528,055432,臻鼎群益97購02,1.31,1.31,1.26,1.26,-0.14,-10.0,57000,2,71870,0,0,0,0,0,0,56000,1000,55000,55000
20200528,055433,嘉聯益群益99購01,0.67,0.74,0.67,0.68,+0.03,4.62,682000,15,487280,0,0,0,0,0,0,98000,584000,-486000,-486000
20200528,055434,樺漢群益97購01,,,,,0.00,0.00,0,0,0,0,0,0,0,0,0,0,0,0,0
20200528,055435,佳世達中信99購01,0.10,0.10,0.10,0.10,0.00,0.00,20000,2,2000,0,0,0,0,0,0,0,20000,-20000,-20000
20200528,055436,晶豪科中信99購01,,,,,0.00,0.00,0,0,0,0,0,0,0,0,0,0,0,0,0
20200528,055437,禾伸堂中信99購01,1.30,1.31,1.21,1.21,-0.12,-9.02,187000,11,240870,0,0,0,0,0,0,77000,110000,-33000,-33000
20200528,055438,鴻海國票98購01,,,,,0.00,0.00,0,0,0,0,0,0,0,0,0,0,0,0,0
20200528,055439,台表科國票98購02,2.03,2.03,1.72,1.74,-0.18,-9.38,44000,7,82960,0,0,0,0,0,0,20000,24000,-4000,-4000
20200528,05543P,鴻海元富96售04,,,,,0.00,0.00,0,0,0,0,0,0,0,0,0,0,0,0,0
20200528,055440,矽力國票98購01,13.90,14.20,13.90,13.90,+1.20,9.45,44000,5,619600,0,0,0,0,0,0,8000,36000,-28000,-28000
20200528,055441,緯穎國票98購01,,,,,0.00,0.00,0,0,0,0,0,0,0,0,0,0,0,0,0
20200528,055442,矽創國票98購02,1.46,1.73,1.46,1.55,+0.27,21.09,459000,13,706700,0,0,0,0,0,0,61000,398000,-337000,-337000
20200528,055443,台虹國票98購01,1.81,1.81,1.66,1.66,-0.17,-9.29,22000,2,39070,0,0,0,0,0,0,17000,5000,12000,12000
20200528,055444,致新台新97購01,2.32,2.59,2.32,2.59,+0.51,24.52,174000,15,433570,0,0,0,0,0,0,0,174000,-174000,-174000
20200528,055445,旺宏統一99購01,,,,,0.00,0.00,0,0,0,0,0,0,0,0,0,0,0,0,0
20200528,055446,奇力新統一9A購01,0.27,0.27,0.23,0.23,0.00,0.00,60000,5,15000,0,0,0,0,0,0,0,60000,-60000,-60000
20200528,055447,華新科統一97購04,,,,,0.00,0.00,0,0,0,0,0,0,0,0,0,0,0,0,0
20200528,055448,健策統一97購02,,,,,0.00,0.00,0,0,0,0,0,0,0,0,0,0,0,0,0
20200528,055449,超眾統一9A購01,1.80,1.80,1.59,1.64,-0.05,-2.96,175000,9,289920,0,0,0,0,0,0,14000,158000,-144000,-144000
20200528,05544P,台表科元富96售01,,,,,0.00,0.00,0,0,0,0,0,0,0,0,0,0,0,0,0
20200528,055450,台積電元富97購01,,,,,0.00,0.00,0,0,0,0,0,0,0,0,0,0,0,0,0
20200528,055451,台積電元富97購02,,,,,0.00,0.00,0,0,0,0,0,0,0,0,0,0,0,0,0
20200528,055452,台積電元富97購03,,,,,0.00,0.00,0,0,0,0,0,0,0,0,0,0,0,0,0
20200528,055453,華邦電元富97購01,,,,,0.00,0.00,0,0,0,0,0,0,0,0,0,0,0,0,0
20200528,055454,華邦電元富97購02,,,,,0.00,0.00,0,0,0,0,0,0,0,0,0,0,0,0,0
20200528,055455,健策國泰98購02,,,,,0.00,0.00,0,0,0,0,0,0,0,0,0,0,0,0,0
20200528,055456,上銀富邦99購01,1.91,1.91,1.91,1.91,+0.07,3.8,10000,1,19100,0,0,0,0,0,0,10000,0,10000,10000
20200528,055457,聚陽永豐97購01,,,,,0.00,0.00,0,0,0,0,0,0,0,0,0,0,0,0,0
20200528,055458,燿華永豐98購01,,,,,0.00,0.00,0,0,0,0,0,0,0,0,0,0,0,0,0
20200528,055459,建準永豐97購03,3.41,4.01,3.41,4.01,+0.39,10.77,86000,11,314980,0,0,0,0,0,0,7000,79000,-72000,-72000
20200528,05545P,台表科國泰98售01,0.90,0.90,0.54,0.63,+0.04,6.78,534000,20,312870,0,0,0,0,0,0,203000,330000,-127000,-127000
20200528,055460,華擎永豐97購01,4.72,5.05,4.60,4.60,-0.10,-2.13,21000,3,101220,0,0,0,0,0,0,11000,10000,1000,1000
20200528,055461,TPK永豐97購01,,,,,0.00,0.00,0,0,0,0,0,0,0,0,0,0,0,0,0
20200528,055462,華邦電日盛97購01,,,,,0.00,0.00,0,0,0,0,0,0,0,0,0,0,0,0,0
20200528,055463,國喬凱基97購01,,,,,0.00,0.00,0,0,0,0,0,0,0,0,0,0,0,0,0
20200528,055464,聚陽凱基97購01,0.18,0.18,0.17,0.17,0.00,0.00,200000,20,35000,0,0,0,0,0,0,0,180000,-180000,-180000
20200528,055465,和大凱基97購03,,,,,0.00,0.00,0,0,0,0,0,0,0,0,0,0,0,0,0
20200528,055466,台達電凱基97購03,,,,,0.00,0.00,0,0,0,0,0,0,0,0,0,0,0,0,0
20200528,055467,國巨凱基97購05,,,,,0.00,0.00,0,0,0,0,0,0,0,0,0,0,0,0,0
20200528,055468,智邦凱基97購04,9.25,9.25,9.25,9.25,+1.40,17.83,1000,1,9250,0,0,0,0,0,0,0,1000,-1000,-1000
20200528,055469,台光電凱基97購01,,,,,0.00,0.00,0,0,0,0,0,0,0,0,0,0,0,0,0
20200528,05546P,全新元大97售01,,,,,0.00,0.00,0,0,0,0,0,0,0,0,0,0,0,0,0
20200528,055470,南亞科凱基97購01,0.46,0.46,0.41,0.41,-0.01,-2.38,25000,4,11000,0,0,0,0,0,0,10000,15000,-5000,-5000
20200528,055471,聯發科凱基97購04,,,,,0.00,0.00,0,0,0,0,0,0,0,0,0,0,0,0,0
20200528,055472,大立光凱基97購07,,,,,0.00,0.00,0,0,0,0,0,0,0,0,0,0,0,0,0
20200528,055473,禾伸堂凱基97購01,,,,,0.00,0.00,0,0,0,0,0,0,0,0,0,0,0,0,0
20200528,055474,欣興凱基97購05,0.83,0.92,0.83,0.92,0.00,0.00,3000,3,2640,0,0,0,0,0,0,0,3000,-3000,-3000
20200528,055475,臻鼎凱基97購02,,,,,0.00,0.00,0,0,0,0,0,0,0,0,0,0,0,0,0
20200528,055476,台郡凱基97購02,1.60,1.60,1.60,1.60,-0.04,-2.44,13000,1,20800,0,0,0,0,0,0,0,13000,-13000,-13000
20200528,055477,同欣電凱基98購01,,,,,0.00,0.00,0,0,0,0,0,0,0,0,0,0,0,0,0
20200528,055478,訊芯凱基97購01,,,,,0.00,0.00,0,0,0,0,0,0,0,0,0,0,0,0,0
20200528,055479,GIS凱基97購04,,,,,0.00,0.00,0,0,0,0,0,0,0,0,0,0,0,0,0
20200528,05547P,群創元大96售03,,,,,0.00,0.00,0,0,0,0,0,0,0,0,0,0,0,0,0
20200528,055480,元上證元大97購02,,,,,0.00,0.00,0,0,0,0,0,0,0,0,0,0,0,0,0
20200528,055481,聚陽元大97購01,0.42,0.42,0.42,0.42,-0.13,-23.64,160000,1,67200,0,0,0,0,0,0,160000,0,160000,160000
20200528,055482,聚陽元大97購02,,,,,0.00,0.00,0,0,0,0,0,0,0,0,0,0,0,0,0
20200528,055483,和大元大97購03,,,,,0.00,0.00,0,0,0,0,0,0,0,0,0,0,0,0,0
20200528,055484,華通元大97購04,,,,,0.00,0.00,0,0,0,0,0,0,0,0,0,0,0,0,0
20200528,055485,國巨元大97購09,,,,,0.00,0.00,0,0,0,0,0,0,0,0,0,0,0,0,0
20200528,055486,國巨元大98購06,,,,,0.00,0.00,0,0,0,0,0,0,0,0,0,0,0,0,0
20200528,055487,國巨元大98購07,,,,,0.00,0.00,0,0,0,0,0,0,0,0,0,0,0,0,0
20200528,055488,華邦電元大98購01,,,,,0.00,0.00,0,0,0,0,0,0,0,0,0,0,0,0,0
20200528,055489,瑞昱元大97購02,2.15,2.15,2.15,2.15,+0.14,6.97,8000,1,17200,0,0,0,0,0,0,8000,0,8000,8000
20200528,05548P,臺股指元大96售02,0.87,0.87,0.87,0.87,-0.04,-4.4,1000,1,870,0,0,0,0,0,0,1000,0,1000,1000
20200528,055490,台光電元大97購01,2.06,2.06,2.06,2.06,-0.30,-12.71,10000,1,20600,0,0,0,0,0,0,10000,0,10000,10000
20200528,055491,奇力新元大98購03,,,,,0.00,0.00,0,0,0,0,0,0,0,0,0,0,0,0,0
20200528,055492,華新科元大97購08,,,,,0.00,0.00,0,0,0,0,0,0,0,0,0,0,0,0,0
20200528,055493,華新科元大97購09,,,,,0.00,0.00,0,0,0,0,0,0,0,0,0,0,0,0,0
20200528,055494,華新科元大98購01,,,,,0.00,0.00,0,0,0,0,0,0,0,0,0,0,0,0,0
20200528,055495,長榮航元大97購01,0.05,0.05,0.05,0.05,0.00,0.00,3000,2,150,0,0,0,0,0,0,3000,0,3000,3000
20200528,055496,高鐵元大97購02,1.11,1.11,0.70,0.70,-0.27,-27.84,463000,25,453210,0,0,0,0,0,0,315000,156000,159000,159000
20200528,055497,開發金元大97購01,0.55,0.55,0.53,0.53,-0.04,-7.02,198000,3,105540,0,0,0,0,0,0,55000,143000,-88000,-88000
20200528,055498,大立光元大97購07,,,,,0.00,0.00,0,0,0,0,0,0,0,0,0,0,0,0,0
20200528,055499,大立光元大98購05,,,,,0.00,0.00,0,0,0,0,0,0,0,0,0,0,0,0,0
20200528,05549P,臺股指元大96售03,,,,,0.00,0.00,0,0,0,0,0,0,0,0,0,0,0,0,0
20200528,055500,京鼎元大97購04,,,,,0.00,0.00,0,0,0,0,0,0,0,0,0,0,0,0,0
20200528,055501,創意元大97購01,1.03,1.03,1.01,1.01,-0.01,-0.98,15000,4,15210,0,0,0,0,0,0,1000,10000,-9000,-9000
20200528,055502,群創元大9C購03,,,,,0.00,0.00,0,0,0,0,0,0,0,0,0,0,0,0,0
20200528,055503,健策元大98購05,1.04,1.06,1.04,1.06,+0.06,6.0,25000,3,26100,0,0,0,0,0,0,25000,0,25000,25000
20200528,055504,貿聯元大98購04,,,,,0.00,0.00,0,0,0,0,0,0,0,0,0,0,0,0,0
20200528,055505,新唐元大97購02,0.24,0.29,0.24,0.29,+0.06,26.09,85000,8,21250,0,0,0,0,0,0,30000,55000,-25000,-25000
20200528,055506,台郡元大99購02,,,,,0.00,0.00,0,0,0,0,0,0,0,0,0,0,0,0,0
20200528,055507,樺漢元大98購02,0.16,0.16,0.16,0.16,+0.01,6.67,90000,1,14400,0,0,0,0,0,0,90000,0,90000,90000
20200528,055508,矽力元大97購01,,,,,0.00,0.00,0,0,0,0,0,0,0,0,0,0,0,0,0
20200528,055509,訊芯元大97購03,,,,,0.00,0.00,0,0,0,0,0,0,0,0,0,0,0,0,0
20200528,05550P,臺股指元大96售07,,,,,0.00,0.00,0,0,0,0,0,0,0,0,0,0,0,0,0
20200528,055510,GIS元大97購03,,,,,0.00,0.00,0,0,0,0,0,0,0,0,0,0,0,0,0
20200528,055511,大立光兆豐97購02,0.03,0.03,0.03,0.03,0.00,0.00,20000,1,600,0,0,0,0,0,0,20000,0,20000,20000
20200528,055512,聯詠兆豐97購01,,,,,0.00,0.00,0,0,0,0,0,0,0,0,0,0,0,0,0
20200528,055513,旺宏亞東98購01,,,,,0.00,0.00,0,0,0,0,0,0,0,0,0,0,0,0,0
20200528,055514,亞光麥證97購01,,,,,0.00,0.00,0,0,0,0,0,0,0,0,0,0,0,0,0
20200528,055515,聚陽中信9A購01,0.39,0.39,0.37,0.37,-0.05,-11.9,45000,4,16750,0,0,0,0,0,0,25000,20000,5000,5000
20200528,055516,上銀中信97購01,1.24,1.24,1.24,1.24,+0.05,4.2,4000,1,4960,0,0,0,0,0,0,0,0,0,0
20200528,055517,國巨中信97購03,,,,,0.00,0.00,0,0,0,0,0,0,0,0,0,0,0,0,0
20200528,055518,華新科中信99購01,0.12,0.12,0.12,0.12,-0.03,-20.0,130000,7,15600,0,0,0,0,0,0,0,120000,-120000,-120000
20200528,055519,茂林中信99購01,1.06,1.06,0.96,0.98,-0.42,-30.0,114000,25,114340,0,0,0,0,0,0,94000,20000,74000,74000
20200528,05551P,電子類元大96售01,,,,,0.00,0.00,0,0,0,0,0,0,0,0,0,0,0,0,0
20200528,055520,矽力中信97購02,,,,,0.00,0.00,0,0,0,0,0,0,0,0,0,0,0,0,0
20200528,055521,S&P反1群益01購01,2.14,2.16,2.14,2.14,-0.07,-3.17,56000,5,119860,0,0,0,0,0,0,0,56000,-56000,-56000
20200528,055522,道瓊反群益01購01,,,,,0.00,0.00,0,0,0,0,0,0,0,0,0,0,0,0,0
20200528,055523,道瓊銀群益9A購01,,,,,0.00,0.00,0,0,0,0,0,0,0,0,0,0,0,0,0
20200528,055524,鴻海群益98購01,,,,,0.00,0.00,0,0,0,0,0,0,0,0,0,0,0,0,0
20200528,055525,國巨群益98購05,2.01,2.04,1.96,1.96,-0.02,-1.01,81000,6,163230,0,0,0,0,0,0,41000,41000,0,0
20200528,055526,台積電群益97購02,,,,,0.00,0.00,0,0,0,0,0,0,0,0,0,0,0,0,0
20200528,055527,旺宏群益99購03,1.23,1.25,1.23,1.25,+0.02,1.63,186000,12,230740,0,0,0,0,0,0,186000,0,186000,186000
20200528,055528,華邦電群益97購01,,,,,0.00,0.00,0,0,0,0,0,0,0,0,0,0,0,0,0
20200528,055529,華邦電群益97購02,,,,,0.00,0.00,0,0,0,0,0,0,0,0,0,0,0,0,0
20200528,05552P,聯詠群益96售01,,,,,0.00,0.00,0,0,0,0,0,0,0,0,0,0,0,0,0
20200528,055530,聯發科群益98購01,,,,,0.00,0.00,0,0,0,0,0,0,0,0,0,0,0,0,0
20200528,055531,華新科群益98購03,0.34,0.34,0.34,0.34,-0.04,-10.53,10000,1,3400,0,0,0,0,0,0,0,10000,-10000,-10000
20200528,055532,中工群益98購01,,,,,0.00,0.00,0,0,0,0,0,0,0,0,0,0,0,0,0
20200528,055533,大立光群益97購03,0.73,0.73,0.73,0.73,+0.04,5.8,17000,1,12410,0,0,0,0,0,0,17000,0,17000,17000
20200528,055534,晶技群益97購03,,,,,0.00,0.00,0,0,0,0,0,0,0,0,0,0,0,0,0
20200528,055535,緯創群益98購01,0.50,0.50,0.50,0.50,0.00,0.00,10000,1,5000,0,0,0,0,0,0,10000,0,10000,10000
20200528,055536,嘉聯益群益99購02,0.78,0.87,0.78,0.87,0.00,0.00,417000,5,348700,0,0,0,0,0,0,0,417000,-417000,-417000
20200528,055537,康友群益97購03,,,,,0.00,0.00,0,0,0,0,0,0,0,0,0,0,0,0,0
20200528,055538,鴻海日盛97購04,0.02,0.03,0.02,0.03,0.00,0.00,2099000,21,53070,0,0,0,0,0,0,1899000,0,1899000,1899000
20200528,055539,億光台新97購01,,,,,0.00,0.00,0,0,0,0,0,0,0,0,0,0,0,0,0
20200528,05553P,智原群益96售01,,,,,0.00,0.00,0,0,0,0,0,0,0,0,0,0,0,0,0
20200528,055540,京鼎台新97購01,,,,,0.00,0.00,0,0,0,0,0,0,0,0,0,0,0,0,0
20200528,055541,聚陽凱基98購01,0.30,0.30,0.30,0.30,+0.01,3.45,45000,2,13500,0,0,0,0,0,0,45000,0,45000,45000
20200528,055542,亞德客凱基97購01,,,,,0.00,0.00,0,0,0,0,0,0,0,0,0,0,0,0,0
20200528,055543,為升凱基97購01,,,,,0.00,0.00,0,0,0,0,0,0,0,0,0,0,0,0,0
20200528,055544,鴻海凱基97購05,,,,,0.00,0.00,0,0,0,0,0,0,0,0,0,0,0,0,0
20200528,055545,國巨凱基97購06,1.24,1.24,1.10,1.15,-0.07,-5.74,28000,6,33930,0,0,0,0,0,0,18000,11000,7000,7000
20200528,055546,台積電凱基97購12,,,,,0.00,0.00,0,0,0,0,0,0,0,0,0,0,0,0,0
20200528,055547,台積電凱基97購13,,,,,0.00,0.00,0,0,0,0,0,0,0,0,0,0,0,0,0
20200528,055548,旺宏凱基97購02,,,,,0.00,0.00,0,0,0,0,0,0,0,0,0,0,0,0,0
20200528,055549,旺宏凱基97購03,0.79,0.82,0.78,0.78,-0.03,-3.7,118000,12,94540,0,0,0,0,0,0,118000,0,118000,118000
20200528,05554P,群創群益96售02,,,,,0.00,0.00,0,0,0,0,0,0,0,0,0,0,0,0,0
20200528,055550,華邦電凱基97購03,,,,,0.00,0.00,0,0,0,0,0,0,0,0,0,0,0,0,0
20200528,055551,致茂凱基98購01,0.32,0.32,0.32,0.32,-0.01,-3.03,10000,1,3200,0,0,0,0,0,0,10000,0,10000,10000
20200528,055552,瑞昱凱基97購02,,,,,0.00,0.00,0,0,0,0,0,0,0,0,0,0,0,0,0
20200528,055553,聯發科凱基97購05,,,,,0.00,0.00,0,0,0,0,0,0,0,0,0,0,0,0,0
20200528,055554,聯發科凱基97購06,,,,,0.00,0.00,0,0,0,0,0,0,0,0,0,0,0,0,0
20200528,055555,全新凱基9A購01,0.41,0.41,0.41,0.41,0.00,0.00,20000,1,8200,0,0,0,0,0,0,0,20000,-20000,-20000
20200528,055556,奇力新凱基98購03,0.26,0.26,0.26,0.26,-0.05,-16.13,100000,1,26000,0,0,0,0,0,0,0,100000,-100000,-100000
20200528,055557,華新科凱基97購01,0.27,0.27,0.27,0.27,0.00,0.00,33000,1,8910,0,0,0,0,0,0,0,33000,-33000,-33000
20200528,055558,大立光凱基97購08,,,,,0.00,0.00,0,0,0,0,0,0,0,0,0,0,0,0,0
20200528,055559,大立光凱基97購09,,,,,0.00,0.00,0,0,0,0,0,0,0,0,0,0,0,0,0
20200528,05555P,健策群益98售01,,,,,0.00,0.00,0,0,0,0,0,0,0,0,0,0,0,0,0
20200528,055560,大立光凱基97購10,,,,,0.00,0.00,0,0,0,0,0,0,0,0,0,0,0,0,0
20200528,055561,奇鋐凱基97購01,0.69,0.83,0.69,0.74,+0.08,12.12,226000,14,170480,0,0,0,0,0,0,200000,86000,114000,114000
20200528,055562,欣興凱基97購06,1.44,1.50,1.44,1.50,+0.16,11.94,105000,5,153190,0,0,0,0,0,0,0,105000,-105000,-105000
20200528,055563,智易凱基97購02,1.14,1.17,1.13,1.13,0.00,0.00,56000,6,64360,0,0,0,0,0,0,0,56000,-56000,-56000
20200528,055564,茂林凱基98購01,0.73,0.73,0.73,0.73,-0.29,-28.43,15000,1,10950,0,0,0,0,0,0,15000,0,15000,15000
20200528,055565,祥碩凱基97購01,,,,,0.00,0.00,0,0,0,0,0,0,0,0,0,0,0,0,0
20200528,055566,台表科凱基97購03,1.49,1.49,1.49,1.49,+0.01,0.68,20000,1,29800,0,0,0,0,0,0,20000,0,20000,20000
20200528,055567,訊芯凱基98購02,,,,,0.00,0.00,0,0,0,0,0,0,0,0,0,0,0,0,0
20200528,055568,緯穎凱基97購02,4.04,4.04,3.40,3.40,-0.51,-13.04,16000,3,60450,0,0,0,0,0,0,16000,6000,10000,10000
20200528,055569,聚陽統一98購01,0.56,0.58,0.50,0.50,-0.09,-15.25,173000,8,91580,0,0,0,0,0,0,8000,151000,-143000,-143000
20200528,05556P,全新國票96售04,,,,,0.00,0.00,0,0,0,0,0,0,0,0,0,0,0,0,0
20200528,055570,華通統一98購03,,,,,0.00,0.00,0,0,0,0,0,0,0,0,0,0,0,0,0
20200528,055571,鴻海統一97購03,,,,,0.00,0.00,0,0,0,0,0,0,0,0,0,0,0,0,0
20200528,055572,鴻海統一98購04,2.08,2.08,2.02,2.02,-0.04,-1.94,13000,7,26920,0,0,0,0,0,0,13000,13000,0,0
20200528,055573,國巨統一97購06,0.31,0.31,0.31,0.31,0.00,0.00,20000,2,6200,0,0,0,0,0,0,20000,20000,0,0
20200528,055574,美律統一97購01,,,,,0.00,0.00,0,0,0,0,0,0,0,0,0,0,0,0,0
20200528,055575,華新科統一98購01,0.63,0.63,0.63,0.63,-0.02,-3.08,20000,5,12600,0,0,0,0,0,0,20000,0,20000,20000
20200528,055576,嘉晶統一98購01,7.65,7.75,7.00,7.00,-1.10,-13.58,126000,6,945950,0,0,0,0,0,0,61000,65000,-4000,-4000
20200528,055577,晶技統一97購02,2.10,2.10,2.10,2.10,-0.37,-14.98,20000,4,42000,0,0,0,0,0,0,20000,0,20000,20000
20200528,055578,群創統一98購03,,,,,0.00,0.00,0,0,0,0,0,0,0,0,0,0,0,0,0
20200528,055579,健策統一9A購01,1.41,1.45,1.19,1.21,-0.10,-7.63,1957000,77,2614570,0,0,0,0,0,0,1160000,968000,192000,192000
20200528,05557P,S&P500中信96售02,,,,,0.00,0.00,0,0,0,0,0,0,0,0,0,0,0,0,0
20200528,055580,南茂統一97購01,,,,,0.00,0.00,0,0,0,0,0,0,0,0,0,0,0,0,0
20200528,055581,和大元大97購04,,,,,0.00,0.00,0,0,0,0,0,0,0,0,0,0,0,0,0
20200528,055582,亞德客元大97購01,3.59,3.59,2.74,2.77,0.00,0.00,160000,5,448400,0,0,0,0,0,0,150000,160000,-10000,-10000
20200528,055583,國巨元大97購10,1.48,1.48,1.31,1.31,-0.17,-11.49,137000,5,185470,0,0,0,0,0,0,2000,136000,-134000,-134000
20200528,055584,國巨元大97購11,0.87,0.87,0.87,0.87,0.00,0.00,47000,1,40890,0,0,0,0,0,0,0,47000,-47000,-47000
20200528,055585,國巨元大98購08,,,,,0.00,0.00,0,0,0,0,0,0,0,0,0,0,0,0,0
20200528,055586,旺宏元大98購06,1.75,1.78,1.71,1.71,+0.01,0.59,221000,7,387590,0,0,0,0,0,0,153000,68000,85000,85000
20200528,055587,智邦元大97購02,8.75,8.75,8.75,8.75,+1.40,19.05,2000,1,17500,0,0,0,0,0,0,2000,2000,0,0
20200528,055588,瑞昱元大97購03,,,,,0.00,0.00,0,0,0,0,0,0,0,0,0,0,0,0,0
20200528,055589,台光電元大98購04,,,,,0.00,0.00,0,0,0,0,0,0,0,0,0,0,0,0,0
20200528,05558P,鴻海麥證96售01,,,,,0.00,0.00,0,0,0,0,0,0,0,0,0,0,0,0,0
20200528,055590,聯發科元大98購02,,,,,0.00,0.00,0,0,0,0,0,0,0,0,0,0,0,0,0
20200528,055591,全新元大98購01,,,,,0.00,0.00,0,0,0,0,0,0,0,0,0,0,0,0,0
20200528,055592,奇力新元大97購07,,,,,0.00,0.00,0,0,0,0,0,0,0,0,0,0,0,0,0
20200528,055593,華新科元大97購10,,,,,0.00,0.00,0,0,0,0,0,0,0,0,0,0,0,0,0
20200528,055594,華新科元大98購02,1.66,1.66,1.66,1.66,-0.09,-5.14,47000,2,78020,0,0,0,0,0,0,14000,33000,-19000,-19000
20200528,055595,宏達電元大98購02,,,,,0.00,0.00,0,0,0,0,0,0,0,0,0,0,0,0,0
20200528,055596,新光金元大9B購02,,,,,0.00,0.00,0,0,0,0,0,0,0,0,0,0,0,0,0
20200528,055597,禾伸堂元大98購02,3.29,3.29,3.29,3.29,+0.01,0.3,10000,1,32900,0,0,0,0,0,0,10000,0,10000,10000
20200528,055598,欣興元大97購03,,,,,0.00,0.00,0,0,0,0,0,0,0,0,0,0,0,0,0
20200528,055599,TPK元大97購01,0.28,0.28,0.28,0.28,-0.02,-6.67,5000,1,1400,0,0,0,0,0,0,5000,0,5000,5000
20200528,05559P,臺股指麥證96售01,2.62,3.23,2.62,3.23,0.00,0.00,2000,2,5850,1000,1000,0,0,0,0,1000,1000,0,0
20200528,055600,致伸元大97購02,0.13,0.13,0.13,0.13,0.00,0.00,69000,1,8970,0,0,0,0,0,0,0,69000,-69000,-69000
20200528,055601,茂林元大97購03,,,,,0.00,0.00,0,0,0,0,0,0,0,0,0,0,0,0,0
20200528,055602,康控元大97購03,,,,,0.00,0.00,0,0,0,0,0,0,0,0,0,0,0,0,0
20200528,055603,超眾元大97購04,1.19,1.19,1.10,1.15,-0.35,-23.33,278000,12,315850,0,0,0,0,0,0,218000,60000,158000,158000
20200528,055604,訊芯元大98購02,0.31,0.31,0.31,0.31,0.00,0.00,68000,1,21080,0,0,0,0,0,0,0,68000,-68000,-68000
20200528,055605,緯穎元大97購02,3.08,3.08,2.96,2.96,0.00,0.00,144000,12,438660,0,0,0,0,0,0,144000,0,144000,144000
20200528,055606,矽創元大97購01,0.55,0.57,0.55,0.57,0.00,0.00,12000,4,6760,0,0,0,0,0,0,1000,3000,-2000,-2000
20200528,055607,華通康和97購01,,,,,0.00,0.00,0,0,0,0,0,0,0,0,0,0,0,0,0
20200528,055608,華邦電康和97購01,,,,,0.00,0.00,0,0,0,0,0,0,0,0,0,0,0,0,0
20200528,055609,旺宏國票99購01,,,,,0.00,0.00,0,0,0,0,0,0,0,0,0,0,0,0,0
20200528,05560P,友達兆豐96售01,,,,,0.00,0.00,0,0,0,0,0,0,0,0,0,0,0,0,0
20200528,055610,光磊國票98購01,,,,,0.00,0.00,0,0,0,0,0,0,0,0,0,0,0,0,0
20200528,055611,燿華國票98購02,0.09,0.10,0.09,0.10,-0.01,-9.09,124000,3,12150,0,0,0,0,0,0,15000,109000,-94000,-94000
20200528,055612,台光電國票97購04,,,,,0.00,0.00,0,0,0,0,0,0,0,0,0,0,0,0,0
20200528,055613,全新國票98購01,,,,,0.00,0.00,0,0,0,0,0,0,0,0,0,0,0,0,0
20200528,055614,華新科國票97購02,,,,,0.00,0.00,0,0,0,0,0,0,0,0,0,0,0,0,0
20200528,055615,宏達電國票99購02,0.65,0.65,0.65,0.65,-0.05,-7.14,10000,1,6500,0,0,0,0,0,0,0,10000,-10000,-10000
20200528,055616,智原國票97購03,,,,,0.00,0.00,0,0,0,0,0,0,0,0,0,0,0,0,0
20200528,055617,TPK國票98購04,0.66,0.72,0.66,0.66,-0.05,-7.04,127000,5,86520,0,0,0,0,0,0,36000,91000,-55000,-55000
20200528,055618,麗豐國票98購01,1.05,1.09,1.02,1.02,-0.07,-6.42,128000,3,134900,0,0,0,0,0,0,0,128000,-128000,-128000
20200528,055619,同欣電國票98購02,1.90,1.93,1.77,1.77,-0.06,-3.28,588000,10,1082110,0,0,0,0,0,0,369000,214000,155000,155000
20200528,05561P,大立光兆豐96售02,,,,,0.00,0.00,0,0,0,0,0,0,0,0,0,0,0,0,0
20200528,055620,樺漢國票98購01,1.36,1.36,1.32,1.32,-0.03,-2.22,86000,3,116080,0,0,0,0,0,0,22000,64000,-42000,-42000
20200528,055621,國巨國泰98購03,,,,,0.00,0.00,0,0,0,0,0,0,0,0,0,0,0,0,0
20200528,055622,群創國泰99購01,,,,,0.00,0.00,0,0,0,0,0,0,0,0,0,0,0,0,0
20200528,055623,貿聯國泰99購01,0.54,0.54,0.48,0.48,0.00,0.00,55000,6,27850,0,0,0,0,0,0,0,50000,-50000,-50000
20200528,055624,聯發科富邦99購07,,,,,0.00,0.00,0,0,0,0,0,0,0,0,0,0,0,0,0
20200528,055625,亞光富邦98購01,,,,,0.00,0.00,0,0,0,0,0,0,0,0,0,0,0,0,0
20200528,055626,力山永豐97購01,1.27,1.29,1.27,1.29,+0.03,2.38,50000,5,64300,0,0,0,0,0,0,10000,40000,-30000,-30000
20200528,055627,亞德客永豐97購02,1.92,2.09,1.92,2.08,+0.13,6.67,91000,17,176980,0,0,0,0,0,0,91000,10000,81000,81000
20200528,055628,旺宏永豐97購01,,,,,0.00,0.00,0,0,0,0,0,0,0,0,0,0,0,0,0
20200528,055629,華新科永豐97購04,,,,,0.00,0.00,0,0,0,0,0,0,0,0,0,0,0,0,0
20200528,05562P,鴻海元大96售16,,,,,0.00,0.00,0,0,0,0,0,0,0,0,0,0,0,0,0
20200528,055630,聯詠永豐97購02,,,,,0.00,0.00,0,0,0,0,0,0,0,0,0,0,0,0,0
20200528,055631,創意永豐98購01,0.95,1.02,0.95,1.02,+0.05,5.15,228000,12,223510,0,0,0,0,0,0,116000,112000,4000,4000
20200528,055632,群創永豐98購01,,,,,0.00,0.00,0,0,0,0,0,0,0,0,0,0,0,0,0
20200528,055633,牧德永豐97購02,,,,,0.00,0.00,0,0,0,0,0,0,0,0,0,0,0,0,0
20200528,055634,訊芯永豐97購02,,,,,0.00,0.00,0,0,0,0,0,0,0,0,0,0,0,0,0
20200528,055635,緯穎永豐97購01,0.96,1.00,0.80,0.80,-0.12,-13.04,70000,26,63710,0,0,0,0,0,0,20000,50000,-30000,-30000
20200528,055636,元油反元富97購02,,,,,0.00,0.00,0,0,0,0,0,0,0,0,0,0,0,0,0
20200528,055637,亞德客元富97購01,,,,,0.00,0.00,0,0,0,0,0,0,0,0,0,0,0,0,0
20200528,055638,上銀元富97購01,,,,,0.00,0.00,0,0,0,0,0,0,0,0,0,0,0,0,0
20200528,055639,上銀元富97購02,2.48,2.68,2.08,2.08,-0.35,-14.4,326000,47,810290,0,0,0,0,0,0,297000,49000,248000,248000
20200528,05563P,台積電元大97售07,0.05,0.05,0.05,0.05,-0.09,-64.29,3000,1,150,0,0,0,0,0,0,0,3000,-3000,-3000
20200528,055640,鴻海元富97購03,,,,,0.00,0.00,0,0,0,0,0,0,0,0,0,0,0,0,0
20200528,055641,鴻海元富97購04,,,,,0.00,0.00,0,0,0,0,0,0,0,0,0,0,0,0,0
20200528,055642,廣宇元富97購01,,,,,0.00,0.00,0,0,0,0,0,0,0,0,0,0,0,0,0
20200528,055643,宏碁元富97購01,0.04,0.04,0.04,0.04,-0.02,-33.33,15000,1,600,0,0,0,0,0,0,0,0,0,0
20200528,055644,致茂元富97購01,,,,,0.00,0.00,0,0,0,0,0,0,0,0,0,0,0,0,0
20200528,055645,技嘉元富97購01,2.51,2.56,2.37,2.37,-0.43,-15.36,19000,3,48300,0,0,0,0,0,0,18000,1000,17000,17000
20200528,055646,漢唐元富97購01,0.59,0.59,0.59,0.59,-0.08,-11.94,2198000,9,1296820,0,0,0,0,0,0,2198000,0,2198000,2198000
20200528,055647,義隆元富97購01,1.88,1.99,1.88,1.95,+0.14,7.73,360000,11,694230,0,0,0,0,0,0,220000,140000,80000,80000
20200528,055648,可成元富97購01,0.79,0.79,0.75,0.75,-0.05,-6.25,102000,2,80500,0,0,0,0,0,0,2000,100000,-98000,-98000
20200528,055649,華新科元富97購03,0.05,0.05,0.05,0.05,0.00,0.00,109000,4,5450,0,0,0,0,0,0,109000,100000,9000,9000
20200528,05564P,玉晶光元大97售02,0.05,0.06,0.05,0.06,0.00,0.00,10000,2,550,0,0,0,0,0,0,0,0,0,0
20200528,055650,華新科元富98購01,,,,,0.00,0.00,0,0,0,0,0,0,0,0,0,0,0,0,0
20200528,055651,富邦金元富97購01,,,,,0.00,0.00,0,0,0,0,0,0,0,0,0,0,0,0,0
20200528,055652,聯詠元富01購01,0.84,0.84,0.78,0.78,-0.06,-7.14,59000,4,47940,0,0,0,0,0,0,34000,25000,9000,9000
20200528,055653,聯詠元富01購02,0.80,0.80,0.76,0.80,0.00,0.00,80000,6,62440,0,0,0,0,0,0,51000,29000,22000,22000
20200528,055654,景碩元富97購01,,,,,0.00,0.00,0,0,0,0,0,0,0,0,0,0,0,0,0
20200528,055655,群創元富99購07,,,,,0.00,0.00,0,0,0,0,0,0,0,0,0,0,0,0,0
20200528,055656,新唐元富97購01,,,,,0.00,0.00,0,0,0,0,0,0,0,0,0,0,0,0,0
20200528,055657,超眾元富97購02,0.84,0.93,0.82,0.88,-0.02,-2.22,297000,24,260200,0,0,0,0,0,0,120000,177000,-57000,-57000
20200528,055658,南電元富97購01,,,,,0.00,0.00,0,0,0,0,0,0,0,0,0,0,0,0,0
20200528,055659,百和元富97購01,,,,,0.00,0.00,0,0,0,0,0,0,0,0,0,0,0,0,0
20200528,05565P,鎧勝元大96售01,,,,,0.00,0.00,0,0,0,0,0,0,0,0,0,0,0,0,0
20200528,055660,台光電兆豐97購01,,,,,0.00,0.00,0,0,0,0,0,0,0,0,0,0,0,0,0
20200528,055661,亞德客中信98購01,0.61,0.69,0.46,0.69,+0.12,21.05,192000,30,111990,0,0,0,0,0,0,138000,52000,86000,86000
20200528,055662,上銀中信99購01,,,,,0.00,0.00,0,0,0,0,0,0,0,0,0,0,0,0,0
20200528,055663,崇越中信97購01,,,,,0.00,0.00,0,0,0,0,0,0,0,0,0,0,0,0,0
20200528,055664,和大群益98購02,,,,,0.00,0.00,0,0,0,0,0,0,0,0,0,0,0,0,0
20200528,055665,亞德客群益97購01,3.03,3.21,2.53,2.53,-0.38,-13.06,612000,27,1869500,0,0,0,0,0,0,600000,12000,588000,588000
20200528,055666,鴻海群益97購05,,,,,0.00,0.00,0,0,0,0,0,0,0,0,0,0,0,0,0
20200528,055667,致茂群益98購01,0.67,0.67,0.67,0.67,0.00,0.00,122000,1,81740,0,0,0,0,0,0,0,122000,-122000,-122000
20200528,055668,欣興群益97購01,1.29,1.38,1.29,1.38,+0.21,17.95,56000,2,73050,0,0,0,0,0,0,0,56000,-56000,-56000
20200528,055669,緯穎群益97購02,,,,,0.00,0.00,0,0,0,0,0,0,0,0,0,0,0,0,0
20200528,05566P,景碩永豐96售01,,,,,0.00,0.00,0,0,0,0,0,0,0,0,0,0,0,0,0
20200528,055670,矽創群益98購02,1.79,2.00,1.79,1.79,+0.19,11.88,657000,21,1262310,0,0,0,0,0,0,100000,557000,-457000,-457000
20200528,055671,世紀鋼群益97購01,3.12,3.99,3.12,3.99,+1.17,41.49,12000,10,41100,0,0,0,0,0,0,12000,0,12000,12000
20200528,055672,國巨日盛97購02,0.31,0.31,0.31,0.31,0.00,0.00,10000,1,3100,0,0,0,0,0,0,10000,10000,0,0
20200528,055673,旺宏日盛97購01,,,,,0.00,0.00,0,0,0,0,0,0,0,0,0,0,0,0,0
20200528,055674,南港康和97購02,,,,,0.00,0.00,0,0,0,0,0,0,0,0,0,0,0,0,0
20200528,055675,亞德客凱基97購02,1.18,1.27,1.00,1.00,-0.09,-8.26,96000,7,113410,0,40000,-40000,0,0,0,91000,9000,82000,42000
20200528,055676,亞德客凱基97購03,,,,,0.00,0.00,0,0,0,0,0,0,0,0,0,0,0,0,0
20200528,055677,喬山凱基97購01,,,,,0.00,0.00,0,0,0,0,0,0,0,0,0,0,0,0,0
20200528,055678,上銀凱基97購02,0.58,0.58,0.58,0.58,-0.08,-12.12,20000,1,11600,0,0,0,0,0,0,20000,0,20000,20000
20200528,055679,華通凱基99購01,,,,,0.00,0.00,0,0,0,0,0,0,0,0,0,0,0,0,0
20200528,05567P,致伸群益96售01,,,,,0.00,0.00,0,0,0,0,0,0,0,0,0,0,0,0,0
20200528,055680,美律凱基99購01,,,,,0.00,0.00,0,0,0,0,0,0,0,0,0,0,0,0,0
20200528,055681,奇鋐凱基98購03,0.57,0.67,0.57,0.61,0.00,0.00,245000,36,158770,0,0,0,0,0,0,37000,245000,-208000,-208000
20200528,055682,智原凱基98購02,,,,,0.00,0.00,0,0,0,0,0,0,0,0,0,0,0,0,0
20200528,055683,晶技凱基99購01,,,,,0.00,0.00,0,0,0,0,0,0,0,0,0,0,0,0,0
20200528,055684,京鼎凱基97購01,,,,,0.00,0.00,0,0,0,0,0,0,0,0,0,0,0,0,0
20200528,055685,日月光凱基97購02,,,,,0.00,0.00,0,0,0,0,0,0,0,0,0,0,0,0,0
20200528,055686,致伸凱基97購02,,,,,0.00,0.00,0,0,0,0,0,0,0,0,0,0,0,0,0
20200528,055687,瀚宇博凱基97購01,1.02,1.05,1.02,1.05,+0.09,9.37,70000,3,71700,0,0,0,0,0,0,10000,60000,-50000,-50000
20200528,055688,力成凱基98購02,,,,,0.00,0.00,0,0,0,0,0,0,0,0,0,0,0,0,0
20200528,055689,台郡凱基99購01,1.13,1.13,1.13,1.13,-0.05,-4.24,40000,1,45200,0,0,0,0,0,0,40000,0,40000,40000
20200528,05568P,台積電統一96售03,0.66,0.66,0.66,0.66,0.00,0.00,2000,1,1320,0,0,0,0,0,0,0,2000,-2000,-2000
20200528,055690,矽力凱基97購02,3.26,3.70,3.26,3.32,+0.53,19.0,36000,6,123800,0,0,0,0,0,0,36000,0,36000,36000
20200528,055691,訊芯凱基97購02,,,,,0.00,0.00,0,0,0,0,0,0,0,0,0,0,0,0,0
20200528,055692,緯穎凱基97購03,,,,,0.00,0.00,0,0,0,0,0,0,0,0,0,0,0,0,0
20200528,055693,南茂凱基97購01,,,,,0.00,0.00,0,0,0,0,0,0,0,0,0,0,0,0,0
20200528,055694,光罩國票98購01,,,,,0.00,0.00,0,0,0,0,0,0,0,0,0,0,0,0,0
20200528,055695,大毅國票98購03,6.30,6.30,6.30,6.30,-0.15,-2.33,8000,1,50400,0,0,0,0,0,0,8000,0,8000,8000
20200528,055696,華新科國票98購01,,,,,0.00,0.00,0,0,0,0,0,0,0,0,0,0,0,0,0
20200528,055697,牧德國票98購01,,,,,0.00,0.00,0,0,0,0,0,0,0,0,0,0,0,0,0
20200528,055698,茂林國票98購03,1.04,1.08,1.00,1.04,-0.02,-1.89,83000,13,86840,0,0,0,0,0,0,60000,23000,37000,37000
20200528,055699,康控國票97購04,,,,,0.00,0.00,0,0,0,0,0,0,0,0,0,0,0,0,0
20200528,05569P,漢唐統一97售01,0.48,0.50,0.48,0.50,0.00,0.00,160000,2,78800,0,0,0,0,0,0,100000,60000,40000,40000
20200528,055700,緯穎國泰98購02,3.29,3.29,3.26,3.26,0.00,0.00,20000,2,65500,0,0,0,0,0,0,20000,0,20000,20000
20200528,055701,亞德客富邦99購01,1.23,1.33,1.07,1.07,-0.13,-10.83,205000,34,254470,0,0,0,0,0,0,151000,54000,97000,97000
20200528,055702,美律富邦98購01,0.21,0.21,0.21,0.21,0.00,0.00,10000,1,2100,0,0,0,0,0,0,10000,0,10000,10000
20200528,055703,緯穎富邦98購01,0.48,0.48,0.48,0.48,-0.07,-12.73,24000,1,11520,0,0,0,0,0,0,24000,0,24000,24000
20200528,055704,亞德客永豐97購04,0.93,1.00,0.93,0.99,+0.08,8.79,204000,16,194930,0,0,0,0,0,0,204000,0,204000,204000
20200528,055705,微星永豐97購01,0.29,0.31,0.29,0.31,+0.04,14.81,129000,4,38610,0,0,0,0,0,0,69000,60000,9000,9000
20200528,055706,大立光永豐97購03,,,,,0.00,0.00,0,0,0,0,0,0,0,0,0,0,0,0,0
20200528,055707,聯鈞永豐98購01,0.64,0.64,0.64,0.64,+0.01,1.59,24000,1,15360,0,0,0,0,0,0,24000,0,24000,24000
20200528,055708,茂林永豐97購02,0.21,0.21,0.21,0.21,-0.02,-8.7,45000,14,9450,0,0,0,0,0,0,45000,0,45000,45000
20200528,055709,深中小元大97購03,,,,,0.00,0.00,0,0,0,0,0,0,0,0,0,0,0,0,0
20200528,05570P,聯發科統一96售04,,,,,0.00,0.00,0,0,0,0,0,0,0,0,0,0,0,0,0
20200528,055710,亞德客元大97購03,2.89,3.09,2.43,2.43,-0.27,-10.0,140000,29,406740,0,0,0,0,0,0,130000,20000,110000,110000
20200528,055711,上銀元大97購04,,,,,0.00,0.00,0,0,0,0,0,0,0,0,0,0,0,0,0
20200528,055712,金寶元大97購02,,,,,0.00,0.00,0,0,0,0,0,0,0,0,0,0,0,0,0
20200528,055713,國巨元大98購09,3.44,3.45,3.13,3.13,-0.16,-4.86,43000,5,144050,0,0,0,0,0,0,21000,32000,-11000,-11000
20200528,055714,智邦元大97購03,6.70,6.95,5.80,5.80,0.00,0.00,21000,10,141700,0,0,0,0,0,0,9000,20000,-11000,-11000
20200528,055715,智邦元大97購04,,,,,0.00,0.00,0,0,0,0,0,0,0,0,0,0,0,0,0
20200528,055716,致茂元大97購01,0.73,0.73,0.71,0.73,-0.13,-15.12,68000,3,49480,0,0,0,0,0,0,68000,0,68000,68000
20200528,055717,聯發科元大97購19,,,,,0.00,0.00,0,0,0,0,0,0,0,0,0,0,0,0,0
20200528,055718,可成元大97購02,,,,,0.00,0.00,0,0,0,0,0,0,0,0,0,0,0,0,0
20200528,055719,可成元大97購03,,,,,0.00,0.00,0,0,0,0,0,0,0,0,0,0,0,0,0
20200528,05571P,大立光統一96售03,,,,,0.00,0.00,0,0,0,0,0,0,0,0,0,0,0,0,0
20200528,055720,宏達電元大97購05,0.47,0.47,0.47,0.47,-0.05,-9.62,50000,1,23500,0,0,0,0,0,0,50000,0,50000,50000
20200528,055721,聯詠元大97購04,,,,,0.00,0.00,0,0,0,0,0,0,0,0,0,0,0,0,0
20200528,055722,聯鈞元大97購03,,,,,0.00,0.00,0,0,0,0,0,0,0,0,0,0,0,0,0
20200528,055723,康控元大97購04,,,,,0.00,0.00,0,0,0,0,0,0,0,0,0,0,0,0,0
20200528,055724,祥碩元大97購03,,,,,0.00,0.00,0,0,0,0,0,0,0,0,0,0,0,0,0
20200528,055725,嘉聯益元大98購03,0.61,0.64,0.61,0.64,+0.09,16.36,279000,3,173960,0,0,0,0,0,0,0,279000,-279000,-279000
20200528,055726,台表科元大98購03,3.55,3.55,3.26,3.26,-0.27,-7.65,29000,3,99650,0,0,0,0,0,0,14000,15000,-1000,-1000
20200528,055727,矽力元大97購02,10.50,11.90,10.50,11.90,+1.95,19.6,26000,4,288500,0,0,0,0,0,0,15000,11000,4000,4000
20200528,055728,緯穎元大97購03,,,,,0.00,0.00,0,0,0,0,0,0,0,0,0,0,0,0,0
20200528,055729,金寶元富99購01,,,,,0.00,0.00,0,0,0,0,0,0,0,0,0,0,0,0,0
20200528,05572P,群創統一96售02,,,,,0.00,0.00,0,0,0,0,0,0,0,0,0,0,0,0,0
20200528,055730,建準元富97購02,2.03,2.55,2.03,2.27,+0.33,17.01,371000,23,868920,0,0,0,0,0,0,35000,336000,-301000,-301000
20200528,055731,美律元富97購01,0.37,0.38,0.37,0.38,+0.02,5.56,83000,2,30770,0,0,0,0,0,0,6000,77000,-71000,-71000
20200528,055732,全新元富9A購01,0.51,0.53,0.51,0.53,-0.02,-3.64,9000,2,4610,0,0,0,0,0,0,8000,1000,7000,7000
20200528,055733,奇力新元富97購01,,,,,0.00,0.00,0,0,0,0,0,0,0,0,0,0,0,0,0
20200528,055734,奇力新元富97購02,,,,,0.00,0.00,0,0,0,0,0,0,0,0,0,0,0,0,0
20200528,055735,宏達電元富98購01,,,,,0.00,0.00,0,0,0,0,0,0,0,0,0,0,0,0,0
20200528,055736,宏達電元富99購01,0.59,0.59,0.49,0.50,-0.08,-13.79,740000,12,400900,0,0,0,0,0,0,200000,530000,-330000,-330000
20200528,055737,開發金元富97購01,,,,,0.00,0.00,0,0,0,0,0,0,0,0,0,0,0,0,0
20200528,055738,玉山金元富97購01,0.79,0.79,0.79,0.79,0.00,0.00,2000,1,1580,0,0,0,0,0,0,0,2000,-2000,-2000
20200528,055739,健鼎元富97購01,,,,,0.00,0.00,0,0,0,0,0,0,0,0,0,0,0,0,0
20200528,05573P,仁寶元富96售02,,,,,0.00,0.00,0,0,0,0,0,0,0,0,0,0,0,0,0
20200528,055740,智易元富97購01,0.65,0.65,0.65,0.65,0.00,0.00,13000,2,8450,0,0,0,0,0,0,0,13000,-13000,-13000
20200528,055741,健策元富97購01,1.64,1.72,1.36,1.36,-0.16,-10.53,503000,45,788020,0,0,0,0,0,0,373000,120000,253000,253000
20200528,055742,健策元富97購02,0.37,0.38,0.37,0.38,-0.07,-15.56,6000,4,2260,0,0,0,0,0,0,6000,0,6000,6000
20200528,055743,TPK元富98購01,,,,,0.00,0.00,0,0,0,0,0,0,0,0,0,0,0,0,0
20200528,055744,茂林元富97購02,0.52,0.52,0.45,0.45,-0.07,-13.46,781000,65,388830,0,0,0,0,0,0,601000,192000,409000,409000
20200528,055745,臻鼎元富97購01,0.33,0.33,0.33,0.33,-0.02,-5.71,170000,1,56100,0,0,0,0,0,0,170000,0,170000,170000
20200528,055746,同欣電元富97購01,0.67,0.67,0.60,0.62,-0.17,-21.52,218000,10,144350,0,0,0,0,0,0,198000,20000,178000,178000
20200528,055747,康舒元富97購01,,,,,0.00,0.00,0,0,0,0,0,0,0,0,0,0,0,0,0
20200528,055748,GIS元富97購01,1.19,1.19,1.11,1.11,+0.07,6.73,25000,2,28950,0,0,0,0,0,0,10000,0,10000,10000
20200528,055749,智邦永昌9C購01,,,,,0.00,0.00,0,0,0,0,0,0,0,0,0,0,0,0,0
20200528,05574P,英業達元富96售01,,,,,0.00,0.00,0,0,0,0,0,0,0,0,0,0,0,0,0
20200528,055750,瑞昱永昌9C購01,,,,,0.00,0.00,0,0,0,0,0,0,0,0,0,0,0,0,0
20200528,055751,南亞科永昌9C購01,,,,,0.00,0.00,0,0,0,0,0,0,0,0,0,0,0,0,0
20200528,055752,臺股指永昌97購01,,,,,0.00,0.00,0,0,0,0,0,0,0,0,0,0,0,0,0
20200528,055753,貿聯第一98購01,,,,,0.00,0.00,0,0,0,0,0,0,0,0,0,0,0,0,0
20200528,055754,和大兆豐97購01,,,,,0.00,0.00,0,0,0,0,0,0,0,0,0,0,0,0,0
20200528,055755,禾伸堂兆豐97購02,1.50,1.50,1.50,1.50,-0.08,-5.06,38000,1,57000,0,0,0,0,0,0,38000,0,38000,38000
20200528,055756,臺股指兆豐97購01,,,,,0.00,0.00,0,0,0,0,0,0,0,0,0,0,0,0,0
20200528,055757,大成鋼群益99購01,,,,,0.00,0.00,0,0,0,0,0,0,0,0,0,0,0,0,0
20200528,055758,旺宏群益97購01,,,,,0.00,0.00,0,0,0,0,0,0,0,0,0,0,0,0,0
20200528,055759,技嘉群益98購02,1.32,1.32,1.32,1.32,0.00,0.00,1000,1,1320,0,0,0,0,0,0,1000,0,1000,1000
20200528,05575P,玉晶光元富96售01,,,,,0.00,0.00,0,0,0,0,0,0,0,0,0,0,0,0,0
20200528,055760,新日興群益98購02,,,,,0.00,0.00,0,0,0,0,0,0,0,0,0,0,0,0,0
20200528,055761,創意群益97購01,,,,,0.00,0.00,0,0,0,0,0,0,0,0,0,0,0,0,0
20200528,055762,智伸科群益97購01,,,,,0.00,0.00,0,0,0,0,0,0,0,0,0,0,0,0,0
20200528,055763,鎧勝群益97購01,0.20,0.20,0.20,0.20,-0.01,-4.76,35000,2,7000,0,0,0,0,0,0,0,35000,-35000,-35000
20200528,055764,臺股指群益97購02,0.49,0.49,0.49,0.49,0.00,0.00,10000,1,4900,0,0,0,0,0,0,0,0,0,0
20200528,055765,臺股指群益97購03,,,,,0.00,0.00,0,0,0,0,0,0,0,0,0,0,0,0,0
20200528,055766,臺股指群益97購04,,,,,0.00,0.00,0,0,0,0,0,0,0,0,0,0,0,0,0
20200528,055767,臺股指群益97購05,,,,,0.00,0.00,0,0,0,0,0,0,0,0,0,0,0,0,0
20200528,055768,臺股指群益97購06,,,,,0.00,0.00,0,0,0,0,0,0,0,0,0,0,0,0,0
20200528,055769,智伸科中信97購01,,,,,0.00,0.00,0,0,0,0,0,0,0,0,0,0,0,0,0
20200528,05576P,群創日盛99售02,,,,,0.00,0.00,0,0,0,0,0,0,0,0,0,0,0,0,0
20200528,055770,欣興麥證97購01,,,,,0.00,0.00,0,0,0,0,0,0,0,0,0,0,0,0,0
20200528,055771,台積電日盛97購04,,,,,0.00,0.00,0,0,0,0,0,0,0,0,0,0,0,0,0
20200528,055772,致茂凱基97購01,,,,,0.00,0.00,0,0,0,0,0,0,0,0,0,0,0,0,0
20200528,055773,瑞昱凱基97購03,2.28,2.28,2.28,2.28,+0.13,6.05,54000,2,123120,0,0,0,0,0,0,48000,6000,42000,42000
20200528,055774,台光電凱基97購02,1.46,1.46,1.46,1.46,-0.09,-5.81,6000,1,8760,0,0,0,0,0,0,6000,0,6000,6000
20200528,055775,友達凱基9A購01,,,,,0.00,0.00,0,0,0,0,0,0,0,0,0,0,0,0,0
20200528,055776,宏達電凱基98購02,0.87,0.87,0.75,0.75,-0.13,-14.77,104000,4,86320,0,0,0,0,0,0,56000,56000,0,0
20200528,055777,冠德凱基97購01,0.62,0.70,0.62,0.66,+0.05,8.2,202000,11,132510,0,0,0,0,0,0,131000,71000,60000,60000
20200528,055778,美食凱基97購01,,,,,0.00,0.00,0,0,0,0,0,0,0,0,0,0,0,0,0
20200528,055779,國泰金凱基97購02,1.62,1.62,1.62,1.62,-0.16,-8.99,34000,1,55080,0,0,0,0,0,0,0,34000,-34000,-34000
20200528,05577P,上銀凱基96售02,,,,,0.00,0.00,0,0,0,0,0,0,0,0,0,0,0,0,0
20200528,055780,禾伸堂凱基99購01,,,,,0.00,0.00,0,0,0,0,0,0,0,0,0,0,0,0,0
20200528,055781,聯詠凱基98購01,,,,,0.00,0.00,0,0,0,0,0,0,0,0,0,0,0,0,0
20200528,055782,新日興凱基99購01,0.88,0.95,0.86,0.89,+0.06,7.23,152000,8,141860,0,0,0,0,0,0,44000,108000,-64000,-64000
20200528,055783,群創凱基99購03,,,,,0.00,0.00,0,0,0,0,0,0,0,0,0,0,0,0,0
20200528,055784,TPK凱基97購02,,,,,0.00,0.00,0,0,0,0,0,0,0,0,0,0,0,0,0
20200528,055785,祥碩凱基97購02,8.45,8.45,8.45,8.45,-1.85,-17.96,10000,1,84500,0,0,0,0,0,0,10000,0,10000,10000
20200528,055786,彩晶凱基99購02,,,,,0.00,0.00,0,0,0,0,0,0,0,0,0,0,0,0,0
20200528,055787,聯茂凱基99購01,,,,,0.00,0.00,0,0,0,0,0,0,0,0,0,0,0,0,0
20200528,055788,緯穎凱基97購04,4.33,4.33,3.94,3.94,-0.81,-17.05,37000,5,153550,0,0,0,0,0,0,32000,20000,12000,12000
20200528,055789,台虹凱基97購01,,,,,0.00,0.00,0,0,0,0,0,0,0,0,0,0,0,0,0
20200528,05578P,鴻海凱基96售11,,,,,0.00,0.00,0,0,0,0,0,0,0,0,0,0,0,0,0
20200528,055790,南電凱基97購01,,,,,0.00,0.00,0,0,0,0,0,0,0,0,0,0,0,0,0
20200528,055791,臺股指凱基97購14,,,,,0.00,0.00,0,0,0,0,0,0,0,0,0,0,0,0,0
20200528,055792,臺股指凱基97購15,,,,,0.00,0.00,0,0,0,0,0,0,0,0,0,0,0,0,0
20200528,055793,臺股指凱基97購16,,,,,0.00,0.00,0,0,0,0,0,0,0,0,0,0,0,0,0
20200528,055794,聯發科國泰99購01,,,,,0.00,0.00,0,0,0,0,0,0,0,0,0,0,0,0,0
20200528,055795,茂林國泰98購01,1.01,1.01,0.93,0.94,-0.46,-32.86,110000,17,108610,0,0,0,0,0,0,80000,30000,50000,50000
20200528,055796,南電國泰98購01,2.44,2.50,2.30,2.30,-0.11,-4.56,152000,13,368500,0,0,0,0,0,0,78000,74000,4000,4000
20200528,055797,華通富邦98購01,,,,,0.00,0.00,0,0,0,0,0,0,0,0,0,0,0,0,0
20200528,055798,聯茂富邦98購01,0.36,0.36,0.31,0.34,+0.01,3.03,10000,5,3220,0,0,0,0,0,0,6000,3000,3000,3000
20200528,055799,致茂永豐97購02,,,,,0.00,0.00,0,0,0,0,0,0,0,0,0,0,0,0,0
20200528,05579P,友達凱基98售03,1.16,1.21,1.16,1.21,+0.02,1.68,75000,2,88850,0,0,0,0,0,0,38000,37000,1000,1000
20200528,055800,欣興永豐97購02,0.01,0.01,0.01,0.01,0.00,0.00,60000,1,600,0,0,0,0,0,0,60000,0,60000,60000
20200528,055801,景碩永豐97購02,,,,,0.00,0.00,0,0,0,0,0,0,0,0,0,0,0,0,0
20200528,055802,新日興永豐97購01,,,,,0.00,0.00,0,0,0,0,0,0,0,0,0,0,0,0,0
20200528,055803,鎧勝永豐97購01,,,,,0.00,0.00,0,0,0,0,0,0,0,0,0,0,0,0,0
20200528,055804,祥碩永豐97購02,3.71,4.61,3.64,4.33,+0.73,20.28,144000,44,610120,0,0,0,0,0,0,17000,119000,-102000,-102000
20200528,055805,矽力永豐97購01,0.93,1.18,0.93,1.07,+0.19,21.59,357000,44,364920,0,0,0,0,0,0,219000,97000,122000,122000
20200528,055806,致新永豐97購02,0.71,0.83,0.71,0.83,+0.09,12.16,425000,28,324890,0,0,0,0,0,0,230000,195000,35000,35000
20200528,055807,勤誠永豐97購01,,,,,0.00,0.00,0,0,0,0,0,0,0,0,0,0,0,0,0
20200528,055808,世紀鋼永豐97購01,0.73,0.87,0.73,0.84,+0.30,55.56,102000,15,81030,0,0,0,0,0,0,0,102000,-102000,-102000
20200528,055809,T50反1國票98購02,0.95,0.95,0.95,0.95,+0.05,5.56,7000,1,6650,0,0,0,0,0,0,7000,0,7000,7000
20200528,05580P,美律凱基96售03,,,,,0.00,0.00,0,0,0,0,0,0,0,0,0,0,0,0,0
20200528,055810,T50反1國票99購01,,,,,0.00,0.00,0,0,0,0,0,0,0,0,0,0,0,0,0
20200528,055811,國巨國票98購05,,,,,0.00,0.00,0,0,0,0,0,0,0,0,0,0,0,0,0
20200528,055812,台積電國票99購02,,,,,0.00,0.00,0,0,0,0,0,0,0,0,0,0,0,0,0
20200528,055813,聯發科國票98購04,4.88,4.91,4.40,4.45,-0.35,-7.29,17000,6,81950,0,0,0,0,0,0,16000,1000,15000,15000
20200528,055814,晶豪科國票97購02,2.38,2.41,2.12,2.12,-0.11,-4.93,143000,4,323950,0,0,0,0,0,0,61000,143000,-82000,-82000
20200528,055815,亞光國票99購01,,,,,0.00,0.00,0,0,0,0,0,0,0,0,0,0,0,0,0
20200528,055816,新日興國票98購01,1.69,1.94,1.69,1.81,0.00,0.00,53000,5,99380,0,0,0,0,0,0,0,53000,-53000,-53000
20200528,055817,京鼎國票99購01,,,,,0.00,0.00,0,0,0,0,0,0,0,0,0,0,0,0,0
20200528,055818,晶相光國票97購02,,,,,0.00,0.00,0,0,0,0,0,0,0,0,0,0,0,0,0
20200528,055819,晶相光國票98購01,,,,,0.00,0.00,0,0,0,0,0,0,0,0,0,0,0,0,0
20200528,05581P,華新科凱基96售07,,,,,0.00,0.00,0,0,0,0,0,0,0,0,0,0,0,0,0
20200528,055820,矽力國票98購02,7.00,8.35,7.00,7.65,+0.85,12.5,330000,41,2603700,0,0,0,0,0,0,146000,163000,-17000,-17000
20200528,055821,勤誠國票98購01,,,,,0.00,0.00,0,0,0,0,0,0,0,0,0,0,0,0,0
20200528,055822,臺股指國票97購09,0.48,0.48,0.40,0.42,-0.07,-14.29,7000,7,2940,0,0,0,0,0,0,0,7000,-7000,-7000
20200528,055823,臺股指國票97購10,,,,,0.00,0.00,0,0,0,0,0,0,0,0,0,0,0,0,0
20200528,055824,臺股指國票97購11,0.84,0.84,0.64,0.66,-0.14,-17.5,63000,8,46410,0,0,0,0,0,0,0,63000,-63000,-63000
20200528,055825,臺股指國票97購12,,,,,0.00,0.00,0,0,0,0,0,0,0,0,0,0,0,0,0
20200528,055826,中石化元大97購01,,,,,0.00,0.00,0,0,0,0,0,0,0,0,0,0,0,0,0
20200528,055827,中石化元大98購01,,,,,0.00,0.00,0,0,0,0,0,0,0,0,0,0,0,0,0
20200528,055828,上銀元大97購05,3.11,3.38,3.11,3.38,+0.20,6.29,39000,2,124800,0,0,0,0,0,0,39000,0,39000,39000
20200528,055829,上銀元大97購06,5.50,5.75,5.50,5.50,-0.15,-2.65,21000,3,116500,0,0,0,0,0,0,21000,0,21000,21000
20200528,05582P,群創凱基98售06,1.97,2.05,1.97,2.05,+0.05,2.5,110000,4,218300,0,0,0,0,0,0,90000,100000,-10000,-10000
20200528,055830,上銀元大97購07,5.35,5.35,4.72,4.72,-0.88,-15.71,15000,2,79620,0,0,0,0,0,0,14000,1000,13000,13000
20200528,055831,台達電元大97購01,0.53,0.53,0.53,0.53,0.00,0.00,20000,2,10600,0,0,0,0,0,0,0,20000,-20000,-20000
20200528,055832,台達電元大97購02,,,,,0.00,0.00,0,0,0,0,0,0,0,0,0,0,0,0,0
20200528,055833,華通元大98購05,,,,,0.00,0.00,0,0,0,0,0,0,0,0,0,0,0,0,0
20200528,055834,國巨元大97購13,2.68,2.74,2.46,2.48,-0.13,-4.98,90000,8,232190,0,0,0,0,0,0,75000,17000,58000,58000
20200528,055835,華邦電元大97購03,0.30,0.30,0.22,0.22,0.00,0.00,208000,3,61600,0,0,0,0,0,0,0,208000,-208000,-208000
20200528,055836,華邦電元大97購04,0.13,0.13,0.13,0.13,0.00,0.00,9000,1,1170,0,0,0,0,0,0,0,9000,-9000,-9000
20200528,055837,致茂元大97購02,,,,,0.00,0.00,0,0,0,0,0,0,0,0,0,0,0,0,0
20200528,055838,致茂元大97購03,,,,,0.00,0.00,0,0,0,0,0,0,0,0,0,0,0,0,0
20200528,055839,瑞昱元大97購04,2.64,2.64,2.58,2.58,0.00,0.00,15000,2,39000,0,0,0,0,0,0,15000,15000,0,0
20200528,05583P,訊芯凱基96售01,,,,,0.00,0.00,0,0,0,0,0,0,0,0,0,0,0,0,0
20200528,055840,南亞科元大97購03,,,,,0.00,0.00,0,0,0,0,0,0,0,0,0,0,0,0,0
20200528,055841,南亞科元大97購04,0.64,0.64,0.52,0.52,-0.03,-5.45,118000,2,67360,0,0,0,0,0,0,68000,50000,18000,18000
20200528,055842,建準元大98購01,1.44,1.47,1.34,1.34,+0.10,8.06,87000,4,120820,0,0,0,0,0,0,87000,0,87000,87000
20200528,055843,美律元大97購02,,,,,0.00,0.00,0,0,0,0,0,0,0,0,0,0,0,0,0
20200528,055844,大毅元大98購01,1.87,1.87,1.83,1.83,+0.03,1.67,44000,2,82080,0,0,0,0,0,0,44000,0,44000,44000
20200528,055845,大立光元大97購08,,,,,0.00,0.00,0,0,0,0,0,0,0,0,0,0,0,0,0
20200528,055846,大立光元大97購09,0.52,0.52,0.52,0.52,0.00,0.00,24000,1,12480,0,0,0,0,0,0,0,24000,-24000,-24000
20200528,055847,大立光元大97購10,,,,,0.00,0.00,0,0,0,0,0,0,0,0,0,0,0,0,0
20200528,055848,大立光元大97購11,0.68,0.68,0.68,0.68,-0.07,-9.33,38000,1,25840,0,0,0,0,0,0,38000,0,38000,38000
20200528,055849,聯詠元大97購05,0.39,0.39,0.39,0.39,-0.04,-9.3,78000,2,30420,0,0,0,0,0,0,10000,68000,-58000,-58000
20200528,05584P,臺股指凱基96售13,,,,,0.00,0.00,0,0,0,0,0,0,0,0,0,0,0,0,0
20200528,055850,聯詠元大97購06,0.58,0.59,0.57,0.59,-0.04,-6.35,110000,5,64840,0,0,0,0,0,0,21000,89000,-68000,-68000
20200528,055851,智原元大98購01,,,,,0.00,0.00,0,0,0,0,0,0,0,0,0,0,0,0,0
20200528,055852,聯鈞元大98購01,,,,,0.00,0.00,0,0,0,0,0,0,0,0,0,0,0,0,0
20200528,055853,群創元大98購03,,,,,0.00,0.00,0,0,0,0,0,0,0,0,0,0,0,0,0
20200528,055854,群創元大98購04,,,,,0.00,0.00,0,0,0,0,0,0,0,0,0,0,0,0,0
20200528,055855,牧德元大99購02,,,,,0.00,0.00,0,0,0,0,0,0,0,0,0,0,0,0,0
20200528,055856,新唐元大97購03,0.35,0.35,0.35,0.35,0.00,0.00,30000,1,10500,0,0,0,0,0,0,0,30000,-30000,-30000
20200528,055857,嘉聯益元大97購04,,,,,0.00,0.00,0,0,0,0,0,0,0,0,0,0,0,0,0
20200528,055858,聯茂元大97購03,0.75,0.81,0.75,0.81,+0.07,9.46,110000,6,84240,0,0,0,0,0,0,47000,63000,-16000,-16000
20200528,055859,啟碁元大97購03,0.61,0.61,0.56,0.56,-0.03,-5.08,219000,7,128740,0,0,0,0,0,0,219000,1000,218000,218000
20200528,05585P,臺股指凱基96售14,,,,,0.00,0.00,0,0,0,0,0,0,0,0,0,0,0,0,0
20200528,055860,啟碁元大97購04,0.53,0.53,0.53,0.53,0.00,0.00,1000,1,530,0,0,0,0,0,0,1000,1000,0,0
20200528,055861,矽力元大97購03,3.59,3.59,3.56,3.59,+0.05,1.41,18000,3,64410,0,0,0,0,0,0,18000,0,18000,18000
20200528,055862,矽力元大97購04,4.59,4.59,4.59,4.59,0.00,0.00,10000,1,45900,0,0,0,0,0,0,0,10000,-10000,-10000
20200528,055863,緯穎元大97購05,1.55,1.55,1.55,1.55,+0.15,10.71,10000,1,15500,0,0,0,0,0,0,10000,0,10000,10000
20200528,055864,臺股指元大97購01,,,,,0.00,0.00,0,0,0,0,0,0,0,0,0,0,0,0,0
20200528,055865,臺股指元大97購02,,,,,0.00,0.00,0,0,0,0,0,0,0,0,0,0,0,0,0
20200528,055866,臺股指元大97購03,,,,,0.00,0.00,0,0,0,0,0,0,0,0,0,0,0,0,0
20200528,055867,臺股指元大97購05,0.05,0.05,0.05,0.05,-0.01,-16.67,40000,1,2000,0,0,0,0,0,0,40000,0,40000,40000
20200528,055868,臺股指元大97購07,,,,,0.00,0.00,0,0,0,0,0,0,0,0,0,0,0,0,0
20200528,055869,臺股指元大97購08,,,,,0.00,0.00,0,0,0,0,0,0,0,0,0,0,0,0,0
20200528,05586P,臺股指凱基96售15,,,,,0.00,0.00,0,0,0,0,0,0,0,0,0,0,0,0,0
20200528,055870,智原台新97購01,,,,,0.00,0.00,0,0,0,0,0,0,0,0,0,0,0,0,0
20200528,055871,群創台新97購02,0.01,0.01,0.01,0.01,0.00,0.00,370000,4,3700,0,0,0,0,0,0,370000,0,370000,370000
20200528,055872,亞泥元富97購01,0.45,0.45,0.45,0.45,-0.05,-10.0,2000,1,900,0,0,0,0,0,0,2000,0,2000,2000
20200528,055873,聚陽元富97購01,0.18,0.24,0.17,0.24,-0.03,-11.11,355000,6,63790,0,0,0,0,0,0,349000,1000,348000,348000
20200528,055874,中環元富9A購01,0.49,0.50,0.43,0.43,-0.05,-10.42,216000,23,102170,0,0,0,0,0,0,79000,137000,-58000,-58000
20200528,055875,光罩元富97購02,,,,,0.00,0.00,0,0,0,0,0,0,0,0,0,0,0,0,0
20200528,055876,美食元富9A購01,0.89,0.89,0.89,0.89,-0.01,-1.11,20000,1,17800,0,0,0,0,0,0,0,0,0,0
20200528,055877,奇鋐元富97購01,1.04,1.26,1.04,1.18,+0.22,22.92,565000,41,653160,0,0,0,0,0,0,128000,437000,-309000,-309000
20200528,055878,泰碩元富97購02,,,,,0.00,0.00,0,0,0,0,0,0,0,0,0,0,0,0,0
20200528,055879,神達元富97購01,,,,,0.00,0.00,0,0,0,0,0,0,0,0,0,0,0,0,0
20200528,05587P,鴻海凱基96售12,,,,,0.00,0.00,0,0,0,0,0,0,0,0,0,0,0,0,0
20200528,055880,神達元富97購02,,,,,0.00,0.00,0,0,0,0,0,0,0,0,0,0,0,0,0
20200528,055881,康控元富97購01,,,,,0.00,0.00,0,0,0,0,0,0,0,0,0,0,0,0,0
20200528,055882,嘉聯益元富97購01,,,,,0.00,0.00,0,0,0,0,0,0,0,0,0,0,0,0,0
20200528,055883,樺漢元富97購01,,,,,0.00,0.00,0,0,0,0,0,0,0,0,0,0,0,0,0
20200528,055884,臺股指元富97購01,,,,,0.00,0.00,0,0,0,0,0,0,0,0,0,0,0,0,0
20200528,055885,大成鋼統一97購02,0.33,0.39,0.33,0.39,+0.07,21.88,334000,5,117260,0,0,0,0,0,0,152000,182000,-30000,-30000
20200528,055886,上銀統一97購02,0.93,0.93,0.59,0.59,-0.30,-33.71,6000,4,4670,0,0,0,0,0,0,5000,0,5000,5000
20200528,055887,上銀統一97購03,1.27,1.36,1.02,1.02,-0.20,-16.39,495000,34,603950,0,0,0,0,0,0,390000,105000,285000,285000
20200528,055888,鴻海統一97購04,,,,,0.00,0.00,0,0,0,0,0,0,0,0,0,0,0,0,0
20200528,055889,鴻海統一97購05,,,,,0.00,0.00,0,0,0,0,0,0,0,0,0,0,0,0,0
20200528,05588P,群創兆豐97售02,1.33,1.41,1.33,1.41,+0.06,4.44,20000,3,27400,0,0,0,0,0,0,10000,10000,0,0
20200528,055890,鴻海統一99購01,,,,,0.00,0.00,0,0,0,0,0,0,0,0,0,0,0,0,0
20200528,055891,鴻海統一9A購01,0.41,0.42,0.38,0.40,+0.01,2.56,468000,20,188940,0,0,0,0,0,0,391000,59000,332000,332000
20200528,055892,國巨統一99購01,1.06,1.07,0.95,0.95,-0.06,-5.94,25000,3,26050,0,0,0,0,0,0,20000,25000,-5000,-5000
20200528,055893,大立光統一97購07,0.19,0.19,0.16,0.16,-0.03,-15.79,70000,2,12700,0,0,0,0,0,0,50000,20000,30000,30000
20200528,055894,欣興統一97購03,0.23,0.26,0.22,0.22,0.00,0.00,390000,6,95200,0,0,0,0,0,0,210000,180000,30000,30000
20200528,055895,群創統一97購04,,,,,0.00,0.00,0,0,0,0,0,0,0,0,0,0,0,0,0
20200528,055896,南電統一97購02,1.33,1.37,1.18,1.18,-0.11,-8.53,545000,18,701230,0,0,0,0,0,0,223000,322000,-99000,-99000
20200528,055897,TXFI0永昌99購01,,,,,0.00,0.00,0,0,0,0,0,0,0,0,0,0,0,0,0
20200528,055898,訊芯第一97購01,,,,,0.00,0.00,0,0,0,0,0,0,0,0,0,0,0,0,0
20200528,055899,群創中信99購01,,,,,0.00,0.00,0,0,0,0,0,0,0,0,0,0,0,0,0
20200528,05589P,大立光中信9A售01,,,,,0.00,0.00,0,0,0,0,0,0,0,0,0,0,0,0,0
20200528,055900,瀚宇博中信97購01,,,,,0.00,0.00,0,0,0,0,0,0,0,0,0,0,0,0,0
20200528,055901,超眾中信97購01,,,,,0.00,0.00,0,0,0,0,0,0,0,0,0,0,0,0,0
20200528,055902,同欣電中信99購01,0.40,0.41,0.37,0.37,-0.02,-5.13,679000,52,262840,0,0,0,0,0,0,238000,371000,-133000,-133000
20200528,055903,鈺齊中信97購02,,,,,0.00,0.00,0,0,0,0,0,0,0,0,0,0,0,0,0
20200528,055904,貿聯亞東99購01,,,,,0.00,0.00,0,0,0,0,0,0,0,0,0,0,0,0,0
20200528,055905,可成兆豐97購03,,,,,0.00,0.00,0,0,0,0,0,0,0,0,0,0,0,0,0
20200528,055906,大立光兆豐97購03,,,,,0.00,0.00,0,0,0,0,0,0,0,0,0,0,0,0,0
20200528,055907,台虹兆豐98購01,0.68,0.68,0.66,0.66,-0.05,-7.04,180000,2,120260,0,0,0,0,0,0,180000,0,180000,180000
20200528,055908,GIS日盛97購01,,,,,0.00,0.00,0,0,0,0,0,0,0,0,0,0,0,0,0
20200528,055909,大成鋼凱基98購02,0.70,0.79,0.70,0.79,+0.04,5.33,42000,5,31280,0,0,0,0,0,0,2000,40000,-38000,-38000
20200528,05590P,臺股指中信96售05,0.27,0.37,0.27,0.37,+0.04,12.12,310000,7,97600,0,0,0,0,0,0,310000,0,310000,310000
20200528,055910,瑞昱凱基98購01,3.80,3.80,3.80,3.80,+0.08,2.15,20000,1,76000,0,0,0,0,0,0,20000,0,20000,20000
20200528,055911,可成凱基98購02,,,,,0.00,0.00,0,0,0,0,0,0,0,0,0,0,0,0,0
20200528,055912,宏達電凱基98購03,0.78,0.78,0.75,0.75,-0.13,-14.77,58000,3,45120,0,0,0,0,0,0,8000,58000,-50000,-50000
20200528,055913,中信金凱基97購01,,,,,0.00,0.00,0,0,0,0,0,0,0,0,0,0,0,0,0
20200528,055914,大立光凱基97購13,,,,,0.00,0.00,0,0,0,0,0,0,0,0,0,0,0,0,0
20200528,055915,大立光凱基98購07,,,,,0.00,0.00,0,0,0,0,0,0,0,0,0,0,0,0,0
20200528,055916,奇鋐凱基99購01,0.75,0.84,0.75,0.78,+0.04,5.41,263000,13,205170,0,0,0,0,0,0,93000,170000,-77000,-77000
20200528,055917,禾伸堂凱基98購02,,,,,0.00,0.00,0,0,0,0,0,0,0,0,0,0,0,0,0
20200528,055918,和鑫凱基97購01,,,,,0.00,0.00,0,0,0,0,0,0,0,0,0,0,0,0,0
20200528,055919,景碩凱基98購02,2.16,2.37,2.16,2.37,+0.16,7.24,25000,3,56360,0,0,0,0,0,0,15000,10000,5000,5000
20200528,05591P,義隆群益96售03,,,,,0.00,0.00,0,0,0,0,0,0,0,0,0,0,0,0,0
20200528,055920,智伸科凱基97購02,0.16,0.16,0.16,0.16,0.00,0.00,10000,1,1600,0,0,0,0,0,0,0,10000,-10000,-10000
20200528,055921,新唐凱基98購01,0.43,0.43,0.43,0.43,0.00,0.00,60000,1,25800,0,0,0,0,0,0,60000,0,60000,60000
20200528,055922,台郡凱基98購03,,,,,0.00,0.00,0,0,0,0,0,0,0,0,0,0,0,0,0
20200528,055923,矽力凱基98購01,4.26,4.90,4.22,4.37,+0.39,9.8,263000,72,1200030,0,0,0,0,0,0,100000,154000,-54000,-54000
20200528,055924,深中小群益9B購01,,,,,0.00,0.00,0,0,0,0,0,0,0,0,0,0,0,0,0
20200528,055925,上銀群益97購01,,,,,0.00,0.00,0,0,0,0,0,0,0,0,0,0,0,0,0
20200528,055926,國巨群益98購06,,,,,0.00,0.00,0,0,0,0,0,0,0,0,0,0,0,0,0
20200528,055927,南亞科群益97購01,,,,,0.00,0.00,0,0,0,0,0,0,0,0,0,0,0,0,0
20200528,055928,南亞科群益97購02,,,,,0.00,0.00,0,0,0,0,0,0,0,0,0,0,0,0,0
20200528,055929,聯發科群益97購05,1.73,1.73,1.57,1.57,-0.15,-8.72,132000,10,221280,0,0,0,0,0,0,130000,112000,18000,18000
20200528,05592P,可成群益96售03,,,,,0.00,0.00,0,0,0,0,0,0,0,0,0,0,0,0,0
20200528,055930,可成群益98購01,,,,,0.00,0.00,0,0,0,0,0,0,0,0,0,0,0,0,0
20200528,055931,冠德群益97購02,0.80,0.94,0.80,0.84,+0.03,3.7,210000,14,175840,0,0,0,0,0,0,145000,65000,80000,80000
20200528,055932,玉山金群益99購01,,,,,0.00,0.00,0,0,0,0,0,0,0,0,0,0,0,0,0
20200528,055933,欣興群益98購02,2.11,2.30,2.11,2.20,+0.01,0.46,125000,4,278750,0,0,0,0,0,0,112000,13000,99000,99000
20200528,055934,景碩群益98購03,1.90,2.06,1.90,1.95,+0.02,1.04,322000,8,645780,0,0,0,0,0,0,99000,263000,-164000,-164000
20200528,055935,創意群益97購02,0.46,0.46,0.46,0.46,+0.06,15.0,10000,1,4600,0,0,0,0,0,0,0,10000,-10000,-10000
20200528,055936,彩晶群益98購02,,,,,0.00,0.00,0,0,0,0,0,0,0,0,0,0,0,0,0
20200528,055937,康舒群益97購01,,,,,0.00,0.00,0,0,0,0,0,0,0,0,0,0,0,0,0
20200528,055938,矽力群益97購01,4.57,5.30,4.57,4.83,+0.47,10.78,82000,9,398170,0,0,0,0,0,0,55000,27000,28000,28000
20200528,055939,GIS群益97購01,,,,,0.00,0.00,0,0,0,0,0,0,0,0,0,0,0,0,0
20200528,05593P,鴻海國票97售03,,,,,0.00,0.00,0,0,0,0,0,0,0,0,0,0,0,0,0
20200528,055940,致新群益98購01,3.14,3.43,3.14,3.43,+0.32,10.29,361000,24,1180560,0,0,0,0,0,0,172000,157000,15000,15000
20200528,055941,百和群益98購02,,,,,0.00,0.00,0,0,0,0,0,0,0,0,0,0,0,0,0
20200528,055942,臺股指群益9C購01,,,,,0.00,0.00,0,0,0,0,0,0,0,0,0,0,0,0,0
20200528,055943,瑞昱麥證97購01,,,,,0.00,0.00,0,0,0,0,0,0,0,0,0,0,0,0,0
20200528,055944,日月光麥證97購01,,,,,0.00,0.00,0,0,0,0,0,0,0,0,0,0,0,0,0
20200528,055945,上証2X元大97購04,,,,,0.00,0.00,0,0,0,0,0,0,0,0,0,0,0,0,0
20200528,055946,元油反元大97購02,,,,,0.00,0.00,0,0,0,0,0,0,0,0,0,0,0,0,0
20200528,055947,元油反元大98購03,,,,,0.00,0.00,0,0,0,0,0,0,0,0,0,0,0,0,0
20200528,055948,道瓊銀元大98購02,,,,,0.00,0.00,0,0,0,0,0,0,0,0,0,0,0,0,0
20200528,055949,亞德客元大97購04,3.08,3.28,2.51,2.61,-0.27,-9.38,173000,29,521930,0,0,0,0,0,0,173000,63000,110000,110000
20200528,05594P,旺宏國票96售04,0.30,0.30,0.30,0.30,-0.05,-14.29,20000,1,6000,0,0,0,0,0,0,20000,0,20000,20000
20200528,055950,華新元大97購02,,,,,0.00,0.00,0,0,0,0,0,0,0,0,0,0,0,0,0
20200528,055951,大成鋼元大97購02,,,,,0.00,0.00,0,0,0,0,0,0,0,0,0,0,0,0,0
20200528,055952,上銀元大97購08,,,,,0.00,0.00,0,0,0,0,0,0,0,0,0,0,0,0,0
20200528,055953,上銀元大97購09,4.96,4.96,4.52,4.52,-0.33,-6.8,45000,3,211720,0,0,0,0,0,0,37000,8000,29000,29000
20200528,055954,南港元大97購02,,,,,0.00,0.00,0,0,0,0,0,0,0,0,0,0,0,0,0
20200528,055955,微星元大97購01,3.15,3.22,2.99,2.99,-0.03,-0.99,56000,6,171990,0,0,0,0,0,0,56000,26000,30000,30000
20200528,055956,瑞昱元大97購05,,,,,0.00,0.00,0,0,0,0,0,0,0,0,0,0,0,0,0
20200528,055957,瑞昱元大97購06,,,,,0.00,0.00,0,0,0,0,0,0,0,0,0,0,0,0,0
20200528,055958,台光電元大97購02,2.10,2.10,2.01,2.01,-0.09,-4.29,31000,3,65010,0,0,0,0,0,0,31000,0,31000,31000
20200528,055959,美律元大97購03,,,,,0.00,0.00,0,0,0,0,0,0,0,0,0,0,0,0,0
20200528,05595P,友達統一96售02,,,,,0.00,0.00,0,0,0,0,0,0,0,0,0,0,0,0,0
20200528,055960,義隆元大97購01,1.71,1.87,1.56,1.60,+0.17,11.89,327000,36,536760,0,0,0,0,0,0,317000,44000,273000,273000
20200528,055961,國泰金元大97購01,,,,,0.00,0.00,0,0,0,0,0,0,0,0,0,0,0,0,0
20200528,055962,晶豪科元大97購02,2.93,3.02,2.93,3.02,+0.15,5.23,92000,4,273110,0,0,0,0,0,0,0,92000,-92000,-92000
20200528,055963,欣興元大97購04,1.48,1.67,1.48,1.57,+0.14,9.79,272000,13,432700,0,0,0,0,0,0,144000,144000,0,0
20200528,055964,正文元大97購02,,,,,0.00,0.00,0,0,0,0,0,0,0,0,0,0,0,0,0
20200528,055965,泰鼎元大97購03,,,,,0.00,0.00,0,0,0,0,0,0,0,0,0,0,0,0,0
20200528,055966,茂林元大99購01,,,,,0.00,0.00,0,0,0,0,0,0,0,0,0,0,0,0,0
20200528,055967,臻鼎元大97購01,,,,,0.00,0.00,0,0,0,0,0,0,0,0,0,0,0,0,0
20200528,055968,祥碩元大97購04,,,,,0.00,0.00,0,0,0,0,0,0,0,0,0,0,0,0,0
20200528,055969,彩晶元大99購02,,,,,0.00,0.00,0,0,0,0,0,0,0,0,0,0,0,0,0
20200528,05596P,可成統一96售01,1.55,1.70,1.55,1.70,+0.02,1.19,72000,3,114570,0,0,0,0,0,0,50000,22000,28000,28000
20200528,055970,聯茂元大97購04,1.89,2.03,1.89,2.03,+0.15,7.98,58000,4,112180,0,0,0,0,0,0,9000,49000,-40000,-40000
20200528,055971,矽力元大97購05,3.38,3.43,3.38,3.43,+0.73,27.04,20000,2,68100,0,0,0,0,0,0,0,20000,-20000,-20000
20200528,055972,GIS元大97購04,1.15,1.15,0.81,0.87,-0.12,-12.12,472000,29,506610,0,0,0,0,0,0,276000,196000,80000,80000
20200528,055973,亞德客統一97購01,1.25,1.27,1.25,1.25,-0.42,-25.15,994000,10,1246820,0,0,0,0,0,0,994000,0,994000,994000
20200528,055974,上銀統一97購05,3.48,3.53,2.85,2.85,-0.81,-22.13,130000,31,419760,0,0,0,0,0,0,90000,40000,50000,50000
20200528,055975,鴻海統一98購05,,,,,0.00,0.00,0,0,0,0,0,0,0,0,0,0,0,0,0
20200528,055976,台積電統一99購03,0.11,0.11,0.06,0.06,-0.04,-40.0,615000,12,46000,0,0,0,0,0,0,120000,615000,-495000,-495000
20200528,055977,南亞科統一97購01,,,,,0.00,0.00,0,0,0,0,0,0,0,0,0,0,0,0,0
20200528,055978,大立光統一98購05,,,,,0.00,0.00,0,0,0,0,0,0,0,0,0,0,0,0,0
20200528,055979,聯鈞統一97購03,,,,,0.00,0.00,0,0,0,0,0,0,0,0,0,0,0,0,0
20200528,05597P,鴻海元富96售06,,,,,0.00,0.00,0,0,0,0,0,0,0,0,0,0,0,0,0
20200528,055980,祥碩統一98購01,2.04,2.04,2.04,2.04,+0.22,12.09,5000,1,10200,0,0,0,0,0,0,5000,0,5000,5000
20200528,055981,臺股指統一97購03,,,,,0.00,0.00,0,0,0,0,0,0,0,0,0,0,0,0,0
20200528,055982,T50反1元富97購01,,,,,0.00,0.00,0,0,0,0,0,0,0,0,0,0,0,0,0
20200528,055983,全新元富9A購02,0.50,0.51,0.50,0.51,-0.03,-5.56,70000,3,35560,0,0,0,0,0,0,70000,0,70000,70000
20200528,055984,大立光元富97購02,,,,,0.00,0.00,0,0,0,0,0,0,0,0,0,0,0,0,0
20200528,055985,聯鈞元富97購01,,,,,0.00,0.00,0,0,0,0,0,0,0,0,0,0,0,0,0
20200528,055986,祥碩元富97購01,,,,,0.00,0.00,0,0,0,0,0,0,0,0,0,0,0,0,0
20200528,055987,台表科元富97購01,0.74,0.74,0.66,0.71,-0.13,-15.48,152000,11,108960,0,0,0,0,0,0,72000,80000,-8000,-8000
20200528,055988,矽力元富97購01,2.76,3.25,2.76,2.90,+0.34,13.28,127000,35,389020,0,0,0,0,0,0,27000,98000,-71000,-71000
20200528,055989,矽力元富9A購01,3.60,4.12,3.60,3.75,+0.35,10.29,112000,31,424700,0,0,0,0,0,0,51000,54000,-3000,-3000
20200528,05598P,國巨元富96售03,,,,,0.00,0.00,0,0,0,0,0,0,0,0,0,0,0,0,0
20200528,055990,矽創元富97購01,,,,,0.00,0.00,0,0,0,0,0,0,0,0,0,0,0,0,0
20200528,055991,鈺齊元富97購01,,,,,0.00,0.00,0,0,0,0,0,0,0,0,0,0,0,0,0
20200528,055992,智原台新97購02,,,,,0.00,0.00,0,0,0,0,0,0,0,0,0,0,0,0,0
20200528,055993,致茂國泰99購01,,,,,0.00,0.00,0,0,0,0,0,0,0,0,0,0,0,0,0
20200528,055994,聯發科國泰99購02,2.40,2.40,2.11,2.22,-0.11,-4.72,161000,3,341100,0,0,0,0,0,0,160000,160000,0,0
20200528,055995,華擎國泰99購01,,,,,0.00,0.00,0,0,0,0,0,0,0,0,0,0,0,0,0
20200528,055996,矽力國泰99購01,3.85,3.88,3.81,3.81,+0.61,19.06,18000,4,69240,0,0,0,0,0,0,0,18000,-18000,-18000
20200528,055997,矽創國泰99購01,0.64,0.64,0.54,0.54,0.00,0.00,2000,2,1180,0,0,0,0,0,0,0,2000,-2000,-2000
20200528,055998,臺股指富邦99購01,,,,,0.00,0.00,0,0,0,0,0,0,0,0,0,0,0,0,0
20200528,055999,電子類富邦99購01,,,,,0.00,0.00,0,0,0,0,0,0,0,0,0,0,0,0,0
20200528,05599P,欣興台新96售01,,,,,0.00,0.00,0,0,0,0,0,0,0,0,0,0,0,0,0
20200528,056000,佳世達永豐97購01,,,,,0.00,0.00,0,0,0,0,0,0,0,0,0,0,0,0,0
20200528,056001,美食永豐97購01,0.49,0.49,0.45,0.45,-0.08,-15.09,152000,15,72630,0,0,0,0,0,0,35000,117000,-82000,-82000
20200528,056002,嘉晶永豐97購01,1.15,1.16,1.12,1.12,-0.17,-13.18,83000,5,93840,0,0,0,0,0,0,82000,1000,81000,81000
20200528,056003,智伸科永豐97購02,,,,,0.00,0.00,0,0,0,0,0,0,0,0,0,0,0,0,0
20200528,056004,南電永豐97購02,1.59,1.59,1.48,1.48,-0.10,-6.33,13000,2,20450,0,0,0,0,0,0,13000,0,13000,13000
20200528,056005,臺股指永豐97購04,,,,,0.00,0.00,0,0,0,0,0,0,0,0,0,0,0,0,0
20200528,056006,義隆亞東97購01,,,,,0.00,0.00,0,0,0,0,0,0,0,0,0,0,0,0,0
20200528,056007,上銀中信97購02,,,,,0.00,0.00,0,0,0,0,0,0,0,0,0,0,0,0,0
20200528,056008,全新中信9B購01,,,,,0.00,0.00,0,0,0,0,0,0,0,0,0,0,0,0,0
20200528,056009,奇力新中信98購03,,,,,0.00,0.00,0,0,0,0,0,0,0,0,0,0,0,0,0
20200528,05600P,玉晶光台新96售04,,,,,0.00,0.00,0,0,0,0,0,0,0,0,0,0,0,0,0
20200528,056010,力成中信97購01,,,,,0.00,0.00,0,0,0,0,0,0,0,0,0,0,0,0,0
20200528,056011,矽力中信99購01,1.54,1.81,1.54,1.62,+0.16,10.96,55000,8,90300,0,0,0,0,0,0,49000,6000,43000,43000
20200528,056012,勤誠中信99購01,0.20,0.21,0.19,0.19,0.00,0.00,65000,3,12900,0,0,0,0,0,0,0,65000,-65000,-65000
20200528,056013,T50反1群益97購01,,,,,0.00,0.00,0,0,0,0,0,0,0,0,0,0,0,0,0
20200528,056014,上銀群益97購02,1.09,1.18,1.09,1.15,+0.04,3.6,119000,11,135470,0,0,0,0,0,0,119000,0,119000,119000
20200528,056015,華通群益99購01,0.69,0.69,0.69,0.69,0.00,0.00,1000,1,690,0,0,0,0,0,0,0,1000,-1000,-1000
20200528,056016,鴻海群益97購06,,,,,0.00,0.00,0,0,0,0,0,0,0,0,0,0,0,0,0
20200528,056017,台積電群益97購04,,,,,0.00,0.00,0,0,0,0,0,0,0,0,0,0,0,0,0
20200528,056018,旺宏群益97購02,,,,,0.00,0.00,0,0,0,0,0,0,0,0,0,0,0,0,0
20200528,056019,燿華群益97購02,,,,,0.00,0.00,0,0,0,0,0,0,0,0,0,0,0,0,0
20200528,05601P,鴻海元大97售04,,,,,0.00,0.00,0,0,0,0,0,0,0,0,0,0,0,0,0
20200528,056020,義隆群益97購01,1.51,1.64,1.43,1.43,+0.04,2.88,184000,17,281610,0,0,0,0,0,0,77000,132000,-55000,-55000
20200528,056021,興富發群益97購01,1.31,1.40,1.28,1.28,-0.02,-1.54,145000,6,193670,0,0,0,0,0,0,53000,92000,-39000,-39000
20200528,056022,新光金群益97購02,,,,,0.00,0.00,0,0,0,0,0,0,0,0,0,0,0,0,0
20200528,056023,晶豪科群益97購01,2.40,2.47,2.22,2.22,-0.17,-7.11,242000,4,563400,0,0,0,0,0,0,122000,120000,2000,2000
20200528,056024,大立光群益97購05,,,,,0.00,0.00,0,0,0,0,0,0,0,0,0,0,0,0,0
20200528,056025,嘉晶群益97購01,5.10,5.30,4.46,4.62,-1.13,-19.65,197000,17,970940,80000,0,80000,0,0,0,41000,156000,-115000,-35000
20200528,056026,智易群益97購01,1.94,2.04,1.94,2.02,0.00,0.00,18000,4,35640,0,0,0,0,0,0,0,18000,-18000,-18000
20200528,056027,樺漢群益97購02,,,,,0.00,0.00,0,0,0,0,0,0,0,0,0,0,0,0,0
20200528,056028,GIS群益97購02,1.44,1.44,1.44,1.44,-0.03,-2.04,11000,2,15840,0,0,0,0,0,0,11000,0,11000,11000
20200528,056029,國巨麥證98購01,,,,,0.00,0.00,0,0,0,0,0,0,0,0,0,0,0,0,0
20200528,05602P,國巨元大96售06,,,,,0.00,0.00,0,0,0,0,0,0,0,0,0,0,0,0,0
20200528,056030,華通日盛97購01,,,,,0.00,0.00,0,0,0,0,0,0,0,0,0,0,0,0,0
20200528,056031,勤誠康和97購02,,,,,0.00,0.00,0,0,0,0,0,0,0,0,0,0,0,0,0
20200528,056032,勤誠康和97購03,,,,,0.00,0.00,0,0,0,0,0,0,0,0,0,0,0,0,0
20200528,056033,T50正2凱基99購02,,,,,0.00,0.00,0,0,0,0,0,0,0,0,0,0,0,0,0
20200528,056034,華通凱基98購01,,,,,0.00,0.00,0,0,0,0,0,0,0,0,0,0,0,0,0
20200528,056035,鴻海凱基97購06,,,,,0.00,0.00,0,0,0,0,0,0,0,0,0,0,0,0,0
20200528,056036,鴻海凱基97購07,,,,,0.00,0.00,0,0,0,0,0,0,0,0,0,0,0,0,0
20200528,056037,美律凱基98購03,,,,,0.00,0.00,0,0,0,0,0,0,0,0,0,0,0,0,0
20200528,056038,可成凱基97購01,0.66,0.66,0.64,0.64,0.00,0.00,176000,2,113360,0,0,0,0,0,0,140000,36000,104000,104000
20200528,056039,宏達電凱基97購02,,,,,0.00,0.00,0,0,0,0,0,0,0,0,0,0,0,0,0
20200528,05603P,聯發科元大96售09,,,,,0.00,0.00,0,0,0,0,0,0,0,0,0,0,0,0,0
20200528,056040,亞光凱基98購01,0.10,0.10,0.10,0.10,0.00,0.00,80000,1,8000,0,0,0,0,0,0,80000,0,80000,80000
20200528,056041,禾伸堂凱基98購03,3.22,3.22,3.22,3.22,0.00,0.00,20000,1,64400,0,0,0,0,0,0,0,20000,-20000,-20000
20200528,056042,京鼎凱基97購02,,,,,0.00,0.00,0,0,0,0,0,0,0,0,0,0,0,0,0
20200528,056043,力成凱基97購01,,,,,0.00,0.00,0,0,0,0,0,0,0,0,0,0,0,0,0
20200528,056044,同欣電凱基97購03,0.46,0.46,0.44,0.46,-0.08,-14.81,442000,6,203280,0,0,0,0,0,0,442000,0,442000,442000
20200528,056045,勤誠凱基97購01,,,,,0.00,0.00,0,0,0,0,0,0,0,0,0,0,0,0,0
20200528,056046,百和凱基97購01,,,,,0.00,0.00,0,0,0,0,0,0,0,0,0,0,0,0,0
20200528,056047,台積電兆豐97購02,,,,,0.00,0.00,0,0,0,0,0,0,0,0,0,0,0,0,0
20200528,056048,同欣電兆豐97購01,0.07,0.07,0.07,0.07,0.00,0.00,1000,1,70,0,0,0,0,0,0,1000,0,1000,1000
20200528,056049,奇力新國票98購01,0.33,0.33,0.29,0.29,0.00,0.00,30000,3,9100,0,0,0,0,0,0,0,30000,-30000,-30000
20200528,05604P,聯發科元大96售10,,,,,0.00,0.00,0,0,0,0,0,0,0,0,0,0,0,0,0
20200528,056050,晶技國票98購01,,,,,0.00,0.00,0,0,0,0,0,0,0,0,0,0,0,0,0
20200528,056051,T50反1元大97購05,,,,,0.00,0.00,0,0,0,0,0,0,0,0,0,0,0,0,0
20200528,056052,T50反1元大97購06,,,,,0.00,0.00,0,0,0,0,0,0,0,0,0,0,0,0,0
20200528,056053,和大元大97購05,,,,,0.00,0.00,0,0,0,0,0,0,0,0,0,0,0,0,0
20200528,056054,亞德客元大97購05,3.11,3.33,2.47,2.47,-0.46,-15.7,140000,33,427810,0,0,0,0,0,0,128000,23000,105000,105000
20200528,056055,國巨元大97購15,,,,,0.00,0.00,0,0,0,0,0,0,0,0,0,0,0,0,0
20200528,056056,旺宏元大97購06,,,,,0.00,0.00,0,0,0,0,0,0,0,0,0,0,0,0,0
20200528,056057,華邦電元大97購05,0.46,0.50,0.42,0.42,+0.09,27.27,300000,21,142200,0,0,0,0,0,0,300000,0,300000,300000
20200528,056058,建準元大97購02,2.70,2.92,2.65,2.92,+0.45,18.22,50000,5,138300,0,0,0,0,0,0,50000,0,50000,50000
20200528,056059,美律元大98購02,,,,,0.00,0.00,0,0,0,0,0,0,0,0,0,0,0,0,0
20200528,05605P,嘉聯益元大97售02,,,,,0.00,0.00,0,0,0,0,0,0,0,0,0,0,0,0,0
20200528,056060,宏達電元大99購01,,,,,0.00,0.00,0,0,0,0,0,0,0,0,0,0,0,0,0
20200528,056061,國泰金元大97購02,,,,,0.00,0.00,0,0,0,0,0,0,0,0,0,0,0,0,0
20200528,056062,大立光元大97購12,0.16,0.16,0.16,0.16,0.00,0.00,10000,1,1600,0,0,0,0,0,0,10000,10000,0,0
20200528,056063,大立光元大97購13,,,,,0.00,0.00,0,0,0,0,0,0,0,0,0,0,0,0,0
20200528,056064,大立光元大97購14,,,,,0.00,0.00,0,0,0,0,0,0,0,0,0,0,0,0,0
20200528,056065,奇鋐元大97購01,1.74,2.02,1.73,2.02,+0.40,24.69,177000,5,321550,0,0,0,0,0,0,50000,127000,-77000,-77000
20200528,056066,奇鋐元大98購02,0.54,0.54,0.54,0.54,0.00,0.00,30000,1,16200,0,0,0,0,0,0,0,0,0,0
20200528,056067,智原元大97購01,,,,,0.00,0.00,0,0,0,0,0,0,0,0,0,0,0,0,0
20200528,056068,欣興元大97購05,1.73,1.83,1.73,1.83,0.00,0.00,44000,7,78310,0,0,0,0,0,0,1000,44000,-43000,-43000
20200528,056069,新日興元大97購03,0.09,0.09,0.09,0.09,0.00,0.00,2000,1,180,0,0,0,0,0,0,2000,0,2000,2000
20200528,05606P,TPK國票97售02,1.70,1.84,1.70,1.84,0.00,0.00,73000,3,131480,0,0,0,0,0,0,0,73000,-73000,-73000
20200528,056070,新日興元大97購04,,,,,0.00,0.00,0,0,0,0,0,0,0,0,0,0,0,0,0
20200528,056071,創意元大97購02,0.60,0.60,0.60,0.60,0.00,0.00,2000,1,1200,0,0,0,0,0,0,0,2000,-2000,-2000
20200528,056072,群創元大97購01,,,,,0.00,0.00,0,0,0,0,0,0,0,0,0,0,0,0,0
20200528,056073,智伸科元大97購01,,,,,0.00,0.00,0,0,0,0,0,0,0,0,0,0,0,0,0
20200528,056074,茂林元大97購04,,,,,0.00,0.00,0,0,0,0,0,0,0,0,0,0,0,0,0
20200528,056075,瀚宇博元大97購03,1.17,1.19,1.12,1.17,0.00,0.00,426000,28,490570,0,0,0,0,0,0,341000,189000,152000,152000
20200528,056076,超眾元大97購05,1.93,1.98,1.79,1.98,-0.14,-6.6,32000,4,60460,0,0,0,0,0,0,30000,12000,18000,18000
20200528,056077,矽力元大97購07,3.91,4.32,3.91,4.14,+0.43,11.59,215000,19,865050,0,0,0,0,0,0,148000,67000,81000,81000
20200528,056078,勤誠元大97購01,,,,,0.00,0.00,0,0,0,0,0,0,0,0,0,0,0,0,0
20200528,056079,世紀鋼元大97購02,2.94,2.94,2.94,2.94,0.00,0.00,10000,1,29400,0,0,0,0,0,0,10000,0,10000,10000
20200528,05607P,華通日盛96售01,,,,,0.00,0.00,0,0,0,0,0,0,0,0,0,0,0,0,0
20200528,056080,世紀鋼元大97購03,1.65,1.96,1.65,1.96,0.00,0.00,4000,4,7080,0,0,0,0,0,0,0,4000,-4000,-4000
20200528,056081,T50反1統一99購02,,,,,0.00,0.00,0,0,0,0,0,0,0,0,0,0,0,0,0
20200528,056082,旺宏統一99購02,,,,,0.00,0.00,0,0,0,0,0,0,0,0,0,0,0,0,0
20200528,056083,億光統一97購03,0.52,0.52,0.47,0.48,0.00,0.00,131000,3,64950,0,0,0,0,0,0,0,131000,-131000,-131000
20200528,056084,漢唐統一97購03,2.00,2.00,2.00,2.00,+0.03,1.52,24000,2,48000,0,0,0,0,0,0,12000,12000,0,0
20200528,056085,聯發科統一97購01,4.18,4.18,4.18,4.18,0.00,0.00,1000,1,4180,0,0,0,0,0,0,0,1000,-1000,-1000
20200528,056086,奇力新統一98購01,0.02,0.02,0.02,0.02,0.00,0.00,10000,1,200,0,0,0,0,0,0,10000,0,10000,10000
20200528,056087,世芯統一97購01,0.89,0.89,0.78,0.79,-0.08,-9.2,70000,4,56050,0,0,0,0,0,0,60000,10000,50000,50000
20200528,056088,台郡統一97購02,0.82,0.82,0.82,0.82,-0.02,-2.38,49000,2,40180,0,0,0,0,0,0,1000,48000,-47000,-47000
20200528,056089,同欣電統一98購01,,,,,0.00,0.00,0,0,0,0,0,0,0,0,0,0,0,0,0
20200528,05608P,聯發科凱基96售10,,,,,0.00,0.00,0,0,0,0,0,0,0,0,0,0,0,0,0
20200528,056090,康舒統一97購01,,,,,0.00,0.00,0,0,0,0,0,0,0,0,0,0,0,0,0
20200528,056091,百和統一97購01,0.53,0.54,0.47,0.47,-0.04,-7.84,426000,12,219300,0,0,0,0,0,0,360000,66000,294000,294000
20200528,056092,亞德客元富97購02,2.50,2.71,2.01,2.01,-0.37,-15.55,331000,55,833890,0,0,0,0,0,0,175000,93000,82000,82000
20200528,056093,大毅元富97購01,,,,,0.00,0.00,0,0,0,0,0,0,0,0,0,0,0,0,0
20200528,056094,大立光元富97購03,0.35,0.35,0.29,0.30,-0.04,-11.76,323000,10,98940,0,0,0,0,0,0,40000,283000,-243000,-243000
20200528,056095,臻鼎元富9A購01,,,,,0.00,0.00,0,0,0,0,0,0,0,0,0,0,0,0,0
20200528,056096,超眾元富9A購01,,,,,0.00,0.00,0,0,0,0,0,0,0,0,0,0,0,0,0
20200528,056097,訊芯元富97購02,,,,,0.00,0.00,0,0,0,0,0,0,0,0,0,0,0,0,0
20200528,056098,矽創元富97購02,0.59,0.60,0.51,0.52,+0.06,13.04,679000,24,389520,0,0,0,0,0,0,200000,479000,-279000,-279000
20200528,056099,上銀永豐97購02,0.11,0.11,0.05,0.05,-0.06,-54.55,51000,3,2610,0,0,0,0,0,0,0,0,0,0
20200528,05609P,國泰金凱基96售01,0.02,0.02,0.02,0.02,0.00,0.00,20000,1,400,0,0,0,0,0,0,20000,0,20000,20000
20200528,056100,楠梓電永豐97購02,,,,,0.00,0.00,0,0,0,0,0,0,0,0,0,0,0,0,0
20200528,056101,光磊永豐98購01,0.63,0.66,0.63,0.66,-0.02,-2.94,163000,5,104790,0,0,0,0,0,0,0,163000,-163000,-163000
20200528,056102,億光永豐97購02,,,,,0.00,0.00,0,0,0,0,0,0,0,0,0,0,0,0,0
20200528,056103,聯發科永豐97購03,,,,,0.00,0.00,0,0,0,0,0,0,0,0,0,0,0,0,0
20200528,056104,義隆永豐97購01,0.57,0.63,0.57,0.63,0.00,0.00,5000,2,3030,0,0,0,0,0,0,0,5000,-5000,-5000
20200528,056105,智原永豐97購01,,,,,0.00,0.00,0,0,0,0,0,0,0,0,0,0,0,0,0
20200528,056106,晶相光永豐97購02,,,,,0.00,0.00,0,0,0,0,0,0,0,0,0,0,0,0,0
20200528,056107,智易永豐97購02,1.44,1.55,1.44,1.55,+0.13,9.15,94000,14,138750,0,0,0,0,0,0,40000,54000,-14000,-14000
20200528,056108,麗豐永豐97購01,,,,,0.00,0.00,0,0,0,0,0,0,0,0,0,0,0,0,0
20200528,056109,彩晶永豐98購01,,,,,0.00,0.00,0,0,0,0,0,0,0,0,0,0,0,0,0
20200528,05610P,國巨群益98售01,,,,,0.00,0.00,0,0,0,0,0,0,0,0,0,0,0,0,0
20200528,056110,嘉聯益永豐97購02,,,,,0.00,0.00,0,0,0,0,0,0,0,0,0,0,0,0,0
20200528,056111,力成永豐97購01,,,,,0.00,0.00,0,0,0,0,0,0,0,0,0,0,0,0,0
20200528,056112,勤誠永豐97購02,,,,,0.00,0.00,0,0,0,0,0,0,0,0,0,0,0,0,0
20200528,056113,新日興兆豐98購01,,,,,0.00,0.00,0,0,0,0,0,0,0,0,0,0,0,0,0
20200528,056114,台達電群益97購02,,,,,0.00,0.00,0,0,0,0,0,0,0,0,0,0,0,0,0
20200528,056115,奇力新群益97購06,,,,,0.00,0.00,0,0,0,0,0,0,0,0,0,0,0,0,0
20200528,056116,義隆群益97購02,1.94,2.11,1.94,1.98,+0.14,7.61,102000,23,204560,0,0,0,0,0,0,59000,75000,-16000,-16000
20200528,056117,宏達電群益97購02,,,,,0.00,0.00,0,0,0,0,0,0,0,0,0,0,0,0,0
20200528,056118,聯詠群益97購03,,,,,0.00,0.00,0,0,0,0,0,0,0,0,0,0,0,0,0
20200528,056119,欣興群益97購02,0.90,1.01,0.90,0.90,+0.03,3.45,1334000,18,1217010,0,0,0,0,0,0,599000,735000,-136000,-136000
20200528,05611P,康控群益96售02,,,,,0.00,0.00,0,0,0,0,0,0,0,0,0,0,0,0,0
20200528,056120,聯茂群益97購02,,,,,0.00,0.00,0,0,0,0,0,0,0,0,0,0,0,0,0
20200528,056121,勤誠群益97購01,0.63,0.63,0.62,0.62,-0.08,-11.43,200000,2,125000,0,0,0,0,0,0,0,200000,-200000,-200000
20200528,056122,勤誠群益97購02,1.20,1.20,1.12,1.12,-0.15,-11.81,204000,4,241430,0,0,0,0,0,0,102000,102000,0,0
20200528,056123,鈺齊群益97購01,,,,,0.00,0.00,0,0,0,0,0,0,0,0,0,0,0,0,0
20200528,056124,華通國票98購02,2.08,2.26,1.94,1.94,+0.16,8.99,99000,7,218560,0,0,0,0,0,0,1000,98000,-97000,-97000
20200528,056125,旺宏國票98購02,,,,,0.00,0.00,0,0,0,0,0,0,0,0,0,0,0,0,0
20200528,056126,台郡國票98購02,2.21,2.28,2.21,2.28,+0.08,3.64,22000,2,49390,0,0,0,0,0,0,11000,11000,0,0
20200528,056127,致新國票98購02,1.99,2.22,1.99,2.22,+0.31,16.23,496000,24,1026300,0,0,0,0,0,0,289000,202000,87000,87000
20200528,056128,和大中信99購01,0.08,0.09,0.08,0.09,+0.02,28.57,30000,3,2500,0,0,0,0,0,0,0,30000,-30000,-30000
20200528,056129,義隆麥證97購01,1.03,1.03,1.03,1.03,+0.15,17.05,50000,1,51500,0,50000,-50000,0,0,0,0,50000,-50000,-50000
20200528,05612P,台積電元大96售13,,,,,0.00,0.00,0,0,0,0,0,0,0,0,0,0,0,0,0
20200528,056130,新日興麥證97購01,0.18,0.18,0.18,0.18,+0.04,28.57,20000,1,3600,20000,0,20000,0,0,0,20000,0,20000,20000
20200528,056131,鴻海元大97購12,,,,,0.00,0.00,0,0,0,0,0,0,0,0,0,0,0,0,0
20200528,056132,台光電元大97購03,5.20,5.20,4.55,4.61,-0.49,-9.61,152000,14,759510,0,0,0,0,0,0,92000,60000,32000,32000
20200528,056133,可成元大97購05,1.22,1.24,1.15,1.15,-0.04,-3.36,69000,6,84510,0,0,0,0,0,0,69000,1000,68000,68000
20200528,056134,可成元大97購06,,,,,0.00,0.00,0,0,0,0,0,0,0,0,0,0,0,0,0
20200528,056135,緯創元大98購01,4.20,4.26,4.07,4.07,-0.01,-0.25,102000,8,428600,0,0,0,0,0,0,64000,38000,26000,26000
20200528,056136,京鼎元大98購01,0.66,0.67,0.66,0.67,0.00,0.00,174000,2,115840,0,0,0,0,0,0,74000,100000,-26000,-26000
20200528,056137,聯鈞元大9A購01,,,,,0.00,0.00,0,0,0,0,0,0,0,0,0,0,0,0,0
20200528,056138,群創元大9B購01,,,,,0.00,0.00,0,0,0,0,0,0,0,0,0,0,0,0,0
20200528,056139,貿聯元大97購04,0.94,0.94,0.91,0.91,-0.03,-3.19,153000,8,140090,0,0,0,0,0,0,153000,0,153000,153000
20200528,05613P,臻鼎台新96售01,,,,,0.00,0.00,0,0,0,0,0,0,0,0,0,0,0,0,0
20200528,056140,康控元大98購01,,,,,0.00,0.00,0,0,0,0,0,0,0,0,0,0,0,0,0
20200528,056141,聯茂元大97購05,1.66,1.79,1.66,1.79,+0.13,7.83,179000,11,310140,0,0,0,0,0,0,73000,106000,-33000,-33000
20200528,056142,超眾元大97購06,0.81,0.83,0.81,0.83,-0.05,-5.68,4000,4,3270,0,0,0,0,0,0,1000,3000,-2000,-2000
20200528,056143,訊芯元大97購04,0.23,0.23,0.23,0.23,-0.04,-14.81,2000,1,460,0,0,0,0,0,0,0,2000,-2000,-2000
20200528,056144,GIS元大98購01,2.60,2.64,2.15,2.22,-0.15,-6.33,771000,45,1870520,0,0,0,0,0,0,452000,233000,219000,219000
20200528,056145,緯穎元大98購03,,,,,0.00,0.00,0,0,0,0,0,0,0,0,0,0,0,0,0
20200528,056146,台虹元大98購01,1.46,1.47,1.33,1.33,-0.10,-6.99,526000,11,759590,0,0,0,0,0,0,526000,51000,475000,475000
20200528,056147,鴻海日盛97購05,0.06,0.11,0.06,0.11,0.00,0.00,250000,3,24000,0,0,0,0,0,0,250000,200000,50000,50000
20200528,056148,臺股指日盛97購03,,,,,0.00,0.00,0,0,0,0,0,0,0,0,0,0,0,0,0
20200528,056149,亞光康和97購01,,,,,0.00,0.00,0,0,0,0,0,0,0,0,0,0,0,0,0
20200528,05614P,臺股指康和96售03,,,,,0.00,0.00,0,0,0,0,0,0,0,0,0,0,0,0,0
20200528,056150,台光電凱基98購02,2.99,2.99,2.99,2.99,-0.15,-4.78,10000,1,29900,0,0,0,0,0,0,10000,0,10000,10000
20200528,056151,建準凱基97購01,2.85,3.38,2.85,3.38,+0.30,9.74,61000,8,191380,0,0,0,0,0,0,10000,51000,-41000,-41000
20200528,056152,可成凱基97購02,,,,,0.00,0.00,0,0,0,0,0,0,0,0,0,0,0,0,0
20200528,056153,華新科凱基97購02,,,,,0.00,0.00,0,0,0,0,0,0,0,0,0,0,0,0,0
20200528,056154,宏達電凱基97購03,,,,,0.00,0.00,0,0,0,0,0,0,0,0,0,0,0,0,0
20200528,056155,嘉晶凱基97購01,2.09,2.09,1.85,1.85,-0.20,-9.76,16000,4,31280,0,0,0,0,0,0,11000,5000,6000,6000
20200528,056156,禾伸堂凱基98購04,,,,,0.00,0.00,0,0,0,0,0,0,0,0,0,0,0,0,0
20200528,056157,聯詠凱基97購03,1.13,1.13,1.13,1.13,-0.07,-5.83,1000,1,1130,0,0,0,0,0,0,0,1000,-1000,-1000
20200528,056158,新日興凱基98購02,,,,,0.00,0.00,0,0,0,0,0,0,0,0,0,0,0,0,0
20200528,056159,牧德凱基99購01,,,,,0.00,0.00,0,0,0,0,0,0,0,0,0,0,0,0,0
20200528,05615P,臺股指康和96售04,,,,,0.00,0.00,0,0,0,0,0,0,0,0,0,0,0,0,0
20200528,056160,智易凱基97購03,1.80,1.88,1.80,1.88,+0.29,18.24,33000,4,60880,0,0,0,0,0,0,18000,15000,3000,3000
20200528,056161,康控凱基98購02,,,,,0.00,0.00,0,0,0,0,0,0,0,0,0,0,0,0,0
20200528,056162,祥碩凱基97購03,6.30,7.70,6.30,7.05,+0.75,11.9,123000,12,898850,0,0,0,0,0,0,99000,24000,75000,75000
20200528,056163,嘉聯益凱基98購03,,,,,0.00,0.00,0,0,0,0,0,0,0,0,0,0,0,0,0
20200528,056164,聯茂凱基98購03,,,,,0.00,0.00,0,0,0,0,0,0,0,0,0,0,0,0,0
20200528,056165,矽力凱基98購02,1.95,2.32,1.95,2.11,+0.37,21.26,49000,6,103170,1000,0,1000,0,0,0,30000,19000,11000,12000
20200528,056166,微星台新97購01,1.19,1.19,1.12,1.14,+0.04,3.64,116000,7,135420,0,0,0,0,0,0,4000,112000,-108000,-108000
20200528,056167,力成台新97購01,0.15,0.16,0.15,0.16,0.00,0.00,658000,6,101700,0,0,0,0,0,0,658000,658000,0,0
20200528,056168,鴻海元富97購07,1.17,1.17,1.17,1.17,+0.01,0.86,98000,2,114660,0,0,0,0,0,0,98000,0,98000,98000
20200528,056169,鴻海元富97購08,1.02,1.03,0.96,0.96,-0.03,-3.03,46000,3,46820,0,0,0,0,0,0,42000,4000,38000,38000
20200528,05616P,台光電永豐96售01,,,,,0.00,0.00,0,0,0,0,0,0,0,0,0,0,0,0,0
20200528,056170,鴻海元富97購09,,,,,0.00,0.00,0,0,0,0,0,0,0,0,0,0,0,0,0
20200528,056171,鴻海元富97購10,,,,,0.00,0.00,0,0,0,0,0,0,0,0,0,0,0,0,0
20200528,056172,鴻海元富97購11,,,,,0.00,0.00,0,0,0,0,0,0,0,0,0,0,0,0,0
20200528,056173,廣達元富97購01,,,,,0.00,0.00,0,0,0,0,0,0,0,0,0,0,0,0,0
20200528,056174,億光元富97購01,0.51,0.51,0.51,0.51,0.00,0.00,1000,1,510,0,0,0,0,0,0,0,1000,-1000,-1000
20200528,056175,可成元富97購03,,,,,0.00,0.00,0,0,0,0,0,0,0,0,0,0,0,0,0
20200528,056176,創意元富97購01,0.42,0.42,0.42,0.42,0.00,0.00,35000,1,14700,0,0,0,0,0,0,35000,0,35000,35000
20200528,056177,嘉澤元富97購01,,,,,0.00,0.00,0,0,0,0,0,0,0,0,0,0,0,0,0
20200528,056178,嘉澤元富97購02,3.16,3.16,2.85,2.85,-0.58,-16.91,27000,3,82080,0,0,0,0,0,0,17000,10000,7000,7000
20200528,056179,康友元富97購02,,,,,0.00,0.00,0,0,0,0,0,0,0,0,0,0,0,0,0
20200528,05617P,大立光統一97售02,1.57,1.60,1.57,1.60,0.00,0.00,3000,2,4740,0,0,0,0,0,0,0,3000,-3000,-3000
20200528,056180,南茂元富97購01,,,,,0.00,0.00,0,0,0,0,0,0,0,0,0,0,0,0,0
20200528,056181,百和元富97購02,,,,,0.00,0.00,0,0,0,0,0,0,0,0,0,0,0,0,0
20200528,056182,台光電統一97購03,2.12,2.12,1.85,1.85,-0.24,-11.48,30000,3,60500,0,0,0,0,0,0,0,30000,-30000,-30000
20200528,056183,南亞科統一97購02,0.41,0.41,0.41,0.41,0.00,0.00,10000,1,4100,0,0,0,0,0,0,0,10000,-10000,-10000
20200528,056184,南亞科統一97購03,,,,,0.00,0.00,0,0,0,0,0,0,0,0,0,0,0,0,0
20200528,056185,全新統一98購01,,,,,0.00,0.00,0,0,0,0,0,0,0,0,0,0,0,0,0
20200528,056186,智原統一97購01,,,,,0.00,0.00,0,0,0,0,0,0,0,0,0,0,0,0,0
20200528,056187,京鼎統一97購01,,,,,0.00,0.00,0,0,0,0,0,0,0,0,0,0,0,0,0
20200528,056188,晶相光統一99購01,,,,,0.00,0.00,0,0,0,0,0,0,0,0,0,0,0,0,0
20200528,056189,樺漢統一97購02,,,,,0.00,0.00,0,0,0,0,0,0,0,0,0,0,0,0,0
20200528,05618P,聯發科元富96售02,,,,,0.00,0.00,0,0,0,0,0,0,0,0,0,0,0,0,0
20200528,056190,昇陽半統一97購01,,,,,0.00,0.00,0,0,0,0,0,0,0,0,0,0,0,0,0
20200528,056191,世紀鋼統一97購01,2.79,3.54,2.78,3.31,+0.44,15.33,506000,30,1548590,0,0,0,0,0,0,201000,305000,-104000,-104000
20200528,056192,智邦富邦98購01,1.75,1.75,1.75,1.75,0.00,0.00,6000,1,10500,0,0,0,0,0,0,6000,0,6000,6000
20200528,056193,聯發科富邦99購08,1.72,1.72,1.63,1.66,0.00,0.00,24000,4,40000,0,0,0,0,0,0,20000,4000,16000,16000
20200528,056194,聯發科富邦9B購01,,,,,0.00,0.00,0,0,0,0,0,0,0,0,0,0,0,0,0
20200528,056195,群創富邦98購01,0.20,0.20,0.20,0.20,0.00,0.00,30000,1,6000,0,0,0,0,0,0,30000,0,30000,30000
20200528,056196,聯茂富邦98購02,0.49,0.54,0.49,0.53,+0.02,3.92,405000,13,211500,0,0,0,0,0,0,320000,85000,235000,235000
20200528,056197,友訊永豐97購01,,,,,0.00,0.00,0,0,0,0,0,0,0,0,0,0,0,0,0
20200528,056198,台光電永豐97購02,1.24,1.24,1.14,1.14,-0.13,-10.24,29000,5,35260,0,0,0,0,0,0,17000,12000,5000,5000
20200528,056199,美律永豐97購01,,,,,0.00,0.00,0,0,0,0,0,0,0,0,0,0,0,0,0
20200528,05619P,創意元富96售02,,,,,0.00,0.00,0,0,0,0,0,0,0,0,0,0,0,0,0
20200528,056200,大毅永豐98購01,0.90,0.90,0.86,0.86,-0.02,-2.27,12000,3,10720,0,0,0,0,0,0,10000,2000,8000,8000
20200528,056201,華新科永豐98購01,,,,,0.00,0.00,0,0,0,0,0,0,0,0,0,0,0,0,0
20200528,056202,國揚永豐97購01,0.71,0.71,0.71,0.71,0.00,0.00,1000,1,710,0,0,0,0,0,0,0,0,0,0
20200528,056203,興富發永豐97購01,1.28,1.33,1.28,1.33,+0.08,6.4,35000,3,45960,0,0,0,0,0,0,0,35000,-35000,-35000
20200528,056204,嘉澤永豐97購01,0.56,0.56,0.54,0.54,-0.21,-28.0,100000,6,54600,0,0,0,0,0,0,50000,50000,0,0
20200528,056205,貿聯永豐97購01,,,,,0.00,0.00,0,0,0,0,0,0,0,0,0,0,0,0,0
20200528,056206,泰鼎永豐97購01,1.95,1.95,1.89,1.89,-0.05,-2.58,115000,4,223430,0,0,0,0,0,0,105000,110000,-5000,-5000
20200528,056207,茂林永豐97購03,0.17,0.17,0.17,0.17,-0.02,-10.53,6000,2,1020,0,0,0,0,0,0,5000,1000,4000,4000
20200528,056208,崇越永豐97購01,0.24,0.24,0.24,0.24,0.00,0.00,5000,1,1200,0,0,0,0,0,0,5000,0,5000,5000
20200528,056209,超眾永豐97購02,0.77,0.81,0.72,0.80,-0.02,-2.44,193000,19,144460,0,0,0,0,0,0,150000,43000,107000,107000
20200528,05620P,大立光富邦9B售01,0.88,0.88,0.88,0.88,+0.04,4.76,2000,2,1760,0,0,0,0,0,0,0,0,0,0
20200528,056210,矽創永豐97購02,0.33,0.34,0.29,0.29,0.00,0.00,81000,6,26630,0,0,0,0,0,0,0,81000,-81000,-81000
20200528,056211,南港國票98購01,0.44,0.49,0.40,0.40,-0.07,-14.89,60000,3,26210,0,0,0,0,0,0,53000,7000,46000,46000
20200528,056212,台光電國票98購03,,,,,0.00,0.00,0,0,0,0,0,0,0,0,0,0,0,0,0
20200528,056213,建準國票98購02,4.01,4.63,3.75,3.78,-0.06,-1.56,169000,25,707740,0,0,0,0,0,0,47000,118000,-71000,-71000
20200528,056214,義隆國票99購01,2.12,2.12,2.12,2.12,+0.31,17.13,14000,1,29680,0,0,0,0,0,0,14000,0,14000,14000
20200528,056215,華新科國票97購03,0.43,0.43,0.36,0.38,-0.08,-17.39,400000,15,146810,0,0,0,0,0,0,344000,56000,288000,288000
20200528,056216,智原第一97購01,,,,,0.00,0.00,0,0,0,0,0,0,0,0,0,0,0,0,0
20200528,056217,A50正2中信99購02,,,,,0.00,0.00,0,0,0,0,0,0,0,0,0,0,0,0,0
20200528,056218,億光中信98購01,,,,,0.00,0.00,0,0,0,0,0,0,0,0,0,0,0,0,0
20200528,056219,T50反1日盛02購01,0.88,1.00,0.88,1.00,+0.03,3.09,2000,2,1880,0,0,0,0,0,0,0,0,0,0
20200528,05621P,聯電中信96售01,,,,,0.00,0.00,0,0,0,0,0,0,0,0,0,0,0,0,0
20200528,056220,上証2X凱基99購01,,,,,0.00,0.00,0,0,0,0,0,0,0,0,0,0,0,0,0
20200528,056221,鴻海凱基99購01,,,,,0.00,0.00,0,0,0,0,0,0,0,0,0,0,0,0,0
20200528,056222,台積電凱基9A購01,,,,,0.00,0.00,0,0,0,0,0,0,0,0,0,0,0,0,0
20200528,056223,華邦電凱基97購04,0.69,0.77,0.69,0.71,+0.13,22.41,114000,31,82820,0,0,0,0,0,0,104000,0,104000,104000
20200528,056224,聯發科凱基97購08,,,,,0.00,0.00,0,0,0,0,0,0,0,0,0,0,0,0,0
20200528,056225,聯發科凱基97購09,,,,,0.00,0.00,0,0,0,0,0,0,0,0,0,0,0,0,0
20200528,056226,聯發科凱基97購10,,,,,0.00,0.00,0,0,0,0,0,0,0,0,0,0,0,0,0
20200528,056227,奇力新凱基98購04,0.20,0.20,0.20,0.20,-0.01,-4.76,99000,1,19800,0,0,0,0,0,0,0,99000,-99000,-99000
20200528,056228,可成凱基97購03,0.48,0.48,0.48,0.48,-0.02,-4.0,2000,1,960,0,0,0,0,0,0,0,2000,-2000,-2000
20200528,056229,可成凱基97購04,0.19,0.19,0.19,0.19,-0.03,-13.64,399000,1,75810,0,0,0,0,0,0,399000,0,399000,399000
20200528,05622P,台積電中信96售02,,,,,0.00,0.00,0,0,0,0,0,0,0,0,0,0,0,0,0
20200528,056230,可成凱基98購03,,,,,0.00,0.00,0,0,0,0,0,0,0,0,0,0,0,0,0
20200528,056231,嘉聯益凱基97購02,0.64,0.66,0.64,0.66,0.00,0.00,110000,2,72400,0,0,0,0,0,0,0,110000,-110000,-110000
20200528,056232,瑞儀凱基98購01,0.20,0.23,0.20,0.21,0.00,0.00,341000,10,73800,0,0,0,0,0,0,176000,165000,11000,11000
20200528,056233,超眾凱基97購02,,,,,0.00,0.00,0,0,0,0,0,0,0,0,0,0,0,0,0
20200528,056234,GIS麥證97購01,0.81,0.81,0.81,0.81,+0.04,5.19,4000,1,3240,4000,0,4000,0,0,0,4000,0,4000,4000
20200528,056235,鴻海群益97購07,,,,,0.00,0.00,0,0,0,0,0,0,0,0,0,0,0,0,0
20200528,056236,台積電群益97購06,,,,,0.00,0.00,0,0,0,0,0,0,0,0,0,0,0,0,0
20200528,056237,智邦群益97購02,,,,,0.00,0.00,0,0,0,0,0,0,0,0,0,0,0,0,0
20200528,056238,聯發科群益98購02,,,,,0.00,0.00,0,0,0,0,0,0,0,0,0,0,0,0,0
20200528,056239,宏達電群益98購01,0.83,0.83,0.74,0.74,-0.13,-14.94,12000,2,9600,0,0,0,0,0,0,12000,12000,0,0
20200528,05623P,台積電中信96售03,,,,,0.00,0.00,0,0,0,0,0,0,0,0,0,0,0,0,0
20200528,056240,嘉晶群益97購02,2.14,2.14,1.96,1.96,-0.27,-12.11,16000,2,33340,0,0,0,0,0,0,16000,0,16000,16000
20200528,056241,緯創群益97購01,1.76,1.79,1.68,1.68,-0.04,-2.33,652000,39,1148690,0,0,0,0,0,0,398000,253000,145000,145000
20200528,056242,緯創群益9A購01,,,,,0.00,0.00,0,0,0,0,0,0,0,0,0,0,0,0,0
20200528,056243,創意群益97購03,0.59,0.60,0.54,0.54,+0.02,3.85,18000,5,10500,0,0,0,0,0,0,0,18000,-18000,-18000
20200528,056244,群創群益98購09,,,,,0.00,0.00,0,0,0,0,0,0,0,0,0,0,0,0,0
20200528,056245,嘉澤群益97購01,,,,,0.00,0.00,0,0,0,0,0,0,0,0,0,0,0,0,0
20200528,056246,祥碩群益97購01,,,,,0.00,0.00,0,0,0,0,0,0,0,0,0,0,0,0,0
20200528,056247,台郡群益97購01,,,,,0.00,0.00,0,0,0,0,0,0,0,0,0,0,0,0,0
20200528,056248,康友群益97購04,,,,,0.00,0.00,0,0,0,0,0,0,0,0,0,0,0,0,0
20200528,056249,鴻海兆豐97購05,,,,,0.00,0.00,0,0,0,0,0,0,0,0,0,0,0,0,0
20200528,05624P,同欣電中信98售01,0.32,0.32,0.26,0.26,0.00,0.00,11000,2,2920,0,0,0,0,0,0,0,11000,-11000,-11000
20200528,056250,瑞昱兆豐97購02,0.90,0.92,0.90,0.90,+0.06,7.14,143000,11,129820,0,0,0,0,0,0,12000,131000,-119000,-119000
20200528,056251,聯發科兆豐97購02,,,,,0.00,0.00,0,0,0,0,0,0,0,0,0,0,0,0,0
20200528,056252,聯發科兆豐97購03,,,,,0.00,0.00,0,0,0,0,0,0,0,0,0,0,0,0,0
20200528,056253,京鼎兆豐98購01,0.21,0.21,0.21,0.21,0.00,0.00,10000,1,2100,0,0,0,0,0,0,0,10000,-10000,-10000
20200528,056254,為升元富97購01,,,,,0.00,0.00,0,0,0,0,0,0,0,0,0,0,0,0,0
20200528,056255,華新科元富97購05,0.85,0.86,0.84,0.86,-0.03,-3.37,21000,9,17850,0,0,0,0,0,0,20000,1000,19000,19000
20200528,056256,聯茂元富97購03,0.71,0.71,0.70,0.70,0.00,0.00,8000,2,5660,0,0,0,0,0,0,0,8000,-8000,-8000
20200528,056257,聯茂元富97購04,,,,,0.00,0.00,0,0,0,0,0,0,0,0,0,0,0,0,0
20200528,056258,訊芯元富97購04,,,,,0.00,0.00,0,0,0,0,0,0,0,0,0,0,0,0,0
20200528,056259,T50反1統一9A購01,,,,,0.00,0.00,0,0,0,0,0,0,0,0,0,0,0,0,0
20200528,05625P,國巨國票97售01,0.69,0.76,0.67,0.76,+0.01,1.33,67000,6,45760,0,0,0,0,0,0,54000,13000,41000,41000
20200528,056260,鴻海統一98購07,,,,,0.00,0.00,0,0,0,0,0,0,0,0,0,0,0,0,0
20200528,056261,台積電統一97購07,0.13,0.13,0.10,0.10,0.00,0.00,135000,3,14700,0,0,0,0,0,0,0,135000,-135000,-135000
20200528,056262,台積電統一98購04,,,,,0.00,0.00,0,0,0,0,0,0,0,0,0,0,0,0,0
20200528,056263,友訊統一99購01,,,,,0.00,0.00,0,0,0,0,0,0,0,0,0,0,0,0,0
20200528,056264,聯發科統一98購02,,,,,0.00,0.00,0,0,0,0,0,0,0,0,0,0,0,0,0
20200528,056265,國泰金統一97購01,,,,,0.00,0.00,0,0,0,0,0,0,0,0,0,0,0,0,0
20200528,056266,開發金統一9A購01,1.40,1.40,1.36,1.36,-0.05,-3.55,287000,12,399140,0,0,0,0,0,0,287000,112000,175000,175000
20200528,056267,文曄統一97購02,1.30,1.31,1.30,1.31,0.00,0.00,57000,2,74170,0,0,0,0,0,0,57000,0,57000,57000
20200528,056268,新日興統一97購01,0.45,0.52,0.41,0.41,+0.02,5.13,690000,18,334260,0,0,0,0,0,0,288000,402000,-114000,-114000
20200528,056269,新日興統一98購01,,,,,0.00,0.00,0,0,0,0,0,0,0,0,0,0,0,0,0
20200528,05626P,景碩國票97售03,1.52,1.52,1.44,1.44,-0.09,-5.88,75000,3,111600,0,0,0,0,0,0,40000,35000,5000,5000
20200528,056270,群創統一98購04,,,,,0.00,0.00,0,0,0,0,0,0,0,0,0,0,0,0,0
20200528,056271,嘉澤統一97購01,4.67,4.67,4.67,4.67,0.00,0.00,5000,1,23350,0,0,0,0,0,0,0,5000,-5000,-5000
20200528,056272,嘉澤統一99購01,,,,,0.00,0.00,0,0,0,0,0,0,0,0,0,0,0,0,0
20200528,056273,祥碩統一97購02,,,,,0.00,0.00,0,0,0,0,0,0,0,0,0,0,0,0,0
20200528,056274,彩晶統一98購02,,,,,0.00,0.00,0,0,0,0,0,0,0,0,0,0,0,0,0
20200528,056275,國巨國泰98購04,,,,,0.00,0.00,0,0,0,0,0,0,0,0,0,0,0,0,0
20200528,056276,同欣電國泰98購01,,,,,0.00,0.00,0,0,0,0,0,0,0,0,0,0,0,0,0
20200528,056277,上銀富邦99購02,0.81,0.81,0.77,0.77,-0.28,-26.67,11000,2,8510,0,0,0,0,0,0,11000,10000,1000,1000
20200528,056278,全新富邦98購02,,,,,0.00,0.00,0,0,0,0,0,0,0,0,0,0,0,0,0
20200528,056279,新日興富邦99購01,0.35,0.37,0.34,0.34,0.00,0.00,65000,7,23600,0,0,0,0,0,0,0,65000,-65000,-65000
20200528,05627P,致伸國票97售01,,,,,0.00,0.00,0,0,0,0,0,0,0,0,0,0,0,0,0
20200528,056280,上証2X永豐98購01,1.41,1.41,1.41,1.41,-0.12,-7.84,10000,1,14100,0,0,0,0,0,0,0,10000,-10000,-10000
20200528,056281,深中小永豐97購01,0.67,0.67,0.57,0.57,-0.13,-18.57,182000,7,116940,0,0,0,0,0,0,128000,54000,74000,74000
20200528,056282,S&P反1永豐97購01,1.41,1.41,1.41,1.41,-0.10,-6.62,6000,1,8460,0,0,0,0,0,0,6000,0,6000,6000
20200528,056283,鴻海永豐97購03,0.08,0.08,0.08,0.08,-0.01,-11.11,22000,1,1760,0,0,0,0,0,0,0,22000,-22000,-22000
20200528,056284,台積電永豐97購06,,,,,0.00,0.00,0,0,0,0,0,0,0,0,0,0,0,0,0
20200528,056285,可成永豐97購02,,,,,0.00,0.00,0,0,0,0,0,0,0,0,0,0,0,0,0
20200528,056286,奇鋐永豐97購01,0.91,1.04,0.91,0.94,+0.03,3.3,275000,15,269180,0,0,0,0,0,0,37000,275000,-238000,-238000
20200528,056287,亞光永豐97購02,0.67,0.67,0.67,0.67,0.00,0.00,15000,1,10050,0,0,0,0,0,0,0,15000,-15000,-15000
20200528,056288,健鼎永豐97購01,0.40,0.40,0.40,0.40,+0.04,11.11,282000,3,112800,0,0,0,0,0,0,0,282000,-282000,-282000
20200528,056289,合勤控永豐97購01,0.43,0.46,0.42,0.45,-0.09,-16.67,162000,5,70510,0,0,0,0,0,0,161000,1000,160000,160000
20200528,05628P,茂林國票97售02,0.07,0.07,0.07,0.07,+0.02,40.0,300000,1,21000,0,0,0,0,0,0,300000,0,300000,300000
20200528,056290,正文永豐98購01,,,,,0.00,0.00,0,0,0,0,0,0,0,0,0,0,0,0,0
20200528,056291,聯茂永豐97購03,0.34,0.41,0.34,0.39,+0.02,5.41,56000,11,21300,0,0,0,0,0,0,16000,40000,-24000,-24000
20200528,056292,統一元大97購01,0.87,0.87,0.86,0.86,-0.13,-13.13,75000,2,64850,0,0,0,0,0,0,75000,0,75000,75000
20200528,056293,上銀元大97購10,1.23,1.23,1.23,1.23,-0.07,-5.38,1000,1,1230,0,0,0,0,0,0,1000,0,1000,1000
20200528,056294,上銀元大97購11,1.53,1.53,1.53,1.53,-0.18,-10.53,2000,1,3060,0,0,0,0,0,0,2000,2000,0,0
20200528,056295,國巨元大97購16,2.38,2.38,2.34,2.34,+0.01,0.43,2000,2,4720,0,0,0,0,0,0,2000,1000,1000,1000
20200528,056296,旺宏元大97購07,0.93,0.93,0.87,0.87,-0.01,-1.14,78000,2,71940,0,0,0,0,0,0,0,78000,-78000,-78000
20200528,056297,台光電元大97購04,2.35,2.35,2.35,2.35,+0.06,2.62,10000,1,23500,0,0,0,0,0,0,10000,0,10000,10000
20200528,056298,億光元大97購02,0.75,0.75,0.75,0.75,0.00,0.00,68000,1,51000,0,0,0,0,0,0,0,68000,-68000,-68000
20200528,056299,友達元大9B購04,,,,,0.00,0.00,0,0,0,0,0,0,0,0,0,0,0,0,0
20200528,05629P,聯發科永昌99售02,1.36,1.36,1.36,1.36,+0.13,10.57,20000,1,27200,0,0,0,0,0,0,0,0,0,0
20200528,056300,聯發科元大97購23,,,,,0.00,0.00,0,0,0,0,0,0,0,0,0,0,0,0,0
20200528,056301,開發金元大9A購01,0.68,0.68,0.67,0.67,-0.01,-1.47,74000,5,49680,0,0,0,0,0,0,74000,0,74000,74000
20200528,056302,大立光元大97購17,0.90,0.90,0.84,0.84,-0.07,-7.69,42000,5,36430,0,0,0,0,0,0,5000,37000,-32000,-32000
20200528,056303,亞光元大97購04,,,,,0.00,0.00,0,0,0,0,0,0,0,0,0,0,0,0,0
20200528,056304,創意元大97購03,0.51,0.54,0.50,0.50,0.00,0.00,163000,6,83950,0,0,0,0,0,0,68000,95000,-27000,-27000
20200528,056305,群創元大9A購03,,,,,0.00,0.00,0,0,0,0,0,0,0,0,0,0,0,0,0
20200528,056306,晶相光元大98購01,,,,,0.00,0.00,0,0,0,0,0,0,0,0,0,0,0,0,0
20200528,056307,貿聯元大97購05,0.79,0.79,0.76,0.77,-0.02,-2.53,217000,10,168670,0,0,0,0,0,0,149000,68000,81000,81000
20200528,056308,TPK元大97購02,0.67,0.73,0.57,0.57,-0.11,-16.18,118000,5,78000,0,0,0,0,0,0,108000,13000,95000,95000
20200528,056309,合勤控元大97購01,1.17,1.17,1.04,1.04,-0.18,-14.75,796000,31,888320,0,0,0,0,0,0,578000,218000,360000,360000
20200528,05630P,大立光永昌96售06,,,,,0.00,0.00,0,0,0,0,0,0,0,0,0,0,0,0,0
20200528,056310,神達元大97購02,,,,,0.00,0.00,0,0,0,0,0,0,0,0,0,0,0,0,0
20200528,056311,泰鼎元大98購01,,,,,0.00,0.00,0,0,0,0,0,0,0,0,0,0,0,0,0
20200528,056312,茂林元大98購01,0.61,0.61,0.61,0.61,-0.03,-4.69,12000,1,7320,0,0,0,0,0,0,12000,0,12000,12000
20200528,056313,聯茂元大98購01,0.81,0.81,0.81,0.81,0.00,0.00,40000,1,32400,0,0,0,0,0,0,40000,0,40000,40000
20200528,056314,力成元大97購01,1.13,1.13,1.01,1.01,-0.11,-9.82,183000,6,191760,0,0,0,0,0,0,115000,73000,42000,42000
20200528,056315,同欣電元大97購05,,,,,0.00,0.00,0,0,0,0,0,0,0,0,0,0,0,0,0
20200528,056316,訊芯元大98購03,,,,,0.00,0.00,0,0,0,0,0,0,0,0,0,0,0,0,0
20200528,056317,華通群益99購02,,,,,0.00,0.00,0,0,0,0,0,0,0,0,0,0,0,0,0
20200528,056318,鴻海群益98購02,0.28,0.28,0.28,0.28,0.00,0.00,20000,1,5600,0,0,0,0,0,0,20000,0,20000,20000
20200528,056319,智原群益98購02,,,,,0.00,0.00,0,0,0,0,0,0,0,0,0,0,0,0,0
20200528,05631P,國巨富邦9A售01,0.54,0.54,0.54,0.54,+0.02,3.85,200000,2,108000,0,0,0,0,0,0,0,200000,-200000,-200000
20200528,056320,京鼎群益99購01,0.96,0.97,0.90,0.90,-0.05,-5.26,119000,3,113170,0,0,0,0,0,0,101000,19000,82000,82000
20200528,056321,創意群益98購02,1.12,1.17,1.09,1.09,-0.05,-4.39,209000,5,239010,0,0,0,0,0,0,107000,106000,1000,1000
20200528,056322,臺股指群益98購01,,,,,0.00,0.00,0,0,0,0,0,0,0,0,0,0,0,0,0
20200528,056323,旺宏兆豐98購01,0.36,0.36,0.32,0.32,-0.05,-13.51,80000,3,27000,0,0,0,0,0,0,50000,30000,20000,20000
20200528,056324,南亞科兆豐98購01,0.25,0.25,0.20,0.20,0.00,0.00,72000,5,16200,0,0,0,0,0,0,10000,62000,-52000,-52000
20200528,056325,群創兆豐9A購01,0.02,0.02,0.02,0.02,0.00,0.00,10000,1,200,0,0,0,0,0,0,0,10000,-10000,-10000
20200528,056326,TPK兆豐98購01,,,,,0.00,0.00,0,0,0,0,0,0,0,0,0,0,0,0,0
20200528,056327,樺漢兆豐98購01,,,,,0.00,0.00,0,0,0,0,0,0,0,0,0,0,0,0,0
20200528,056328,訊芯兆豐98購01,,,,,0.00,0.00,0,0,0,0,0,0,0,0,0,0,0,0,0
20200528,056329,上銀國票98購02,,,,,0.00,0.00,0,0,0,0,0,0,0,0,0,0,0,0,0
20200528,05632P,大立光群益96售02,,,,,0.00,0.00,0,0,0,0,0,0,0,0,0,0,0,0,0
20200528,056330,玉晶光國票99購03,1.07,1.07,1.07,1.07,-0.01,-0.93,28000,1,29960,0,0,0,0,0,0,0,28000,-28000,-28000
20200528,056331,聯鈞國票99購01,,,,,0.00,0.00,0,0,0,0,0,0,0,0,0,0,0,0,0
20200528,056332,台郡國票99購01,2.36,2.36,2.36,2.36,-0.10,-4.07,97000,4,228920,0,0,0,0,0,0,91000,6000,85000,85000
20200528,056333,台積電日盛9B購01,,,,,0.00,0.00,0,0,0,0,0,0,0,0,0,0,0,0,0
20200528,056334,台積電凱基98購06,,,,,0.00,0.00,0,0,0,0,0,0,0,0,0,0,0,0,0
20200528,056335,微星凱基98購01,0.96,1.03,0.96,1.03,+0.08,8.42,93000,7,93440,0,0,0,0,0,0,55000,18000,37000,37000
20200528,056336,南亞科凱基98購02,,,,,0.00,0.00,0,0,0,0,0,0,0,0,0,0,0,0,0
20200528,056337,聯發科凱基98購06,,,,,0.00,0.00,0,0,0,0,0,0,0,0,0,0,0,0,0
20200528,056338,聯發科凱基99購01,,,,,0.00,0.00,0,0,0,0,0,0,0,0,0,0,0,0,0
20200528,056339,聯發科凱基99購02,,,,,0.00,0.00,0,0,0,0,0,0,0,0,0,0,0,0,0
20200528,05633P,台表科群益96售04,,,,,0.00,0.00,0,0,0,0,0,0,0,0,0,0,0,0,0
20200528,056340,可成凱基98購04,,,,,0.00,0.00,0,0,0,0,0,0,0,0,0,0,0,0,0
20200528,056341,宏達電凱基9A購01,0.18,0.18,0.17,0.17,-0.01,-5.56,11000,3,1930,0,0,0,0,0,0,0,0,0,0
20200528,056342,中工凱基98購01,,,,,0.00,0.00,0,0,0,0,0,0,0,0,0,0,0,0,0
20200528,056343,高鐵凱基98購02,1.51,1.51,1.07,1.07,-0.30,-21.9,356000,23,468970,0,10000,-10000,0,0,0,307000,58000,249000,239000
20200528,056344,嘉晶凱基98購02,,,,,0.00,0.00,0,0,0,0,0,0,0,0,0,0,0,0,0
20200528,056345,嘉聯益凱基99購01,0.29,0.29,0.29,0.29,0.00,0.00,134000,2,38860,0,0,0,0,0,0,0,134000,-134000,-134000
20200528,056346,聯茂凱基99購02,0.42,0.42,0.42,0.42,0.00,0.00,15000,1,6300,0,0,0,0,0,0,15000,0,15000,15000
20200528,056347,GIS凱基9A購01,1.12,1.12,1.01,1.02,-0.11,-9.73,120000,18,125130,0,0,0,0,0,0,20000,79000,-59000,-59000
20200528,056348,S&P反1元大9A購01,,,,,0.00,0.00,0,0,0,0,0,0,0,0,0,0,0,0,0
20200528,056349,道瓊銀元大9B購01,1.05,1.05,0.84,1.00,0.00,0.00,170000,8,147070,0,0,0,0,0,0,70000,0,70000,70000
20200528,05634P,玉晶光台新97售01,0.22,0.22,0.20,0.20,0.00,0.00,114000,8,24050,0,0,0,0,0,0,19000,0,19000,19000
20200528,056350,上銀元大98購02,,,,,0.00,0.00,0,0,0,0,0,0,0,0,0,0,0,0,0
20200528,056351,鴻海元大98購06,0.60,0.61,0.60,0.61,+0.02,3.39,24000,2,14620,0,0,0,0,0,0,24000,0,24000,24000
20200528,056352,鴻海元大99購01,0.98,0.98,0.96,0.96,-0.04,-4.0,20000,2,19400,0,0,0,0,0,0,10000,10000,0,0
20200528,056353,鴻海元大99購02,,,,,0.00,0.00,0,0,0,0,0,0,0,0,0,0,0,0,0
20200528,056354,國巨元大98購10,2.79,2.79,2.53,2.53,-0.14,-5.24,12000,3,33160,0,0,0,0,0,0,2000,12000,-10000,-10000
20200528,056355,台積電元大98購08,,,,,0.00,0.00,0,0,0,0,0,0,0,0,0,0,0,0,0
20200528,056356,台積電元大99購01,0.41,0.51,0.41,0.45,-0.04,-8.16,16000,12,7400,0,0,0,0,0,0,3000,13000,-10000,-10000
20200528,056357,台積電元大9A購01,0.50,0.50,0.50,0.50,0.00,0.00,10000,1,5000,0,0,0,0,0,0,10000,0,10000,10000
20200528,056358,友訊元大99購01,1.25,1.25,1.25,1.25,-0.07,-5.3,48000,2,60000,0,0,0,0,0,0,0,48000,-48000,-48000
20200528,056359,旺宏元大9A購01,,,,,0.00,0.00,0,0,0,0,0,0,0,0,0,0,0,0,0
20200528,05635P,健策台新96售02,,,,,0.00,0.00,0,0,0,0,0,0,0,0,0,0,0,0,0
20200528,056360,智邦元大98購01,8.15,8.25,7.15,7.20,+0.40,5.88,16000,7,125400,0,0,0,0,0,0,16000,12000,4000,4000
20200528,056361,美律元大99購02,0.45,0.45,0.45,0.45,0.00,0.00,10000,1,4500,0,0,0,0,0,0,10000,0,10000,10000
20200528,056362,聯發科元大99購01,,,,,0.00,0.00,0,0,0,0,0,0,0,0,0,0,0,0,0
20200528,056363,華新科元大99購04,,,,,0.00,0.00,0,0,0,0,0,0,0,0,0,0,0,0,0
20200528,056364,亞光元大99購02,,,,,0.00,0.00,0,0,0,0,0,0,0,0,0,0,0,0,0
20200528,056365,欣興元大98購01,2.07,2.24,2.07,2.23,+0.15,7.21,139000,8,295800,0,0,0,0,0,0,3000,139000,-136000,-136000
20200528,056366,玉晶光元大99購04,2.08,2.08,1.90,1.90,+0.04,2.15,76000,3,146660,0,0,0,0,0,0,46000,30000,16000,16000
20200528,056367,祥碩元大98購01,,,,,0.00,0.00,0,0,0,0,0,0,0,0,0,0,0,0,0
20200528,056368,祥碩元大98購02,,,,,0.00,0.00,0,0,0,0,0,0,0,0,0,0,0,0,0
20200528,056369,彩晶元大01購01,,,,,0.00,0.00,0,0,0,0,0,0,0,0,0,0,0,0,0
20200528,05636P,國巨永豐96售03,,,,,0.00,0.00,0,0,0,0,0,0,0,0,0,0,0,0,0
20200528,056370,台郡元大98購03,,,,,0.00,0.00,0,0,0,0,0,0,0,0,0,0,0,0,0
20200528,056371,樺漢元大98購03,,,,,0.00,0.00,0,0,0,0,0,0,0,0,0,0,0,0,0
20200528,056372,訊芯元大98購04,,,,,0.00,0.00,0,0,0,0,0,0,0,0,0,0,0,0,0
20200528,056373,上銀統一99購02,,,,,0.00,0.00,0,0,0,0,0,0,0,0,0,0,0,0,0
20200528,056374,聯發科統一9B購01,,,,,0.00,0.00,0,0,0,0,0,0,0,0,0,0,0,0,0
20200528,056375,玉晶光統一01購01,,,,,0.00,0.00,0,0,0,0,0,0,0,0,0,0,0,0,0
20200528,056376,玉晶光統一98購01,0.26,0.29,0.24,0.24,0.00,0.00,260000,8,73120,0,0,0,0,0,0,0,260000,-260000,-260000
20200528,056377,智伸科統一9A購01,,,,,0.00,0.00,0,0,0,0,0,0,0,0,0,0,0,0,0
20200528,056378,欣興元富98購01,1.65,1.97,1.65,1.94,+0.30,18.29,208000,14,373240,0,0,0,0,0,0,23000,185000,-162000,-162000
20200528,056379,玉晶光元富98購01,1.74,1.79,1.74,1.79,+0.10,5.92,20000,2,35300,0,0,0,0,0,0,10000,10000,0,0
20200528,05637P,聯電元大96售04,,,,,0.00,0.00,0,0,0,0,0,0,0,0,0,0,0,0,0
20200528,056380,麗豐元富98購01,0.39,0.39,0.37,0.37,-0.04,-9.76,30000,3,11450,0,0,0,0,0,0,0,30000,-30000,-30000
20200528,056381,台虹元富98購01,1.23,1.23,1.12,1.12,-0.11,-8.94,1218000,60,1460480,0,0,0,0,0,0,768000,450000,318000,318000
20200528,056382,道瓊反國泰9A購01,0.73,0.73,0.73,0.73,0.00,0.00,10000,1,7300,0,0,0,0,0,0,0,10000,-10000,-10000
20200528,056383,上銀國泰99購01,5.05,5.05,4.31,4.31,-0.55,-11.32,76000,11,378220,0,0,0,0,0,0,75000,1000,74000,74000
20200528,056384,玉晶光國泰9A購02,,,,,0.00,0.00,0,0,0,0,0,0,0,0,0,0,0,0,0
20200528,056385,創意國泰99購01,0.58,0.63,0.55,0.55,+0.01,1.85,332000,21,196290,0,0,0,0,0,0,108000,332000,-224000,-224000
20200528,056386,TPK國泰99購01,0.57,0.57,0.44,0.44,-0.05,-10.2,15000,2,7510,0,0,0,0,0,0,15000,0,15000,15000
20200528,056387,智伸科國泰99購01,0.26,0.26,0.26,0.26,0.00,0.00,20000,2,5200,0,0,0,0,0,0,0,20000,-20000,-20000
20200528,056388,勤誠國泰99購01,,,,,0.00,0.00,0,0,0,0,0,0,0,0,0,0,0,0,0
20200528,056389,鴻海富邦99購01,,,,,0.00,0.00,0,0,0,0,0,0,0,0,0,0,0,0,0
20200528,05638P,國巨統一96售04,,,,,0.00,0.00,0,0,0,0,0,0,0,0,0,0,0,0,0
20200528,056390,台積電富邦9B購01,0.27,0.27,0.27,0.27,+0.10,58.82,1000,1,270,0,0,0,0,0,0,0,1000,-1000,-1000
20200528,056391,大立光富邦9C購01,0.23,0.23,0.23,0.23,+0.07,43.75,100000,5,23000,0,0,0,0,0,0,0,0,0,0
20200528,056392,玉晶光富邦9C購01,,,,,0.00,0.00,0,0,0,0,0,0,0,0,0,0,0,0,0
20200528,056393,精元永豐98購01,0.06,0.09,0.06,0.08,0.00,0.00,770000,29,50900,0,0,0,0,0,0,500000,270000,230000,230000
20200528,056394,晶豪科永豐98購01,1.50,1.57,1.32,1.33,-0.06,-4.32,45000,6,63080,0,0,0,0,0,0,0,45000,-45000,-45000
20200528,056395,玉晶光永豐9B購01,0.86,0.86,0.80,0.80,0.00,0.00,15000,3,12500,0,0,0,0,0,0,0,15000,-15000,-15000
20200528,056396,祥碩永豐98購01,1.91,2.50,1.81,2.39,+0.48,25.13,104000,10,216700,0,0,0,0,0,0,56000,48000,8000,8000
20200528,056397,彩晶永豐99購01,,,,,0.00,0.00,0,0,0,0,0,0,0,0,0,0,0,0,0
20200528,056398,南茂永豐98購01,0.93,0.93,0.80,0.80,-0.12,-13.04,745000,27,648510,0,0,0,0,0,0,365000,400000,-35000,-35000
20200528,056399,上証2X群益9C購01,,,,,0.00,0.00,0,0,0,0,0,0,0,0,0,0,0,0,0
20200528,05639P,欣興統一97售01,1.35,1.36,1.23,1.32,-0.04,-2.94,157000,14,210170,0,0,0,0,0,0,134000,23000,111000,111000
20200528,056400,道瓊反群益9C購01,,,,,0.00,0.00,0,0,0,0,0,0,0,0,0,0,0,0,0
20200528,056401,國巨群益98購07,0.92,0.92,0.92,0.92,0.00,0.00,2000,1,1840,0,0,0,0,0,0,0,2000,-2000,-2000
20200528,056402,智易群益98購02,,,,,0.00,0.00,0,0,0,0,0,0,0,0,0,0,0,0,0
20200528,056403,茂林群益98購01,1.47,1.47,1.45,1.45,-0.29,-16.67,20000,11,29280,0,0,0,0,0,0,20000,0,20000,20000
20200528,056404,嘉聯益群益9A購01,1.04,1.15,1.04,1.06,+0.04,3.92,609000,16,672570,0,0,0,0,0,0,40000,609000,-569000,-569000
20200528,056405,聯茂群益98購01,3.52,3.52,3.52,3.52,+0.17,5.07,50000,1,176000,0,0,0,0,0,0,50000,0,50000,50000
20200528,056406,建準國票99購01,,,,,0.00,0.00,0,0,0,0,0,0,0,0,0,0,0,0,0
20200528,056407,嘉晶國票99購01,9.80,9.80,9.30,9.30,-1.20,-11.43,66000,10,627450,0,0,0,0,0,0,66000,0,66000,66000
20200528,056408,奇鋐國票99購01,2.26,2.61,2.26,2.40,+0.23,10.6,113000,13,278800,0,0,0,0,0,0,0,113000,-113000,-113000
20200528,056409,麗豐國票99購01,0.72,0.72,0.72,0.72,-0.07,-8.86,38000,1,27360,0,0,0,0,0,0,38000,0,38000,38000
20200528,05640P,旺宏元富96售03,,,,,0.00,0.00,0,0,0,0,0,0,0,0,0,0,0,0,0
20200528,056410,康控國票99購01,1.14,1.14,1.14,1.14,0.00,0.00,38000,1,43320,0,0,0,0,0,0,0,38000,-38000,-38000
20200528,056411,緯穎國票99購01,5.65,6.00,5.00,5.00,-0.75,-13.04,482000,13,2773250,0,0,0,0,0,0,85000,401000,-316000,-316000
20200528,056412,上証2X中信9A購02,1.03,1.03,0.98,0.98,-0.02,-2.0,26000,5,26300,0,0,0,0,0,0,10000,16000,-6000,-6000
20200528,056413,上証反中信9A購01,,,,,0.00,0.00,0,0,0,0,0,0,0,0,0,0,0,0,0
20200528,056414,國巨中信98購02,,,,,0.00,0.00,0,0,0,0,0,0,0,0,0,0,0,0,0
20200528,056415,聯發科中信98購04,1.26,1.26,1.26,1.26,0.00,0.00,10000,1,12600,0,0,0,0,0,0,0,10000,-10000,-10000
20200528,056416,華新科中信98購01,0.20,0.20,0.20,0.20,-0.03,-13.04,20000,2,4000,0,0,0,0,0,0,0,20000,-20000,-20000
20200528,056417,欣興中信98購01,0.33,0.39,0.33,0.34,+0.01,3.03,275000,11,98140,0,0,0,0,0,0,20000,255000,-235000,-235000
20200528,056418,台光電元富98購01,2.88,2.91,2.60,2.60,-0.26,-9.09,150000,16,424500,0,0,0,0,0,0,65000,85000,-20000,-20000
20200528,056419,欣興元富98購02,2.22,2.57,2.18,2.37,+0.10,4.41,528000,33,1261320,0,0,0,0,0,0,43000,486000,-443000,-443000
20200528,05641P,貿聯元富96售02,,,,,0.00,0.00,0,0,0,0,0,0,0,0,0,0,0,0,0
20200528,056420,台表科元富98購01,1.42,1.42,1.16,1.21,-0.12,-9.02,2515000,23,3050940,0,0,0,0,0,0,1129000,1364000,-235000,-235000
20200528,056421,鴻海統一98購08,,,,,0.00,0.00,0,0,0,0,0,0,0,0,0,0,0,0,0
20200528,056422,全新統一98購02,0.55,0.55,0.54,0.54,-0.05,-8.47,78000,4,42620,0,0,0,0,0,0,78000,0,78000,78000
20200528,056423,奇鋐統一98購01,1.37,1.51,1.37,1.51,+0.16,11.85,140000,3,193410,0,0,0,0,0,0,49000,91000,-42000,-42000
20200528,056424,泰碩統一98購01,,,,,0.00,0.00,0,0,0,0,0,0,0,0,0,0,0,0,0
20200528,056425,聯發科日盛9A購01,,,,,0.00,0.00,0,0,0,0,0,0,0,0,0,0,0,0,0
20200528,056426,上証2X凱基9A購01,,,,,0.00,0.00,0,0,0,0,0,0,0,0,0,0,0,0,0
20200528,056427,上銀凱基98購03,,,,,0.00,0.00,0,0,0,0,0,0,0,0,0,0,0,0,0
20200528,056428,台達電凱基99購01,0.93,0.93,0.93,0.93,0.00,0.00,4000,1,3720,0,0,0,0,0,0,4000,4000,0,0
20200528,056429,華通凱基98購02,1.38,1.38,1.38,1.38,0.00,0.00,90000,1,124200,0,0,0,0,0,0,90000,90000,0,0
20200528,05642P,玉晶光兆豐97售02,0.16,0.17,0.16,0.17,0.00,0.00,127000,2,21180,0,0,0,0,0,0,127000,0,127000,127000
20200528,056430,鴻海凱基98購06,0.80,0.80,0.80,0.80,-0.04,-4.76,43000,1,34400,0,0,0,0,0,0,0,43000,-43000,-43000
20200528,056431,鴻海凱基98購07,,,,,0.00,0.00,0,0,0,0,0,0,0,0,0,0,0,0,0
20200528,056432,鴻海凱基98購08,,,,,0.00,0.00,0,0,0,0,0,0,0,0,0,0,0,0,0
20200528,056433,鴻海凱基98購09,1.12,1.15,1.10,1.10,+0.01,0.92,24000,3,26860,0,0,0,0,0,0,24000,14000,10000,10000
20200528,056434,國巨凱基98購03,2.46,2.50,2.25,2.25,-0.15,-6.25,201000,17,476310,0,0,0,0,0,0,155000,47000,108000,108000
20200528,056435,台積電凱基98購09,,,,,0.00,0.00,0,0,0,0,0,0,0,0,0,0,0,0,0
20200528,056436,台積電凱基98購10,,,,,0.00,0.00,0,0,0,0,0,0,0,0,0,0,0,0,0
20200528,056437,台積電凱基98購11,,,,,0.00,0.00,0,0,0,0,0,0,0,0,0,0,0,0,0
20200528,056438,旺宏凱基98購05,1.49,1.51,1.34,1.34,-0.20,-12.99,330000,19,482120,0,0,0,0,0,0,330000,0,330000,330000
20200528,056439,華邦電凱基98購02,0.30,0.30,0.30,0.30,+0.08,36.36,1000,1,300,0,0,0,0,0,0,1000,0,1000,1000
20200528,05643P,大立光中信98售01,1.39,1.39,1.39,1.39,0.00,0.00,100000,1,139000,0,0,0,0,0,0,100000,100000,0,0
20200528,056440,智邦凱基98購03,,,,,0.00,0.00,0,0,0,0,0,0,0,0,0,0,0,0,0
20200528,056441,燿華凱基98購01,,,,,0.00,0.00,0,0,0,0,0,0,0,0,0,0,0,0,0
20200528,056442,瑞昱凱基98購02,,,,,0.00,0.00,0,0,0,0,0,0,0,0,0,0,0,0,0
20200528,056443,南亞科凱基98購03,,,,,0.00,0.00,0,0,0,0,0,0,0,0,0,0,0,0,0
20200528,056444,南亞科凱基99購01,0.71,0.72,0.63,0.63,-0.01,-1.56,60000,8,40420,0,0,0,0,0,0,10000,50000,-40000,-40000
20200528,056445,聯發科凱基98購07,,,,,0.00,0.00,0,0,0,0,0,0,0,0,0,0,0,0,0
20200528,056446,聯發科凱基98購08,,,,,0.00,0.00,0,0,0,0,0,0,0,0,0,0,0,0,0
20200528,056447,聯發科凱基98購09,6.80,6.80,6.80,6.80,0.00,0.00,3000,1,20400,0,0,0,0,0,0,0,3000,-3000,-3000
20200528,056448,全新凱基99購01,0.55,0.55,0.55,0.55,-0.02,-3.51,30000,2,16500,0,0,0,0,0,0,30000,0,30000,30000
20200528,056449,義隆凱基98購03,2.23,2.35,2.21,2.25,+0.14,6.64,75000,23,171360,0,0,0,0,0,0,38000,63000,-25000,-25000
20200528,05644P,大立光中信9A售03,0.42,0.47,0.42,0.47,+0.01,2.17,181000,6,79800,0,0,0,0,0,0,68000,113000,-45000,-45000
20200528,056450,可成凱基98購05,,,,,0.00,0.00,0,0,0,0,0,0,0,0,0,0,0,0,0
20200528,056451,可成凱基99購01,,,,,0.00,0.00,0,0,0,0,0,0,0,0,0,0,0,0,0
20200528,056452,亞光凱基98購02,,,,,0.00,0.00,0,0,0,0,0,0,0,0,0,0,0,0,0
20200528,056453,禾伸堂凱基99購02,,,,,0.00,0.00,0,0,0,0,0,0,0,0,0,0,0,0,0
20200528,056454,欣興凱基98購02,,,,,0.00,0.00,0,0,0,0,0,0,0,0,0,0,0,0,0
20200528,056455,群創凱基9A購01,,,,,0.00,0.00,0,0,0,0,0,0,0,0,0,0,0,0,0
20200528,056456,群創凱基9B購01,,,,,0.00,0.00,0,0,0,0,0,0,0,0,0,0,0,0,0
20200528,056457,嘉澤凱基98購01,3.46,3.46,3.46,3.46,-0.28,-7.49,2000,1,6920,0,0,0,0,0,0,0,2000,-2000,-2000
20200528,056458,日月光凱基98購02,0.90,0.92,0.90,0.91,+0.02,2.25,103000,3,93620,0,0,0,0,0,0,54000,49000,5000,5000
20200528,056459,茂林凱基99購01,1.30,1.31,1.23,1.23,-0.06,-4.65,626000,39,780270,0,0,0,0,0,0,558000,110000,448000,448000
20200528,05645P,聯發科凱基96售13,,,,,0.00,0.00,0,0,0,0,0,0,0,0,0,0,0,0,0
20200528,056460,同欣電凱基99購01,,,,,0.00,0.00,0,0,0,0,0,0,0,0,0,0,0,0,0
20200528,056461,樺漢凱基98購02,0.75,0.77,0.75,0.77,+0.01,1.32,320000,10,244200,0,0,0,0,0,0,0,320000,-320000,-320000
20200528,056462,訊芯凱基98購03,0.50,0.50,0.50,0.50,-0.10,-16.67,49000,1,24500,0,0,0,0,0,0,0,49000,-49000,-49000
20200528,056463,台虹凱基98購02,1.07,1.08,0.98,1.00,-0.03,-2.91,870000,34,912930,0,0,0,0,0,0,457000,494000,-37000,-37000
20200528,056464,臺股指凱基99購06,0.19,0.19,0.19,0.19,-0.04,-17.39,10000,1,1900,0,0,0,0,0,0,0,10000,-10000,-10000
20200528,056465,臺股指凱基99購07,,,,,0.00,0.00,0,0,0,0,0,0,0,0,0,0,0,0,0
20200528,056466,臺股指凱基99購08,,,,,0.00,0.00,0,0,0,0,0,0,0,0,0,0,0,0,0
20200528,056467,上証2X元大98購02,,,,,0.00,0.00,0,0,0,0,0,0,0,0,0,0,0,0,0
20200528,056468,鴻海元大98購07,,,,,0.00,0.00,0,0,0,0,0,0,0,0,0,0,0,0,0
20200528,056469,國巨元大99購01,1.94,1.94,1.93,1.93,-0.03,-1.53,25000,3,48450,0,0,0,0,0,0,0,25000,-25000,-25000
20200528,05646P,聯發科國票96售05,0.22,0.22,0.22,0.22,0.00,0.00,1000,1,220,0,0,0,0,0,0,1000,0,1000,1000
20200528,056470,旺宏元大99購01,1.87,1.87,1.83,1.83,-0.05,-2.66,38000,8,69660,0,0,0,0,0,0,35000,38000,-3000,-3000
20200528,056471,台光電元大99購01,,,,,0.00,0.00,0,0,0,0,0,0,0,0,0,0,0,0,0
20200528,056472,美律元大99購03,0.67,0.67,0.66,0.67,+0.06,9.84,103000,4,68430,0,0,0,0,0,0,103000,0,103000,103000
20200528,056473,奇力新元大99購02,,,,,0.00,0.00,0,0,0,0,0,0,0,0,0,0,0,0,0
20200528,056474,華新科元大99購05,,,,,0.00,0.00,0,0,0,0,0,0,0,0,0,0,0,0,0
20200528,056475,宏達電元大99購02,0.61,0.61,0.60,0.60,-0.15,-20.0,20000,2,12100,0,0,0,0,0,0,0,20000,-20000,-20000
20200528,056476,智原元大98購02,,,,,0.00,0.00,0,0,0,0,0,0,0,0,0,0,0,0,0
20200528,056477,欣興元大98購02,2.21,2.25,2.21,2.21,+0.17,8.33,103000,8,229590,0,0,0,0,0,0,4000,99000,-95000,-95000
20200528,056478,晶技元大99購01,3.15,3.18,3.09,3.15,-0.08,-2.48,219000,24,686090,0,0,0,0,0,0,216000,0,216000,216000
20200528,056479,玉晶光元大99購05,1.98,2.14,1.91,1.91,+0.03,1.6,24000,8,48470,0,0,0,0,0,0,24000,1000,23000,23000
20200528,05647P,聯發科國票97售02,,,,,0.00,0.00,0,0,0,0,0,0,0,0,0,0,0,0,0
20200528,056480,京鼎元大98購02,1.25,1.25,1.13,1.13,-0.07,-5.83,90000,8,106960,0,0,0,0,0,0,41000,51000,-10000,-10000
20200528,056481,創意元大98購01,0.89,0.92,0.83,0.83,0.00,0.00,247000,16,209930,0,0,0,0,0,0,75000,152000,-77000,-77000
20200528,056482,貿聯元大99購01,,,,,0.00,0.00,0,0,0,0,0,0,0,0,0,0,0,0,0
20200528,056483,TPK元大98購01,,,,,0.00,0.00,0,0,0,0,0,0,0,0,0,0,0,0,0
20200528,056484,聯茂元大98購02,2.39,2.47,2.39,2.47,+0.04,1.65,28000,3,67560,0,0,0,0,0,0,15000,13000,2000,2000
20200528,056485,同欣電元大98購01,0.44,0.44,0.44,0.44,0.00,0.00,20000,1,8800,0,0,0,0,0,0,20000,0,20000,20000
20200528,056486,樺漢元大98購04,1.32,1.45,1.32,1.45,+0.02,1.4,63000,3,88700,0,0,0,0,0,0,10000,53000,-43000,-43000
20200528,056487,康友元大98購01,,,,,0.00,0.00,0,0,0,0,0,0,0,0,0,0,0,0,0
20200528,056488,致新元大99購01,2.51,2.79,2.51,2.77,+0.17,6.54,482000,33,1286700,0,0,0,0,0,0,243000,360000,-117000,-117000
20200528,056489,S&P反1國泰9A購01,1.07,1.07,1.05,1.05,0.00,0.00,155000,4,163550,0,0,0,0,0,0,0,155000,-155000,-155000
20200528,05648P,康控國票97售01,,,,,0.00,0.00,0,0,0,0,0,0,0,0,0,0,0,0,0
20200528,056490,台積電國泰99購01,,,,,0.00,0.00,0,0,0,0,0,0,0,0,0,0,0,0,0
20200528,056491,南亞科國泰99購01,,,,,0.00,0.00,0,0,0,0,0,0,0,0,0,0,0,0,0
20200528,056492,全新國泰9A購01,0.61,0.62,0.59,0.62,0.00,0.00,721000,38,443720,0,0,0,0,0,0,651000,559000,92000,92000
20200528,056493,晶技國泰99購01,,,,,0.00,0.00,0,0,0,0,0,0,0,0,0,0,0,0,0
20200528,056494,緯創國泰99購01,1.67,1.67,1.67,1.67,0.00,0.00,15000,1,25050,0,0,0,0,0,0,15000,0,15000,15000
20200528,056495,泰鼎國泰99購01,,,,,0.00,0.00,0,0,0,0,0,0,0,0,0,0,0,0,0
20200528,056496,康控國泰99購01,0.78,0.78,0.78,0.78,-0.12,-13.33,5000,1,3900,0,0,0,0,0,0,5000,0,5000,5000
20200528,056497,GIS國泰99購01,3.21,3.21,2.66,2.66,0.00,0.00,16000,2,48610,0,0,0,0,0,0,0,16000,-16000,-16000
20200528,056498,A50正2富邦9B購01,,,,,0.00,0.00,0,0,0,0,0,0,0,0,0,0,0,0,0
20200528,056499,鴻海富邦98購02,,,,,0.00,0.00,0,0,0,0,0,0,0,0,0,0,0,0,0
20200528,05649P,矽創國票97售03,,,,,0.00,0.00,0,0,0,0,0,0,0,0,0,0,0,0,0
20200528,056500,大立光富邦9B購02,0.45,0.45,0.45,0.45,0.00,0.00,1000,1,450,0,0,0,0,0,0,0,0,0,0
20200528,056501,貿聯富邦99購01,,,,,0.00,0.00,0,0,0,0,0,0,0,0,0,0,0,0,0
20200528,056502,A50正2永豐98購01,,,,,0.00,0.00,0,0,0,0,0,0,0,0,0,0,0,0,0
20200528,056503,楠梓電永豐98購01,,,,,0.00,0.00,0,0,0,0,0,0,0,0,0,0,0,0,0
20200528,056504,國巨永豐98購02,,,,,0.00,0.00,0,0,0,0,0,0,0,0,0,0,0,0,0
20200528,056505,聯發科永豐98購01,2.50,2.50,2.50,2.50,+0.16,6.84,1000,1,2500,0,0,0,0,0,0,1000,0,1000,1000
20200528,056506,晶豪科永豐98購02,3.52,3.59,3.35,3.35,-0.04,-1.18,17000,3,60090,0,0,0,0,0,0,0,17000,-17000,-17000
20200528,056507,創意永豐98購02,1.11,1.14,1.05,1.05,-0.02,-1.87,405000,30,444550,0,0,0,0,0,0,60000,299000,-239000,-239000
20200528,056508,揚明光永豐98購01,,,,,0.00,0.00,0,0,0,0,0,0,0,0,0,0,0,0,0
20200528,056509,晶相光永豐98購01,,,,,0.00,0.00,0,0,0,0,0,0,0,0,0,0,0,0,0
20200528,05650P,台積電富邦96售01,0.02,0.02,0.02,0.02,0.00,0.00,100000,2,2000,0,0,0,0,0,0,0,100000,-100000,-100000
20200528,056510,正文永豐98購02,,,,,0.00,0.00,0,0,0,0,0,0,0,0,0,0,0,0,0
20200528,056511,超眾永豐98購01,1.05,1.05,0.98,0.98,-0.14,-12.5,23000,4,23840,0,0,0,0,0,0,3000,20000,-17000,-17000
20200528,056512,易華電永豐98購01,0.41,0.41,0.34,0.35,-0.06,-14.63,70000,6,26310,0,0,0,0,0,0,39000,31000,8000,8000
20200528,056513,臻鼎亞東99購01,,,,,0.00,0.00,0,0,0,0,0,0,0,0,0,0,0,0,0
20200528,056514,訊芯亞東99購01,,,,,0.00,0.00,0,0,0,0,0,0,0,0,0,0,0,0,0
20200528,056515,燿華兆豐99購01,0.21,0.21,0.18,0.18,0.00,0.00,20000,2,3900,0,0,0,0,0,0,0,10000,-10000,-10000
20200528,056516,晶豪科兆豐98購01,2.19,2.19,2.19,2.19,0.00,0.00,2000,1,4380,0,0,0,0,0,0,0,2000,-2000,-2000
20200528,056517,茂林兆豐99購01,1.00,1.00,0.95,0.95,-0.02,-2.06,118000,25,115750,0,0,0,0,0,0,88000,30000,58000,58000
20200528,056518,美律國票99購01,1.70,1.70,1.70,1.70,+0.10,6.25,13000,1,22100,0,0,0,0,0,0,13000,0,13000,13000
20200528,056519,創意國票99購01,2.99,2.99,2.99,2.99,+0.11,3.82,50000,2,149500,0,0,0,0,0,0,40000,10000,30000,30000
20200528,05651P,大立光元大97售02,2.99,3.25,2.98,3.25,0.00,0.00,96000,5,301240,0,0,0,0,0,0,96000,96000,0,0
20200528,056520,鴻海日盛99購01,0.27,0.32,0.27,0.32,-0.04,-11.11,5000,5,1430,0,0,0,0,0,0,4000,0,4000,4000
20200528,056521,群創日盛98購01,,,,,0.00,0.00,0,0,0,0,0,0,0,0,0,0,0,0,0
20200528,056522,T50反1中信9B購01,,,,,0.00,0.00,0,0,0,0,0,0,0,0,0,0,0,0,0
20200528,056523,光寶科中信98購01,0.60,0.60,0.52,0.52,-0.12,-18.75,316000,11,179760,0,0,0,0,0,0,192000,124000,68000,68000
20200528,056524,欣興中信98購02,0.47,0.53,0.47,0.48,+0.02,4.35,507000,9,247850,0,0,0,0,0,0,31000,476000,-445000,-445000
20200528,056525,T50反1凱基99購06,,,,,0.00,0.00,0,0,0,0,0,0,0,0,0,0,0,0,0
20200528,056526,力山凱基98購01,4.68,4.76,4.59,4.59,+0.11,2.46,78000,20,362470,0,0,0,0,0,0,66000,13000,53000,53000
20200528,056527,大成鋼凱基98購03,,,,,0.00,0.00,0,0,0,0,0,0,0,0,0,0,0,0,0
20200528,056528,為升凱基98購01,,,,,0.00,0.00,0,0,0,0,0,0,0,0,0,0,0,0,0
20200528,056529,中環凱基98購01,0.76,0.77,0.76,0.76,-0.07,-8.43,86000,5,65520,0,0,0,0,0,0,86000,0,86000,86000
20200528,05652P,臻鼎群益96售01,,,,,0.00,0.00,0,0,0,0,0,0,0,0,0,0,0,0,0
20200528,056530,旺宏凱基98購06,,,,,0.00,0.00,0,0,0,0,0,0,0,0,0,0,0,0,0
20200528,056531,佳世達凱基98購01,,,,,0.00,0.00,0,0,0,0,0,0,0,0,0,0,0,0,0
20200528,056532,技嘉凱基98購01,3.69,3.69,3.53,3.53,-0.32,-8.31,2000,2,7220,0,0,0,0,0,0,2000,2000,0,0
20200528,056533,友達凱基9A購02,,,,,0.00,0.00,0,0,0,0,0,0,0,0,0,0,0,0,0
20200528,056534,京元電凱基98購01,2.28,2.30,2.15,2.17,-0.19,-8.05,90000,6,201020,0,0,0,0,0,0,51000,39000,12000,12000
20200528,056535,全新凱基99購02,1.19,1.22,1.19,1.22,-0.02,-1.61,157000,9,187490,0,0,0,0,0,0,110000,47000,63000,63000
20200528,056536,義隆凱基98購04,3.70,3.86,3.61,3.61,+0.18,5.25,220000,33,809660,0,0,0,0,0,0,180000,148000,32000,32000
20200528,056537,冠德凱基98購01,3.36,3.66,3.36,3.51,+0.18,5.41,229000,31,805790,0,0,0,0,0,0,49000,178000,-129000,-129000
20200528,056538,國泰金凱基98購01,0.56,0.56,0.50,0.50,-0.06,-10.71,166000,3,87200,0,0,0,0,0,0,166000,0,166000,166000
20200528,056539,新光金凱基9A購01,,,,,0.00,0.00,0,0,0,0,0,0,0,0,0,0,0,0,0
20200528,05653P,華邦電統一96售02,,,,,0.00,0.00,0,0,0,0,0,0,0,0,0,0,0,0,0
20200528,056540,聯詠凱基98購02,0.92,0.97,0.92,0.97,-0.04,-3.96,6000,2,5670,0,0,0,0,0,0,6000,3000,3000,3000
20200528,056541,智原凱基98購03,,,,,0.00,0.00,0,0,0,0,0,0,0,0,0,0,0,0,0
20200528,056542,緯創凱基98購01,,,,,0.00,0.00,0,0,0,0,0,0,0,0,0,0,0,0,0
20200528,056543,京鼎凱基98購01,0.85,0.85,0.81,0.81,0.00,0.00,93000,2,77050,0,0,0,0,0,0,93000,0,93000,93000
20200528,056544,貿聯凱基98購03,1.27,1.27,1.27,1.27,+0.07,5.83,50000,1,63500,0,0,0,0,0,0,50000,0,50000,50000
20200528,056545,TPK凱基98購02,0.91,0.91,0.75,0.75,-0.10,-11.76,442000,14,395130,0,0,0,0,0,0,432000,53000,379000,379000
20200528,056546,致伸凱基98購01,,,,,0.00,0.00,0,0,0,0,0,0,0,0,0,0,0,0,0
20200528,056547,臻鼎凱基99購01,,,,,0.00,0.00,0,0,0,0,0,0,0,0,0,0,0,0,0
20200528,056548,瀚宇博凱基98購02,2.38,2.47,2.38,2.47,+0.02,0.82,271000,18,653880,0,0,0,0,0,0,173000,98000,75000,75000
20200528,056549,嘉聯益凱基98購04,0.52,0.52,0.52,0.52,0.00,0.00,20000,1,10400,0,0,0,0,0,0,0,20000,-20000,-20000
20200528,05654P,台光電統一96售01,,,,,0.00,0.00,0,0,0,0,0,0,0,0,0,0,0,0,0
20200528,056550,瑞儀凱基99購01,,,,,0.00,0.00,0,0,0,0,0,0,0,0,0,0,0,0,0
20200528,056551,台郡凱基98購04,2.85,2.85,2.85,2.85,+0.05,1.79,10000,1,28500,0,0,0,0,0,0,0,10000,-10000,-10000
20200528,056552,台表科凱基99購01,2.16,2.19,2.03,2.03,-0.14,-6.45,54000,8,116380,0,0,0,0,0,0,0,54000,-54000,-54000
20200528,056553,啟碁凱基98購02,0.46,0.46,0.46,0.46,0.00,0.00,1000,1,460,0,0,0,0,0,0,1000,1000,0,0
20200528,056554,GIS凱基99購01,1.50,1.50,1.50,1.50,-0.01,-0.66,5000,1,7500,0,0,0,0,0,0,5000,0,5000,5000
20200528,056555,矽創凱基98購01,1.27,1.32,1.18,1.18,0.00,0.00,39000,5,49670,0,0,0,0,0,0,0,39000,-39000,-39000
20200528,056556,南電凱基98購01,,,,,0.00,0.00,0,0,0,0,0,0,0,0,0,0,0,0,0
20200528,056557,世紀鋼凱基98購02,5.20,6.20,5.15,6.20,+0.90,16.98,160000,33,899000,0,0,0,0,0,0,76000,84000,-8000,-8000
20200528,056558,台達電群益98購01,1.89,1.89,1.81,1.81,-0.16,-8.12,12000,2,21880,0,0,0,0,0,0,12000,0,12000,12000
20200528,056559,華通群益98購02,0.75,0.87,0.75,0.78,+0.08,11.43,444000,25,361250,0,0,0,0,0,0,266000,168000,98000,98000
20200528,05655P,南亞科統一96售01,,,,,0.00,0.00,0,0,0,0,0,0,0,0,0,0,0,0,0
20200528,056560,旺宏群益98購03,1.47,1.53,1.25,1.25,-0.30,-19.35,487000,22,693220,0,0,0,0,0,0,277000,195000,82000,82000
20200528,056561,台光電群益98購02,,,,,0.00,0.00,0,0,0,0,0,0,0,0,0,0,0,0,0
20200528,056562,奇力新群益98購01,,,,,0.00,0.00,0,0,0,0,0,0,0,0,0,0,0,0,0
20200528,056563,華新科群益98購04,2.09,2.12,2.09,2.12,0.00,0.00,20000,2,42100,0,0,0,0,0,0,0,20000,-20000,-20000
20200528,056564,亞光群益98購02,,,,,0.00,0.00,0,0,0,0,0,0,0,0,0,0,0,0,0
20200528,056565,欣興群益98購03,1.91,2.05,1.91,1.92,+0.17,9.71,83000,6,166520,0,0,0,0,0,0,10000,80000,-70000,-70000
20200528,056566,臻鼎群益98購01,,,,,0.00,0.00,0,0,0,0,0,0,0,0,0,0,0,0,0
20200528,056567,瀚宇博群益98購02,2.32,2.38,2.31,2.32,+0.12,5.45,311000,17,727750,0,0,0,0,0,0,217000,94000,123000,123000
20200528,056568,台表科群益98購01,,,,,0.00,0.00,0,0,0,0,0,0,0,0,0,0,0,0,0
20200528,056569,T50正2元大9B購02,,,,,0.00,0.00,0,0,0,0,0,0,0,0,0,0,0,0,0
20200528,05656P,台表科統一96售01,,,,,0.00,0.00,0,0,0,0,0,0,0,0,0,0,0,0,0
20200528,056570,旺宏元大98購07,,,,,0.00,0.00,0,0,0,0,0,0,0,0,0,0,0,0,0
20200528,056571,燿華元大98購02,1.10,1.10,1.07,1.07,0.00,0.00,150000,3,160590,0,0,0,0,0,0,71000,79000,-8000,-8000
20200528,056572,義隆元大99購01,1.84,1.88,1.77,1.80,+0.13,7.78,658000,48,1181800,0,0,0,0,0,0,514000,64000,450000,450000
20200528,056573,華新科元大99購06,1.27,1.27,1.25,1.25,-0.04,-3.1,60000,4,75500,0,0,0,0,0,0,60000,0,60000,60000
20200528,056574,亞光元大99購03,1.34,1.39,1.20,1.20,-0.14,-10.45,179000,6,238940,0,0,0,0,0,0,30000,149000,-119000,-119000
20200528,056575,禾伸堂元大99購01,,,,,0.00,0.00,0,0,0,0,0,0,0,0,0,0,0,0,0
20200528,056576,晶技元大99購02,5.60,5.60,5.40,5.40,0.00,0.00,12000,2,65800,0,0,0,0,0,0,0,12000,-12000,-12000
20200528,056577,玉晶光元大99購06,0.77,0.77,0.77,0.77,+0.09,13.24,5000,2,3850,0,0,0,0,0,0,1000,0,1000,1000
20200528,056578,智易元大99購02,2.44,2.59,2.33,2.34,+0.05,2.18,197000,23,493700,0,0,0,0,0,0,68000,129000,-61000,-61000
20200528,056579,麗豐元大99購01,1.17,1.20,1.13,1.13,-0.03,-2.59,320000,12,369070,0,0,0,0,0,0,242000,66000,176000,176000
20200528,05657P,樺漢統一97售01,,,,,0.00,0.00,0,0,0,0,0,0,0,0,0,0,0,0,0
20200528,056580,泰鼎元大9A購01,,,,,0.00,0.00,0,0,0,0,0,0,0,0,0,0,0,0,0
20200528,056581,超眾元大99購01,3.13,3.25,3.01,3.25,-0.29,-8.19,55000,6,172890,0,0,0,0,0,0,43000,22000,21000,21000
20200528,056582,易華電元大98購01,0.86,0.86,0.85,0.85,-0.02,-2.3,84000,2,71740,0,0,0,0,0,0,50000,34000,16000,16000
20200528,056583,昇陽半元大98購02,0.75,0.76,0.70,0.70,-0.01,-1.41,180000,5,130610,0,0,0,0,0,0,0,180000,-180000,-180000
20200528,056584,鴻海統一9B購01,0.98,0.99,0.93,0.95,0.00,0.00,2152000,18,2067650,0,0,0,0,0,0,1182000,965000,217000,217000
20200528,056585,台積電統一9A購01,0.34,0.34,0.34,0.34,0.00,0.00,2000,1,680,0,0,0,0,0,0,0,2000,-2000,-2000
20200528,056586,光罩統一98購02,0.59,0.60,0.59,0.59,-0.01,-1.67,98000,4,58620,0,0,0,0,0,0,8000,90000,-82000,-82000
20200528,056587,聯發科統一9A購01,,,,,0.00,0.00,0,0,0,0,0,0,0,0,0,0,0,0,0
20200528,056588,聯發科統一9A購02,4.23,4.25,4.09,4.25,0.00,0.00,55000,5,231330,0,0,0,0,0,0,0,55000,-55000,-55000
20200528,056589,康控統一98購01,,,,,0.00,0.00,0,0,0,0,0,0,0,0,0,0,0,0,0
20200528,05658P,日月光元富96售02,4.66,4.79,4.59,4.78,-0.07,-1.44,139000,38,651180,0,0,0,0,0,0,100000,39000,61000,61000
20200528,056590,樺漢統一9A購01,,,,,0.00,0.00,0,0,0,0,0,0,0,0,0,0,0,0,0
20200528,056591,S&P正2元富9A購01,0.15,0.16,0.15,0.16,+0.03,23.08,70000,3,11050,0,0,0,0,0,0,70000,0,70000,70000
20200528,056592,台積電元富98購01,,,,,0.00,0.00,0,0,0,0,0,0,0,0,0,0,0,0,0
20200528,056593,台積電元富98購02,,,,,0.00,0.00,0,0,0,0,0,0,0,0,0,0,0,0,0
20200528,056594,台積電元富98購03,,,,,0.00,0.00,0,0,0,0,0,0,0,0,0,0,0,0,0
20200528,056595,台積電元富98購04,,,,,0.00,0.00,0,0,0,0,0,0,0,0,0,0,0,0,0
20200528,056596,光磊元富98購01,1.15,1.20,1.12,1.20,+0.04,3.45,150000,9,173200,0,0,0,0,0,0,90000,60000,30000,30000
20200528,056597,宏碁元富98購01,,,,,0.00,0.00,0,0,0,0,0,0,0,0,0,0,0,0,0
20200528,056598,京元電元富98購01,0.51,0.51,0.51,0.51,-0.08,-13.56,12000,1,6120,0,0,0,0,0,0,12000,0,12000,12000
20200528,056599,臻鼎元富98購01,1.61,1.61,1.53,1.53,-0.03,-1.92,104000,3,163120,0,0,0,0,0,0,104000,0,104000,104000
20200528,05659P,A50正2中信97售01,,,,,0.00,0.00,0,0,0,0,0,0,0,0,0,0,0,0,0
20200528,056600,聯茂元富98購01,1.32,1.32,1.32,1.32,0.00,0.00,6000,1,7920,0,0,0,0,0,0,0,6000,-6000,-6000
20200528,056601,鈺齊元富98購01,,,,,0.00,0.00,0,0,0,0,0,0,0,0,0,0,0,0,0
20200528,056602,嘉澤國泰99購01,,,,,0.00,0.00,0,0,0,0,0,0,0,0,0,0,0,0,0
20200528,056603,嘉聯益國泰9A購01,1.58,1.79,1.58,1.74,+0.16,10.13,636000,25,1089600,0,0,0,0,0,0,0,636000,-636000,-636000
20200528,056604,鴻海富邦9A購01,,,,,0.00,0.00,0,0,0,0,0,0,0,0,0,0,0,0,0
20200528,056605,台積電富邦9B購02,0.34,0.37,0.33,0.33,-0.04,-10.81,186000,8,63380,0,0,0,0,0,0,0,0,0,0
20200528,056606,華新科富邦9A購02,,,,,0.00,0.00,0,0,0,0,0,0,0,0,0,0,0,0,0
20200528,056607,貿聯富邦99購02,,,,,0.00,0.00,0,0,0,0,0,0,0,0,0,0,0,0,0
20200528,056608,力山永豐98購01,2.93,3.01,2.55,2.63,-0.21,-7.39,36000,14,101930,0,0,0,0,0,0,16000,20000,-4000,-4000
20200528,056609,楠梓電永豐98購02,,,,,0.00,0.00,0,0,0,0,0,0,0,0,0,0,0,0,0
20200528,05660P,玉晶光第一96售01,,,,,0.00,0.00,0,0,0,0,0,0,0,0,0,0,0,0,0
20200528,056610,鴻海永豐98購01,0.20,0.20,0.20,0.20,+0.01,5.26,15000,1,3000,0,0,0,0,0,0,0,15000,-15000,-15000
20200528,056611,國巨永豐98購03,1.18,1.18,1.18,1.18,+0.02,1.72,60000,1,70800,0,0,0,0,0,0,60000,0,60000,60000
20200528,056612,台積電永豐98購01,,,,,0.00,0.00,0,0,0,0,0,0,0,0,0,0,0,0,0
20200528,056613,旺宏永豐98購01,0.89,0.89,0.89,0.89,-0.08,-8.25,95000,2,84550,0,0,0,0,0,0,95000,0,95000,95000
20200528,056614,智邦永豐98購01,2.94,3.28,2.70,2.70,+0.12,4.65,177000,10,547280,0,0,0,0,0,0,152000,23000,129000,129000
20200528,056615,燿華永豐98購02,,,,,0.00,0.00,0,0,0,0,0,0,0,0,0,0,0,0,0
20200528,056616,台光電永豐98購01,,,,,0.00,0.00,0,0,0,0,0,0,0,0,0,0,0,0,0
20200528,056617,美律永豐98購01,0.53,0.53,0.53,0.53,+0.03,6.0,55000,1,29150,0,0,0,0,0,0,55000,0,55000,55000
20200528,056618,京元電永豐98購01,,,,,0.00,0.00,0,0,0,0,0,0,0,0,0,0,0,0,0
20200528,056619,強茂永豐98購01,,,,,0.00,0.00,0,0,0,0,0,0,0,0,0,0,0,0,0
20200528,05661P,聯發科統一96售06,0.45,0.45,0.45,0.45,0.00,0.00,20000,1,9000,0,0,0,0,0,0,20000,0,20000,20000
20200528,056620,華新科永豐98購02,,,,,0.00,0.00,0,0,0,0,0,0,0,0,0,0,0,0,0
20200528,056621,宏達電永豐98購01,0.58,0.58,0.58,0.58,-0.14,-19.44,10000,1,5800,0,0,0,0,0,0,0,10000,-10000,-10000
20200528,056622,高鐵永豐98購01,1.76,1.76,1.49,1.49,-0.25,-14.37,137000,25,239830,0,0,0,0,0,0,135000,2000,133000,133000
20200528,056623,禾伸堂永豐98購01,1.31,1.31,1.31,1.31,-0.09,-6.43,20000,2,26200,0,0,0,0,0,0,10000,10000,0,0
20200528,056624,景碩永豐98購01,0.72,0.84,0.72,0.84,+0.13,18.31,183000,16,140190,0,0,0,0,0,0,110000,73000,37000,37000
20200528,056625,致伸永豐98購01,0.43,0.44,0.43,0.44,0.00,0.00,68000,2,29340,0,0,0,0,0,0,0,68000,-68000,-68000
20200528,056626,同欣電永豐98購01,0.53,0.53,0.51,0.51,-0.11,-17.74,47000,5,24620,0,0,0,0,0,0,47000,0,47000,47000
20200528,056627,訊芯永豐98購01,,,,,0.00,0.00,0,0,0,0,0,0,0,0,0,0,0,0,0
20200528,056628,矽創永豐98購01,,,,,0.00,0.00,0,0,0,0,0,0,0,0,0,0,0,0,0
20200528,056629,昇陽半永豐98購01,,,,,0.00,0.00,0,0,0,0,0,0,0,0,0,0,0,0,0
20200528,05662P,景碩元富96售01,,,,,0.00,0.00,0,0,0,0,0,0,0,0,0,0,0,0,0
20200528,056630,臺股指永豐98購02,,,,,0.00,0.00,0,0,0,0,0,0,0,0,0,0,0,0,0
20200528,056631,臺股指永豐98購03,,,,,0.00,0.00,0,0,0,0,0,0,0,0,0,0,0,0,0
20200528,056632,鴻海永昌98購01,0.77,0.77,0.77,0.77,0.00,0.00,60000,1,46200,0,0,0,0,0,0,60000,0,60000,60000
20200528,056633,鴻海永昌98購02,,,,,0.00,0.00,0,0,0,0,0,0,0,0,0,0,0,0,0
20200528,056634,為升兆豐99購01,0.31,0.32,0.31,0.32,0.00,0.00,32000,4,10230,0,0,0,0,0,0,0,31000,-31000,-31000
20200528,056635,亞德客日盛99購01,3.32,3.44,3.09,3.09,-0.23,-6.93,104000,28,351300,0,0,0,0,0,0,94000,10000,84000,84000
20200528,056636,台積電日盛9A購01,,,,,0.00,0.00,0,0,0,0,0,0,0,0,0,0,0,0,0
20200528,056637,台光電日盛9A購01,3.77,3.77,3.47,3.47,-0.42,-10.8,36000,6,127880,0,0,0,0,0,0,23000,23000,0,0
20200528,056638,臺股指日盛98購01,0.41,0.43,0.29,0.30,-0.07,-18.92,743000,16,255900,0,0,0,0,0,0,281000,462000,-181000,-181000
20200528,056639,國產康和98購01,0.65,0.65,0.57,0.57,-0.07,-10.94,100000,5,61300,0,0,0,0,0,0,20000,80000,-60000,-60000
20200528,05663P,創意元富96售04,,,,,0.00,0.00,0,0,0,0,0,0,0,0,0,0,0,0,0
20200528,056640,元油2X凱基9A購01,,,,,0.00,0.00,0,0,0,0,0,0,0,0,0,0,0,0,0
20200528,056641,華通凱基98購03,2.76,3.14,2.76,2.95,+0.30,11.32,267000,25,824100,0,0,0,0,0,0,23000,244000,-221000,-221000
20200528,056642,旺宏凱基98購07,1.81,1.85,1.66,1.66,-0.22,-11.7,63000,32,114500,0,0,0,0,0,0,60000,3000,57000,57000
20200528,056643,奇力新凱基99購01,,,,,0.00,0.00,0,0,0,0,0,0,0,0,0,0,0,0,0
20200528,056644,宏達電凱基98購04,1.24,1.26,1.19,1.19,-0.20,-14.39,59000,3,73960,0,0,0,0,0,0,9000,59000,-50000,-50000
20200528,056645,大立光凱基98購12,,,,,0.00,0.00,0,0,0,0,0,0,0,0,0,0,0,0,0
20200528,056646,奇鋐凱基99購02,0.82,0.93,0.82,0.89,0.00,0.00,155000,28,139210,0,0,0,0,0,0,17000,153000,-136000,-136000
20200528,056647,晶技凱基98購02,,,,,0.00,0.00,0,0,0,0,0,0,0,0,0,0,0,0,0
20200528,056648,牧德凱基99購02,,,,,0.00,0.00,0,0,0,0,0,0,0,0,0,0,0,0,0
20200528,056649,智易凱基98購01,2.61,2.73,2.61,2.73,+0.29,11.89,59000,6,155630,0,0,0,0,0,0,0,19000,-19000,-19000
20200528,05664P,國巨凱基96售09,,,,,0.00,0.00,0,0,0,0,0,0,0,0,0,0,0,0,0
20200528,056650,彩晶凱基9A購01,,,,,0.00,0.00,0,0,0,0,0,0,0,0,0,0,0,0,0
20200528,056651,聯茂凱基98購04,2.18,2.35,2.18,2.35,0.00,0.00,44000,5,99260,0,0,0,0,0,0,0,44000,-44000,-44000
20200528,056652,上証反元大9B購01,,,,,0.00,0.00,0,0,0,0,0,0,0,0,0,0,0,0,0
20200528,056653,元石油元大98購01,0.02,0.03,0.02,0.03,0.00,0.00,269000,4,7380,0,0,0,0,0,0,0,0,0,0
20200528,056654,元油2X元大98購02,,,,,0.00,0.00,0,0,0,0,0,0,0,0,0,0,0,0,0
20200528,056655,旺宏元大99購02,2.40,2.45,2.39,2.39,-0.02,-0.83,123000,7,297290,0,0,0,0,0,0,55000,68000,-13000,-13000
20200528,056656,華邦電元大98購02,,,,,0.00,0.00,0,0,0,0,0,0,0,0,0,0,0,0,0
20200528,056657,華邦電元大99購01,1.90,2.01,1.76,1.76,+0.09,5.39,606000,35,1154610,0,0,0,0,0,0,376000,110000,266000,266000
20200528,056658,美食元大98購01,2.07,2.07,2.07,2.07,-0.35,-14.46,50000,1,103500,0,0,0,0,0,0,50000,0,50000,50000
20200528,056659,泰碩元大99購01,1.48,1.48,1.45,1.45,-0.07,-4.61,90000,4,131330,0,0,0,0,0,0,90000,40000,50000,50000
20200528,05665P,台積電凱基96售08,,,,,0.00,0.00,0,0,0,0,0,0,0,0,0,0,0,0,0
20200528,056660,臺股指元大9A購07,,,,,0.00,0.00,0,0,0,0,0,0,0,0,0,0,0,0,0
20200528,056661,臺股指元大9A購08,,,,,0.00,0.00,0,0,0,0,0,0,0,0,0,0,0,0,0
20200528,056662,臺股指元大9A購09,,,,,0.00,0.00,0,0,0,0,0,0,0,0,0,0,0,0,0
20200528,056663,臺股指元大9A購10,,,,,0.00,0.00,0,0,0,0,0,0,0,0,0,0,0,0,0
20200528,056664,上証反中信9B購01,0.23,0.23,0.23,0.23,0.00,0.00,6000,1,1380,0,0,0,0,0,0,6000,0,6000,6000
20200528,056665,上証2X國票99購02,0.71,0.71,0.71,0.71,-0.08,-10.13,20000,1,14200,0,0,0,0,0,0,20000,0,20000,20000
20200528,056666,元油2X國票9A購01,0.04,0.04,0.04,0.04,0.00,0.00,1000,1,40,0,0,0,0,0,0,0,0,0,0
20200528,056667,上銀國票99購01,5.35,5.85,5.35,5.85,+0.10,1.74,26000,14,140800,0,0,0,0,0,0,26000,0,26000,26000
20200528,056668,光磊國票99購01,2.65,2.77,2.60,2.77,+0.07,2.59,183000,17,498880,0,0,0,0,0,0,45000,156000,-111000,-111000
20200528,056669,貿聯國票99購01,1.61,1.64,1.55,1.55,-0.05,-3.12,348000,22,558490,0,0,0,0,0,0,82000,286000,-204000,-204000
20200528,05666P,聯發科凱基96售14,,,,,0.00,0.00,0,0,0,0,0,0,0,0,0,0,0,0,0
20200528,056670,樺漢國票99購01,1.50,1.50,1.50,1.50,-0.07,-4.46,5000,1,7500,0,0,0,0,0,0,5000,0,5000,5000
20200528,056671,台灣50元富9A購01,,,,,0.00,0.00,0,0,0,0,0,0,0,0,0,0,0,0,0
20200528,056672,元油2X元富98購10,0.04,0.04,0.04,0.04,+0.01,33.33,1000,1,40,0,0,0,0,0,0,0,0,0,0
20200528,056673,中石化元富9B購01,,,,,0.00,0.00,0,0,0,0,0,0,0,0,0,0,0,0,0
20200528,056674,華邦電元富98購01,1.05,1.07,0.75,0.76,-0.19,-20.0,1300000,77,1216700,0,0,0,0,0,0,739000,445000,294000,294000
20200528,056675,聯發科元富02購01,,,,,0.00,0.00,0,0,0,0,0,0,0,0,0,0,0,0,0
20200528,056676,國產元富98購01,1.28,1.30,1.21,1.21,-0.12,-9.02,594000,23,751420,0,0,0,0,0,0,323000,207000,116000,116000
20200528,056677,智伸科元富98購01,1.37,1.39,1.09,1.09,-0.26,-19.26,588000,44,769610,0,0,0,0,0,0,368000,213000,155000,155000
20200528,056678,力成元富98購01,,,,,0.00,0.00,0,0,0,0,0,0,0,0,0,0,0,0,0
20200528,056679,元油2X統一98購01,,,,,0.00,0.00,0,0,0,0,0,0,0,0,0,0,0,0,0
20200528,05667P,旺宏台新96售01,,,,,0.00,0.00,0,0,0,0,0,0,0,0,0,0,0,0,0
20200528,056680,華通統一98購04,0.64,0.67,0.64,0.64,+0.11,20.75,110000,5,71400,0,0,0,0,0,0,80000,6000,74000,74000
20200528,056681,鴻海統一98購09,1.48,1.48,1.42,1.42,-0.04,-2.74,12000,6,17640,0,0,0,0,0,0,12000,12000,0,0
20200528,056682,鴻海統一98購10,1.22,1.22,1.18,1.18,-0.03,-2.48,40000,8,48700,0,0,0,0,0,0,40000,9000,31000,31000
20200528,056683,台積電統一98購05,0.45,0.45,0.45,0.45,+0.01,2.27,10000,1,4500,0,0,0,0,0,0,0,10000,-10000,-10000
20200528,056684,旺宏統一98購02,1.05,1.07,0.94,0.94,-0.13,-12.15,192000,19,197980,0,0,0,0,0,0,192000,0,192000,192000
20200528,056685,光罩統一98購03,0.27,0.27,0.23,0.23,-0.06,-20.69,85000,3,20850,0,0,0,0,0,0,55000,30000,25000,25000
20200528,056686,可成統一98購01,0.62,0.62,0.62,0.62,-0.05,-7.46,10000,1,6200,0,0,0,0,0,0,0,10000,-10000,-10000
20200528,056687,元大金統一98購01,,,,,0.00,0.00,0,0,0,0,0,0,0,0,0,0,0,0,0
20200528,056688,聯詠統一98購01,,,,,0.00,0.00,0,0,0,0,0,0,0,0,0,0,0,0,0
20200528,056689,玉晶光統一9A購03,1.94,1.94,1.94,1.94,-0.01,-0.51,30000,1,58200,0,0,0,0,0,0,30000,0,30000,30000
20200528,05668P,滬深2X永豐96售04,,,,,0.00,0.00,0,0,0,0,0,0,0,0,0,0,0,0,0
20200528,056691,元油2X群益9B購01,0.06,0.06,0.05,0.05,-0.01,-16.67,71000,3,3710,0,0,0,0,0,0,0,5000,-5000,-5000
20200528,056692,燿華群益98購03,,,,,0.00,0.00,0,0,0,0,0,0,0,0,0,0,0,0,0
20200528,056693,國產群益98購01,0.73,0.73,0.66,0.66,-0.10,-13.16,543000,13,386840,0,0,0,0,0,0,533000,0,533000,533000
20200528,056694,欣興群益98購04,3.22,3.74,3.22,3.33,+0.23,7.42,139000,16,486450,0,0,0,0,0,0,36000,128000,-92000,-92000
20200528,056695,景碩群益99購01,,,,,0.00,0.00,0,0,0,0,0,0,0,0,0,0,0,0,0
20200528,056696,茂林群益98購02,0.76,0.76,0.76,0.76,-0.39,-33.91,40000,6,30400,0,0,0,0,0,0,40000,0,40000,40000
20200528,056697,緯穎群益98購01,,,,,0.00,0.00,0,0,0,0,0,0,0,0,0,0,0,0,0
20200528,056698,T50反1國泰9A購01,,,,,0.00,0.00,0,0,0,0,0,0,0,0,0,0,0,0,0
20200528,056699,光罩國泰99購01,0.70,0.70,0.69,0.69,-0.08,-10.39,40000,4,27800,0,0,0,0,0,0,10000,40000,-30000,-30000
20200528,05669P,嘉晶永豐96售03,,,,,0.00,0.00,0,0,0,0,0,0,0,0,0,0,0,0,0
20200528,056700,華新科國泰99購03,0.65,0.65,0.65,0.65,+0.02,3.17,2000,1,1300,0,0,0,0,0,0,2000,0,2000,2000
20200528,056701,國產國泰9A購01,1.28,1.28,1.16,1.16,-0.20,-14.71,23000,10,28310,0,0,0,0,0,0,0,23000,-23000,-23000
20200528,056702,欣興國泰9A購01,,,,,0.00,0.00,0,0,0,0,0,0,0,0,0,0,0,0,0
20200528,056703,群創國泰9A購01,,,,,0.00,0.00,0,0,0,0,0,0,0,0,0,0,0,0,0
20200528,056704,健策國泰99購01,,,,,0.00,0.00,0,0,0,0,0,0,0,0,0,0,0,0,0
20200528,056705,超眾國泰99購01,2.25,2.37,2.25,2.32,+0.06,2.65,217000,13,509390,0,0,0,0,0,0,16000,201000,-185000,-185000
20200528,056706,元油2X富邦9B購01,,,,,0.00,0.00,0,0,0,0,0,0,0,0,0,0,0,0,0
20200528,056707,鴻海富邦99購03,,,,,0.00,0.00,0,0,0,0,0,0,0,0,0,0,0,0,0
20200528,056708,元油2X永豐98購02,,,,,0.00,0.00,0,0,0,0,0,0,0,0,0,0,0,0,0
20200528,056709,華通永豐98購01,2.20,2.42,2.20,2.40,+0.33,15.94,85000,8,198730,0,0,0,0,0,0,10000,75000,-65000,-65000
20200528,05670P,台積電國票98售01,0.51,0.51,0.51,0.51,0.00,0.00,20000,2,10200,0,0,0,0,0,0,0,20000,-20000,-20000
20200528,056710,漢唐永豐98購01,0.97,0.98,0.94,0.94,-0.09,-8.74,143000,5,136600,0,0,0,0,0,0,92000,51000,41000,41000
20200528,056711,亞光永豐98購01,,,,,0.00,0.00,0,0,0,0,0,0,0,0,0,0,0,0,0
20200528,056712,京鼎永豐98購01,,,,,0.00,0.00,0,0,0,0,0,0,0,0,0,0,0,0,0
20200528,056713,華擎永豐98購01,2.70,2.97,2.70,2.84,+0.07,2.53,53000,9,152350,0,0,0,0,0,0,5000,53000,-48000,-48000
20200528,056714,晶相光永豐98購02,0.65,0.65,0.63,0.63,-0.09,-12.5,135000,5,85570,0,0,0,0,0,0,125000,0,125000,125000
20200528,056715,瀚宇博永豐98購01,0.72,0.77,0.72,0.75,0.00,0.00,148000,15,109290,0,0,0,0,0,0,98000,87000,11000,11000
20200528,056716,康舒永豐98購01,0.37,0.37,0.37,0.37,+0.01,2.78,37000,2,13690,0,0,0,0,0,0,0,37000,-37000,-37000
20200528,056717,康友永豐98購01,0.04,0.04,0.03,0.03,0.00,0.00,120000,6,4600,0,0,0,0,0,0,0,30000,-30000,-30000
20200528,056718,GIS永豐98購01,1.21,1.21,1.21,1.21,0.00,0.00,10000,1,12100,0,0,0,0,0,0,10000,0,10000,10000
20200528,056719,台虹永豐98購01,0.69,0.70,0.64,0.64,-0.08,-11.11,145000,20,100040,0,0,0,0,0,0,145000,20000,125000,125000
20200528,05671P,友達國泰97售03,,,,,0.00,0.00,0,0,0,0,0,0,0,0,0,0,0,0,0
20200528,056720,世紀鋼永豐98購01,,,,,0.00,0.00,0,0,0,0,0,0,0,0,0,0,0,0,0
20200528,056721,台灣50永昌9A購01,,,,,0.00,0.00,0,0,0,0,0,0,0,0,0,0,0,0,0
20200528,056722,滬深反中信9B購01,0.53,0.53,0.53,0.53,0.00,0.00,10000,1,5300,0,0,0,0,0,0,0,10000,-10000,-10000
20200528,056723,國巨中信9A購01,,,,,0.00,0.00,0,0,0,0,0,0,0,0,0,0,0,0,0
20200528,056724,臻鼎中信9A購01,0.35,0.35,0.29,0.31,-0.03,-8.82,1289000,34,407290,0,0,0,0,0,0,305000,871000,-566000,-566000
20200528,056725,鴻海國票99購03,,,,,0.00,0.00,0,0,0,0,0,0,0,0,0,0,0,0,0
20200528,056726,友達日盛9A購01,,,,,0.00,0.00,0,0,0,0,0,0,0,0,0,0,0,0,0
20200528,056727,滬深反凱基9B購01,0.29,0.29,0.29,0.29,0.00,0.00,2000,1,580,0,0,0,0,0,0,0,2000,-2000,-2000
20200528,056728,元油2X凱基9A購02,,,,,0.00,0.00,0,0,0,0,0,0,0,0,0,0,0,0,0
20200528,056729,元油2X凱基9A購03,,,,,0.00,0.00,0,0,0,0,0,0,0,0,0,0,0,0,0
20200528,05672P,鴻海群益96售03,,,,,0.00,0.00,0,0,0,0,0,0,0,0,0,0,0,0,0
20200528,056730,元油2X凱基9A購04,0.02,0.02,0.02,0.02,0.00,0.00,51000,1,1020,0,0,0,0,0,0,0,0,0,0
20200528,056731,國巨凱基98購04,,,,,0.00,0.00,0,0,0,0,0,0,0,0,0,0,0,0,0
20200528,056732,國巨凱基98購07,,,,,0.00,0.00,0,0,0,0,0,0,0,0,0,0,0,0,0
20200528,056733,國巨凱基98購10,,,,,0.00,0.00,0,0,0,0,0,0,0,0,0,0,0,0,0
20200528,056734,國巨凱基99購01,,,,,0.00,0.00,0,0,0,0,0,0,0,0,0,0,0,0,0
20200528,056735,國巨凱基99購02,,,,,0.00,0.00,0,0,0,0,0,0,0,0,0,0,0,0,0
20200528,056736,國巨凱基99購03,1.85,1.85,1.85,1.85,0.00,0.00,3000,1,5550,0,0,0,0,0,0,3000,0,3000,3000
20200528,056737,國巨凱基9A購01,,,,,0.00,0.00,0,0,0,0,0,0,0,0,0,0,0,0,0
20200528,056738,國巨凱基9A購02,1.29,1.29,1.23,1.23,-0.05,-3.91,21000,3,26460,0,0,0,0,0,0,10000,11000,-1000,-1000
20200528,056739,美律凱基98購04,,,,,0.00,0.00,0,0,0,0,0,0,0,0,0,0,0,0,0
20200528,05673P,台積電群益96售05,0.07,0.07,0.02,0.02,0.00,0.00,391000,3,8570,0,0,0,0,0,0,374000,391000,-17000,-17000
20200528,056740,大立光凱基98購13,,,,,0.00,0.00,0,0,0,0,0,0,0,0,0,0,0,0,0
20200528,056741,大立光凱基98購14,,,,,0.00,0.00,0,0,0,0,0,0,0,0,0,0,0,0,0
20200528,056742,玉晶光凱基9A購01,,,,,0.00,0.00,0,0,0,0,0,0,0,0,0,0,0,0,0
20200528,056743,貿聯凱基98購04,1.19,1.24,1.17,1.24,+0.06,5.08,102000,10,122680,0,0,0,0,0,0,34000,68000,-34000,-34000
20200528,056744,麗豐凱基9A購01,0.65,0.65,0.63,0.63,-0.02,-3.08,125000,7,81010,0,0,0,0,0,0,20000,105000,-85000,-85000
20200528,056745,聯茂凱基99購03,2.84,2.84,2.84,2.84,0.00,0.00,2000,1,5680,0,0,0,0,0,0,0,2000,-2000,-2000
20200528,056746,超眾凱基99購01,1.89,2.02,1.89,1.94,-0.12,-5.83,151000,15,301730,0,0,0,0,0,0,68000,131000,-63000,-63000
20200528,056747,致新凱基99購01,2.10,2.27,2.10,2.22,+0.09,4.23,99000,19,215360,0,0,0,0,0,0,22000,76000,-54000,-54000
20200528,056748,T50反1兆豐99購01,,,,,0.00,0.00,0,0,0,0,0,0,0,0,0,0,0,0,0
20200528,056749,滬深2X兆豐99購01,0.90,1.01,0.90,0.94,+0.04,4.44,314000,9,295000,0,0,0,0,0,0,306000,0,306000,306000
20200528,05674P,瑞昱群益96售02,,,,,0.00,0.00,0,0,0,0,0,0,0,0,0,0,0,0,0
20200528,056750,元油2X兆豐9A購01,,,,,0.00,0.00,0,0,0,0,0,0,0,0,0,0,0,0,0
20200528,056751,和大兆豐98購01,,,,,0.00,0.00,0,0,0,0,0,0,0,0,0,0,0,0,0
20200528,056752,國巨兆豐98購02,,,,,0.00,0.00,0,0,0,0,0,0,0,0,0,0,0,0,0
20200528,056753,群創兆豐98購02,0.01,0.01,0.01,0.01,0.00,0.00,10000,1,100,0,0,0,0,0,0,0,10000,-10000,-10000
20200528,056754,智易兆豐99購01,,,,,0.00,0.00,0,0,0,0,0,0,0,0,0,0,0,0,0
20200528,056755,聯茂兆豐98購01,1.07,1.16,1.06,1.10,0.00,0.00,113000,14,127900,0,0,0,0,0,0,35000,78000,-43000,-43000
20200528,056756,T50反1元大98購06,0.32,0.32,0.32,0.32,0.00,0.00,5000,1,1600,0,0,0,0,0,0,5000,0,5000,5000
20200528,056757,T50反1元大98購07,1.10,1.10,1.10,1.10,+0.03,2.8,5000,1,5500,0,0,0,0,0,0,0,5000,-5000,-5000
20200528,056758,元石油元大98購02,,,,,0.00,0.00,0,0,0,0,0,0,0,0,0,0,0,0,0
20200528,056759,元油2X元大98購05,,,,,0.00,0.00,0,0,0,0,0,0,0,0,0,0,0,0,0
20200528,05675P,美律群益97售01,,,,,0.00,0.00,0,0,0,0,0,0,0,0,0,0,0,0,0
20200528,056760,元油2X元大98購06,,,,,0.00,0.00,0,0,0,0,0,0,0,0,0,0,0,0,0
20200528,056761,元油2X元大98購07,0.01,0.02,0.01,0.02,0.00,0.00,358000,16,3690,0,0,0,0,0,0,0,0,0,0
20200528,056762,亞德客元大98購01,2.87,3.00,2.55,2.58,-0.15,-5.49,226000,30,636210,0,0,0,0,0,0,226000,5000,221000,221000
20200528,056763,國巨元大99購02,2.78,2.78,2.66,2.66,-0.04,-1.48,33000,3,88700,0,0,0,0,0,0,33000,0,33000,33000
20200528,056764,友達元大9A購03,,,,,0.00,0.00,0,0,0,0,0,0,0,0,0,0,0,0,0
20200528,056765,友達元大9B購05,,,,,0.00,0.00,0,0,0,0,0,0,0,0,0,0,0,0,0
20200528,056766,義隆元大98購01,2.73,2.80,2.59,2.59,+0.09,3.6,75000,14,203900,0,0,0,0,0,0,65000,16000,49000,49000
20200528,056767,大毅元大99購01,1.54,1.54,1.54,1.54,0.00,0.00,23000,2,35420,0,0,0,0,0,0,23000,0,23000,23000
20200528,056768,宏達電元大99購03,,,,,0.00,0.00,0,0,0,0,0,0,0,0,0,0,0,0,0
20200528,056769,國產元大98購01,0.98,0.98,0.84,0.87,-0.12,-12.12,684000,26,639600,0,0,0,0,0,0,337000,347000,-10000,-10000
20200528,05676P,欣興群益96售04,,,,,0.00,0.00,0,0,0,0,0,0,0,0,0,0,0,0,0
20200528,056770,國產元大98購02,1.04,1.04,0.94,0.94,-0.09,-8.74,194000,12,193460,0,0,0,0,0,0,155000,39000,116000,116000
20200528,056771,嘉晶元大99購01,12.90,12.90,12.90,12.90,0.00,0.00,10000,1,129000,0,0,0,0,0,0,0,10000,-10000,-10000
20200528,056772,欣興元大99購01,3.46,3.83,3.43,3.71,+0.24,6.92,35000,12,127860,0,0,0,0,0,0,21000,25000,-4000,-4000
20200528,056773,晶技元大99購03,,,,,0.00,0.00,0,0,0,0,0,0,0,0,0,0,0,0,0
20200528,056774,和鑫元大98購01,0.46,0.50,0.39,0.40,-0.05,-11.11,56000,6,25200,0,0,0,0,0,0,20000,31000,-11000,-11000
20200528,056775,康控元大99購01,,,,,0.00,0.00,0,0,0,0,0,0,0,0,0,0,0,0,0
20200528,056776,聯茂元大99購01,3.30,3.54,3.30,3.44,+0.10,2.99,74000,5,251320,0,0,0,0,0,0,11000,63000,-52000,-52000
20200528,056777,矽力元大98購02,6.10,6.70,6.10,6.30,+0.50,8.62,147000,21,926250,0,0,0,0,0,0,79000,67000,12000,12000
20200528,056778,元石油群益9B購01,,,,,0.00,0.00,0,0,0,0,0,0,0,0,0,0,0,0,0
20200528,056779,元油2X群益9A購02,,,,,0.00,0.00,0,0,0,0,0,0,0,0,0,0,0,0,0
20200528,05677P,玉晶光群益98售03,0.16,0.19,0.16,0.19,-0.02,-9.52,50000,3,8300,0,0,0,0,0,0,40000,10000,30000,30000
20200528,056780,元油2X群益9A購03,0.02,0.02,0.02,0.02,-0.02,-50.0,60000,3,1200,0,0,0,0,0,0,0,0,0,0
20200528,056781,元油2X群益9B購02,0.06,0.08,0.06,0.07,-0.02,-22.22,152000,7,10050,0,0,0,0,0,0,0,150000,-150000,-150000
20200528,056782,鴻海群益98購04,,,,,0.00,0.00,0,0,0,0,0,0,0,0,0,0,0,0,0
20200528,056783,國巨群益99購01,1.63,1.68,1.53,1.53,-0.09,-5.56,106000,12,172030,0,0,0,0,0,0,71000,35000,36000,36000
20200528,056784,南亞科群益98購01,0.62,0.63,0.61,0.61,+0.05,8.93,158000,4,98720,0,0,0,0,0,0,121000,37000,84000,84000
20200528,056785,可成群益99購01,,,,,0.00,0.00,0,0,0,0,0,0,0,0,0,0,0,0,0
20200528,056786,亞光群益98購03,0.56,0.56,0.54,0.54,+0.01,1.89,186000,3,103200,0,0,0,0,0,0,10000,176000,-166000,-166000
20200528,056787,健鼎群益98購01,1.23,1.31,1.23,1.23,-0.01,-0.81,249000,15,315340,0,0,0,0,0,0,39000,210000,-171000,-171000
20200528,056788,日月光群益98購01,,,,,0.00,0.00,0,0,0,0,0,0,0,0,0,0,0,0,0
20200528,056789,和碩群益98購01,0.55,0.55,0.55,0.55,0.00,0.00,18000,2,9900,0,0,0,0,0,0,0,18000,-18000,-18000
20200528,05678P,群創群益97售01,1.72,1.72,1.72,1.72,-0.02,-1.15,10000,1,17200,0,0,0,0,0,0,10000,0,10000,10000
20200528,056790,彩晶群益98購03,,,,,0.00,0.00,0,0,0,0,0,0,0,0,0,0,0,0,0
20200528,056791,嘉聯益群益98購01,1.70,1.92,1.70,1.78,0.00,0.00,380000,10,713790,0,0,0,0,0,0,0,380000,-380000,-380000
20200528,056792,訊芯群益98購01,,,,,0.00,0.00,0,0,0,0,0,0,0,0,0,0,0,0,0
20200528,056793,臺股指群益98購03,,,,,0.00,0.00,0,0,0,0,0,0,0,0,0,0,0,0,0
20200528,056794,上銀麥證98購01,2.17,2.29,1.96,1.96,-0.17,-7.98,90000,12,191180,60000,30000,30000,0,0,0,60000,30000,30000,30000
20200528,056795,鴻海麥證98購01,,,,,0.00,0.00,0,0,0,0,0,0,0,0,0,0,0,0,0
20200528,056796,國巨麥證98購02,1.72,1.74,1.63,1.63,0.00,0.00,53000,7,89190,32000,21000,11000,0,0,0,32000,21000,11000,11000
20200528,056797,台積電麥證98購01,,,,,0.00,0.00,0,0,0,0,0,0,0,0,0,0,0,0,0
20200528,056798,華新科麥證98購01,,,,,0.00,0.00,0,0,0,0,0,0,0,0,0,0,0,0,0
20200528,056799,群創麥證98購01,,,,,0.00,0.00,0,0,0,0,0,0,0,0,0,0,0,0,0
20200528,05679P,台表科群益96售05,,,,,0.00,0.00,0,0,0,0,0,0,0,0,0,0,0,0,0
20200528,056800,臺股指麥證98購01,,,,,0.00,0.00,0,0,0,0,0,0,0,0,0,0,0,0,0
20200528,056801,國巨台新98購01,,,,,0.00,0.00,0,0,0,0,0,0,0,0,0,0,0,0,0
20200528,056802,友達台新98購01,,,,,0.00,0.00,0,0,0,0,0,0,0,0,0,0,0,0,0
20200528,056803,群創台新99購02,,,,,0.00,0.00,0,0,0,0,0,0,0,0,0,0,0,0,0
20200528,056804,T50反1統一9A購03,,,,,0.00,0.00,0,0,0,0,0,0,0,0,0,0,0,0,0
20200528,056805,元石油統一9B購01,0.15,0.30,0.15,0.30,-0.01,-3.23,181000,27,29090,0,0,0,0,0,0,0,180000,-180000,-180000
20200528,056806,元油2X統一98購02,,,,,0.00,0.00,0,0,0,0,0,0,0,0,0,0,0,0,0
20200528,056807,元油2X統一9B購01,0.09,0.09,0.09,0.09,0.00,0.00,1000,1,90,0,0,0,0,0,0,0,0,0,0
20200528,056808,台積電統一98購06,,,,,0.00,0.00,0,0,0,0,0,0,0,0,0,0,0,0,0
20200528,056809,旺宏統一98購03,0.47,0.47,0.41,0.41,-0.05,-10.87,81000,3,37510,0,0,0,0,0,0,81000,0,81000,81000
20200528,05680P,聯發科元大96售12,,,,,0.00,0.00,0,0,0,0,0,0,0,0,0,0,0,0,0
20200528,056810,群創統一9A購01,,,,,0.00,0.00,0,0,0,0,0,0,0,0,0,0,0,0,0
20200528,056811,健策統一9B購01,0.67,0.77,0.52,0.52,-0.13,-20.0,325000,27,193860,0,0,0,0,0,0,272000,71000,201000,201000
20200528,056812,泰鼎統一98購01,,,,,0.00,0.00,0,0,0,0,0,0,0,0,0,0,0,0,0
20200528,056813,聯茂統一99購01,1.13,1.24,1.13,1.21,+0.02,1.68,1395000,36,1675930,0,0,0,0,0,0,659000,741000,-82000,-82000
20200528,056814,元油2X永豐98購04,,,,,0.00,0.00,0,0,0,0,0,0,0,0,0,0,0,0,0
20200528,056815,元油2X永豐98購05,,,,,0.00,0.00,0,0,0,0,0,0,0,0,0,0,0,0,0
20200528,056816,華通永豐98購02,,,,,0.00,0.00,0,0,0,0,0,0,0,0,0,0,0,0,0
20200528,056817,國巨永豐98購04,,,,,0.00,0.00,0,0,0,0,0,0,0,0,0,0,0,0,0
20200528,056818,正崴永豐98購01,1.21,1.21,1.18,1.18,-0.04,-3.28,57000,8,68000,0,0,0,0,0,0,57000,0,57000,57000
20200528,056819,奇力新永豐98購01,,,,,0.00,0.00,0,0,0,0,0,0,0,0,0,0,0,0,0
20200528,05681P,大立光元大96售05,,,,,0.00,0.00,0,0,0,0,0,0,0,0,0,0,0,0,0
20200528,056820,欣興永豐98購02,1.75,1.84,1.75,1.84,+0.01,0.55,61000,2,109450,0,0,0,0,0,0,31000,30000,1000,1000
20200528,056821,日電貿永豐98購01,0.63,0.63,0.56,0.56,-0.03,-5.08,151000,12,89050,0,0,0,0,0,0,73000,78000,-5000,-5000
20200528,056822,佐登永豐98購01,0.18,0.18,0.18,0.18,0.00,0.00,2000,1,360,0,0,0,0,0,0,2000,0,2000,2000
20200528,056823,智伸科永豐98購01,0.61,0.61,0.53,0.53,-0.08,-13.11,221000,18,125170,0,0,0,0,0,0,211000,10000,201000,201000
20200528,056824,元石油富邦9B購01,,,,,0.00,0.00,0,0,0,0,0,0,0,0,0,0,0,0,0
20200528,056825,深中小富邦9B購01,,,,,0.00,0.00,0,0,0,0,0,0,0,0,0,0,0,0,0
20200528,056826,A50正2富邦9B購02,,,,,0.00,0.00,0,0,0,0,0,0,0,0,0,0,0,0,0
20200528,056827,元油2X富邦02購01,0.23,0.24,0.22,0.22,-0.10,-31.25,26000,5,5860,0,0,0,0,0,0,0,0,0,0
20200528,056828,國巨富邦9A購03,0.30,0.30,0.30,0.30,0.00,0.00,10000,1,3000,0,0,0,0,0,0,0,0,0,0
20200528,056829,台積電富邦9A購01,0.29,0.30,0.26,0.27,-0.02,-6.9,2856000,82,793780,0,0,0,0,0,0,1321000,0,1321000,1321000
20200528,05682P,大立光元大98售03,,,,,0.00,0.00,0,0,0,0,0,0,0,0,0,0,0,0,0
20200528,056830,友達富邦99購01,,,,,0.00,0.00,0,0,0,0,0,0,0,0,0,0,0,0,0
20200528,056831,元油2X元富98購11,,,,,0.00,0.00,0,0,0,0,0,0,0,0,0,0,0,0,0
20200528,056832,元油2X元富98購12,,,,,0.00,0.00,0,0,0,0,0,0,0,0,0,0,0,0,0
20200528,056833,和大元富9B購01,,,,,0.00,0.00,0,0,0,0,0,0,0,0,0,0,0,0,0
20200528,056834,華新元富99購01,0.99,1.19,0.90,0.90,+0.05,5.88,219000,36,231460,0,0,0,0,0,0,45000,129000,-84000,-84000
20200528,056835,聯電元富99購01,1.11,1.18,1.11,1.15,+0.05,4.55,646000,13,735950,0,0,0,0,0,0,143000,503000,-360000,-360000
20200528,056836,國巨元富98購01,,,,,0.00,0.00,0,0,0,0,0,0,0,0,0,0,0,0,0
20200528,056837,國巨元富98購02,,,,,0.00,0.00,0,0,0,0,0,0,0,0,0,0,0,0,0
20200528,056838,旺宏元富98購01,0.78,0.78,0.77,0.77,-0.09,-10.47,112000,2,86660,0,0,0,0,0,0,112000,0,112000,112000
20200528,056839,台光電元富98購02,,,,,0.00,0.00,0,0,0,0,0,0,0,0,0,0,0,0,0
20200528,05683P,矽創元大96售01,,,,,0.00,0.00,0,0,0,0,0,0,0,0,0,0,0,0,0
20200528,056840,友達元富98購02,,,,,0.00,0.00,0,0,0,0,0,0,0,0,0,0,0,0,0
20200528,056841,友達元富98購03,,,,,0.00,0.00,0,0,0,0,0,0,0,0,0,0,0,0,0
20200528,056842,全新元富98購01,0.53,0.57,0.53,0.57,-0.03,-5.0,310000,10,171040,0,0,0,0,0,0,212000,98000,114000,114000
20200528,056843,冠德元富98購01,2.29,2.34,2.18,2.18,+0.17,8.46,12000,6,27240,0,0,0,0,0,0,7000,3000,4000,4000
20200528,056844,欣興元富98購03,2.94,3.32,2.91,3.32,+0.42,14.48,519000,27,1638670,0,0,0,0,0,0,96000,423000,-327000,-327000
20200528,056845,揚明光元富98購01,1.24,1.26,1.08,1.08,-0.18,-14.29,442000,15,529400,0,0,0,0,0,0,358000,84000,274000,274000
20200528,056846,晶相光元富98購01,1.25,1.27,1.23,1.23,-0.15,-10.87,328000,6,408330,0,0,0,0,0,0,304000,24000,280000,280000
20200528,056847,佐登元富98購01,1.22,1.27,1.21,1.21,-0.04,-3.2,30000,4,37000,0,0,0,0,0,0,10000,20000,-10000,-10000
20200528,056848,泰鼎元富98購01,,,,,0.00,0.00,0,0,0,0,0,0,0,0,0,0,0,0,0
20200528,056849,瀚宇博元富98購01,2.32,2.39,2.31,2.36,+0.03,1.29,668000,43,1567960,0,0,0,0,0,0,248000,405000,-157000,-157000
20200528,05684P,臺股指元大96售09,1.62,1.62,1.62,1.62,0.00,0.00,7000,1,11340,0,0,0,0,0,0,7000,0,7000,7000
20200528,056850,彩晶元富99購01,0.48,0.48,0.48,0.48,0.00,0.00,63000,1,30240,0,0,0,0,0,0,0,63000,-63000,-63000
20200528,056851,瑞儀元富98購01,2.36,2.45,2.31,2.45,+0.06,2.51,264000,16,628370,0,0,0,0,0,0,164000,100000,64000,64000
20200528,056852,矽格元富98購01,2.56,2.59,2.37,2.37,-0.19,-7.42,355000,9,897770,0,0,0,0,0,0,109000,246000,-137000,-137000
20200528,056853,元油2X中信9B購02,,,,,0.00,0.00,0,0,0,0,0,0,0,0,0,0,0,0,0
20200528,056854,友達中信9A購01,,,,,0.00,0.00,0,0,0,0,0,0,0,0,0,0,0,0,0
20200528,056855,祥碩中信98購02,0.95,1.16,0.86,1.07,+0.18,20.22,912000,33,968290,0,0,0,0,0,0,292000,560000,-268000,-268000
20200528,056856,華通群益9A購01,3.64,4.01,3.64,3.74,+0.29,8.41,97000,12,366530,0,0,0,0,0,0,42000,55000,-13000,-13000
20200528,056857,國巨群益99購02,,,,,0.00,0.00,0,0,0,0,0,0,0,0,0,0,0,0,0
20200528,056858,國巨群益99購03,,,,,0.00,0.00,0,0,0,0,0,0,0,0,0,0,0,0,0
20200528,056859,台積電群益98購02,,,,,0.00,0.00,0,0,0,0,0,0,0,0,0,0,0,0,0
20200528,05685P,臺股指元大96售10,,,,,0.00,0.00,0,0,0,0,0,0,0,0,0,0,0,0,0
20200528,056860,正崴群益98購01,2.13,2.13,1.97,1.97,-0.30,-13.22,252000,10,518620,0,0,0,0,0,0,155000,97000,58000,58000
20200528,056861,美律群益99購01,,,,,0.00,0.00,0,0,0,0,0,0,0,0,0,0,0,0,0
20200528,056862,聯發科群益98購03,,,,,0.00,0.00,0,0,0,0,0,0,0,0,0,0,0,0,0
20200528,056863,義隆群益98購01,4.55,4.76,4.46,4.47,+0.18,4.2,64000,24,292150,0,0,0,0,0,0,47000,48000,-1000,-1000
20200528,056864,新日興群益99購01,,,,,0.00,0.00,0,0,0,0,0,0,0,0,0,0,0,0,0
20200528,056865,樺漢群益98購01,,,,,0.00,0.00,0,0,0,0,0,0,0,0,0,0,0,0,0
20200528,056866,矽創群益98購03,,,,,0.00,0.00,0,0,0,0,0,0,0,0,0,0,0,0,0
20200528,056867,華通麥證98購01,,,,,0.00,0.00,0,0,0,0,0,0,0,0,0,0,0,0,0
20200528,056868,奇力新麥證98購01,,,,,0.00,0.00,0,0,0,0,0,0,0,0,0,0,0,0,0
20200528,056869,國巨日盛99購03,,,,,0.00,0.00,0,0,0,0,0,0,0,0,0,0,0,0,0
20200528,05686P,臺股指元大96售11,,,,,0.00,0.00,0,0,0,0,0,0,0,0,0,0,0,0,0
20200528,056870,全新日盛9A購01,0.39,0.39,0.39,0.39,0.00,0.00,30000,1,11700,0,0,0,0,0,0,30000,30000,0,0
20200528,056871,新日興日盛99購01,,,,,0.00,0.00,0,0,0,0,0,0,0,0,0,0,0,0,0
20200528,056872,旺宏凱基98購08,,,,,0.00,0.00,0,0,0,0,0,0,0,0,0,0,0,0,0
20200528,056873,友達凱基98購07,,,,,0.00,0.00,0,0,0,0,0,0,0,0,0,0,0,0,0
20200528,056874,友達凱基98購08,,,,,0.00,0.00,0,0,0,0,0,0,0,0,0,0,0,0,0
20200528,056875,亞光凱基98購03,,,,,0.00,0.00,0,0,0,0,0,0,0,0,0,0,0,0,0
20200528,056876,群創凱基98購11,,,,,0.00,0.00,0,0,0,0,0,0,0,0,0,0,0,0,0
20200528,056877,群創凱基99購04,,,,,0.00,0.00,0,0,0,0,0,0,0,0,0,0,0,0,0
20200528,056878,元油2X國票99購02,,,,,0.00,0.00,0,0,0,0,0,0,0,0,0,0,0,0,0
20200528,056879,旺宏國票99購02,1.26,1.26,1.26,1.26,-0.01,-0.79,24000,1,30240,0,0,0,0,0,0,24000,0,24000,24000
20200528,05687P,臺股指元大96售12,,,,,0.00,0.00,0,0,0,0,0,0,0,0,0,0,0,0,0
20200528,056880,緯穎國票98購02,,,,,0.00,0.00,0,0,0,0,0,0,0,0,0,0,0,0,0
20200528,056881,台灣50康和9A購01,,,,,0.00,0.00,0,0,0,0,0,0,0,0,0,0,0,0,0
20200528,056882,華邦電康和98購01,,,,,0.00,0.00,0,0,0,0,0,0,0,0,0,0,0,0,0
20200528,056883,美食康和98購01,,,,,0.00,0.00,0,0,0,0,0,0,0,0,0,0,0,0,0
20200528,056884,元油2X元大99購02,,,,,0.00,0.00,0,0,0,0,0,0,0,0,0,0,0,0,0
20200528,056885,元油2X元大99購03,,,,,0.00,0.00,0,0,0,0,0,0,0,0,0,0,0,0,0
20200528,056886,元油2X元大99購04,,,,,0.00,0.00,0,0,0,0,0,0,0,0,0,0,0,0,0
20200528,056887,元油2X元大99購05,,,,,0.00,0.00,0,0,0,0,0,0,0,0,0,0,0,0,0
20200528,056888,元油2X元大99購06,,,,,0.00,0.00,0,0,0,0,0,0,0,0,0,0,0,0,0
20200528,056889,元油2X元大99購07,,,,,0.00,0.00,0,0,0,0,0,0,0,0,0,0,0,0,0
20200528,05688P,臺股指元大96售13,,,,,0.00,0.00,0,0,0,0,0,0,0,0,0,0,0,0,0
20200528,056890,國巨元大98購11,1.75,1.75,1.73,1.73,-0.06,-3.35,60000,2,104800,0,0,0,0,0,0,50000,10000,40000,40000
20200528,056891,國巨元大99購03,,,,,0.00,0.00,0,0,0,0,0,0,0,0,0,0,0,0,0
20200528,056892,旺宏元大9A購02,0.93,0.93,0.79,0.79,-0.11,-12.22,25000,3,21700,0,0,0,0,0,0,0,25000,-25000,-25000
20200528,056893,智邦元大98購02,4.49,4.65,4.14,4.14,0.00,0.00,26000,5,116760,0,0,0,0,0,0,6000,26000,-20000,-20000
20200528,056894,佳世達元大99購01,0.57,0.57,0.57,0.57,0.00,0.00,5000,1,2850,0,0,0,0,0,0,5000,0,5000,5000
20200528,056895,技嘉元大98購01,3.92,3.98,3.81,3.81,-0.35,-8.41,3000,3,11710,0,0,0,0,0,0,3000,3000,0,0
20200528,056896,南亞科元大98購01,,,,,0.00,0.00,0,0,0,0,0,0,0,0,0,0,0,0,0
20200528,056897,南亞科元大98購02,0.99,0.99,0.97,0.97,+0.09,10.23,51000,2,50470,0,0,0,0,0,0,0,51000,-51000,-51000
20200528,056898,全新元大98購02,,,,,0.00,0.00,0,0,0,0,0,0,0,0,0,0,0,0,0
20200528,056899,可成元大98購01,1.09,1.09,1.06,1.06,-0.08,-7.02,136000,4,144760,0,0,0,0,0,0,68000,68000,0,0
20200528,05689P,滬深2X中信97售02,,,,,0.00,0.00,0,0,0,0,0,0,0,0,0,0,0,0,0
20200528,056900,可成元大98購02,,,,,0.00,0.00,0,0,0,0,0,0,0,0,0,0,0,0,0
20200528,056901,華新科元大98購03,,,,,0.00,0.00,0,0,0,0,0,0,0,0,0,0,0,0,0
20200528,056902,大立光元大98購12,,,,,0.00,0.00,0,0,0,0,0,0,0,0,0,0,0,0,0
20200528,056903,大立光元大99購04,1.41,1.41,1.41,1.41,-0.08,-5.37,1000,1,1410,0,0,0,0,0,0,1000,0,1000,1000
20200528,056904,大立光元大99購05,0.69,0.69,0.69,0.69,-0.04,-5.48,4000,1,2760,0,0,0,0,0,0,0,4000,-4000,-4000
20200528,056905,欣興元大98購03,2.52,2.70,2.52,2.55,+0.20,8.51,121000,15,310440,0,0,0,0,0,0,71000,71000,0,0
20200528,056906,玉晶光元大9B購01,0.88,0.88,0.88,0.88,+0.10,12.82,20000,1,17600,0,0,0,0,0,0,20000,0,20000,20000
20200528,056907,群創元大9C購04,,,,,0.00,0.00,0,0,0,0,0,0,0,0,0,0,0,0,0
20200528,056908,牧德元大99購03,0.28,0.30,0.28,0.30,0.00,0.00,15000,3,4300,0,0,0,0,0,0,10000,0,10000,10000
20200528,056909,嘉聯益元大99購03,1.68,1.88,1.68,1.74,+0.11,6.75,441000,16,794460,0,0,0,0,0,0,20000,421000,-401000,-401000
20200528,05690P,友達中信96售02,,,,,0.00,0.00,0,0,0,0,0,0,0,0,0,0,0,0,0
20200528,056910,超眾元大99購02,2.01,2.10,1.98,2.01,-0.08,-3.83,140000,15,285710,0,0,0,0,0,0,140000,90000,50000,50000
20200528,056911,緯穎元大99購01,2.54,2.58,2.49,2.49,-0.09,-3.49,218000,6,549800,0,0,0,0,0,0,213000,5000,208000,208000
20200528,056912,臺股指元大99購04,,,,,0.00,0.00,0,0,0,0,0,0,0,0,0,0,0,0,0
20200528,056913,臺股指元大99購05,,,,,0.00,0.00,0,0,0,0,0,0,0,0,0,0,0,0,0
20200528,056914,臺股指元大99購09,,,,,0.00,0.00,0,0,0,0,0,0,0,0,0,0,0,0,0
20200528,056915,上銀兆豐99購01,1.60,1.66,1.56,1.56,-0.08,-4.88,190000,33,307400,0,0,0,0,0,0,190000,0,190000,190000
20200528,056916,台達電兆豐98購02,,,,,0.00,0.00,0,0,0,0,0,0,0,0,0,0,0,0,0
20200528,056917,國巨兆豐98購03,,,,,0.00,0.00,0,0,0,0,0,0,0,0,0,0,0,0,0
20200528,056918,台積電兆豐98購01,,,,,0.00,0.00,0,0,0,0,0,0,0,0,0,0,0,0,0
20200528,056919,英業達兆豐98購01,1.60,1.65,1.60,1.65,+0.02,1.23,17000,3,27680,0,0,0,0,0,0,0,17000,-17000,-17000
20200528,05691P,聯發科中信98售01,0.20,0.20,0.20,0.20,0.00,0.00,50000,1,10000,0,0,0,0,0,0,50000,0,50000,50000
20200528,056920,友達兆豐98購02,0.09,0.09,0.09,0.09,0.00,0.00,30000,3,2700,0,0,0,0,0,0,0,30000,-30000,-30000
20200528,056921,京元電兆豐98購01,0.62,0.62,0.56,0.56,-0.06,-9.68,105000,6,61100,0,0,0,0,0,0,55000,50000,5000,5000
20200528,056922,全新兆豐99購01,0.57,0.57,0.57,0.57,0.00,0.00,145000,2,82650,0,0,0,0,0,0,145000,0,145000,145000
20200528,056923,奇力新兆豐99購02,,,,,0.00,0.00,0,0,0,0,0,0,0,0,0,0,0,0,0
20200528,056924,亞光兆豐98購01,,,,,0.00,0.00,0,0,0,0,0,0,0,0,0,0,0,0,0
20200528,056925,群創兆豐98購03,0.03,0.03,0.02,0.02,0.00,0.00,33000,2,890,0,0,0,0,0,0,0,10000,-10000,-10000
20200528,056926,日月光兆豐98購01,,,,,0.00,0.00,0,0,0,0,0,0,0,0,0,0,0,0,0
20200528,056927,T50反1台新02購01,,,,,0.00,0.00,0,0,0,0,0,0,0,0,0,0,0,0,0
20200528,056928,旺宏台新98購01,0.22,0.22,0.22,0.22,-0.03,-12.0,20000,1,4400,0,0,0,0,0,0,0,20000,-20000,-20000
20200528,056929,華新科台新98購01,0.64,0.64,0.57,0.57,-0.07,-10.94,22000,8,13060,0,0,0,0,0,0,20000,0,20000,20000
20200528,05692P,聯發科中信9A售02,0.44,0.50,0.44,0.47,+0.01,2.17,428000,13,200520,0,0,0,0,0,0,307000,121000,186000,186000
20200528,056930,晶豪科台新98購01,3.30,3.30,3.30,3.30,0.00,0.00,21000,2,69300,0,0,0,0,0,0,0,21000,-21000,-21000
20200528,056931,智原台新98購01,,,,,0.00,0.00,0,0,0,0,0,0,0,0,0,0,0,0,0
20200528,056932,T50反1元富98購01,,,,,0.00,0.00,0,0,0,0,0,0,0,0,0,0,0,0,0
20200528,056933,國巨元富98購03,,,,,0.00,0.00,0,0,0,0,0,0,0,0,0,0,0,0,0
20200528,056934,國巨元富98購04,,,,,0.00,0.00,0,0,0,0,0,0,0,0,0,0,0,0,0
20200528,056935,華新科元富98購02,,,,,0.00,0.00,0,0,0,0,0,0,0,0,0,0,0,0,0
20200528,056936,禾伸堂元富98購01,2.63,2.63,2.63,2.63,-0.09,-3.31,10000,2,26300,0,0,0,0,0,0,10000,0,10000,10000
20200528,056937,智原元富98購01,0.59,0.59,0.51,0.51,-0.05,-8.93,485000,30,267640,0,0,0,0,0,0,277000,208000,69000,69000
20200528,056938,泰碩元富98購01,,,,,0.00,0.00,0,0,0,0,0,0,0,0,0,0,0,0,0
20200528,056939,康控元富98購01,1.06,1.07,1.04,1.07,+0.04,3.88,257000,6,272800,0,0,0,0,0,0,218000,39000,179000,179000
20200528,05693P,滬深2X凱基98售02,1.39,1.39,1.39,1.39,-0.23,-14.2,10000,1,13900,0,0,0,0,0,0,10000,0,10000,10000
20200528,056940,嘉聯益元富98購01,1.56,1.71,1.51,1.51,+0.02,1.34,94000,13,152800,0,0,0,0,0,0,20000,74000,-54000,-54000
20200528,056941,台郡元富9B購01,1.64,1.64,1.64,1.64,+0.09,5.81,1000,1,1640,0,0,0,0,0,0,1000,0,1000,1000
20200528,056942,昇陽半元富98購01,,,,,0.00,0.00,0,0,0,0,0,0,0,0,0,0,0,0,0
20200528,056943,華通統一99購01,1.76,2.02,1.74,1.85,+0.19,11.45,414000,37,795830,0,0,0,0,0,0,78000,344000,-266000,-266000
20200528,056944,鴻海統一98購11,,,,,0.00,0.00,0,0,0,0,0,0,0,0,0,0,0,0,0
20200528,056945,鴻海統一98購12,0.70,0.70,0.65,0.65,-0.03,-4.41,161000,7,112200,0,0,0,0,0,0,136000,25000,111000,111000
20200528,056946,國巨統一98購05,0.97,0.98,0.97,0.97,+0.02,2.11,108000,4,105290,0,0,0,0,0,0,108000,0,108000,108000
20200528,056947,國巨統一9A購01,,,,,0.00,0.00,0,0,0,0,0,0,0,0,0,0,0,0,0
20200528,056948,旺宏統一9A購01,,,,,0.00,0.00,0,0,0,0,0,0,0,0,0,0,0,0,0
20200528,056949,義隆統一98購01,2.29,2.37,2.26,2.28,+0.14,6.54,307000,10,707260,0,0,0,0,0,0,216000,91000,125000,125000
20200528,05694P,台積電凱基96售09,,,,,0.00,0.00,0,0,0,0,0,0,0,0,0,0,0,0,0
20200528,056950,亞光統一99購01,0.11,0.11,0.11,0.11,-0.04,-26.67,3000,1,330,0,0,0,0,0,0,3000,0,3000,3000
20200528,056951,牧德統一99購01,0.47,0.47,0.44,0.44,-0.04,-8.33,43000,4,19350,0,0,0,0,0,0,23000,20000,3000,3000
20200528,056952,元油2X國泰99購01,,,,,0.00,0.00,0,0,0,0,0,0,0,0,0,0,0,0,0
20200528,056953,智邦富邦98購02,,,,,0.00,0.00,0,0,0,0,0,0,0,0,0,0,0,0,0
20200528,056954,聯詠富邦9A購01,0.57,0.59,0.54,0.59,+0.01,1.72,60000,4,33100,0,0,0,0,0,0,55000,5000,50000,50000
20200528,056955,台灣50永豐98購01,0.05,0.05,0.04,0.04,0.00,0.00,465000,7,19100,0,0,0,0,0,0,0,0,0,0
20200528,056956,元油2X永豐99購01,,,,,0.00,0.00,0,0,0,0,0,0,0,0,0,0,0,0,0
20200528,056957,元油2X永豐9A購02,,,,,0.00,0.00,0,0,0,0,0,0,0,0,0,0,0,0,0
20200528,056958,喬山永豐98購01,1.07,1.12,1.07,1.09,-0.04,-3.54,112000,6,120260,0,0,0,0,0,0,106000,6000,100000,100000
20200528,056959,鴻海永豐98購03,,,,,0.00,0.00,0,0,0,0,0,0,0,0,0,0,0,0,0
20200528,05695P,台積電凱基96售10,,,,,0.00,0.00,0,0,0,0,0,0,0,0,0,0,0,0,0
20200528,056960,光罩永豐98購01,0.47,0.47,0.47,0.47,0.00,0.00,3000,1,1410,0,0,0,0,0,0,3000,0,3000,3000
20200528,056961,凱美永豐98購01,0.65,0.74,0.65,0.74,+0.06,8.82,539000,13,381420,0,0,0,0,0,0,74000,465000,-391000,-391000
20200528,056962,技嘉永豐98購01,0.92,0.92,0.76,0.77,-0.17,-18.09,42000,5,35400,0,0,0,0,0,0,42000,0,42000,42000
20200528,056963,建準永豐98購01,2.44,2.94,2.44,2.50,+0.15,6.38,135000,31,363060,0,0,0,0,0,0,39000,92000,-53000,-53000
20200528,056964,聯發科永豐98購03,,,,,0.00,0.00,0,0,0,0,0,0,0,0,0,0,0,0,0
20200528,056965,全新永豐98購01,,,,,0.00,0.00,0,0,0,0,0,0,0,0,0,0,0,0,0
20200528,056966,嘉晶永豐98購01,,,,,0.00,0.00,0,0,0,0,0,0,0,0,0,0,0,0,0
20200528,056967,奇鋐永豐98購01,1.57,1.59,1.54,1.54,0.00,0.00,61000,11,95700,0,0,0,0,0,0,10000,51000,-41000,-41000
20200528,056968,揚明光永豐98購02,,,,,0.00,0.00,0,0,0,0,0,0,0,0,0,0,0,0,0
20200528,056969,智易永豐98購01,2.40,2.56,2.38,2.56,+0.23,9.87,86000,14,211400,0,0,0,0,0,0,30000,56000,-26000,-26000
20200528,05696P,南亞科凱基96售01,,,,,0.00,0.00,0,0,0,0,0,0,0,0,0,0,0,0,0
20200528,056970,TPK永豐98購01,0.49,0.52,0.48,0.52,+0.03,6.12,61000,12,30840,0,0,0,0,0,0,61000,32000,29000,29000
20200528,056971,麗豐永豐98購01,0.60,0.60,0.57,0.57,0.00,0.00,150000,6,88500,0,0,0,0,0,0,0,150000,-150000,-150000
20200528,056972,祥碩永豐98購02,1.38,1.83,1.38,1.74,+0.28,19.18,52000,5,76180,0,0,0,0,0,0,46000,6000,40000,40000
20200528,056973,T50反1永昌9C購01,,,,,0.00,0.00,0,0,0,0,0,0,0,0,0,0,0,0,0
20200528,056974,臻鼎永昌9C購01,,,,,0.00,0.00,0,0,0,0,0,0,0,0,0,0,0,0,0
20200528,056975,元油2X群益98購03,,,,,0.00,0.00,0,0,0,0,0,0,0,0,0,0,0,0,0
20200528,056976,喬山群益98購01,0.39,0.39,0.39,0.39,-0.05,-11.36,10000,1,3900,0,0,0,0,0,0,0,10000,-10000,-10000
20200528,056977,國巨群益9A購01,0.60,0.60,0.60,0.60,0.00,0.00,1000,1,600,0,0,0,0,0,0,0,0,0,0
20200528,056978,技嘉群益99購01,2.84,2.84,2.82,2.82,-0.27,-8.74,29000,2,82120,0,0,0,0,0,0,0,29000,-29000,-29000
20200528,056979,微星群益98購01,2.37,2.37,2.37,2.37,0.00,0.00,100000,1,237000,0,0,0,0,0,0,0,100000,-100000,-100000
20200528,05697P,友達凱基96售01,,,,,0.00,0.00,0,0,0,0,0,0,0,0,0,0,0,0,0
20200528,056980,建準群益98購02,2.13,2.35,1.88,1.88,-0.16,-7.84,57000,25,119770,0,0,0,0,0,0,17000,39000,-22000,-22000
20200528,056981,全新群益99購03,0.65,0.65,0.65,0.65,-0.06,-8.45,265000,1,172250,0,0,0,0,0,0,265000,0,265000,265000
20200528,056982,華新科群益98購05,,,,,0.00,0.00,0,0,0,0,0,0,0,0,0,0,0,0,0
20200528,056983,大立光群益99購02,0.97,0.97,0.97,0.97,0.00,0.00,1000,1,970,0,0,0,0,0,0,0,1000,-1000,-1000
20200528,056984,嘉晶群益98購01,5.35,5.35,5.35,5.35,-0.10,-1.83,45000,1,240750,0,0,0,0,0,0,45000,0,45000,45000
20200528,056985,智原群益98購03,,,,,0.00,0.00,0,0,0,0,0,0,0,0,0,0,0,0,0
20200528,056986,超眾群益98購03,1.84,1.84,1.69,1.69,-0.17,-9.14,47000,2,85580,0,0,0,0,0,0,6000,41000,-35000,-35000
20200528,056987,南茂群益98購01,0.72,0.76,0.65,0.65,-0.19,-22.62,113000,3,74900,0,0,0,0,0,0,103000,10000,93000,93000
20200528,056988,聚陽兆豐98購01,0.54,0.55,0.48,0.48,-0.08,-14.29,150000,12,78320,0,0,0,0,0,0,60000,70000,-10000,-10000
20200528,056989,鴻海兆豐98購02,0.55,0.55,0.53,0.53,-0.02,-3.64,360000,6,191000,0,0,0,0,0,0,355000,5000,350000,350000
20200528,05698P,群創凱基96售01,,,,,0.00,0.00,0,0,0,0,0,0,0,0,0,0,0,0,0
20200528,056990,聯發科兆豐98購01,,,,,0.00,0.00,0,0,0,0,0,0,0,0,0,0,0,0,0
20200528,056991,牧德兆豐98購01,0.47,0.47,0.42,0.42,-0.04,-8.7,395000,9,182850,0,0,0,0,0,0,15000,380000,-365000,-365000
20200528,056992,祥碩兆豐98購01,,,,,0.00,0.00,0,0,0,0,0,0,0,0,0,0,0,0,0
20200528,056993,GIS兆豐99購01,1.21,1.21,0.99,0.99,-0.08,-7.48,100000,10,109800,0,0,0,0,0,0,40000,60000,-20000,-20000
20200528,056994,緯穎兆豐98購02,1.74,1.74,1.72,1.72,-0.07,-3.91,18000,3,31300,0,0,0,0,0,0,8000,10000,-2000,-2000
20200528,056995,華新科日盛99購01,0.75,0.77,0.69,0.69,-0.06,-8.0,245000,28,178060,0,0,0,0,0,0,105000,140000,-35000,-35000
20200528,056996,矽力日盛99購01,3.31,3.76,3.31,3.53,+0.29,8.95,185000,32,649510,0,0,0,0,0,0,88000,55000,33000,33000
20200528,056997,台灣50康和9A購02,,,,,0.00,0.00,0,0,0,0,0,0,0,0,0,0,0,0,0
20200528,056998,麗豐康和98購01,0.70,0.70,0.70,0.70,0.00,0.00,90000,1,63000,0,0,0,0,0,0,0,90000,-90000,-90000
20200528,056999,元油2X國票98購02,,,,,0.00,0.00,0,0,0,0,0,0,0,0,0,0,0,0,0
20200528,05699P,茂林凱基96售05,,,,,0.00,0.00,0,0,0,0,0,0,0,0,0,0,0,0,0
20200528,057000,亞德客國票99購01,4.64,4.77,4.01,4.01,-0.56,-12.25,98000,13,449820,0,0,0,0,0,0,78000,25000,53000,53000
20200528,057001,華邦電國票99購02,0.56,0.58,0.54,0.54,+0.08,17.39,310000,22,174140,0,0,0,0,0,0,140000,170000,-30000,-30000
20200528,057002,友達國票98購01,0.08,0.08,0.08,0.08,0.00,0.00,30000,1,2400,0,0,0,0,0,0,0,30000,-30000,-30000
20200528,057003,立積國票98購01,1.52,1.52,1.39,1.39,-0.26,-15.76,160000,4,236370,0,0,0,0,0,0,160000,0,160000,160000
20200528,057004,滬深反中信9A購01,1.10,1.16,1.10,1.16,+0.01,0.87,13000,2,14540,0,0,0,0,0,0,9000,4000,5000,5000
20200528,057005,元油2X中信9C購01,,,,,0.00,0.00,0,0,0,0,0,0,0,0,0,0,0,0,0
20200528,057006,國巨中信98購03,0.21,0.21,0.21,0.21,0.00,0.00,10000,1,2100,0,0,0,0,0,0,0,10000,-10000,-10000
20200528,057007,奇力新中信98購04,,,,,0.00,0.00,0,0,0,0,0,0,0,0,0,0,0,0,0
20200528,057008,華新科中信99購02,,,,,0.00,0.00,0,0,0,0,0,0,0,0,0,0,0,0,0
20200528,057009,信邦中信99購01,0.80,0.82,0.80,0.82,+0.02,2.5,102000,3,81640,0,0,0,0,0,0,2000,100000,-98000,-98000
20200528,05700P,臻鼎凱基96售02,,,,,0.00,0.00,0,0,0,0,0,0,0,0,0,0,0,0,0
20200528,057010,景碩中信98購01,0.21,0.21,0.21,0.21,+0.02,10.53,25000,1,5250,0,0,0,0,0,0,0,25000,-25000,-25000
20200528,057011,日月光中信99購01,,,,,0.00,0.00,0,0,0,0,0,0,0,0,0,0,0,0,0
20200528,057012,康控中信98購01,0.17,0.17,0.16,0.16,-0.04,-20.0,440000,5,72400,0,0,0,0,0,0,0,440000,-440000,-440000
20200528,057013,聯發科麥證98購01,5.20,5.20,5.20,5.20,-0.30,-5.45,10000,2,52000,10000,0,10000,0,0,0,10000,0,10000,10000
20200528,057014,元油2X凱基9A購05,,,,,0.00,0.00,0,0,0,0,0,0,0,0,0,0,0,0,0
20200528,057015,元油2X凱基9B購04,,,,,0.00,0.00,0,0,0,0,0,0,0,0,0,0,0,0,0
20200528,057016,中石化凱基9B購01,0.73,0.73,0.70,0.70,-0.03,-4.11,32000,3,22460,0,0,0,0,0,0,0,32000,-32000,-32000
20200528,057017,和大凱基98購01,0.42,0.42,0.41,0.41,-0.04,-8.89,30000,2,12500,0,0,0,0,0,0,30000,0,30000,30000
20200528,057018,亞德客凱基98購01,,,,,0.00,0.00,0,0,0,0,0,0,0,0,0,0,0,0,0
20200528,057019,台積電凱基98購14,1.11,1.11,1.11,1.11,-0.12,-9.76,10000,1,11100,0,0,0,0,0,0,0,10000,-10000,-10000
20200528,05701P,彩晶凱基96售01,,,,,0.00,0.00,0,0,0,0,0,0,0,0,0,0,0,0,0
20200528,057020,台積電凱基99購02,,,,,0.00,0.00,0,0,0,0,0,0,0,0,0,0,0,0,0
20200528,057021,台積電凱基9A購02,,,,,0.00,0.00,0,0,0,0,0,0,0,0,0,0,0,0,0
20200528,057022,智邦凱基98購04,4.89,5.00,4.89,5.00,0.00,0.00,20000,3,98900,0,0,0,0,0,0,0,20000,-20000,-20000
20200528,057023,美律凱基99購02,,,,,0.00,0.00,0,0,0,0,0,0,0,0,0,0,0,0,0
20200528,057024,義隆凱基99購01,2.48,2.59,2.44,2.48,+0.16,6.9,97000,26,240290,0,0,0,0,0,0,77000,39000,38000,38000
20200528,057025,華新科凱基98購04,,,,,0.00,0.00,0,0,0,0,0,0,0,0,0,0,0,0,0
20200528,057026,長榮航凱基98購01,,,,,0.00,0.00,0,0,0,0,0,0,0,0,0,0,0,0,0
20200528,057027,祥碩凱基98購01,1.14,1.60,1.14,1.52,+0.42,38.18,13000,10,17340,0,0,0,0,0,0,12000,1000,11000,11000
20200528,057028,台郡凱基99購02,2.45,2.49,2.45,2.49,+0.01,0.4,30000,2,73900,0,0,0,0,0,0,0,30000,-30000,-30000
20200528,057029,緯穎凱基98購04,,,,,0.00,0.00,0,0,0,0,0,0,0,0,0,0,0,0,0
20200528,05702P,矽創凱基96售02,,,,,0.00,0.00,0,0,0,0,0,0,0,0,0,0,0,0,0
20200528,057030,滬深反元大9B購01,0.25,0.25,0.25,0.25,-0.02,-7.41,30000,1,7500,0,0,0,0,0,0,30000,0,30000,30000
20200528,057031,滬深反元大9B購02,,,,,0.00,0.00,0,0,0,0,0,0,0,0,0,0,0,0,0
20200528,057032,A50反1元大9B購01,0.80,0.81,0.74,0.81,+0.02,2.53,173000,12,137080,0,0,0,0,0,0,33000,140000,-107000,-107000
20200528,057033,A50反1元大9B購02,0.18,0.18,0.18,0.18,-0.02,-10.0,20000,1,3600,0,0,0,0,0,0,20000,0,20000,20000
20200528,057034,道瓊反元大9B購01,,,,,0.00,0.00,0,0,0,0,0,0,0,0,0,0,0,0,0
20200528,057035,元油2X元大9B購03,0.17,0.17,0.17,0.17,0.00,0.00,10000,1,1700,0,0,0,0,0,0,0,0,0,0
20200528,057036,元油2X元大9B購04,,,,,0.00,0.00,0,0,0,0,0,0,0,0,0,0,0,0,0
20200528,057037,元油2X元大9B購05,,,,,0.00,0.00,0,0,0,0,0,0,0,0,0,0,0,0,0
20200528,057038,元油2X元大9B購06,0.05,0.06,0.05,0.06,0.00,0.00,61000,4,3160,0,0,0,0,0,0,0,61000,-61000,-61000
20200528,057039,元油2X元大9B購07,0.07,0.08,0.07,0.08,-0.01,-11.11,285000,9,19960,0,0,0,0,0,0,0,1000,-1000,-1000
20200528,05703P,矽力群益96售03,,,,,0.00,0.00,0,0,0,0,0,0,0,0,0,0,0,0,0
20200528,057040,國巨元大98購12,2.35,2.35,2.35,2.35,-0.12,-4.86,1000,1,2350,0,0,0,0,0,0,1000,1000,0,0
20200528,057041,國巨元大99購04,,,,,0.00,0.00,0,0,0,0,0,0,0,0,0,0,0,0,0
20200528,057042,台積電元大98購10,,,,,0.00,0.00,0,0,0,0,0,0,0,0,0,0,0,0,0
20200528,057043,台積電元大99購02,,,,,0.00,0.00,0,0,0,0,0,0,0,0,0,0,0,0,0
20200528,057044,旺宏元大98購08,1.26,1.27,1.18,1.18,-0.13,-9.92,61000,7,76240,0,0,0,0,0,0,51000,10000,41000,41000
20200528,057045,美律元大99購04,1.24,1.28,1.22,1.24,+0.11,9.73,120000,5,149640,0,0,0,0,0,0,70000,50000,20000,20000
20200528,057046,奇力新元大99購03,,,,,0.00,0.00,0,0,0,0,0,0,0,0,0,0,0,0,0
20200528,057047,華新科元大99購07,,,,,0.00,0.00,0,0,0,0,0,0,0,0,0,0,0,0,0
20200528,057048,新日興元大98購01,1.07,1.18,1.05,1.10,+0.06,5.77,107000,10,119380,0,0,0,0,0,0,69000,39000,30000,30000
20200528,057049,新日興元大98購02,,,,,0.00,0.00,0,0,0,0,0,0,0,0,0,0,0,0,0
20200528,05704P,矽力群益96售04,,,,,0.00,0.00,0,0,0,0,0,0,0,0,0,0,0,0,0
20200528,057050,群創元大99購03,,,,,0.00,0.00,0,0,0,0,0,0,0,0,0,0,0,0,0
20200528,057051,群創元大9B購03,,,,,0.00,0.00,0,0,0,0,0,0,0,0,0,0,0,0,0
20200528,057052,華擎元大98購01,,,,,0.00,0.00,0,0,0,0,0,0,0,0,0,0,0,0,0
20200528,057053,立積元大98購02,1.38,1.38,1.36,1.36,-0.06,-4.23,189000,4,259960,0,0,0,0,0,0,121000,68000,53000,53000
20200528,057054,立積元大98購03,1.21,1.21,1.12,1.12,-0.13,-10.4,294000,10,351920,0,0,0,0,0,0,196000,98000,98000,98000
20200528,057055,立積元大99購01,1.42,1.44,1.36,1.36,-0.05,-3.55,285000,16,400820,0,0,0,0,0,0,214000,96000,118000,118000
20200528,057056,立積元大99購02,1.93,1.93,1.89,1.89,-0.08,-4.06,88000,4,168920,0,0,0,0,0,0,88000,0,88000,88000
20200528,057057,立積元大9A購01,2.32,2.32,2.23,2.23,-0.14,-5.91,89000,3,205850,0,0,0,0,0,0,39000,50000,-11000,-11000
20200528,057058,祥碩元大98購04,,,,,0.00,0.00,0,0,0,0,0,0,0,0,0,0,0,0,0
20200528,057059,易華電元大99購01,1.06,1.06,1.06,1.06,-0.02,-1.85,17000,2,18020,0,0,0,0,0,0,17000,0,17000,17000
20200528,05705P,上証2X永豐96售03,,,,,0.00,0.00,0,0,0,0,0,0,0,0,0,0,0,0,0
20200528,057060,緯穎元大98購05,2.16,2.18,2.16,2.18,+0.05,2.35,14000,2,30320,0,0,0,0,0,0,14000,0,14000,14000
20200528,057061,華擎國泰9A購01,,,,,0.00,0.00,0,0,0,0,0,0,0,0,0,0,0,0,0
20200528,057062,立積國泰99購01,0.71,0.72,0.70,0.70,-0.01,-1.41,387000,12,272500,0,0,0,0,0,0,373000,15000,358000,358000
20200528,057063,立積國泰9A購01,0.65,0.65,0.60,0.60,-0.05,-7.69,47000,5,29180,0,0,0,0,0,0,37000,10000,27000,27000
20200528,057064,華新科富邦9B購01,0.27,0.27,0.27,0.27,0.00,0.00,10000,1,2700,0,0,0,0,0,0,0,10000,-10000,-10000
20200528,057065,牧德富邦99購01,,,,,0.00,0.00,0,0,0,0,0,0,0,0,0,0,0,0,0
20200528,057066,緯穎富邦99購01,0.57,0.57,0.57,0.57,0.00,0.00,150000,2,85500,0,0,0,0,0,0,150000,0,150000,150000
20200528,057067,元油2X永豐9B購01,,,,,0.00,0.00,0,0,0,0,0,0,0,0,0,0,0,0,0
20200528,057068,國巨永豐98購06,,,,,0.00,0.00,0,0,0,0,0,0,0,0,0,0,0,0,0
20200528,057069,台積電永豐98購02,,,,,0.00,0.00,0,0,0,0,0,0,0,0,0,0,0,0,0
20200528,05706P,TPK永豐96售02,2.18,2.23,2.18,2.23,0.00,0.00,25000,2,55100,0,0,0,0,0,0,0,25000,-25000,-25000
20200528,057070,美律永豐98購02,,,,,0.00,0.00,0,0,0,0,0,0,0,0,0,0,0,0,0
20200528,057071,華擎永豐98購02,1.00,1.00,0.95,0.95,-0.02,-2.06,60000,4,58100,0,0,0,0,0,0,37000,23000,14000,14000
20200528,057072,日月光永豐98購01,0.82,0.82,0.81,0.82,+0.02,2.5,82000,4,67140,0,0,0,0,0,0,45000,37000,8000,8000
20200528,057073,康控永豐98購01,0.42,0.42,0.42,0.42,0.00,0.00,47000,1,19740,0,0,0,0,0,0,0,47000,-47000,-47000
20200528,057074,立積永豐98購01,0.23,0.23,0.23,0.23,-0.03,-11.54,24000,1,5520,0,0,0,0,0,0,0,24000,-24000,-24000
20200528,057075,嘉聯益永豐98購01,0.80,0.83,0.80,0.82,+0.05,6.49,136000,3,112110,0,0,0,0,0,0,68000,68000,0,0
20200528,057076,緯穎永豐98購01,3.11,3.11,3.11,3.11,-0.03,-0.96,8000,1,24880,0,0,0,0,0,0,0,8000,-8000,-8000
20200528,057077,國巨統一98購06,0.65,0.65,0.60,0.60,-0.01,-1.64,60000,5,37500,0,0,0,0,0,0,0,60000,-60000,-60000
20200528,057078,國巨統一9A購02,0.44,0.44,0.44,0.44,-0.01,-2.22,2000,1,880,0,0,0,0,0,0,0,2000,-2000,-2000
20200528,057079,台積電統一9A購02,,,,,0.00,0.00,0,0,0,0,0,0,0,0,0,0,0,0,0
20200528,05707P,中磊永豐96售01,,,,,0.00,0.00,0,0,0,0,0,0,0,0,0,0,0,0,0
20200528,057080,華新科統一99購02,0.20,0.20,0.20,0.20,-0.04,-16.67,10000,1,2000,0,0,0,0,0,0,10000,0,10000,10000
20200528,057081,大立光統一98購07,,,,,0.00,0.00,0,0,0,0,0,0,0,0,0,0,0,0,0
20200528,057082,玉晶光統一9A購04,0.76,0.82,0.74,0.74,+0.02,2.78,194000,7,148120,0,0,0,0,0,0,160000,34000,126000,126000
20200528,057083,立積統一98購01,,,,,0.00,0.00,0,0,0,0,0,0,0,0,0,0,0,0,0
20200528,057084,立積統一9B購01,0.73,0.73,0.73,0.73,-0.06,-7.59,20000,2,14600,0,0,0,0,0,0,20000,0,20000,20000
20200528,057085,立積統一9B購02,0.39,0.41,0.36,0.37,-0.03,-7.5,933000,20,359350,0,0,0,0,0,0,348000,585000,-237000,-237000
20200528,057086,立積統一9C購01,,,,,0.00,0.00,0,0,0,0,0,0,0,0,0,0,0,0,0
20200528,057087,台郡統一99購01,1.32,1.32,1.32,1.32,-0.04,-2.94,318000,5,419760,0,0,0,0,0,0,207000,111000,96000,96000
20200528,057088,上銀元富98購01,1.04,1.12,0.87,0.87,-0.19,-17.92,414000,43,428650,0,0,0,0,0,0,398000,46000,352000,352000
20200528,057089,奇力新元富98購01,,,,,0.00,0.00,0,0,0,0,0,0,0,0,0,0,0,0,0
20200528,05708P,奇力新國票97售04,0.55,0.68,0.55,0.68,+0.07,11.48,237000,7,144710,0,0,0,0,0,0,30000,207000,-177000,-177000
20200528,057090,奇力新元富98購02,,,,,0.00,0.00,0,0,0,0,0,0,0,0,0,0,0,0,0
20200528,057091,華新科元富9A購01,0.43,0.43,0.43,0.43,0.00,0.00,1000,1,430,0,0,0,0,0,0,1000,0,1000,1000
20200528,057092,健策元富98購01,2.54,2.64,2.18,2.18,-0.16,-6.84,371000,16,945660,0,0,0,0,0,0,369000,2000,367000,367000
20200528,057093,臻鼎元富98購02,1.32,1.32,1.20,1.20,-0.30,-20.0,19000,9,24540,0,0,0,0,0,0,19000,3000,16000,16000
20200528,057094,祥碩元富98購01,3.73,4.01,3.66,3.66,+0.42,12.96,39000,12,148620,0,0,0,0,0,0,0,39000,-39000,-39000
20200528,057095,祥碩元富98購02,,,,,0.00,0.00,0,0,0,0,0,0,0,0,0,0,0,0,0
20200528,057096,緯穎元富98購01,2.89,3.00,2.82,2.85,-0.16,-5.32,163000,16,471390,0,0,0,0,0,0,116000,47000,69000,69000
20200528,057097,致新元富98購01,,,,,0.00,0.00,0,0,0,0,0,0,0,0,0,0,0,0,0
20200528,057098,新光金台新98購01,,,,,0.00,0.00,0,0,0,0,0,0,0,0,0,0,0,0,0
20200528,057099,元油2X中信9B購03,,,,,0.00,0.00,0,0,0,0,0,0,0,0,0,0,0,0,0
20200528,05709P,大立光國票97售01,,,,,0.00,0.00,0,0,0,0,0,0,0,0,0,0,0,0,0
20200528,057100,國巨中信9A購02,0.44,0.44,0.44,0.44,-0.01,-2.22,10000,1,4400,0,0,0,0,0,0,10000,0,10000,10000
20200528,057101,新光金中信9A購01,,,,,0.00,0.00,0,0,0,0,0,0,0,0,0,0,0,0,0
20200528,057102,亞光中信9A購01,0.76,0.77,0.76,0.77,-0.01,-1.28,147000,6,112630,0,0,0,0,0,0,36000,111000,-75000,-75000
20200528,057103,禾伸堂中信9A購01,1.32,1.33,1.27,1.27,-0.08,-5.93,100000,10,130200,0,0,0,0,0,0,20000,80000,-60000,-60000
20200528,057104,康友中信99購01,0.07,0.07,0.07,0.07,+0.01,16.67,30000,3,2100,0,0,0,0,0,0,0,20000,-20000,-20000
20200528,057105,致茂群益9A購01,0.78,0.80,0.78,0.78,+0.02,2.63,173000,4,137810,0,0,0,0,0,0,30000,143000,-113000,-113000
20200528,057106,美律群益98購03,0.74,0.76,0.74,0.76,+0.07,10.14,118000,3,89480,0,0,0,0,0,0,98000,10000,88000,88000
20200528,057107,華新科群益98購06,0.54,0.54,0.54,0.54,+0.03,5.88,1000,1,540,0,0,0,0,0,0,0,1000,-1000,-1000
20200528,057108,潤泰全群益98購01,,,,,0.00,0.00,0,0,0,0,0,0,0,0,0,0,0,0,0
20200528,057109,信邦群益98購01,1.60,1.67,1.60,1.67,+0.07,4.38,177000,6,292620,0,0,0,0,0,0,87000,90000,-3000,-3000
20200528,05710P,禾伸堂國票97售02,0.15,0.16,0.15,0.16,+0.01,6.67,200000,4,30500,0,0,0,0,0,0,0,200000,-200000,-200000
20200528,057110,立積群益98購01,0.53,0.54,0.53,0.53,-0.03,-5.36,140000,4,74910,0,0,0,0,0,0,140000,0,140000,140000
20200528,057111,立積群益98購02,,,,,0.00,0.00,0,0,0,0,0,0,0,0,0,0,0,0,0
20200528,057112,立積群益99購01,0.71,0.71,0.70,0.70,0.00,0.00,179000,4,126490,0,0,0,0,0,0,83000,79000,4000,4000
20200528,057113,祥碩群益98購01,,,,,0.00,0.00,0,0,0,0,0,0,0,0,0,0,0,0,0
20200528,057114,台虹群益98購01,0.72,0.73,0.70,0.70,-0.05,-6.67,183000,9,130240,0,0,0,0,0,0,183000,12000,171000,171000
20200528,057115,元油2X日盛9A購01,,,,,0.00,0.00,0,0,0,0,0,0,0,0,0,0,0,0,0
20200528,057116,鴻海日盛9A購01,,,,,0.00,0.00,0,0,0,0,0,0,0,0,0,0,0,0,0
20200528,057117,開發金日盛9B購01,0.58,0.58,0.51,0.51,-0.03,-5.56,19000,3,10810,0,0,0,0,0,0,3000,0,3000,3000
20200528,057118,欣興日盛9A購01,1.47,1.50,1.34,1.34,-0.02,-1.47,163000,6,233920,0,0,0,0,0,0,163000,100000,63000,63000
20200528,057119,微星康和98購01,1.43,1.43,1.43,1.43,+0.04,2.88,217000,11,310310,0,0,0,0,0,0,0,217000,-217000,-217000
20200528,05711P,茂林國票97售03,0.26,0.27,0.24,0.25,-0.11,-30.56,170000,13,42600,0,0,0,0,0,0,100000,60000,40000,40000
20200528,057120,茂林康和98購01,0.76,0.76,0.75,0.75,-0.24,-24.24,195000,23,147180,0,0,0,0,0,0,101000,94000,7000,7000
20200528,057121,立積康和98購01,0.35,0.35,0.35,0.35,0.00,0.00,86000,1,30100,0,0,0,0,0,0,86000,0,86000,86000
20200528,057122,元油2X凱基9B購05,,,,,0.00,0.00,0,0,0,0,0,0,0,0,0,0,0,0,0
20200528,057123,上銀凱基98購05,,,,,0.00,0.00,0,0,0,0,0,0,0,0,0,0,0,0,0
20200528,057124,為升凱基98購02,,,,,0.00,0.00,0,0,0,0,0,0,0,0,0,0,0,0,0
20200528,057125,國巨凱基98購12,,,,,0.00,0.00,0,0,0,0,0,0,0,0,0,0,0,0,0
20200528,057126,台積電凱基99購03,,,,,0.00,0.00,0,0,0,0,0,0,0,0,0,0,0,0,0
20200528,057127,旺宏凱基98購09,0.89,0.89,0.89,0.89,-0.06,-6.32,5000,1,4450,0,0,0,0,0,0,5000,0,5000,5000
20200528,057128,台光電凱基98購03,,,,,0.00,0.00,0,0,0,0,0,0,0,0,0,0,0,0,0
20200528,057129,聯發科凱基99購03,,,,,0.00,0.00,0,0,0,0,0,0,0,0,0,0,0,0,0
20200528,05712P,友達統一97售03,,,,,0.00,0.00,0,0,0,0,0,0,0,0,0,0,0,0,0
20200528,057130,全新凱基98購03,,,,,0.00,0.00,0,0,0,0,0,0,0,0,0,0,0,0,0
20200528,057131,奇力新凱基98購05,,,,,0.00,0.00,0,0,0,0,0,0,0,0,0,0,0,0,0
20200528,057132,華新科凱基98購05,0.66,0.66,0.66,0.66,-0.05,-7.04,35000,1,23100,0,0,0,0,0,0,35000,0,35000,35000
20200528,057133,京鼎凱基98購02,,,,,0.00,0.00,0,0,0,0,0,0,0,0,0,0,0,0,0
20200528,057134,茂林凱基98購02,0.93,0.93,0.89,0.90,-0.42,-31.82,166000,24,151040,0,0,0,0,0,0,116000,50000,66000,66000
20200528,057135,立積凱基98購01,0.71,0.72,0.71,0.72,-0.04,-5.26,7000,2,4980,0,0,0,0,0,0,7000,0,7000,7000
20200528,057136,立積凱基98購02,0.88,0.88,0.80,0.80,-0.04,-4.76,8000,3,6800,0,0,0,0,0,0,0,8000,-8000,-8000
20200528,057137,鈺齊凱基98購01,0.50,0.50,0.50,0.50,0.00,0.00,499000,3,249500,0,0,0,0,0,0,0,499000,-499000,-499000
20200528,057138,亞德客兆豐98購01,1.61,1.65,1.50,1.50,-0.01,-0.66,167000,29,267000,0,0,0,0,0,0,134000,25000,109000,109000
20200528,057139,華新科兆豐98購02,0.12,0.12,0.12,0.12,0.00,0.00,10000,1,1200,0,0,0,0,0,0,0,10000,-10000,-10000
20200528,05713P,大立光統一96售05,,,,,0.00,0.00,0,0,0,0,0,0,0,0,0,0,0,0,0
20200528,057140,宏達電兆豐98購01,,,,,0.00,0.00,0,0,0,0,0,0,0,0,0,0,0,0,0
20200528,057141,嘉聯益兆豐99購01,0.64,0.70,0.64,0.70,+0.07,11.11,386000,9,264700,0,0,0,0,0,0,0,386000,-386000,-386000
20200528,057142,力成兆豐98購01,,,,,0.00,0.00,0,0,0,0,0,0,0,0,0,0,0,0,0
20200528,057143,台郡兆豐98購01,,,,,0.00,0.00,0,0,0,0,0,0,0,0,0,0,0,0,0
20200528,057144,南電兆豐98購01,,,,,0.00,0.00,0,0,0,0,0,0,0,0,0,0,0,0,0
20200528,057145,上銀國票98購03,,,,,0.00,0.00,0,0,0,0,0,0,0,0,0,0,0,0,0
20200528,057146,技嘉國票98購01,,,,,0.00,0.00,0,0,0,0,0,0,0,0,0,0,0,0,0
20200528,057147,新日興國票99購01,2.50,2.54,2.50,2.54,+0.34,15.45,24000,2,60480,0,0,0,0,0,0,0,24000,-24000,-24000
20200528,057148,玉晶光國票99購04,2.07,2.22,1.98,2.03,-0.01,-0.49,92000,23,197320,0,0,0,0,0,0,7000,85000,-78000,-78000
20200528,057149,京鼎國票99購02,1.33,1.33,1.27,1.31,0.00,0.00,117000,8,153000,0,0,0,0,0,0,106000,98000,8000,8000
20200528,05714P,群創統一97售03,,,,,0.00,0.00,0,0,0,0,0,0,0,0,0,0,0,0,0
20200528,057150,貿聯國票99購02,1.59,1.62,1.54,1.54,-0.06,-3.75,186000,8,292930,0,0,0,0,0,0,43000,143000,-100000,-100000
20200528,057151,易華電國票99購01,0.73,0.73,0.63,0.63,-0.13,-17.11,304000,7,207140,0,0,0,0,0,0,142000,162000,-20000,-20000
20200528,057152,緯穎國票99購03,,,,,0.00,0.00,0,0,0,0,0,0,0,0,0,0,0,0,0
20200528,057153,祥碩國泰99購01,3.58,3.58,3.58,3.58,-0.15,-4.02,20000,1,71600,0,0,0,0,0,0,20000,0,20000,20000
20200528,057154,易華電國泰99購01,0.33,0.33,0.32,0.32,-0.05,-13.51,9000,2,2950,0,0,0,0,0,0,0,9000,-9000,-9000
20200528,057155,元油2X富邦9B購02,,,,,0.00,0.00,0,0,0,0,0,0,0,0,0,0,0,0,0
20200528,057156,元油2X富邦9C購01,,,,,0.00,0.00,0,0,0,0,0,0,0,0,0,0,0,0,0
20200528,057157,群創富邦98購02,,,,,0.00,0.00,0,0,0,0,0,0,0,0,0,0,0,0,0
20200528,057158,義隆永豐99購01,0.92,1.00,0.89,0.94,+0.11,13.25,449000,61,429840,0,0,0,0,0,0,139000,280000,-141000,-141000
20200528,057159,晶技永豐98購01,,,,,0.00,0.00,0,0,0,0,0,0,0,0,0,0,0,0,0
20200528,05715P,創意元富96售05,,,,,0.00,0.00,0,0,0,0,0,0,0,0,0,0,0,0,0
20200528,057160,佐登永豐98購02,,,,,0.00,0.00,0,0,0,0,0,0,0,0,0,0,0,0,0
20200528,057161,亞德客元大98購02,2.43,2.58,2.04,2.13,-0.16,-6.99,379000,33,879490,0,0,0,0,0,0,210000,169000,41000,41000
20200528,057162,上銀元大98購03,4.51,4.60,4.40,4.40,-0.01,-0.23,26000,4,117810,0,0,0,0,0,0,17000,9000,8000,8000
20200528,057163,上銀元大98購04,2.57,2.68,2.19,2.20,-0.29,-11.65,161000,14,372410,0,0,0,0,0,0,48000,113000,-65000,-65000
20200528,057164,國巨元大98購14,2.00,2.00,2.00,2.00,0.00,0.00,1000,1,2000,0,0,0,0,0,0,0,1000,-1000,-1000
20200528,057165,國巨元大99購05,,,,,0.00,0.00,0,0,0,0,0,0,0,0,0,0,0,0,0
20200528,057166,國巨元大99購06,,,,,0.00,0.00,0,0,0,0,0,0,0,0,0,0,0,0,0
20200528,057167,台積電元大99購03,,,,,0.00,0.00,0,0,0,0,0,0,0,0,0,0,0,0,0
20200528,057168,旺宏元大99購03,0.75,0.75,0.67,0.67,-0.07,-9.46,19000,5,13230,0,0,0,0,0,0,13000,6000,7000,7000
20200528,057169,微星元大98購01,2.55,2.55,2.48,2.48,-0.04,-1.59,28000,2,70140,0,0,0,0,0,0,0,28000,-28000,-28000
20200528,05716P,T50反1元大98售03,,,,,0.00,0.00,0,0,0,0,0,0,0,0,0,0,0,0,0
20200528,057170,瑞昱元大98購01,2.65,2.69,2.61,2.61,+0.10,3.98,178000,10,474070,0,0,0,0,0,0,11000,175000,-164000,-164000
20200528,057171,台光電元大9B購01,3.25,3.25,3.06,3.06,-0.18,-5.56,13000,3,40350,0,0,0,0,0,0,13000,0,13000,13000
20200528,057172,南亞科元大98購03,0.88,0.88,0.75,0.75,-0.05,-6.25,118000,2,95000,0,0,0,0,0,0,68000,50000,18000,18000
20200528,057173,南亞科元大98購04,0.95,0.97,0.81,0.81,-0.02,-2.41,263000,12,248940,0,0,0,0,0,0,11000,252000,-241000,-241000
20200528,057174,南亞科元大98購05,0.98,1.00,0.92,0.92,+0.07,8.24,259000,8,251780,0,0,0,0,0,0,2000,257000,-255000,-255000
20200528,057175,美律元大98購03,,,,,0.00,0.00,0,0,0,0,0,0,0,0,0,0,0,0,0
20200528,057176,全新元大99購02,0.97,0.98,0.97,0.98,-0.02,-2.0,62000,3,60370,0,0,0,0,0,0,62000,0,62000,62000
20200528,057177,奇力新元大99購04,,,,,0.00,0.00,0,0,0,0,0,0,0,0,0,0,0,0,0
20200528,057178,可成元大98購03,1.20,1.20,1.20,1.20,-0.01,-0.83,80000,1,96000,0,0,0,0,0,0,0,80000,-80000,-80000
20200528,057179,可成元大98購04,1.54,1.58,1.48,1.48,-0.03,-1.99,107000,5,163840,0,0,0,0,0,0,6000,101000,-95000,-95000
20200528,05717P,鴻海元大97售07,3.60,3.75,3.60,3.69,-0.10,-2.64,50000,5,185400,0,0,0,0,0,0,50000,50000,0,0
20200528,057180,華新科元大99購08,,,,,0.00,0.00,0,0,0,0,0,0,0,0,0,0,0,0,0
20200528,057181,亞光元大98購02,1.19,1.22,1.19,1.22,+0.05,4.27,254000,6,307700,0,0,0,0,0,0,99000,155000,-56000,-56000
20200528,057182,禾伸堂元大99購02,,,,,0.00,0.00,0,0,0,0,0,0,0,0,0,0,0,0,0
20200528,057183,玉晶光元大99購07,,,,,0.00,0.00,0,0,0,0,0,0,0,0,0,0,0,0,0
20200528,057184,群創元大98購05,,,,,0.00,0.00,0,0,0,0,0,0,0,0,0,0,0,0,0
20200528,057185,群創元大98購06,,,,,0.00,0.00,0,0,0,0,0,0,0,0,0,0,0,0,0
20200528,057186,群創元大99購04,,,,,0.00,0.00,0,0,0,0,0,0,0,0,0,0,0,0,0
20200528,057187,群創元大9B購04,,,,,0.00,0.00,0,0,0,0,0,0,0,0,0,0,0,0,0
20200528,057188,佐登元大98購01,,,,,0.00,0.00,0,0,0,0,0,0,0,0,0,0,0,0,0
20200528,057189,康控元大98購02,,,,,0.00,0.00,0,0,0,0,0,0,0,0,0,0,0,0,0
20200528,05718P,國巨元大96售09,,,,,0.00,0.00,0,0,0,0,0,0,0,0,0,0,0,0,0
20200528,057190,立積元大9A購02,0.95,0.95,0.92,0.92,-0.01,-1.08,70000,5,64900,0,0,0,0,0,0,45000,40000,5000,5000
20200528,057191,祥碩元大98購05,5.45,5.70,5.30,5.65,0.00,0.00,43000,4,235000,0,0,0,0,0,0,0,43000,-43000,-43000
20200528,057192,力成元大98購01,,,,,0.00,0.00,0,0,0,0,0,0,0,0,0,0,0,0,0
20200528,057193,力成元大98購02,0.16,0.17,0.15,0.15,-0.03,-16.67,365000,5,59700,0,0,0,0,0,0,365000,0,365000,365000
20200528,057194,南電元大98購01,6.15,6.15,6.15,6.15,+0.10,1.65,2000,1,12300,0,0,0,0,0,0,2000,0,2000,2000
20200528,057195,南茂元大98購01,1.53,1.53,1.31,1.31,-0.20,-13.25,440000,21,628830,10000,0,10000,0,0,0,232000,250000,-18000,-8000
20200528,057196,茂林台新98購01,1.02,1.07,1.01,1.01,-0.06,-5.61,266000,26,276210,0,0,0,0,0,0,256000,0,256000,256000
20200528,057197,立積台新98購01,0.48,0.49,0.45,0.45,-0.04,-8.16,470000,17,223360,0,0,0,0,0,0,311000,159000,152000,152000
20200528,057198,智伸科統一9B購01,0.35,0.36,0.35,0.36,-0.06,-14.29,39000,2,13930,0,0,0,0,0,0,39000,0,39000,39000
20200528,057199,台達電元富02購01,1.12,1.12,1.09,1.09,-0.04,-3.54,217000,4,238700,0,0,0,0,0,0,129000,88000,41000,41000
20200528,05719P,可成元大96售03,0.90,0.90,0.90,0.90,-0.06,-6.25,81000,2,72900,0,0,0,0,0,0,1000,80000,-79000,-79000
20200528,057200,技嘉元富98購01,,,,,0.00,0.00,0,0,0,0,0,0,0,0,0,0,0,0,0
20200528,057201,華擎元富98購01,5.00,5.00,4.66,4.70,-0.03,-0.63,15000,3,71800,0,0,0,0,0,0,5000,15000,-10000,-10000
20200528,057202,TPK元富98購02,0.93,1.00,0.84,0.84,-0.09,-9.68,334000,33,318350,0,0,0,0,0,0,179000,155000,24000,24000
20200528,057203,麗豐元富98購02,0.75,0.77,0.74,0.74,-0.03,-3.9,307000,7,231090,0,0,0,0,0,0,196000,111000,85000,85000
20200528,057204,利勤元富98購01,,,,,0.00,0.00,0,0,0,0,0,0,0,0,0,0,0,0,0
20200528,057205,元翎元富98購01,,,,,0.00,0.00,0,0,0,0,0,0,0,0,0,0,0,0,0
20200528,057206,立積元富98購01,1.17,1.19,1.16,1.17,-0.01,-0.85,320000,22,374520,0,0,0,0,0,0,268000,52000,216000,216000
20200528,057207,立積元富98購02,1.04,1.06,1.02,1.02,+0.02,2.0,188000,22,194880,0,0,0,0,0,0,186000,2000,184000,184000
20200528,057208,上海銀元富98購01,,,,,0.00,0.00,0,0,0,0,0,0,0,0,0,0,0,0,0
20200528,057209,元油2X第一98購01,,,,,0.00,0.00,0,0,0,0,0,0,0,0,0,0,0,0,0
20200528,05720P,可成中信98售01,,,,,0.00,0.00,0,0,0,0,0,0,0,0,0,0,0,0,0
20200528,057210,T50反1群益98購01,,,,,0.00,0.00,0,0,0,0,0,0,0,0,0,0,0,0,0
20200528,057211,鴻海群益98購05,1.55,1.55,1.50,1.50,-0.02,-1.32,6000,2,9200,0,0,0,0,0,0,2000,6000,-4000,-4000
20200528,057212,台積電群益98購03,,,,,0.00,0.00,0,0,0,0,0,0,0,0,0,0,0,0,0
20200528,057213,華邦電群益98購01,,,,,0.00,0.00,0,0,0,0,0,0,0,0,0,0,0,0,0
20200528,057214,瑞昱群益98購01,2.50,2.52,2.48,2.48,+0.05,2.06,277000,8,692620,0,0,0,0,0,0,0,276000,-276000,-276000
20200528,057215,友達群益98購03,,,,,0.00,0.00,0,0,0,0,0,0,0,0,0,0,0,0,0
20200528,057216,聯發科群益99購01,4.05,4.08,3.92,3.92,-0.12,-2.97,159000,12,637400,0,0,0,0,0,0,129000,30000,99000,99000
20200528,057217,奇力新群益99購01,,,,,0.00,0.00,0,0,0,0,0,0,0,0,0,0,0,0,0
20200528,057218,可成群益99購03,,,,,0.00,0.00,0,0,0,0,0,0,0,0,0,0,0,0,0
20200528,057219,群創群益98購10,,,,,0.00,0.00,0,0,0,0,0,0,0,0,0,0,0,0,0
20200528,05721P,全新群益98售02,,,,,0.00,0.00,0,0,0,0,0,0,0,0,0,0,0,0,0
20200528,057220,鈺齊群益98購01,0.14,0.14,0.14,0.14,+0.02,16.67,10000,1,1400,0,0,0,0,0,0,10000,0,10000,10000
20200528,057221,華通國票98購03,3.67,4.09,3.67,3.69,+0.30,8.85,113000,13,438640,0,0,0,0,0,0,20000,95000,-75000,-75000
20200528,057222,鴻海國票99購04,1.53,1.53,1.53,1.53,+0.03,2.0,67000,1,102510,0,0,0,0,0,0,67000,0,67000,67000
20200528,057223,富邦金日盛99購01,,,,,0.00,0.00,0,0,0,0,0,0,0,0,0,0,0,0,0
20200528,057224,和碩日盛9A購01,,,,,0.00,0.00,0,0,0,0,0,0,0,0,0,0,0,0,0
20200528,057225,華新凱基98購01,1.10,1.24,1.05,1.05,+0.24,29.63,450000,26,517030,0,0,0,0,0,0,405000,25000,380000,380000
20200528,057226,上銀凱基98購06,4.10,4.23,4.06,4.23,-0.01,-0.24,51000,12,209150,0,0,0,0,0,0,51000,0,51000,51000
20200528,057227,台積電凱基98購15,,,,,0.00,0.00,0,0,0,0,0,0,0,0,0,0,0,0,0
20200528,057228,友達凱基9B購01,,,,,0.00,0.00,0,0,0,0,0,0,0,0,0,0,0,0,0
20200528,057229,友達凱基9B購02,,,,,0.00,0.00,0,0,0,0,0,0,0,0,0,0,0,0,0
20200528,05722P,玉晶光國票97售03,0.90,0.96,0.84,0.95,-0.07,-6.86,298000,26,269550,0,0,0,0,0,0,109000,251000,-142000,-142000
20200528,057230,建準凱基98購02,4.25,4.69,3.99,3.99,+0.05,1.27,26000,13,115140,0,0,0,0,0,0,4000,22000,-18000,-18000
20200528,057231,美律凱基98購05,0.51,0.51,0.50,0.50,+0.02,4.17,65000,5,32600,0,0,0,0,0,0,15000,50000,-35000,-35000
20200528,057232,京元電凱基98購02,0.93,0.93,0.93,0.93,0.00,0.00,46000,1,42780,0,0,0,0,0,0,46000,0,46000,46000
20200528,057233,聯發科凱基98購14,,,,,0.00,0.00,0,0,0,0,0,0,0,0,0,0,0,0,0
20200528,057234,宏達電凱基98購05,0.96,0.97,0.75,0.75,-0.19,-20.21,472000,6,455500,0,0,0,0,0,0,468000,12000,456000,456000
20200528,057235,亞光凱基98購04,,,,,0.00,0.00,0,0,0,0,0,0,0,0,0,0,0,0,0
20200528,057236,聯詠凱基98購03,0.86,0.86,0.84,0.84,-0.10,-10.64,98000,2,83300,0,0,0,0,0,0,49000,49000,0,0
20200528,057237,群創凱基9B購02,,,,,0.00,0.00,0,0,0,0,0,0,0,0,0,0,0,0,0
20200528,057238,群創凱基9B購03,,,,,0.00,0.00,0,0,0,0,0,0,0,0,0,0,0,0,0
20200528,057239,貿聯凱基98購05,2.56,2.66,2.53,2.66,+0.13,5.14,86000,9,220960,0,0,0,0,0,0,50000,36000,14000,14000
20200528,05723P,華通永豐96售03,0.21,0.21,0.21,0.21,-0.13,-38.24,15000,2,3150,0,0,0,0,0,0,0,15000,-15000,-15000
20200528,057240,茂林凱基9A購01,0.67,0.68,0.65,0.66,-0.02,-2.94,276000,25,183480,0,0,0,0,0,0,85000,156000,-71000,-71000
20200528,057241,超眾凱基99購02,4.20,4.20,4.20,4.20,+0.06,1.45,30000,1,126000,0,0,0,0,0,0,0,30000,-30000,-30000
20200528,057242,台郡凱基98購05,1.31,1.31,1.31,1.31,-0.05,-3.68,35000,2,45850,0,0,0,0,0,0,30000,5000,25000,25000
20200528,057243,樺漢凱基99購01,,,,,0.00,0.00,0,0,0,0,0,0,0,0,0,0,0,0,0
20200528,057244,鈺齊凱基99購01,,,,,0.00,0.00,0,0,0,0,0,0,0,0,0,0,0,0,0
20200528,057245,福懋科台新98購01,,,,,0.00,0.00,0,0,0,0,0,0,0,0,0,0,0,0,0
20200528,057246,元油2X統一99購01,,,,,0.00,0.00,0,0,0,0,0,0,0,0,0,0,0,0,0
20200528,057247,元油2X統一9A購01,,,,,0.00,0.00,0,0,0,0,0,0,0,0,0,0,0,0,0
20200528,057248,台積電統一98購08,,,,,0.00,0.00,0,0,0,0,0,0,0,0,0,0,0,0,0
20200528,057249,華邦電統一9A購01,0.86,0.91,0.75,0.75,-0.01,-1.32,336000,37,288610,0,0,0,0,0,0,246000,88000,158000,158000
20200528,05724P,致茂永豐96售01,0.41,0.45,0.41,0.45,0.00,0.00,85000,2,35850,0,0,0,0,0,0,0,85000,-85000,-85000
20200528,057250,大立光統一98購08,,,,,0.00,0.00,0,0,0,0,0,0,0,0,0,0,0,0,0
20200528,057251,泰鼎統一98購02,,,,,0.00,0.00,0,0,0,0,0,0,0,0,0,0,0,0,0
20200528,057252,牧德元富98購01,0.45,0.45,0.45,0.45,-0.09,-16.67,250000,1,112500,0,0,0,0,0,0,250000,0,250000,250000
20200528,057253,高股息中信99購02,,,,,0.00,0.00,0,0,0,0,0,0,0,0,0,0,0,0,0
20200528,057254,友達麥證98購01,,,,,0.00,0.00,0,0,0,0,0,0,0,0,0,0,0,0,0
20200528,057255,聯發科麥證98購02,,,,,0.00,0.00,0,0,0,0,0,0,0,0,0,0,0,0,0
20200528,057256,元油2X兆豐98購01,,,,,0.00,0.00,0,0,0,0,0,0,0,0,0,0,0,0,0
20200528,057257,台泥兆豐99購01,1.51,1.52,1.50,1.50,-0.05,-3.23,114000,4,172220,0,0,0,0,0,0,110000,4000,106000,106000
20200528,057258,中環兆豐98購01,0.36,0.36,0.36,0.36,-0.02,-5.26,61000,1,21960,0,0,0,0,0,0,61000,0,61000,61000
20200528,057259,台積電兆豐98購03,,,,,0.00,0.00,0,0,0,0,0,0,0,0,0,0,0,0,0
20200528,05725P,嘉聯益永豐96售02,,,,,0.00,0.00,0,0,0,0,0,0,0,0,0,0,0,0,0
20200528,057260,微星兆豐98購01,1.56,1.64,1.50,1.64,+0.09,5.81,109000,9,169760,0,0,0,0,0,0,41000,68000,-27000,-27000
20200528,057261,瑞昱兆豐98購01,0.89,0.90,0.89,0.90,+0.08,9.76,60000,6,53600,0,0,0,0,0,0,0,60000,-60000,-60000
20200528,057262,友達兆豐98購03,,,,,0.00,0.00,0,0,0,0,0,0,0,0,0,0,0,0,0
20200528,057263,可成兆豐99購01,,,,,0.00,0.00,0,0,0,0,0,0,0,0,0,0,0,0,0
20200528,057264,新光金兆豐98購01,0.05,0.05,0.05,0.05,0.00,0.00,10000,1,500,0,0,0,0,0,0,0,10000,-10000,-10000
20200528,057265,聯詠兆豐98購01,,,,,0.00,0.00,0,0,0,0,0,0,0,0,0,0,0,0,0
20200528,057266,TPK兆豐98購02,0.72,0.79,0.66,0.66,-0.08,-10.81,2259000,59,1660560,0,0,0,0,0,0,549000,1640000,-1091000,-1091000
20200528,057267,康控兆豐99購01,,,,,0.00,0.00,0,0,0,0,0,0,0,0,0,0,0,0,0
20200528,057268,臻鼎兆豐99購01,0.81,0.81,0.81,0.81,-0.04,-4.71,40000,2,32400,0,0,0,0,0,0,30000,10000,20000,20000
20200528,057269,鈺齊兆豐98購01,0.40,0.45,0.34,0.34,+0.03,9.68,252000,9,104100,0,0,0,0,0,0,0,252000,-252000,-252000
20200528,05726P,易華電永豐96售02,,,,,0.00,0.00,0,0,0,0,0,0,0,0,0,0,0,0,0
20200528,057270,遠東新元大98購01,0.96,0.96,0.81,0.81,-0.13,-13.83,20000,2,17700,0,0,0,0,0,0,10000,20000,-10000,-10000
20200528,057271,國巨元大98購17,,,,,0.00,0.00,0,0,0,0,0,0,0,0,0,0,0,0,0
20200528,057272,台積電元大98購14,1.09,1.09,1.09,1.09,0.00,0.00,2000,1,2180,0,0,0,0,0,0,2000,0,2000,2000
20200528,057273,智邦元大98購05,8.55,8.80,7.70,7.70,+0.40,5.48,9000,5,73850,0,0,0,0,0,0,9000,9000,0,0
20200528,057274,友達元大98購03,,,,,0.00,0.00,0,0,0,0,0,0,0,0,0,0,0,0,0
20200528,057275,友達元大9A購04,,,,,0.00,0.00,0,0,0,0,0,0,0,0,0,0,0,0,0
20200528,057276,全新元大99購03,,,,,0.00,0.00,0,0,0,0,0,0,0,0,0,0,0,0,0
20200528,057277,可成元大98購05,1.50,1.50,1.50,1.50,+0.03,2.04,68000,1,102000,0,0,0,0,0,0,0,68000,-68000,-68000
20200528,057278,可成元大98購06,1.12,1.12,1.07,1.08,-0.03,-2.7,140000,6,155220,0,0,0,0,0,0,76000,64000,12000,12000
20200528,057279,國揚元大98購01,3.81,4.01,3.68,3.81,-0.13,-3.3,211000,25,808500,0,0,0,0,0,0,145000,66000,79000,79000
20200528,05727P,新光金日盛96售02,,,,,0.00,0.00,0,0,0,0,0,0,0,0,0,0,0,0,0
20200528,057280,大立光元大98購15,1.08,1.09,1.08,1.09,-0.07,-6.03,4000,2,4340,0,0,0,0,0,0,2000,2000,0,0
20200528,057281,大立光元大98購16,1.32,1.32,1.32,1.32,0.00,0.00,68000,1,89760,0,0,0,0,0,0,0,68000,-68000,-68000
20200528,057282,大立光元大99購06,,,,,0.00,0.00,0,0,0,0,0,0,0,0,0,0,0,0,0
20200528,057283,欣興元大98購07,2.18,2.36,2.17,2.23,+0.10,4.69,251000,11,567510,0,0,0,0,0,0,72000,181000,-109000,-109000
20200528,057284,新日興元大98購03,1.86,2.05,1.79,1.79,+0.08,4.68,139000,5,262610,0,0,0,0,0,0,88000,51000,37000,37000
20200528,057285,群創元大98購07,,,,,0.00,0.00,0,0,0,0,0,0,0,0,0,0,0,0,0
20200528,057286,群創元大9B購05,,,,,0.00,0.00,0,0,0,0,0,0,0,0,0,0,0,0,0
20200528,057287,彩晶元大9C購03,1.01,1.01,0.99,0.99,0.00,0.00,103000,5,103240,0,0,0,0,0,0,100000,3000,97000,97000
20200528,057288,聯茂元大98購03,2.70,2.89,2.70,2.89,+0.16,5.86,118000,9,328630,0,0,0,0,0,0,33000,108000,-75000,-75000
20200528,057289,力成元大98購03,0.53,0.56,0.49,0.49,-0.03,-5.77,371000,8,202270,0,0,0,0,0,0,0,371000,-371000,-371000
20200528,05728P,滬深2X凱基98售03,,,,,0.00,0.00,0,0,0,0,0,0,0,0,0,0,0,0,0
20200528,057290,元油2X國泰99購02,,,,,0.00,0.00,0,0,0,0,0,0,0,0,0,0,0,0,0
20200528,057291,國巨國泰9A購01,,,,,0.00,0.00,0,0,0,0,0,0,0,0,0,0,0,0,0
20200528,057292,國巨國泰9B購01,,,,,0.00,0.00,0,0,0,0,0,0,0,0,0,0,0,0,0
20200528,057293,力成國泰99購01,,,,,0.00,0.00,0,0,0,0,0,0,0,0,0,0,0,0,0
20200528,057294,台灣50永豐99購01,,,,,0.00,0.00,0,0,0,0,0,0,0,0,0,0,0,0,0
20200528,057295,可成永豐98購02,,,,,0.00,0.00,0,0,0,0,0,0,0,0,0,0,0,0,0
20200528,057296,智原永豐98購01,1.35,1.35,1.28,1.29,-0.03,-2.27,101000,8,131510,0,0,0,0,0,0,101000,0,101000,101000
20200528,057297,新日興永豐98購01,,,,,0.00,0.00,0,0,0,0,0,0,0,0,0,0,0,0,0
20200528,057298,旭富永豐98購01,0.74,0.77,0.70,0.70,-0.05,-6.67,551000,25,406920,0,0,0,0,0,0,37000,514000,-477000,-477000
20200528,057299,立積永豐98購02,0.20,0.20,0.18,0.18,0.00,0.00,8000,3,1530,0,0,0,0,0,0,6000,2000,4000,4000
20200528,05729P,臺股指凱基97售02,2.60,2.92,2.58,2.88,+0.15,5.49,226000,19,626890,0,0,0,0,0,0,71000,155000,-84000,-84000
20200528,057300,訊連永豐98購01,0.36,0.36,0.36,0.36,-0.04,-10.0,68000,1,24480,0,0,0,0,0,0,0,68000,-68000,-68000
20200528,057301,嘉聯益永豐98購02,,,,,0.00,0.00,0,0,0,0,0,0,0,0,0,0,0,0,0
20200528,057302,福懋科中信98購01,,,,,0.00,0.00,0,0,0,0,0,0,0,0,0,0,0,0,0
20200528,057303,喬山兆豐99購01,0.92,0.92,0.75,0.75,0.00,0.00,126000,14,101840,0,0,0,0,0,0,0,126000,-126000,-126000
20200528,057304,為升兆豐99購02,0.06,0.06,0.06,0.06,-0.01,-14.29,39000,2,2340,0,0,0,0,0,0,0,10000,-10000,-10000
20200528,057305,南亞科兆豐98購02,0.04,0.04,0.04,0.04,-0.01,-20.0,10000,1,400,0,0,0,0,0,0,0,10000,-10000,-10000
20200528,057306,玉晶光兆豐99購01,0.99,0.99,0.98,0.99,0.00,0.00,20000,3,19750,0,0,0,0,0,0,0,20000,-20000,-20000
20200528,057307,瀚宇博兆豐99購01,0.86,0.89,0.86,0.87,0.00,0.00,1432000,39,1247800,0,0,0,0,0,0,966000,464000,502000,502000
20200528,057308,同欣電兆豐99購01,0.47,0.47,0.44,0.44,-0.01,-2.22,23000,3,10780,0,0,0,0,0,0,23000,0,23000,23000
20200528,057309,南茂兆豐99購01,0.84,0.84,0.83,0.83,0.00,0.00,180000,2,150400,0,0,0,0,0,0,180000,0,180000,180000
20200528,05730P,臺股指凱基97售03,2.44,2.60,2.40,2.60,-0.01,-0.38,340000,15,835400,0,0,0,0,0,0,340000,0,340000,340000
20200528,057310,聯發科日盛99購01,,,,,0.00,0.00,0,0,0,0,0,0,0,0,0,0,0,0,0
20200528,057311,玉晶光日盛9A購01,,,,,0.00,0.00,0,0,0,0,0,0,0,0,0,0,0,0,0
20200528,057312,美律麥證98購01,0.34,0.34,0.33,0.33,+0.01,3.12,42000,2,13880,0,42000,-42000,0,0,0,0,42000,-42000,-42000
20200528,057313,聯發科麥證99購01,,,,,0.00,0.00,0,0,0,0,0,0,0,0,0,0,0,0,0
20200528,057314,全新麥證98購01,,,,,0.00,0.00,0,0,0,0,0,0,0,0,0,0,0,0,0
20200528,057315,台灣50康和9A購03,,,,,0.00,0.00,0,0,0,0,0,0,0,0,0,0,0,0,0
20200528,057316,國巨凱基99購04,0.51,0.51,0.51,0.51,0.00,0.00,10000,1,5100,0,0,0,0,0,0,0,10000,-10000,-10000
20200528,057317,技嘉凱基98購02,1.47,1.47,1.29,1.29,-0.28,-17.83,21000,2,30690,0,0,0,0,0,0,21000,0,21000,21000
20200528,057318,台光電凱基9A購01,2.36,2.36,2.36,2.36,-0.30,-11.28,1000,1,2360,0,0,0,0,0,0,1000,0,1000,1000
20200528,057319,奇力新凱基99購02,,,,,0.00,0.00,0,0,0,0,0,0,0,0,0,0,0,0,0
20200528,05731P,創意統一96售03,0.85,0.89,0.85,0.89,-0.06,-6.32,106000,2,94140,0,0,0,0,0,0,0,106000,-106000,-106000
20200528,057320,玉晶光凱基98購01,1.31,1.37,1.31,1.33,+0.04,3.1,89000,3,118490,0,0,0,0,0,0,0,89000,-89000,-89000
20200528,057321,台泥群益98購01,3.54,3.56,3.45,3.45,-0.14,-3.9,146000,6,510250,0,0,0,0,0,0,146000,83000,63000,63000
20200528,057322,旺宏群益98購04,0.61,0.61,0.56,0.56,-0.10,-15.15,40000,2,24300,0,0,0,0,0,0,40000,0,40000,40000
20200528,057323,智邦群益98購01,9.80,9.80,9.75,9.75,+2.00,25.81,11000,2,107750,0,0,0,0,0,0,11000,0,11000,11000
20200528,057324,億光群益98購01,,,,,0.00,0.00,0,0,0,0,0,0,0,0,0,0,0,0,0
20200528,057325,可成群益9A購01,1.62,1.62,1.53,1.53,-0.06,-3.77,177000,2,274140,0,0,0,0,0,0,140000,37000,103000,103000
20200528,057326,景碩群益99購02,0.72,0.72,0.72,0.72,0.00,0.00,60000,1,43200,0,0,0,0,0,0,60000,0,60000,60000
20200528,057327,玉晶光群益9A購04,2.33,2.47,2.33,2.47,0.00,0.00,232000,5,552970,0,0,0,0,0,0,3000,232000,-229000,-229000
20200528,057328,京鼎群益99購02,1.23,1.23,1.23,1.23,+0.04,3.36,3000,2,3690,0,0,0,0,0,0,3000,3000,0,0
20200528,057329,緯穎群益98購02,3.59,3.77,3.29,3.29,-0.18,-5.19,516000,18,1817240,0,0,0,0,0,0,89000,413000,-324000,-324000
20200528,05732P,臺股指統一96售02,2.91,2.91,2.91,2.91,+0.09,3.19,1000,1,2910,0,0,0,0,0,0,1000,0,1000,1000
20200528,057330,台積電國票99購03,0.83,0.83,0.83,0.83,+0.01,1.22,499000,1,414170,0,0,0,0,0,0,499000,499000,0,0
20200528,057331,台積電國票99購04,,,,,0.00,0.00,0,0,0,0,0,0,0,0,0,0,0,0,0
20200528,057332,旺宏國票99購03,1.85,1.85,1.85,1.85,0.00,0.00,30000,1,55500,0,0,0,0,0,0,0,30000,-30000,-30000
20200528,057333,智邦國票99購01,5.35,5.35,5.35,5.35,0.00,0.00,8000,1,42800,0,0,0,0,0,0,8000,0,8000,8000
20200528,057334,技嘉國票98購02,3.14,3.14,3.00,3.00,-0.41,-12.02,3000,2,9280,0,0,0,0,0,0,3000,3000,0,0
20200528,057335,技嘉國票99購01,1.90,1.90,1.72,1.76,-0.40,-18.52,175000,13,320780,0,0,0,0,0,0,55000,123000,-68000,-68000
20200528,057336,聯發科國票99購01,,,,,0.00,0.00,0,0,0,0,0,0,0,0,0,0,0,0,0
20200528,057337,聯發科國票99購02,,,,,0.00,0.00,0,0,0,0,0,0,0,0,0,0,0,0,0
20200528,057338,群創國票99購01,,,,,0.00,0.00,0,0,0,0,0,0,0,0,0,0,0,0,0
20200528,057339,群創國票99購02,,,,,0.00,0.00,0,0,0,0,0,0,0,0,0,0,0,0,0
20200528,05733P,臺股指統一96售03,,,,,0.00,0.00,0,0,0,0,0,0,0,0,0,0,0,0,0
20200528,057340,玉晶光元富98購04,2.11,2.11,2.11,2.11,+0.16,8.21,10000,1,21100,0,0,0,0,0,0,10000,0,10000,10000
20200528,057341,技嘉台新98購01,,,,,0.00,0.00,0,0,0,0,0,0,0,0,0,0,0,0,0
20200528,057342,玉晶光台新98購01,,,,,0.00,0.00,0,0,0,0,0,0,0,0,0,0,0,0,0
20200528,057343,道瓊反統一9A購01,1.59,1.59,1.59,1.59,-0.19,-10.67,10000,1,15900,0,0,0,0,0,0,0,10000,-10000,-10000
20200528,057344,元油2X統一98購03,,,,,0.00,0.00,0,0,0,0,0,0,0,0,0,0,0,0,0
20200528,057345,中50統一98購01,,,,,0.00,0.00,0,0,0,0,0,0,0,0,0,0,0,0,0
20200528,057346,鴻海統一98購13,1.01,1.01,1.01,1.01,+0.01,1.0,5000,3,5050,0,0,0,0,0,0,5000,5000,0,0
20200528,057347,國巨統一9A購03,0.56,0.57,0.50,0.50,-0.05,-9.09,613000,24,328180,0,0,0,0,0,0,314000,259000,55000,55000
20200528,057348,台積電統一98購09,,,,,0.00,0.00,0,0,0,0,0,0,0,0,0,0,0,0,0
20200528,057349,聯發科統一98購04,,,,,0.00,0.00,0,0,0,0,0,0,0,0,0,0,0,0,0
20200528,05734P,臺股指統一96售04,,,,,0.00,0.00,0,0,0,0,0,0,0,0,0,0,0,0,0
20200528,057350,全新統一98購03,,,,,0.00,0.00,0,0,0,0,0,0,0,0,0,0,0,0,0
20200528,057351,奇力新統一98購02,,,,,0.00,0.00,0,0,0,0,0,0,0,0,0,0,0,0,0
20200528,057352,大立光統一9A購02,1.42,1.42,1.33,1.33,-0.08,-5.67,77000,4,105560,0,0,0,0,0,0,49000,28000,21000,21000
20200528,057353,玉晶光統一99購01,1.07,1.10,1.07,1.10,+0.05,4.76,3000,2,3270,0,0,0,0,0,0,3000,1000,2000,2000
20200528,057354,聯鈞統一99購03,0.69,0.69,0.62,0.63,+0.01,1.61,40000,6,26250,0,0,0,0,0,0,15000,25000,-10000,-10000
20200528,057355,彩晶統一98購03,0.19,0.19,0.19,0.19,+0.01,5.56,120000,1,22800,0,0,0,0,0,0,120000,0,120000,120000
20200528,057356,彩晶統一98購04,0.44,0.44,0.44,0.44,0.00,0.00,216000,3,95040,0,0,0,0,0,0,0,216000,-216000,-216000
20200528,057357,超眾統一98購01,0.98,1.00,0.92,0.94,-0.16,-14.55,608000,20,592960,0,0,0,0,0,0,422000,181000,241000,241000
20200528,057358,元油2X元大98購08,,,,,0.00,0.00,0,0,0,0,0,0,0,0,0,0,0,0,0
20200528,057359,元油2X元大98購09,,,,,0.00,0.00,0,0,0,0,0,0,0,0,0,0,0,0,0
20200528,05735P,臺股指統一96售05,,,,,0.00,0.00,0,0,0,0,0,0,0,0,0,0,0,0,0
20200528,057360,元油2X元大98購10,,,,,0.00,0.00,0,0,0,0,0,0,0,0,0,0,0,0,0
20200528,057361,元油2X元大98購11,,,,,0.00,0.00,0,0,0,0,0,0,0,0,0,0,0,0,0
20200528,057362,元油2X元大98購12,0.01,0.01,0.01,0.01,0.00,0.00,20000,1,200,0,0,0,0,0,0,0,0,0,0
20200528,057363,華通元大99購02,5.25,5.85,5.20,5.85,+0.88,17.71,30000,9,167800,0,0,0,0,0,0,12000,30000,-18000,-18000
20200528,057364,國巨元大98購18,2.17,2.20,2.17,2.20,+0.06,2.8,43000,4,93340,0,0,0,0,0,0,43000,1000,42000,42000
20200528,057365,智邦元大98購07,8.20,9.10,7.50,7.50,+0.40,5.63,53000,16,456600,0,0,0,0,0,0,39000,50000,-11000,-11000
20200528,057366,智邦元大98購08,4.61,5.35,4.40,4.44,+0.23,5.46,129000,24,629730,0,0,0,0,0,0,38000,120000,-82000,-82000
20200528,057367,技嘉元大98購02,3.08,3.08,2.76,2.76,-0.48,-14.81,36000,6,106070,0,0,0,0,0,0,33000,3000,30000,30000
20200528,057368,微星元大98購02,2.43,2.43,2.43,2.43,-0.63,-20.59,5000,1,12150,0,0,0,0,0,0,5000,0,5000,5000
20200528,057369,奇力新元大99購05,1.33,1.33,1.23,1.23,-0.15,-10.87,43000,2,55090,0,0,0,0,0,0,21000,22000,-1000,-1000
20200528,05736P,臺股指統一96售06,3.71,3.71,3.71,3.71,0.00,0.00,1000,1,3710,0,0,0,0,0,0,0,1000,-1000,-1000
20200528,057370,可成元大98購07,1.09,1.09,1.08,1.08,+0.01,0.93,69000,4,75200,0,0,0,0,0,0,68000,1000,67000,67000
20200528,057371,可成元大98購08,,,,,0.00,0.00,0,0,0,0,0,0,0,0,0,0,0,0,0
20200528,057372,華新科元大99購10,,,,,0.00,0.00,0,0,0,0,0,0,0,0,0,0,0,0,0
20200528,057373,大立光元大98購17,1.14,1.14,1.14,1.14,-0.10,-8.06,10000,1,11400,0,0,0,0,0,0,10000,0,10000,10000
20200528,057374,禾伸堂元大99購03,2.31,2.31,2.26,2.28,-0.04,-1.72,78000,3,179020,0,0,0,0,0,0,78000,12000,66000,66000
20200528,057375,欣興元大98購09,2.46,2.67,2.46,2.67,+0.26,10.79,161000,13,415410,0,0,0,0,0,0,12000,151000,-139000,-139000
20200528,057376,新日興元大98購04,1.41,1.56,1.38,1.43,+0.14,10.85,248000,11,368920,0,0,0,0,0,0,68000,180000,-112000,-112000
20200528,057377,康控元大99購02,1.12,1.13,1.03,1.03,-0.07,-6.36,100000,3,112500,0,0,0,0,0,0,100000,0,100000,100000
20200528,057378,康友元大98購02,0.37,0.37,0.37,0.37,0.00,0.00,2000,1,740,0,0,0,0,0,0,2000,0,2000,2000
20200528,057379,寶成元大98購02,0.52,0.52,0.33,0.33,-0.20,-37.74,108000,7,42740,0,0,0,0,0,0,38000,40000,-2000,-2000
20200528,05737P,臺股指統一96售07,,,,,0.00,0.00,0,0,0,0,0,0,0,0,0,0,0,0,0
20200528,057380,技嘉國泰9A購01,,,,,0.00,0.00,0,0,0,0,0,0,0,0,0,0,0,0,0
20200528,057381,微星國泰9A購01,1.57,1.70,1.57,1.70,-0.06,-3.41,66000,2,104400,0,0,0,0,0,0,60000,6000,54000,54000
20200528,057382,聯發科國泰9A購01,,,,,0.00,0.00,0,0,0,0,0,0,0,0,0,0,0,0,0
20200528,057383,玉晶光富邦9A購01,0.77,0.78,0.73,0.73,0.00,0.00,532000,6,409520,0,0,0,0,0,0,0,532000,-532000,-532000
20200528,057384,台灣50永豐99購02,,,,,0.00,0.00,0,0,0,0,0,0,0,0,0,0,0,0,0
20200528,057385,光罩永豐99購01,0.24,0.25,0.21,0.21,-0.02,-8.7,55000,8,13100,0,0,0,0,0,0,5000,50000,-45000,-45000
20200528,057386,聯發科永豐98購04,3.95,3.95,3.75,3.81,0.00,0.00,35000,4,134400,0,0,0,0,0,0,10000,25000,-15000,-15000
20200528,057387,奇力新永豐98購03,0.23,0.23,0.23,0.23,0.00,0.00,20000,1,4600,0,0,0,0,0,0,20000,0,20000,20000
20200528,057388,奇鋐永豐98購02,1.82,2.06,1.82,1.95,+0.15,8.33,310000,13,609620,0,0,0,0,0,0,88000,222000,-134000,-134000
20200528,057389,玉晶光永豐98購06,0.44,0.49,0.43,0.44,0.00,0.00,100000,5,44100,0,0,0,0,0,0,0,100000,-100000,-100000
20200528,05738P,臺股指統一97售01,,,,,0.00,0.00,0,0,0,0,0,0,0,0,0,0,0,0,0
20200528,057390,台表科永豐98購01,1.29,1.29,1.26,1.26,-0.05,-3.82,12000,3,15180,0,0,0,0,0,0,2000,10000,-8000,-8000
20200528,057391,樺漢永豐98購01,,,,,0.00,0.00,0,0,0,0,0,0,0,0,0,0,0,0,0
20200528,057392,福懋科永豐98購01,,,,,0.00,0.00,0,0,0,0,0,0,0,0,0,0,0,0,0
20200528,057393,台積電中信02購01,0.30,0.31,0.28,0.30,+0.02,7.14,128000,12,37010,0,0,0,0,0,0,0,0,0,0
20200528,057394,台積電中信9C購02,0.25,0.25,0.25,0.25,0.00,0.00,160000,7,40000,0,0,0,0,0,0,0,150000,-150000,-150000
20200528,057395,旺宏中信98購03,0.06,0.06,0.05,0.05,-0.01,-16.67,150000,14,8000,0,0,0,0,0,0,20000,130000,-110000,-110000
20200528,057396,健鼎中信99購01,,,,,0.00,0.00,0,0,0,0,0,0,0,0,0,0,0,0,0
20200528,057397,茂林中信9A購01,1.04,1.04,1.00,1.00,-0.34,-25.37,193000,36,196800,0,0,0,0,0,0,166000,27000,139000,139000
20200528,057398,台郡中信99購01,,,,,0.00,0.00,0,0,0,0,0,0,0,0,0,0,0,0,0
20200528,057399,滬深反群益9C購01,0.73,0.81,0.73,0.80,+0.01,1.27,65000,4,49750,0,0,0,0,0,0,35000,30000,5000,5000
20200528,05739P,臺股指統一97售02,2.83,2.96,2.83,2.96,-0.05,-1.66,30000,3,86600,0,0,0,0,0,0,30000,0,30000,30000
20200528,057400,全新群益9A購01,,,,,0.00,0.00,0,0,0,0,0,0,0,0,0,0,0,0,0
20200528,057401,晶豪科群益99購01,4.05,4.05,4.05,4.05,0.00,0.00,41000,1,166050,0,0,0,0,0,0,0,41000,-41000,-41000
20200528,057402,嘉晶群益98購02,,,,,0.00,0.00,0,0,0,0,0,0,0,0,0,0,0,0,0
20200528,057403,亞光群益98購04,0.99,0.99,0.90,0.90,-0.06,-6.25,107000,3,103230,0,0,0,0,0,0,107000,0,107000,107000
20200528,057404,貿聯群益99購01,1.12,1.13,1.10,1.13,+0.01,0.89,590000,12,661740,0,0,0,0,0,0,310000,280000,30000,30000
20200528,057405,麗豐群益98購01,0.71,0.71,0.71,0.71,-0.03,-4.05,10000,1,7100,0,0,0,0,0,0,0,10000,-10000,-10000
20200528,057406,茂林群益98購03,0.76,0.76,0.69,0.69,-0.06,-8.0,123000,14,86310,0,0,0,0,0,0,120000,3000,117000,117000
20200528,057407,超眾群益99購01,0.98,1.02,0.98,1.00,0.00,0.00,214000,5,214520,0,0,0,0,0,0,107000,107000,0,0
20200528,057408,台郡群益98購01,0.33,0.33,0.31,0.31,0.00,0.00,5000,2,1590,0,0,0,0,0,0,2000,3000,-1000,-1000
20200528,057409,台虹群益98購02,,,,,0.00,0.00,0,0,0,0,0,0,0,0,0,0,0,0,0
20200528,05740P,宏達電元富96售01,,,,,0.00,0.00,0,0,0,0,0,0,0,0,0,0,0,0,0
20200528,057410,南電群益98購01,1.36,1.36,1.36,1.36,+0.10,7.94,10000,1,13600,0,0,0,0,0,0,0,10000,-10000,-10000
20200528,057411,臺股指群益99購05,1.54,1.54,1.53,1.53,+0.01,0.66,6000,2,9210,0,0,0,0,0,0,0,6000,-6000,-6000
20200528,057412,臺股指群益99購06,0.06,0.06,0.06,0.06,0.00,0.00,20000,1,1200,0,0,0,0,0,0,0,0,0,0
20200528,057413,臺股指群益9C購04,4.84,4.84,4.53,4.53,-0.24,-5.03,35000,2,164750,0,0,0,0,0,0,20000,15000,5000,5000
20200528,057414,華新科日盛9A購01,,,,,0.00,0.00,0,0,0,0,0,0,0,0,0,0,0,0,0
20200528,057415,和碩日盛98購01,,,,,0.00,0.00,0,0,0,0,0,0,0,0,0,0,0,0,0
20200528,057416,T50反1凱基9C購01,,,,,0.00,0.00,0,0,0,0,0,0,0,0,0,0,0,0,0
20200528,057417,國巨凱基9A購03,0.25,0.25,0.25,0.25,+0.02,8.7,16000,1,4000,0,0,0,0,0,0,0,16000,-16000,-16000
20200528,057418,台光電凱基98購04,,,,,0.00,0.00,0,0,0,0,0,0,0,0,0,0,0,0,0
20200528,057419,奇力新凱基98購06,,,,,0.00,0.00,0,0,0,0,0,0,0,0,0,0,0,0,0
20200528,05741P,聯發科元大96售14,,,,,0.00,0.00,0,0,0,0,0,0,0,0,0,0,0,0,0
20200528,057420,美食凱基98購01,,,,,0.00,0.00,0,0,0,0,0,0,0,0,0,0,0,0,0
20200528,057421,智原凱基98購04,1.42,1.42,1.41,1.41,0.00,0.00,24000,2,33960,0,0,0,0,0,0,24000,0,24000,24000
20200528,057422,欣興凱基98購04,1.67,1.67,1.67,1.67,+0.08,5.03,100000,1,167000,0,0,0,0,0,0,0,100000,-100000,-100000
20200528,057423,台郡凱基98購06,0.77,0.77,0.77,0.77,-0.04,-4.94,1000,1,770,0,0,0,0,0,0,1000,0,1000,1000
20200528,057424,訊芯凱基98購04,,,,,0.00,0.00,0,0,0,0,0,0,0,0,0,0,0,0,0
20200528,057425,臺股指凱基9C購02,0.45,0.59,0.45,0.59,0.00,0.00,11000,2,5090,0,0,0,0,0,0,0,0,0,0
20200528,057426,元油2X兆豐9B購01,0.09,0.12,0.09,0.12,0.00,0.00,11000,2,1020,0,0,0,0,0,0,0,10000,-10000,-10000
20200528,057427,華通兆豐99購01,,,,,0.00,0.00,0,0,0,0,0,0,0,0,0,0,0,0,0
20200528,057428,正崴兆豐98購01,0.82,0.82,0.73,0.73,-0.09,-10.98,107000,6,84240,0,0,0,0,0,0,86000,21000,65000,65000
20200528,057429,華新科兆豐98購03,0.14,0.14,0.14,0.14,-0.03,-17.65,10000,1,1400,0,0,0,0,0,0,10000,10000,0,0
20200528,05742P,可成元大96售04,,,,,0.00,0.00,0,0,0,0,0,0,0,0,0,0,0,0,0
20200528,057430,富邦金兆豐98購01,,,,,0.00,0.00,0,0,0,0,0,0,0,0,0,0,0,0,0
20200528,057431,京鼎兆豐98購02,,,,,0.00,0.00,0,0,0,0,0,0,0,0,0,0,0,0,0
20200528,057432,T50反1國票9B購01,,,,,0.00,0.00,0,0,0,0,0,0,0,0,0,0,0,0,0
20200528,057433,上銀國票98購04,5.35,5.85,5.30,5.70,+0.25,4.59,53000,17,288100,0,0,0,0,0,0,48000,5000,43000,43000
20200528,057434,國巨國票99購03,,,,,0.00,0.00,0,0,0,0,0,0,0,0,0,0,0,0,0
20200528,057435,旺宏國票99購04,,,,,0.00,0.00,0,0,0,0,0,0,0,0,0,0,0,0,0
20200528,057436,義隆國票99購02,3.06,3.06,2.90,2.90,+0.24,9.02,55000,2,165580,0,0,0,0,0,0,55000,0,55000,55000
20200528,057437,可成國票99購01,1.76,1.76,1.76,1.76,+0.06,3.53,10000,1,17600,0,0,0,0,0,0,10000,0,10000,10000
20200528,057438,禾伸堂國票99購01,,,,,0.00,0.00,0,0,0,0,0,0,0,0,0,0,0,0,0
20200528,057439,元油2X統一99購02,,,,,0.00,0.00,0,0,0,0,0,0,0,0,0,0,0,0,0
20200528,05743P,創意元大96售01,,,,,0.00,0.00,0,0,0,0,0,0,0,0,0,0,0,0,0
20200528,057440,台積電統一98購10,0.88,0.88,0.27,0.27,0.00,0.00,30000,3,14200,0,0,0,0,0,0,0,20000,-20000,-20000
20200528,057441,奇力新統一98購03,,,,,0.00,0.00,0,0,0,0,0,0,0,0,0,0,0,0,0
20200528,057442,玉晶光統一98購03,,,,,0.00,0.00,0,0,0,0,0,0,0,0,0,0,0,0,0
20200528,057443,臺股指統一99購04,,,,,0.00,0.00,0,0,0,0,0,0,0,0,0,0,0,0,0
20200528,057444,台泥元富98購01,2.64,2.64,2.57,2.57,-0.16,-5.86,264000,6,688000,0,0,0,0,0,0,174000,90000,84000,84000
20200528,057445,華通元富02購01,2.09,2.34,2.09,2.21,+0.26,13.33,997000,29,2266090,0,0,0,0,0,0,652000,345000,307000,307000
20200528,057446,旺宏元富02購01,1.87,1.90,1.87,1.90,-0.02,-1.04,92000,21,173000,0,0,0,0,0,0,92000,0,92000,92000
20200528,057447,智邦元富02購01,4.68,4.84,4.20,4.20,-0.03,-0.71,178000,15,826610,0,0,0,0,0,0,32000,146000,-114000,-114000
20200528,057448,致茂元富98購01,0.78,0.79,0.75,0.75,-0.02,-2.6,100000,3,75700,0,0,0,0,0,0,80000,20000,60000,60000
20200528,057449,華新科元富99購02,1.83,1.85,1.79,1.79,-0.04,-2.19,109000,20,199090,0,0,0,0,0,0,109000,0,109000,109000
20200528,05744P,台表科元大96售04,,,,,0.00,0.00,0,0,0,0,0,0,0,0,0,0,0,0,0
20200528,057450,國泰金元富98購01,1.91,1.93,1.80,1.82,-0.10,-5.21,112000,5,211690,0,0,0,0,0,0,58000,54000,4000,4000
20200528,057451,大立光元富9B購01,1.62,1.62,1.45,1.45,-0.11,-7.05,86000,4,135000,0,0,0,0,0,0,50000,36000,14000,14000
20200528,057452,新日興元富98購01,0.80,0.86,0.80,0.86,+0.10,13.16,50000,2,42400,0,0,0,0,0,0,40000,10000,30000,30000
20200528,057453,矽創元富98購01,,,,,0.00,0.00,0,0,0,0,0,0,0,0,0,0,0,0,0
20200528,057454,上銀國泰99購02,,,,,0.00,0.00,0,0,0,0,0,0,0,0,0,0,0,0,0
20200528,057455,景碩國泰99購01,0.52,0.57,0.52,0.53,+0.03,6.0,221000,14,123370,0,0,0,0,0,0,10000,211000,-201000,-201000
20200528,057456,道瓊銀富邦9C購01,1.91,1.91,1.88,1.91,+0.16,9.14,35000,5,66520,0,0,0,0,0,0,0,0,0,0
20200528,057457,華邦電富邦98購01,1.15,1.25,0.98,0.98,0.00,0.00,452000,84,546400,0,0,0,0,0,0,357000,30000,327000,327000
20200528,057458,TPK富邦9A購01,0.37,0.37,0.37,0.37,-0.03,-7.5,50000,5,18500,0,0,0,0,0,0,0,50000,-50000,-50000
20200528,057459,臺股指富邦99購03,,,,,0.00,0.00,0,0,0,0,0,0,0,0,0,0,0,0,0
20200528,05745P,富邦金兆豐96售02,,,,,0.00,0.00,0,0,0,0,0,0,0,0,0,0,0,0,0
20200528,057460,楠梓電永豐98購03,,,,,0.00,0.00,0,0,0,0,0,0,0,0,0,0,0,0,0
20200528,057461,國巨永豐98購07,0.18,0.18,0.17,0.17,-0.02,-10.53,30000,2,5300,0,0,0,0,0,0,20000,10000,10000,10000
20200528,057462,光磊永豐98購02,0.87,0.93,0.86,0.93,+0.04,4.49,88000,5,77490,0,0,0,0,0,0,34000,54000,-20000,-20000
20200528,057463,華邦電永豐98購01,0.13,0.13,0.07,0.07,-0.01,-12.5,451000,33,45010,0,0,0,0,0,0,40000,386000,-346000,-346000
20200528,057464,大立光永豐98購02,,,,,0.00,0.00,0,0,0,0,0,0,0,0,0,0,0,0,0
20200528,057465,智易永豐98購02,2.10,2.26,2.10,2.26,0.00,0.00,141000,14,306390,0,0,0,0,0,0,0,141000,-141000,-141000
20200528,057466,泰鼎永豐98購01,1.18,1.23,1.08,1.11,-0.04,-3.48,106000,9,126690,0,0,0,0,0,0,61000,45000,16000,16000
20200528,057467,祥碩永豐98購04,0.85,0.94,0.77,0.80,+0.12,17.65,303000,15,243560,0,0,0,0,0,0,265000,23000,242000,242000
20200528,057468,台郡永豐98購01,,,,,0.00,0.00,0,0,0,0,0,0,0,0,0,0,0,0,0
20200528,057469,康友永豐98購02,,,,,0.00,0.00,0,0,0,0,0,0,0,0,0,0,0,0,0
20200528,05746P,台積電群益96售07,,,,,0.00,0.00,0,0,0,0,0,0,0,0,0,0,0,0,0
20200528,057470,易華電永豐98購02,,,,,0.00,0.00,0,0,0,0,0,0,0,0,0,0,0,0,0
20200528,057471,昇陽半永豐98購02,0.22,0.22,0.21,0.21,0.00,0.00,35000,3,7600,0,0,0,0,0,0,5000,30000,-25000,-25000
20200528,057472,T50正2元大9B購03,0.32,0.32,0.32,0.32,0.00,0.00,40000,4,12800,0,0,0,0,0,0,0,40000,-40000,-40000
20200528,057473,T50反1元大98購08,,,,,0.00,0.00,0,0,0,0,0,0,0,0,0,0,0,0,0
20200528,057474,T50反1元大98購09,,,,,0.00,0.00,0,0,0,0,0,0,0,0,0,0,0,0,0
20200528,057475,聯電元大9A購01,0.47,0.49,0.47,0.47,+0.02,4.44,2364000,22,1131670,0,0,0,0,0,0,426000,1926000,-1500000,-1500000
20200528,057476,國巨元大98購19,,,,,0.00,0.00,0,0,0,0,0,0,0,0,0,0,0,0,0
20200528,057477,智邦元大98購09,6.35,6.75,5.65,5.65,+0.25,4.63,34000,9,217700,0,0,0,0,0,0,10000,34000,-24000,-24000
20200528,057478,智邦元大99購01,3.90,3.90,3.90,3.90,+0.70,21.87,4000,1,15600,0,0,0,0,0,0,0,0,0,0
20200528,057479,致茂元大98購03,1.20,1.25,1.12,1.12,-0.25,-18.25,122000,6,147500,0,0,0,0,0,0,122000,0,122000,122000
20200528,05747P,漢唐群益96售03,,,,,0.00,0.00,0,0,0,0,0,0,0,0,0,0,0,0,0
20200528,057480,技嘉元大98購03,3.54,3.54,3.14,3.14,-0.49,-13.5,41000,11,141810,0,0,0,0,0,0,38000,10000,28000,28000
20200528,057481,技嘉元大98購04,3.62,3.62,3.54,3.54,-0.31,-8.05,5000,2,18020,0,0,0,0,0,0,5000,5000,0,0
20200528,057482,微星元大98購03,2.53,2.53,2.53,2.53,+0.04,1.61,10000,1,25300,0,0,0,0,0,0,0,10000,-10000,-10000
20200528,057483,微星元大98購04,1.90,2.00,1.90,1.90,+0.03,1.6,270000,11,531780,0,0,0,0,0,0,151000,100000,51000,51000
20200528,057484,南亞科元大98購06,0.78,0.78,0.75,0.75,+0.05,7.14,205000,5,159300,0,0,0,0,0,0,0,205000,-205000,-205000
20200528,057485,友達元大9C購04,,,,,0.00,0.00,0,0,0,0,0,0,0,0,0,0,0,0,0
20200528,057486,美律元大98購04,0.93,0.97,0.91,0.97,+0.09,10.23,149000,5,136570,0,0,0,0,0,0,68000,81000,-13000,-13000
20200528,057487,聯發科元大98購10,,,,,0.00,0.00,0,0,0,0,0,0,0,0,0,0,0,0,0
20200528,057488,聯發科元大99購02,2.91,3.02,2.91,3.02,0.00,0.00,2000,2,5930,0,0,0,0,0,0,0,1000,-1000,-1000
20200528,057489,奇力新元大99購06,1.17,1.17,1.17,1.17,-0.09,-7.14,68000,1,79560,0,0,0,0,0,0,68000,0,68000,68000
20200528,05748P,臺股指群益99售02,8.15,8.35,8.15,8.30,0.00,0.00,10000,4,82750,0,0,0,0,0,0,0,10000,-10000,-10000
20200528,057490,可成元大98購10,0.92,0.92,0.85,0.86,-0.05,-5.49,253000,6,221990,0,0,0,0,0,0,68000,185000,-117000,-117000
20200528,057491,美食元大98購03,2.89,2.89,2.46,2.46,-0.37,-13.07,111000,8,298110,0,0,0,0,0,0,59000,52000,7000,7000
20200528,057492,大立光元大98購18,,,,,0.00,0.00,0,0,0,0,0,0,0,0,0,0,0,0,0
20200528,057493,聯詠元大98購02,1.61,1.63,1.56,1.59,-0.06,-3.64,255000,14,406250,0,0,0,0,0,0,181000,74000,107000,107000
20200528,057494,玉晶光元大99購09,2.27,2.27,2.25,2.25,+0.07,3.21,13000,4,29310,0,0,0,0,0,0,13000,3000,10000,10000
20200528,057495,牧德元大99購04,1.88,1.88,1.70,1.70,-0.13,-7.1,55000,3,97400,0,0,0,0,0,0,30000,25000,5000,5000
20200528,057496,佐登元大98購02,,,,,0.00,0.00,0,0,0,0,0,0,0,0,0,0,0,0,0
20200528,057497,祥碩元大98購06,4.32,4.71,4.32,4.71,-0.29,-5.8,30000,3,135800,0,0,0,0,0,0,0,30000,-30000,-30000
20200528,057498,台郡元大98購04,1.31,1.31,1.31,1.31,-0.07,-5.07,95000,2,124450,0,0,0,0,0,0,27000,68000,-41000,-41000
20200528,057499,奇鋐群益98購01,2.48,2.63,2.48,2.56,+0.31,13.78,169000,7,437670,0,0,0,0,0,0,4000,165000,-161000,-161000
20200528,05749P,臺股指群益99售03,,,,,0.00,0.00,0,0,0,0,0,0,0,0,0,0,0,0,0
20200528,057500,神達群益98購01,,,,,0.00,0.00,0,0,0,0,0,0,0,0,0,0,0,0,0
20200528,057501,超眾群益98購04,3.00,3.03,3.00,3.03,-0.51,-14.41,71000,3,213990,0,0,0,0,0,0,71000,0,71000,71000
20200528,057502,訊芯群益98購02,0.55,0.55,0.55,0.55,-0.09,-14.06,98000,1,53900,0,0,0,0,0,0,98000,0,98000,98000
20200528,057503,世紀鋼群益98購02,5.95,7.00,5.95,7.00,0.00,0.00,6000,2,36750,0,0,0,0,0,0,0,6000,-6000,-6000
20200528,057504,技嘉麥證98購01,1.19,1.20,1.17,1.17,-0.29,-19.86,67000,3,79450,52000,15000,37000,0,0,0,52000,15000,37000,37000
20200528,057505,健策麥證98購01,1.41,1.47,1.23,1.23,-0.09,-6.82,195000,20,265180,83000,112000,-29000,0,0,0,83000,112000,-29000,-29000
20200528,057506,聯鈞國票99購02,1.47,1.47,1.47,1.47,0.00,0.00,2000,1,2940,0,0,0,0,0,0,0,2000,-2000,-2000
20200528,057507,貿聯國票98購02,1.24,1.27,1.20,1.20,+0.03,2.56,524000,19,643990,0,0,0,0,0,0,319000,205000,114000,114000
20200528,057508,康控國票99購03,0.54,0.54,0.54,0.54,+0.03,5.88,4000,1,2160,0,0,0,0,0,0,0,4000,-4000,-4000
20200528,057509,聯發科統一9A購03,3.83,3.83,3.54,3.54,-0.25,-6.6,77000,5,273830,0,0,0,0,0,0,71000,6000,65000,65000
20200528,05750P,臺股指群益99售04,,,,,0.00,0.00,0,0,0,0,0,0,0,0,0,0,0,0,0
20200528,057510,泰碩統一98購02,,,,,0.00,0.00,0,0,0,0,0,0,0,0,0,0,0,0,0
20200528,057511,健策統一98購02,1.40,1.44,1.16,1.16,-0.15,-11.45,997000,32,1311360,0,0,0,0,0,0,932000,248000,684000,684000
20200528,057512,華邦電台新98購01,0.38,0.39,0.25,0.25,-0.02,-7.41,227000,17,75130,0,0,0,0,0,0,60000,167000,-107000,-107000
20200528,057513,智邦台新98購01,4.63,4.63,3.85,3.85,0.00,0.00,13000,5,59410,0,0,0,0,0,0,13000,13000,0,0
20200528,057514,華新科元富99購03,1.16,1.17,1.16,1.17,-0.01,-0.85,82000,11,95140,0,0,0,0,0,0,82000,0,82000,82000
20200528,057515,智原元富98購02,,,,,0.00,0.00,0,0,0,0,0,0,0,0,0,0,0,0,0
20200528,057516,和鑫元富98購01,0.53,0.58,0.46,0.46,-0.02,-4.17,796000,17,432940,0,0,0,0,0,0,254000,532000,-278000,-278000
20200528,057517,矽創元富98購02,0.71,0.80,0.67,0.70,+0.19,37.25,470000,25,345500,0,0,0,0,0,0,14000,456000,-442000,-442000
20200528,057518,世紀鋼元富98購01,,,,,0.00,0.00,0,0,0,0,0,0,0,0,0,0,0,0,0
20200528,057519,元油2X元大98購14,,,,,0.00,0.00,0,0,0,0,0,0,0,0,0,0,0,0,0
20200528,05751P,台積電中信96售05,,,,,0.00,0.00,0,0,0,0,0,0,0,0,0,0,0,0,0
20200528,057520,元油2X元大98購15,,,,,0.00,0.00,0,0,0,0,0,0,0,0,0,0,0,0,0
20200528,057521,元油2X元大98購16,,,,,0.00,0.00,0,0,0,0,0,0,0,0,0,0,0,0,0
20200528,057522,元油2X元大98購17,,,,,0.00,0.00,0,0,0,0,0,0,0,0,0,0,0,0,0
20200528,057523,大成鋼元大99購01,1.21,1.40,1.18,1.28,+0.08,6.67,916000,26,1211460,0,0,0,0,0,0,237000,450000,-213000,-213000
20200528,057524,旺宏元大99購04,,,,,0.00,0.00,0,0,0,0,0,0,0,0,0,0,0,0,0
20200528,057525,光磊元大99購01,1.59,1.69,1.59,1.69,+0.05,3.05,79000,4,129610,0,0,0,0,0,0,57000,34000,23000,23000
20200528,057526,智邦元大98購10,5.05,5.40,4.57,4.57,+0.23,5.3,23000,9,115040,0,0,0,0,0,0,14000,23000,-9000,-9000
20200528,057527,億光元大98購01,0.97,0.97,0.89,0.89,-0.08,-8.25,217000,13,200660,0,0,0,0,0,0,77000,114000,-37000,-37000
20200528,057528,南亞科元大99購01,,,,,0.00,0.00,0,0,0,0,0,0,0,0,0,0,0,0,0
20200528,057529,嘉晶元大99購02,6.70,6.70,6.50,6.50,-0.30,-4.41,56000,3,367100,0,0,0,0,0,0,26000,30000,-4000,-4000
20200528,05752P,台積電中信96售06,,,,,0.00,0.00,0,0,0,0,0,0,0,0,0,0,0,0,0
20200528,057530,奇鋐元大99購01,4.42,4.77,4.42,4.43,+0.25,5.98,190000,12,868920,0,0,0,0,0,0,77000,143000,-66000,-66000
20200528,057531,禾伸堂元大99購04,1.89,1.89,1.89,1.89,-0.02,-1.05,100000,3,189000,0,0,0,0,0,0,50000,50000,0,0
20200528,057532,智原元大98購03,1.36,1.36,1.21,1.21,-0.07,-5.47,211000,20,274230,0,0,0,0,0,0,208000,15000,193000,193000
20200528,057533,晶相光元大98購02,1.08,1.08,1.07,1.08,-0.07,-6.09,94000,7,100880,0,0,0,0,0,0,84000,10000,74000,74000
20200528,057534,旭富元大98購01,,,,,0.00,0.00,0,0,0,0,0,0,0,0,0,0,0,0,0
20200528,057535,泰鼎元大99購01,,,,,0.00,0.00,0,0,0,0,0,0,0,0,0,0,0,0,0
20200528,057536,康控元大99購03,,,,,0.00,0.00,0,0,0,0,0,0,0,0,0,0,0,0,0
20200528,057537,聯茂元大98購04,1.46,1.59,1.46,1.59,+0.15,10.42,137000,6,203690,0,0,0,0,0,0,68000,69000,-1000,-1000
20200528,057538,緯穎元大98購07,2.44,2.44,2.15,2.15,-0.25,-10.42,74000,6,172540,0,0,0,0,0,0,74000,14000,60000,60000
20200528,057539,南茂元大98購02,1.55,1.55,1.33,1.33,-0.20,-13.07,543000,17,815470,0,0,0,0,0,0,400000,143000,257000,257000
20200528,05753P,臺股指中信99售02,,,,,0.00,0.00,0,0,0,0,0,0,0,0,0,0,0,0,0
20200528,057540,緯穎日盛99購01,2.64,2.64,2.64,2.64,0.00,0.00,8000,1,21120,0,0,0,0,0,0,0,8000,-8000,-8000
20200528,057541,台灣50康和9A購04,,,,,0.00,0.00,0,0,0,0,0,0,0,0,0,0,0,0,0
20200528,057542,上銀凱基99購01,0.77,0.77,0.77,0.77,-0.03,-3.75,10000,1,7700,0,0,0,0,0,0,0,10000,-10000,-10000
20200528,057543,華通凱基99購02,1.64,1.65,1.57,1.57,+0.21,15.44,71000,5,115350,0,0,0,0,0,0,0,71000,-71000,-71000
20200528,057544,鴻海凱基02購01,,,,,0.00,0.00,0,0,0,0,0,0,0,0,0,0,0,0,0
20200528,057545,國巨凱基99購05,0.33,0.33,0.33,0.33,0.00,0.00,8000,1,2640,0,0,0,0,0,0,0,8000,-8000,-8000
20200528,057546,台積電凱基02購01,0.50,0.50,0.50,0.50,0.00,0.00,10000,1,5000,0,0,0,0,0,0,0,0,0,0
20200528,057547,技嘉凱基99購01,1.87,1.87,1.87,1.87,-0.46,-19.74,20000,1,37400,0,0,0,0,0,0,20000,0,20000,20000
20200528,057548,微星凱基99購01,0.61,0.64,0.61,0.64,+0.04,6.67,103000,8,64370,0,0,0,0,0,0,70000,28000,42000,42000
20200528,057549,台光電凱基98購05,,,,,0.00,0.00,0,0,0,0,0,0,0,0,0,0,0,0,0
20200528,05754P,臺股指中信99售03,,,,,0.00,0.00,0,0,0,0,0,0,0,0,0,0,0,0,0
20200528,057550,聯發科凱基02購01,,,,,0.00,0.00,0,0,0,0,0,0,0,0,0,0,0,0,0
20200528,057551,華新科凱基98購06,,,,,0.00,0.00,0,0,0,0,0,0,0,0,0,0,0,0,0
20200528,057552,禾伸堂凱基98購05,,,,,0.00,0.00,0,0,0,0,0,0,0,0,0,0,0,0,0
20200528,057553,景碩凱基98購03,0.65,0.65,0.65,0.65,-0.07,-9.72,14000,1,9100,0,0,0,0,0,0,14000,0,14000,14000
20200528,057554,新日興凱基99購02,0.38,0.40,0.38,0.38,0.00,0.00,73000,11,28540,0,0,0,0,0,0,70000,73000,-3000,-3000
20200528,057555,玉晶光凱基9A購02,,,,,0.00,0.00,0,0,0,0,0,0,0,0,0,0,0,0,0
20200528,057556,智易凱基99購01,1.72,1.86,1.67,1.72,+0.07,4.24,258000,26,459390,0,0,0,0,0,0,211000,105000,106000,106000
20200528,057557,聯茂凱基99購04,1.78,1.78,1.78,1.78,+0.03,1.71,30000,1,53400,0,0,0,0,0,0,0,30000,-30000,-30000
20200528,057558,致新凱基98購01,3.98,4.40,3.98,4.40,+0.34,8.37,66000,10,271380,0,0,0,0,0,0,46000,20000,26000,26000
20200528,057559,可成兆豐99購02,,,,,0.00,0.00,0,0,0,0,0,0,0,0,0,0,0,0,0
20200528,05755P,臺股指中信99售04,1.41,1.49,1.39,1.49,+0.05,3.47,136000,17,192040,0,0,0,0,0,0,71000,50000,21000,21000
20200528,057560,華新科兆豐99購01,0.17,0.17,0.17,0.17,0.00,0.00,10000,1,1700,0,0,0,0,0,0,0,10000,-10000,-10000
20200528,057561,大立光兆豐98購02,,,,,0.00,0.00,0,0,0,0,0,0,0,0,0,0,0,0,0
20200528,057562,奇鋐兆豐98購01,1.31,1.34,1.31,1.34,+0.09,7.2,157000,5,209240,0,0,0,0,0,0,20000,137000,-117000,-117000
20200528,057563,旭富國泰9A購01,2.99,2.99,2.12,2.17,0.00,0.00,17000,4,37260,0,0,0,0,0,0,0,15000,-15000,-15000
20200528,057564,台積電富邦9B購03,,,,,0.00,0.00,0,0,0,0,0,0,0,0,0,0,0,0,0
20200528,057565,可成富邦99購01,,,,,0.00,0.00,0,0,0,0,0,0,0,0,0,0,0,0,0
20200528,057566,欣興富邦99購01,,,,,0.00,0.00,0,0,0,0,0,0,0,0,0,0,0,0,0
20200528,057567,嘉聯益富邦9A購01,0.49,0.54,0.46,0.50,+0.03,6.38,1094000,29,546210,0,0,0,0,0,0,91000,939000,-848000,-848000
20200528,057568,友訊永豐99購01,0.63,0.63,0.63,0.63,0.00,0.00,60000,3,37800,0,0,0,0,0,0,0,60000,-60000,-60000
20200528,057569,光磊永豐98購03,0.77,0.81,0.77,0.81,+0.03,3.85,115000,4,90160,0,0,0,0,0,0,68000,47000,21000,21000
20200528,05756P,臺股指中信99售05,,,,,0.00,0.00,0,0,0,0,0,0,0,0,0,0,0,0,0
20200528,057570,技嘉永豐98購02,0.34,0.35,0.30,0.30,-0.08,-21.05,191000,17,62900,0,0,0,0,0,0,40000,141000,-101000,-101000
20200528,057571,泰碩永豐98購01,,,,,0.00,0.00,0,0,0,0,0,0,0,0,0,0,0,0,0
20200528,057572,明泰永豐98購01,,,,,0.00,0.00,0,0,0,0,0,0,0,0,0,0,0,0,0
20200528,057573,京鼎永豐98購02,,,,,0.00,0.00,0,0,0,0,0,0,0,0,0,0,0,0,0
20200528,057574,中磊永豐98購01,,,,,0.00,0.00,0,0,0,0,0,0,0,0,0,0,0,0,0
20200528,057575,世紀鋼永豐98購02,1.64,2.36,1.60,2.14,+0.44,25.88,312000,73,635370,0,0,0,0,0,0,112000,188000,-76000,-76000
20200528,057576,南亞科第一9C購01,,,,,0.00,0.00,0,0,0,0,0,0,0,0,0,0,0,0,0
20200528,057577,廣宇中信9A購01,,,,,0.00,0.00,0,0,0,0,0,0,0,0,0,0,0,0,0
20200528,057578,可成中信99購01,0.31,0.31,0.27,0.28,0.00,0.00,303000,18,85450,0,0,0,0,0,0,172000,110000,62000,62000
20200528,057579,長榮航中信9A購01,0.35,0.35,0.28,0.28,-0.05,-15.15,283000,43,89590,0,0,0,0,0,0,122000,141000,-19000,-19000
20200528,05757P,旺宏永豐96售03,0.44,0.53,0.44,0.53,0.00,0.00,29000,2,12850,0,0,0,0,0,0,1000,28000,-27000,-27000
20200528,057580,玉山金中信9A購01,0.48,0.48,0.46,0.46,-0.03,-6.12,325000,6,152290,0,0,0,0,0,0,186000,139000,47000,47000
20200528,057581,元大金中信9A購01,0.23,0.23,0.21,0.21,-0.02,-8.7,2498000,17,525400,0,0,0,0,0,0,2424000,51000,2373000,2373000
20200528,057582,亞光中信9A購02,0.37,0.37,0.37,0.37,0.00,0.00,20000,1,7400,0,0,0,0,0,0,0,20000,-20000,-20000
20200528,057583,啟碁中信9A購01,0.59,0.60,0.58,0.58,0.00,0.00,157000,7,91660,0,0,0,0,0,0,152000,5000,147000,147000
20200528,057584,國巨亞東99購01,,,,,0.00,0.00,0,0,0,0,0,0,0,0,0,0,0,0,0
20200528,057585,鴻海國票99購05,,,,,0.00,0.00,0,0,0,0,0,0,0,0,0,0,0,0,0
20200528,057586,台積電國票99購06,,,,,0.00,0.00,0,0,0,0,0,0,0,0,0,0,0,0,0
20200528,057587,微星國票99購01,2.94,3.04,2.94,3.04,-0.34,-10.06,163000,12,491900,0,0,0,0,0,0,50000,113000,-63000,-63000
20200528,057588,南亞科國票99購01,,,,,0.00,0.00,0,0,0,0,0,0,0,0,0,0,0,0,0
20200528,057589,超眾國票9A購01,2.61,2.73,2.61,2.73,-0.15,-5.21,12000,2,32160,0,0,0,0,0,0,5000,7000,-2000,-2000
20200528,05758P,光罩永豐96售02,1.07,1.18,1.03,1.18,+0.06,5.36,272000,13,304940,0,0,0,0,0,0,78000,194000,-116000,-116000
20200528,057590,元油2X兆豐98購02,,,,,0.00,0.00,0,0,0,0,0,0,0,0,0,0,0,0,0
20200528,057591,鴻海兆豐99購01,,,,,0.00,0.00,0,0,0,0,0,0,0,0,0,0,0,0,0
20200528,057592,美律兆豐99購01,,,,,0.00,0.00,0,0,0,0,0,0,0,0,0,0,0,0,0
20200528,057593,聯發科兆豐98購03,,,,,0.00,0.00,0,0,0,0,0,0,0,0,0,0,0,0,0
20200528,057594,宏達電兆豐99購01,,,,,0.00,0.00,0,0,0,0,0,0,0,0,0,0,0,0,0
20200528,057595,健鼎兆豐98購01,0.95,1.01,0.95,0.96,+0.04,4.35,225000,17,220740,0,0,0,0,0,0,31000,194000,-163000,-163000
20200528,057596,聯茂兆豐99購01,0.45,0.45,0.42,0.44,+0.01,2.33,57000,7,24650,0,0,0,0,0,0,30000,27000,3000,3000
20200528,057597,華通群益9A購02,,,,,0.00,0.00,0,0,0,0,0,0,0,0,0,0,0,0,0
20200528,057598,鴻海群益98購07,0.33,0.33,0.33,0.33,+0.03,10.0,100000,1,33000,0,0,0,0,0,0,0,100000,-100000,-100000
20200528,057599,技嘉群益9A購01,2.14,2.21,2.02,2.02,-0.38,-15.83,30000,7,65510,0,0,0,0,0,0,9000,8000,1000,1000
20200528,05759P,智邦永豐96售02,,,,,0.00,0.00,0,0,0,0,0,0,0,0,0,0,0,0,0
20200528,057600,大立光群益99購03,,,,,0.00,0.00,0,0,0,0,0,0,0,0,0,0,0,0,0
20200528,057601,中磊群益98購01,1.43,1.43,1.32,1.32,0.00,0.00,150000,2,204600,0,0,0,0,0,0,0,150000,-150000,-150000
20200528,057602,聯茂群益98購02,0.57,0.66,0.57,0.66,0.00,0.00,216000,7,127470,0,0,0,0,0,0,0,216000,-216000,-216000
20200528,057603,樺漢群益98購02,0.90,0.95,0.90,0.95,+0.01,1.06,103000,3,96200,0,0,0,0,0,0,0,103000,-103000,-103000
20200528,057604,鴻海統一9C購01,1.10,1.10,1.08,1.08,-0.01,-0.92,7000,5,7680,0,0,0,0,0,0,7000,7000,0,0
20200528,057605,旺宏統一99購03,0.64,0.64,0.59,0.59,-0.04,-6.35,416000,7,259840,0,0,0,0,0,0,296000,120000,176000,176000
20200528,057606,健策統一98購03,1.19,1.19,1.03,1.05,-0.13,-11.02,173000,23,195090,0,0,0,0,0,0,98000,75000,23000,23000
20200528,057607,旺宏台新98購02,0.67,0.67,0.67,0.67,0.00,0.00,1000,1,670,0,0,0,0,0,0,0,1000,-1000,-1000
20200528,057608,南亞科台新98購01,,,,,0.00,0.00,0,0,0,0,0,0,0,0,0,0,0,0,0
20200528,057609,友訊元富98購01,0.95,0.96,0.91,0.94,-0.01,-1.05,556000,24,525480,0,0,0,0,0,0,128000,428000,-300000,-300000
20200528,05760P,京鼎永豐96售02,,,,,0.00,0.00,0,0,0,0,0,0,0,0,0,0,0,0,0
20200528,057610,致茂元富98購02,,,,,0.00,0.00,0,0,0,0,0,0,0,0,0,0,0,0,0
20200528,057611,技嘉元富98購02,,,,,0.00,0.00,0,0,0,0,0,0,0,0,0,0,0,0,0
20200528,057612,瑞昱元富02購01,2.19,2.21,2.14,2.21,+0.10,4.74,446000,23,974460,0,0,0,0,0,0,230000,226000,4000,4000
20200528,057613,瑞昱元富02購02,2.52,2.55,2.51,2.52,+0.09,3.7,154000,14,391390,0,0,0,0,0,0,13000,146000,-133000,-133000
20200528,057614,華新科元富99購04,0.76,0.77,0.76,0.77,0.00,0.00,115000,12,88350,0,0,0,0,0,0,21000,94000,-73000,-73000
20200528,057615,元油2X凱基98購02,,,,,0.00,0.00,0,0,0,0,0,0,0,0,0,0,0,0,0
20200528,057616,聯電凱基99購01,0.43,0.43,0.43,0.43,+0.03,7.5,233000,4,100190,0,0,0,0,0,0,233000,0,233000,233000
20200528,057617,國巨凱基99購06,,,,,0.00,0.00,0,0,0,0,0,0,0,0,0,0,0,0,0
20200528,057618,台光電凱基99購01,2.33,2.34,2.30,2.34,+0.03,1.3,14000,3,32350,0,0,0,0,0,0,11000,3000,8000,8000
20200528,057619,玉晶光凱基98購02,1.10,1.10,1.01,1.01,+0.03,3.06,30000,3,32400,0,0,0,0,0,0,25000,5000,20000,20000
20200528,05761P,嘉澤永豐96售01,,,,,0.00,0.00,0,0,0,0,0,0,0,0,0,0,0,0,0
20200528,057620,康控凱基99購01,,,,,0.00,0.00,0,0,0,0,0,0,0,0,0,0,0,0,0
20200528,057621,崇越凱基98購01,0.25,0.25,0.25,0.25,0.00,0.00,18000,2,4500,0,0,0,0,0,0,0,18000,-18000,-18000
20200528,057622,元油2X國泰99購03,,,,,0.00,0.00,0,0,0,0,0,0,0,0,0,0,0,0,0
20200528,057623,友訊國泰99購01,0.96,1.01,0.96,1.00,-0.03,-2.91,280000,11,277200,0,0,0,0,0,0,50000,230000,-180000,-180000
20200528,057624,新日興國泰99購01,1.03,1.13,1.03,1.03,+0.07,7.29,407000,13,440660,0,0,0,0,0,0,12000,395000,-383000,-383000
20200528,057625,泰鼎國泰9A購01,0.92,0.92,0.88,0.88,-0.01,-1.12,3000,2,2720,0,0,0,0,0,0,1000,0,1000,1000
20200528,057626,技嘉富邦9A購01,0.85,0.85,0.76,0.76,-0.10,-11.63,329000,30,262650,0,0,0,0,0,0,217000,104000,113000,113000
20200528,057627,和大永豐98購01,,,,,0.00,0.00,0,0,0,0,0,0,0,0,0,0,0,0,0
20200528,057628,旺宏永豐98購02,0.99,0.99,0.99,0.99,-0.11,-10.0,103000,1,101970,0,0,0,0,0,0,103000,0,103000,103000
20200528,057629,泰碩永豐98購02,2.17,2.19,1.99,1.99,-0.18,-8.29,103000,7,213190,0,0,0,0,0,0,96000,7000,89000,89000
20200528,05762P,昇陽半永豐96售04,,,,,0.00,0.00,0,0,0,0,0,0,0,0,0,0,0,0,0
20200528,057630,茂林永豐98購01,0.38,0.39,0.38,0.38,-0.20,-34.48,70000,12,26610,0,0,0,0,0,0,70000,0,70000,70000
20200528,057631,康控永豐98購02,,,,,0.00,0.00,0,0,0,0,0,0,0,0,0,0,0,0,0
20200528,057632,傳奇永豐98購01,0.16,0.16,0.12,0.13,0.00,0.00,615000,9,88300,0,0,0,0,0,0,305000,310000,-5000,-5000
20200528,057633,緯穎永豐98購02,1.09,1.09,0.86,0.86,-0.16,-15.69,51000,8,50260,0,0,0,0,0,0,31000,41000,-10000,-10000
20200528,057634,道瓊反元大99購01,,,,,0.00,0.00,0,0,0,0,0,0,0,0,0,0,0,0,0
20200528,057635,中鋼元大98購01,,,,,0.00,0.00,0,0,0,0,0,0,0,0,0,0,0,0,0
20200528,057636,上銀元大98購06,2.54,2.56,2.17,2.17,-0.35,-13.89,59000,6,145240,0,0,0,0,0,0,48000,11000,37000,37000
20200528,057637,上銀元大98購07,2.00,2.03,1.72,1.73,-0.16,-8.47,544000,21,980280,0,0,0,0,0,0,536000,8000,528000,528000
20200528,057638,上銀元大99購01,2.35,2.35,2.06,2.07,-0.20,-8.81,85000,13,190180,0,1000,-1000,0,0,0,55000,30000,25000,24000
20200528,057639,國巨元大99購07,1.38,1.38,1.38,1.38,0.00,0.00,5000,1,6900,0,0,0,0,0,0,5000,0,5000,5000
20200528,05763P,致新永豐96售01,,,,,0.00,0.00,0,0,0,0,0,0,0,0,0,0,0,0,0
20200528,057640,台積電元大98購16,1.23,1.23,1.23,1.23,-0.10,-7.52,4000,1,4920,0,0,0,0,0,0,4000,0,4000,4000
20200528,057641,旺宏元大98購10,1.45,1.49,1.32,1.32,-0.15,-10.2,154000,14,222050,0,0,0,0,0,0,53000,154000,-101000,-101000
20200528,057642,南亞科元大98購07,,,,,0.00,0.00,0,0,0,0,0,0,0,0,0,0,0,0,0
20200528,057643,聯發科元大99購03,,,,,0.00,0.00,0,0,0,0,0,0,0,0,0,0,0,0,0
20200528,057644,奇力新元大98購04,,,,,0.00,0.00,0,0,0,0,0,0,0,0,0,0,0,0,0
20200528,057645,華新科元大99購11,,,,,0.00,0.00,0,0,0,0,0,0,0,0,0,0,0,0,0
20200528,057646,玉山金元大98購01,2.28,2.28,2.26,2.26,-0.05,-2.16,109000,5,247720,0,0,0,0,0,0,59000,51000,8000,8000
20200528,057647,欣興元大98購10,1.62,1.78,1.62,1.73,+0.08,4.85,292000,7,500800,0,0,0,0,0,0,16000,277000,-261000,-261000
20200528,057648,和碩元大98購01,1.36,1.36,1.35,1.35,0.00,0.00,15000,2,20300,0,0,0,0,0,0,0,15000,-15000,-15000
20200528,057649,嘉聯益元大99購04,1.07,1.18,1.07,1.10,+0.05,4.76,388000,10,442040,0,0,0,0,0,0,70000,320000,-250000,-250000
20200528,05764P,世紀鋼永豐96售03,,,,,0.00,0.00,0,0,0,0,0,0,0,0,0,0,0,0,0
20200528,057650,力成元大98購04,1.21,1.21,1.09,1.10,-0.11,-9.09,139000,4,160210,0,0,0,0,0,0,71000,68000,3000,3000
20200528,057651,矽力元大98購03,8.10,8.95,8.10,8.40,+0.60,7.69,102000,12,866250,0,0,0,0,0,0,37000,65000,-28000,-28000
20200528,057652,欣興永昌9C購01,,,,,0.00,0.00,0,0,0,0,0,0,0,0,0,0,0,0,0
20200528,057653,臺股指永昌98購01,,,,,0.00,0.00,0,0,0,0,0,0,0,0,0,0,0,0,0
20200528,057654,A50正2中信98購01,,,,,0.00,0.00,0,0,0,0,0,0,0,0,0,0,0,0,0
20200528,057655,奇力新中信98購05,,,,,0.00,0.00,0,0,0,0,0,0,0,0,0,0,0,0,0
20200528,057656,大成鋼兆豐98購01,0.57,0.68,0.57,0.66,+0.09,15.79,882000,22,543940,0,0,0,0,0,0,0,882000,-882000,-882000
20200528,057657,國巨兆豐98購04,,,,,0.00,0.00,0,0,0,0,0,0,0,0,0,0,0,0,0
20200528,057658,玉晶光兆豐99購02,0.73,0.75,0.71,0.71,+0.03,4.41,20000,4,14600,0,0,0,0,0,0,0,20000,-20000,-20000
20200528,057659,台表科兆豐98購01,1.01,1.01,1.01,1.01,-0.20,-16.53,5000,1,5050,0,0,0,0,0,0,0,5000,-5000,-5000
20200528,05765P,臺股指永豐96售01,,,,,0.00,0.00,0,0,0,0,0,0,0,0,0,0,0,0,0
20200528,057660,訊芯兆豐98購02,,,,,0.00,0.00,0,0,0,0,0,0,0,0,0,0,0,0,0
20200528,057661,臺股指兆豐98購01,,,,,0.00,0.00,0,0,0,0,0,0,0,0,0,0,0,0,0
20200528,057662,上銀元大9A購01,2.69,2.75,2.41,2.41,-0.17,-6.59,105000,11,283770,0,0,0,0,0,0,104000,1000,103000,103000
20200528,057663,國巨元大99購08,,,,,0.00,0.00,0,0,0,0,0,0,0,0,0,0,0,0,0
20200528,057664,台積電元大9A購03,,,,,0.00,0.00,0,0,0,0,0,0,0,0,0,0,0,0,0
20200528,057665,技嘉元大99購01,3.32,3.32,3.03,3.03,-0.27,-8.18,94000,5,297600,0,0,0,0,0,0,40000,56000,-16000,-16000
20200528,057666,奇力新元大9A購01,,,,,0.00,0.00,0,0,0,0,0,0,0,0,0,0,0,0,0
20200528,057667,可成元大99購01,1.40,1.40,1.33,1.33,-0.02,-1.48,90000,2,123900,0,0,0,0,0,0,30000,60000,-30000,-30000
20200528,057668,華新科元大9A購01,,,,,0.00,0.00,0,0,0,0,0,0,0,0,0,0,0,0,0
20200528,057669,嘉晶元大99購03,,,,,0.00,0.00,0,0,0,0,0,0,0,0,0,0,0,0,0
20200528,05766P,A50正2凱基99售01,,,,,0.00,0.00,0,0,0,0,0,0,0,0,0,0,0,0,0
20200528,057670,欣興元大99購02,2.62,2.85,2.62,2.64,0.00,0.00,364000,23,1000960,0,0,0,0,0,0,12000,350000,-338000,-338000
20200528,057671,群創元大9B購06,,,,,0.00,0.00,0,0,0,0,0,0,0,0,0,0,0,0,0
20200528,057672,茂林元大98購02,2.25,2.25,2.08,2.11,-0.09,-4.09,66000,6,141910,0,0,0,0,0,0,66000,0,66000,66000
20200528,057673,臻鼎元大98購01,1.05,1.05,1.05,1.05,-0.21,-16.67,1000,1,1050,0,0,0,0,0,0,1000,0,1000,1000
20200528,057674,台郡元大99購03,0.87,0.87,0.84,0.84,-0.04,-4.55,323000,9,277770,0,0,0,0,0,0,157000,180000,-23000,-23000
20200528,057675,同欣電元大98購02,1.05,1.06,0.99,0.99,-0.04,-3.88,269000,20,276810,0,0,0,0,0,0,124000,145000,-21000,-21000
20200528,057676,臺股指元大98購06,,,,,0.00,0.00,0,0,0,0,0,0,0,0,0,0,0,0,0
20200528,057677,臺股指元大98購07,0.16,0.16,0.16,0.16,+0.02,14.29,10000,1,1600,0,0,0,0,0,0,10000,0,10000,10000
20200528,057678,臺股指元大98購08,,,,,0.00,0.00,0,0,0,0,0,0,0,0,0,0,0,0,0
20200528,057679,臺股指元大98購09,,,,,0.00,0.00,0,0,0,0,0,0,0,0,0,0,0,0,0
20200528,05767P,國巨凱基96售11,,,,,0.00,0.00,0,0,0,0,0,0,0,0,0,0,0,0,0
20200528,057680,臺股指元大98購10,,,,,0.00,0.00,0,0,0,0,0,0,0,0,0,0,0,0,0
20200528,057681,T50反1日盛9C購01,,,,,0.00,0.00,0,0,0,0,0,0,0,0,0,0,0,0,0
20200528,057682,台積電日盛9A購03,0.24,0.24,0.21,0.21,-0.05,-19.23,99000,11,21560,0,0,0,0,0,0,94000,99000,-5000,-5000
20200528,057683,技嘉日盛98購01,2.57,2.57,2.44,2.44,-0.83,-25.38,66000,2,168970,0,0,0,0,0,0,66000,0,66000,66000
20200528,057684,聯茂日盛99購01,1.32,1.36,1.32,1.36,0.00,0.00,170000,10,228020,0,0,0,0,0,0,0,170000,-170000,-170000
20200528,057685,台灣50凱基9C購01,,,,,0.00,0.00,0,0,0,0,0,0,0,0,0,0,0,0,0
20200528,057686,中50凱基99購01,,,,,0.00,0.00,0,0,0,0,0,0,0,0,0,0,0,0,0
20200528,057687,中502X凱基98購01,,,,,0.00,0.00,0,0,0,0,0,0,0,0,0,0,0,0,0
20200528,057688,國巨凱基99購07,,,,,0.00,0.00,0,0,0,0,0,0,0,0,0,0,0,0,0
20200528,057689,南亞科凱基99購02,0.71,0.71,0.63,0.63,0.00,0.00,229000,12,159030,0,0,0,0,0,0,0,229000,-229000,-229000
20200528,05768P,台積電凱基96售15,,,,,0.00,0.00,0,0,0,0,0,0,0,0,0,0,0,0,0
20200528,057690,美律凱基99購03,1.16,1.18,1.15,1.18,+0.03,2.61,72000,3,84910,0,0,0,0,0,0,2000,70000,-68000,-68000
20200528,057691,健策凱基99購01,1.67,1.73,1.49,1.49,-0.10,-6.29,109000,11,180810,0,0,0,0,0,0,109000,0,109000,109000
20200528,057692,臺股指凱基98購10,,,,,0.00,0.00,0,0,0,0,0,0,0,0,0,0,0,0,0
20200528,057693,臺股指凱基98購11,0.18,0.18,0.13,0.13,0.00,0.00,21000,3,3730,0,0,0,0,0,0,20000,0,20000,20000
20200528,057694,臺股指凱基98購12,0.11,0.11,0.11,0.11,0.00,0.00,11000,1,1210,0,0,0,0,0,0,11000,0,11000,11000
20200528,057695,S&P反1群益9B購01,,,,,0.00,0.00,0,0,0,0,0,0,0,0,0,0,0,0,0
20200528,057696,聯電群益9A購01,0.18,0.19,0.18,0.18,0.00,0.00,780000,15,146000,0,0,0,0,0,0,20000,760000,-740000,-740000
20200528,057697,國巨群益98購09,0.16,0.16,0.16,0.16,0.00,0.00,30000,1,4800,0,0,0,0,0,0,0,30000,-30000,-30000
20200528,057698,奇力新群益98購02,,,,,0.00,0.00,0,0,0,0,0,0,0,0,0,0,0,0,0
20200528,057699,可成群益9A購02,1.30,1.30,1.22,1.23,-0.01,-0.81,41000,5,51170,0,0,0,0,0,0,20000,21000,-1000,-1000
20200528,05769P,台積電凱基96售16,,,,,0.00,0.00,0,0,0,0,0,0,0,0,0,0,0,0,0
20200528,057700,新日興群益9A購01,1.28,1.41,1.28,1.28,+0.07,5.79,132000,9,182680,0,0,0,0,0,0,4000,128000,-124000,-124000
20200528,057701,嘉聯益群益98購02,,,,,0.00,0.00,0,0,0,0,0,0,0,0,0,0,0,0,0
20200528,057702,同欣電群益99購01,,,,,0.00,0.00,0,0,0,0,0,0,0,0,0,0,0,0,0
20200528,057703,矽力群益98購01,2.26,2.45,2.13,2.45,+0.42,20.69,26000,6,58770,0,0,0,0,0,0,26000,0,26000,26000
20200528,057704,台虹群益98購03,1.48,1.49,1.35,1.35,-0.19,-12.34,903000,29,1325570,0,0,0,0,0,0,878000,177000,701000,701000
20200528,057705,臺股指群益98購05,1.60,1.62,1.32,1.37,-0.13,-8.67,119000,16,170160,0,0,0,0,0,0,7000,112000,-105000,-105000
20200528,057706,臺股指群益98購06,,,,,0.00,0.00,0,0,0,0,0,0,0,0,0,0,0,0,0
20200528,057707,臺股指群益98購07,2.00,2.01,1.74,1.74,-0.08,-4.4,206000,12,375170,0,0,0,0,0,0,41000,165000,-124000,-124000
20200528,057708,臺股指群益98購08,1.12,1.13,0.97,0.97,0.00,0.00,49000,5,52560,0,0,0,0,0,0,39000,10000,29000,29000
20200528,057709,電子類群益98購01,,,,,0.00,0.00,0,0,0,0,0,0,0,0,0,0,0,0,0
20200528,05770P,聯發科凱基96售16,,,,,0.00,0.00,0,0,0,0,0,0,0,0,0,0,0,0,0
20200528,057710,金融類群益98購01,,,,,0.00,0.00,0,0,0,0,0,0,0,0,0,0,0,0,0
20200528,057711,台積電統一9A購03,,,,,0.00,0.00,0,0,0,0,0,0,0,0,0,0,0,0,0
20200528,057712,南亞科統一9A購01,0.93,0.95,0.86,0.86,0.00,0.00,73000,4,66850,0,0,0,0,0,0,1000,72000,-71000,-71000
20200528,057713,美律統一99購01,,,,,0.00,0.00,0,0,0,0,0,0,0,0,0,0,0,0,0
20200528,057714,聯發科統一98購05,3.15,3.15,3.15,3.15,+0.07,2.27,29000,1,91350,0,0,0,0,0,0,29000,0,29000,29000
20200528,057715,聯發科統一99購03,,,,,0.00,0.00,0,0,0,0,0,0,0,0,0,0,0,0,0
20200528,057716,神達統一98購01,1.00,1.00,1.00,1.00,+0.02,2.04,65000,2,65000,0,0,0,0,0,0,15000,50000,-35000,-35000
20200528,057717,友訊元富98購02,0.81,0.83,0.78,0.78,-0.04,-4.88,532000,19,430270,0,0,0,0,0,0,128000,404000,-276000,-276000
20200528,057718,旺宏元富02購02,1.10,1.11,1.02,1.02,-0.09,-8.11,181000,17,194940,0,0,0,0,0,0,131000,50000,81000,81000
20200528,057719,欣興元富02購01,1.83,1.99,1.82,1.88,+0.08,4.44,422000,23,797970,0,0,0,0,0,0,13000,408000,-395000,-395000
20200528,05771P,大立光凱基96售13,,,,,0.00,0.00,0,0,0,0,0,0,0,0,0,0,0,0,0
20200528,057720,日電貿元富98購01,1.45,1.46,1.35,1.36,-0.07,-4.9,460000,19,646330,0,0,0,0,0,0,362000,98000,264000,264000
20200528,057721,華擎元富98購02,2.45,2.49,2.19,2.19,-0.18,-7.59,291000,14,683360,0,0,0,0,0,0,109000,182000,-73000,-73000
20200528,057722,臺股指元富98購01,,,,,0.00,0.00,0,0,0,0,0,0,0,0,0,0,0,0,0
20200528,057723,臺股指元富98購02,,,,,0.00,0.00,0,0,0,0,0,0,0,0,0,0,0,0,0
20200528,057724,亞德客國泰99購01,2.24,2.34,1.93,1.98,-0.17,-7.91,748000,102,1626580,0,0,0,0,0,0,493000,292000,201000,201000
20200528,057725,台達電國泰9A購01,1.32,1.32,1.23,1.23,-0.09,-6.82,190000,7,237000,0,0,0,0,0,0,106000,84000,22000,22000
20200528,057726,華通國泰9A購01,,,,,0.00,0.00,0,0,0,0,0,0,0,0,0,0,0,0,0
20200528,057727,華邦電國泰9A購01,1.46,1.57,1.20,1.21,-0.05,-3.97,1001000,74,1484640,0,0,0,0,0,0,776000,275000,501000,501000
20200528,057728,瑞昱國泰99購01,,,,,0.00,0.00,0,0,0,0,0,0,0,0,0,0,0,0,0
20200528,057729,華新科國泰99購04,0.98,0.98,0.97,0.97,-0.02,-2.02,80000,32,78000,0,0,0,0,0,0,50000,30000,20000,20000
20200528,05772P,景碩凱基96售02,,,,,0.00,0.00,0,0,0,0,0,0,0,0,0,0,0,0,0
20200528,057730,聯鈞國泰9A購01,1.04,1.08,1.02,1.02,-0.01,-0.97,419000,13,446480,0,0,0,0,0,0,229000,190000,39000,39000
20200528,057731,華擎國泰9A購02,,,,,0.00,0.00,0,0,0,0,0,0,0,0,0,0,0,0,0
20200528,057732,牧德國泰9A購01,,,,,0.00,0.00,0,0,0,0,0,0,0,0,0,0,0,0,0
20200528,057733,嘉聯益國泰99購01,0.84,0.96,0.84,0.96,+0.13,15.66,287000,14,258800,0,0,0,0,0,0,0,287000,-287000,-287000
20200528,057734,訊芯國泰9A購01,,,,,0.00,0.00,0,0,0,0,0,0,0,0,0,0,0,0,0
20200528,057735,台灣50富邦9C購02,1.13,1.13,1.13,1.13,-0.23,-16.91,28000,1,31640,0,0,0,0,0,0,28000,0,28000,28000
20200528,057736,鴻海富邦99購04,1.93,1.95,1.92,1.92,+0.01,0.52,165000,11,318600,0,0,0,0,0,0,165000,0,165000,165000
20200528,057737,國巨富邦99購02,0.16,0.16,0.16,0.16,0.00,0.00,20000,3,3200,0,0,0,0,0,0,0,0,0,0
20200528,057738,旺宏富邦9A購01,0.53,0.53,0.49,0.49,-0.03,-5.77,68000,5,35180,0,0,0,0,0,0,22000,46000,-24000,-24000
20200528,057739,新日興富邦9B購01,0.54,0.60,0.53,0.55,+0.04,7.84,545000,53,310210,0,0,0,0,0,0,365000,487000,-122000,-122000
20200528,05773P,臺股指凱基99售03,,,,,0.00,0.00,0,0,0,0,0,0,0,0,0,0,0,0,0
20200528,057740,茂林富邦9A購01,0.45,0.45,0.42,0.42,-0.04,-8.7,207000,43,89760,0,0,0,0,0,0,199000,5000,194000,194000
20200528,057741,超眾富邦98購01,,,,,0.00,0.00,0,0,0,0,0,0,0,0,0,0,0,0,0
20200528,057742,喬山永豐98購02,0.86,0.86,0.77,0.77,-0.14,-15.38,71000,2,56110,0,0,0,0,0,0,71000,0,71000,71000
20200528,057743,華擎永豐98購03,1.00,1.03,0.97,0.97,0.00,0.00,32000,4,32050,0,0,0,0,0,0,22000,10000,12000,12000
20200528,057744,健策永豐98購02,1.80,1.81,1.73,1.73,-0.11,-5.98,74000,3,131440,0,0,0,0,0,0,74000,0,74000,74000
20200528,057745,泰鼎永豐99購01,0.99,1.01,0.89,0.89,-0.07,-7.29,115000,14,108800,0,0,0,0,0,0,30000,85000,-55000,-55000
20200528,057746,同欣電永豐98購02,0.27,0.27,0.27,0.27,-0.02,-6.9,100000,1,27000,0,0,0,0,0,0,0,100000,-100000,-100000
20200528,057747,致新永豐98購01,1.32,1.50,1.31,1.48,+0.12,8.82,372000,57,526320,0,0,0,0,0,0,105000,267000,-162000,-162000
20200528,057748,華通國票98購04,2.29,2.67,2.29,2.41,+0.27,12.62,266000,15,664200,0,0,0,0,0,0,111000,157000,-46000,-46000
20200528,057749,華新科國票99購01,,,,,0.00,0.00,0,0,0,0,0,0,0,0,0,0,0,0,0
20200528,05774P,臺股指凱基99售04,,,,,0.00,0.00,0,0,0,0,0,0,0,0,0,0,0,0,0
20200528,057750,神達國票99購01,,,,,0.00,0.00,0,0,0,0,0,0,0,0,0,0,0,0,0
20200528,057751,神達國票99購02,2.41,2.41,2.41,2.41,+0.02,0.84,1000,1,2410,0,0,0,0,0,0,1000,0,1000,1000
20200528,057752,臺股指國票98購08,1.49,1.49,1.26,1.26,-0.12,-8.7,32000,5,42230,0,0,0,0,0,0,15000,17000,-2000,-2000
20200528,057753,臺股指國票98購09,,,,,0.00,0.00,0,0,0,0,0,0,0,0,0,0,0,0,0
20200528,057754,臺股指國票98購10,,,,,0.00,0.00,0,0,0,0,0,0,0,0,0,0,0,0,0
20200528,057755,鴻海日盛98購01,0.24,0.24,0.24,0.24,0.00,0.00,6000,1,1440,0,0,0,0,0,0,0,6000,-6000,-6000
20200528,057756,瑞昱日盛99購01,,,,,0.00,0.00,0,0,0,0,0,0,0,0,0,0,0,0,0
20200528,057757,鴻海凱基98購13,,,,,0.00,0.00,0,0,0,0,0,0,0,0,0,0,0,0,0
20200528,057758,鴻海凱基99購03,2.75,2.75,2.68,2.68,-0.06,-2.19,14000,7,38360,0,0,0,0,0,0,14000,14000,0,0
20200528,057759,聯發科凱基98購17,,,,,0.00,0.00,0,0,0,0,0,0,0,0,0,0,0,0,0
20200528,05775P,台積電國泰98售02,,,,,0.00,0.00,0,0,0,0,0,0,0,0,0,0,0,0,0
20200528,057760,聯發科凱基98購18,4.72,4.72,4.45,4.45,-0.17,-3.68,119000,9,545170,0,0,0,0,0,0,119000,0,119000,119000
20200528,057761,聯發科凱基99購04,,,,,0.00,0.00,0,0,0,0,0,0,0,0,0,0,0,0,0
20200528,057762,全新凱基99購03,,,,,0.00,0.00,0,0,0,0,0,0,0,0,0,0,0,0,0
20200528,057763,康控凱基99購02,0.32,0.32,0.32,0.32,0.00,0.00,10000,1,3200,0,0,0,0,0,0,0,10000,-10000,-10000
20200528,057764,台表科凱基9A購01,,,,,0.00,0.00,0,0,0,0,0,0,0,0,0,0,0,0,0
20200528,057765,康舒凱基98購01,0.23,0.23,0.23,0.23,0.00,0.00,10000,1,2300,0,0,0,0,0,0,0,10000,-10000,-10000
20200528,057766,矽力凱基98購03,4.61,4.97,4.61,4.93,+0.46,10.29,74000,21,348760,0,0,0,0,0,0,40000,13000,27000,27000
20200528,057767,緯穎凱基98購06,2.02,2.11,1.98,2.11,+0.12,6.03,96000,12,197780,0,0,0,0,0,0,95000,1000,94000,94000
20200528,057768,華新科中信9A購01,0.15,0.15,0.15,0.15,-0.02,-11.76,100000,1,15000,0,0,0,0,0,0,0,100000,-100000,-100000
20200528,057769,T50反1群益98購02,,,,,0.00,0.00,0,0,0,0,0,0,0,0,0,0,0,0,0
20200528,05776P,鴻海統一98售02,,,,,0.00,0.00,0,0,0,0,0,0,0,0,0,0,0,0,0
20200528,057770,亞德客群益98購01,2.07,2.07,2.07,2.07,-0.20,-8.81,57000,1,117990,0,0,0,0,0,0,57000,0,57000,57000
20200528,057771,鴻海群益99購01,,,,,0.00,0.00,0,0,0,0,0,0,0,0,0,0,0,0,0
20200528,057772,台積電群益99購01,0.96,0.96,0.89,0.89,-0.09,-9.18,2000,2,1850,0,0,0,0,0,0,0,2000,-2000,-2000
20200528,057773,技嘉群益9A購02,2.58,2.63,2.38,2.38,-0.35,-12.82,447000,12,1108070,0,0,0,0,0,0,218000,231000,-13000,-13000
20200528,057774,台光電群益99購02,5.35,5.35,5.35,5.35,-0.80,-13.01,2000,1,10700,0,0,0,0,0,0,2000,0,2000,2000
20200528,057775,南亞科群益98購02,0.43,0.44,0.40,0.40,+0.01,2.56,43000,5,18680,0,0,0,0,0,0,6000,37000,-31000,-31000
20200528,057776,京元電群益98購02,1.23,1.23,1.15,1.15,-0.09,-7.26,135000,4,161370,0,0,0,0,0,0,93000,42000,51000,51000
20200528,057777,可成群益9A購03,1.09,1.09,1.09,1.09,-0.05,-4.39,100000,1,109000,0,0,0,0,0,0,0,100000,-100000,-100000
20200528,057778,大立光群益98購02,,,,,0.00,0.00,0,0,0,0,0,0,0,0,0,0,0,0,0
20200528,057779,禾伸堂群益98購02,2.97,2.97,2.97,2.97,+0.02,0.68,25000,1,74250,0,0,0,0,0,0,25000,0,25000,25000
20200528,05777P,台積電統一96售04,,,,,0.00,0.00,0,0,0,0,0,0,0,0,0,0,0,0,0
20200528,057780,台郡群益98購02,1.38,1.41,1.35,1.35,-0.05,-3.57,137000,6,188070,0,0,0,0,0,0,122000,15000,107000,107000
20200528,057781,國巨國票99購04,,,,,0.00,0.00,0,0,0,0,0,0,0,0,0,0,0,0,0
20200528,057782,台積電國票99購07,,,,,0.00,0.00,0,0,0,0,0,0,0,0,0,0,0,0,0
20200528,057783,台積電國票9A購01,,,,,0.00,0.00,0,0,0,0,0,0,0,0,0,0,0,0,0
20200528,057784,台積電國票9B購01,,,,,0.00,0.00,0,0,0,0,0,0,0,0,0,0,0,0,0
20200528,057785,智邦國票99購02,14.40,14.40,14.40,14.40,0.00,0.00,40000,1,576000,0,0,0,0,0,0,0,40000,-40000,-40000
20200528,057786,聯發科國票98購05,,,,,0.00,0.00,0,0,0,0,0,0,0,0,0,0,0,0,0
20200528,057787,TPK國票99購01,1.85,1.94,1.66,1.66,-0.17,-9.29,321000,15,584100,0,0,0,0,0,0,126000,195000,-69000,-69000
20200528,057788,嘉聯益國票99購01,0.95,0.95,0.95,0.95,0.00,0.00,40000,2,38000,0,0,0,0,0,0,0,40000,-40000,-40000
20200528,057789,上銀統一9A購01,1.89,1.89,1.85,1.85,-0.15,-7.5,98000,3,185140,0,0,0,0,0,0,96000,2000,94000,94000
20200528,05778P,台積電統一96售05,,,,,0.00,0.00,0,0,0,0,0,0,0,0,0,0,0,0,0
20200528,057790,台積電統一99購04,1.15,1.15,1.15,1.15,-0.05,-4.17,4000,2,4600,0,0,0,0,0,0,4000,4000,0,0
20200528,057791,可成統一99購01,0.39,0.39,0.36,0.36,-0.01,-2.7,21000,3,7790,0,0,0,0,0,0,11000,10000,1000,1000
20200528,057792,群創統一99購01,0.18,0.18,0.18,0.18,0.00,0.00,20000,1,3600,0,0,0,0,0,0,20000,0,20000,20000
20200528,057793,群創統一99購02,,,,,0.00,0.00,0,0,0,0,0,0,0,0,0,0,0,0,0
20200528,057794,T50反1兆豐99購02,0.61,0.65,0.61,0.63,+0.04,6.78,86000,6,53460,0,0,0,0,0,0,60000,11000,49000,49000
20200528,057795,鴻海兆豐99購02,,,,,0.00,0.00,0,0,0,0,0,0,0,0,0,0,0,0,0
20200528,057796,鴻海兆豐99購03,0.28,0.28,0.28,0.28,0.00,0.00,10000,1,2800,0,0,0,0,0,0,0,10000,-10000,-10000
20200528,057797,大立光兆豐99購01,,,,,0.00,0.00,0,0,0,0,0,0,0,0,0,0,0,0,0
20200528,057798,貿聯兆豐99購01,0.79,0.82,0.76,0.76,-0.02,-2.56,906000,35,724090,0,0,0,0,0,0,360000,546000,-186000,-186000
20200528,057799,世紀鋼兆豐98購01,1.35,1.68,1.35,1.55,+0.35,29.17,51000,10,80700,0,0,0,0,0,0,30000,20000,10000,10000
20200528,05779P,台積電統一96售06,,,,,0.00,0.00,0,0,0,0,0,0,0,0,0,0,0,0,0
20200528,057800,元油2X元大98購18,,,,,0.00,0.00,0,0,0,0,0,0,0,0,0,0,0,0,0
20200528,057801,元油2X元大98購19,,,,,0.00,0.00,0,0,0,0,0,0,0,0,0,0,0,0,0
20200528,057802,卜蜂元大98購01,2.92,3.06,2.90,2.90,-0.11,-3.65,42000,9,123470,0,0,0,0,0,0,17000,11000,6000,6000
20200528,057803,上銀元大98購08,2.11,2.23,2.11,2.15,+0.07,3.37,78000,3,166100,0,0,0,0,0,0,23000,55000,-32000,-32000
20200528,057804,為升元大98購01,0.87,0.87,0.79,0.79,-0.09,-10.23,379000,10,310390,0,0,0,0,0,0,170000,209000,-39000,-39000
20200528,057805,華通元大98購06,2.74,3.09,2.74,2.95,+0.35,13.46,58000,10,171990,0,0,0,0,0,0,24000,38000,-14000,-14000
20200528,057806,國巨元大98購20,,,,,0.00,0.00,0,0,0,0,0,0,0,0,0,0,0,0,0
20200528,057807,友訊元大98購02,1.37,1.37,1.37,1.37,0.00,0.00,2000,1,2740,0,0,0,0,0,0,2000,0,2000,2000
20200528,057808,旺宏元大99購05,1.28,1.28,1.17,1.17,-0.07,-5.65,11000,2,12980,0,0,0,0,0,0,10000,1000,9000,9000
20200528,057809,英業達元大98購01,2.32,2.32,2.20,2.20,-0.09,-3.93,150000,9,337060,0,0,0,0,0,0,100000,50000,50000,50000
20200528,05780P,台積電統一96售07,,,,,0.00,0.00,0,0,0,0,0,0,0,0,0,0,0,0,0
20200528,057810,技嘉元大98購06,2.05,2.06,1.96,1.96,-0.17,-7.98,71000,5,141070,0,0,0,0,0,0,67000,4000,63000,63000
20200528,057811,南亞科元大98購08,,,,,0.00,0.00,0,0,0,0,0,0,0,0,0,0,0,0,0
20200528,057812,友達元大9A購05,0.49,0.49,0.47,0.47,-0.01,-2.08,10000,2,4800,0,0,0,0,0,0,0,10000,-10000,-10000
20200528,057813,京元電元大98購03,0.64,0.64,0.63,0.64,-0.01,-1.54,167000,3,106380,0,0,0,0,0,0,167000,99000,68000,68000
20200528,057814,聯發科元大98購12,3.84,3.84,3.84,3.84,0.00,0.00,1000,1,3840,0,0,0,0,0,0,0,1000,-1000,-1000
20200528,057815,信邦元大98購01,2.58,2.67,2.55,2.58,-0.05,-1.9,179000,7,469620,0,0,0,0,0,0,33000,146000,-113000,-113000
20200528,057816,欣興元大98購13,1.72,1.94,1.72,1.80,+0.02,1.12,490000,15,896360,0,0,0,0,0,0,35000,456000,-421000,-421000
20200528,057817,景碩元大98購01,1.49,1.57,1.49,1.49,-0.01,-0.67,256000,8,393220,0,0,0,0,0,0,82000,174000,-92000,-92000
20200528,057818,泰碩元大9A購01,2.50,2.50,2.47,2.47,-0.22,-8.18,90000,5,223680,0,0,0,0,0,0,90000,90000,0,0
20200528,057819,新日興元大99購01,1.82,2.02,1.82,1.96,+0.34,20.99,226000,10,429630,0,0,0,0,0,0,60000,166000,-106000,-106000
20200528,05781P,臺股指統一99售02,,,,,0.00,0.00,0,0,0,0,0,0,0,0,0,0,0,0,0
20200528,057820,華擎元大98購02,1.95,1.95,1.95,1.95,+0.05,2.63,11000,1,21450,0,0,0,0,0,0,0,11000,-11000,-11000
20200528,057821,晶相光元大98購03,0.57,0.57,0.56,0.56,-0.04,-6.67,50000,4,28100,0,0,0,0,0,0,50000,0,50000,50000
20200528,057822,牧德元大9A購01,,,,,0.00,0.00,0,0,0,0,0,0,0,0,0,0,0,0,0
20200528,057823,神達元大98購01,,,,,0.00,0.00,0,0,0,0,0,0,0,0,0,0,0,0,0
20200528,057824,日月光元大98購01,1.16,1.16,1.10,1.10,-0.05,-4.35,187000,9,213590,0,0,0,0,0,0,117000,70000,47000,47000
20200528,057825,和碩元大98購02,,,,,0.00,0.00,0,0,0,0,0,0,0,0,0,0,0,0,0
20200528,057826,祥碩元大98購08,3.86,4.41,3.86,4.41,+0.32,7.82,71000,6,289710,0,0,0,0,0,0,32000,71000,-39000,-39000
20200528,057827,康友元大98購03,0.34,0.34,0.34,0.34,-0.01,-2.86,68000,1,23120,0,0,0,0,0,0,0,68000,-68000,-68000
20200528,057828,緯穎元大99購02,3.72,3.77,3.47,3.47,-0.13,-3.61,126000,13,459030,0,0,0,0,0,0,91000,35000,56000,56000
20200528,057829,臺股指元大98購12,,,,,0.00,0.00,0,0,0,0,0,0,0,0,0,0,0,0,0
20200528,05782P,聯詠元富96售02,,,,,0.00,0.00,0,0,0,0,0,0,0,0,0,0,0,0,0
20200528,057830,T50反1台新02購02,,,,,0.00,0.00,0,0,0,0,0,0,0,0,0,0,0,0,0
20200528,057831,聯發科元富02購04,3.57,3.57,3.48,3.48,-0.14,-3.87,128000,7,449590,0,0,0,0,0,0,83000,45000,38000,38000
20200528,057832,聯發科元富02購05,4.63,4.63,4.51,4.51,-0.04,-0.88,29000,2,131150,0,0,0,0,0,0,3000,26000,-23000,-23000
20200528,057833,聯發科元富02購06,4.36,4.36,4.08,4.08,-0.20,-4.67,62000,4,263880,0,0,0,0,0,0,34000,28000,6000,6000
20200528,057834,聯發科元富02購07,5.15,5.15,4.93,4.93,-0.07,-1.4,19000,3,95030,0,0,0,0,0,0,3000,16000,-13000,-13000
20200528,057835,華擎元富9B購01,3.20,3.24,2.91,2.91,-0.13,-4.28,317000,19,983220,0,0,0,0,0,0,126000,192000,-66000,-66000
20200528,057836,南亞科國泰9A購01,0.92,0.92,0.91,0.91,+0.12,15.19,121000,2,110820,0,0,0,0,0,0,71000,50000,21000,21000
20200528,057837,康控國泰99購02,,,,,0.00,0.00,0,0,0,0,0,0,0,0,0,0,0,0,0
20200528,057838,台郡國泰99購01,0.87,0.87,0.87,0.87,-0.01,-1.14,138000,2,120060,0,0,0,0,0,0,0,138000,-138000,-138000
20200528,057839,台積電富邦9A購02,,,,,0.00,0.00,0,0,0,0,0,0,0,0,0,0,0,0,0
20200528,05783P,嘉澤元富96售01,,,,,0.00,0.00,0,0,0,0,0,0,0,0,0,0,0,0,0
20200528,057840,健策富邦99購01,,,,,0.00,0.00,0,0,0,0,0,0,0,0,0,0,0,0,0
20200528,057841,茂林富邦9A購02,0.41,0.41,0.40,0.40,0.00,0.00,120000,39,49180,0,0,0,0,0,0,120000,0,120000,120000
20200528,057842,緯穎富邦99購02,0.84,0.84,0.84,0.84,0.00,0.00,10000,1,8400,0,0,0,0,0,0,0,10000,-10000,-10000
20200528,057843,晶技永豐98購02,4.10,4.16,4.07,4.16,-0.29,-6.52,44000,13,181240,0,0,0,0,0,0,44000,0,44000,44000
20200528,057844,新日興永豐99購01,0.17,0.18,0.16,0.17,+0.02,13.33,36000,4,6380,0,0,0,0,0,0,0,36000,-36000,-36000
20200528,057845,晶相光永豐98購03,0.09,0.09,0.09,0.09,0.00,0.00,10000,1,900,0,0,0,0,0,0,0,10000,-10000,-10000
20200528,057846,神達永豐98購01,0.26,0.26,0.26,0.26,0.00,0.00,100000,1,26000,0,0,0,0,0,0,0,100000,-100000,-100000
20200528,057847,聯茂永豐98購01,0.20,0.20,0.19,0.19,0.00,0.00,110000,3,20960,0,0,0,0,0,0,100000,10000,90000,90000
20200528,057848,台表科永豐98購02,0.42,0.42,0.42,0.42,+0.01,2.44,10000,1,4200,0,0,0,0,0,0,10000,0,10000,10000
20200528,057849,南茂永豐98購02,1.02,1.02,1.02,1.02,-0.03,-2.86,10000,2,10200,0,0,0,0,0,0,10000,0,10000,10000
20200528,05784P,臺股指元大96售18,,,,,0.00,0.00,0,0,0,0,0,0,0,0,0,0,0,0,0
20200528,057850,上銀兆豐99購02,0.59,0.59,0.59,0.59,0.00,0.00,10000,1,5900,0,0,0,0,0,0,0,10000,-10000,-10000
20200528,057851,鴻海國票99購06,,,,,0.00,0.00,0,0,0,0,0,0,0,0,0,0,0,0,0
20200528,057852,國巨國票99購05,,,,,0.00,0.00,0,0,0,0,0,0,0,0,0,0,0,0,0
20200528,057853,旺宏國票99購05,2.16,2.16,2.05,2.05,-0.19,-8.48,112000,5,239090,0,0,0,0,0,0,112000,0,112000,112000
20200528,057854,聯發科國票99購03,,,,,0.00,0.00,0,0,0,0,0,0,0,0,0,0,0,0,0
20200528,057855,晶技國票99購01,,,,,0.00,0.00,0,0,0,0,0,0,0,0,0,0,0,0,0
20200528,057856,聯鈞國票99購03,,,,,0.00,0.00,0,0,0,0,0,0,0,0,0,0,0,0,0
20200528,057857,牧德國票99購01,0.82,0.82,0.82,0.82,-0.04,-4.65,5000,1,4100,0,0,0,0,0,0,5000,0,5000,5000
20200528,057858,T50正2康和98購01,,,,,0.00,0.00,0,0,0,0,0,0,0,0,0,0,0,0,0
20200528,057859,神達康和98購01,1.23,1.24,1.23,1.24,+0.02,1.64,24000,2,29700,0,0,0,0,0,0,24000,24000,0,0
20200528,05785P,臺股指元大96售19,,,,,0.00,0.00,0,0,0,0,0,0,0,0,0,0,0,0,0
20200528,057860,金寶凱基98購01,0.38,0.41,0.38,0.38,+0.01,2.7,205000,5,80090,0,0,0,0,0,0,82000,123000,-41000,-41000
20200528,057861,台積電凱基98購16,,,,,0.00,0.00,0,0,0,0,0,0,0,0,0,0,0,0,0
20200528,057862,智邦凱基99購01,3.45,3.76,3.30,3.30,+0.29,9.63,56000,9,196360,0,0,0,0,0,0,8000,48000,-40000,-40000
20200528,057863,美律凱基9A購01,0.70,0.71,0.70,0.71,+0.05,7.58,56000,2,39660,0,0,0,0,0,0,46000,10000,36000,36000
20200528,057864,奇力新凱基99購03,,,,,0.00,0.00,0,0,0,0,0,0,0,0,0,0,0,0,0
20200528,057865,富邦金凱基98購01,0.92,0.92,0.90,0.90,0.00,0.00,94000,2,85680,0,0,0,0,0,0,94000,0,94000,94000
20200528,057866,玉山金凱基98購01,0.22,0.22,0.21,0.21,0.00,0.00,12000,2,2580,0,0,0,0,0,0,0,0,0,0
20200528,057867,大立光凱基98購17,,,,,0.00,0.00,0,0,0,0,0,0,0,0,0,0,0,0,0
20200528,057868,大立光凱基98購18,,,,,0.00,0.00,0,0,0,0,0,0,0,0,0,0,0,0,0
20200528,057869,大立光凱基99購01,1.89,1.89,1.89,1.89,-0.07,-3.57,49000,1,92610,0,0,0,0,0,0,49000,0,49000,49000
20200528,05786P,臺股指永昌96售03,3.00,3.00,3.00,3.00,0.00,0.00,10000,1,30000,0,0,0,0,0,0,10000,10000,0,0
20200528,057870,大立光凱基99購02,,,,,0.00,0.00,0,0,0,0,0,0,0,0,0,0,0,0,0
20200528,057871,國巨元大99購09,0.52,0.52,0.52,0.52,0.00,0.00,10000,1,5200,0,0,0,0,0,0,0,10000,-10000,-10000
20200528,057872,旺宏元大99購06,1.76,1.78,1.76,1.77,-0.01,-0.56,50000,5,88600,0,0,0,0,0,0,50000,0,50000,50000
20200528,057873,義隆元大98購03,2.91,3.00,2.77,2.77,+0.17,6.54,323000,46,915880,0,0,0,0,0,0,288000,148000,140000,140000
20200528,057874,可成元大99購02,1.09,1.10,1.03,1.03,-0.06,-5.5,100000,5,107210,0,0,0,0,0,0,60000,40000,20000,20000
20200528,057875,京鼎元大98購03,1.34,1.34,1.22,1.22,-0.07,-5.43,158000,5,207460,0,0,0,0,0,0,57000,103000,-46000,-46000
20200528,057876,隆達元大98購01,2.65,2.74,2.38,2.40,-0.24,-9.09,42000,10,104080,0,0,0,0,0,0,11000,24000,-13000,-13000
20200528,057877,神達元大99購01,2.97,2.97,2.93,2.95,+0.05,1.72,153000,8,451010,0,0,0,0,0,0,104000,73000,31000,31000
20200528,057878,台郡元大99購04,2.00,2.00,1.90,1.90,-0.09,-4.52,60000,2,115000,0,0,0,0,0,0,0,60000,-60000,-60000
20200528,057879,電子類元大99購02,,,,,0.00,0.00,0,0,0,0,0,0,0,0,0,0,0,0,0
20200528,05787P,臺股指永昌96售04,3.00,3.00,3.00,3.00,0.00,0.00,3000,1,9000,0,0,0,0,0,0,0,3000,-3000,-3000
20200528,057880,金融類元大99購02,,,,,0.00,0.00,0,0,0,0,0,0,0,0,0,0,0,0,0
20200528,057881,SP黃豆群益9A購01,,,,,0.00,0.00,0,0,0,0,0,0,0,0,0,0,0,0,0
20200528,057882,華通群益9A購03,2.89,2.89,2.64,2.64,+0.19,7.76,42000,4,119370,0,0,0,0,0,0,8000,34000,-26000,-26000
20200528,057883,中環群益98購01,0.35,0.35,0.32,0.32,-0.04,-11.11,91000,5,31020,0,0,0,0,0,0,60000,31000,29000,29000
20200528,057884,華邦電群益98購02,,,,,0.00,0.00,0,0,0,0,0,0,0,0,0,0,0,0,0
20200528,057885,台光電群益98購04,,,,,0.00,0.00,0,0,0,0,0,0,0,0,0,0,0,0,0
20200528,057886,聯詠群益98購01,1.69,1.69,1.55,1.69,+0.02,1.2,120000,14,195280,0,0,0,0,0,0,52000,68000,-16000,-16000
20200528,057887,智原群益98購04,1.13,1.13,1.06,1.06,-0.04,-3.64,109000,6,117760,0,0,0,0,0,0,89000,30000,59000,59000
20200528,057888,貿聯群益98購02,2.50,2.52,2.47,2.52,+0.03,1.2,337000,8,840170,0,0,0,0,0,0,296000,41000,255000,255000
20200528,057889,致新群益99購01,1.85,1.94,1.85,1.94,0.00,0.00,16000,2,30500,0,0,0,0,0,0,16000,0,16000,16000
20200528,05788P,臺股指永昌96售05,2.00,2.00,2.00,2.00,0.00,0.00,1000,1,2000,0,0,0,0,0,0,1000,0,1000,1000
20200528,057890,滬深反統一98購01,0.81,0.81,0.81,0.81,0.00,0.00,26000,1,21060,0,0,0,0,0,0,26000,0,26000,26000
20200528,057891,華新科統一9A購01,0.39,0.40,0.39,0.40,-0.01,-2.44,20000,10,7810,0,0,0,0,0,0,20000,0,20000,20000
20200528,057892,上証2X元富02購01,2.72,2.72,2.72,2.72,+0.17,6.67,5000,1,13600,0,0,0,0,0,0,5000,0,5000,5000
20200528,057893,亞德客元富98購03,2.31,2.41,2.06,2.06,-0.27,-11.59,113000,23,264040,0,0,0,0,0,0,73000,30000,43000,43000
20200528,057894,華通元富02購02,2.70,2.93,2.70,2.77,+0.19,7.36,797000,30,2280330,0,0,0,0,0,0,285000,512000,-227000,-227000
20200528,057895,全新元富9B購01,0.53,0.53,0.53,0.53,-0.03,-5.36,67000,2,35510,0,0,0,0,0,0,67000,0,67000,67000
20200528,057896,嘉晶元富98購01,4.67,4.67,4.67,4.67,-0.26,-5.27,3000,1,14010,0,0,0,0,0,0,3000,0,3000,3000
20200528,057897,華通富邦99購01,0.35,0.35,0.35,0.35,0.00,0.00,2000,1,700,0,0,0,0,0,0,2000,0,2000,2000
20200528,057898,元油2X永豐98購06,,,,,0.00,0.00,0,0,0,0,0,0,0,0,0,0,0,0,0
20200528,057899,台積電永豐98購04,,,,,0.00,0.00,0,0,0,0,0,0,0,0,0,0,0,0,0
20200528,05789P,臺股指永昌96售06,2.30,2.30,2.30,2.30,+1.10,91.67,3000,2,6900,0,0,0,0,0,0,0,0,0,0
20200528,057900,南亞科永豐98購01,,,,,0.00,0.00,0,0,0,0,0,0,0,0,0,0,0,0,0
20200528,057901,大立光永豐98購04,,,,,0.00,0.00,0,0,0,0,0,0,0,0,0,0,0,0,0
20200528,057902,嘉晶永豐98購02,1.81,1.91,1.74,1.75,-0.14,-7.41,427000,11,752870,0,10000,-10000,0,0,0,363000,64000,299000,289000
20200528,057903,聯鈞永豐99購01,0.23,0.23,0.23,0.23,-0.01,-4.17,580000,3,133400,0,0,0,0,0,0,580000,0,580000,580000
20200528,057904,矽力永豐98購01,1.60,1.77,1.51,1.60,+0.18,12.68,216000,30,351660,0,0,0,0,0,0,166000,44000,122000,122000
20200528,057905,臺股指永豐98購06,,,,,0.00,0.00,0,0,0,0,0,0,0,0,0,0,0,0,0
20200528,057906,福懋科中信99購01,,,,,0.00,0.00,0,0,0,0,0,0,0,0,0,0,0,0,0
20200528,057907,台達電亞東99購01,,,,,0.00,0.00,0,0,0,0,0,0,0,0,0,0,0,0,0
20200528,057908,國泰金亞東99購01,,,,,0.00,0.00,0,0,0,0,0,0,0,0,0,0,0,0,0
20200528,057909,台光電兆豐98購01,1.89,1.89,1.66,1.66,-0.25,-13.09,68000,11,119620,0,0,0,0,0,0,0,68000,-68000,-68000
20200528,05790P,臺股指永昌96售07,1.00,2.01,1.00,2.01,+0.80,66.12,3000,2,5020,0,0,0,0,0,0,3000,0,3000,3000
20200528,057910,華新科兆豐99購02,0.09,0.09,0.09,0.09,-0.02,-18.18,10000,1,900,0,0,0,0,0,0,10000,10000,0,0
20200528,057911,國巨日盛98購01,,,,,0.00,0.00,0,0,0,0,0,0,0,0,0,0,0,0,0
20200528,057912,美律日盛99購01,0.82,0.83,0.81,0.81,+0.02,2.53,348000,6,287260,0,0,0,0,0,0,143000,205000,-62000,-62000
20200528,057913,健策日盛98購01,1.35,1.35,1.35,1.35,+0.04,3.05,10000,1,13500,0,0,0,0,0,0,10000,0,10000,10000
20200528,057914,日月光日盛9A購01,,,,,0.00,0.00,0,0,0,0,0,0,0,0,0,0,0,0,0
20200528,057915,台泥凱基98購01,1.72,1.73,1.71,1.71,-0.06,-3.39,50000,5,86090,0,0,0,0,0,0,50000,50000,0,0
20200528,057916,國巨凱基98購13,0.57,0.57,0.52,0.52,-0.03,-5.45,40000,2,21800,0,0,0,0,0,0,20000,20000,0,0
20200528,057917,台積電凱基98購17,,,,,0.00,0.00,0,0,0,0,0,0,0,0,0,0,0,0,0
20200528,057918,旺宏凱基99購01,1.43,1.44,1.42,1.44,-0.03,-2.04,40000,19,56930,0,0,0,0,0,0,40000,0,40000,40000
20200528,057919,技嘉凱基98購03,1.66,1.66,1.58,1.58,-0.08,-4.82,50000,5,81430,0,0,0,0,0,0,50000,0,50000,50000
20200528,05791P,臺股指中信99售06,,,,,0.00,0.00,0,0,0,0,0,0,0,0,0,0,0,0,0
20200528,057920,奇力新凱基98購08,,,,,0.00,0.00,0,0,0,0,0,0,0,0,0,0,0,0,0
20200528,057921,可成凱基98購09,,,,,0.00,0.00,0,0,0,0,0,0,0,0,0,0,0,0,0
20200528,057922,華新科凱基99購01,,,,,0.00,0.00,0,0,0,0,0,0,0,0,0,0,0,0,0
20200528,057923,晶豪科凱基98購02,1.83,1.84,1.64,1.64,-0.07,-4.09,43000,5,76870,0,0,0,0,0,0,30000,43000,-13000,-13000
20200528,057924,健策凱基98購02,1.82,1.87,1.72,1.72,+0.01,0.58,108000,16,196970,0,0,0,0,0,0,104000,4000,100000,100000
20200528,057925,貿聯凱基99購01,1.16,1.19,1.14,1.16,0.00,0.00,332000,16,386520,0,0,0,0,0,0,116000,216000,-100000,-100000
20200528,057926,帆宣凱基98購02,0.97,0.98,0.90,0.90,+0.09,11.11,119000,5,111390,0,0,0,0,0,0,85000,34000,51000,51000
20200528,057927,勤誠凱基98購01,1.26,1.26,1.26,1.26,0.00,0.00,50000,1,63000,0,0,0,0,0,0,50000,0,50000,50000
20200528,057928,鈺齊凱基98購02,0.80,0.95,0.80,0.82,+0.08,10.81,95000,6,79860,0,0,0,0,0,0,44000,51000,-7000,-7000
20200528,057929,上銀群益98購02,4.10,4.42,4.10,4.17,+0.19,4.77,93000,8,395530,0,0,0,0,0,0,93000,0,93000,93000
20200528,05792P,臺股指中信99售07,,,,,0.00,0.00,0,0,0,0,0,0,0,0,0,0,0,0,0
20200528,057930,旺宏群益99購04,4.04,4.16,3.79,3.79,-0.27,-6.65,101000,18,403260,0,0,0,0,0,0,96000,32000,64000,64000
20200528,057931,正崴群益98購02,2.17,2.21,2.01,2.01,-0.26,-11.45,400000,15,841320,0,0,0,0,0,0,162000,199000,-37000,-37000
20200528,057932,美律群益98購04,,,,,0.00,0.00,0,0,0,0,0,0,0,0,0,0,0,0,0
20200528,057933,聯發科群益98購06,,,,,0.00,0.00,0,0,0,0,0,0,0,0,0,0,0,0,0
20200528,057934,華新科群益98購07,,,,,0.00,0.00,0,0,0,0,0,0,0,0,0,0,0,0,0
20200528,057935,晶技群益98購02,,,,,0.00,0.00,0,0,0,0,0,0,0,0,0,0,0,0,0
20200528,057936,健策群益99購01,4.08,4.15,3.93,3.93,-0.15,-3.68,146000,12,589420,0,0,0,0,0,0,117000,29000,88000,88000
20200528,057937,神達群益98購02,1.41,1.42,1.38,1.38,-0.01,-0.72,45000,3,62970,0,0,0,0,0,0,23000,45000,-22000,-22000
20200528,057938,台表科群益98購02,,,,,0.00,0.00,0,0,0,0,0,0,0,0,0,0,0,0,0
20200528,057939,鈺齊群益98購02,,,,,0.00,0.00,0,0,0,0,0,0,0,0,0,0,0,0,0
20200528,05793P,臺股指中信99售08,2.05,2.17,2.05,2.17,+0.08,3.83,15000,2,31350,0,0,0,0,0,0,10000,5000,5000,5000
20200528,057940,和大國票99購01,0.79,0.82,0.71,0.71,-0.05,-6.58,235000,6,188950,0,0,0,0,0,0,6000,229000,-223000,-223000
20200528,057941,聯電國票99購01,0.56,0.57,0.56,0.57,+0.03,5.56,32000,3,18120,0,0,0,0,0,0,32000,0,32000,32000
20200528,057942,可成國票99購02,0.38,0.38,0.38,0.38,0.00,0.00,20000,1,7600,0,0,0,0,0,0,0,0,0,0
20200528,057943,可成國票99購03,1.48,1.48,1.38,1.40,-0.07,-4.76,18000,6,25290,0,0,0,0,0,0,18000,18000,0,0
20200528,057944,新日興國票99購02,,,,,0.00,0.00,0,0,0,0,0,0,0,0,0,0,0,0,0
20200528,057945,京鼎國票99購03,1.16,1.17,1.07,1.07,-0.08,-6.96,59000,6,64920,0,0,0,0,0,0,11000,59000,-48000,-48000
20200528,057946,晶相光國票99購01,,,,,0.00,0.00,0,0,0,0,0,0,0,0,0,0,0,0,0
20200528,057947,和碩國票99購01,,,,,0.00,0.00,0,0,0,0,0,0,0,0,0,0,0,0,0
20200528,057948,嘉聯益國票99購02,1.24,1.25,1.20,1.20,+0.14,13.21,60000,5,73730,0,0,0,0,0,0,19000,60000,-41000,-41000
20200528,057949,南電國票99購01,4.67,4.85,4.31,4.31,-0.31,-6.71,133000,10,599090,0,0,0,0,0,0,25000,108000,-83000,-83000
20200528,05794P,華邦電群益96售04,,,,,0.00,0.00,0,0,0,0,0,0,0,0,0,0,0,0,0
20200528,057950,T50正2元大9B購04,,,,,0.00,0.00,0,0,0,0,0,0,0,0,0,0,0,0,0
20200528,057951,元油2X元大98購20,,,,,0.00,0.00,0,0,0,0,0,0,0,0,0,0,0,0,0
20200528,057952,元油2X元大98購21,,,,,0.00,0.00,0,0,0,0,0,0,0,0,0,0,0,0,0
20200528,057953,聚陽元大98購01,0.93,0.93,0.82,0.83,-0.11,-11.7,111000,9,97770,0,0,0,0,0,0,107000,0,107000,107000
20200528,057954,宏碁元大99購01,,,,,0.00,0.00,0,0,0,0,0,0,0,0,0,0,0,0,0
20200528,057955,技嘉元大98購07,1.99,1.99,1.78,1.78,-0.18,-9.18,192000,12,365020,0,0,0,0,0,0,107000,125000,-18000,-18000
20200528,057956,全新元大99購04,0.80,0.80,0.79,0.79,-0.04,-4.82,90000,4,71300,0,0,0,0,0,0,90000,0,90000,90000
20200528,057957,嘉晶元大98購01,8.80,8.80,8.15,8.15,-1.00,-10.93,23000,4,195300,0,0,0,0,0,0,12000,11000,1000,1000
20200528,057958,禾伸堂元大99購05,1.98,2.01,1.96,1.96,-0.11,-5.31,73000,6,144380,0,0,0,0,0,0,73000,23000,50000,50000
20200528,057959,欣興元大98購14,2.50,2.83,2.45,2.61,+0.02,0.77,70000,11,182530,0,0,0,0,0,0,57000,20000,37000,37000
20200528,05795P,華邦電群益96售05,,,,,0.00,0.00,0,0,0,0,0,0,0,0,0,0,0,0,0
20200528,057960,聯鈞元大98購02,0.85,0.85,0.83,0.83,0.00,0.00,162000,3,136040,0,0,0,0,0,0,94000,68000,26000,26000
20200528,057961,茂林元大9A購01,1.70,1.70,1.64,1.64,-0.03,-1.8,80000,12,133440,0,0,0,0,0,0,80000,28000,52000,52000
20200528,057962,超眾元大99購03,4.00,4.14,4.00,4.14,-0.20,-4.61,43000,7,174160,0,0,0,0,0,0,34000,9000,25000,25000
20200528,057963,緯穎元大98購08,4.27,4.27,3.90,3.90,-0.16,-3.94,81000,3,319570,0,0,0,0,0,0,72000,11000,61000,61000
20200528,057964,緯穎元大99購03,4.37,4.44,4.07,4.09,-0.33,-7.47,48000,10,209040,0,0,0,0,0,0,40000,8000,32000,32000
20200528,057965,臺股指元大98購14,,,,,0.00,0.00,0,0,0,0,0,0,0,0,0,0,0,0,0
20200528,057966,金融類元大98購01,,,,,0.00,0.00,0,0,0,0,0,0,0,0,0,0,0,0,0
20200528,057967,聯發科國泰9A購02,3.89,3.91,3.89,3.91,-0.22,-5.33,43000,3,167870,0,0,0,0,0,0,43000,0,43000,43000
20200528,057968,可成國泰9A購01,,,,,0.00,0.00,0,0,0,0,0,0,0,0,0,0,0,0,0
20200528,057969,緯穎國泰99購01,3.26,3.40,3.01,3.01,-0.16,-5.05,506000,43,1604480,0,0,0,0,0,0,463000,108000,355000,355000
20200528,05796P,臺股指群益96售10,,,,,0.00,0.00,0,0,0,0,0,0,0,0,0,0,0,0,0
20200528,057970,國巨富邦99購03,,,,,0.00,0.00,0,0,0,0,0,0,0,0,0,0,0,0,0
20200528,057971,華新科富邦9B購02,0.79,0.79,0.77,0.79,-0.01,-1.25,40000,20,31280,0,0,0,0,0,0,30000,10000,20000,20000
20200528,057972,群創富邦9C購01,0.83,0.83,0.83,0.83,0.00,0.00,12000,1,9960,0,0,0,0,0,0,0,12000,-12000,-12000
20200528,057973,神達富邦9A購01,0.75,0.75,0.73,0.73,0.00,0.00,55000,5,40880,0,0,0,0,0,0,53000,23000,30000,30000
20200528,057974,上銀永豐98購02,0.40,0.44,0.30,0.30,-0.15,-33.33,113000,24,44840,0,0,0,0,0,0,78000,32000,46000,46000
20200528,057975,台積電永豐98購05,,,,,0.00,0.00,0,0,0,0,0,0,0,0,0,0,0,0,0
20200528,057976,旺宏永豐98購03,1.24,1.24,1.24,1.24,-0.07,-5.34,43000,1,53320,0,0,0,0,0,0,43000,0,43000,43000
20200528,057977,台光電永豐98購02,,,,,0.00,0.00,0,0,0,0,0,0,0,0,0,0,0,0,0
20200528,057978,聯發科永豐98購05,2.06,2.06,2.06,2.06,-0.11,-5.07,1000,1,2060,0,0,0,0,0,0,1000,0,1000,1000
20200528,057979,華新科永豐98購03,,,,,0.00,0.00,0,0,0,0,0,0,0,0,0,0,0,0,0
20200528,05797P,臺股指群益96售11,,,,,0.00,0.00,0,0,0,0,0,0,0,0,0,0,0,0,0
20200528,057980,聯詠永豐98購01,1.41,1.41,1.39,1.39,-0.07,-4.79,21000,2,29390,0,0,0,0,0,0,10000,11000,-1000,-1000
20200528,057981,臻鼎永豐98購01,0.25,0.27,0.23,0.23,-0.06,-20.69,22000,6,5490,0,0,0,0,0,0,13000,9000,4000,4000
20200528,057982,帆宣永豐98購01,0.79,0.79,0.79,0.79,+0.09,12.86,3000,1,2370,0,0,0,0,0,0,0,3000,-3000,-3000
20200528,057983,緯穎永豐98購03,1.69,1.69,1.69,1.69,-0.11,-6.11,6000,1,10140,0,0,0,0,0,0,6000,0,6000,6000
20200528,057984,聯發科台新98購01,,,,,0.00,0.00,0,0,0,0,0,0,0,0,0,0,0,0,0
20200528,057985,華通元富02購03,2.78,3.05,2.78,2.85,+0.15,5.56,669000,27,1981450,0,0,0,0,0,0,207000,462000,-255000,-255000
20200528,057986,華新科元富99購05,,,,,0.00,0.00,0,0,0,0,0,0,0,0,0,0,0,0,0
20200528,057987,大立光元富98購02,0.82,0.84,0.73,0.75,-0.04,-5.06,150000,15,116560,0,0,0,0,0,0,60000,90000,-30000,-30000
20200528,057988,鈺齊元富98購02,1.38,1.46,1.37,1.37,+0.10,7.87,136000,18,189910,0,0,0,0,0,0,20000,116000,-96000,-96000
20200528,057989,旺宏統一99購04,0.65,0.65,0.60,0.60,-0.08,-11.76,440000,6,280780,0,0,0,0,0,0,340000,0,340000,340000
20200528,05798P,臺股指群益96售12,,,,,0.00,0.00,0,0,0,0,0,0,0,0,0,0,0,0,0
20200528,057990,美律統一99購02,,,,,0.00,0.00,0,0,0,0,0,0,0,0,0,0,0,0,0
20200528,057991,健策統一9C購01,1.70,1.71,1.49,1.50,-0.17,-10.18,667000,22,1026500,0,0,0,0,0,0,638000,29000,609000,609000
20200528,057992,大立光日盛98購01,,,,,0.00,0.00,0,0,0,0,0,0,0,0,0,0,0,0,0
20200528,057993,中環中信98購01,0.39,0.39,0.38,0.38,-0.05,-11.63,78000,11,29720,0,0,0,0,0,0,68000,10000,58000,58000
20200528,057994,技嘉中信98購01,2.83,2.83,2.70,2.70,-0.42,-13.46,14000,2,39100,0,0,0,0,0,0,14000,4000,10000,10000
20200528,057995,華新科中信98購02,0.31,0.31,0.29,0.29,-0.04,-12.12,42000,2,12780,0,0,0,0,0,0,0,42000,-42000,-42000
20200528,057996,臻鼎中信98購01,2.05,2.06,1.84,1.84,-0.10,-5.15,35000,4,68400,0,0,0,0,0,0,20000,15000,5000,5000
20200528,057997,旺宏第一9C購01,1.21,1.22,1.14,1.14,-0.10,-8.06,140000,11,165820,0,0,0,0,0,0,100000,40000,60000,60000
20200528,057998,玉晶光麥證9A購01,0.86,0.91,0.85,0.87,+0.05,6.1,314000,11,276870,312000,2000,310000,0,0,0,312000,2000,310000,310000
20200528,057999,智邦亞東99購02,,,,,0.00,0.00,0,0,0,0,0,0,0,0,0,0,0,0,0
20200528,05799P,臺股指群益96售13,,,,,0.00,0.00,0,0,0,0,0,0,0,0,0,0,0,0,0
20200528,058000,FBVIX群益9B購01,,,,,0.00,0.00,0,0,0,0,0,0,0,0,0,0,0,0,0
20200528,058001,FBVIX群益9B購02,,,,,0.00,0.00,0,0,0,0,0,0,0,0,0,0,0,0,0
20200528,058002,FBVIX群益9C購01,,,,,0.00,0.00,0,0,0,0,0,0,0,0,0,0,0,0,0
20200528,058003,FBVIX群益9C購02,,,,,0.00,0.00,0,0,0,0,0,0,0,0,0,0,0,0,0
20200528,058004,大立光群益98購03,0.95,0.95,0.95,0.95,-0.02,-2.06,1000,1,950,0,0,0,0,0,0,1000,0,1000,1000
20200528,058005,茂林群益98購04,1.02,1.02,1.00,1.00,-0.25,-20.0,20000,12,20280,0,0,0,0,0,0,20000,0,20000,20000
20200528,058006,台郡群益98購04,2.22,2.22,2.13,2.13,-0.14,-6.17,74000,2,159780,0,0,0,0,0,0,74000,0,74000,74000
20200528,058007,南電群益98購02,1.47,1.47,1.43,1.43,-0.09,-5.92,111000,2,161970,0,0,0,0,0,0,30000,81000,-51000,-51000
20200528,058008,禾伸堂國票99購02,2.33,2.33,2.21,2.21,-0.22,-9.05,55000,2,125030,0,0,0,0,0,0,55000,0,55000,55000
20200528,058009,智易國票99購01,5.80,5.80,5.80,5.80,0.00,0.00,2000,2,11600,0,0,0,0,0,0,2000,2000,0,0
20200528,05800P,台積電兆豐96售04,,,,,0.00,0.00,0,0,0,0,0,0,0,0,0,0,0,0,0
20200528,058010,帆宣國票98購01,2.86,2.93,2.61,2.61,+0.37,16.52,18000,3,51220,0,0,0,0,0,0,3000,15000,-12000,-12000
20200528,058011,台虹國票99購01,3.18,3.18,2.95,2.95,-0.32,-9.79,112000,7,349320,0,0,0,0,0,0,112000,0,112000,112000
20200528,058012,鈺齊國票99購01,1.67,1.80,1.56,1.56,+0.09,6.12,136000,12,226280,0,0,0,0,0,0,81000,55000,26000,26000
20200528,058013,SP黃豆凱基9A購01,,,,,0.00,0.00,0,0,0,0,0,0,0,0,0,0,0,0,0
20200528,058014,上銀凱基99購02,2.89,2.99,2.63,2.63,-0.33,-11.15,57000,24,164480,0,0,0,0,0,0,54000,3000,51000,51000
20200528,058015,旺宏凱基99購02,3.08,3.10,2.81,2.81,-0.38,-11.91,41000,3,124380,0,0,0,0,0,0,33000,8000,25000,25000
20200528,058016,智邦凱基98購06,7.60,7.60,7.60,7.60,+1.70,28.81,2000,1,15200,0,0,0,0,0,0,0,2000,-2000,-2000
20200528,058017,漢唐凱基99購01,2.50,2.50,2.50,2.50,-0.06,-2.34,15000,2,37500,0,0,0,0,0,0,15000,0,15000,15000
20200528,058018,南亞科凱基99購03,1.70,1.76,1.66,1.66,+0.08,5.06,29000,3,50340,0,0,0,0,0,0,28000,1000,27000,27000
20200528,058019,美律凱基99購04,1.29,1.32,1.29,1.32,+0.08,6.45,60000,2,77700,0,0,0,0,0,0,50000,10000,40000,40000
20200528,05801P,正崴兆豐96售01,,,,,0.00,0.00,0,0,0,0,0,0,0,0,0,0,0,0,0
20200528,058020,大立光凱基99購03,,,,,0.00,0.00,0,0,0,0,0,0,0,0,0,0,0,0,0
20200528,058021,牧德凱基98購02,0.69,0.69,0.69,0.69,0.00,0.00,30000,2,20700,0,0,0,0,0,0,30000,0,30000,30000
20200528,058022,樺漢凱基99購02,1.99,2.05,1.99,2.05,-0.01,-0.49,37000,2,74710,0,0,0,0,0,0,0,37000,-37000,-37000
20200528,058023,南電凱基98購02,,,,,0.00,0.00,0,0,0,0,0,0,0,0,0,0,0,0,0
20200528,058024,台積電國泰9A購01,,,,,0.00,0.00,0,0,0,0,0,0,0,0,0,0,0,0,0
20200528,058025,聯茂國泰99購01,1.43,1.52,1.42,1.49,+0.04,2.76,339000,30,494340,0,0,0,0,0,0,193000,146000,47000,47000
20200528,058026,上銀富邦9A購01,1.99,2.03,1.75,1.75,-0.28,-13.79,306000,58,585120,0,0,0,0,0,0,266000,40000,226000,226000
20200528,058027,鴻海富邦98購04,,,,,0.00,0.00,0,0,0,0,0,0,0,0,0,0,0,0,0
20200528,058028,國巨富邦99購04,0.10,0.11,0.10,0.10,-0.04,-28.57,125000,9,13000,0,0,0,0,0,0,0,75000,-75000,-75000
20200528,058029,台灣50永豐9A購01,,,,,0.00,0.00,0,0,0,0,0,0,0,0,0,0,0,0,0
20200528,05802P,臺股指兆豐96售02,,,,,0.00,0.00,0,0,0,0,0,0,0,0,0,0,0,0,0
20200528,058030,國巨永豐98購08,,,,,0.00,0.00,0,0,0,0,0,0,0,0,0,0,0,0,0
20200528,058031,旺宏永豐98購04,1.66,1.66,1.63,1.63,-0.08,-4.68,127000,5,207310,0,0,0,0,0,0,117000,0,117000,117000
20200528,058032,大立光永豐98購05,1.25,1.25,1.25,1.25,0.00,0.00,24000,1,30000,0,0,0,0,0,0,0,24000,-24000,-24000
20200528,058033,景碩永豐98購02,1.10,1.10,1.10,1.10,0.00,0.00,36000,3,39600,0,0,0,0,0,0,0,36000,-36000,-36000
20200528,058034,神達永豐98購02,0.13,0.13,0.13,0.13,0.00,0.00,100000,2,13000,0,0,0,0,0,0,0,100000,-100000,-100000
20200528,058035,旭富永豐98購02,0.61,0.65,0.60,0.60,-0.03,-4.76,231000,11,145700,0,0,0,0,0,0,86000,145000,-59000,-59000
20200528,058036,南電永豐98購01,1.45,1.45,1.45,1.45,-0.14,-8.81,58000,1,84100,0,0,0,0,0,0,0,58000,-58000,-58000
20200528,058037,台灣50元大9B購02,0.64,0.64,0.64,0.64,0.00,0.00,1000,1,640,0,0,0,0,0,0,0,1000,-1000,-1000
20200528,058038,滬深反元大98購01,,,,,0.00,0.00,0,0,0,0,0,0,0,0,0,0,0,0,0
20200528,058039,元石油元大98購03,0.05,0.05,0.05,0.05,-0.01,-16.67,45000,2,2250,0,0,0,0,0,0,0,0,0,0
20200528,05803P,臺股指兆豐96售03,,,,,0.00,0.00,0,0,0,0,0,0,0,0,0,0,0,0,0
20200528,058040,FBVIX元大98購01,,,,,0.00,0.00,0,0,0,0,0,0,0,0,0,0,0,0,0
20200528,058041,FBVIX元大98購02,3.73,3.73,3.73,3.73,+0.05,1.36,10000,1,37300,0,0,0,0,0,0,10000,0,10000,10000
20200528,058042,鴻海元大98購12,2.16,2.16,2.11,2.11,+0.01,0.48,51000,6,109260,0,0,0,0,0,0,50000,1000,49000,49000
20200528,058043,鴻海元大98購13,1.90,1.90,1.79,1.79,0.00,0.00,65000,7,122650,0,0,0,0,0,0,55000,10000,45000,45000
20200528,058044,鴻海元大99購07,,,,,0.00,0.00,0,0,0,0,0,0,0,0,0,0,0,0,0
20200528,058045,鴻海元大99購08,,,,,0.00,0.00,0,0,0,0,0,0,0,0,0,0,0,0,0
20200528,058046,國巨元大9A購01,,,,,0.00,0.00,0,0,0,0,0,0,0,0,0,0,0,0,0
20200528,058047,可成元大98購11,0.69,0.69,0.66,0.66,-0.07,-9.59,70000,5,47550,0,0,0,0,0,0,10000,60000,-50000,-50000
20200528,058048,群創元大9B購07,,,,,0.00,0.00,0,0,0,0,0,0,0,0,0,0,0,0,0
20200528,058049,帆宣元大98購01,1.13,1.13,1.02,1.02,+0.02,2.0,310000,13,344370,0,0,0,0,0,0,259000,51000,208000,208000
20200528,05804P,美律永豐96售01,,,,,0.00,0.00,0,0,0,0,0,0,0,0,0,0,0,0,0
20200528,058050,台郡元大99購05,1.14,1.16,1.14,1.14,-0.01,-0.87,128000,3,146920,0,0,0,0,0,0,78000,50000,28000,28000
20200528,058051,同欣電元大98購03,1.63,1.63,1.48,1.48,-0.38,-20.43,93000,3,150440,0,0,0,0,0,0,25000,68000,-43000,-43000
20200528,058052,南電元大98購02,,,,,0.00,0.00,0,0,0,0,0,0,0,0,0,0,0,0,0
20200528,058053,上銀統一9B購01,1.41,1.49,1.26,1.26,-0.15,-10.64,412000,50,585060,0,0,0,0,0,0,330000,77000,253000,253000
20200528,058054,台積電統一9C購01,0.53,0.53,0.48,0.49,-0.02,-3.92,1783000,31,896490,0,0,0,0,0,0,595000,1188000,-593000,-593000
20200528,058055,華擎統一9A購01,1.18,1.18,1.10,1.10,-0.06,-5.17,97000,6,114330,0,0,0,0,0,0,87000,10000,77000,77000
20200528,058056,FBVIX元富98購01,,,,,0.00,0.00,0,0,0,0,0,0,0,0,0,0,0,0,0
20200528,058057,FBVIX元富98購02,,,,,0.00,0.00,0,0,0,0,0,0,0,0,0,0,0,0,0
20200528,058058,大立光元富9B購02,,,,,0.00,0.00,0,0,0,0,0,0,0,0,0,0,0,0,0
20200528,058059,晶技元富98購01,,,,,0.00,0.00,0,0,0,0,0,0,0,0,0,0,0,0,0
20200528,05805P,義隆永豐96售02,,,,,0.00,0.00,0,0,0,0,0,0,0,0,0,0,0,0,0
20200528,058060,貿聯元富98購01,,,,,0.00,0.00,0,0,0,0,0,0,0,0,0,0,0,0,0
20200528,058061,貿聯元富9B購01,2.43,2.51,2.28,2.30,-0.10,-4.17,258000,41,624120,0,0,0,0,0,0,138000,120000,18000,18000
20200528,058062,上銀中信98購01,1.33,1.33,1.28,1.30,+0.03,2.36,95000,20,123020,0,0,0,0,0,0,95000,0,95000,95000
20200528,058063,旺宏中信98購04,2.08,2.10,2.06,2.10,-0.06,-2.78,40000,20,83180,0,0,0,0,0,0,40000,0,40000,40000
20200528,058064,華邦電亞東99購01,,,,,0.00,0.00,0,0,0,0,0,0,0,0,0,0,0,0,0
20200528,058065,南亞科亞東99購01,0.13,0.13,0.13,0.13,0.00,0.00,20000,2,2600,0,0,0,0,0,0,0,20000,-20000,-20000
20200528,058066,可成亞東99購01,,,,,0.00,0.00,0,0,0,0,0,0,0,0,0,0,0,0,0
20200528,058067,台積電第一9C購01,,,,,0.00,0.00,0,0,0,0,0,0,0,0,0,0,0,0,0
20200528,058068,旺宏凱基98購11,1.87,1.94,1.73,1.75,-0.21,-10.71,106000,32,195080,0,0,0,0,0,0,76000,46000,30000,30000
20200528,058069,美律凱基99購05,,,,,0.00,0.00,0,0,0,0,0,0,0,0,0,0,0,0,0
20200528,05806P,宏達電永豐96售03,,,,,0.00,0.00,0,0,0,0,0,0,0,0,0,0,0,0,0
20200528,058070,華新科凱基98購07,1.12,1.12,1.12,1.12,+0.05,4.67,45000,1,50400,0,0,0,0,0,0,0,45000,-45000,-45000
20200528,058071,大立光凱基98購19,,,,,0.00,0.00,0,0,0,0,0,0,0,0,0,0,0,0,0
20200528,058072,大立光凱基98購20,,,,,0.00,0.00,0,0,0,0,0,0,0,0,0,0,0,0,0
20200528,058073,大立光凱基99購04,,,,,0.00,0.00,0,0,0,0,0,0,0,0,0,0,0,0,0
20200528,058074,欣興凱基99購01,2.66,2.76,2.66,2.75,0.00,0.00,128000,8,347880,0,0,0,0,0,0,0,128000,-128000,-128000
20200528,058075,貿聯凱基99購02,,,,,0.00,0.00,0,0,0,0,0,0,0,0,0,0,0,0,0
20200528,058076,神達凱基98購02,0.62,0.62,0.60,0.60,-0.01,-1.64,107000,2,64740,0,0,0,0,0,0,107000,0,107000,107000
20200528,058077,超眾凱基98購02,1.88,1.99,1.88,1.94,-0.10,-4.9,119000,8,235280,0,0,0,0,0,0,46000,73000,-27000,-27000
20200528,058078,景碩國票99購01,1.93,2.04,1.93,1.99,-0.15,-7.01,131000,6,260160,0,0,0,0,0,0,38000,93000,-55000,-55000
20200528,058079,鴻海群益98購08,2.03,2.03,2.02,2.02,-0.04,-1.94,7000,2,14190,0,0,0,0,0,0,2000,7000,-5000,-5000
20200528,05807P,泰鼎永豐96售03,0.01,0.01,0.01,0.01,0.00,0.00,10000,1,100,0,0,0,0,0,0,0,0,0,0
20200528,058080,台積電群益98購06,3.64,3.64,3.64,3.64,+0.02,0.55,388000,1,1412320,0,0,0,0,0,0,388000,0,388000,388000
20200528,058081,技嘉群益9A購03,3.15,3.15,2.91,2.91,-0.36,-11.01,27000,5,81990,0,0,0,0,0,0,4000,27000,-23000,-23000
20200528,058082,美律群益98購05,,,,,0.00,0.00,0,0,0,0,0,0,0,0,0,0,0,0,0
20200528,058083,聯發科群益98購08,,,,,0.00,0.00,0,0,0,0,0,0,0,0,0,0,0,0,0
20200528,058084,大立光群益98購04,,,,,0.00,0.00,0,0,0,0,0,0,0,0,0,0,0,0,0
20200528,058085,景碩群益9A購01,2.05,2.13,2.05,2.11,+0.13,6.57,219000,4,465950,0,0,0,0,0,0,0,219000,-219000,-219000
20200528,058086,鴻海元大98購14,2.65,2.65,2.65,2.65,-0.01,-0.38,46000,1,121900,0,0,0,0,0,0,46000,0,46000,46000
20200528,058087,鴻海元大98購15,1.17,1.17,1.17,1.17,0.00,0.00,10000,1,11700,0,0,0,0,0,0,0,10000,-10000,-10000
20200528,058088,鴻海元大9A購01,1.20,1.20,1.20,1.20,0.00,0.00,1000,1,1200,0,0,0,0,0,0,0,1000,-1000,-1000
20200528,058089,聯發科元大98購15,,,,,0.00,0.00,0,0,0,0,0,0,0,0,0,0,0,0,0
20200528,05808P,臺股指國票96售01,,,,,0.00,0.00,0,0,0,0,0,0,0,0,0,0,0,0,0
20200528,058090,聯發科元大98購16,4.39,4.39,4.39,4.39,0.00,0.00,5000,1,21950,0,0,0,0,0,0,0,5000,-5000,-5000
20200528,058091,欣興元大99購03,2.37,2.54,2.37,2.54,+0.25,10.92,91000,6,219110,0,0,0,0,0,0,36000,58000,-22000,-22000
20200528,058092,牧德元大98購02,0.66,0.66,0.66,0.66,-0.08,-10.81,20000,1,13200,0,0,0,0,0,0,20000,0,20000,20000
20200528,058093,神達元大9A購01,2.50,2.51,2.45,2.45,-0.03,-1.21,132000,5,325780,0,0,0,0,0,0,82000,74000,8000,8000
20200528,058094,祥碩元大98購09,3.73,3.73,3.73,3.73,-0.15,-3.87,10000,1,37300,0,0,0,0,0,0,0,10000,-10000,-10000
20200528,058095,昇陽半元大98購03,1.18,1.25,1.14,1.14,-0.10,-8.06,114000,8,136980,0,0,0,0,0,0,0,114000,-114000,-114000
20200528,058096,南電元大98購04,2.16,2.16,2.13,2.16,-0.17,-7.3,64000,3,137880,0,0,0,0,0,0,14000,50000,-36000,-36000
20200528,058097,台灣50國泰99購01,,,,,0.00,0.00,0,0,0,0,0,0,0,0,0,0,0,0,0
20200528,058098,T50反1國泰9A購02,0.78,0.79,0.78,0.79,0.00,0.00,13000,2,10170,0,0,0,0,0,0,0,13000,-13000,-13000
20200528,058099,鴻海國泰9A購02,0.47,0.47,0.38,0.38,+0.01,2.7,62000,5,24130,0,0,0,0,0,0,0,46000,-46000,-46000
20200528,05809P,臺股指國票96售02,,,,,0.00,0.00,0,0,0,0,0,0,0,0,0,0,0,0,0
20200528,058100,聯茂國泰99購02,0.99,1.08,0.97,1.08,+0.05,4.85,345000,17,360490,0,0,0,0,0,0,241000,104000,137000,137000
20200528,058101,台積電富邦9C購01,0.21,0.21,0.19,0.19,-0.02,-9.52,125000,13,24350,0,0,0,0,0,0,0,125000,-125000,-125000
20200528,058102,楠梓電永豐98購04,,,,,0.00,0.00,0,0,0,0,0,0,0,0,0,0,0,0,0
20200528,058103,台積電永豐98購06,,,,,0.00,0.00,0,0,0,0,0,0,0,0,0,0,0,0,0
20200528,058104,國巨統一9A購04,0.24,0.24,0.22,0.22,-0.01,-4.35,67000,5,15630,0,0,0,0,0,0,27000,30000,-3000,-3000
20200528,058105,旺宏統一9A購02,1.15,1.16,1.03,1.03,-0.11,-9.65,927000,38,1057390,0,0,0,0,0,0,899000,28000,871000,871000
20200528,058106,神達統一98購02,,,,,0.00,0.00,0,0,0,0,0,0,0,0,0,0,0,0,0
20200528,058107,全新台新99購01,0.61,0.62,0.61,0.62,-0.01,-1.59,68000,6,41780,0,0,0,0,0,0,48000,20000,28000,28000
20200528,058108,台郡台新99購01,1.12,1.12,1.12,1.12,+0.01,0.9,9000,1,10080,0,0,0,0,0,0,0,9000,-9000,-9000
20200528,058109,台灣50元富9B購01,,,,,0.00,0.00,0,0,0,0,0,0,0,0,0,0,0,0,0
20200528,05810P,臺股指國票96售03,,,,,0.00,0.00,0,0,0,0,0,0,0,0,0,0,0,0,0
20200528,058110,光寶科元富98購01,2.56,2.57,2.38,2.38,-0.20,-7.75,100000,15,250140,0,0,0,0,0,0,100000,0,100000,100000
20200528,058111,健鼎元富98購01,2.07,2.07,2.07,2.07,+0.10,5.08,10000,2,20700,0,0,0,0,0,0,0,10000,-10000,-10000
20200528,058112,神達元富98購01,1.16,1.18,1.16,1.18,+0.02,1.72,400000,2,470000,0,0,0,0,0,0,400000,0,400000,400000
20200528,058113,百和元富98購01,1.05,1.05,1.00,1.03,+0.07,7.29,423000,29,434570,0,0,0,0,0,0,423000,0,423000,423000
20200528,058114,台積電第一01購01,,,,,0.00,0.00,0,0,0,0,0,0,0,0,0,0,0,0,0
20200528,058115,台光電中信99購01,,,,,0.00,0.00,0,0,0,0,0,0,0,0,0,0,0,0,0
20200528,058116,正崴中信99購02,1.49,1.49,1.37,1.37,-0.11,-7.43,118000,5,168420,0,0,0,0,0,0,70000,48000,22000,22000
20200528,058117,元石油群益9B購02,,,,,0.00,0.00,0,0,0,0,0,0,0,0,0,0,0,0,0
20200528,058118,瑞昱群益99購01,4.93,5.00,4.93,5.00,+0.31,6.61,189000,9,942350,0,0,0,0,0,0,10000,179000,-169000,-169000
20200528,058119,華新亞東99購01,1.72,1.77,1.51,1.53,+0.18,13.33,61000,16,96340,0,0,0,0,0,0,21000,40000,-19000,-19000
20200528,05811P,臺股指國票96售04,,,,,0.00,0.00,0,0,0,0,0,0,0,0,0,0,0,0,0
20200528,058120,台灣50國票99購03,0.48,0.48,0.48,0.48,+0.01,2.13,100000,1,48000,0,0,0,0,0,0,100000,0,100000,100000
20200528,058121,國巨國票9A購01,0.22,0.22,0.22,0.22,0.00,0.00,1000,1,220,0,0,0,0,0,0,1000,0,1000,1000
20200528,058122,美律國票9A購01,1.87,1.88,1.84,1.84,+0.02,1.1,135000,7,251660,0,0,0,0,0,0,25000,110000,-85000,-85000
20200528,058123,亞光國票9A購01,,,,,0.00,0.00,0,0,0,0,0,0,0,0,0,0,0,0,0
20200528,058124,玉晶光國票9A購01,,,,,0.00,0.00,0,0,0,0,0,0,0,0,0,0,0,0,0
20200528,058125,元油2X元大9C購01,0.06,0.07,0.05,0.06,0.00,0.00,477000,15,25460,0,0,0,0,0,0,0,5000,-5000,-5000
20200528,058126,元油2X元大9C購02,0.07,0.13,0.06,0.13,0.00,0.00,437000,7,28280,0,0,0,0,0,0,0,0,0,0
20200528,058127,FBVIX元大9C購01,,,,,0.00,0.00,0,0,0,0,0,0,0,0,0,0,0,0,0
20200528,058128,FBVIX元大9C購02,,,,,0.00,0.00,0,0,0,0,0,0,0,0,0,0,0,0,0
20200528,058129,國巨元大99購10,1.15,1.15,1.15,1.15,0.00,0.00,10000,1,11500,0,0,0,0,0,0,0,10000,-10000,-10000
20200528,05812P,臺股指國票96售05,4.25,4.25,4.22,4.22,0.00,0.00,2000,2,8470,0,0,0,0,0,0,0,2000,-2000,-2000
20200528,058130,瑞昱元大99購01,2.71,2.71,2.66,2.66,0.00,0.00,248000,5,662930,0,0,0,0,0,0,248000,248000,0,0
20200528,058131,義隆元大99購02,1.55,1.59,1.47,1.48,+0.09,6.47,251000,41,381350,0,0,0,0,0,0,177000,130000,47000,47000
20200528,058132,義隆元大99購03,1.52,1.55,1.46,1.48,+0.08,5.71,198000,30,295490,0,0,0,0,0,0,165000,29000,136000,136000
20200528,058133,華新科元大9A購02,0.46,0.46,0.46,0.46,-0.04,-8.0,5000,1,2300,0,0,0,0,0,0,0,5000,-5000,-5000
20200528,058134,信邦元大99購01,1.87,1.96,1.83,1.89,+0.03,1.61,218000,12,414740,15000,5000,10000,0,0,0,36000,182000,-146000,-136000
20200528,058135,景碩元大99購01,1.78,1.91,1.76,1.79,+0.02,1.13,210000,10,381720,0,0,0,0,0,0,60000,150000,-90000,-90000
20200528,058136,景碩元大99購02,1.58,1.67,1.56,1.67,+0.07,4.38,168000,3,273440,0,0,0,0,0,0,0,168000,-168000,-168000
20200528,058137,玉晶光元大99購11,0.79,0.80,0.78,0.78,+0.04,5.41,70000,4,55400,0,0,0,0,0,0,10000,60000,-50000,-50000
20200528,058138,晶相光元大9C購01,,,,,0.00,0.00,0,0,0,0,0,0,0,0,0,0,0,0,0
20200528,058139,臻鼎元大99購01,1.33,1.33,1.19,1.19,-0.07,-5.56,143000,10,183590,0,0,0,0,0,0,109000,34000,75000,75000
20200528,05813P,臺股指國票96售06,5.85,5.85,5.70,5.70,+0.35,6.54,2000,2,11550,0,0,0,0,0,0,1000,1000,0,0
20200528,058140,臻鼎元大99購02,1.48,1.48,1.38,1.38,-0.06,-4.17,221000,7,319440,0,0,0,0,0,0,102000,121000,-19000,-19000
20200528,058141,嘉聯益元大99購05,,,,,0.00,0.00,0,0,0,0,0,0,0,0,0,0,0,0,0
20200528,058142,瑞儀元大99購01,1.82,1.82,1.76,1.79,+0.05,2.87,194000,13,344380,0,0,0,0,0,0,164000,28000,136000,136000
20200528,058143,瑞儀元大99購02,1.58,1.58,1.49,1.49,-0.02,-1.32,83000,9,127660,0,0,0,0,0,0,83000,0,83000,83000
20200528,058144,聯茂元大99購02,0.70,0.77,0.70,0.77,+0.06,8.45,180000,5,131000,0,0,0,0,0,0,20000,160000,-140000,-140000
20200528,058145,聯茂元大99購03,0.74,0.77,0.74,0.77,+0.01,1.32,374000,12,283040,0,0,0,0,0,0,158000,216000,-58000,-58000
20200528,058146,勤誠元大99購01,1.49,1.49,1.41,1.41,-0.09,-6.0,529000,7,756080,0,0,0,0,0,0,508000,21000,487000,487000
20200528,058147,鈺齊元大99購01,1.28,1.37,1.24,1.24,+0.09,7.83,206000,14,266500,0,0,0,0,0,0,36000,170000,-134000,-134000
20200528,058148,百和元大99購01,1.96,2.01,1.86,1.86,0.00,0.00,150000,8,287020,0,0,0,0,0,0,60000,90000,-30000,-30000
20200528,058149,百和元大99購02,1.70,1.74,1.59,1.61,-0.02,-1.23,460000,13,759830,0,0,0,0,0,0,295000,265000,30000,30000
20200528,05814P,臺股指國票96售07,3.55,3.55,3.55,3.55,0.00,0.00,10000,1,35500,0,0,0,0,0,0,10000,0,10000,10000
20200528,058150,中502X統一9B購01,,,,,0.00,0.00,0,0,0,0,0,0,0,0,0,0,0,0,0
20200528,058151,台積電統一9A購04,,,,,0.00,0.00,0,0,0,0,0,0,0,0,0,0,0,0,0
20200528,058152,聯發科統一9B購02,,,,,0.00,0.00,0,0,0,0,0,0,0,0,0,0,0,0,0
20200528,058153,景碩統一9B購01,0.69,0.73,0.69,0.73,+0.05,7.35,210000,6,149290,0,0,0,0,0,0,39000,171000,-132000,-132000
20200528,058154,泰碩統一9A購01,1.27,1.31,1.23,1.23,-0.06,-4.65,270000,10,339320,0,0,0,0,0,0,93000,177000,-84000,-84000
20200528,058155,牧德統一9A購01,,,,,0.00,0.00,0,0,0,0,0,0,0,0,0,0,0,0,0
20200528,058156,超眾統一9A購02,0.67,0.69,0.65,0.69,-0.02,-2.82,926000,14,617920,0,0,0,0,0,0,462000,464000,-2000,-2000
20200528,058157,華通台新99購01,,,,,0.00,0.00,0,0,0,0,0,0,0,0,0,0,0,0,0
20200528,058158,台積電台新99購01,0.40,0.40,0.40,0.40,0.00,0.00,1000,1,400,0,0,0,0,0,0,1000,1000,0,0
20200528,058159,健策台新9A購01,2.26,2.29,1.99,2.00,-0.14,-6.54,146000,25,321580,0,0,0,0,0,0,111000,35000,76000,76000
20200528,05815P,台積電凱基97售06,1.93,2.10,1.93,2.10,+0.04,1.94,100000,3,206600,0,0,0,0,0,0,80000,100000,-20000,-20000
20200528,058160,奇鋐元富99購01,4.08,4.54,4.07,4.35,+0.31,7.67,544000,62,2359370,0,0,0,0,0,0,104000,460000,-356000,-356000
20200528,058161,T50反1日盛03購01,,,,,0.00,0.00,0,0,0,0,0,0,0,0,0,0,0,0,0
20200528,058162,上銀日盛9B購01,,,,,0.00,0.00,0,0,0,0,0,0,0,0,0,0,0,0,0
20200528,058163,道瓊反凱基9B購01,1.15,1.15,1.06,1.06,-0.25,-19.08,109000,8,117960,0,0,0,0,0,0,83000,30000,53000,53000
20200528,058164,FBVIX凱基03購02,,,,,0.00,0.00,0,0,0,0,0,0,0,0,0,0,0,0,0
20200528,058165,FBVIX凱基9C購01,,,,,0.00,0.00,0,0,0,0,0,0,0,0,0,0,0,0,0
20200528,058166,鴻海凱基9A購01,,,,,0.00,0.00,0,0,0,0,0,0,0,0,0,0,0,0,0
20200528,058167,鴻海凱基9A購03,3.51,3.51,3.51,3.51,+0.02,0.57,1000,1,3510,0,0,0,0,0,0,1000,1000,0,0
20200528,058168,國巨凱基9A購04,,,,,0.00,0.00,0,0,0,0,0,0,0,0,0,0,0,0,0
20200528,058169,國巨凱基9A購05,0.21,0.21,0.21,0.21,0.00,0.00,2000,1,420,0,0,0,0,0,0,2000,0,2000,2000
20200528,05816P,台積電凱基97售07,,,,,0.00,0.00,0,0,0,0,0,0,0,0,0,0,0,0,0
20200528,058170,國巨凱基9A購06,0.64,0.64,0.64,0.64,-0.05,-7.25,50000,1,32000,0,0,0,0,0,0,0,50000,-50000,-50000
20200528,058171,國巨凱基9A購07,,,,,0.00,0.00,0,0,0,0,0,0,0,0,0,0,0,0,0
20200528,058172,國巨凱基9B購02,,,,,0.00,0.00,0,0,0,0,0,0,0,0,0,0,0,0,0
20200528,058173,台積電凱基99購04,,,,,0.00,0.00,0,0,0,0,0,0,0,0,0,0,0,0,0
20200528,058174,台積電凱基9A購05,1.27,1.27,1.27,1.27,-0.10,-7.3,10000,1,12700,0,0,0,0,0,0,0,10000,-10000,-10000
20200528,058175,旺宏凱基99購03,1.70,1.75,1.69,1.70,-0.01,-0.58,60000,17,103030,0,0,0,0,0,0,50000,0,50000,50000
20200528,058176,聯發科凱基99購05,,,,,0.00,0.00,0,0,0,0,0,0,0,0,0,0,0,0,0
20200528,058177,華新科凱基99購02,1.13,1.13,1.13,1.13,-0.05,-4.24,6000,1,6780,0,0,0,0,0,0,6000,0,6000,6000
20200528,058178,國巨國泰9A購02,,,,,0.00,0.00,0,0,0,0,0,0,0,0,0,0,0,0,0
20200528,058179,國巨國泰9B購02,,,,,0.00,0.00,0,0,0,0,0,0,0,0,0,0,0,0,0
20200528,05817P,可成凱基96售07,1.46,1.48,1.46,1.48,-0.07,-4.52,20000,2,29400,0,0,0,0,0,0,0,20000,-20000,-20000
20200528,058180,華新科國泰9A購01,0.80,0.80,0.73,0.73,-0.06,-7.59,462000,22,357800,0,0,0,0,0,0,302000,160000,142000,142000
20200528,058181,華新科國泰9B購01,0.83,0.83,0.82,0.83,0.00,0.00,87000,11,72130,0,0,0,0,0,0,87000,0,87000,87000
20200528,058182,日電貿國泰9A購01,1.79,1.79,1.72,1.72,-0.13,-7.03,195000,7,346200,0,0,0,0,0,0,190000,38000,152000,152000
20200528,058183,國巨富邦9A購06,0.10,0.10,0.10,0.10,0.00,0.00,10000,1,1000,0,0,0,0,0,0,0,10000,-10000,-10000
20200528,058184,鴻海永豐99購01,0.44,0.44,0.44,0.44,+0.02,4.76,10000,1,4400,0,0,0,0,0,0,10000,0,10000,10000
20200528,058185,國巨永豐99購01,0.31,0.31,0.29,0.29,-0.03,-9.38,145000,3,43650,0,0,0,0,0,0,145000,0,145000,145000
20200528,058186,聯發科永豐99購01,,,,,0.00,0.00,0,0,0,0,0,0,0,0,0,0,0,0,0
20200528,058187,泰碩永豐99購01,1.83,1.83,1.83,1.83,-0.25,-12.02,12000,1,21960,0,0,0,0,0,0,12000,0,12000,12000
20200528,058188,華擎永豐99購01,1.02,1.07,0.95,0.97,-0.05,-4.9,749000,36,758600,0,0,0,0,0,0,282000,455000,-173000,-173000
20200528,058189,嘉澤永豐99購01,,,,,0.00,0.00,0,0,0,0,0,0,0,0,0,0,0,0,0
20200528,05818P,大立光凱基96售14,0.82,0.82,0.82,0.82,-0.07,-7.87,2000,1,1640,0,0,0,0,0,0,2000,0,2000,2000
20200528,058190,貿聯永豐99購01,1.01,1.04,0.98,0.99,-0.02,-1.98,276000,19,276900,0,0,0,0,0,0,230000,16000,214000,214000
20200528,058191,祥碩永豐99購01,2.91,3.23,2.91,3.17,+0.30,10.45,75000,8,230850,0,0,0,0,0,0,30000,44000,-14000,-14000
20200528,058192,訊芯永豐99購01,0.38,0.38,0.38,0.38,-0.01,-2.56,47000,1,17860,0,0,0,0,0,0,0,47000,-47000,-47000
20200528,058193,緯穎永豐99購01,3.03,3.03,3.03,3.03,-0.03,-0.98,10000,1,30300,0,0,0,0,0,0,0,10000,-10000,-10000
20200528,058194,勤誠永豐99購01,,,,,0.00,0.00,0,0,0,0,0,0,0,0,0,0,0,0,0
20200528,058195,鈺齊永豐99購01,0.25,0.27,0.25,0.26,0.00,0.00,123000,7,31580,0,0,0,0,0,0,0,123000,-123000,-123000
20200528,058196,台塑中信99購01,0.61,0.61,0.53,0.54,-0.09,-14.29,263000,9,147620,0,0,0,0,0,0,50000,213000,-163000,-163000
20200528,058197,國巨中信99購02,0.20,0.20,0.19,0.19,-0.02,-9.52,720000,4,143900,0,0,0,0,0,0,710000,10000,700000,700000
20200528,058198,瑞昱亞東99購01,,,,,0.00,0.00,0,0,0,0,0,0,0,0,0,0,0,0,0
20200528,058199,國巨康和99購01,,,,,0.00,0.00,0,0,0,0,0,0,0,0,0,0,0,0,0
20200528,05819P,臺股指凱基96售16,,,,,0.00,0.00,0,0,0,0,0,0,0,0,0,0,0,0,0
20200528,058200,世芯康和99購01,1.23,1.26,1.15,1.25,+0.02,1.63,2053000,62,2474240,4000,0,4000,0,0,0,1230000,828000,402000,406000
20200528,058201,華通凱基9A購01,1.94,2.14,1.94,2.00,+0.19,10.5,90000,9,188120,0,0,0,0,0,0,1000,89000,-88000,-88000
20200528,058202,鴻海凱基9A購04,,,,,0.00,0.00,0,0,0,0,0,0,0,0,0,0,0,0,0
20200528,058203,信邦凱基99購01,1.56,1.57,1.53,1.54,-0.03,-1.91,80000,5,124060,0,0,0,0,0,0,0,56000,-56000,-56000
20200528,058204,世芯凱基9A購01,2.98,2.99,2.93,2.93,-0.01,-0.34,16000,3,47330,0,0,0,0,0,0,13000,3000,10000,10000
20200528,058205,神達凱基9B購01,0.57,0.57,0.57,0.57,0.00,0.00,12000,2,6840,0,0,0,0,0,0,0,12000,-12000,-12000
20200528,058206,祥碩凱基99購01,5.00,5.00,5.00,5.00,0.00,0.00,10000,1,50000,0,0,0,0,0,0,0,10000,-10000,-10000
20200528,058207,南茂凱基99購01,0.97,0.98,0.90,0.90,-0.11,-10.89,111000,5,106020,0,0,0,0,0,0,91000,20000,71000,71000
20200528,058208,百和凱基99購01,2.33,2.33,2.22,2.22,+0.01,0.45,86000,4,192440,0,0,0,0,0,0,16000,70000,-54000,-54000
20200528,058209,臺股指凱基01購01,0.59,0.61,0.48,0.49,-0.06,-10.91,1492000,23,827790,0,0,0,0,0,0,74000,1418000,-1344000,-1344000
20200528,05820P,臺股指凱基96售17,,,,,0.00,0.00,0,0,0,0,0,0,0,0,0,0,0,0,0
20200528,058210,臺股指凱基9C購04,0.92,0.92,0.75,0.77,-0.07,-8.33,742000,33,600270,0,0,0,0,0,0,120000,582000,-462000,-462000
20200528,058211,國巨群益9A購02,,,,,0.00,0.00,0,0,0,0,0,0,0,0,0,0,0,0,0
20200528,058212,華新科群益9A購01,1.16,1.16,1.14,1.14,0.00,0.00,58000,2,67180,0,0,0,0,0,0,58000,0,58000,58000
20200528,058213,欣興群益99購01,1.97,2.14,1.91,1.91,+0.06,3.24,242000,9,489860,0,0,0,0,0,0,78000,164000,-86000,-86000
20200528,058214,世芯群益9A購01,4.00,4.00,4.00,4.00,-0.49,-10.91,2000,1,8000,0,0,0,0,0,0,0,2000,-2000,-2000
20200528,058215,貿聯群益99購02,1.60,1.66,1.49,1.49,-0.08,-5.1,267000,15,423130,0,0,0,0,0,0,126000,141000,-15000,-15000
20200528,058216,TPK群益99購01,1.75,1.84,1.75,1.84,+0.12,6.98,13000,2,23020,0,0,0,0,0,0,13000,3000,10000,10000
20200528,058217,新唐群益99購01,0.72,0.77,0.72,0.77,+0.08,11.59,15000,2,11200,0,0,0,0,0,0,15000,0,15000,15000
20200528,058218,緯穎群益99購01,5.20,5.45,5.15,5.45,+0.30,5.83,53000,13,276850,0,0,0,0,0,0,53000,4000,49000,49000
20200528,058219,台灣50國票9A購02,,,,,0.00,0.00,0,0,0,0,0,0,0,0,0,0,0,0,0
20200528,05821P,臺股指凱基96售18,,,,,0.00,0.00,0,0,0,0,0,0,0,0,0,0,0,0,0
20200528,058220,世芯國票9A購01,5.05,5.05,4.92,4.94,-0.31,-5.9,16000,3,79440,0,0,0,0,0,0,4000,12000,-8000,-8000
20200528,058221,上銀統一99購04,0.94,1.00,0.80,0.80,-0.15,-15.79,390000,35,336410,0,0,0,0,0,0,190000,200000,-10000,-10000
20200528,058222,玉晶光統一9B購01,0.55,0.58,0.54,0.54,+0.02,3.85,30000,3,16700,0,0,0,0,0,0,10000,20000,-10000,-10000
20200528,058223,世芯統一9B購01,,,,,0.00,0.00,0,0,0,0,0,0,0,0,0,0,0,0,0
20200528,058224,世芯統一9B購02,2.20,2.20,2.20,2.20,-0.10,-4.35,5000,1,11000,0,0,0,0,0,0,5000,0,5000,5000
20200528,058225,旺宏元富99購01,2.49,2.49,2.32,2.32,-0.19,-7.57,162000,17,386920,0,0,0,0,0,0,162000,0,162000,162000
20200528,058226,世芯元富99購01,7.20,7.20,7.20,7.20,0.00,0.00,6000,1,43200,0,0,0,0,0,0,0,6000,-6000,-6000
20200528,058227,台灣50元大9C購01,,,,,0.00,0.00,0,0,0,0,0,0,0,0,0,0,0,0,0
20200528,058228,為升元大99購01,0.21,0.29,0.21,0.29,0.00,0.00,31000,2,6590,0,0,0,0,0,0,30000,0,30000,30000
20200528,058229,為升元大99購02,0.77,0.77,0.75,0.75,-0.02,-2.6,142000,3,108540,0,0,0,0,0,0,74000,68000,6000,6000
20200528,05822P,臺股指凱基96售19,1.70,2.13,1.70,2.13,+0.27,14.52,42000,6,80940,0,0,0,0,0,0,42000,0,42000,42000
20200528,058230,國巨元大99購11,,,,,0.00,0.00,0,0,0,0,0,0,0,0,0,0,0,0,0
20200528,058231,技嘉元大99購02,4.07,4.07,3.81,3.81,-0.36,-8.63,9000,4,35810,0,0,0,0,0,0,9000,8000,1000,1000
20200528,058232,聯發科元大99購05,7.40,7.40,7.40,7.40,0.00,0.00,4000,1,29600,0,0,0,0,0,0,0,4000,-4000,-4000
20200528,058233,聯發科元大99購06,,,,,0.00,0.00,0,0,0,0,0,0,0,0,0,0,0,0,0
20200528,058234,華新科元大99購12,,,,,0.00,0.00,0,0,0,0,0,0,0,0,0,0,0,0,0
20200528,058235,大立光元大99購08,,,,,0.00,0.00,0,0,0,0,0,0,0,0,0,0,0,0,0
20200528,058236,大立光元大99購09,2.07,2.07,1.88,1.88,-0.12,-6.0,180000,5,359200,0,0,0,0,0,0,60000,120000,-60000,-60000
20200528,058237,嘉晶元大99購04,,,,,0.00,0.00,0,0,0,0,0,0,0,0,0,0,0,0,0
20200528,058238,奇鋐元大99購02,4.41,4.77,4.41,4.42,+0.25,6.0,168000,15,766720,0,0,0,0,0,0,112000,118000,-6000,-6000
20200528,058239,景碩元大99購03,1.72,1.87,1.70,1.87,+0.07,3.89,94000,3,163320,0,0,0,0,0,0,6000,88000,-82000,-82000
20200528,05823P,臺股指凱基96售20,,,,,0.00,0.00,0,0,0,0,0,0,0,0,0,0,0,0,0
20200528,058240,景碩元大99購04,2.08,2.18,2.05,2.05,+0.01,0.49,139000,7,292860,0,0,0,0,0,0,50000,89000,-39000,-39000
20200528,058241,景碩元大99購05,1.85,1.98,1.83,1.88,+0.04,2.17,258000,12,490160,0,0,0,0,0,0,70000,188000,-118000,-118000
20200528,058242,玉晶光元大9A購01,,,,,0.00,0.00,0,0,0,0,0,0,0,0,0,0,0,0,0
20200528,058243,華擎元大99購01,1.88,1.88,1.81,1.82,0.00,0.00,296000,23,542520,0,0,0,0,0,0,246000,274000,-28000,-28000
20200528,058244,神達元大99購02,1.75,1.76,1.68,1.68,-0.04,-2.33,298000,6,514440,0,0,0,0,0,0,210000,110000,100000,100000
20200528,058245,訊連元大99購01,1.05,1.05,0.99,0.99,-0.07,-6.6,276000,6,279500,0,0,0,0,0,0,6000,270000,-264000,-264000
20200528,058246,帆宣元大99購01,1.15,1.20,1.11,1.11,+0.08,7.77,937000,27,1071890,0,0,0,0,0,0,853000,79000,774000,774000
20200528,058247,聯茂元大99購04,1.09,1.15,1.09,1.15,+0.07,6.48,130000,5,143240,0,0,0,0,0,0,6000,124000,-118000,-118000
20200528,058248,聯茂元大99購05,,,,,0.00,0.00,0,0,0,0,0,0,0,0,0,0,0,0,0
20200528,058249,緯穎元大99購04,5.15,5.20,5.10,5.10,-0.15,-2.86,30000,6,154750,0,0,0,0,0,0,30000,0,30000,30000
20200528,05824P,臺股指凱基96售21,,,,,0.00,0.00,0,0,0,0,0,0,0,0,0,0,0,0,0
20200528,058250,台虹元大99購01,2.72,2.73,2.52,2.52,-0.27,-9.68,301000,29,802060,0,0,0,0,0,0,121000,208000,-87000,-87000
20200528,058251,百和元大99購03,1.45,1.49,1.37,1.37,-0.02,-1.44,392000,12,555570,0,0,0,0,0,0,162000,230000,-68000,-68000
20200528,058252,臺股指元大9A購16,,,,,0.00,0.00,0,0,0,0,0,0,0,0,0,0,0,0,0
20200528,058253,臺股指元大9A購17,0.75,0.75,0.75,0.75,0.00,0.00,10000,1,7500,0,0,0,0,0,0,0,10000,-10000,-10000
20200528,058254,臺股指元大9A購18,,,,,0.00,0.00,0,0,0,0,0,0,0,0,0,0,0,0,0
20200528,058255,臺股指元大9A購19,5.60,5.60,5.60,5.60,0.00,0.00,10000,1,56000,0,0,0,0,0,0,0,10000,-10000,-10000
20200528,058256,臺股指元大9A購20,1.38,1.38,1.19,1.19,0.00,0.00,23000,4,28990,0,0,0,0,0,0,8000,15000,-7000,-7000
20200528,058257,聯陽國泰9B購01,4.03,4.03,4.03,4.03,-0.07,-1.71,10000,1,40300,0,0,0,0,0,0,10000,0,10000,10000
20200528,058258,世芯國泰9A購01,3.45,3.45,3.36,3.42,-0.17,-4.74,26000,3,88440,0,0,0,0,0,0,11000,17000,-6000,-6000
20200528,058259,訊連國泰9B購01,,,,,0.00,0.00,0,0,0,0,0,0,0,0,0,0,0,0,0
20200528,05825P,臺股指凱基96售22,,,,,0.00,0.00,0,0,0,0,0,0,0,0,0,0,0,0,0
20200528,058260,華新科富邦9C購01,,,,,0.00,0.00,0,0,0,0,0,0,0,0,0,0,0,0,0
20200528,058261,大立光富邦03購01,0.32,0.32,0.31,0.31,-0.04,-11.43,11000,3,3470,0,0,0,0,0,0,0,10000,-10000,-10000
20200528,058262,大立光富邦9C購02,1.23,1.23,1.22,1.22,+0.04,3.39,24000,3,29440,0,0,0,0,0,0,16000,8000,8000,8000
20200528,058263,大成鋼永豐99購01,1.07,1.18,1.07,1.18,+0.12,11.32,659000,17,730710,0,0,0,0,0,0,0,659000,-659000,-659000
20200528,058264,瑞昱永豐99購01,2.36,2.36,2.36,2.36,+0.07,3.06,10000,1,23600,0,0,0,0,0,0,0,10000,-10000,-10000
20200528,058265,奇力新永豐9A購01,0.61,0.61,0.61,0.61,0.00,0.00,30000,1,18300,0,0,0,0,0,0,30000,0,30000,30000
20200528,058266,宏達電永豐99購01,1.11,1.11,1.07,1.07,-0.14,-11.57,8000,2,8720,0,0,0,0,0,0,8000,8000,0,0
20200528,058267,奇鋐永豐99購01,0.77,0.92,0.77,0.82,+0.11,15.49,76000,8,62620,0,0,0,0,0,0,34000,42000,-8000,-8000
20200528,058268,泰碩永豐9A購01,,,,,0.00,0.00,0,0,0,0,0,0,0,0,0,0,0,0,0
20200528,058269,世芯永豐9A購01,3.09,3.09,2.94,2.99,-0.08,-2.61,16000,3,48590,0,0,0,0,0,0,11000,5000,6000,6000
20200528,05826P,臺股指凱基96售23,,,,,0.00,0.00,0,0,0,0,0,0,0,0,0,0,0,0,0
20200528,058270,上緯控永豐99購01,1.11,1.11,0.90,0.92,-0.10,-9.8,1352000,139,1337170,0,0,0,0,0,0,844000,337000,507000,507000
20200528,058271,訊連永豐99購01,0.55,0.55,0.51,0.51,-0.04,-7.27,137000,3,70950,0,0,0,0,0,0,0,137000,-137000,-137000
20200528,058272,超眾永豐9A購01,1.49,1.56,1.46,1.56,-0.11,-6.59,115000,6,176200,0,0,0,0,0,0,115000,0,115000,115000
20200528,058273,同欣電永豐99購01,0.64,0.64,0.64,0.64,-0.09,-12.33,12000,1,7680,0,0,0,0,0,0,12000,0,12000,12000
20200528,058274,世紀鋼永豐99購01,2.00,2.50,2.00,2.29,0.00,0.00,134000,12,304800,0,0,0,0,0,0,85000,35000,50000,50000
20200528,058275,S&P500中信9B購01,,,,,0.00,0.00,0,0,0,0,0,0,0,0,0,0,0,0,0
20200528,058276,道瓊指中信9C購01,,,,,0.00,0.00,0,0,0,0,0,0,0,0,0,0,0,0,0
20200528,058277,FBVIX中信03購01,,,,,0.00,0.00,0,0,0,0,0,0,0,0,0,0,0,0,0
20200528,058278,FBVIX中信03購02,2.58,2.58,2.58,2.58,0.00,0.00,3000,1,7740,0,0,0,0,0,0,3000,0,3000,3000
20200528,058279,FBVIX中信03購03,,,,,0.00,0.00,0,0,0,0,0,0,0,0,0,0,0,0,0
20200528,05827P,台積電統一96售10,,,,,0.00,0.00,0,0,0,0,0,0,0,0,0,0,0,0,0
20200528,058280,SGBR2X中信99購01,0.10,0.12,0.10,0.12,-0.04,-25.0,11000,2,1120,0,0,0,0,0,0,0,0,0,0
20200528,058281,奇力新中信99購01,,,,,0.00,0.00,0,0,0,0,0,0,0,0,0,0,0,0,0
20200528,058282,聯茂中信99購01,0.20,0.20,0.20,0.20,+0.04,25.0,6000,1,1200,0,0,0,0,0,0,0,6000,-6000,-6000
20200528,058283,世紀鋼中信99購01,1.28,1.76,1.28,1.76,+0.56,46.67,127000,9,177100,0,0,0,0,0,0,91000,0,91000,91000
20200528,058284,滬深反群益01購01,1.02,1.02,1.02,1.02,0.00,0.00,159000,2,162180,0,0,0,0,0,0,159000,0,159000,159000
20200528,058285,牧德群益9A購02,,,,,0.00,0.00,0,0,0,0,0,0,0,0,0,0,0,0,0
20200528,058286,道瓊指國票9B購01,1.90,1.90,1.90,1.90,+0.19,11.11,2000,1,3800,0,0,0,0,0,0,2000,0,2000,2000
20200528,058287,國巨國票9A購02,,,,,0.00,0.00,0,0,0,0,0,0,0,0,0,0,0,0,0
20200528,058288,南亞科國票9A購01,,,,,0.00,0.00,0,0,0,0,0,0,0,0,0,0,0,0,0
20200528,058289,奇鋐國票9A購01,4.86,5.30,4.86,5.30,+0.50,10.42,51000,8,249780,0,0,0,0,0,0,10000,41000,-31000,-31000
20200528,05828P,台積電統一97售02,,,,,0.00,0.00,0,0,0,0,0,0,0,0,0,0,0,0,0
20200528,058290,南電國票9A購01,3.60,3.69,3.38,3.39,-0.24,-6.61,213000,10,757840,0,0,0,0,0,0,72000,141000,-69000,-69000
20200528,058291,元油2X日盛99購01,,,,,0.00,0.00,0,0,0,0,0,0,0,0,0,0,0,0,0
20200528,058292,上銀凱基9A購01,2.40,2.41,2.40,2.41,-0.12,-4.74,48000,11,115300,0,0,0,0,0,0,48000,10000,38000,38000
20200528,058293,光寶科凱基9A購01,1.48,1.48,1.38,1.38,-0.09,-6.12,180000,17,262200,0,0,0,0,0,0,154000,6000,148000,148000
20200528,058294,華新科凱基9A購01,0.51,0.51,0.51,0.51,-0.02,-3.77,62000,10,31620,0,0,0,0,0,0,28000,34000,-6000,-6000
20200528,058295,欣興凱基99購02,1.91,2.00,1.87,1.87,+0.04,2.19,396000,13,756180,0,0,0,0,0,0,160000,236000,-76000,-76000
20200528,058296,明泰凱基99購01,,,,,0.00,0.00,0,0,0,0,0,0,0,0,0,0,0,0,0
20200528,058297,茂林凱基9A購02,1.25,1.28,1.19,1.19,-0.49,-29.17,122000,19,148470,0,0,0,0,0,0,122000,0,122000,122000
20200528,058298,聯茂凱基99購05,1.17,1.21,1.17,1.21,+0.03,2.54,170000,4,201700,0,0,0,0,0,0,0,170000,-170000,-170000
20200528,058299,同欣電凱基9A購01,,,,,0.00,0.00,0,0,0,0,0,0,0,0,0,0,0,0,0
20200528,05829P,臺股指統一96售08,,,,,0.00,0.00,0,0,0,0,0,0,0,0,0,0,0,0,0
20200528,058300,元油2X元大99購09,,,,,0.00,0.00,0,0,0,0,0,0,0,0,0,0,0,0,0
20200528,058301,元油2X元大99購10,,,,,0.00,0.00,0,0,0,0,0,0,0,0,0,0,0,0,0
20200528,058302,元油2X元大99購11,,,,,0.00,0.00,0,0,0,0,0,0,0,0,0,0,0,0,0
20200528,058303,華通元大99購03,,,,,0.00,0.00,0,0,0,0,0,0,0,0,0,0,0,0,0
20200528,058304,鴻海元大99購12,,,,,0.00,0.00,0,0,0,0,0,0,0,0,0,0,0,0,0
20200528,058305,華邦電元大99購02,0.68,0.73,0.64,0.64,-0.02,-3.03,84000,14,56330,0,0,0,0,0,0,18000,69000,-51000,-51000
20200528,058306,聯發科元大99購07,,,,,0.00,0.00,0,0,0,0,0,0,0,0,0,0,0,0,0
20200528,058307,聯發科元大99購08,,,,,0.00,0.00,0,0,0,0,0,0,0,0,0,0,0,0,0
20200528,058308,全新元大9B購01,0.59,0.59,0.57,0.57,+0.01,1.79,40000,3,23100,0,0,0,0,0,0,0,40000,-40000,-40000
20200528,058309,大毅元大99購02,3.49,3.49,3.33,3.33,-0.19,-5.4,86000,6,297220,0,0,0,0,0,0,43000,43000,0,0
20200528,05830P,滬深2X元富99售03,2.51,2.54,2.35,2.54,+0.04,1.6,50000,6,120130,0,0,0,0,0,0,1000,49000,-48000,-48000
20200528,058310,大立光元大99購10,,,,,0.00,0.00,0,0,0,0,0,0,0,0,0,0,0,0,0
20200528,058311,緯穎元大99購05,,,,,0.00,0.00,0,0,0,0,0,0,0,0,0,0,0,0,0
20200528,058312,大毅國泰9B購01,1.73,1.73,1.69,1.69,-0.05,-2.87,71000,2,121630,0,0,0,0,0,0,41000,30000,11000,11000
20200528,058313,台積電富邦9B購04,,,,,0.00,0.00,0,0,0,0,0,0,0,0,0,0,0,0,0
20200528,058314,欣興富邦9B購01,0.60,0.60,0.58,0.58,+0.01,1.75,6000,2,3500,0,0,0,0,0,0,0,1000,-1000,-1000
20200528,058315,TPK富邦9C購01,1.07,1.12,1.00,1.00,-0.05,-4.76,338000,20,372110,0,0,0,0,0,0,258000,83000,175000,175000
20200528,058316,元油2X永豐9A購03,,,,,0.00,0.00,0,0,0,0,0,0,0,0,0,0,0,0,0
20200528,058317,國巨永豐99購02,,,,,0.00,0.00,0,0,0,0,0,0,0,0,0,0,0,0,0
20200528,058318,致茂永豐9A購01,0.37,0.37,0.37,0.37,-0.05,-11.9,66000,1,24420,0,0,0,0,0,0,66000,0,66000,66000
20200528,058319,大毅永豐9A購01,0.94,0.94,0.93,0.94,+0.03,3.3,38000,6,35710,0,0,0,0,0,0,32000,17000,15000,15000
20200528,05831P,臺股指元富96售03,,,,,0.00,0.00,0,0,0,0,0,0,0,0,0,0,0,0,0
20200528,058320,華新科永豐99購02,0.34,0.35,0.30,0.30,-0.06,-16.67,90000,15,29760,0,0,0,0,0,0,40000,74000,-34000,-34000
20200528,058321,大立光永豐99購01,0.96,0.96,0.96,0.96,0.00,0.00,1000,1,960,0,0,0,0,0,0,1000,0,1000,1000
20200528,058322,玉晶光永豐99購02,0.74,0.82,0.73,0.73,+0.05,7.35,488000,27,380870,0,0,0,0,0,0,14000,454000,-440000,-440000
20200528,058323,泰鼎永豐9A購01,,,,,0.00,0.00,0,0,0,0,0,0,0,0,0,0,0,0,0
20200528,058324,嘉聯益永豐9A購01,1.15,1.28,1.15,1.15,+0.05,4.55,428000,18,528130,0,0,0,0,0,0,10000,428000,-418000,-418000
20200528,058325,昇陽半永豐99購01,0.35,0.36,0.35,0.35,+0.03,9.38,15000,3,5280,0,0,0,0,0,0,0,15000,-15000,-15000
20200528,058326,祥碩台新99購01,5.55,5.55,5.55,5.55,0.00,0.00,80000,1,444000,0,0,0,0,0,0,80000,0,80000,80000
20200528,058327,大毅統一9B購01,0.67,0.68,0.64,0.65,-0.02,-2.99,384000,22,251960,0,0,0,0,0,0,318000,60000,258000,258000
20200528,058328,世紀鋼統一9B購01,0.75,0.95,0.74,0.88,+0.12,15.79,1483000,66,1296690,0,0,0,0,0,0,1012000,471000,541000,541000
20200528,058329,S&P正2元富01購01,,,,,0.00,0.00,0,0,0,0,0,0,0,0,0,0,0,0,0
20200528,05832P,臺股指元富96售04,,,,,0.00,0.00,0,0,0,0,0,0,0,0,0,0,0,0,0
20200528,058330,鴻海元富99購01,,,,,0.00,0.00,0,0,0,0,0,0,0,0,0,0,0,0,0
20200528,058331,鴻海元富99購02,,,,,0.00,0.00,0,0,0,0,0,0,0,0,0,0,0,0,0
20200528,058332,鴻海元富99購03,1.31,1.31,1.31,1.31,0.00,0.00,1000,1,1310,0,0,0,0,0,0,1000,0,1000,1000
20200528,058333,鴻海元富99購04,2.12,2.13,2.12,2.13,+0.04,1.91,45000,4,95680,0,0,0,0,0,0,38000,7000,31000,31000
20200528,058334,鴻海元富99購05,2.02,2.03,2.02,2.03,+0.05,2.53,25000,2,50680,0,0,0,0,0,0,18000,7000,11000,11000
20200528,058335,鴻海元富99購06,1.99,2.01,1.99,2.01,+0.05,2.55,51000,4,101770,0,0,0,0,0,0,33000,18000,15000,15000
20200528,058336,鴻海元富99購07,,,,,0.00,0.00,0,0,0,0,0,0,0,0,0,0,0,0,0
20200528,058337,日月光元富99購01,0.78,0.79,0.76,0.76,+0.01,1.33,135000,5,106010,0,0,0,0,0,0,118000,17000,101000,101000
20200528,058338,康友元富99購01,0.53,0.54,0.48,0.48,0.00,0.00,100000,5,49700,0,0,0,0,0,0,60000,40000,20000,20000
20200528,058339,康友元富99購02,0.48,0.48,0.45,0.45,-0.02,-4.26,12000,2,5700,0,0,0,0,0,0,0,12000,-12000,-12000
20200528,05833P,臺股指元富96售05,,,,,0.00,0.00,0,0,0,0,0,0,0,0,0,0,0,0,0
20200528,058340,高股息群益99購01,,,,,0.00,0.00,0,0,0,0,0,0,0,0,0,0,0,0,0
20200528,058341,T50反1群益99購01,,,,,0.00,0.00,0,0,0,0,0,0,0,0,0,0,0,0,0
20200528,058342,鴻海群益9A購01,2.10,2.11,2.02,2.02,-0.04,-1.94,58000,3,122000,0,0,0,0,0,0,58000,2000,56000,56000
20200528,058343,台積電群益99購02,,,,,0.00,0.00,0,0,0,0,0,0,0,0,0,0,0,0,0
20200528,058344,旺宏群益99購05,2.11,2.11,1.95,1.95,-0.22,-10.14,112000,9,230340,0,0,0,0,0,0,87000,5000,82000,82000
20200528,058345,台光電群益99購03,3.41,3.41,3.00,3.00,-0.45,-13.04,16000,4,52230,0,0,0,0,0,0,0,16000,-16000,-16000
20200528,058346,嘉晶群益99購01,2.59,2.59,2.55,2.55,-0.26,-9.25,23000,5,58950,0,0,0,0,0,0,10000,13000,-3000,-3000
20200528,058347,玉晶光群益9B購01,6.80,7.30,6.80,6.80,+0.20,3.03,52000,26,364450,0,0,0,0,0,0,31000,42000,-11000,-11000
20200528,058348,台表科群益99購01,,,,,0.00,0.00,0,0,0,0,0,0,0,0,0,0,0,0,0
20200528,058349,滬深2X日盛9A購01,,,,,0.00,0.00,0,0,0,0,0,0,0,0,0,0,0,0,0
20200528,05834P,臺股指元富96售06,,,,,0.00,0.00,0,0,0,0,0,0,0,0,0,0,0,0,0
20200528,058350,T50正2凱基9B購01,,,,,0.00,0.00,0,0,0,0,0,0,0,0,0,0,0,0,0
20200528,058351,上銀凱基9A購02,,,,,0.00,0.00,0,0,0,0,0,0,0,0,0,0,0,0,0
20200528,058352,鴻海凱基9A購05,1.34,1.36,1.29,1.29,+0.03,2.38,93000,5,125100,0,0,0,0,0,0,79000,14000,65000,65000
20200528,058353,國巨凱基99購09,1.12,1.12,1.03,1.03,-0.03,-2.83,13000,4,13480,0,0,0,0,0,0,0,13000,-13000,-13000
20200528,058354,台積電凱基9A購06,0.93,0.93,0.92,0.92,0.00,0.00,10000,10,9250,0,0,0,0,0,0,0,10000,-10000,-10000
20200528,058355,旺宏凱基99購04,2.76,2.81,2.76,2.76,-0.04,-1.43,68000,12,188980,0,0,0,0,0,0,68000,0,68000,68000
20200528,058356,華邦電凱基99購01,1.23,1.32,1.00,1.00,-0.06,-5.66,201000,34,253070,0,0,0,0,0,0,181000,30000,151000,151000
20200528,058357,智邦凱基99購02,6.70,6.70,6.70,6.70,0.00,0.00,10000,1,67000,0,0,0,0,0,0,0,10000,-10000,-10000
20200528,058358,技嘉凱基9A購01,3.40,3.42,3.22,3.22,-0.39,-10.8,22000,3,74640,0,0,0,0,0,0,1000,22000,-21000,-21000
20200528,058359,瑞昱凱基99購01,3.50,3.50,3.50,3.50,0.00,0.00,20000,2,70000,0,0,0,0,0,0,20000,20000,0,0
20200528,05835P,臺股指元富96售07,,,,,0.00,0.00,0,0,0,0,0,0,0,0,0,0,0,0,0
20200528,058360,台光電凱基9A購02,,,,,0.00,0.00,0,0,0,0,0,0,0,0,0,0,0,0,0
20200528,058361,美律凱基99購06,1.25,1.25,1.25,1.25,+0.04,3.31,10000,1,12500,0,0,0,0,0,0,0,0,0,0
20200528,058362,聯發科凱基99購06,,,,,0.00,0.00,0,0,0,0,0,0,0,0,0,0,0,0,0
20200528,058363,全新凱基9A購02,1.69,1.75,1.69,1.74,+0.01,0.58,362000,17,624980,0,0,0,0,0,0,352000,0,352000,352000
20200528,058364,奇力新凱基99購04,,,,,0.00,0.00,0,0,0,0,0,0,0,0,0,0,0,0,0
20200528,058365,奇力新凱基9A購01,0.58,0.58,0.58,0.58,0.00,0.00,10000,1,5800,0,0,0,0,0,0,10000,10000,0,0
20200528,058366,元大金凱基99購01,,,,,0.00,0.00,0,0,0,0,0,0,0,0,0,0,0,0,0
20200528,058367,大立光凱基9A購01,,,,,0.00,0.00,0,0,0,0,0,0,0,0,0,0,0,0,0
20200528,058368,奇鋐凱基9A購01,2.01,2.20,2.01,2.14,+0.13,6.47,27000,6,57040,0,0,0,0,0,0,14000,9000,5000,5000
20200528,058369,亞光凱基99購02,1.55,1.56,1.54,1.54,+0.05,3.36,125000,4,193650,0,0,0,0,0,0,0,125000,-125000,-125000
20200528,05836P,臺股指元富96售08,,,,,0.00,0.00,0,0,0,0,0,0,0,0,0,0,0,0,0
20200528,058370,聯詠凱基99購01,0.65,0.66,0.65,0.66,-0.10,-13.16,30000,2,19700,0,0,0,0,0,0,10000,20000,-10000,-10000
20200528,058371,智原凱基9A購01,1.95,1.95,1.86,1.86,-0.03,-1.59,78000,10,150290,0,0,0,0,0,0,58000,20000,38000,38000
20200528,058372,欣興凱基99購03,2.04,2.24,2.04,2.14,+0.03,1.42,409000,13,896540,0,0,0,0,0,0,25000,384000,-359000,-359000
20200528,058373,晶技凱基99購02,,,,,0.00,0.00,0,0,0,0,0,0,0,0,0,0,0,0,0
20200528,058374,玉晶光凱基9A購03,1.62,1.65,1.62,1.63,0.00,0.00,48000,3,77940,0,0,0,0,0,0,0,48000,-48000,-48000
20200528,058375,群創凱基9B購04,1.14,1.14,1.13,1.13,-0.01,-0.88,84000,2,95320,0,0,0,0,0,0,44000,40000,4000,4000
20200528,058376,貿聯凱基9A購01,,,,,0.00,0.00,0,0,0,0,0,0,0,0,0,0,0,0,0
20200528,058377,茂林凱基9A購03,1.61,1.61,1.55,1.59,-0.02,-1.24,70000,22,112390,0,0,0,0,0,0,70000,0,70000,70000
20200528,058378,南電凱基99購01,,,,,0.00,0.00,0,0,0,0,0,0,0,0,0,0,0,0,0
20200528,058379,臺股指凱基99購14,0.67,0.68,0.52,0.55,-0.06,-9.84,430000,24,239300,0,0,0,0,0,0,268000,162000,106000,106000
20200528,05837P,臺股指富邦96售04,,,,,0.00,0.00,0,0,0,0,0,0,0,0,0,0,0,0,0
20200528,058380,臺股指凱基99購15,0.48,0.51,0.39,0.41,-0.06,-12.77,1165000,17,541120,0,0,0,0,0,0,719000,446000,273000,273000
20200528,058381,元石油中信9C購01,,,,,0.00,0.00,0,0,0,0,0,0,0,0,0,0,0,0,0
20200528,058382,S&P500中信99購01,,,,,0.00,0.00,0,0,0,0,0,0,0,0,0,0,0,0,0
20200528,058383,道瓊指中信9C購02,,,,,0.00,0.00,0,0,0,0,0,0,0,0,0,0,0,0,0
20200528,058384,大成鋼中信99購01,,,,,0.00,0.00,0,0,0,0,0,0,0,0,0,0,0,0,0
20200528,058385,創意中信99購01,0.91,0.96,0.86,0.86,0.00,0.00,333000,12,304670,0,0,0,0,0,0,10000,323000,-313000,-313000
20200528,058386,A50正2國票9B購01,,,,,0.00,0.00,0,0,0,0,0,0,0,0,0,0,0,0,0
20200528,058387,國巨國票9A購03,3.21,3.23,2.98,2.98,-0.15,-4.79,10000,6,30610,0,0,0,0,0,0,5000,10000,-5000,-5000
20200528,058388,健策國票9A購01,1.83,1.83,1.64,1.64,-0.19,-10.38,91000,2,156080,0,0,0,0,0,0,91000,91000,0,0
20200528,058389,聯茂國票9A購01,5.15,5.65,5.15,5.65,+0.25,4.63,55000,7,296000,0,0,0,0,0,0,20000,35000,-15000,-15000
20200528,05838P,臺股指富邦96售05,,,,,0.00,0.00,0,0,0,0,0,0,0,0,0,0,0,0,0
20200528,058390,樺漢國票9A購01,4.76,4.76,4.76,4.76,+0.03,0.63,40000,2,190400,0,0,0,0,0,0,0,40000,-40000,-40000
20200528,058391,T50反1元大99購02,0.39,0.53,0.39,0.53,-0.02,-3.64,24000,3,10940,0,0,0,0,0,0,9000,10000,-1000,-1000
20200528,058392,元油2X元大99購12,0.02,0.02,0.02,0.02,0.00,0.00,342000,7,6840,0,0,0,0,0,0,0,0,0,0
20200528,058393,元油2X元大99購13,,,,,0.00,0.00,0,0,0,0,0,0,0,0,0,0,0,0,0
20200528,058394,元油2X元大99購14,0.02,0.02,0.02,0.02,0.00,0.00,70000,1,1400,0,0,0,0,0,0,0,0,0,0
20200528,058395,元油2X元大99購15,,,,,0.00,0.00,0,0,0,0,0,0,0,0,0,0,0,0,0
20200528,058396,力山元大99購01,5.10,5.30,4.87,4.87,-0.23,-4.51,59000,8,304260,0,0,0,0,0,0,21000,38000,-17000,-17000
20200528,058397,大成鋼元大99購02,1.30,1.48,1.28,1.30,+0.05,4.0,523000,25,727470,0,0,0,0,0,0,79000,368000,-289000,-289000
20200528,058398,中環元大99購02,0.74,0.74,0.67,0.67,-0.10,-12.99,167000,9,121610,0,0,0,0,0,0,157000,10000,147000,147000
20200528,058399,美律元大99購05,0.74,0.75,0.72,0.72,+0.03,4.35,260000,7,192500,0,0,0,0,0,0,248000,10000,238000,238000
20200528,05839P,臺股指富邦96售06,,,,,0.00,0.00,0,0,0,0,0,0,0,0,0,0,0,0,0
20200528,058400,聯發科元大99購09,,,,,0.00,0.00,0,0,0,0,0,0,0,0,0,0,0,0,0
20200528,058401,華航元大9A購01,,,,,0.00,0.00,0,0,0,0,0,0,0,0,0,0,0,0,0
20200528,058402,欣興元大99購04,3.19,3.47,3.17,3.47,+0.27,8.44,160000,28,546250,0,0,0,0,0,0,44000,149000,-105000,-105000
20200528,058403,玉晶光元大99購12,3.48,3.68,3.39,3.39,+0.10,3.04,202000,61,721800,0,0,0,0,0,0,94000,202000,-108000,-108000
20200528,058404,貿聯元大99購02,,,,,0.00,0.00,0,0,0,0,0,0,0,0,0,0,0,0,0
20200528,058405,訊連元大99購02,1.06,1.06,1.00,1.00,-0.07,-6.54,268000,3,274000,0,0,0,0,0,0,0,268000,-268000,-268000
20200528,058406,聯茂元大99購06,0.83,0.87,0.83,0.87,+0.06,7.41,214000,4,178820,0,0,0,0,0,0,50000,164000,-114000,-114000
20200528,058407,滬深2X兆豐9A購01,,,,,0.00,0.00,0,0,0,0,0,0,0,0,0,0,0,0,0
20200528,058408,華通兆豐99購02,1.65,1.84,1.65,1.72,+0.16,10.26,356000,20,620530,0,0,0,0,0,0,113000,243000,-130000,-130000
20200528,058409,鴻海兆豐99購05,,,,,0.00,0.00,0,0,0,0,0,0,0,0,0,0,0,0,0
20200528,05840P,臺股指富邦96售07,,,,,0.00,0.00,0,0,0,0,0,0,0,0,0,0,0,0,0
20200528,058410,國巨兆豐99購03,1.68,1.69,1.68,1.69,+0.05,3.05,28000,3,47230,0,0,0,0,0,0,9000,19000,-10000,-10000
20200528,058411,技嘉兆豐99購01,,,,,0.00,0.00,0,0,0,0,0,0,0,0,0,0,0,0,0
20200528,058412,聯發科兆豐99購01,,,,,0.00,0.00,0,0,0,0,0,0,0,0,0,0,0,0,0
20200528,058413,義隆兆豐99購01,1.51,1.57,1.49,1.49,+0.10,7.19,465000,42,705580,0,0,0,0,0,0,207000,258000,-51000,-51000
20200528,058414,大立光兆豐99購02,,,,,0.00,0.00,0,0,0,0,0,0,0,0,0,0,0,0,0
20200528,058415,祥碩兆豐99購01,2.95,2.95,2.95,2.95,-0.16,-5.14,1000,1,2950,0,0,0,0,0,0,0,1000,-1000,-1000
20200528,058416,鴻海麥證99購01,,,,,0.00,0.00,0,0,0,0,0,0,0,0,0,0,0,0,0
20200528,058417,國巨麥證99購01,,,,,0.00,0.00,0,0,0,0,0,0,0,0,0,0,0,0,0
20200528,058418,台積電麥證99購01,,,,,0.00,0.00,0,0,0,0,0,0,0,0,0,0,0,0,0
20200528,058419,聯發科麥證99購02,,,,,0.00,0.00,0,0,0,0,0,0,0,0,0,0,0,0,0
20200528,05841P,華通元大96售04,,,,,0.00,0.00,0,0,0,0,0,0,0,0,0,0,0,0,0
20200528,058420,聯發科麥證99購03,,,,,0.00,0.00,0,0,0,0,0,0,0,0,0,0,0,0,0
20200528,058421,國泰金麥證01購01,1.48,1.48,1.43,1.43,-0.18,-11.18,14000,3,20620,0,14000,-14000,0,0,0,0,14000,-14000,-14000
20200528,058422,百和麥證99購01,2.08,2.08,1.89,1.92,+0.01,0.52,237000,22,466770,97000,140000,-43000,0,0,0,97000,140000,-43000,-43000
20200528,058423,臺股指麥證99購01,4.39,4.39,4.39,4.39,-0.47,-9.67,5000,1,21950,0,5000,-5000,0,0,0,0,5000,-5000,-5000
20200528,058424,滬深2X元富99購04,1.27,1.46,1.23,1.23,-0.04,-3.15,452000,12,621440,0,0,0,0,0,0,112000,340000,-228000,-228000
20200528,058425,S&P正2元富01購02,,,,,0.00,0.00,0,0,0,0,0,0,0,0,0,0,0,0,0
20200528,058426,旺宏元富99購02,,,,,0.00,0.00,0,0,0,0,0,0,0,0,0,0,0,0,0
20200528,058427,大毅元富99購01,1.68,1.68,1.68,1.68,-0.05,-2.89,2000,1,3360,0,0,0,0,0,0,0,2000,-2000,-2000
20200528,058428,大立光元富99購02,1.97,1.97,1.79,1.79,-0.19,-9.6,43000,4,83930,0,0,0,0,0,0,12000,31000,-19000,-19000
20200528,058429,欣興元富99購01,2.62,2.92,2.62,2.92,+0.24,8.96,483000,24,1360220,0,0,0,0,0,0,10000,473000,-463000,-463000
20200528,05842P,台積電元大96售15,4.06,4.06,4.06,4.06,0.00,0.00,3000,1,12180,0,0,0,0,0,0,0,3000,-3000,-3000
20200528,058430,滬深2X統一99購02,,,,,0.00,0.00,0,0,0,0,0,0,0,0,0,0,0,0,0
20200528,058431,國巨統一9B購01,1.18,1.20,1.10,1.10,-0.04,-3.51,215000,12,246370,0,0,0,0,0,0,131000,84000,47000,47000
20200528,058432,台積電統一9B購03,,,,,0.00,0.00,0,0,0,0,0,0,0,0,0,0,0,0,0
20200528,058433,台積電統一9B購04,,,,,0.00,0.00,0,0,0,0,0,0,0,0,0,0,0,0,0
20200528,058434,旺宏統一9B購01,1.29,1.30,1.28,1.29,-0.02,-1.53,107000,41,138110,0,0,0,0,0,0,107000,0,107000,107000
20200528,058435,旺宏統一9B購02,1.16,1.17,1.09,1.09,-0.09,-7.63,53000,14,60870,0,0,0,0,0,0,53000,0,53000,53000
20200528,058436,聯發科統一9B購03,,,,,0.00,0.00,0,0,0,0,0,0,0,0,0,0,0,0,0
20200528,058437,可成統一9B購01,,,,,0.00,0.00,0,0,0,0,0,0,0,0,0,0,0,0,0
20200528,058438,大立光統一9B購01,1.43,1.43,1.35,1.35,-0.04,-2.88,126000,6,179380,0,0,0,0,0,0,100000,26000,74000,74000
20200528,058439,玉晶光統一01購02,2.07,2.19,2.06,2.19,+0.19,9.5,95000,7,202860,0,0,0,0,0,0,5000,90000,-85000,-85000
20200528,05843P,台積電元大96售16,,,,,0.00,0.00,0,0,0,0,0,0,0,0,0,0,0,0,0
20200528,058440,玉晶光統一99購02,1.18,1.23,1.18,1.23,+0.12,10.81,7000,2,8310,0,0,0,0,0,0,6000,1000,5000,5000
20200528,058441,T50反1台新03購01,,,,,0.00,0.00,0,0,0,0,0,0,0,0,0,0,0,0,0
20200528,058442,玉晶光台新99購01,,,,,0.00,0.00,0,0,0,0,0,0,0,0,0,0,0,0,0
20200528,058443,T50正2富邦01購01,,,,,0.00,0.00,0,0,0,0,0,0,0,0,0,0,0,0,0
20200528,058444,國巨富邦9B購01,0.86,0.86,0.86,0.86,+0.01,1.18,10000,1,8600,0,0,0,0,0,0,10000,0,10000,10000
20200528,058445,旺宏富邦9C購01,0.68,0.68,0.60,0.60,-0.08,-11.76,98000,8,63960,0,0,0,0,0,0,30000,23000,7000,7000
20200528,058446,新光金富邦9C購01,,,,,0.00,0.00,0,0,0,0,0,0,0,0,0,0,0,0,0
20200528,058447,玉晶光富邦9A購02,,,,,0.00,0.00,0,0,0,0,0,0,0,0,0,0,0,0,0
20200528,058448,滬深2X永豐9A購01,,,,,0.00,0.00,0,0,0,0,0,0,0,0,0,0,0,0,0
20200528,058449,台積電永豐99購01,,,,,0.00,0.00,0,0,0,0,0,0,0,0,0,0,0,0,0
20200528,05844P,旺宏元大96售07,,,,,0.00,0.00,0,0,0,0,0,0,0,0,0,0,0,0,0
20200528,058450,旺宏永豐99購01,2.02,2.04,1.90,1.90,-0.18,-8.65,210000,9,410850,0,0,0,0,0,0,60000,150000,-90000,-90000
20200528,058451,智邦永豐9A購01,3.10,3.10,3.10,3.10,+0.54,21.09,16000,1,49600,0,0,0,0,0,0,16000,16000,0,0
20200528,058452,義隆永豐99購02,1.94,2.07,1.93,2.07,+0.26,14.36,159000,32,315740,0,0,0,0,0,0,85000,88000,-3000,-3000
20200528,058453,可成永豐99購01,0.73,0.73,0.70,0.70,-0.04,-5.41,35000,3,25000,0,0,0,0,0,0,35000,0,35000,35000
20200528,058454,嘉晶永豐99購01,2.54,2.54,2.54,2.54,-0.23,-8.3,5000,1,12700,0,0,0,0,0,0,5000,0,5000,5000
20200528,058455,玉晶光永豐99購03,,,,,0.00,0.00,0,0,0,0,0,0,0,0,0,0,0,0,0
20200528,058456,京鼎永豐99購01,1.12,1.12,1.10,1.11,-0.01,-0.89,102000,3,113220,0,0,0,0,0,0,2000,101000,-99000,-99000
20200528,058457,創意永豐99購01,0.86,0.94,0.84,0.87,+0.02,2.35,583000,48,520000,0,0,0,0,0,0,296000,307000,-11000,-11000
20200528,058458,牧德永豐9A購01,,,,,0.00,0.00,0,0,0,0,0,0,0,0,0,0,0,0,0
20200528,058459,南電永豐99購01,1.53,1.53,1.53,1.53,-0.11,-6.71,12000,1,18360,0,0,0,0,0,0,0,12000,-12000,-12000
20200528,05845P,大立光元大96售06,1.92,2.27,1.92,2.27,+0.07,3.18,2000,2,4190,0,0,0,0,0,0,1000,1000,0,0
20200528,058460,臺股指永豐99購01,,,,,0.00,0.00,0,0,0,0,0,0,0,0,0,0,0,0,0
20200528,058461,滬深2X永昌9C購01,,,,,0.00,0.00,0,0,0,0,0,0,0,0,0,0,0,0,0
20200528,058462,台積電兆豐99購01,0.59,0.59,0.59,0.59,0.00,0.00,44000,1,25960,0,0,0,0,0,0,44000,0,44000,44000
20200528,058463,宏達電兆豐99購02,,,,,0.00,0.00,0,0,0,0,0,0,0,0,0,0,0,0,0
20200528,058464,矽創兆豐9A購01,0.93,1.06,0.93,0.94,+0.12,14.63,583000,64,571790,0,0,0,0,0,0,220000,297000,-77000,-77000
20200528,058465,元石油中信01購01,,,,,0.00,0.00,0,0,0,0,0,0,0,0,0,0,0,0,0
20200528,058466,SGBR2X中信99購02,0.15,0.15,0.14,0.15,-0.01,-6.25,158000,14,22370,0,0,0,0,0,0,0,0,0,0
20200528,058467,日月光中信9A購01,0.28,0.28,0.28,0.28,0.00,0.00,10000,1,2800,0,0,0,0,0,0,0,10000,-10000,-10000
20200528,058468,聯茂中信99購02,0.41,0.47,0.41,0.46,+0.05,12.2,279000,14,121420,0,0,0,0,0,0,70000,209000,-139000,-139000
20200528,058469,臺股指中信9A購05,,,,,0.00,0.00,0,0,0,0,0,0,0,0,0,0,0,0,0
20200528,05846P,大立光元大96售07,2.90,2.90,2.90,2.90,-0.09,-3.01,227000,1,658300,0,0,0,0,0,0,227000,227000,0,0
20200528,058470,台灣50日盛9B購02,0.42,0.44,0.37,0.37,-0.04,-9.76,29000,4,11830,0,0,0,0,0,0,29000,0,29000,29000
20200528,058471,台積電日盛9C購01,,,,,0.00,0.00,0,0,0,0,0,0,0,0,0,0,0,0,0
20200528,058472,亞德客凱基9A購01,1.79,1.79,1.79,1.79,0.00,0.00,10000,1,17900,0,0,0,0,0,0,10000,10000,0,0
20200528,058473,上銀凱基9A購03,3.31,3.42,3.31,3.42,+0.07,2.09,47000,20,156840,0,0,0,0,0,0,47000,0,47000,47000
20200528,058474,鴻海凱基9A購06,1.15,1.17,1.15,1.17,+0.05,4.46,26000,2,30020,0,0,0,0,0,0,26000,26000,0,0
20200528,058475,台積電凱基99購06,,,,,0.00,0.00,0,0,0,0,0,0,0,0,0,0,0,0,0
20200528,058476,旺宏凱基9A購01,2.46,2.49,2.45,2.45,-0.06,-2.39,60000,14,147800,0,0,0,0,0,0,60000,0,60000,60000
20200528,058477,億光凱基9A購01,0.65,0.65,0.65,0.65,-0.02,-2.99,25000,1,16250,0,0,0,0,0,0,25000,0,25000,25000
20200528,058478,聯發科凱基9A購01,,,,,0.00,0.00,0,0,0,0,0,0,0,0,0,0,0,0,0
20200528,058479,亞光凱基9A購01,1.44,1.47,1.44,1.47,-0.01,-0.68,129000,4,189060,0,0,0,0,0,0,29000,100000,-71000,-71000
20200528,05847P,大立光元大96售08,3.19,3.19,3.19,3.19,0.00,0.00,10000,1,31900,0,0,0,0,0,0,10000,0,10000,10000
20200528,058480,新日興凱基9A購01,1.28,1.28,1.28,1.28,+0.12,10.34,50000,2,64000,0,0,0,0,0,0,40000,10000,30000,30000
20200528,058481,玉晶光凱基9A購04,1.71,1.80,1.71,1.80,+0.13,7.78,27000,2,46800,0,0,0,0,0,0,0,27000,-27000,-27000
20200528,058482,祥碩凱基99購02,3.49,3.57,3.49,3.57,-0.35,-8.93,20000,2,70600,0,0,0,0,0,0,10000,10000,0,0
20200528,058483,道瓊指國票9A購01,0.50,0.51,0.50,0.50,+0.07,16.28,391000,5,195810,0,0,0,0,0,0,391000,0,391000,391000
20200528,058484,元金2X國票04購01,,,,,0.00,0.00,0,0,0,0,0,0,0,0,0,0,0,0,0
20200528,058485,智邦國票9A購01,,,,,0.00,0.00,0,0,0,0,0,0,0,0,0,0,0,0,0
20200528,058486,大立光國票9A購01,1.11,1.11,1.11,1.11,0.00,0.00,3000,1,3330,0,0,0,0,0,0,0,3000,-3000,-3000
20200528,058487,晶技國票9A購01,6.80,6.80,6.75,6.80,-0.35,-4.9,15000,7,101900,0,0,0,0,0,0,15000,0,15000,15000
20200528,058488,華擎國票9A購01,5.90,6.00,5.90,6.00,0.00,0.00,998000,2,5938100,0,0,0,0,0,0,499000,499000,0,0
20200528,058489,台灣50群益9B購01,,,,,0.00,0.00,0,0,0,0,0,0,0,0,0,0,0,0,0
20200528,05848P,臺股指元大96售24,,,,,0.00,0.00,0,0,0,0,0,0,0,0,0,0,0,0,0
20200528,058490,元黃金群益9B購01,,,,,0.00,0.00,0,0,0,0,0,0,0,0,0,0,0,0,0
20200528,058491,滬深2X群益01購01,,,,,0.00,0.00,0,0,0,0,0,0,0,0,0,0,0,0,0
20200528,058492,華通群益9B購01,2.29,2.29,2.29,2.29,0.00,0.00,10000,1,22900,0,0,0,0,0,0,0,10000,-10000,-10000
20200528,058493,台積電群益9A購01,,,,,0.00,0.00,0,0,0,0,0,0,0,0,0,0,0,0,0
20200528,058494,可成群益9B購01,1.82,1.84,1.81,1.81,+0.07,4.02,62000,5,112730,0,0,0,0,0,0,29000,33000,-4000,-4000
20200528,058495,元大金群益9B購01,1.69,1.69,1.62,1.62,-0.08,-4.71,183000,4,306440,0,0,0,0,0,0,85000,98000,-13000,-13000
20200528,058496,文曄群益99購01,1.04,1.04,1.04,1.04,-0.03,-2.8,98000,1,101920,0,0,0,0,0,0,98000,0,98000,98000
20200528,058497,新日興群益9B購01,1.50,1.63,1.50,1.52,+0.08,5.56,242000,13,378680,0,0,0,0,0,0,4000,240000,-236000,-236000
20200528,058498,世紀鋼群益99購01,2.00,2.67,1.98,2.38,+0.35,17.24,451000,33,1037940,0,0,0,0,0,0,177000,274000,-97000,-97000
20200528,058499,滬深2X元大9C購01,0.58,0.63,0.55,0.55,-0.03,-5.17,312000,8,181030,0,0,0,0,0,0,5000,312000,-307000,-307000
20200528,05849P,臺股指元大96售25,,,,,0.00,0.00,0,0,0,0,0,0,0,0,0,0,0,0,0
20200528,058500,元石油元大9C購01,0.20,0.20,0.18,0.19,-0.03,-13.64,139000,9,27160,0,0,0,0,0,0,0,0,0,0
20200528,058501,S&P正2元大99購01,0.95,0.95,0.83,0.83,0.00,0.00,15000,2,13650,0,0,0,0,0,0,5000,10000,-5000,-5000
20200528,058502,鴻海元大99購13,2.42,2.42,2.40,2.42,+0.13,5.68,125000,5,301500,0,0,0,0,0,0,0,125000,-125000,-125000
20200528,058503,鴻海元大99購14,2.64,2.64,2.64,2.64,+0.07,2.72,91000,4,240240,0,0,0,0,0,0,91000,50000,41000,41000
20200528,058504,台積電元大99購07,,,,,0.00,0.00,0,0,0,0,0,0,0,0,0,0,0,0,0
20200528,058505,台積電元大99購08,2.53,2.53,2.28,2.28,-0.18,-7.32,73000,6,178780,0,0,0,0,0,0,28000,45000,-17000,-17000
20200528,058506,台積電元大99購09,,,,,0.00,0.00,0,0,0,0,0,0,0,0,0,0,0,0,0
20200528,058507,美律元大9A購01,0.81,0.83,0.79,0.80,+0.02,2.56,193000,11,157420,0,0,0,0,0,0,10000,183000,-173000,-173000
20200528,058508,聯發科元大99購11,,,,,0.00,0.00,0,0,0,0,0,0,0,0,0,0,0,0,0
20200528,058509,聯發科元大99購12,,,,,0.00,0.00,0,0,0,0,0,0,0,0,0,0,0,0,0
20200528,05850P,台積電兆豐96售06,,,,,0.00,0.00,0,0,0,0,0,0,0,0,0,0,0,0,0
20200528,058510,全新元大9B購02,0.48,0.49,0.48,0.49,+0.01,2.08,29000,3,14010,0,0,0,0,0,0,29000,0,29000,29000
20200528,058511,華新科元大9B購01,,,,,0.00,0.00,0,0,0,0,0,0,0,0,0,0,0,0,0
20200528,058512,宏達電元大99購04,0.99,0.99,0.87,0.87,-0.18,-17.14,142000,6,135060,0,0,0,0,0,0,76000,74000,2000,2000
20200528,058513,宏達電元大99購05,1.51,1.51,1.33,1.33,-0.19,-12.5,160000,6,224410,0,0,0,0,0,0,92000,86000,6000,6000
20200528,058514,潤泰全元大99購01,1.42,1.43,1.34,1.36,-0.04,-2.86,590000,34,826560,0,0,0,0,0,0,271000,342000,-71000,-71000
20200528,058515,健鼎元大99購01,1.44,1.56,1.44,1.47,+0.01,0.68,568000,22,855520,0,0,0,0,0,0,441000,97000,344000,344000
20200528,058516,健鼎元大99購02,1.50,1.60,1.50,1.54,+0.05,3.36,806000,16,1265290,0,0,0,0,0,0,20000,781000,-761000,-761000
20200528,058517,景碩元大99購06,1.84,1.93,1.84,1.93,+0.13,7.22,44000,3,82670,0,0,0,0,0,0,0,44000,-44000,-44000
20200528,058518,玉晶光元大99購13,0.86,0.91,0.86,0.86,+0.03,3.61,210000,11,184950,0,0,0,0,0,0,55000,150000,-95000,-95000
20200528,058519,嘉澤元大99購01,,,,,0.00,0.00,0,0,0,0,0,0,0,0,0,0,0,0,0
20200528,05851P,力山群益97售01,0.61,0.69,0.58,0.68,+0.02,3.03,270000,12,173110,0,0,0,0,0,0,70000,200000,-130000,-130000
20200528,058520,智易元大99購03,4.03,4.35,3.91,3.94,+0.10,2.6,244000,38,1020200,0,0,0,0,0,0,119000,204000,-85000,-85000
20200528,058521,日月光元大99購01,1.90,1.90,1.90,1.90,+0.01,0.53,26000,1,49400,0,0,0,0,0,0,26000,0,26000,26000
20200528,058522,聯茂元大99購07,0.71,0.74,0.71,0.74,+0.06,8.82,131000,4,93830,0,0,0,0,0,0,11000,130000,-119000,-119000
20200528,058523,聯茂元大99購08,0.55,0.59,0.54,0.56,-0.01,-1.75,404000,10,228370,0,0,0,0,0,0,130000,334000,-204000,-204000
20200528,058524,超眾元大99購04,2.40,2.49,2.34,2.49,+0.09,3.75,114000,10,278040,0,0,0,0,0,0,50000,80000,-30000,-30000
20200528,058525,台虹元大99購02,1.10,1.10,1.00,1.00,-0.08,-7.41,806000,17,868020,0,0,0,0,0,0,366000,456000,-90000,-90000
20200528,058526,鈺齊元大99購02,1.19,1.26,1.16,1.16,+0.08,7.41,261000,10,311760,0,0,0,0,0,0,34000,227000,-193000,-193000
20200528,058527,世紀鋼元大99購01,2.00,2.30,2.00,2.30,+0.42,22.34,46000,5,97000,0,0,0,0,0,0,21000,0,21000,21000
20200528,058528,世紀鋼元大99購02,0.91,0.91,0.87,0.91,+0.16,21.33,100000,6,87900,0,0,0,0,0,0,100000,0,100000,100000
20200528,058529,S&P正2元富9B購01,,,,,0.00,0.00,0,0,0,0,0,0,0,0,0,0,0,0,0
20200528,05852P,嘉晶群益96售01,,,,,0.00,0.00,0,0,0,0,0,0,0,0,0,0,0,0,0
20200528,058530,為升元富99購01,,,,,0.00,0.00,0,0,0,0,0,0,0,0,0,0,0,0,0
20200528,058531,華通元富99購01,3.42,3.83,3.41,3.58,+0.33,10.15,567000,37,2119010,0,0,0,0,0,0,200000,367000,-167000,-167000
20200528,058532,禾伸堂元富99購01,2.39,2.44,2.39,2.44,-0.02,-0.81,113000,8,270670,0,0,0,0,0,0,109000,4000,105000,105000
20200528,058533,玉晶光元富99購01,2.21,2.21,2.21,2.21,0.00,0.00,10000,1,22100,0,0,0,0,0,0,0,10000,-10000,-10000
20200528,058534,友達統一9B購01,,,,,0.00,0.00,0,0,0,0,0,0,0,0,0,0,0,0,0
20200528,058535,玉晶光統一9A購06,0.87,0.87,0.85,0.85,+0.04,4.94,15000,2,12850,0,0,0,0,0,0,5000,10000,-5000,-5000
20200528,058536,群創統一9B購01,,,,,0.00,0.00,0,0,0,0,0,0,0,0,0,0,0,0,0
20200528,058537,彩晶統一9B購01,0.74,0.75,0.72,0.72,0.00,0.00,262000,7,194110,0,0,0,0,0,0,69000,193000,-124000,-124000
20200528,058538,智邦台新99購02,5.85,5.85,5.20,5.20,0.00,0.00,8000,4,45100,0,0,0,0,0,0,8000,8000,0,0
20200528,058539,聯發科台新99購01,,,,,0.00,0.00,0,0,0,0,0,0,0,0,0,0,0,0,0
20200528,05853P,欣興群益96售05,,,,,0.00,0.00,0,0,0,0,0,0,0,0,0,0,0,0,0
20200528,058540,嘉聯益國泰9A購02,1.30,1.34,1.30,1.34,0.00,0.00,98000,2,128120,0,0,0,0,0,0,98000,0,98000,98000
20200528,058541,T50反1富邦01購01,,,,,0.00,0.00,0,0,0,0,0,0,0,0,0,0,0,0,0
20200528,058542,T50反1富邦9B購01,,,,,0.00,0.00,0,0,0,0,0,0,0,0,0,0,0,0,0
20200528,058543,滬深2X富邦9A購01,,,,,0.00,0.00,0,0,0,0,0,0,0,0,0,0,0,0,0
20200528,058544,FBVIX富邦9B購01,3.30,3.31,3.30,3.31,-0.03,-0.9,25000,3,82730,0,0,0,0,0,0,13000,25000,-12000,-12000
20200528,058545,義隆富邦9C購01,1.32,1.39,1.32,1.33,+0.05,3.91,27000,14,36250,0,0,0,0,0,0,19000,21000,-2000,-2000
20200528,058546,玉晶光富邦9B購01,0.67,0.67,0.65,0.65,0.00,0.00,100000,3,65220,0,0,0,0,0,0,0,100000,-100000,-100000
20200528,058547,世紀鋼富邦9A購01,0.62,0.84,0.62,0.77,+0.12,18.46,599000,95,448470,0,0,0,0,0,0,178000,23000,155000,155000
20200528,058548,元石油永豐99購01,,,,,0.00,0.00,0,0,0,0,0,0,0,0,0,0,0,0,0
20200528,058549,藍天永豐99購01,,,,,0.00,0.00,0,0,0,0,0,0,0,0,0,0,0,0,0
20200528,05854P,華新科凱基96售09,,,,,0.00,0.00,0,0,0,0,0,0,0,0,0,0,0,0,0
20200528,058550,南亞科永豐99購01,1.40,1.40,1.40,1.40,+0.14,11.11,25000,3,35000,0,0,0,0,0,0,0,25000,-25000,-25000
20200528,058551,義隆永豐99購03,1.91,2.03,1.89,2.03,+0.25,14.04,130000,28,254400,0,0,0,0,0,0,52000,90000,-38000,-38000
20200528,058552,欣興永豐99購01,,,,,0.00,0.00,0,0,0,0,0,0,0,0,0,0,0,0,0
20200528,058553,合勤控永豐99購01,0.89,0.89,0.89,0.89,-0.16,-15.24,1000,1,890,0,0,0,0,0,0,1000,0,1000,1000
20200528,058554,瀚宇博永豐99購01,0.90,0.94,0.90,0.91,-0.02,-2.15,78000,3,71180,0,0,0,0,0,0,68000,10000,58000,58000
20200528,058555,矽創永豐9A購01,1.36,1.49,1.35,1.35,+0.10,8.0,323000,16,463170,0,0,0,0,0,0,55000,268000,-213000,-213000
20200528,058556,百和永豐99購01,1.57,1.58,1.50,1.50,+0.05,3.45,140000,9,216120,0,0,0,0,0,0,107000,33000,74000,74000
20200528,058557,健策第一01購01,1.94,1.95,1.78,1.78,-0.10,-5.32,90000,9,171600,0,0,0,0,0,0,80000,10000,70000,70000
20200528,058558,鴻海日盛9A購02,,,,,0.00,0.00,0,0,0,0,0,0,0,0,0,0,0,0,0
20200528,058559,華新科日盛99購02,1.09,1.11,1.09,1.11,-0.01,-0.89,103000,36,113050,0,0,0,0,0,0,103000,0,103000,103000
20200528,05855P,滬深2X中信9C售01,,,,,0.00,0.00,0,0,0,0,0,0,0,0,0,0,0,0,0
20200528,058560,T50反1凱基9A購04,,,,,0.00,0.00,0,0,0,0,0,0,0,0,0,0,0,0,0
20200528,058561,T50反1凱基9A購05,,,,,0.00,0.00,0,0,0,0,0,0,0,0,0,0,0,0,0
20200528,058562,元油2X凱基99購01,,,,,0.00,0.00,0,0,0,0,0,0,0,0,0,0,0,0,0
20200528,058563,元油2X凱基9B購07,,,,,0.00,0.00,0,0,0,0,0,0,0,0,0,0,0,0,0
20200528,058564,元金2X凱基9C購01,,,,,0.00,0.00,0,0,0,0,0,0,0,0,0,0,0,0,0
20200528,058565,鴻海凱基9A購07,,,,,0.00,0.00,0,0,0,0,0,0,0,0,0,0,0,0,0
20200528,058566,聯發科凱基9A購02,9.10,9.10,8.75,8.75,-0.25,-2.78,15000,3,133000,0,0,0,0,0,0,15000,10000,5000,5000
20200528,058567,華新科凱基9A購02,,,,,0.00,0.00,0,0,0,0,0,0,0,0,0,0,0,0,0
20200528,058568,宏達電凱基9A購02,1.08,1.08,0.99,0.99,-0.09,-8.33,408000,5,426040,0,0,0,0,0,0,208000,208000,0,0
20200528,058569,健策凱基9A購01,3.00,3.13,2.64,2.64,-0.24,-8.33,130000,19,378090,0,0,0,0,0,0,130000,33000,97000,97000
20200528,05856P,A50正2中信99售01,,,,,0.00,0.00,0,0,0,0,0,0,0,0,0,0,0,0,0
20200528,058570,臻鼎凱基9A購01,,,,,0.00,0.00,0,0,0,0,0,0,0,0,0,0,0,0,0
20200528,058571,緯穎凱基9A購02,2.86,2.86,2.86,2.86,-0.11,-3.7,20000,1,57200,0,0,0,0,0,0,20000,0,20000,20000
20200528,058572,百和凱基9A購01,3.18,3.18,3.03,3.03,+0.01,0.33,85000,5,259790,0,0,0,0,0,0,15000,70000,-55000,-55000
20200528,058573,鴻海群益9A購02,2.51,2.52,2.39,2.39,-0.06,-2.45,43000,10,107560,0,0,0,0,0,0,43000,12000,31000,31000
20200528,058574,台積電群益99購03,2.74,2.74,2.74,2.74,-0.08,-2.84,2000,1,5480,0,0,0,0,0,0,0,2000,-2000,-2000
20200528,058575,智邦群益99購01,,,,,0.00,0.00,0,0,0,0,0,0,0,0,0,0,0,0,0
20200528,058576,南亞科群益99購01,0.95,0.95,0.90,0.90,+0.04,4.65,30000,3,27900,0,0,0,0,0,0,0,30000,-30000,-30000
20200528,058577,南亞科群益99購02,1.29,1.29,1.09,1.09,-0.05,-4.39,143000,4,177120,0,0,0,0,0,0,98000,45000,53000,53000
20200528,058578,聯發科群益99購03,,,,,0.00,0.00,0,0,0,0,0,0,0,0,0,0,0,0,0
20200528,058579,聯發科群益99購04,11.70,11.80,11.70,11.80,-0.40,-3.28,10000,2,117100,0,0,0,0,0,0,9000,1000,8000,8000
20200528,05857P,旺宏中信98售02,,,,,0.00,0.00,0,0,0,0,0,0,0,0,0,0,0,0,0
20200528,058580,華新科群益99購02,,,,,0.00,0.00,0,0,0,0,0,0,0,0,0,0,0,0,0
20200528,058581,大立光群益99購05,,,,,0.00,0.00,0,0,0,0,0,0,0,0,0,0,0,0,0
20200528,058582,禾伸堂群益99購02,,,,,0.00,0.00,0,0,0,0,0,0,0,0,0,0,0,0,0
20200528,058583,臻鼎群益99購01,2.27,2.27,2.17,2.17,-0.27,-11.07,10000,2,22200,0,0,0,0,0,0,10000,10000,0,0
20200528,058584,百和群益9A購01,2.00,2.00,1.88,1.88,0.00,0.00,255000,12,490910,0,0,0,0,0,0,79000,176000,-97000,-97000
20200528,058585,S&P正2中信9B購02,0.81,0.82,0.81,0.82,+0.09,12.33,12000,2,9740,0,0,0,0,0,0,10000,2000,8000,8000
20200528,058586,鴻海中信01購02,0.54,0.54,0.51,0.53,+0.01,1.92,283000,12,150640,0,0,0,0,0,0,147000,136000,11000,11000
20200528,058587,台積電中信9C購03,0.61,0.62,0.58,0.58,-0.02,-3.33,157000,10,93260,0,0,0,0,0,0,0,157000,-157000,-157000
20200528,058588,致茂中信9B購01,1.32,1.36,1.30,1.30,-0.02,-1.52,170000,13,226300,0,0,0,0,0,0,135000,56000,79000,79000
20200528,058589,群創中信01購01,1.02,1.02,1.02,1.02,-0.02,-1.92,25000,2,25500,0,0,0,0,0,0,0,25000,-25000,-25000
20200528,05858P,矽力中信96售01,,,,,0.00,0.00,0,0,0,0,0,0,0,0,0,0,0,0,0
20200528,058590,南電中信9A購02,0.36,0.40,0.36,0.38,0.00,0.00,50000,4,19100,0,0,0,0,0,0,10000,40000,-30000,-30000
20200528,058591,台灣50統一9B購02,,,,,0.00,0.00,0,0,0,0,0,0,0,0,0,0,0,0,0
20200528,058592,聯發科統一9C購01,2.59,2.59,2.47,2.47,-0.08,-3.14,30000,2,76500,0,0,0,0,0,0,30000,0,30000,30000
20200528,058593,大立光統一9B購02,0.88,0.88,0.88,0.88,+0.01,1.15,30000,1,26400,0,0,0,0,0,0,30000,0,30000,30000
20200528,058594,台灣50元富9B購03,,,,,0.00,0.00,0,0,0,0,0,0,0,0,0,0,0,0,0
20200528,058595,T50正2元富99購01,,,,,0.00,0.00,0,0,0,0,0,0,0,0,0,0,0,0,0
20200528,058596,旺宏台新99購01,1.51,1.51,1.45,1.45,-0.03,-2.03,38000,2,55700,0,0,0,0,0,0,28000,10000,18000,18000
20200528,058597,瑞昱台新99購01,,,,,0.00,0.00,0,0,0,0,0,0,0,0,0,0,0,0,0
20200528,058598,T50反1元大99購04,1.28,1.28,1.28,1.28,0.00,0.00,82000,3,104960,0,0,0,0,0,0,0,82000,-82000,-82000
20200528,058599,T50反1元大99購05,,,,,0.00,0.00,0,0,0,0,0,0,0,0,0,0,0,0,0
20200528,05859P,台表科國票97售04,0.80,0.87,0.78,0.85,+0.10,13.33,378000,7,313400,0,0,0,0,0,0,10000,368000,-358000,-358000
20200528,058600,國巨元大99購15,,,,,0.00,0.00,0,0,0,0,0,0,0,0,0,0,0,0,0
20200528,058601,台積電元大99購10,2.15,2.15,2.15,2.15,-0.02,-0.92,13000,2,27950,0,0,0,0,0,0,3000,0,3000,3000
20200528,058602,台積電元大99購11,,,,,0.00,0.00,0,0,0,0,0,0,0,0,0,0,0,0,0
20200528,058603,台積電元大99購12,,,,,0.00,0.00,0,0,0,0,0,0,0,0,0,0,0,0,0
20200528,058604,華邦電元大99購03,0.97,1.04,0.78,0.79,-0.16,-16.84,532000,38,510130,0,0,0,0,0,0,346000,177000,169000,169000
20200528,058605,華邦電元大99購04,0.97,1.03,0.79,0.80,-0.20,-20.0,1161000,49,1104700,0,0,0,0,0,0,921000,359000,562000,562000
20200528,058606,聯發科元大99購13,,,,,0.00,0.00,0,0,0,0,0,0,0,0,0,0,0,0,0
20200528,058607,聯發科元大99購14,,,,,0.00,0.00,0,0,0,0,0,0,0,0,0,0,0,0,0
20200528,058608,華新科元大99購13,,,,,0.00,0.00,0,0,0,0,0,0,0,0,0,0,0,0,0
20200528,058609,玉山金元大99購01,,,,,0.00,0.00,0,0,0,0,0,0,0,0,0,0,0,0,0
20200528,05860P,旺宏康和96售01,0.66,0.66,0.66,0.66,0.00,0.00,18000,1,11880,0,0,0,0,0,0,0,18000,-18000,-18000
20200528,058610,欣興元大99購05,2.70,2.92,2.70,2.73,+0.10,3.8,280000,21,791790,0,0,0,0,0,0,82000,195000,-113000,-113000
20200528,058611,欣興元大99購06,2.78,2.94,2.78,2.94,+0.17,6.14,108000,6,308170,0,0,0,0,0,0,3000,108000,-105000,-105000
20200528,058612,健策元大99購02,5.55,5.55,5.30,5.30,-0.05,-0.93,55000,8,298550,0,0,0,0,0,0,55000,3000,52000,52000
20200528,058613,茂林元大99購03,1.68,1.68,1.56,1.61,-0.04,-2.42,301000,24,487360,0,0,0,0,0,0,151000,148000,3000,3000
20200528,058614,台郡元大9A購01,,,,,0.00,0.00,0,0,0,0,0,0,0,0,0,0,0,0,0
20200528,058615,矽創元大99購01,1.27,1.35,1.24,1.24,0.00,0.00,90000,10,118800,0,0,0,0,0,0,0,90000,-90000,-90000
20200528,058616,台虹元大9A購01,0.70,0.70,0.66,0.66,-0.02,-2.94,235000,10,159710,0,0,0,0,0,0,135000,169000,-34000,-34000
20200528,058617,南電元大99購01,3.08,3.08,3.01,3.01,-0.29,-8.79,41000,2,126070,0,0,0,0,0,0,0,41000,-41000,-41000
20200528,058618,南電元大99購02,3.06,3.11,2.90,2.90,-0.14,-4.61,22000,9,65790,0,0,0,0,0,0,10000,12000,-2000,-2000
20200528,058619,台灣50國票99購04,,,,,0.00,0.00,0,0,0,0,0,0,0,0,0,0,0,0,0
20200528,05861P,瀚宇博永豐96售02,0.98,0.98,0.98,0.98,-0.11,-10.09,47000,1,46060,0,0,0,0,0,0,47000,0,47000,47000
20200528,058620,滬深2X國票9A購02,,,,,0.00,0.00,0,0,0,0,0,0,0,0,0,0,0,0,0
20200528,058621,華通國票9A購01,2.53,2.73,2.50,2.50,+0.14,5.93,94000,4,238080,0,0,0,0,0,0,94000,8000,86000,86000
20200528,058622,國巨國票99購07,2.34,2.39,2.15,2.15,-0.11,-4.87,195000,19,438800,0,0,0,0,0,0,91000,104000,-13000,-13000
20200528,058623,國巨國票99購08,2.04,2.04,2.04,2.04,0.00,0.00,1000,1,2040,0,0,0,0,0,0,0,1000,-1000,-1000
20200528,058624,台積電國票99購09,,,,,0.00,0.00,0,0,0,0,0,0,0,0,0,0,0,0,0
20200528,058625,旺宏國票9A購01,2.72,2.72,2.51,2.51,-0.27,-9.71,134000,10,358230,0,0,0,0,0,0,124000,10000,114000,114000
20200528,058626,瑞昱國票9A購01,4.65,4.67,4.65,4.65,+0.22,4.97,24000,6,111980,0,0,0,0,0,0,5000,19000,-14000,-14000
20200528,058627,聯發科國票99購04,,,,,0.00,0.00,0,0,0,0,0,0,0,0,0,0,0,0,0
20200528,058628,宏達電國票9A購01,0.94,0.94,0.93,0.93,-0.17,-15.45,21000,2,19540,0,0,0,0,0,0,20000,1000,19000,19000
20200528,058629,嘉晶國票9A購01,3.56,3.56,3.33,3.33,0.00,0.00,7000,5,24280,0,0,0,0,0,0,7000,0,7000,7000
20200528,05862P,大立光國泰98售01,2.17,2.17,2.17,2.17,0.00,0.00,68000,1,147560,0,0,0,0,0,0,68000,68000,0,0
20200528,058630,日月光國票9A購01,2.16,2.16,2.09,2.09,-0.10,-4.57,97000,4,206400,0,0,0,0,0,0,38000,59000,-21000,-21000
20200528,058631,鈺齊國票9A購01,6.85,7.00,6.70,7.00,+1.30,22.81,42000,4,285400,0,0,0,0,0,0,40000,2000,38000,38000
20200528,058632,世紀鋼國票9A購01,6.70,6.85,6.55,6.55,0.00,0.00,55000,7,362700,0,0,0,0,0,0,7000,48000,-41000,-41000
20200528,058633,台灣50兆豐99購01,,,,,0.00,0.00,0,0,0,0,0,0,0,0,0,0,0,0,0
20200528,058634,可成兆豐99購03,,,,,0.00,0.00,0,0,0,0,0,0,0,0,0,0,0,0,0
20200528,058635,華新科兆豐99購03,,,,,0.00,0.00,0,0,0,0,0,0,0,0,0,0,0,0,0
20200528,058636,亞光兆豐9A購01,,,,,0.00,0.00,0,0,0,0,0,0,0,0,0,0,0,0,0
20200528,058637,晶技兆豐99購01,2.08,2.11,1.99,1.99,-0.17,-7.87,236000,25,485270,0,0,0,0,0,0,190000,46000,144000,144000
20200528,058638,矽力兆豐99購01,3.40,3.40,3.40,3.40,0.00,0.00,1000,1,3400,0,0,0,0,0,0,1000,0,1000,1000
20200528,058639,南電兆豐99購01,1.65,1.70,1.60,1.60,-0.07,-4.19,155000,4,254000,0,0,0,0,0,0,155000,0,155000,155000
20200528,05863P,滬深2X元大96售09,,,,,0.00,0.00,0,0,0,0,0,0,0,0,0,0,0,0,0
20200528,058640,台灣50麥證9A購01,,,,,0.00,0.00,0,0,0,0,0,0,0,0,0,0,0,0,0
20200528,058641,鴻海麥證99購02,0.68,0.68,0.67,0.67,0.00,0.00,180000,2,121600,180000,0,180000,0,0,0,180000,180000,0,0
20200528,058642,旺宏麥證9A購01,1.29,1.31,1.29,1.29,-0.04,-3.01,40000,8,51850,40000,0,40000,0,0,0,40000,0,40000,40000
20200528,058643,T50正2富邦03購01,,,,,0.00,0.00,0,0,0,0,0,0,0,0,0,0,0,0,0
20200528,058644,元黃金富邦03購01,1.27,1.27,1.27,1.27,0.00,0.00,1000,1,1270,0,0,0,0,0,0,0,1000,-1000,-1000
20200528,058645,康控富邦01購01,0.51,0.57,0.49,0.49,-0.10,-16.95,214000,10,109530,0,0,0,0,0,0,0,213000,-213000,-213000
20200528,058646,聯茂富邦9A購01,0.26,0.29,0.26,0.28,+0.03,12.0,364000,13,99290,0,0,0,0,0,0,322000,42000,280000,280000
20200528,058647,華新科永豐99購03,0.81,0.81,0.81,0.81,-0.05,-5.81,20000,5,16200,0,0,0,0,0,0,20000,0,20000,20000
20200528,058648,聯陽永豐99購01,1.61,1.64,1.54,1.54,-0.13,-7.78,292000,16,464530,0,0,0,0,0,0,172000,120000,52000,52000
20200528,058649,健策永豐99購01,3.20,3.20,3.07,3.09,+0.15,5.1,123000,16,382400,0,0,0,0,0,0,123000,0,123000,123000
20200528,05864P,元油反元大96售07,,,,,0.00,0.00,0,0,0,0,0,0,0,0,0,0,0,0,0
20200528,058650,台虹永豐9A購01,,,,,0.00,0.00,0,0,0,0,0,0,0,0,0,0,0,0,0
20200528,058651,FBVIX中信9C購01,1.75,1.79,1.75,1.79,0.00,0.00,137000,6,244650,0,0,0,0,0,0,111000,25000,86000,86000
20200528,058652,SGBR2X中信01購01,0.19,0.19,0.19,0.19,-0.02,-9.52,55000,3,10450,0,0,0,0,0,0,0,0,0,0
20200528,058653,光寶科中信9A購01,,,,,0.00,0.00,0,0,0,0,0,0,0,0,0,0,0,0,0
20200528,058654,鴻海中信03購01,2.21,2.21,2.15,2.15,-0.02,-0.92,23000,7,50570,0,0,0,0,0,0,16000,16000,0,0
20200528,058655,鴻海中信03購02,,,,,0.00,0.00,0,0,0,0,0,0,0,0,0,0,0,0,0
20200528,058656,燿華中信99購01,0.61,0.61,0.54,0.54,-0.03,-5.26,113000,10,62940,0,0,0,0,0,0,62000,47000,15000,15000
20200528,058657,大立光中信99購01,,,,,0.00,0.00,0,0,0,0,0,0,0,0,0,0,0,0,0
20200528,058658,瑞儀中信99購01,1.99,2.05,1.99,2.00,-0.03,-1.48,165000,6,329750,0,0,0,0,0,0,55000,115000,-60000,-60000
20200528,058659,力成中信99購01,1.39,1.39,1.39,1.39,0.00,0.00,8000,1,11120,0,0,0,0,0,0,8000,0,8000,8000
20200528,05865P,大立光元大96售09,,,,,0.00,0.00,0,0,0,0,0,0,0,0,0,0,0,0,0
20200528,058660,樺漢中信9A購01,0.94,1.00,0.94,0.96,0.00,0.00,620000,19,606800,0,0,0,0,0,0,230000,390000,-160000,-160000
20200528,058661,臺股指中信9C購01,0.73,0.73,0.73,0.73,0.00,0.00,200000,1,146000,0,0,0,0,0,0,200000,0,200000,200000
20200528,058662,禾伸堂兆豐99購01,,,,,0.00,0.00,0,0,0,0,0,0,0,0,0,0,0,0,0
20200528,058663,瑞儀兆豐9A購01,1.39,1.41,1.35,1.41,+0.03,2.17,111000,6,154390,0,0,0,0,0,0,41000,0,41000,41000
20200528,058664,百和兆豐99購01,1.31,1.31,1.20,1.21,-0.01,-0.82,371000,34,466670,0,0,0,0,0,0,225000,146000,79000,79000
20200528,058665,台灣50群益9B購02,,,,,0.00,0.00,0,0,0,0,0,0,0,0,0,0,0,0,0
20200528,058666,上証反群益01購01,0.65,0.65,0.65,0.65,0.00,0.00,223000,2,144950,0,0,0,0,0,0,223000,0,223000,223000
20200528,058667,元油2X群益99購01,,,,,0.00,0.00,0,0,0,0,0,0,0,0,0,0,0,0,0
20200528,058668,元油2X群益9B購04,0.06,0.10,0.06,0.10,0.00,0.00,100000,2,6040,0,0,0,0,0,0,0,1000,-1000,-1000
20200528,058669,上銀群益99購01,,,,,0.00,0.00,0,0,0,0,0,0,0,0,0,0,0,0,0
20200528,05866P,致伸元大96售01,,,,,0.00,0.00,0,0,0,0,0,0,0,0,0,0,0,0,0
20200528,058670,鴻海群益9A購03,0.69,0.70,0.64,0.64,-0.05,-7.25,211000,5,143100,0,0,0,0,0,0,190000,21000,169000,169000
20200528,058671,旺宏群益9A購01,4.64,4.68,4.64,4.68,-0.06,-1.27,64000,4,298240,0,0,0,0,0,0,64000,0,64000,64000
20200528,058672,可成群益9B購02,1.27,1.27,1.27,1.27,-0.03,-2.31,1000,1,1270,0,0,0,0,0,0,1000,1000,0,0
20200528,058673,華新科群益9A購02,,,,,0.00,0.00,0,0,0,0,0,0,0,0,0,0,0,0,0
20200528,058674,宏達電群益99購01,1.28,1.28,1.14,1.14,-0.18,-13.64,13000,2,16080,0,0,0,0,0,0,13000,13000,0,0
20200528,058675,康控群益9B購01,0.52,0.52,0.52,0.52,-0.02,-3.7,108000,2,56160,0,0,0,0,0,0,108000,0,108000,108000
20200528,058676,聯茂群益99購01,0.73,0.77,0.72,0.76,+0.06,8.57,266000,6,192050,0,0,0,0,0,0,17000,249000,-232000,-232000
20200528,058677,矽格群益99購01,0.75,0.75,0.75,0.75,0.00,0.00,20000,1,15000,0,0,0,0,0,0,0,20000,-20000,-20000
20200528,058678,南亞科日盛99購01,,,,,0.00,0.00,0,0,0,0,0,0,0,0,0,0,0,0,0
20200528,058679,可成日盛99購01,,,,,0.00,0.00,0,0,0,0,0,0,0,0,0,0,0,0,0
20200528,05867P,友達兆豐97售02,,,,,0.00,0.00,0,0,0,0,0,0,0,0,0,0,0,0,0
20200528,058680,國巨麥證99購02,,,,,0.00,0.00,0,0,0,0,0,0,0,0,0,0,0,0,0
20200528,058681,大立光康和9B購01,,,,,0.00,0.00,0,0,0,0,0,0,0,0,0,0,0,0,0
20200528,058682,聯發科凱基99購07,,,,,0.00,0.00,0,0,0,0,0,0,0,0,0,0,0,0,0
20200528,058683,可成凱基9A購01,1.30,1.30,1.30,1.30,+0.04,3.17,1000,1,1300,0,0,0,0,0,0,1000,1000,0,0
20200528,058684,健策凱基99購02,3.21,3.21,2.84,2.84,-0.14,-4.7,67000,15,212670,0,0,0,0,0,0,62000,10000,52000,52000
20200528,058685,TPK凱基99購01,1.65,1.74,1.52,1.52,-0.13,-7.88,140000,15,229160,0,0,0,0,0,0,52000,92000,-40000,-40000
20200528,058686,祥碩凱基99購03,2.82,3.12,2.82,3.12,+0.36,13.04,15000,3,45500,0,0,0,0,0,0,2000,12000,-10000,-10000
20200528,058687,聯茂凱基9A購01,0.88,0.95,0.88,0.94,+0.03,3.3,39000,7,35520,0,0,0,0,0,0,30000,9000,21000,21000
20200528,058688,矽創凱基9A購01,1.70,1.96,1.70,1.80,+0.14,8.43,196000,23,357380,0,0,0,0,0,0,32000,164000,-132000,-132000
20200528,058689,元油2X國票99購03,0.03,0.03,0.03,0.03,+0.01,50.0,1000,1,30,0,0,0,0,0,0,0,0,0,0
20200528,05868P,台積電凱基96售17,4.76,4.76,4.76,4.76,0.00,0.00,50000,1,238000,0,0,0,0,0,0,50000,50000,0,0
20200528,058690,元油2X國票9A購03,,,,,0.00,0.00,0,0,0,0,0,0,0,0,0,0,0,0,0
20200528,058691,友訊國票9A購01,1.65,1.65,1.65,1.65,-0.09,-5.17,38000,1,62700,0,0,0,0,0,0,38000,0,38000,38000
20200528,058692,華邦電國票9B購01,0.67,0.67,0.40,0.60,+0.05,9.09,1223000,57,586090,0,0,0,0,0,0,382000,720000,-338000,-338000
20200528,058693,旭富國票9A購01,4.45,4.60,4.43,4.60,+0.08,1.77,58000,5,261660,0,0,0,0,0,0,5000,53000,-48000,-48000
20200528,058694,鈺齊國票9A購02,3.70,3.91,3.63,3.74,+0.50,15.43,187000,12,707500,0,0,0,0,0,0,175000,12000,163000,163000
20200528,058695,元油2X元大9C購03,,,,,0.00,0.00,0,0,0,0,0,0,0,0,0,0,0,0,0
20200528,058696,元油2X元大9C購04,0.10,0.10,0.10,0.10,-0.01,-9.09,199000,1,19900,0,0,0,0,0,0,0,0,0,0
20200528,058697,亞德客元大99購01,3.74,3.74,3.74,3.74,0.00,0.00,1000,1,3740,0,0,0,0,0,0,0,1000,-1000,-1000
20200528,058698,華通元大99購05,1.12,1.19,1.09,1.10,+0.07,6.8,212000,27,240990,0,0,0,0,0,0,60000,158000,-98000,-98000
20200528,058699,楠梓電元大99購02,1.45,1.45,1.34,1.34,-0.07,-4.96,248000,6,353640,0,0,0,0,0,0,68000,180000,-112000,-112000
20200528,05869P,旺宏凱基96售05,,,,,0.00,0.00,0,0,0,0,0,0,0,0,0,0,0,0,0
20200528,058700,鴻海元大99購15,2.17,2.17,2.08,2.08,-0.04,-1.89,105000,4,226910,0,0,0,0,0,0,55000,100000,-45000,-45000
20200528,058701,鴻海元大99購16,1.04,1.04,1.04,1.04,+0.04,4.0,1000,1,1040,0,0,0,0,0,0,0,1000,-1000,-1000
20200528,058702,國巨元大99購16,1.08,1.10,1.03,1.03,-0.03,-2.83,40000,3,42400,0,0,0,0,0,0,40000,0,40000,40000
20200528,058703,台積電元大99購16,1.00,1.00,1.00,1.00,-0.07,-6.54,30000,1,30000,0,0,0,0,0,0,0,30000,-30000,-30000
20200528,058704,台積電元大99購17,1.69,1.69,1.69,1.69,+0.01,0.6,2000,1,3380,0,0,0,0,0,0,2000,0,2000,2000
20200528,058705,長榮航元大99購01,1.46,1.46,1.41,1.41,+0.01,0.71,279000,10,394290,0,0,0,0,0,0,211000,68000,143000,143000
20200528,058706,聯鈞元大9C購01,0.50,0.50,0.50,0.50,-0.01,-1.96,5000,2,2500,0,0,0,0,0,0,0,3000,-3000,-3000
20200528,058707,泰鼎元大99購02,4.35,4.35,4.03,4.03,-0.07,-1.71,82000,8,343420,0,0,0,0,0,0,50000,48000,2000,2000
20200528,058708,臺股指元大9A購21,,,,,0.00,0.00,0,0,0,0,0,0,0,0,0,0,0,0,0
20200528,058709,臺股指元大9A購22,,,,,0.00,0.00,0,0,0,0,0,0,0,0,0,0,0,0,0
20200528,05870P,聯發科凱基96售19,2.98,2.98,2.98,2.98,0.00,0.00,5000,1,14900,0,0,0,0,0,0,0,5000,-5000,-5000
20200528,058710,臺股指元大9A購23,,,,,0.00,0.00,0,0,0,0,0,0,0,0,0,0,0,0,0
20200528,058711,鴻海統一9A購02,0.84,0.84,0.84,0.84,+0.02,2.44,5000,1,4200,0,0,0,0,0,0,5000,0,5000,5000
20200528,058712,鴻海統一9B購03,,,,,0.00,0.00,0,0,0,0,0,0,0,0,0,0,0,0,0
20200528,058713,國巨統一9B購02,0.52,0.52,0.47,0.47,-0.04,-7.84,15000,2,7550,0,0,0,0,0,0,10000,15000,-5000,-5000
20200528,058714,美律統一9B購01,0.86,0.87,0.84,0.84,+0.01,1.2,383000,7,330640,0,0,0,0,0,0,18000,365000,-347000,-347000
20200528,058715,鴻海台新99購02,,,,,0.00,0.00,0,0,0,0,0,0,0,0,0,0,0,0,0
20200528,058716,華新科台新99購02,0.42,0.42,0.42,0.42,0.00,0.00,10000,1,4200,0,0,0,0,0,0,10000,10000,0,0
20200528,058717,南電台新99購02,,,,,0.00,0.00,0,0,0,0,0,0,0,0,0,0,0,0,0
20200528,058718,台灣50元富03購01,1.19,1.19,1.19,1.19,-0.05,-4.03,4000,1,4760,0,0,0,0,0,0,0,4000,-4000,-4000
20200528,058719,智邦元富99購01,6.05,6.05,6.05,6.05,+0.45,8.04,10000,1,60500,0,0,0,0,0,0,10000,0,10000,10000
20200528,05871P,全新凱基96售04,,,,,0.00,0.00,0,0,0,0,0,0,0,0,0,0,0,0,0
20200528,058720,旭富元富99購01,,,,,0.00,0.00,0,0,0,0,0,0,0,0,0,0,0,0,0
20200528,058721,立積元富9C購01,1.30,1.31,1.21,1.23,-0.03,-2.38,662000,32,846090,0,0,0,0,0,0,484000,175000,309000,309000
20200528,058722,台郡元富99購01,0.83,0.83,0.80,0.80,-0.03,-3.61,582000,22,475260,0,0,0,0,0,0,356000,226000,130000,130000
20200528,058723,元石油國泰9A購01,0.69,0.69,0.69,0.69,-0.05,-6.76,1000,1,690,0,0,0,0,0,0,0,1000,-1000,-1000
20200528,058724,大立光國泰9B購01,,,,,0.00,0.00,0,0,0,0,0,0,0,0,0,0,0,0,0
20200528,058725,美律富邦9A購01,0.76,0.77,0.76,0.77,+0.05,6.94,366000,3,279780,0,0,0,0,0,0,0,366000,-366000,-366000
20200528,058726,宏達電富邦9A購01,0.07,0.07,0.07,0.07,0.00,0.00,40000,2,2800,0,0,0,0,0,0,0,0,0,0
20200528,058727,嘉晶富邦9A購01,1.10,1.16,1.04,1.05,-0.12,-10.26,425000,20,454570,0,0,0,0,0,0,346000,56000,290000,290000
20200528,058728,SP黃豆永豐99購01,0.64,0.65,0.64,0.65,0.00,0.00,60000,2,38600,0,0,0,0,0,0,0,0,0,0
20200528,058729,國巨永豐99購03,,,,,0.00,0.00,0,0,0,0,0,0,0,0,0,0,0,0,0
20200528,05872P,大立光凱基96售15,,,,,0.00,0.00,0,0,0,0,0,0,0,0,0,0,0,0,0
20200528,058730,玉晶光永豐9A購01,1.47,1.53,1.46,1.46,+0.06,4.29,41000,6,61550,0,0,0,0,0,0,10000,31000,-21000,-21000
20200528,058731,貿聯永豐99購02,0.87,0.92,0.85,0.86,0.00,0.00,248000,31,216380,0,0,0,0,0,0,123000,145000,-22000,-22000
20200528,058732,矽格永豐99購01,0.71,0.73,0.66,0.66,-0.05,-7.04,165000,6,113000,0,0,0,0,0,0,100000,65000,35000,35000
20200528,058733,同欣電永豐99購02,1.10,1.10,1.05,1.05,-0.04,-3.67,254000,14,274230,0,0,0,0,0,0,232000,1000,231000,231000
20200528,058734,康友永豐99購01,0.13,0.13,0.11,0.11,-0.02,-15.38,425000,9,53950,0,0,0,0,0,0,360000,65000,295000,295000
20200528,058735,南茂永豐99購01,0.51,0.51,0.48,0.48,-0.08,-14.29,30000,2,14700,0,0,0,0,0,0,20000,10000,10000,10000
20200528,058736,鈺齊永豐99購02,0.28,0.29,0.25,0.25,+0.03,13.64,132000,8,34770,0,0,0,0,0,0,60000,72000,-12000,-12000
20200528,058737,鴻海第一01購01,,,,,0.00,0.00,0,0,0,0,0,0,0,0,0,0,0,0,0
20200528,058738,FBVIX中信03購04,1.96,2.01,1.96,2.00,+0.01,0.5,79000,5,157780,0,0,0,0,0,0,7000,72000,-65000,-65000
20200528,058739,喬山中信99購01,1.03,1.08,0.78,0.78,-0.19,-19.59,1070000,60,964990,0,0,0,0,0,0,813000,207000,606000,606000
20200528,05873P,華通群益97售02,,,,,0.00,0.00,0,0,0,0,0,0,0,0,0,0,0,0,0
20200528,058740,T50反1日盛9B購02,,,,,0.00,0.00,0,0,0,0,0,0,0,0,0,0,0,0,0
20200528,058741,欣興日盛99購01,1.58,1.77,1.58,1.61,-0.01,-0.62,173000,13,285100,0,0,0,0,0,0,51000,122000,-71000,-71000
20200528,058742,鴻海康和99購01,1.14,1.14,1.11,1.11,-0.02,-1.77,8000,5,9090,0,0,0,0,0,0,8000,8000,0,0
20200528,058743,可成康和99購01,1.20,1.20,1.17,1.17,-0.03,-2.5,3000,2,3540,0,0,0,0,0,0,3000,3000,0,0
20200528,058744,FBVIX凱基9C購03,,,,,0.00,0.00,0,0,0,0,0,0,0,0,0,0,0,0,0
20200528,058745,元金2X凱基9C購02,,,,,0.00,0.00,0,0,0,0,0,0,0,0,0,0,0,0,0
20200528,058746,華通凱基9A購02,2.04,2.15,2.04,2.13,+0.28,15.14,94000,7,199820,0,0,0,0,0,0,0,94000,-94000,-94000
20200528,058747,友達凱基9A購03,,,,,0.00,0.00,0,0,0,0,0,0,0,0,0,0,0,0,0
20200528,058748,景碩凱基9A購01,0.96,1.01,0.94,0.94,0.00,0.00,259000,8,251580,0,0,0,0,0,0,219000,80000,139000,139000
20200528,058749,康控凱基99購03,,,,,0.00,0.00,0,0,0,0,0,0,0,0,0,0,0,0,0
20200528,05874P,台積電群益96售10,,,,,0.00,0.00,0,0,0,0,0,0,0,0,0,0,0,0,0
20200528,058750,緯穎凱基9A購03,2.19,2.25,2.16,2.25,-0.03,-1.32,41000,4,91290,0,0,0,0,0,0,1000,40000,-39000,-39000
20200528,058751,南茂凱基9A購01,2.65,2.65,2.65,2.65,0.00,0.00,45000,1,119250,0,0,0,0,0,0,0,45000,-45000,-45000
20200528,058752,鈺齊凱基9A購01,1.19,1.29,1.14,1.18,+0.10,9.26,221000,19,271610,19000,0,19000,0,0,0,53000,168000,-115000,-96000
20200528,058753,元石油群益9B購03,0.18,0.18,0.18,0.18,-0.05,-21.74,5000,1,900,0,0,0,0,0,0,0,0,0,0
20200528,058754,元油2X群益99購02,0.02,0.02,0.02,0.02,0.00,0.00,350000,3,7000,0,0,0,0,0,0,0,91000,-91000,-91000
20200528,058755,SGBR2X群益99購01,,,,,0.00,0.00,0,0,0,0,0,0,0,0,0,0,0,0,0
20200528,058756,SGBR2X群益99購02,,,,,0.00,0.00,0,0,0,0,0,0,0,0,0,0,0,0,0
20200528,058757,道瓊銀群益9A購02,,,,,0.00,0.00,0,0,0,0,0,0,0,0,0,0,0,0,0
20200528,058758,台積電群益99購05,1.04,1.04,0.97,0.97,-0.05,-4.9,5000,2,5130,0,0,0,0,0,0,0,5000,-5000,-5000
20200528,058759,義隆群益99購01,3.63,3.77,3.55,3.56,+0.14,4.09,189000,25,685830,0,0,0,0,0,0,118000,91000,27000,27000
20200528,05875P,旺宏群益98售01,1.96,2.08,1.96,2.08,+0.09,4.52,188000,5,375440,0,0,0,0,0,0,116000,72000,44000,44000
20200528,058760,嘉晶群益9A購01,,,,,0.00,0.00,0,0,0,0,0,0,0,0,0,0,0,0,0
20200528,058761,欣興群益99購02,2.05,2.14,2.04,2.04,+0.08,4.08,276000,10,578590,0,0,0,0,0,0,2000,276000,-274000,-274000
20200528,058762,貿聯群益99購03,1.65,1.71,1.61,1.62,0.00,0.00,165000,12,272890,0,0,0,0,0,0,66000,99000,-33000,-33000
20200528,058763,和碩群益99購01,2.35,2.35,2.34,2.34,-0.05,-2.09,349000,3,817160,0,0,0,0,0,0,50000,299000,-249000,-249000
20200528,058764,康友群益99購01,0.59,0.59,0.54,0.54,0.00,0.00,97000,3,55430,0,0,0,0,0,0,0,97000,-97000,-97000
20200528,058765,緯穎群益99購03,,,,,0.00,0.00,0,0,0,0,0,0,0,0,0,0,0,0,0
20200528,058766,力山兆豐99購01,2.94,3.06,2.72,2.72,-0.18,-6.21,246000,25,722180,0,0,0,0,0,0,180000,64000,116000,116000
20200528,058767,亞德客兆豐99購01,1.99,2.01,1.99,2.01,-0.03,-1.47,43000,5,85950,0,0,0,0,0,0,43000,0,43000,43000
20200528,058768,南港兆豐99購01,0.92,0.92,0.84,0.84,-0.21,-20.0,136000,7,122400,0,0,0,0,0,0,10000,100000,-90000,-90000
20200528,058769,友達兆豐99購01,,,,,0.00,0.00,0,0,0,0,0,0,0,0,0,0,0,0,0
20200528,05876P,聯發科群益96售03,,,,,0.00,0.00,0,0,0,0,0,0,0,0,0,0,0,0,0
20200528,058770,貿聯兆豐9A購01,1.51,1.56,1.50,1.50,0.00,0.00,246000,28,376580,0,0,0,0,0,0,46000,170000,-124000,-124000
20200528,058771,神達兆豐99購01,0.96,0.96,0.93,0.93,0.00,0.00,446000,12,420380,0,0,0,0,0,0,296000,150000,146000,146000
20200528,058772,茂林兆豐9A購01,1.06,1.06,1.04,1.06,-0.24,-18.46,69000,15,72460,0,0,0,0,0,0,69000,0,69000,69000
20200528,058773,和碩兆豐99購01,1.74,1.74,1.66,1.66,-0.08,-4.6,30000,4,51620,0,0,0,0,0,0,9000,21000,-12000,-12000
20200528,058774,台郡兆豐9A購01,0.83,0.83,0.81,0.81,-0.02,-2.41,10000,2,8200,0,0,0,0,0,0,0,10000,-10000,-10000
20200528,058775,台積電國票9A購02,3.32,3.34,3.09,3.09,-0.15,-4.63,92000,19,300680,0,0,0,0,0,0,78000,14000,64000,64000
20200528,058776,台積電國票9A購03,,,,,0.00,0.00,0,0,0,0,0,0,0,0,0,0,0,0,0
20200528,058777,台光電國票9A購01,24.10,24.10,23.70,23.70,+0.10,0.42,2000,2,47800,0,0,0,0,0,0,1000,1000,0,0
20200528,058778,聯發科國票9A購01,,,,,0.00,0.00,0,0,0,0,0,0,0,0,0,0,0,0,0
20200528,058779,大立光國票9A購02,,,,,0.00,0.00,0,0,0,0,0,0,0,0,0,0,0,0,0
20200528,05877P,大立光群益96售06,,,,,0.00,0.00,0,0,0,0,0,0,0,0,0,0,0,0,0
20200528,058780,牧德國票9A購01,,,,,0.00,0.00,0,0,0,0,0,0,0,0,0,0,0,0,0
20200528,058781,康友國票9A購01,0.53,0.53,0.51,0.52,-0.05,-8.77,65000,3,33800,0,0,0,0,0,0,20000,45000,-25000,-25000
20200528,058782,臺股指國票99購01,2.70,2.70,2.44,2.44,-0.16,-6.15,113000,5,301040,0,0,0,0,0,0,90000,23000,67000,67000
20200528,058783,臺股指國票99購02,2.39,2.39,2.01,2.07,-0.18,-8.0,120000,17,267890,0,0,0,0,0,0,38000,82000,-44000,-44000
20200528,058784,臺股指國票99購03,2.98,2.98,2.98,2.98,0.00,0.00,4000,1,11920,0,0,0,0,0,0,0,4000,-4000,-4000
20200528,058785,臺股指國票99購04,,,,,0.00,0.00,0,0,0,0,0,0,0,0,0,0,0,0,0
20200528,058786,元黃金元大99購01,0.63,0.63,0.60,0.60,0.00,0.00,13000,3,8160,0,0,0,0,0,0,0,12000,-12000,-12000
20200528,058787,元石油元大9A購01,0.20,0.20,0.20,0.20,-0.22,-52.38,18000,1,3600,0,0,0,0,0,0,0,0,0,0
20200528,058788,喬山元大99購01,2.30,2.35,1.93,1.95,-0.24,-10.96,631000,39,1337030,0,0,0,0,0,0,356000,275000,81000,81000
20200528,058789,喬山元大99購02,1.49,1.49,1.49,1.49,-0.15,-9.15,10000,1,14900,0,0,0,0,0,0,10000,0,10000,10000
20200528,05878P,創意群益98售01,,,,,0.00,0.00,0,0,0,0,0,0,0,0,0,0,0,0,0
20200528,058790,楠梓電元大99購03,1.57,1.58,1.49,1.49,-0.05,-3.25,100000,4,156800,0,0,0,0,0,0,0,100000,-100000,-100000
20200528,058791,鴻海元大99購17,1.90,1.90,1.89,1.89,+0.09,5.0,54000,2,102460,0,0,0,0,0,0,14000,40000,-26000,-26000
20200528,058792,鴻海元大99購18,2.62,2.62,2.61,2.61,+0.03,1.16,49000,4,127910,0,0,0,0,0,0,47000,2000,45000,45000
20200528,058793,鴻海元大99購19,2.41,2.41,2.41,2.41,+0.09,3.88,4000,1,9640,0,0,0,0,0,0,0,4000,-4000,-4000
20200528,058794,旺宏元大99購09,,,,,0.00,0.00,0,0,0,0,0,0,0,0,0,0,0,0,0
20200528,058795,可成元大99購03,1.75,1.75,1.71,1.75,+0.05,2.94,82000,6,142700,0,0,0,0,0,0,62000,0,62000,62000
20200528,058796,可成元大99購04,1.03,1.03,0.96,0.96,-0.09,-8.57,130000,2,127600,0,0,0,0,0,0,130000,0,130000,130000
20200528,058797,大毅元大99購03,3.62,3.62,3.49,3.49,-0.08,-2.24,70000,7,251690,0,0,0,0,0,0,70000,0,70000,70000
20200528,058798,大立光元大99購11,1.63,1.63,1.49,1.49,-0.15,-9.15,44000,2,66960,0,0,0,0,0,0,44000,0,44000,44000
20200528,058799,晶技元大99購04,,,,,0.00,0.00,0,0,0,0,0,0,0,0,0,0,0,0,0
20200528,05879P,台積電台新96售03,,,,,0.00,0.00,0,0,0,0,0,0,0,0,0,0,0,0,0
20200528,058800,健策元大99購03,5.40,5.40,5.15,5.15,-0.15,-2.83,33000,6,174800,0,0,0,0,0,0,33000,3000,30000,30000
20200528,058801,致伸元大99購01,1.42,1.51,1.42,1.45,+0.05,3.57,564000,39,828620,0,0,0,0,0,0,304000,301000,3000,3000
20200528,058802,矽創元大99購02,3.38,3.78,3.31,3.45,+0.25,7.81,285000,25,1021860,0,0,0,0,0,0,137000,236000,-99000,-99000
20200528,058803,世紀鋼元大99購03,2.64,3.23,2.56,3.02,+0.37,13.96,1024000,131,2951380,0,0,0,0,0,0,402000,752000,-350000,-350000
20200528,058804,T50反1統一9B購01,,,,,0.00,0.00,0,0,0,0,0,0,0,0,0,0,0,0,0
20200528,058805,元石油統一9B購02,,,,,0.00,0.00,0,0,0,0,0,0,0,0,0,0,0,0,0
20200528,058806,道瓊銀統一9B購01,,,,,0.00,0.00,0,0,0,0,0,0,0,0,0,0,0,0,0
20200528,058807,和大統一9B購01,,,,,0.00,0.00,0,0,0,0,0,0,0,0,0,0,0,0,0
20200528,058808,大成鋼統一9B購01,0.60,0.66,0.60,0.61,+0.02,3.39,304000,7,191000,0,0,0,0,0,0,18000,286000,-268000,-268000
20200528,058809,國巨統一9B購03,0.56,0.56,0.50,0.50,-0.05,-9.09,2327000,18,1273860,0,0,0,0,0,0,2127000,130000,1997000,1997000
20200528,05880P,創意康和96售01,,,,,0.00,0.00,0,0,0,0,0,0,0,0,0,0,0,0,0
20200528,058810,國巨統一9B購04,0.53,0.54,0.53,0.53,+0.02,3.92,30000,3,16000,0,0,0,0,0,0,30000,30000,0,0
20200528,058811,台積電統一9A購05,,,,,0.00,0.00,0,0,0,0,0,0,0,0,0,0,0,0,0
20200528,058812,台積電統一9B購06,1.51,1.51,1.51,1.51,-0.05,-3.21,3000,2,4530,0,0,0,0,0,0,3000,3000,0,0
20200528,058813,旺宏統一9B購04,1.33,1.35,1.25,1.25,-0.10,-7.41,210000,29,279570,0,0,0,0,0,0,176000,34000,142000,142000
20200528,058814,南亞科台新99購01,,,,,0.00,0.00,0,0,0,0,0,0,0,0,0,0,0,0,0
20200528,058815,華新科台新99購03,0.68,0.68,0.68,0.68,0.00,0.00,20000,2,13600,0,0,0,0,0,0,20000,20000,0,0
20200528,058816,祥碩台新99購02,,,,,0.00,0.00,0,0,0,0,0,0,0,0,0,0,0,0,0
20200528,058817,嘉聯益台新99購01,,,,,0.00,0.00,0,0,0,0,0,0,0,0,0,0,0,0,0
20200528,058818,南電台新99購03,,,,,0.00,0.00,0,0,0,0,0,0,0,0,0,0,0,0,0
20200528,058819,華通國泰9B購01,2.59,2.84,2.59,2.66,+0.17,6.83,671000,35,1851190,0,0,0,0,0,0,103000,561000,-458000,-458000
20200528,05881P,彩晶康和96售01,1.06,1.07,1.06,1.07,+0.01,0.94,66000,7,70390,0,0,0,0,0,0,66000,0,66000,66000
20200528,058820,致茂國泰9B購01,1.57,1.57,1.49,1.49,-0.05,-3.25,107000,4,162740,0,0,0,0,0,0,87000,20000,67000,67000
20200528,058821,泰鼎國泰9B購01,,,,,0.00,0.00,0,0,0,0,0,0,0,0,0,0,0,0,0
20200528,058822,樺漢國泰9B購01,1.64,1.71,1.64,1.64,0.00,0.00,687000,39,1151640,0,0,0,0,0,0,0,687000,-687000,-687000
20200528,058823,聯發科富邦9C購01,,,,,0.00,0.00,0,0,0,0,0,0,0,0,0,0,0,0,0
20200528,058824,晶技富邦9A購01,,,,,0.00,0.00,0,0,0,0,0,0,0,0,0,0,0,0,0
20200528,058825,同欣電富邦9A購01,,,,,0.00,0.00,0,0,0,0,0,0,0,0,0,0,0,0,0
20200528,058826,台積電永豐99購02,1.89,1.89,1.89,1.89,0.00,0.00,1000,1,1890,0,0,0,0,0,0,0,1000,-1000,-1000
20200528,058827,聯發科永豐9A購01,,,,,0.00,0.00,0,0,0,0,0,0,0,0,0,0,0,0,0
20200528,058828,大毅永豐99購01,0.75,0.75,0.72,0.72,-0.05,-6.49,13000,4,9700,0,0,0,0,0,0,13000,0,13000,13000
20200528,058829,華新科永豐99購04,0.67,0.69,0.65,0.65,-0.02,-2.99,66000,13,44140,0,0,0,0,0,0,36000,40000,-4000,-4000
20200528,05882P,華新科永豐96售01,,,,,0.00,0.00,0,0,0,0,0,0,0,0,0,0,0,0,0
20200528,058830,健策永豐99購02,2.59,2.59,2.43,2.43,-0.10,-3.95,105000,11,263050,0,0,0,0,0,0,100000,5000,95000,95000
20200528,058831,茂林永豐99購01,1.20,1.20,1.15,1.15,-0.04,-3.36,125000,17,147800,0,0,0,0,0,0,105000,20000,85000,85000
20200528,058832,立積永豐99購01,0.22,0.22,0.22,0.22,0.00,0.00,50000,1,11000,0,0,0,0,0,0,50000,0,50000,50000
20200528,058833,台表科永豐99購01,2.16,2.16,2.16,2.16,-0.14,-6.09,3000,1,6480,0,0,0,0,0,0,3000,0,3000,3000
20200528,058834,GIS永豐99購01,2.22,2.22,1.65,1.78,-0.24,-11.88,48000,7,92450,0,0,0,0,0,0,15000,31000,-16000,-16000
20200528,058835,元油2X中信9C購02,0.63,0.63,0.63,0.63,0.00,0.00,18000,2,11340,0,0,0,0,0,0,0,18000,-18000,-18000
20200528,058836,FBVIX中信03購05,0.92,0.94,0.91,0.92,-0.01,-1.08,15000,5,13780,0,0,0,0,0,0,1000,14000,-13000,-13000
20200528,058837,SGBR2X中信9C購01,0.36,0.37,0.35,0.35,-0.05,-12.5,176000,25,64060,0,0,0,0,0,0,0,146000,-146000,-146000
20200528,058838,國巨中信99購03,0.85,0.88,0.80,0.80,-0.03,-3.61,590000,20,504560,0,0,0,0,0,0,183000,407000,-224000,-224000
20200528,058839,瑞儀中信99購02,0.95,0.98,0.95,0.98,+0.02,2.08,55000,8,53000,0,0,0,0,0,0,25000,15000,10000,10000
20200528,05883P,致伸永豐96售03,,,,,0.00,0.00,0,0,0,0,0,0,0,0,0,0,0,0,0
20200528,058840,T50反1群益99購02,,,,,0.00,0.00,0,0,0,0,0,0,0,0,0,0,0,0,0
20200528,058841,深中小群益01購01,0.54,0.55,0.48,0.49,-0.08,-14.04,1098000,15,590950,0,0,0,0,0,0,713000,385000,328000,328000
20200528,058842,元油2X群益9C購01,0.47,1.80,0.46,1.80,+0.30,20.0,194000,25,96700,0,0,0,0,0,0,0,190000,-190000,-190000
20200528,058843,元油2X群益9C購02,,,,,0.00,0.00,0,0,0,0,0,0,0,0,0,0,0,0,0
20200528,058844,元油2X群益9C購03,1.79,1.79,1.79,1.79,0.00,0.00,2000,1,3580,0,0,0,0,0,0,2000,0,2000,2000
20200528,058845,元油2X群益9C購04,,,,,0.00,0.00,0,0,0,0,0,0,0,0,0,0,0,0,0
20200528,058846,鴻海群益99購03,2.71,2.71,2.60,2.62,-0.04,-1.5,150000,8,404140,0,0,0,0,0,0,145000,5000,140000,140000
20200528,058847,國巨群益99購05,,,,,0.00,0.00,0,0,0,0,0,0,0,0,0,0,0,0,0
20200528,058848,台積電群益99購07,1.16,1.16,1.13,1.15,+0.03,2.68,46000,4,52300,0,0,0,0,0,0,33000,13000,20000,20000
20200528,058849,奇力新群益99購02,0.67,0.67,0.67,0.67,-0.04,-5.63,10000,1,6700,0,0,0,0,0,0,10000,0,10000,10000
20200528,05884P,旺宏統一96售01,1.35,1.60,1.35,1.58,+0.18,12.86,142000,16,197860,0,0,0,0,0,0,30000,112000,-82000,-82000
20200528,058850,華新科群益99購03,1.63,1.63,1.63,1.63,+0.05,3.16,5000,1,8150,0,0,0,0,0,0,0,5000,-5000,-5000
20200528,058851,大立光群益99購07,1.60,1.60,1.56,1.59,-0.07,-4.22,109000,5,171490,0,0,0,0,0,0,70000,39000,31000,31000
20200528,058852,貿聯群益99購04,2.62,2.64,2.59,2.64,+0.04,1.54,191000,7,501810,0,0,0,0,0,0,91000,100000,-9000,-9000
20200528,058853,日月光群益99購01,,,,,0.00,0.00,0,0,0,0,0,0,0,0,0,0,0,0,0
20200528,058854,樺漢群益9B購01,1.36,1.39,1.36,1.38,+0.02,1.47,645000,10,890180,0,0,0,0,0,0,201000,444000,-243000,-243000
20200528,058855,台積電兆豐99購02,0.93,0.93,0.84,0.84,-0.05,-5.62,15000,2,13050,0,0,0,0,0,0,10000,15000,-5000,-5000
20200528,058856,新光金兆豐99購01,,,,,0.00,0.00,0,0,0,0,0,0,0,0,0,0,0,0,0
20200528,058857,元油2X日盛99購02,,,,,0.00,0.00,0,0,0,0,0,0,0,0,0,0,0,0,0
20200528,058858,元油2X凱基9A購07,,,,,0.00,0.00,0,0,0,0,0,0,0,0,0,0,0,0,0
20200528,058859,元油2X凱基9A購08,,,,,0.00,0.00,0,0,0,0,0,0,0,0,0,0,0,0,0
20200528,05885P,牧德統一96售01,0.55,0.55,0.55,0.55,0.00,0.00,40000,1,22000,0,0,0,0,0,0,40000,0,40000,40000
20200528,058860,SGBR2X凱基9A購01,,,,,0.00,0.00,0,0,0,0,0,0,0,0,0,0,0,0,0
20200528,058861,國巨凱基9A購08,,,,,0.00,0.00,0,0,0,0,0,0,0,0,0,0,0,0,0
20200528,058862,聯發科凱基99購08,,,,,0.00,0.00,0,0,0,0,0,0,0,0,0,0,0,0,0
20200528,058863,可成凱基99購02,1.27,1.27,1.25,1.25,+0.02,1.63,71000,2,88770,0,0,0,0,0,0,71000,1000,70000,70000
20200528,058864,欣興凱基99購04,2.53,2.67,2.53,2.67,+0.18,7.23,110000,5,287450,0,0,0,0,0,0,0,110000,-110000,-110000
20200528,058865,群創凱基01購01,,,,,0.00,0.00,0,0,0,0,0,0,0,0,0,0,0,0,0
20200528,058866,元油2X國票99購04,,,,,0.00,0.00,0,0,0,0,0,0,0,0,0,0,0,0,0
20200528,058867,元油2X國票99購05,,,,,0.00,0.00,0,0,0,0,0,0,0,0,0,0,0,0,0
20200528,058868,元油2X國票99購06,0.55,0.55,0.55,0.55,-0.02,-3.51,10000,1,5500,0,0,0,0,0,0,0,10000,-10000,-10000
20200528,058869,元油2X國票9A購04,,,,,0.00,0.00,0,0,0,0,0,0,0,0,0,0,0,0,0
20200528,05886P,華通元富96售01,,,,,0.00,0.00,0,0,0,0,0,0,0,0,0,0,0,0,0
20200528,058870,元油2X國票9A購05,,,,,0.00,0.00,0,0,0,0,0,0,0,0,0,0,0,0,0
20200528,058871,元油2X國票9A購06,,,,,0.00,0.00,0,0,0,0,0,0,0,0,0,0,0,0,0
20200528,058872,元油2X國票9B購01,,,,,0.00,0.00,0,0,0,0,0,0,0,0,0,0,0,0,0
20200528,058873,美律國票9A購02,1.38,1.38,1.36,1.36,+0.03,2.26,36000,2,49320,0,0,0,0,0,0,36000,0,36000,36000
20200528,058874,聯鈞國票9A購01,2.28,2.32,2.28,2.32,+0.01,0.43,48000,4,110410,0,0,0,0,0,0,13000,35000,-22000,-22000
20200528,058875,台表科國票9A購02,12.60,13.70,11.40,11.60,-2.00,-14.71,22000,8,269600,0,0,0,0,0,0,20000,2000,18000,18000
20200528,058876,南電國票9A購02,3.98,4.12,3.86,3.86,-0.17,-4.22,185000,7,731060,0,0,0,0,0,0,58000,127000,-69000,-69000
20200528,058877,T50反1國泰9B購01,0.83,0.87,0.81,0.86,+0.02,2.38,629000,24,522670,0,0,0,0,0,0,0,629000,-629000,-629000
20200528,058878,旭富國泰9B購01,2.48,2.55,2.46,2.55,+0.02,0.79,52000,4,129210,0,0,0,0,0,0,47000,5000,42000,42000
20200528,058879,智邦富邦99購01,,,,,0.00,0.00,0,0,0,0,0,0,0,0,0,0,0,0,0
20200528,05887P,友達元富99售03,2.45,2.45,2.44,2.44,0.00,0.00,6000,2,14670,0,0,0,0,0,0,0,6000,-6000,-6000
20200528,058880,台灣50永豐99購04,,,,,0.00,0.00,0,0,0,0,0,0,0,0,0,0,0,0,0
20200528,058881,全新永豐99購01,0.52,0.52,0.51,0.52,-0.05,-8.77,26000,11,13480,0,0,0,0,0,0,26000,0,26000,26000
20200528,058882,晶相光永豐99購01,,,,,0.00,0.00,0,0,0,0,0,0,0,0,0,0,0,0,0
20200528,058883,旭富永豐99購01,,,,,0.00,0.00,0,0,0,0,0,0,0,0,0,0,0,0,0
20200528,058884,世紀鋼永豐99購02,1.73,2.30,1.73,2.15,+0.36,20.11,398000,38,781730,0,0,0,0,0,0,170000,228000,-58000,-58000
20200528,058885,元石油元大9C購02,0.81,0.81,0.81,0.81,+0.01,1.25,7000,2,5670,0,0,0,0,0,0,0,7000,-7000,-7000
20200528,058886,元石油元大9C購03,0.91,0.91,0.87,0.87,-0.05,-5.43,232000,31,203100,0,0,0,0,0,0,0,222000,-222000,-222000
20200528,058887,元石油元大9C購04,0.71,0.75,0.68,0.75,0.00,0.00,69000,7,48890,0,0,0,0,0,0,0,69000,-69000,-69000
20200528,058888,元油2X元大99購16,,,,,0.00,0.00,0,0,0,0,0,0,0,0,0,0,0,0,0
20200528,058889,元油2X元大9C購05,0.30,0.30,0.29,0.29,-0.03,-9.38,52000,7,15280,0,0,0,0,0,0,0,50000,-50000,-50000
20200528,05888P,友達元大97售01,1.75,1.75,1.75,1.75,0.00,0.00,30000,1,52500,0,0,0,0,0,0,30000,0,30000,30000
20200528,058890,元油2X元大9C購06,,,,,0.00,0.00,0,0,0,0,0,0,0,0,0,0,0,0,0
20200528,058891,元油2X元大9C購07,,,,,0.00,0.00,0,0,0,0,0,0,0,0,0,0,0,0,0
20200528,058892,元油2X元大9C購08,,,,,0.00,0.00,0,0,0,0,0,0,0,0,0,0,0,0,0
20200528,058893,元油2X元大9C購10,,,,,0.00,0.00,0,0,0,0,0,0,0,0,0,0,0,0,0
20200528,058894,元油2X元大9C購11,0.27,0.27,0.26,0.26,0.00,0.00,50000,5,13200,0,0,0,0,0,0,0,50000,-50000,-50000
20200528,058895,鴻海元大99購20,2.73,2.73,2.73,2.73,+0.06,2.25,43000,1,117390,0,0,0,0,0,0,0,43000,-43000,-43000
20200528,058896,中環元大99購03,0.91,0.91,0.81,0.82,-0.07,-7.87,184000,10,160520,0,0,0,0,0,0,128000,56000,72000,72000
20200528,058897,國巨元大99購17,,,,,0.00,0.00,0,0,0,0,0,0,0,0,0,0,0,0,0
20200528,058898,台積電元大99購20,,,,,0.00,0.00,0,0,0,0,0,0,0,0,0,0,0,0,0
20200528,058899,旺宏元大99購10,,,,,0.00,0.00,0,0,0,0,0,0,0,0,0,0,0,0,0
20200528,05889P,群創元大98售02,2.25,2.31,2.25,2.31,+0.01,0.43,162000,5,367420,0,0,0,0,0,0,140000,102000,38000,38000
20200528,058900,旺宏元大99購11,2.70,2.70,2.52,2.52,0.00,0.00,18000,2,47880,0,0,0,0,0,0,4000,18000,-14000,-14000
20200528,058901,美律元大99購07,1.05,1.07,1.01,1.01,+0.03,3.06,102000,5,106500,0,0,0,0,0,0,20000,82000,-62000,-62000
20200528,058902,聯發科元大99購15,,,,,0.00,0.00,0,0,0,0,0,0,0,0,0,0,0,0,0
20200528,058903,聯發科元大99購16,,,,,0.00,0.00,0,0,0,0,0,0,0,0,0,0,0,0,0
20200528,058904,晶技元大99購05,5.15,5.15,5.10,5.10,0.00,0.00,22000,3,112700,0,0,0,0,0,0,22000,0,22000,22000
20200528,058905,京鼎元大99購01,2.23,2.23,2.12,2.12,-0.05,-2.3,121000,7,263430,0,0,0,0,0,0,51000,74000,-23000,-23000
20200528,058906,晶相光元大99購01,,,,,0.00,0.00,0,0,0,0,0,0,0,0,0,0,0,0,0
20200528,058907,健策元大99購04,5.80,5.80,5.10,5.10,-0.40,-7.27,28000,4,154600,0,0,0,0,0,0,18000,10000,8000,8000
20200528,058908,貿聯元大99購03,1.60,1.61,1.55,1.55,-0.02,-1.27,453000,31,715620,0,0,0,0,0,0,322000,116000,206000,206000
20200528,058909,神達元大99購03,2.97,2.97,2.86,2.88,-0.03,-1.03,520000,16,1521730,0,0,0,0,0,0,333000,234000,99000,99000
20200528,05890P,彩晶元大99售01,,,,,0.00,0.00,0,0,0,0,0,0,0,0,0,0,0,0,0
20200528,058910,泰鼎元大99購03,,,,,0.00,0.00,0,0,0,0,0,0,0,0,0,0,0,0,0
20200528,058911,茂林元大99購04,2.20,2.20,2.09,2.09,-0.05,-2.34,42000,5,90520,0,0,0,0,0,0,22000,20000,2000,2000
20200528,058912,祥碩元大99購01,6.70,7.75,6.70,7.35,+0.75,11.36,43000,7,304700,0,0,0,0,0,0,4000,41000,-37000,-37000
20200528,058913,元油2X元富01購01,0.28,0.28,0.28,0.28,0.00,0.00,6000,1,1680,0,0,0,0,0,0,0,0,0,0
20200528,058914,元油2X元富01購02,0.18,0.18,0.17,0.17,-0.03,-15.0,95000,10,16170,0,0,0,0,0,0,0,0,0,0
20200528,058915,SGBR2X元富99購01,,,,,0.00,0.00,0,0,0,0,0,0,0,0,0,0,0,0,0
20200528,058916,SGBR2X元富99購02,,,,,0.00,0.00,0,0,0,0,0,0,0,0,0,0,0,0,0
20200528,058917,SGBR2X元富99購03,,,,,0.00,0.00,0,0,0,0,0,0,0,0,0,0,0,0,0
20200528,058918,SGBR2X元富99購04,,,,,0.00,0.00,0,0,0,0,0,0,0,0,0,0,0,0,0
20200528,058919,SGBR2X元富99購05,,,,,0.00,0.00,0,0,0,0,0,0,0,0,0,0,0,0,0
20200528,05891P,聯發科中信98售03,,,,,0.00,0.00,0,0,0,0,0,0,0,0,0,0,0,0,0
20200528,058920,SGBR2X元富99購06,3.00,3.02,2.99,2.99,-0.16,-5.08,77000,8,231820,0,0,0,0,0,0,44000,33000,11000,11000
20200528,058921,聯發科元富03購01,,,,,0.00,0.00,0,0,0,0,0,0,0,0,0,0,0,0,0
20200528,058922,聯發科元富03購02,,,,,0.00,0.00,0,0,0,0,0,0,0,0,0,0,0,0,0
20200528,058923,華新科元富99購06,2.23,2.23,2.12,2.12,-0.14,-6.19,158000,18,346750,0,0,0,0,0,0,151000,7000,144000,144000
20200528,058924,晶相光元富99購02,0.55,0.55,0.55,0.55,-0.02,-3.51,188000,5,103400,0,0,0,0,0,0,188000,0,188000,188000
20200528,058925,旭富元富99購02,1.21,1.25,1.21,1.25,+0.05,4.17,158000,6,196500,0,0,0,0,0,0,20000,158000,-138000,-138000
20200528,058926,勤誠元富99購01,1.35,1.35,1.25,1.26,-0.08,-5.97,130000,10,165850,0,0,0,0,0,0,50000,45000,5000,5000
20200528,058927,勤誠元富99購02,,,,,0.00,0.00,0,0,0,0,0,0,0,0,0,0,0,0,0
20200528,058928,國巨統一9C購01,0.59,0.60,0.56,0.57,-0.03,-5.0,200000,11,115560,0,0,0,0,0,0,136000,64000,72000,72000
20200528,058929,可成統一9C購01,1.07,1.09,1.04,1.04,-0.01,-0.95,63000,7,67330,0,0,0,0,0,0,45000,20000,25000,25000
20200528,05892P,大立光中信98售03,,,,,0.00,0.00,0,0,0,0,0,0,0,0,0,0,0,0,0
20200528,058930,華新科統一9B購01,1.15,1.16,1.10,1.10,-0.05,-4.35,194000,12,219760,0,0,0,0,0,0,107000,87000,20000,20000
20200528,058931,玉晶光統一9C購01,1.27,1.27,1.22,1.22,0.00,0.00,30000,3,37100,0,0,0,0,0,0,10000,20000,-10000,-10000
20200528,058932,FBVIX台新99購01,1.26,1.28,1.26,1.28,+0.01,0.79,3000,2,3820,0,0,0,0,0,0,0,3000,-3000,-3000
20200528,058933,FBVIX台新9B購01,1.45,1.45,1.45,1.45,-0.02,-1.36,34000,1,49300,0,0,0,0,0,0,0,34000,-34000,-34000
20200528,058934,台灣50中信03購03,,,,,0.00,0.00,0,0,0,0,0,0,0,0,0,0,0,0,0
20200528,058935,元油2X中信9C購03,0.96,0.96,0.96,0.96,0.00,0.00,10000,1,9600,0,0,0,0,0,0,0,10000,-10000,-10000
20200528,058936,國喬中信99購01,0.91,0.95,0.87,0.87,-0.07,-7.45,225000,10,204250,0,0,0,0,0,0,105000,120000,-15000,-15000
20200528,058937,仁寶中信99購01,1.22,1.22,1.20,1.20,-0.03,-2.44,60000,5,72800,0,0,0,0,0,0,20000,40000,-20000,-20000
20200528,058938,台積電中信01購03,1.23,1.23,1.23,1.23,+0.02,1.65,30000,1,36900,0,0,0,0,0,0,30000,0,30000,30000
20200528,058939,台積電中信9B購01,1.19,1.19,1.19,1.19,+0.04,3.48,10000,1,11900,0,0,0,0,0,0,10000,0,10000,10000
20200528,05893P,國巨兆豐96售04,,,,,0.00,0.00,0,0,0,0,0,0,0,0,0,0,0,0,0
20200528,058940,聯發科中信9A購03,4.97,4.97,4.83,4.83,-0.04,-0.82,11000,2,54530,0,0,0,0,0,0,11000,0,11000,11000
20200528,058941,華新科中信99購03,,,,,0.00,0.00,0,0,0,0,0,0,0,0,0,0,0,0,0
20200528,058942,南茂中信99購01,,,,,0.00,0.00,0,0,0,0,0,0,0,0,0,0,0,0,0
20200528,058943,元石油群益9C購01,1.10,1.20,1.10,1.20,0.00,0.00,11000,3,13100,0,0,0,0,0,0,0,0,0,0
20200528,058944,元石油群益9C購02,1.85,1.85,1.85,1.85,0.00,0.00,10000,1,18500,0,0,0,0,0,0,10000,0,10000,10000
20200528,058945,S&P正2群益9C購01,,,,,0.00,0.00,0,0,0,0,0,0,0,0,0,0,0,0,0
20200528,058946,SGBR2X群益9B購01,1.56,1.62,1.56,1.59,0.00,0.00,71000,5,114300,0,0,0,0,0,0,3000,68000,-65000,-65000
20200528,058947,SGBR2X群益9B購02,3.23,3.23,3.13,3.16,-0.12,-3.66,103000,12,327500,0,0,0,0,0,0,63000,38000,25000,25000
20200528,058948,道瓊銀群益9C購01,1.77,1.78,1.77,1.77,+0.14,8.59,31000,4,54970,0,0,0,0,0,0,20000,21000,-1000,-1000
20200528,058949,上銀群益99購02,4.09,4.09,4.09,4.09,0.00,0.00,5000,1,20450,0,0,0,0,0,0,5000,0,5000,5000
20200528,05894P,友達群益98售02,,,,,0.00,0.00,0,0,0,0,0,0,0,0,0,0,0,0,0
20200528,058950,國巨群益99購06,3.01,3.15,2.76,2.76,-0.12,-4.17,357000,12,1036240,0,0,0,0,0,0,304000,53000,251000,251000
20200528,058951,南電群益99購01,1.56,1.57,1.45,1.45,-0.09,-5.84,187000,10,289680,0,0,0,0,0,0,27000,160000,-133000,-133000
20200528,058952,南茂群益99購01,,,,,0.00,0.00,0,0,0,0,0,0,0,0,0,0,0,0,0
20200528,058953,S&P反1國票03購01,,,,,0.00,0.00,0,0,0,0,0,0,0,0,0,0,0,0,0
20200528,058954,元油2X國票9A購07,,,,,0.00,0.00,0,0,0,0,0,0,0,0,0,0,0,0,0
20200528,058955,台積電國票9A購04,3.95,3.95,3.54,3.54,-0.29,-7.57,306000,8,1116070,0,0,0,0,0,0,23000,286000,-263000,-263000
20200528,058956,健策國票9A購02,5.30,5.40,4.48,4.48,-0.52,-10.4,177000,28,882430,0,0,0,0,0,0,96000,108000,-12000,-12000
20200528,058957,貿聯國票9A購01,2.61,2.65,2.56,2.65,+0.15,6.0,105000,7,274150,0,0,0,0,0,0,54000,71000,-17000,-17000
20200528,058958,台表科國票9A購03,4.95,4.95,4.95,4.95,0.00,0.00,1000,1,4950,0,0,0,0,0,0,0,1000,-1000,-1000
20200528,058959,南茂國票9A購01,2.45,2.45,2.45,2.45,-0.06,-2.39,12000,1,29400,0,0,0,0,0,0,12000,0,12000,12000
20200528,05895P,奇力新群益96售03,0.90,0.94,0.90,0.94,0.00,0.00,30000,3,27700,0,0,0,0,0,0,0,30000,-30000,-30000
20200528,058960,臺股指國票99購05,,,,,0.00,0.00,0,0,0,0,0,0,0,0,0,0,0,0,0
20200528,058961,台灣50兆豐9C購01,0.62,0.62,0.59,0.59,-0.02,-3.28,43000,5,26060,0,0,0,0,0,0,3000,40000,-37000,-37000
20200528,058962,元油2X兆豐9A購02,0.12,0.12,0.12,0.12,0.00,0.00,1000,1,120,0,0,0,0,0,0,0,0,0,0
20200528,058963,華新科兆豐99購05,1.08,1.10,1.02,1.02,-0.09,-8.11,182000,9,199180,0,0,0,0,0,0,177000,5000,172000,172000
20200528,058964,群創兆豐99購01,0.19,0.19,0.19,0.19,0.00,0.00,10000,1,1900,0,0,0,0,0,0,0,10000,-10000,-10000
20200528,058965,祥碩兆豐99購02,3.42,3.42,3.42,3.42,0.00,0.00,78000,2,266760,0,0,0,0,0,0,0,78000,-78000,-78000
20200528,058966,元油2X日盛99購03,0.26,0.26,0.25,0.25,-0.04,-13.79,110000,10,27900,0,0,0,0,0,0,0,70000,-70000,-70000
20200528,058967,可成麥證99購01,3.02,3.02,3.02,3.02,+0.05,1.68,8000,1,24160,0,8000,-8000,0,0,0,0,8000,-8000,-8000
20200528,058968,T50正2永豐99購01,,,,,0.00,0.00,0,0,0,0,0,0,0,0,0,0,0,0,0
20200528,058969,亞德客永豐99購01,3.73,3.98,3.33,3.40,-0.27,-7.36,166000,22,641440,0,0,0,0,0,0,156000,11000,145000,145000
20200528,05896P,宏達電群益96售03,,,,,0.00,0.00,0,0,0,0,0,0,0,0,0,0,0,0,0
20200528,058970,鴻海永豐99購02,1.06,1.11,1.06,1.11,+0.04,3.74,300000,3,324500,0,0,0,0,0,0,250000,50000,200000,200000
20200528,058971,台積電永豐99購03,,,,,0.00,0.00,0,0,0,0,0,0,0,0,0,0,0,0,0
20200528,058972,新日興永豐9A購01,0.95,0.96,0.94,0.94,+0.07,8.05,82000,3,78350,0,0,0,0,0,0,17000,65000,-48000,-48000
20200528,058973,麗豐永豐99購01,1.34,1.38,1.33,1.33,-0.03,-2.21,119000,5,163370,0,0,0,0,0,0,97000,22000,75000,75000
20200528,058974,臺股指永豐99購03,,,,,0.00,0.00,0,0,0,0,0,0,0,0,0,0,0,0,0
20200528,058975,台灣50凱基01購02,,,,,0.00,0.00,0,0,0,0,0,0,0,0,0,0,0,0,0
20200528,058976,元油2X凱基9A購09,,,,,0.00,0.00,0,0,0,0,0,0,0,0,0,0,0,0,0
20200528,058977,SGBR2X凱基03購01,3.07,3.15,3.07,3.15,-0.09,-2.78,135000,15,420100,0,0,0,0,0,0,47000,35000,12000,12000
20200528,058978,SGBR2X凱基9A購03,,,,,0.00,0.00,0,0,0,0,0,0,0,0,0,0,0,0,0
20200528,058979,上銀凱基99購04,2.90,2.98,2.86,2.86,-0.08,-2.72,56000,22,162570,0,0,0,0,0,0,56000,0,56000,56000
20200528,05897P,國巨凱基96售12,,,,,0.00,0.00,0,0,0,0,0,0,0,0,0,0,0,0,0
20200528,058980,鴻海凱基99購06,5.40,5.45,5.40,5.45,+0.05,0.93,4000,3,21650,0,0,0,0,0,0,4000,4000,0,0
20200528,058981,國巨凱基99購10,,,,,0.00,0.00,0,0,0,0,0,0,0,0,0,0,0,0,0
20200528,058982,台積電凱基99購08,,,,,0.00,0.00,0,0,0,0,0,0,0,0,0,0,0,0,0
20200528,058983,旺宏凱基99購05,2.34,2.37,2.14,2.14,-0.24,-10.08,27000,7,63250,0,0,0,0,0,0,27000,0,27000,27000
20200528,058984,全新凱基9A購03,0.86,0.88,0.86,0.87,-0.05,-5.43,129000,7,111930,0,0,0,0,0,0,109000,0,109000,109000
20200528,058985,可成凱基99購03,1.16,1.16,1.16,1.16,+0.01,0.87,43000,1,49880,0,0,0,0,0,0,43000,0,43000,43000
20200528,058986,華新科凱基9A購03,1.27,1.27,1.27,1.27,+0.02,1.6,20000,2,25400,0,0,0,0,0,0,20000,0,20000,20000
20200528,058987,華新科凱基9B購01,1.77,1.80,1.77,1.80,0.00,0.00,17000,5,30270,0,0,0,0,0,0,17000,0,17000,17000
20200528,058988,大立光凱基9A購02,,,,,0.00,0.00,0,0,0,0,0,0,0,0,0,0,0,0,0
20200528,058989,茂林凱基99購02,1.76,1.77,1.70,1.70,-0.27,-13.71,58000,17,101580,0,0,0,0,0,0,48000,10000,38000,38000
20200528,05898P,旺宏凱基96售06,,,,,0.00,0.00,0,0,0,0,0,0,0,0,0,0,0,0,0
20200528,058990,GIS凱基99購02,3.83,3.83,3.41,3.41,-0.29,-7.84,14000,3,51200,0,0,0,0,0,0,14000,0,14000,14000
20200528,058991,台灣50元大03購01,,,,,0.00,0.00,0,0,0,0,0,0,0,0,0,0,0,0,0
20200528,058992,上証反元大99購02,,,,,0.00,0.00,0,0,0,0,0,0,0,0,0,0,0,0,0
20200528,058993,滬深反元大9C購01,1.21,1.21,1.21,1.21,0.00,0.00,15000,1,18150,0,0,0,0,0,0,0,15000,-15000,-15000
20200528,058994,道瓊指元大99購01,1.15,1.15,1.15,1.15,+0.14,13.86,9000,1,10350,0,0,0,0,0,0,9000,0,9000,9000
20200528,058995,台達電元大99購01,,,,,0.00,0.00,0,0,0,0,0,0,0,0,0,0,0,0,0
20200528,058996,台達電元大99購02,1.42,1.42,1.30,1.30,-0.13,-9.09,129000,5,176500,0,0,0,0,0,0,99000,59000,40000,40000
20200528,058997,鴻海元大99購21,1.24,1.24,1.20,1.20,0.00,0.00,44000,5,54420,0,0,0,0,0,0,1000,43000,-42000,-42000
20200528,058998,鴻海元大99購22,3.21,3.21,3.21,3.21,+0.14,4.56,37000,1,118770,0,0,0,0,0,0,0,37000,-37000,-37000
20200528,058999,台積電元大99購24,1.20,1.20,1.20,1.20,-0.06,-4.76,9000,1,10800,0,0,0,0,0,0,9000,0,9000,9000
20200528,05899P,臺股指凱基96售30,,,,,0.00,0.00,0,0,0,0,0,0,0,0,0,0,0,0,0
20200528,059000,台積電元大99購25,2.32,2.32,2.27,2.27,0.00,0.00,11000,2,25020,0,0,0,0,0,0,1000,11000,-10000,-10000
20200528,059001,聯發科元大99購17,,,,,0.00,0.00,0,0,0,0,0,0,0,0,0,0,0,0,0
20200528,059002,聯發科元大99購18,,,,,0.00,0.00,0,0,0,0,0,0,0,0,0,0,0,0,0
20200528,059003,中壽元大99購01,2.67,2.69,2.53,2.53,-0.26,-9.32,65000,10,167930,0,0,0,0,0,0,53000,12000,41000,41000
20200528,059004,嘉晶元大99購05,3.88,3.88,3.53,3.53,-0.32,-8.31,225000,23,843370,0,0,0,0,0,0,109000,150000,-41000,-41000
20200528,059005,嘉晶元大99購06,2.44,2.57,2.33,2.33,-0.28,-10.73,443000,23,1065660,0,0,0,0,0,0,94000,349000,-255000,-255000
20200528,059006,樺漢元大99購01,2.05,2.10,2.03,2.10,+0.02,0.96,62000,5,128320,0,0,0,0,0,0,0,62000,-62000,-62000
20200528,059007,南電元大99購05,3.61,3.61,3.54,3.55,-0.02,-0.56,60000,3,213400,0,0,0,0,0,0,30000,30000,0,0
20200528,059008,鈺齊元大99購03,1.16,1.21,1.12,1.12,+0.05,4.67,315000,11,367410,0,0,0,0,0,0,94000,221000,-127000,-127000
20200528,059009,世紀鋼元大99購04,3.93,4.94,3.81,4.58,+0.67,17.14,966000,123,4150150,0,0,0,0,0,0,685000,709000,-24000,-24000
20200528,05900P,臺股指凱基99售05,,,,,0.00,0.00,0,0,0,0,0,0,0,0,0,0,0,0,0
20200528,059010,臺股指元大99購12,,,,,0.00,0.00,0,0,0,0,0,0,0,0,0,0,0,0,0
20200528,059011,臺股指元大9A購30,,,,,0.00,0.00,0,0,0,0,0,0,0,0,0,0,0,0,0
20200528,059012,臺股指元大9A購31,,,,,0.00,0.00,0,0,0,0,0,0,0,0,0,0,0,0,0
20200528,059013,臺股指元大9A購32,,,,,0.00,0.00,0,0,0,0,0,0,0,0,0,0,0,0,0
20200528,059014,SGBR2X元富03購01,3.83,3.83,3.83,3.83,-0.15,-3.77,2000,1,7660,0,0,0,0,0,0,0,2000,-2000,-2000
20200528,059015,華通元富99購02,4.76,5.25,4.76,4.93,+0.38,8.35,40000,6,206870,0,0,0,0,0,0,13000,27000,-14000,-14000
20200528,059016,晶相光元富99購03,0.67,0.68,0.62,0.62,-0.10,-13.89,183000,6,121660,0,0,0,0,0,0,183000,0,183000,183000
20200528,059017,台灣50統一9B購03,,,,,0.00,0.00,0,0,0,0,0,0,0,0,0,0,0,0,0
20200528,059018,滬深2X統一9A購01,0.53,0.53,0.53,0.53,-0.01,-1.85,10000,1,5300,0,0,0,0,0,0,0,10000,-10000,-10000
20200528,059019,元石油統一9B購03,2.19,2.19,2.17,2.18,-0.09,-3.96,150000,9,326730,0,0,0,0,0,0,142000,8000,134000,134000
20200528,05901P,臺股指凱基9C售01,3.01,3.11,3.00,3.11,+0.11,3.67,6000,4,18140,0,0,0,0,0,0,0,0,0,0
20200528,059020,元油2X統一9B購02,1.17,1.17,1.17,1.17,-0.07,-5.65,40000,4,46800,0,0,0,0,0,0,20000,20000,0,0
20200528,059021,台積電統一9B購07,0.97,0.97,0.92,0.92,0.00,0.00,3000,2,2860,0,0,0,0,0,0,2000,1000,1000,1000
20200528,059022,聯發科統一9B購04,,,,,0.00,0.00,0,0,0,0,0,0,0,0,0,0,0,0,0
20200528,059023,可成統一9B購02,1.21,1.22,1.17,1.17,-0.01,-0.85,34000,6,40660,0,0,0,0,0,0,13000,24000,-11000,-11000
20200528,059024,大立光統一9B購04,0.46,0.46,0.46,0.46,-0.01,-2.13,60000,2,27600,0,0,0,0,0,0,0,60000,-60000,-60000
20200528,059025,台灣50台新9B購02,2.09,2.09,2.09,2.09,0.00,0.00,40000,1,83600,0,0,0,0,0,0,40000,0,40000,40000
20200528,059026,FBVIX台新99購03,,,,,0.00,0.00,0,0,0,0,0,0,0,0,0,0,0,0,0
20200528,059027,神達台新99購02,1.86,1.86,1.81,1.81,-0.04,-2.16,11000,2,19960,0,0,0,0,0,0,0,11000,-11000,-11000
20200528,059028,嘉聯益台新99購02,,,,,0.00,0.00,0,0,0,0,0,0,0,0,0,0,0,0,0
20200528,059029,旺宏兆豐99購01,1.04,1.06,0.94,0.94,-0.11,-10.48,60000,6,59800,0,0,0,0,0,0,20000,40000,-20000,-20000
20200528,05902P,華通國票96售02,1.55,1.55,1.55,1.55,-0.47,-23.27,2000,1,3100,0,0,0,0,0,0,0,2000,-2000,-2000
20200528,059030,奇力新兆豐99購03,0.81,0.81,0.78,0.78,-0.07,-8.24,517000,5,418560,0,0,0,0,0,0,510000,7000,503000,503000
20200528,059031,元石油中信03購01,1.62,1.64,1.62,1.62,-0.06,-3.57,50000,5,81200,0,0,0,0,0,0,0,50000,-50000,-50000
20200528,059032,元石油群益9C購03,0.70,0.71,0.70,0.70,-0.05,-6.67,30000,3,21100,0,0,0,0,0,0,0,30000,-30000,-30000
20200528,059033,元油2X群益9C購05,1.59,1.59,1.59,1.59,0.00,0.00,2000,1,3180,0,0,0,0,0,0,0,2000,-2000,-2000
20200528,059034,華通群益9B購02,,,,,0.00,0.00,0,0,0,0,0,0,0,0,0,0,0,0,0
20200528,059035,旺宏群益99購06,3.35,3.35,3.35,3.35,-0.03,-0.89,4000,1,13400,0,0,0,0,0,0,4000,0,4000,4000
20200528,059036,可成群益9B購03,2.14,2.14,2.04,2.04,-0.03,-1.45,22000,4,46180,0,0,0,0,0,0,11000,12000,-1000,-1000
20200528,059037,宏達電群益99購02,2.68,2.68,2.59,2.59,-0.33,-11.3,28000,2,74680,0,0,0,0,0,0,28000,28000,0,0
20200528,059038,健策群益9A購02,4.13,4.21,3.50,3.61,-0.17,-4.5,202000,15,746120,0,0,0,0,0,0,148000,136000,12000,12000
20200528,059039,致伸群益99購01,2.27,2.38,2.27,2.38,+0.14,6.25,306000,25,718780,0,0,0,0,0,0,8000,298000,-290000,-290000
20200528,05903P,聯發科統一96售09,,,,,0.00,0.00,0,0,0,0,0,0,0,0,0,0,0,0,0
20200528,059040,訊芯群益99購03,1.14,1.14,1.04,1.04,-0.10,-8.77,201000,3,221780,0,0,0,0,0,0,98000,103000,-5000,-5000
20200528,059041,南茂群益99購02,2.03,2.05,2.03,2.05,-0.09,-4.21,149000,2,303250,0,0,0,0,0,0,110000,39000,71000,71000
20200528,059042,世紀鋼群益99購02,1.56,1.98,1.56,1.88,+0.26,16.05,421000,24,785580,0,0,0,0,0,0,115000,298000,-183000,-183000
20200528,059043,聯電日盛99購01,1.68,1.68,1.68,1.68,+0.02,1.2,200000,2,336000,0,0,0,0,0,0,0,200000,-200000,-200000
20200528,059044,聯電日盛99購02,1.07,1.07,1.07,1.07,+0.01,0.94,200000,1,214000,0,0,0,0,0,0,0,200000,-200000,-200000
20200528,059045,高股息凱基99購01,,,,,0.00,0.00,0,0,0,0,0,0,0,0,0,0,0,0,0
20200528,059046,滬深2X凱基9C購01,,,,,0.00,0.00,0,0,0,0,0,0,0,0,0,0,0,0,0
20200528,059047,元油2X凱基9A購10,1.01,1.04,0.99,0.99,-0.12,-10.81,437000,7,444170,0,0,0,0,0,0,227000,217000,10000,10000
20200528,059048,元油2X凱基9A購11,0.74,0.74,0.74,0.74,0.00,0.00,10000,1,7400,0,0,0,0,0,0,0,10000,-10000,-10000
20200528,059049,元油2X凱基9A購12,0.40,0.40,0.35,0.38,-0.04,-9.52,44000,13,17060,0,0,0,0,0,0,0,42000,-42000,-42000
20200528,05904P,大立光統一96售07,,,,,0.00,0.00,0,0,0,0,0,0,0,0,0,0,0,0,0
20200528,059050,元油2X凱基9B購08,,,,,0.00,0.00,0,0,0,0,0,0,0,0,0,0,0,0,0
20200528,059051,和大凱基9A購01,0.99,1.01,0.99,1.01,+0.05,5.21,60000,3,59800,0,0,0,0,0,0,0,60000,-60000,-60000
20200528,059052,為升凱基99購01,0.40,0.40,0.40,0.40,0.00,0.00,27000,1,10800,0,0,0,0,0,0,27000,0,27000,27000
20200528,059053,鴻海凱基99購07,,,,,0.00,0.00,0,0,0,0,0,0,0,0,0,0,0,0,0
20200528,059054,國巨凱基99購11,1.58,1.58,1.58,1.58,0.00,0.00,10000,1,15800,0,0,0,0,0,0,10000,0,10000,10000
20200528,059055,旺宏凱基9B購02,4.06,4.12,3.77,3.77,-0.38,-9.16,52000,12,211240,0,0,0,0,0,0,50000,2000,48000,48000
20200528,059056,技嘉凱基99購02,3.91,4.01,3.76,3.76,-0.36,-8.74,40000,5,158920,0,0,0,0,0,0,4000,40000,-36000,-36000
20200528,059057,聯發科凱基99購10,,,,,0.00,0.00,0,0,0,0,0,0,0,0,0,0,0,0,0
20200528,059058,可成凱基9B購01,2.72,2.72,2.62,2.62,-0.07,-2.6,16000,3,42990,0,0,0,0,0,0,16000,1000,15000,15000
20200528,059059,宏達電凱基99購03,1.10,1.10,1.00,1.00,-0.12,-10.71,76000,3,82960,0,0,0,0,0,0,76000,8000,68000,68000
20200528,05905P,晶技統一97售01,0.52,0.53,0.51,0.52,+0.01,1.96,237000,13,123760,0,0,0,0,0,0,25000,192000,-167000,-167000
20200528,059060,大立光凱基9A購03,,,,,0.00,0.00,0,0,0,0,0,0,0,0,0,0,0,0,0
20200528,059061,晶技凱基9A購01,2.40,2.45,2.35,2.45,-0.02,-0.81,140000,17,334760,0,0,0,0,0,0,85000,55000,30000,30000
20200528,059062,群創凱基99購05,,,,,0.00,0.00,0,0,0,0,0,0,0,0,0,0,0,0,0
20200528,059063,康控凱基99購04,,,,,0.00,0.00,0,0,0,0,0,0,0,0,0,0,0,0,0
20200528,059064,緯穎凱基99購02,2.12,2.21,1.99,1.99,-0.22,-9.95,202000,18,424310,0,0,0,0,0,0,157000,45000,112000,112000
20200528,059065,南電凱基9A購01,1.39,1.43,1.32,1.32,-0.08,-5.71,30000,3,41400,0,0,0,0,0,0,10000,20000,-10000,-10000
20200528,059066,道瓊指國票04購01,,,,,0.00,0.00,0,0,0,0,0,0,0,0,0,0,0,0,0
20200528,059067,上銀國票9A購02,11.70,12.10,11.70,12.10,-0.50,-3.97,49000,14,578700,0,0,0,0,0,0,30000,19000,11000,11000
20200528,059068,台虹國票9A購01,2.21,2.21,2.21,2.21,-0.11,-4.74,30000,1,66300,0,0,0,0,0,0,0,30000,-30000,-30000
20200528,059069,臺指反元大9C購01,,,,,0.00,0.00,0,0,0,0,0,0,0,0,0,0,0,0,0
20200528,05906P,國巨元富96售05,,,,,0.00,0.00,0,0,0,0,0,0,0,0,0,0,0,0,0
20200528,059070,道瓊指元大99購02,1.72,1.72,1.68,1.68,+0.15,9.8,20000,3,34050,0,0,0,0,0,0,0,20000,-20000,-20000
20200528,059071,元油2X元大9C購12,,,,,0.00,0.00,0,0,0,0,0,0,0,0,0,0,0,0,0
20200528,059072,元油2X元大9C購13,1.36,1.36,1.36,1.36,-0.16,-10.53,11000,2,14960,0,0,0,0,0,0,0,11000,-11000,-11000
20200528,059073,元油2X元大9C購14,1.34,1.34,1.34,1.34,0.00,0.00,3000,1,4020,0,0,0,0,0,0,0,3000,-3000,-3000
20200528,059074,元油2X元大9C購15,1.58,1.59,1.54,1.54,-0.21,-12.0,129000,15,202720,0,0,0,0,0,0,60000,69000,-9000,-9000
20200528,059075,FBVIX元大99購01,1.60,1.60,1.60,1.60,-0.02,-1.23,4000,2,6400,0,0,0,0,0,0,0,4000,-4000,-4000
20200528,059076,FBVIX元大99購04,,,,,0.00,0.00,0,0,0,0,0,0,0,0,0,0,0,0,0
20200528,059077,FBVIX元大99購05,1.52,1.53,1.52,1.53,-0.01,-0.65,6000,2,9140,0,0,0,0,0,0,2000,4000,-2000,-2000
20200528,059078,FBVIX元大99購06,1.55,1.55,1.55,1.55,-0.04,-2.52,2000,1,3100,0,0,0,0,0,0,0,2000,-2000,-2000
20200528,059079,SGBR2X元大99購01,,,,,0.00,0.00,0,0,0,0,0,0,0,0,0,0,0,0,0
20200528,05907P,聯發科元富96售05,,,,,0.00,0.00,0,0,0,0,0,0,0,0,0,0,0,0,0
20200528,059080,亞泥元大99購01,2.23,2.24,2.12,2.12,-0.11,-4.93,223000,10,492010,0,0,0,0,0,0,23000,200000,-177000,-177000
20200528,059081,和大元大99購01,0.74,0.74,0.74,0.74,0.00,0.00,6000,1,4440,0,0,0,0,0,0,6000,0,6000,6000
20200528,059082,華通元大99購06,1.26,1.34,1.25,1.25,+0.09,7.76,189000,12,249000,0,0,0,0,0,0,8000,177000,-169000,-169000
20200528,059083,華通元大99購07,1.29,1.37,1.29,1.37,+0.16,13.22,56000,3,76300,0,0,0,0,0,0,6000,50000,-44000,-44000
20200528,059084,鴻海元大99購24,,,,,0.00,0.00,0,0,0,0,0,0,0,0,0,0,0,0,0
20200528,059085,鴻海元大99購25,3.30,3.30,3.30,3.30,+0.03,0.92,4000,4,13200,0,0,0,0,0,0,4000,4000,0,0
20200528,059086,國巨元大99購18,0.89,0.90,0.85,0.85,-0.03,-3.41,76000,6,67430,0,0,0,0,0,0,6000,61000,-55000,-55000
20200528,059087,台積電元大99購26,,,,,0.00,0.00,0,0,0,0,0,0,0,0,0,0,0,0,0
20200528,059088,台積電元大99購27,,,,,0.00,0.00,0,0,0,0,0,0,0,0,0,0,0,0,0
20200528,059089,聯發科元大99購19,5.70,5.70,5.70,5.70,+0.20,3.64,22000,1,125400,0,0,0,0,0,0,22000,0,22000,22000
20200528,05908P,大立光元富96售05,4.70,5.00,4.70,5.00,+0.05,1.01,51000,3,244800,0,0,0,0,0,0,34000,17000,17000,17000
20200528,059090,台新金元大99購01,1.09,1.09,1.07,1.07,+0.01,0.94,176000,3,189860,0,0,0,0,0,0,99000,77000,22000,22000
20200528,059091,中信金元大99購01,,,,,0.00,0.00,0,0,0,0,0,0,0,0,0,0,0,0,0
20200528,059092,聯陽元大99購01,,,,,0.00,0.00,0,0,0,0,0,0,0,0,0,0,0,0,0
20200528,059093,旭富元大99購01,1.02,1.04,1.02,1.03,+0.01,0.98,51000,3,52530,0,0,0,0,0,0,49000,0,49000,49000
20200528,059094,臻鼎元大99購03,,,,,0.00,0.00,0,0,0,0,0,0,0,0,0,0,0,0,0
20200528,059095,訊芯元大99購01,0.96,0.99,0.90,0.90,-0.05,-5.26,29000,4,27710,0,0,0,0,0,0,9000,29000,-20000,-20000
20200528,059096,百和元大99購04,2.15,2.16,1.99,2.03,-0.02,-0.98,156000,7,321290,0,0,0,0,0,0,31000,125000,-94000,-94000
20200528,059097,世紀鋼元大99購05,1.16,1.44,1.13,1.36,+0.21,18.26,696000,41,880410,0,0,0,0,0,0,505000,454000,51000,51000
20200528,059098,元油2X統一9B購03,,,,,0.00,0.00,0,0,0,0,0,0,0,0,0,0,0,0,0
20200528,059099,元油2X統一9C購01,,,,,0.00,0.00,0,0,0,0,0,0,0,0,0,0,0,0,0
20200528,05909P,康友元富96售02,,,,,0.00,0.00,0,0,0,0,0,0,0,0,0,0,0,0,0
20200528,059100,元油2X統一9C購02,0.67,0.67,0.64,0.65,-0.05,-7.14,336000,11,220440,0,0,0,0,0,0,131000,169000,-38000,-38000
20200528,059101,康控統一9A購01,0.69,0.69,0.64,0.64,-0.02,-3.03,145000,4,93600,0,0,0,0,0,0,110000,35000,75000,75000
20200528,059102,聯鈞元富99購01,,,,,0.00,0.00,0,0,0,0,0,0,0,0,0,0,0,0,0
20200528,059103,旭富元富99購03,,,,,0.00,0.00,0,0,0,0,0,0,0,0,0,0,0,0,0
20200528,059104,臺股指元富99購05,,,,,0.00,0.00,0,0,0,0,0,0,0,0,0,0,0,0,0
20200528,059105,臺股指元富99購06,,,,,0.00,0.00,0,0,0,0,0,0,0,0,0,0,0,0,0
20200528,059106,臺股指元富99購07,,,,,0.00,0.00,0,0,0,0,0,0,0,0,0,0,0,0,0
20200528,059107,南茂國泰9A購01,2.01,2.01,1.84,1.84,-0.20,-9.8,35000,2,69500,0,0,0,0,0,0,30000,5000,25000,25000
20200528,059108,台灣50富邦9B購01,,,,,0.00,0.00,0,0,0,0,0,0,0,0,0,0,0,0,0
20200528,059109,台積電富邦9C購03,1.04,1.04,1.02,1.02,-0.06,-5.56,31000,2,31640,0,0,0,0,0,0,31000,0,31000,31000
20200528,05910P,力山永豐96售02,0.27,0.30,0.27,0.30,0.00,0.00,120000,4,35400,0,0,0,0,0,0,0,120000,-120000,-120000
20200528,059110,元油2X永豐99購02,,,,,0.00,0.00,0,0,0,0,0,0,0,0,0,0,0,0,0
20200528,059111,元油2X永豐99購03,,,,,0.00,0.00,0,0,0,0,0,0,0,0,0,0,0,0,0
20200528,059112,上銀永豐99購01,2.26,2.32,1.86,1.86,-0.25,-11.85,149000,18,304050,0,0,0,0,0,0,90000,129000,-39000,-39000
20200528,059113,群光永豐99購01,2.14,2.30,2.14,2.23,-0.01,-0.45,167000,16,371760,0,0,0,0,0,0,145000,22000,123000,123000
20200528,059114,華新科永豐99購05,0.75,0.75,0.74,0.74,-0.02,-2.63,17000,12,12740,0,0,0,0,0,0,17000,0,17000,17000
20200528,059115,美食永豐99購01,3.92,3.92,3.74,3.77,+0.03,0.8,40000,6,151730,0,0,0,0,0,0,30000,10000,20000,20000
20200528,059116,晶豪科永豐99購01,2.62,2.67,2.62,2.66,+0.16,6.4,64000,3,169270,0,0,0,0,0,0,0,64000,-64000,-64000
20200528,059117,禾伸堂永豐99購01,,,,,0.00,0.00,0,0,0,0,0,0,0,0,0,0,0,0,0
20200528,059118,晶技永豐9A購01,3.23,3.32,3.23,3.32,-0.15,-4.32,45000,8,145640,0,0,0,0,0,0,45000,0,45000,45000
20200528,059119,華擎永豐99購02,,,,,0.00,0.00,0,0,0,0,0,0,0,0,0,0,0,0,0
20200528,05911P,南亞科永豐96售03,1.37,1.76,1.37,1.76,-0.07,-3.83,49000,5,82200,0,0,0,0,0,0,5000,44000,-39000,-39000
20200528,059120,致伸永豐99購01,2.71,2.71,2.71,2.71,0.00,0.00,9000,1,24390,0,0,0,0,0,0,0,9000,-9000,-9000
20200528,059121,瑞儀永豐99購01,2.76,2.76,2.76,2.76,-0.02,-0.72,4000,1,11040,0,0,0,0,0,0,0,4000,-4000,-4000
20200528,059122,超眾永豐99購01,1.99,1.99,1.93,1.93,-0.25,-11.47,8000,2,15860,0,0,0,0,0,0,8000,0,8000,8000
20200528,059123,訊芯永豐99購03,0.89,0.91,0.81,0.81,-0.05,-5.81,182000,8,157660,0,0,0,0,0,0,88000,94000,-6000,-6000
20200528,059124,台積電第一03購01,1.14,1.14,1.09,1.09,-0.03,-2.68,25000,3,27900,0,0,0,0,0,0,10000,15000,-5000,-5000
20200528,059125,台積電第一03購02,1.25,1.25,1.09,1.09,-0.04,-3.54,632000,33,724770,0,0,0,0,0,0,0,632000,-632000,-632000
20200528,059126,臺指反中信9B購01,,,,,0.00,0.00,0,0,0,0,0,0,0,0,0,0,0,0,0
20200528,059127,國巨中信99購04,0.83,0.83,0.77,0.77,-0.03,-3.75,84000,3,66480,0,0,0,0,0,0,80000,4000,76000,76000
20200528,059128,友達中信99購02,0.83,0.88,0.78,0.79,-0.04,-4.82,506000,14,413130,0,0,0,0,0,0,351000,55000,296000,296000
20200528,059129,麗豐中信99購01,1.89,1.89,1.79,1.79,-0.11,-5.79,21000,2,38690,0,0,0,0,0,0,11000,10000,1000,1000
20200528,05912P,和大元大96售01,,,,,0.00,0.00,0,0,0,0,0,0,0,0,0,0,0,0,0
20200528,059130,台灣50群益9B購05,,,,,0.00,0.00,0,0,0,0,0,0,0,0,0,0,0,0,0
20200528,059131,國巨群益99購07,3.12,3.13,3.12,3.13,+0.09,2.96,13000,2,40570,0,0,0,0,0,0,13000,1000,12000,12000
20200528,059132,臺股指群益99購07,,,,,0.00,0.00,0,0,0,0,0,0,0,0,0,0,0,0,0
20200528,059133,臺股指群益99購08,,,,,0.00,0.00,0,0,0,0,0,0,0,0,0,0,0,0,0
20200528,059134,臺股指群益99購09,5.65,5.65,5.65,5.65,0.00,0.00,6000,1,33900,0,0,0,0,0,0,6000,0,6000,6000
20200528,059135,臺股指群益99購10,,,,,0.00,0.00,0,0,0,0,0,0,0,0,0,0,0,0,0
20200528,059136,臺股指群益99購11,7.25,7.25,6.75,6.75,-0.35,-4.93,181000,2,1222250,0,0,0,0,0,0,180000,1000,179000,179000
20200528,059137,電子類群益99購01,2.33,2.33,2.15,2.15,0.00,0.00,2000,2,4480,0,0,0,0,0,0,2000,0,2000,2000
20200528,059138,台積電兆豐99購04,1.57,1.57,1.57,1.57,+0.04,2.61,1000,1,1570,0,0,0,0,0,0,1000,0,1000,1000
20200528,059139,全新兆豐9A購01,1.38,1.43,1.38,1.40,-0.01,-0.71,693000,54,972140,0,0,0,0,0,0,648000,45000,603000,603000
20200528,05913P,國巨元大96售11,,,,,0.00,0.00,0,0,0,0,0,0,0,0,0,0,0,0,0
20200528,059140,大立光兆豐9A購02,1.08,1.08,0.98,0.98,-0.06,-5.77,134000,9,137820,0,0,0,0,0,0,14000,120000,-106000,-106000
20200528,059141,臺股指兆豐99購01,,,,,0.00,0.00,0,0,0,0,0,0,0,0,0,0,0,0,0
20200528,059142,道瓊指國票9B購02,,,,,0.00,0.00,0,0,0,0,0,0,0,0,0,0,0,0,0
20200528,059143,國巨國票9A購04,7.25,7.30,6.80,6.85,-0.20,-2.84,20000,13,143300,0,0,0,0,0,0,18000,13000,5000,5000
20200528,059144,嘉晶國票9A購02,,,,,0.00,0.00,0,0,0,0,0,0,0,0,0,0,0,0,0
20200528,059145,創意國票99購02,17.10,17.20,15.90,15.90,0.00,0.00,10000,7,169200,0,0,0,0,0,0,0,10000,-10000,-10000
20200528,059146,貿聯國票9A購02,3.50,3.53,3.43,3.43,-0.05,-1.44,88000,5,306250,0,0,0,0,0,0,60000,28000,32000,32000
20200528,059147,矽創國票99購01,5.80,6.85,5.75,5.75,+0.55,10.58,261000,30,1715700,0,0,0,0,0,0,82000,179000,-97000,-97000
20200528,059148,百和國票9A購01,6.55,6.55,6.55,6.55,+0.65,11.02,6000,1,39300,0,0,0,0,0,0,6000,0,6000,6000
20200528,059149,臺股指國票99購12,6.70,6.70,6.25,6.25,0.00,0.00,3000,2,19200,0,0,0,0,0,0,3000,0,3000,3000
20200528,05914P,友達元大96售04,,,,,0.00,0.00,0,0,0,0,0,0,0,0,0,0,0,0,0
20200528,059150,臺股指國票99購13,,,,,0.00,0.00,0,0,0,0,0,0,0,0,0,0,0,0,0
20200528,059151,臺股指國票99購14,5.10,5.10,4.50,4.50,-0.36,-7.41,20000,12,95630,0,0,0,0,0,0,6000,14000,-8000,-8000
20200528,059152,臺股指國票99購15,4.33,4.33,4.08,4.08,0.00,0.00,4000,2,16570,0,0,0,0,0,0,1000,3000,-2000,-2000
20200528,059153,臺股指國票99購16,3.94,3.94,3.49,3.54,-0.21,-5.6,40000,14,147370,0,0,0,0,0,0,6000,34000,-28000,-28000
20200528,059154,可成日盛99購02,1.57,1.57,1.57,1.57,-0.03,-1.88,9000,1,14130,0,0,0,0,0,0,9000,0,9000,9000
20200528,059155,台表科日盛99購01,2.88,3.00,2.67,2.82,-0.08,-2.76,136000,7,376610,0,0,0,0,0,0,2000,134000,-132000,-132000
20200528,059156,台灣50凱基01購03,,,,,0.00,0.00,0,0,0,0,0,0,0,0,0,0,0,0,0
20200528,059157,元石油凱基9C購01,,,,,0.00,0.00,0,0,0,0,0,0,0,0,0,0,0,0,0
20200528,059158,S&P正2凱基99購01,,,,,0.00,0.00,0,0,0,0,0,0,0,0,0,0,0,0,0
20200528,059159,上銀凱基99購05,3.69,3.77,3.69,3.73,-0.05,-1.32,52000,13,194200,0,0,0,0,0,0,52000,0,52000,52000
20200528,05915P,聯發科元大96售19,1.49,1.56,1.48,1.50,0.00,0.00,191000,8,293110,0,0,0,0,0,0,0,191000,-191000,-191000
20200528,059160,華通凱基99購03,2.73,2.75,2.69,2.69,+0.27,11.16,185000,16,502780,0,0,0,0,0,0,0,185000,-185000,-185000
20200528,059161,鴻海凱基9A購09,4.47,4.47,4.47,4.47,+0.03,0.68,2000,1,8940,0,0,0,0,0,0,2000,2000,0,0
20200528,059162,國巨凱基99購12,3.80,3.80,3.60,3.60,-0.11,-2.96,10000,2,37800,0,0,0,0,0,0,10000,1000,9000,9000
20200528,059163,台積電凱基99購10,,,,,0.00,0.00,0,0,0,0,0,0,0,0,0,0,0,0,0
20200528,059164,旺宏凱基99購06,4.62,4.69,4.61,4.61,-0.12,-2.54,68000,14,315980,0,0,0,0,0,0,68000,0,68000,68000
20200528,059165,南亞科凱基99購04,3.93,4.00,3.58,3.58,-0.09,-2.45,39000,5,150300,0,0,0,0,0,0,20000,19000,1000,1000
20200528,059166,友達凱基99購05,1.11,1.15,1.11,1.15,+0.02,1.77,30000,3,34000,0,0,0,0,0,0,10000,20000,-10000,-10000
20200528,059167,聯發科凱基99購11,,,,,0.00,0.00,0,0,0,0,0,0,0,0,0,0,0,0,0
20200528,059168,奇力新凱基99購05,,,,,0.00,0.00,0,0,0,0,0,0,0,0,0,0,0,0,0
20200528,059169,可成凱基99購04,2.33,2.33,2.30,2.30,+0.02,0.88,4000,3,9250,0,0,0,0,0,0,1000,4000,-3000,-3000
20200528,05916P,聯發科元大96售20,2.14,2.14,2.14,2.14,+0.03,1.42,5000,1,10700,0,0,0,0,0,0,5000,0,5000,5000
20200528,059170,康控凱基9B購01,,,,,0.00,0.00,0,0,0,0,0,0,0,0,0,0,0,0,0
20200528,059171,祥碩凱基99購04,4.26,4.26,4.17,4.17,+0.08,1.96,26000,2,109320,0,0,0,0,0,0,26000,0,26000,26000
20200528,059172,台郡凱基99購03,,,,,0.00,0.00,0,0,0,0,0,0,0,0,0,0,0,0,0
20200528,059173,矽力凱基99購01,4.35,4.75,4.35,4.62,+0.38,8.96,45000,16,204250,0,0,0,0,0,0,19000,26000,-7000,-7000
20200528,059174,訊芯凱基99購01,1.69,1.69,1.62,1.62,-0.06,-3.57,35000,3,57750,0,0,0,0,0,0,35000,15000,20000,20000
20200528,059175,臺股指凱基99購26,,,,,0.00,0.00,0,0,0,0,0,0,0,0,0,0,0,0,0
20200528,059176,臺股指凱基99購27,2.91,2.91,2.43,2.47,-0.32,-11.47,389000,59,1009520,0,0,0,0,0,0,62000,327000,-265000,-265000
20200528,059177,臺股指凱基99購28,2.19,2.21,2.17,2.20,-0.21,-8.71,51000,10,111590,0,0,0,0,0,0,8000,43000,-35000,-35000
20200528,059178,臺股指凱基99購30,,,,,0.00,0.00,0,0,0,0,0,0,0,0,0,0,0,0,0
20200528,059179,祥碩元富99購01,5.50,5.50,5.50,5.50,0.00,0.00,1000,1,5500,0,0,0,0,0,0,1000,0,1000,1000
20200528,05917P,宏達電元大96售02,,,,,0.00,0.00,0,0,0,0,0,0,0,0,0,0,0,0,0
20200528,059180,祥碩元富9A購01,,,,,0.00,0.00,0,0,0,0,0,0,0,0,0,0,0,0,0
20200528,059181,世紀鋼元富9C購01,2.17,2.62,2.14,2.47,+0.27,12.27,1172000,100,2766440,0,0,0,0,0,0,437000,735000,-298000,-298000
20200528,059182,台灣50台新9B購03,,,,,0.00,0.00,0,0,0,0,0,0,0,0,0,0,0,0,0
20200528,059183,T50反1台新03購02,0.42,0.45,0.42,0.45,+0.02,4.65,180000,17,77880,0,0,0,0,0,0,50000,116000,-66000,-66000
20200528,059184,晶技台新99購01,,,,,0.00,0.00,0,0,0,0,0,0,0,0,0,0,0,0,0
20200528,059185,臺股指台新99購12,,,,,0.00,0.00,0,0,0,0,0,0,0,0,0,0,0,0,0
20200528,059186,華通富邦9A購01,,,,,0.00,0.00,0,0,0,0,0,0,0,0,0,0,0,0,0
20200528,059187,國巨富邦9B購02,1.39,1.40,1.36,1.36,-0.02,-1.45,96000,11,133900,0,0,0,0,0,0,91000,5000,86000,86000
20200528,059188,京元電富邦9B購01,0.82,0.82,0.77,0.77,-0.05,-6.1,774000,27,607290,0,0,0,0,0,0,305000,450000,-145000,-145000
20200528,059189,國泰金富邦9B購01,2.60,2.60,2.38,2.38,-0.19,-7.39,11000,2,28380,0,0,0,0,0,0,10000,1000,9000,9000
20200528,05918P,大立光元大96售11,,,,,0.00,0.00,0,0,0,0,0,0,0,0,0,0,0,0,0
20200528,059190,欣興富邦9A購01,1.65,1.78,1.64,1.65,+0.06,3.77,10000,10,17160,0,0,0,0,0,0,3000,3000,0,0
20200528,059191,茂林富邦9B購01,,,,,0.00,0.00,0,0,0,0,0,0,0,0,0,0,0,0,0
20200528,059192,臺股指富邦9C購01,3.70,3.70,3.70,3.70,0.00,0.00,5000,1,18500,0,0,0,0,0,0,0,5000,-5000,-5000
20200528,059193,台灣50永豐99購05,,,,,0.00,0.00,0,0,0,0,0,0,0,0,0,0,0,0,0
20200528,059194,元金2X永豐99購01,1.42,1.43,1.42,1.43,+0.06,4.38,22000,2,31360,0,0,0,0,0,0,22000,0,22000,22000
20200528,059195,國巨永豐99購04,,,,,0.00,0.00,0,0,0,0,0,0,0,0,0,0,0,0,0
20200528,059196,聯發科永豐99購02,4.37,4.37,4.37,4.37,+0.11,2.58,4000,1,17480,0,0,0,0,0,0,4000,0,4000,4000
20200528,059197,可成永豐99購02,2.40,2.40,2.39,2.39,-0.02,-0.83,16000,2,38300,0,0,0,0,0,0,6000,10000,-4000,-4000
20200528,059198,華新科永豐99購06,1.27,1.27,1.24,1.25,-0.04,-3.1,172000,11,217000,0,0,0,0,0,0,160000,12000,148000,148000
20200528,059199,欣興永豐99購02,4.14,4.50,4.11,4.17,+0.13,3.22,157000,32,681750,0,0,0,0,0,0,21000,137000,-116000,-116000
20200528,05919P,京鼎元大96售03,0.82,0.91,0.82,0.91,+0.02,2.25,266000,10,230200,0,0,0,0,0,0,166000,266000,-100000,-100000
20200528,059200,京鼎永豐99購02,2.00,2.00,1.89,1.89,-0.09,-4.55,60000,5,119110,0,0,0,0,0,0,21000,40000,-19000,-19000
20200528,059201,祥碩永豐99購02,3.94,3.94,3.94,3.94,+0.46,13.22,1000,1,3940,0,0,0,0,0,0,1000,0,1000,1000
20200528,059202,禾聯碩永豐99購01,,,,,0.00,0.00,0,0,0,0,0,0,0,0,0,0,0,0,0
20200528,059203,勤誠永豐99購02,2.18,2.22,2.18,2.19,-0.07,-3.1,18000,3,39380,0,0,0,0,0,0,18000,0,18000,18000
20200528,059204,台灣50元大01購02,5.00,5.00,4.88,4.88,-0.17,-3.37,7000,3,34430,0,0,0,0,0,0,0,7000,-7000,-7000
20200528,059205,元石油元大99購01,1.62,1.62,1.60,1.60,-0.09,-5.33,60000,2,97000,0,0,0,0,0,0,60000,0,60000,60000
20200528,059206,元石油元大99購02,1.37,1.37,1.37,1.37,0.00,0.00,2000,1,2740,0,0,0,0,0,0,2000,0,2000,2000
20200528,059207,臺指反元大9C購02,1.25,1.25,1.25,1.25,-0.01,-0.79,16000,1,20000,0,0,0,0,0,0,16000,0,16000,16000
20200528,059208,SGBR2X元大99購02,0.83,0.85,0.83,0.84,-0.18,-17.65,32000,7,26950,0,0,0,0,0,0,0,0,0,0
20200528,059209,華通元大99購08,1.71,1.87,1.71,1.87,+0.23,14.02,52000,3,97000,0,0,0,0,0,0,2000,50000,-48000,-48000
20200528,05920P,力成元大96售04,,,,,0.00,0.00,0,0,0,0,0,0,0,0,0,0,0,0,0
20200528,059210,鴻海元大99購26,,,,,0.00,0.00,0,0,0,0,0,0,0,0,0,0,0,0,0
20200528,059211,鴻海元大99購27,,,,,0.00,0.00,0,0,0,0,0,0,0,0,0,0,0,0,0
20200528,059212,鴻海元大99購28,,,,,0.00,0.00,0,0,0,0,0,0,0,0,0,0,0,0,0
20200528,059213,國巨元大99購19,3.83,3.87,3.61,3.61,-0.07,-1.9,118000,27,445470,0,0,0,0,0,0,60000,60000,0,0
20200528,059214,國巨元大99購20,4.21,4.21,4.01,4.01,-0.10,-2.43,19000,3,79770,0,0,0,0,0,0,19000,2000,17000,17000
20200528,059215,台積電元大99購28,1.73,1.73,1.73,1.73,-0.01,-0.57,1000,1,1730,0,0,0,0,0,0,1000,0,1000,1000
20200528,059216,台積電元大99購29,,,,,0.00,0.00,0,0,0,0,0,0,0,0,0,0,0,0,0
20200528,059217,台積電元大99購30,3.84,3.84,3.84,3.84,-0.16,-4.0,1000,1,3840,0,0,0,0,0,0,1000,0,1000,1000
20200528,059218,台積電元大99購31,1.31,1.31,1.30,1.31,-0.05,-3.68,137000,3,179150,0,0,0,0,0,0,0,137000,-137000,-137000
20200528,059219,旺宏元大99購12,1.75,1.77,1.63,1.63,-0.14,-7.91,24000,5,40720,0,0,0,0,0,0,21000,4000,17000,17000
20200528,05921P,同欣電元大96售06,,,,,0.00,0.00,0,0,0,0,0,0,0,0,0,0,0,0,0
20200528,059220,聯發科元大99購20,,,,,0.00,0.00,0,0,0,0,0,0,0,0,0,0,0,0,0
20200528,059221,聯發科元大99購21,,,,,0.00,0.00,0,0,0,0,0,0,0,0,0,0,0,0,0
20200528,059222,聯發科元大99購22,,,,,0.00,0.00,0,0,0,0,0,0,0,0,0,0,0,0,0
20200528,059223,大立光元大99購14,3.02,3.02,2.79,2.90,-0.12,-3.97,1346000,25,3787100,0,0,0,0,0,0,1338000,8000,1330000,1330000
20200528,059224,大立光元大99購15,2.76,2.76,2.76,2.76,0.00,0.00,10000,1,27600,0,0,0,0,0,0,0,10000,-10000,-10000
20200528,059225,臺股指元大99購18,,,,,0.00,0.00,0,0,0,0,0,0,0,0,0,0,0,0,0
20200528,059226,臺股指元大99購19,,,,,0.00,0.00,0,0,0,0,0,0,0,0,0,0,0,0,0
20200528,059227,臺股指元大99購20,,,,,0.00,0.00,0,0,0,0,0,0,0,0,0,0,0,0,0
20200528,059228,臺股指元大99購21,,,,,0.00,0.00,0,0,0,0,0,0,0,0,0,0,0,0,0
20200528,059229,臺股指元大99購22,,,,,0.00,0.00,0,0,0,0,0,0,0,0,0,0,0,0,0
20200528,05922P,京元電兆豐96售01,1.63,1.71,1.63,1.71,+0.04,2.4,40000,4,66800,0,0,0,0,0,0,20000,20000,0,0
20200528,059230,滬深2X國票9B購02,,,,,0.00,0.00,0,0,0,0,0,0,0,0,0,0,0,0,0
20200528,059231,華通國票9A購04,,,,,0.00,0.00,0,0,0,0,0,0,0,0,0,0,0,0,0
20200528,059232,台灣50凱基03購01,,,,,0.00,0.00,0,0,0,0,0,0,0,0,0,0,0,0,0
20200528,059233,台灣50凱基9C購02,,,,,0.00,0.00,0,0,0,0,0,0,0,0,0,0,0,0,0
20200528,059234,台灣50凱基9C購03,6.00,6.00,6.00,6.00,+0.15,2.56,34000,1,204000,0,0,0,0,0,0,34000,0,34000,34000
20200528,059235,鴻海凱基99購08,2.54,2.54,2.54,2.54,-0.02,-0.78,7000,1,17780,0,0,0,0,0,0,0,7000,-7000,-7000
20200528,059236,鴻海凱基99購09,2.03,2.03,1.98,1.98,-0.02,-1.0,37000,7,74060,0,0,0,0,0,0,17000,26000,-9000,-9000
20200528,059237,鴻海凱基9A購10,5.85,5.85,5.85,5.85,+0.05,0.86,3000,2,17550,0,0,0,0,0,0,3000,3000,0,0
20200528,059238,台積電凱基99購11,,,,,0.00,0.00,0,0,0,0,0,0,0,0,0,0,0,0,0
20200528,059239,台積電凱基99購12,2.06,2.06,2.06,2.06,+0.03,1.48,2000,1,4120,0,0,0,0,0,0,2000,0,2000,2000
20200528,05923P,旺宏元富96售05,0.74,0.92,0.74,0.91,+0.09,10.98,210000,21,177350,0,0,0,0,0,0,30000,180000,-150000,-150000
20200528,059240,台積電凱基9A購09,8.05,8.05,7.75,7.75,-0.25,-3.12,45000,2,359250,0,0,0,0,0,0,35000,10000,25000,25000
20200528,059241,旺宏凱基99購07,2.82,2.83,2.73,2.73,-0.14,-4.88,28000,19,78540,0,0,0,0,0,0,28000,4000,24000,24000
20200528,059242,南亞科凱基99購06,1.33,1.39,1.22,1.22,0.00,0.00,266000,19,351260,0,0,0,0,0,0,14000,252000,-238000,-238000
20200528,059243,聯發科凱基99購12,,,,,0.00,0.00,0,0,0,0,0,0,0,0,0,0,0,0,0
20200528,059244,聯發科凱基99購13,,,,,0.00,0.00,0,0,0,0,0,0,0,0,0,0,0,0,0
20200528,059245,聯發科凱基9A購03,,,,,0.00,0.00,0,0,0,0,0,0,0,0,0,0,0,0,0
20200528,059246,奇力新凱基9A購02,1.62,1.62,1.62,1.62,-0.01,-0.61,5000,1,8100,0,0,0,0,0,0,0,5000,-5000,-5000
20200528,059247,可成凱基99購05,,,,,0.00,0.00,0,0,0,0,0,0,0,0,0,0,0,0,0
20200528,059248,華新科凱基99購04,2.25,2.25,2.25,2.25,0.00,0.00,10000,1,22500,0,0,0,0,0,0,10000,0,10000,10000
20200528,059249,大立光凱基99購05,1.73,1.73,1.73,1.73,0.00,0.00,10000,1,17300,0,0,0,0,0,0,0,10000,-10000,-10000
20200528,05924P,超眾元富96售04,,,,,0.00,0.00,0,0,0,0,0,0,0,0,0,0,0,0,0
20200528,059250,大立光凱基99購06,1.52,1.52,1.50,1.51,0.00,0.00,21000,5,31600,0,0,0,0,0,0,16000,5000,11000,11000
20200528,059251,大立光凱基9A購04,,,,,0.00,0.00,0,0,0,0,0,0,0,0,0,0,0,0,0
20200528,059252,聯詠凱基99購03,2.55,2.55,2.55,2.55,-0.01,-0.39,20000,1,51000,0,0,0,0,0,0,20000,0,20000,20000
20200528,059253,康控凱基9B購02,,,,,0.00,0.00,0,0,0,0,0,0,0,0,0,0,0,0,0
20200528,059254,台表科凱基9A購02,,,,,0.00,0.00,0,0,0,0,0,0,0,0,0,0,0,0,0
20200528,059255,臺股指凱基99購33,,,,,0.00,0.00,0,0,0,0,0,0,0,0,0,0,0,0,0
20200528,059256,臺股指凱基99購34,2.81,2.81,2.50,2.56,-0.14,-5.19,64000,9,174620,0,0,0,0,0,0,4000,60000,-56000,-56000
20200528,059257,臺股指凱基99購35,3.85,3.85,3.62,3.69,-0.15,-3.91,403000,4,1551120,0,0,0,0,0,0,401000,2000,399000,399000
20200528,059258,台灣50群益99購01,,,,,0.00,0.00,0,0,0,0,0,0,0,0,0,0,0,0,0
20200528,059259,FBVIX中信03購06,0.85,0.86,0.85,0.86,0.00,0.00,16000,4,13710,0,0,0,0,0,0,5000,11000,-6000,-6000
20200528,05925P,晶技永豐96售03,,,,,0.00,0.00,0,0,0,0,0,0,0,0,0,0,0,0,0
20200528,059260,國巨中信99購05,,,,,0.00,0.00,0,0,0,0,0,0,0,0,0,0,0,0,0
20200528,059261,華邦電中信01購01,0.99,1.10,0.86,0.86,-0.03,-3.37,2054000,84,1973050,0,0,0,0,0,0,1496000,511000,985000,985000
20200528,059262,致茂中信01購01,1.19,1.21,1.18,1.18,-0.01,-0.84,46000,5,54850,0,0,0,0,0,0,35000,26000,9000,9000
20200528,059263,瑞昱中信01購01,1.55,1.56,1.55,1.55,+0.05,3.33,36000,6,55850,0,0,0,0,0,0,16000,20000,-4000,-4000
20200528,059264,台光電中信99購02,1.98,1.98,1.94,1.94,-0.11,-5.37,30000,3,58900,0,0,0,0,0,0,10000,20000,-10000,-10000
20200528,059265,美律中信01購01,1.01,1.02,1.00,1.00,0.00,0.00,13000,3,13140,0,0,0,0,0,0,13000,0,13000,13000
20200528,059266,緯創中信01購01,2.08,2.08,2.03,2.03,-0.01,-0.49,32000,4,66060,0,0,0,0,0,0,20000,12000,8000,8000
20200528,059267,群創中信01購02,,,,,0.00,0.00,0,0,0,0,0,0,0,0,0,0,0,0,0
20200528,059268,鎧勝中信01購01,,,,,0.00,0.00,0,0,0,0,0,0,0,0,0,0,0,0,0
20200528,059269,臺股指中信9B購03,,,,,0.00,0.00,0,0,0,0,0,0,0,0,0,0,0,0,0
20200528,05926P,智易永豐96售02,1.01,1.04,1.01,1.04,0.00,0.00,30000,3,30700,0,0,0,0,0,0,0,30000,-30000,-30000
20200528,059270,台灣50元大01購03,,,,,0.00,0.00,0,0,0,0,0,0,0,0,0,0,0,0,0
20200528,059271,台灣50元大01購05,,,,,0.00,0.00,0,0,0,0,0,0,0,0,0,0,0,0,0
20200528,059272,台灣50元大99購01,3.64,3.64,3.64,3.64,-0.14,-3.7,3000,1,10920,0,0,0,0,0,0,0,3000,-3000,-3000
20200528,059273,臺指反元大9C購03,0.81,0.81,0.81,0.81,0.00,0.00,20000,1,16200,0,0,0,0,0,0,20000,0,20000,20000
20200528,059274,國巨元大99購22,1.52,1.52,1.47,1.47,-0.07,-4.55,22000,5,32920,0,0,0,0,0,0,0,22000,-22000,-22000
20200528,059275,可成元大99購05,4.33,4.33,4.16,4.23,+0.01,0.24,5000,4,21310,0,0,0,0,0,0,5000,2000,3000,3000
20200528,059276,可成元大99購06,3.28,3.28,3.07,3.07,-0.09,-2.85,34000,5,107620,0,0,0,0,0,0,15000,20000,-5000,-5000
20200528,059277,群創元大99購05,0.68,0.68,0.68,0.68,-0.03,-4.23,68000,1,46240,0,0,0,0,0,0,68000,0,68000,68000
20200528,059278,群創元大9A購04,0.79,0.79,0.79,0.79,0.00,0.00,10000,1,7900,0,0,0,0,0,0,10000,0,10000,10000
20200528,059279,台灣50富邦9C購03,,,,,0.00,0.00,0,0,0,0,0,0,0,0,0,0,0,0,0
20200528,05927P,正文永豐96售03,,,,,0.00,0.00,0,0,0,0,0,0,0,0,0,0,0,0,0
20200528,059280,台灣50永豐99購06,,,,,0.00,0.00,0,0,0,0,0,0,0,0,0,0,0,0,0
20200528,059281,創意永豐99購02,1.62,1.74,1.60,1.61,+0.03,1.9,408000,36,669780,0,0,0,0,0,0,197000,208000,-11000,-11000
20200528,059282,嘉聯益永豐99購01,2.02,2.20,2.02,2.18,+0.21,10.66,199000,13,419700,0,0,0,0,0,0,49000,150000,-101000,-101000
20200528,059283,康友永豐99購02,,,,,0.00,0.00,0,0,0,0,0,0,0,0,0,0,0,0,0
20200528,059284,緯穎永豐99購03,3.32,3.32,3.32,3.32,-0.02,-0.6,10000,1,33200,0,0,0,0,0,0,0,10000,-10000,-10000
20200528,059285,台灣50元富01購02,,,,,0.00,0.00,0,0,0,0,0,0,0,0,0,0,0,0,0
20200528,059286,S&P正2元富01購03,1.54,1.54,1.54,1.54,+0.06,4.05,3000,1,4620,0,0,0,0,0,0,3000,0,3000,3000
20200528,059287,華通元富99購03,5.35,5.95,5.35,5.85,+0.65,12.5,138000,11,801750,0,0,0,0,0,0,15000,103000,-88000,-88000
20200528,059288,旺宏元富99購03,3.73,3.78,3.73,3.78,+0.06,1.61,60000,11,224900,0,0,0,0,0,0,60000,0,60000,60000
20200528,059289,瑞昱元富99購01,4.50,4.53,4.42,4.50,+0.17,3.93,132000,10,593340,0,0,0,0,0,0,30000,102000,-72000,-72000
20200528,05928P,華邦電康和96售01,,,,,0.00,0.00,0,0,0,0,0,0,0,0,0,0,0,0,0
20200528,059290,全新元富99購01,1.67,1.74,1.66,1.69,-0.08,-4.52,132000,20,221480,0,0,0,0,0,0,127000,5000,122000,122000
20200528,059291,華新科元富9B購01,2.72,2.72,2.72,2.72,-0.03,-1.09,56000,14,152320,0,0,0,0,0,0,56000,0,56000,56000
20200528,059292,華新科元富9B購02,2.53,2.54,2.52,2.54,0.00,0.00,52000,12,131470,0,0,0,0,0,0,42000,10000,32000,32000
20200528,059293,宏達電元富9B購01,1.62,1.62,1.51,1.61,-0.06,-3.59,125000,6,199420,0,0,0,0,0,0,20000,101000,-81000,-81000
20200528,059294,宏達電元富9B購02,1.70,1.70,1.49,1.49,0.00,0.00,18000,2,28920,0,0,0,0,0,0,0,18000,-18000,-18000
20200528,059295,大立光元富99購05,3.07,3.07,2.74,2.79,-0.19,-6.38,155000,17,459420,0,0,0,0,0,0,100000,55000,45000,45000
20200528,059296,大立光元富99購06,2.65,2.65,2.65,2.65,+0.13,5.16,58000,3,153700,0,0,0,0,0,0,8000,50000,-42000,-42000
20200528,059297,大立光元富9C購01,2.91,2.91,2.66,2.70,-0.06,-2.17,89000,13,253480,0,0,0,0,0,0,28000,61000,-33000,-33000
20200528,059298,大立光元富9C購02,3.47,3.47,3.12,3.14,-0.14,-4.27,303000,16,992390,0,0,0,0,0,0,192000,111000,81000,81000
20200528,059299,欣興元富99購03,4.69,5.10,4.64,4.77,+0.15,3.25,52000,13,249240,0,0,0,0,0,0,34000,18000,16000,16000
20200528,05929P,宏達電康和96售01,1.08,1.08,1.08,1.08,+0.10,10.2,10000,1,10800,0,0,0,0,0,0,0,10000,-10000,-10000
20200528,059300,國巨群益99購08,,,,,0.00,0.00,0,0,0,0,0,0,0,0,0,0,0,0,0
20200528,059301,華新科群益99購04,,,,,0.00,0.00,0,0,0,0,0,0,0,0,0,0,0,0,0
20200528,059302,大立光群益99購08,3.05,3.08,2.89,2.89,-0.23,-7.37,65000,4,198910,0,0,0,0,0,0,63000,2000,61000,61000
20200528,059303,國巨兆豐99購04,4.16,4.22,4.16,4.22,+0.19,4.71,10000,2,41900,0,0,0,0,0,0,10000,0,10000,10000
20200528,059304,華新科兆豐99購06,,,,,0.00,0.00,0,0,0,0,0,0,0,0,0,0,0,0,0
20200528,059305,台灣50元大99購02,,,,,0.00,0.00,0,0,0,0,0,0,0,0,0,0,0,0,0
20200528,059306,台灣50元大99購03,,,,,0.00,0.00,0,0,0,0,0,0,0,0,0,0,0,0,0
20200528,059307,T50反1元大99購06,0.68,0.75,0.67,0.72,0.00,0.00,474000,14,342800,0,0,0,0,0,0,141000,333000,-192000,-192000
20200528,059308,T50反1元大99購07,0.75,0.75,0.75,0.75,-0.01,-1.32,10000,1,7500,0,0,0,0,0,0,0,10000,-10000,-10000
20200528,059309,滬深2X元大99購02,,,,,0.00,0.00,0,0,0,0,0,0,0,0,0,0,0,0,0
20200528,05930P,景碩康和96售01,,,,,0.00,0.00,0,0,0,0,0,0,0,0,0,0,0,0,0
20200528,059310,元石油元大99購03,,,,,0.00,0.00,0,0,0,0,0,0,0,0,0,0,0,0,0
20200528,059311,元石油元大99購04,,,,,0.00,0.00,0,0,0,0,0,0,0,0,0,0,0,0,0
20200528,059312,元石油元大99購05,1.62,1.62,1.59,1.60,-0.09,-5.33,362000,10,585420,0,0,0,0,0,0,245000,117000,128000,128000
20200528,059313,元石油元大99購06,1.77,1.78,1.77,1.77,0.00,0.00,170000,6,301600,0,0,0,0,0,0,100000,70000,30000,30000
20200528,059314,上銀元大99購03,,,,,0.00,0.00,0,0,0,0,0,0,0,0,0,0,0,0,0
20200528,059315,鴻海元大99購30,,,,,0.00,0.00,0,0,0,0,0,0,0,0,0,0,0,0,0
20200528,059316,國巨元大99購23,,,,,0.00,0.00,0,0,0,0,0,0,0,0,0,0,0,0,0
20200528,059317,台積電元大99購34,4.53,4.53,4.47,4.50,+0.06,1.35,28000,4,125970,0,0,0,0,0,0,24000,4000,20000,20000
20200528,059318,旺宏元大99購13,,,,,0.00,0.00,0,0,0,0,0,0,0,0,0,0,0,0,0
20200528,059319,台光電元大99購04,4.78,5.00,4.78,5.00,-0.20,-3.85,12000,3,57670,0,0,0,0,0,0,0,11000,-11000,-11000
20200528,05931P,鴻海凱基96售15,,,,,0.00,0.00,0,0,0,0,0,0,0,0,0,0,0,0,0
20200528,059320,華新科元大99購15,5.70,5.80,5.60,5.60,+0.05,0.9,19000,6,108850,0,0,0,0,0,0,3000,16000,-13000,-13000
20200528,059321,欣興元大99購07,,,,,0.00,0.00,0,0,0,0,0,0,0,0,0,0,0,0,0
20200528,059322,晶技元大99購06,3.19,3.19,3.19,3.19,0.00,0.00,10000,1,31900,0,0,0,0,0,0,0,10000,-10000,-10000
20200528,059323,新日興元大99購02,3.91,3.91,3.91,3.91,0.00,0.00,2000,1,7820,0,0,0,0,0,0,2000,0,2000,2000
20200528,059324,智易元大99購04,5.95,6.35,5.95,6.35,+0.45,7.63,35000,8,215000,0,0,0,0,0,0,10000,25000,-15000,-15000
20200528,059325,超眾元大99購05,,,,,0.00,0.00,0,0,0,0,0,0,0,0,0,0,0,0,0
20200528,059326,康友元大99購01,1.23,1.23,1.23,1.23,-0.08,-6.11,60000,4,73800,0,0,0,0,0,0,0,60000,-60000,-60000
20200528,059327,南茂元大99購01,4.19,4.19,3.85,3.85,-0.36,-8.55,100000,4,406000,0,0,0,0,0,0,60000,40000,20000,20000
20200528,059328,台灣50國票99購08,,,,,0.00,0.00,0,0,0,0,0,0,0,0,0,0,0,0,0
20200528,059329,台灣50國票99購09,,,,,0.00,0.00,0,0,0,0,0,0,0,0,0,0,0,0,0
20200528,05932P,鴻海凱基96售16,,,,,0.00,0.00,0,0,0,0,0,0,0,0,0,0,0,0,0
20200528,059330,台灣50國票99購10,,,,,0.00,0.00,0,0,0,0,0,0,0,0,0,0,0,0,0
20200528,059331,台灣50國票9A購06,,,,,0.00,0.00,0,0,0,0,0,0,0,0,0,0,0,0,0
20200528,059332,台灣50國票9A購07,,,,,0.00,0.00,0,0,0,0,0,0,0,0,0,0,0,0,0
20200528,059333,滬深2X國票9A購03,,,,,0.00,0.00,0,0,0,0,0,0,0,0,0,0,0,0,0
20200528,059334,A50正2國票9A購02,,,,,0.00,0.00,0,0,0,0,0,0,0,0,0,0,0,0,0
20200528,059335,台灣50凱基03購02,,,,,0.00,0.00,0,0,0,0,0,0,0,0,0,0,0,0,0
20200528,059336,台灣50凱基9A購02,,,,,0.00,0.00,0,0,0,0,0,0,0,0,0,0,0,0,0
20200528,059337,台灣50凱基9C購05,,,,,0.00,0.00,0,0,0,0,0,0,0,0,0,0,0,0,0
20200528,059338,滬深2X凱基9C購02,,,,,0.00,0.00,0,0,0,0,0,0,0,0,0,0,0,0,0
20200528,059339,上銀凱基99購06,5.55,5.60,5.55,5.60,-0.20,-3.45,10000,10,55550,0,0,0,0,0,0,10000,0,10000,10000
20200528,05933P,鴻海凱基97售03,,,,,0.00,0.00,0,0,0,0,0,0,0,0,0,0,0,0,0
20200528,059340,鴻海凱基9A購12,1.82,1.83,1.82,1.83,+0.05,2.81,20000,2,36500,0,0,0,0,0,0,20000,0,20000,20000
20200528,059341,台積電凱基99購15,2.90,2.90,2.71,2.73,-0.10,-3.53,73000,9,198600,0,0,0,0,0,0,2000,71000,-69000,-69000
20200528,059342,聯發科凱基9A購05,,,,,0.00,0.00,0,0,0,0,0,0,0,0,0,0,0,0,0
20200528,059343,宏達電凱基99購04,1.48,1.48,1.31,1.31,-0.17,-11.49,153000,6,212710,0,0,0,0,0,0,10000,147000,-137000,-137000
20200528,059344,長榮航凱基99購01,1.94,1.94,1.78,1.78,-0.11,-5.82,90000,6,170800,0,0,0,0,0,0,70000,20000,50000,50000
20200528,059345,禾伸堂凱基99購03,2.84,2.84,2.84,2.84,0.00,0.00,10000,1,28400,0,0,0,0,0,0,10000,0,10000,10000
20200528,059346,新日興凱基99購03,2.30,2.43,2.30,2.42,+0.21,9.5,55000,5,131250,0,0,0,0,0,0,0,55000,-55000,-55000
20200528,059347,京鼎凱基99購02,,,,,0.00,0.00,0,0,0,0,0,0,0,0,0,0,0,0,0
20200528,059348,日月光凱基99購01,2.64,2.64,2.64,2.64,+0.03,1.15,45000,1,118800,0,0,0,0,0,0,45000,0,45000,45000
20200528,059349,台郡凱基99購04,1.50,1.53,1.46,1.46,-0.05,-3.31,40000,7,60090,0,0,0,0,0,0,20000,20000,0,0
20200528,05934P,國巨凱基96售13,,,,,0.00,0.00,0,0,0,0,0,0,0,0,0,0,0,0,0
20200528,059350,樺漢凱基9A購01,1.38,1.44,1.38,1.41,+0.02,1.44,255000,22,362170,0,0,0,0,0,0,21000,227000,-206000,-206000
20200528,059351,台虹凱基99購01,2.69,2.69,2.50,2.50,-0.15,-5.66,893000,36,2362240,0,0,0,0,0,0,599000,393000,206000,206000
20200528,059352,台灣50富邦01購01,,,,,0.00,0.00,0,0,0,0,0,0,0,0,0,0,0,0,0
20200528,059353,滬深2X富邦9A購02,,,,,0.00,0.00,0,0,0,0,0,0,0,0,0,0,0,0,0
20200528,059354,臺指反富邦9B購01,0.25,0.27,0.25,0.27,+0.01,3.85,115000,2,28850,0,0,0,0,0,0,115000,0,115000,115000
20200528,059355,國巨富邦9B購03,1.41,1.42,1.39,1.39,-0.01,-0.71,211000,20,298020,0,0,0,0,0,0,211000,0,211000,211000
20200528,059356,滬深2X永豐99購02,,,,,0.00,0.00,0,0,0,0,0,0,0,0,0,0,0,0,0
20200528,059357,華通永豐99購01,3.55,3.73,3.55,3.73,0.00,0.00,26000,3,95180,0,0,0,0,0,0,0,26000,-26000,-26000
20200528,059358,旺宏永豐99購02,2.07,2.13,1.92,1.92,-0.23,-10.7,331000,26,691920,0,0,0,0,0,0,276000,55000,221000,221000
20200528,059359,精元永豐99購01,1.70,1.92,1.64,1.83,+0.25,15.82,1578000,62,2781480,0,0,0,0,0,0,711000,799000,-88000,-88000
20200528,05935P,台積電凱基96售19,4.61,4.61,4.61,4.61,0.00,0.00,12000,2,55320,0,0,0,0,0,0,0,12000,-12000,-12000
20200528,059360,全新永豐99購02,2.30,2.37,2.26,2.37,-0.05,-2.07,183000,16,420320,0,0,0,0,0,0,172000,11000,161000,161000
20200528,059361,玉晶光永豐99購04,,,,,0.00,0.00,0,0,0,0,0,0,0,0,0,0,0,0,0
20200528,059362,健策永豐99購03,,,,,0.00,0.00,0,0,0,0,0,0,0,0,0,0,0,0,0
20200528,059363,超眾永豐99購02,1.95,1.99,1.92,1.96,-0.23,-10.5,113000,7,222150,0,0,0,0,0,0,57000,56000,1000,1000
20200528,059364,昇陽半永豐99購02,1.75,1.76,1.75,1.76,+0.05,2.92,55000,5,96750,0,0,0,0,0,0,0,55000,-55000,-55000
20200528,059365,T50反1台新99購01,,,,,0.00,0.00,0,0,0,0,0,0,0,0,0,0,0,0,0
20200528,059366,台積電台新99購04,,,,,0.00,0.00,0,0,0,0,0,0,0,0,0,0,0,0,0
20200528,059367,台灣50元富01購03,,,,,0.00,0.00,0,0,0,0,0,0,0,0,0,0,0,0,0
20200528,059368,T50正2元富99購02,,,,,0.00,0.00,0,0,0,0,0,0,0,0,0,0,0,0,0
20200528,059369,滬深2X元富9C購01,2.91,2.95,2.91,2.95,-0.02,-0.67,2000,2,5860,0,0,0,0,0,0,1000,1000,0,0
20200528,05936P,台積電凱基96售20,,,,,0.00,0.00,0,0,0,0,0,0,0,0,0,0,0,0,0
20200528,059370,玉晶光元富99購02,1.68,1.76,1.63,1.64,+0.06,3.8,526000,55,884580,0,0,0,0,0,0,262000,256000,6000,6000
20200528,059371,聯鈞元富99購02,,,,,0.00,0.00,0,0,0,0,0,0,0,0,0,0,0,0,0
20200528,059372,台灣50群益99購02,,,,,0.00,0.00,0,0,0,0,0,0,0,0,0,0,0,0,0
20200528,059373,滬深2X群益01購03,,,,,0.00,0.00,0,0,0,0,0,0,0,0,0,0,0,0,0
20200528,059374,A50正2群益01購01,,,,,0.00,0.00,0,0,0,0,0,0,0,0,0,0,0,0,0
20200528,059375,道瓊反群益9C購02,0.31,0.32,0.30,0.31,-0.03,-8.82,221000,17,68190,0,0,0,0,0,0,63000,129000,-66000,-66000
20200528,059376,國巨群益99購09,,,,,0.00,0.00,0,0,0,0,0,0,0,0,0,0,0,0,0
20200528,059377,台積電群益99購09,2.31,2.31,2.23,2.23,-0.04,-1.76,22000,6,50160,0,0,0,0,0,0,10000,12000,-2000,-2000
20200528,059378,台光電群益9B購01,,,,,0.00,0.00,0,0,0,0,0,0,0,0,0,0,0,0,0
20200528,059379,聯電亞東99購02,,,,,0.00,0.00,0,0,0,0,0,0,0,0,0,0,0,0,0
20200528,05937P,台積電凱基96售21,,,,,0.00,0.00,0,0,0,0,0,0,0,0,0,0,0,0,0
20200528,059380,鴻海亞東99購01,,,,,0.00,0.00,0,0,0,0,0,0,0,0,0,0,0,0,0
20200528,059381,TPK亞東99購01,2.32,2.32,2.32,2.32,+0.03,1.31,20000,1,46400,0,0,0,0,0,0,20000,0,20000,20000
20200528,059382,台灣50凱基99購02,,,,,0.00,0.00,0,0,0,0,0,0,0,0,0,0,0,0,0
20200528,059383,台灣50凱基99購03,,,,,0.00,0.00,0,0,0,0,0,0,0,0,0,0,0,0,0
20200528,059384,上証2X凱基9B購01,,,,,0.00,0.00,0,0,0,0,0,0,0,0,0,0,0,0,0
20200528,059385,滬深2X凱基9C購03,,,,,0.00,0.00,0,0,0,0,0,0,0,0,0,0,0,0,0
20200528,059386,上銀凱基99購07,3.83,3.83,3.81,3.81,-0.13,-3.3,42000,12,160840,0,0,0,0,0,0,42000,0,42000,42000
20200528,059387,華通凱基9A購03,2.37,2.37,2.37,2.37,0.00,0.00,10000,1,23700,0,0,0,0,0,0,0,10000,-10000,-10000
20200528,059388,國巨凱基99購13,,,,,0.00,0.00,0,0,0,0,0,0,0,0,0,0,0,0,0
20200528,059389,國巨凱基99購14,,,,,0.00,0.00,0,0,0,0,0,0,0,0,0,0,0,0,0
20200528,05938P,旺宏凱基96售07,,,,,0.00,0.00,0,0,0,0,0,0,0,0,0,0,0,0,0
20200528,059390,華新科凱基99購05,,,,,0.00,0.00,0,0,0,0,0,0,0,0,0,0,0,0,0
20200528,059391,立積凱基9A購01,,,,,0.00,0.00,0,0,0,0,0,0,0,0,0,0,0,0,0
20200528,059392,臺股指凱基99購38,,,,,0.00,0.00,0,0,0,0,0,0,0,0,0,0,0,0,0
20200528,059393,臺股指凱基99購39,,,,,0.00,0.00,0,0,0,0,0,0,0,0,0,0,0,0,0
20200528,059394,臺股指凱基99購40,,,,,0.00,0.00,0,0,0,0,0,0,0,0,0,0,0,0,0
20200528,059395,T50反1元富99購03,0.34,0.37,0.34,0.37,+0.01,2.78,216000,8,75370,0,0,0,0,0,0,186000,30000,156000,156000
20200528,059396,T50反1元富99購04,0.20,0.22,0.20,0.22,+0.01,4.76,25000,3,5150,0,0,0,0,0,0,5000,20000,-15000,-15000
20200528,059397,T50反1元富99購05,0.54,0.58,0.54,0.58,+0.02,3.57,206000,11,111780,0,0,0,0,0,0,0,206000,-206000,-206000
20200528,059398,滬深2X元富9C購02,3.44,3.44,3.20,3.20,0.00,0.00,2000,2,6640,0,0,0,0,0,0,1000,1000,0,0
20200528,059399,滬深2X元富9C購03,,,,,0.00,0.00,0,0,0,0,0,0,0,0,0,0,0,0,0
20200528,05939P,聯發科凱基96售20,,,,,0.00,0.00,0,0,0,0,0,0,0,0,0,0,0,0,0
20200528,059400,滬深2X元富9C購04,4.22,4.25,4.22,4.25,+0.11,2.66,15000,2,63600,0,0,0,0,0,0,5000,10000,-5000,-5000
20200528,059401,牧德元富99購01,,,,,0.00,0.00,0,0,0,0,0,0,0,0,0,0,0,0,0
20200528,059402,台灣50台新99購01,,,,,0.00,0.00,0,0,0,0,0,0,0,0,0,0,0,0,0
20200528,059403,T50反1台新03購03,0.43,0.45,0.43,0.44,+0.03,7.32,231000,7,103380,0,0,0,0,0,0,130000,101000,29000,29000
20200528,059404,鴻海台新99購03,,,,,0.00,0.00,0,0,0,0,0,0,0,0,0,0,0,0,0
20200528,059405,台灣50國票01購01,,,,,0.00,0.00,0,0,0,0,0,0,0,0,0,0,0,0,0
20200528,059406,台灣50國票9A購08,,,,,0.00,0.00,0,0,0,0,0,0,0,0,0,0,0,0,0
20200528,059407,台灣50國票9B購01,,,,,0.00,0.00,0,0,0,0,0,0,0,0,0,0,0,0,0
20200528,059408,台灣50國票9B購02,,,,,0.00,0.00,0,0,0,0,0,0,0,0,0,0,0,0,0
20200528,059409,台灣50國票9C購01,,,,,0.00,0.00,0,0,0,0,0,0,0,0,0,0,0,0,0
20200528,05940P,聯發科凱基96售21,,,,,0.00,0.00,0,0,0,0,0,0,0,0,0,0,0,0,0
20200528,059410,滬深2X國票9A購04,,,,,0.00,0.00,0,0,0,0,0,0,0,0,0,0,0,0,0
20200528,059411,臺股指國票99購17,,,,,0.00,0.00,0,0,0,0,0,0,0,0,0,0,0,0,0
20200528,059412,臺股指國票99購18,,,,,0.00,0.00,0,0,0,0,0,0,0,0,0,0,0,0,0
20200528,059413,台灣50元大99購05,,,,,0.00,0.00,0,0,0,0,0,0,0,0,0,0,0,0,0
20200528,059414,台灣50元大9A購02,,,,,0.00,0.00,0,0,0,0,0,0,0,0,0,0,0,0,0
20200528,059415,台灣50元大9A購03,4.79,4.79,4.62,4.62,-0.06,-1.28,4000,3,18990,0,0,0,0,0,0,3000,1000,2000,2000
20200528,059416,T50反1元大99購08,,,,,0.00,0.00,0,0,0,0,0,0,0,0,0,0,0,0,0
20200528,059417,上証反元大9C購01,,,,,0.00,0.00,0,0,0,0,0,0,0,0,0,0,0,0,0
20200528,059418,上証反元大9C購02,,,,,0.00,0.00,0,0,0,0,0,0,0,0,0,0,0,0,0
20200528,059419,滬深2X元大99購03,,,,,0.00,0.00,0,0,0,0,0,0,0,0,0,0,0,0,0
20200528,05941P,聯發科凱基96售22,,,,,0.00,0.00,0,0,0,0,0,0,0,0,0,0,0,0,0
20200528,059420,滬深2X元大99購04,,,,,0.00,0.00,0,0,0,0,0,0,0,0,0,0,0,0,0
20200528,059421,滬深2X元大99購05,,,,,0.00,0.00,0,0,0,0,0,0,0,0,0,0,0,0,0
20200528,059422,滬深2X元大99購06,,,,,0.00,0.00,0,0,0,0,0,0,0,0,0,0,0,0,0
20200528,059423,滬深2X元大9A購01,,,,,0.00,0.00,0,0,0,0,0,0,0,0,0,0,0,0,0
20200528,059424,SGBR2X元大9A購01,1.51,1.54,1.50,1.52,-0.05,-3.18,300000,20,454070,0,0,0,0,0,0,126000,174000,-48000,-48000
20200528,059425,SGBR2X元大9A購02,1.53,1.57,1.53,1.56,-0.12,-7.14,540000,30,838680,0,0,0,0,0,0,214000,316000,-102000,-102000
20200528,059426,鴻海元大99購31,4.62,4.64,4.48,4.48,-0.05,-1.1,47000,12,216140,0,0,0,0,0,0,44000,9000,35000,35000
20200528,059427,國巨元大99購24,,,,,0.00,0.00,0,0,0,0,0,0,0,0,0,0,0,0,0
20200528,059428,國巨元大99購25,,,,,0.00,0.00,0,0,0,0,0,0,0,0,0,0,0,0,0
20200528,059429,台積電元大99購35,,,,,0.00,0.00,0,0,0,0,0,0,0,0,0,0,0,0,0
20200528,05942P,奇力新凱基96售04,,,,,0.00,0.00,0,0,0,0,0,0,0,0,0,0,0,0,0
20200528,059430,台積電元大99購36,,,,,0.00,0.00,0,0,0,0,0,0,0,0,0,0,0,0,0
20200528,059431,旺宏元大99購14,,,,,0.00,0.00,0,0,0,0,0,0,0,0,0,0,0,0,0
20200528,059432,聯發科元大99購26,,,,,0.00,0.00,0,0,0,0,0,0,0,0,0,0,0,0,0
20200528,059433,聯發科元大99購27,,,,,0.00,0.00,0,0,0,0,0,0,0,0,0,0,0,0,0
20200528,059434,全新元大99購05,4.96,4.97,4.89,4.94,-0.16,-3.14,172000,19,845660,0,0,0,0,0,0,172000,0,172000,172000
20200528,059435,大立光元大99購17,4.35,4.35,4.10,4.10,-0.29,-6.61,21000,3,89650,0,0,0,0,0,0,21000,0,21000,21000
20200528,059436,大立光元大99購18,4.22,4.23,3.95,3.95,-0.35,-8.14,19000,4,79910,0,0,0,0,0,0,18000,1000,17000,17000
20200528,059437,京鼎元大99購02,,,,,0.00,0.00,0,0,0,0,0,0,0,0,0,0,0,0,0
20200528,059438,群創元大99購06,1.14,1.14,1.14,1.14,-0.04,-3.39,5000,1,5700,0,0,0,0,0,0,5000,0,5000,5000
20200528,059439,健策元大9B購01,,,,,0.00,0.00,0,0,0,0,0,0,0,0,0,0,0,0,0
20200528,05943P,欣興凱基96售03,1.55,1.55,1.55,1.55,-0.15,-8.82,1000,1,1550,0,0,0,0,0,0,0,1000,-1000,-1000
20200528,059440,康控元大9B購01,2.69,2.69,2.69,2.69,0.00,0.00,10000,1,26900,0,0,0,0,0,0,10000,10000,0,0
20200528,059441,祥碩元大99購02,,,,,0.00,0.00,0,0,0,0,0,0,0,0,0,0,0,0,0
20200528,059442,祥碩元大99購03,,,,,0.00,0.00,0,0,0,0,0,0,0,0,0,0,0,0,0
20200528,059443,嘉聯益元大9B購01,5.70,6.00,5.70,5.75,+0.10,1.77,54000,9,316150,0,0,0,0,0,0,4000,54000,-50000,-50000
20200528,059444,臺股指元大99購25,,,,,0.00,0.00,0,0,0,0,0,0,0,0,0,0,0,0,0
20200528,059445,臺股指元大99購26,,,,,0.00,0.00,0,0,0,0,0,0,0,0,0,0,0,0,0
20200528,059446,臺股指元大99購27,,,,,0.00,0.00,0,0,0,0,0,0,0,0,0,0,0,0,0
20200528,059447,臺股指元大99購28,,,,,0.00,0.00,0,0,0,0,0,0,0,0,0,0,0,0,0
20200528,059448,上証2X永豐99購01,,,,,0.00,0.00,0,0,0,0,0,0,0,0,0,0,0,0,0
20200528,059449,滬深2X永豐99購03,,,,,0.00,0.00,0,0,0,0,0,0,0,0,0,0,0,0,0
20200528,05944P,富邦金中信96售01,,,,,0.00,0.00,0,0,0,0,0,0,0,0,0,0,0,0,0
20200528,059450,和大永豐99購01,1.60,1.63,1.51,1.51,-0.03,-1.95,28000,3,45010,0,0,0,0,0,0,2000,26000,-24000,-24000
20200528,059451,國巨永豐99購05,,,,,0.00,0.00,0,0,0,0,0,0,0,0,0,0,0,0,0
20200528,059452,全新永豐99購03,1.76,1.82,1.73,1.80,-0.01,-0.55,266000,22,472390,0,0,0,0,0,0,241000,25000,216000,216000
20200528,059453,奇力新永豐99購01,,,,,0.00,0.00,0,0,0,0,0,0,0,0,0,0,0,0,0
20200528,059454,亞光永豐99購01,1.89,1.94,1.78,1.78,-0.09,-4.81,118000,9,223530,0,0,0,0,0,0,56000,62000,-6000,-6000
20200528,059455,玉晶光永豐99購05,3.36,3.41,3.36,3.41,+0.22,6.9,6000,3,20300,0,0,0,0,0,0,0,6000,-6000,-6000
20200528,059456,智易永豐99購01,4.06,4.28,4.00,4.00,+0.03,0.76,81000,14,335270,0,0,0,0,0,0,25000,56000,-31000,-31000
20200528,059457,立積永豐99購02,,,,,0.00,0.00,0,0,0,0,0,0,0,0,0,0,0,0,0
20200528,059458,鎧勝永豐99購01,,,,,0.00,0.00,0,0,0,0,0,0,0,0,0,0,0,0,0
20200528,059459,訊芯永豐99購04,2.29,2.36,2.12,2.12,-0.12,-5.36,242000,11,548950,0,0,0,0,0,0,111000,131000,-20000,-20000
20200528,05945P,聯詠中信96售01,0.15,0.15,0.15,0.15,0.00,0.00,8000,1,1200,0,0,0,0,0,0,8000,8000,0,0
20200528,059460,GIS永豐99購02,,,,,0.00,0.00,0,0,0,0,0,0,0,0,0,0,0,0,0
20200528,059461,鈺齊永豐99購03,1.68,1.82,1.64,1.66,+0.11,7.1,487000,51,839310,0,0,0,0,0,0,222000,247000,-25000,-25000
20200528,059462,台灣50元大9C購06,,,,,0.00,0.00,0,0,0,0,0,0,0,0,0,0,0,0,0
20200528,059463,台灣50元大9C購07,,,,,0.00,0.00,0,0,0,0,0,0,0,0,0,0,0,0,0
20200528,059464,台灣50元大9C購08,,,,,0.00,0.00,0,0,0,0,0,0,0,0,0,0,0,0,0
20200528,059465,台灣50元大9C購09,,,,,0.00,0.00,0,0,0,0,0,0,0,0,0,0,0,0,0
20200528,059466,國巨元大99購26,,,,,0.00,0.00,0,0,0,0,0,0,0,0,0,0,0,0,0
20200528,059467,旺宏元大99購15,6.75,6.75,6.75,6.75,0.00,0.00,4000,1,27000,0,0,0,0,0,0,4000,4000,0,0
20200528,059468,智邦元大99購02,3.98,4.02,3.80,3.80,+0.26,7.34,5000,4,19400,0,0,0,0,0,0,5000,5000,0,0
20200528,059469,智邦元大99購03,4.43,4.91,4.20,4.22,+0.18,4.46,80000,18,364880,0,0,0,0,0,0,44000,51000,-7000,-7000
20200528,05946P,和碩中信96售01,,,,,0.00,0.00,0,0,0,0,0,0,0,0,0,0,0,0,0
20200528,059470,華新科元大99購16,,,,,0.00,0.00,0,0,0,0,0,0,0,0,0,0,0,0,0
20200528,059471,華新科元大99購17,5.40,5.40,5.40,5.40,+0.15,2.86,10000,1,54000,0,0,0,0,0,0,10000,0,10000,10000
20200528,059472,T50正2群益99購01,,,,,0.00,0.00,0,0,0,0,0,0,0,0,0,0,0,0,0
20200528,059473,T50反1群益99購03,0.57,0.57,0.57,0.57,0.00,0.00,50000,1,28500,0,0,0,0,0,0,50000,0,50000,50000
20200528,059474,元石油群益99購01,2.14,2.18,2.14,2.18,-0.16,-6.84,10000,3,21680,0,0,0,0,0,0,3000,0,3000,3000
20200528,059475,元石油群益99購02,1.57,1.57,1.47,1.50,-0.15,-9.09,38000,7,57590,0,0,0,0,0,0,3000,13000,-10000,-10000
20200528,059476,道瓊指群益9C購01,1.14,1.14,1.12,1.12,+0.05,4.67,15000,2,17000,0,0,0,0,0,0,15000,0,15000,15000
20200528,059477,FBVIX群益99購01,,,,,0.00,0.00,0,0,0,0,0,0,0,0,0,0,0,0,0
20200528,059478,FBVIX群益9A購01,,,,,0.00,0.00,0,0,0,0,0,0,0,0,0,0,0,0,0
20200528,059479,國巨群益99購10,,,,,0.00,0.00,0,0,0,0,0,0,0,0,0,0,0,0,0
20200528,05947P,大成鋼元大96售03,,,,,0.00,0.00,0,0,0,0,0,0,0,0,0,0,0,0,0
20200528,059480,美律群益9A購01,1.09,1.11,1.07,1.07,+0.03,2.88,26000,3,28260,0,0,0,0,0,0,21000,5000,16000,16000
20200528,059481,華新科群益99購05,,,,,0.00,0.00,0,0,0,0,0,0,0,0,0,0,0,0,0
20200528,059482,貿聯群益99購05,,,,,0.00,0.00,0,0,0,0,0,0,0,0,0,0,0,0,0
20200528,059483,臺股指群益99購17,,,,,0.00,0.00,0,0,0,0,0,0,0,0,0,0,0,0,0
20200528,059484,臺股指群益99購18,,,,,0.00,0.00,0,0,0,0,0,0,0,0,0,0,0,0,0
20200528,059485,台灣50兆豐99購02,,,,,0.00,0.00,0,0,0,0,0,0,0,0,0,0,0,0,0
20200528,059486,A50正2兆豐9A購01,,,,,0.00,0.00,0,0,0,0,0,0,0,0,0,0,0,0,0
20200528,059487,聯發科兆豐99購03,,,,,0.00,0.00,0,0,0,0,0,0,0,0,0,0,0,0,0
20200528,059488,大立光兆豐99購03,2.11,2.11,2.11,2.11,+0.05,2.43,7000,1,14770,0,0,0,0,0,0,0,7000,-7000,-7000
20200528,059489,上証2X國票9A購01,3.08,3.08,3.08,3.08,0.00,0.00,5000,1,15400,0,0,0,0,0,0,0,5000,-5000,-5000
20200528,05948P,茂林元大96售03,,,,,0.00,0.00,0,0,0,0,0,0,0,0,0,0,0,0,0
20200528,059490,國巨國票99購09,7.50,7.50,7.30,7.30,-0.20,-2.67,2000,2,14800,0,0,0,0,0,0,1000,0,1000,1000
20200528,059491,國巨國票9A購05,,,,,0.00,0.00,0,0,0,0,0,0,0,0,0,0,0,0,0
20200528,059492,國巨國票9A購06,,,,,0.00,0.00,0,0,0,0,0,0,0,0,0,0,0,0,0
20200528,059493,國巨國票9B購01,10.80,10.80,10.40,10.40,-0.30,-2.8,8000,4,84100,0,0,0,0,0,0,3000,7000,-4000,-4000
20200528,059494,國巨國票9C購01,,,,,0.00,0.00,0,0,0,0,0,0,0,0,0,0,0,0,0
20200528,059495,台灣50元富9C購02,,,,,0.00,0.00,0,0,0,0,0,0,0,0,0,0,0,0,0
20200528,059496,T50正2元富99購03,,,,,0.00,0.00,0,0,0,0,0,0,0,0,0,0,0,0,0
20200528,059497,滬深2X元富9C購05,,,,,0.00,0.00,0,0,0,0,0,0,0,0,0,0,0,0,0
20200528,059498,滬深2X元富9C購06,,,,,0.00,0.00,0,0,0,0,0,0,0,0,0,0,0,0,0
20200528,059499,滬深2X元富9C購07,,,,,0.00,0.00,0,0,0,0,0,0,0,0,0,0,0,0,0
20200528,05949P,台積電國票96售09,,,,,0.00,0.00,0,0,0,0,0,0,0,0,0,0,0,0,0
20200528,059500,鴻海元富99購11,2.64,2.65,2.56,2.56,-0.03,-1.16,134000,5,350380,0,0,0,0,0,0,85000,49000,36000,36000
20200528,059501,可成元富99購01,1.72,1.72,1.65,1.65,-0.01,-0.6,38000,4,64270,0,0,0,0,0,0,19000,19000,0,0
20200528,059502,台灣50台新9B購04,,,,,0.00,0.00,0,0,0,0,0,0,0,0,0,0,0,0,0
20200528,059503,大立光富邦9B購04,0.76,0.76,0.71,0.73,-0.01,-1.35,1172000,37,853320,0,0,0,0,0,0,50000,1097000,-1047000,-1047000
20200528,059504,台灣50永豐99購08,,,,,0.00,0.00,0,0,0,0,0,0,0,0,0,0,0,0,0
20200528,059505,上証2X永豐99購02,,,,,0.00,0.00,0,0,0,0,0,0,0,0,0,0,0,0,0
20200528,059506,滬深2X永豐99購04,,,,,0.00,0.00,0,0,0,0,0,0,0,0,0,0,0,0,0
20200528,059507,鴻海永豐99購03,1.39,1.39,1.38,1.38,0.00,0.00,40000,3,55400,0,0,0,0,0,0,20000,20000,0,0
20200528,059508,聯發科永豐99購03,,,,,0.00,0.00,0,0,0,0,0,0,0,0,0,0,0,0,0
20200528,059509,奇力新永豐99購02,2.76,2.76,2.61,2.61,-0.16,-5.78,37000,2,98070,0,0,0,0,0,0,27000,10000,17000,17000
20200528,05950P,台積電國票97售04,6.45,6.55,6.45,6.55,0.00,0.00,4000,2,26000,0,0,0,0,0,0,0,4000,-4000,-4000
20200528,059510,華新科永豐99購07,1.67,1.68,1.66,1.67,-0.03,-1.76,190000,10,318530,0,0,0,0,0,0,181000,9000,172000,172000
20200528,059511,宏達電永豐99購02,0.94,0.94,0.94,0.94,-0.11,-10.48,4000,1,3760,0,0,0,0,0,0,4000,4000,0,0
20200528,059512,晶豪科永豐99購02,,,,,0.00,0.00,0,0,0,0,0,0,0,0,0,0,0,0,0
20200528,059513,揚明光永豐99購01,2.20,2.21,1.99,2.01,-0.17,-7.8,120000,8,254400,0,0,0,0,0,0,120000,43000,77000,77000
20200528,059514,嘉澤永豐99購02,,,,,0.00,0.00,0,0,0,0,0,0,0,0,0,0,0,0,0
20200528,059515,牧德永豐99購01,2.73,2.73,2.73,2.73,-0.12,-4.21,1000,1,2730,0,0,0,0,0,0,0,1000,-1000,-1000
20200528,059516,TPK永豐99購01,1.87,2.01,1.78,1.78,-0.09,-4.81,536000,22,1010340,0,0,0,0,0,0,436000,83000,353000,353000
20200528,059517,茂林永豐99購02,,,,,0.00,0.00,0,0,0,0,0,0,0,0,0,0,0,0,0
20200528,059518,康控永豐99購01,,,,,0.00,0.00,0,0,0,0,0,0,0,0,0,0,0,0,0
20200528,059519,台郡永豐99購01,1.58,1.60,1.57,1.60,-0.01,-0.62,378000,18,600630,0,0,0,0,0,0,206000,172000,34000,34000
20200528,05951P,台積電國票97售05,7.00,7.00,7.00,7.00,0.00,0.00,13000,1,91000,0,0,0,0,0,0,0,13000,-13000,-13000
20200528,059520,台表科永豐99購02,,,,,0.00,0.00,0,0,0,0,0,0,0,0,0,0,0,0,0
20200528,059521,南電永豐99購03,1.84,1.84,1.84,1.84,-0.03,-1.6,35000,2,64400,0,0,0,0,0,0,25000,10000,15000,15000
20200528,059522,上証2X凱基9B購02,,,,,0.00,0.00,0,0,0,0,0,0,0,0,0,0,0,0,0
20200528,059523,滬深2X凱基9C購04,,,,,0.00,0.00,0,0,0,0,0,0,0,0,0,0,0,0,0
20200528,059524,FBVIX凱基9A購02,0.88,0.90,0.88,0.90,0.00,0.00,40000,2,35400,0,0,0,0,0,0,10000,30000,-20000,-20000
20200528,059525,上銀凱基99購08,4.23,4.33,4.23,4.33,-0.06,-1.37,34000,12,144660,0,0,0,0,0,0,34000,0,34000,34000
20200528,059526,鴻海凱基99購12,,,,,0.00,0.00,0,0,0,0,0,0,0,0,0,0,0,0,0
20200528,059527,聯發科凱基99購16,,,,,0.00,0.00,0,0,0,0,0,0,0,0,0,0,0,0,0
20200528,059528,華新科凱基99購06,1.65,1.65,1.65,1.65,-0.04,-2.37,10000,1,16500,0,0,0,0,0,0,10000,0,10000,10000
20200528,059529,華新科凱基9A購04,,,,,0.00,0.00,0,0,0,0,0,0,0,0,0,0,0,0,0
20200528,05952P,台積電國票97售06,,,,,0.00,0.00,0,0,0,0,0,0,0,0,0,0,0,0,0
20200528,059530,華新科凱基9A購05,1.72,1.72,1.72,1.72,-0.07,-3.91,10000,1,17200,0,0,0,0,0,0,0,10000,-10000,-10000
20200528,059531,華新科凱基9B購02,1.95,1.95,1.95,1.95,-0.02,-1.02,4000,1,7800,0,0,0,0,0,0,4000,4000,0,0
20200528,059532,華新科凱基9B購03,2.73,2.74,2.63,2.63,-0.12,-4.36,30000,3,80400,0,0,0,0,0,0,20000,10000,10000,10000
20200528,059533,富邦金凱基99購01,2.03,2.03,2.03,2.03,+0.02,1.0,22000,1,44660,0,0,0,0,0,0,22000,0,22000,22000
20200528,059534,國泰金凱基99購01,2.10,2.10,2.02,2.02,-0.07,-3.35,40000,4,83250,0,0,0,0,0,0,25000,15000,10000,10000
20200528,059535,玉山金凱基99購01,2.64,2.64,2.64,2.64,-0.01,-0.38,10000,1,26400,0,0,0,0,0,0,10000,0,10000,10000
20200528,059536,新光金凱基99購05,1.51,1.51,1.44,1.44,-0.09,-5.88,93000,2,134620,0,0,0,0,0,0,10000,83000,-73000,-73000
20200528,059537,大立光凱基99購09,1.87,1.87,1.79,1.80,-0.03,-1.64,165000,7,302100,0,0,0,0,0,0,158000,7000,151000,151000
20200528,059538,健策凱基99購03,3.98,4.01,3.96,3.99,-0.05,-1.24,58000,23,230970,0,0,0,0,0,0,58000,0,58000,58000
20200528,059539,緯穎凱基99購03,,,,,0.00,0.00,0,0,0,0,0,0,0,0,0,0,0,0,0
20200528,05953P,台積電國票98售02,,,,,0.00,0.00,0,0,0,0,0,0,0,0,0,0,0,0,0
20200528,059540,新光金日盛99購01,1.04,1.04,0.91,0.97,0.00,0.00,236000,7,236420,0,0,0,0,0,0,15000,218000,-203000,-203000
20200528,059541,T50正2康和99購01,3.88,3.88,3.88,3.88,+0.08,2.11,10000,1,38800,0,0,0,0,0,0,10000,0,10000,10000
20200528,059542,聯發科亞東99購01,,,,,0.00,0.00,0,0,0,0,0,0,0,0,0,0,0,0,0
20200528,059543,可成亞東99購02,2.16,2.18,2.11,2.18,0.00,0.00,201000,3,429180,0,0,0,0,0,0,200000,1000,199000,199000
20200528,059544,創意亞東99購01,3.59,3.72,3.59,3.72,+0.29,8.45,12000,2,44380,0,0,0,0,0,0,2000,10000,-8000,-8000
20200528,059545,台灣50群益99購04,,,,,0.00,0.00,0,0,0,0,0,0,0,0,0,0,0,0,0
20200528,059546,FBVIX群益99購03,,,,,0.00,0.00,0,0,0,0,0,0,0,0,0,0,0,0,0
20200528,059547,國巨群益99購11,,,,,0.00,0.00,0,0,0,0,0,0,0,0,0,0,0,0,0
20200528,059548,台積電群益99購10,,,,,0.00,0.00,0,0,0,0,0,0,0,0,0,0,0,0,0
20200528,059549,台光電群益99購04,,,,,0.00,0.00,0,0,0,0,0,0,0,0,0,0,0,0,0
20200528,05954P,旺宏國票97售03,2.70,2.89,2.70,2.88,+0.08,2.86,65000,7,186440,0,0,0,0,0,0,43000,22000,21000,21000
20200528,059550,台灣50日盛99購02,8.15,8.15,8.15,8.15,0.00,0.00,24000,1,195600,0,0,0,0,0,0,0,24000,-24000,-24000
20200528,059551,T50正2康和99購02,,,,,0.00,0.00,0,0,0,0,0,0,0,0,0,0,0,0,0
20200528,059552,台灣50凱基99購04,,,,,0.00,0.00,0,0,0,0,0,0,0,0,0,0,0,0,0
20200528,059553,台灣50凱基99購05,,,,,0.00,0.00,0,0,0,0,0,0,0,0,0,0,0,0,0
20200528,059554,台灣50凱基99購08,,,,,0.00,0.00,0,0,0,0,0,0,0,0,0,0,0,0,0
20200528,059555,台灣50凱基9A購06,1.81,1.81,1.81,1.81,+0.01,0.56,1000,1,1810,0,0,0,0,0,0,0,1000,-1000,-1000
20200528,059556,台灣50凱基9A購07,,,,,0.00,0.00,0,0,0,0,0,0,0,0,0,0,0,0,0
20200528,059557,台灣50凱基9C購07,,,,,0.00,0.00,0,0,0,0,0,0,0,0,0,0,0,0,0
20200528,059558,T50正2凱基9C購03,7.70,7.70,7.70,7.70,0.00,0.00,32000,1,246400,0,0,0,0,0,0,32000,0,32000,32000
20200528,059559,T50反1凱基99購07,0.21,0.21,0.21,0.21,+0.01,5.0,1000,1,210,0,0,0,0,0,0,0,1000,-1000,-1000
20200528,05955P,台光電國票97售02,,,,,0.00,0.00,0,0,0,0,0,0,0,0,0,0,0,0,0
20200528,059560,T50反1凱基99購08,0.16,0.18,0.16,0.17,-0.01,-5.56,464000,21,77740,0,0,0,0,0,0,60000,228000,-168000,-168000
20200528,059561,滬深2X凱基9C購05,,,,,0.00,0.00,0,0,0,0,0,0,0,0,0,0,0,0,0
20200528,059562,上銀凱基99購09,3.99,4.08,3.99,4.08,-0.05,-1.21,22000,9,88210,0,0,0,0,0,0,22000,0,22000,22000
20200528,059563,鴻海凱基9A購14,1.32,1.32,1.30,1.30,-0.01,-0.76,7000,5,9220,0,0,0,0,0,0,7000,7000,0,0
20200528,059564,鴻海凱基9A購15,1.39,1.39,1.37,1.37,-0.01,-0.72,7000,5,9710,0,0,0,0,0,0,7000,7000,0,0
20200528,059565,國巨凱基99購16,,,,,0.00,0.00,0,0,0,0,0,0,0,0,0,0,0,0,0
20200528,059566,台積電凱基9A購11,1.60,1.60,1.60,1.60,0.00,0.00,40000,1,64000,0,0,0,0,0,0,40000,0,40000,40000
20200528,059567,台積電凱基9A購12,,,,,0.00,0.00,0,0,0,0,0,0,0,0,0,0,0,0,0
20200528,059568,台積電凱基9A購13,1.78,1.78,1.72,1.72,-0.04,-2.27,30000,5,51690,0,0,0,0,0,0,30000,3000,27000,27000
20200528,059569,旺宏凱基99購09,2.59,2.59,2.57,2.59,+0.02,0.78,10000,8,25820,0,0,0,0,0,0,10000,0,10000,10000
20200528,05956P,漢唐國票96售02,,,,,0.00,0.00,0,0,0,0,0,0,0,0,0,0,0,0,0
20200528,059570,全新凱基99購04,1.95,1.99,1.95,1.99,-0.07,-3.4,249000,15,493450,0,0,0,0,0,0,242000,0,242000,242000
20200528,059571,奇力新凱基99購06,2.05,2.07,1.91,1.91,-0.11,-5.45,11000,5,21820,0,0,0,0,0,0,0,11000,-11000,-11000
20200528,059572,華新科凱基99購08,2.04,2.04,2.04,2.04,-0.02,-0.97,10000,1,20400,0,0,0,0,0,0,10000,0,10000,10000
20200528,059573,健策凱基9A購02,4.37,4.43,4.35,4.43,+0.03,0.68,68000,14,297860,0,0,0,0,0,0,68000,0,68000,68000
20200528,059574,台表科凱基99購02,,,,,0.00,0.00,0,0,0,0,0,0,0,0,0,0,0,0,0
20200528,059575,臺股指凱基99購41,,,,,0.00,0.00,0,0,0,0,0,0,0,0,0,0,0,0,0
20200528,059576,臺股指凱基99購42,,,,,0.00,0.00,0,0,0,0,0,0,0,0,0,0,0,0,0
20200528,059577,旺宏元富99購04,,,,,0.00,0.00,0,0,0,0,0,0,0,0,0,0,0,0,0
20200528,059578,智邦元富99購02,5.90,5.90,5.90,5.90,0.00,0.00,2000,1,11800,0,0,0,0,0,0,2000,0,2000,2000
20200528,059579,聯發科元富99購06,,,,,0.00,0.00,0,0,0,0,0,0,0,0,0,0,0,0,0
20200528,05957P,友達國票97售04,,,,,0.00,0.00,0,0,0,0,0,0,0,0,0,0,0,0,0
20200528,059580,大立光元富99購07,3.13,3.13,2.81,2.81,-0.36,-11.36,53000,8,164860,0,0,0,0,0,0,47000,6000,41000,41000
20200528,059581,日月光元富99購02,1.97,1.98,1.91,1.91,+0.04,2.14,181000,10,353160,0,0,0,0,0,0,110000,71000,39000,39000
20200528,059582,台灣50台新99購03,,,,,0.00,0.00,0,0,0,0,0,0,0,0,0,0,0,0,0
20200528,059583,台灣50元大01購10,,,,,0.00,0.00,0,0,0,0,0,0,0,0,0,0,0,0,0
20200528,059584,台灣50元大01購11,,,,,0.00,0.00,0,0,0,0,0,0,0,0,0,0,0,0,0
20200528,059585,台灣50元大9C購10,,,,,0.00,0.00,0,0,0,0,0,0,0,0,0,0,0,0,0
20200528,059586,上銀元大9A購02,,,,,0.00,0.00,0,0,0,0,0,0,0,0,0,0,0,0,0
20200528,059587,華通元大9A購01,,,,,0.00,0.00,0,0,0,0,0,0,0,0,0,0,0,0,0
20200528,059588,鴻海元大99購32,4.22,4.22,4.22,4.22,+0.11,2.68,10000,1,42200,0,0,0,0,0,0,0,10000,-10000,-10000
20200528,059589,國巨元大9A購02,,,,,0.00,0.00,0,0,0,0,0,0,0,0,0,0,0,0,0
20200528,05958P,聯發科國票97售04,2.30,2.43,2.30,2.35,+0.04,1.73,14000,8,33370,0,0,0,0,0,0,3000,11000,-8000,-8000
20200528,059590,台積電元大99購39,,,,,0.00,0.00,0,0,0,0,0,0,0,0,0,0,0,0,0
20200528,059591,台積電元大9A購04,,,,,0.00,0.00,0,0,0,0,0,0,0,0,0,0,0,0,0
20200528,059592,聯發科元大99購28,,,,,0.00,0.00,0,0,0,0,0,0,0,0,0,0,0,0,0
20200528,059593,聯發科元大99購29,,,,,0.00,0.00,0,0,0,0,0,0,0,0,0,0,0,0,0
20200528,059594,奇力新元大9B購01,4.53,4.53,4.53,4.53,-0.19,-4.03,4000,2,18120,0,0,0,0,0,0,0,4000,-4000,-4000
20200528,059595,華新科元大9A購03,5.40,5.40,5.40,5.40,+0.15,2.86,20000,2,108000,0,0,0,0,0,0,10000,10000,0,0
20200528,059596,大立光元大99購20,6.35,6.35,6.35,6.35,0.00,0.00,5000,1,31750,0,0,0,0,0,0,5000,0,5000,5000
20200528,059597,大立光元大99購21,,,,,0.00,0.00,0,0,0,0,0,0,0,0,0,0,0,0,0
20200528,059598,欣興元大99購08,6.70,7.00,6.65,6.65,0.00,0.00,32000,6,218650,0,0,0,0,0,0,2000,32000,-30000,-30000
20200528,059599,健策元大9B購02,,,,,0.00,0.00,0,0,0,0,0,0,0,0,0,0,0,0,0
20200528,05959P,聯發科國票98售01,,,,,0.00,0.00,0,0,0,0,0,0,0,0,0,0,0,0,0
20200528,059600,緯穎元大99購07,,,,,0.00,0.00,0,0,0,0,0,0,0,0,0,0,0,0,0
20200528,059601,臺股指元大9A購38,,,,,0.00,0.00,0,0,0,0,0,0,0,0,0,0,0,0,0
20200528,059602,臺股指元大9A購39,,,,,0.00,0.00,0,0,0,0,0,0,0,0,0,0,0,0,0
20200528,059603,臺股指元大9A購40,,,,,0.00,0.00,0,0,0,0,0,0,0,0,0,0,0,0,0
20200528,059604,臺股指元大9A購41,,,,,0.00,0.00,0,0,0,0,0,0,0,0,0,0,0,0,0
20200528,059605,臺股指元大9A購42,5.75,5.75,5.75,5.75,0.00,0.00,1000,1,5750,0,0,0,0,0,0,0,1000,-1000,-1000
20200528,059606,上銀富邦9B購02,,,,,0.00,0.00,0,0,0,0,0,0,0,0,0,0,0,0,0
20200528,059607,台積電富邦9C購04,1.86,1.86,1.78,1.78,-0.02,-1.11,67000,6,122500,0,0,0,0,0,0,15000,52000,-37000,-37000
20200528,059608,聯發科富邦9B購04,,,,,0.00,0.00,0,0,0,0,0,0,0,0,0,0,0,0,0
20200528,059609,A50正2永豐99購01,,,,,0.00,0.00,0,0,0,0,0,0,0,0,0,0,0,0,0
20200528,05960P,欣興統一96售01,1.01,1.01,1.01,1.01,0.00,0.00,3000,1,3030,0,0,0,0,0,0,0,3000,-3000,-3000
20200528,059610,上銀永豐99購02,,,,,0.00,0.00,0,0,0,0,0,0,0,0,0,0,0,0,0
20200528,059611,台積電永豐99購05,1.76,1.76,1.68,1.68,-0.06,-3.45,50000,4,86700,0,0,0,0,0,0,30000,20000,10000,10000
20200528,059612,奇鋐永豐99購02,2.10,2.28,2.10,2.27,+0.27,13.5,145000,12,323800,0,0,0,0,0,0,0,145000,-145000,-145000
20200528,059613,泰鼎永豐99購02,1.64,1.70,1.58,1.58,-0.03,-1.86,99000,15,164510,0,0,0,0,0,0,87000,12000,75000,75000
20200528,059614,致新永豐99購01,3.31,3.58,3.31,3.45,+0.10,2.99,23000,5,78240,0,0,0,0,0,0,21000,2000,19000,19000
20200528,059615,台灣50群益99購05,,,,,0.00,0.00,0,0,0,0,0,0,0,0,0,0,0,0,0
20200528,059616,滬深2X群益01購04,4.09,4.09,4.09,4.09,-0.07,-1.68,6000,1,24540,0,0,0,0,0,0,0,6000,-6000,-6000
20200528,059617,A50正2群益01購02,,,,,0.00,0.00,0,0,0,0,0,0,0,0,0,0,0,0,0
20200528,059618,台積電日盛99購01,2.76,2.78,2.55,2.55,-0.17,-6.25,411000,29,1097870,0,0,0,0,0,0,138000,372000,-234000,-234000
20200528,059619,台積電日盛9A購04,3.34,3.34,3.24,3.24,-0.24,-6.9,51000,2,165340,0,0,0,0,0,0,51000,50000,1000,1000
20200528,05961P,鴻海群益97售01,,,,,0.00,0.00,0,0,0,0,0,0,0,0,0,0,0,0,0
20200528,059620,聯發科日盛99購02,,,,,0.00,0.00,0,0,0,0,0,0,0,0,0,0,0,0,0
20200528,059621,T50正2凱基9C購04,,,,,0.00,0.00,0,0,0,0,0,0,0,0,0,0,0,0,0
20200528,059622,上銀凱基99購10,2.94,2.94,2.94,2.94,-0.05,-1.67,21000,5,61740,0,0,0,0,0,0,21000,0,21000,21000
20200528,059623,聯電凱基99購02,1.09,1.09,1.06,1.09,+0.03,2.83,858000,11,935090,0,0,0,0,0,0,21000,837000,-816000,-816000
20200528,059624,鴻海凱基01購01,1.17,1.17,1.16,1.16,-0.01,-0.85,7000,4,8180,0,0,0,0,0,0,7000,7000,0,0
20200528,059625,國巨凱基99購17,,,,,0.00,0.00,0,0,0,0,0,0,0,0,0,0,0,0,0
20200528,059626,台積電凱基01購01,1.37,1.37,1.37,1.37,-0.04,-2.84,3000,2,4110,0,0,0,0,0,0,3000,3000,0,0
20200528,059627,旺宏凱基99購10,,,,,0.00,0.00,0,0,0,0,0,0,0,0,0,0,0,0,0
20200528,059628,智邦凱基99購04,2.45,2.53,2.34,2.34,0.00,0.00,19000,5,46710,0,0,0,0,0,0,2000,17000,-15000,-15000
20200528,059629,友達凱基99購06,1.05,1.08,1.02,1.02,-0.07,-6.42,173000,4,179850,0,0,0,0,0,0,33000,140000,-107000,-107000
20200528,05962P,大立光群益96售07,,,,,0.00,0.00,0,0,0,0,0,0,0,0,0,0,0,0,0
20200528,059630,美律凱基99購07,1.17,1.17,1.16,1.16,+0.04,3.57,2000,2,2330,0,0,0,0,0,0,0,2000,-2000,-2000
20200528,059631,京元電凱基99購02,0.79,0.79,0.76,0.76,-0.02,-2.56,270000,7,209700,0,0,0,0,0,0,0,270000,-270000,-270000
20200528,059632,聯發科凱基01購01,2.35,2.35,2.23,2.23,-0.08,-3.46,79000,14,179730,0,0,0,0,0,0,0,77000,-77000,-77000
20200528,059633,聯發科凱基9A購07,,,,,0.00,0.00,0,0,0,0,0,0,0,0,0,0,0,0,0
20200528,059634,可成凱基99購07,1.24,1.24,1.24,1.24,0.00,0.00,20000,1,24800,0,0,0,0,0,0,20000,0,20000,20000
20200528,059635,華新科凱基9A購06,1.67,1.67,1.61,1.61,-0.05,-3.01,28000,7,46430,0,0,0,0,0,0,20000,8000,12000,12000
20200528,059636,宏達電凱基99購05,0.70,0.70,0.66,0.66,-0.08,-10.81,18000,3,12120,0,0,0,0,0,0,8000,18000,-10000,-10000
20200528,059637,大立光凱基01購01,0.88,0.89,0.84,0.84,-0.02,-2.33,26000,5,22780,0,0,0,0,0,0,20000,6000,14000,14000
20200528,059638,大立光凱基99購11,1.81,1.82,1.81,1.82,-0.05,-2.67,67000,2,121840,0,0,0,0,0,0,67000,0,67000,67000
20200528,059639,大立光凱基9A購06,1.11,1.11,1.08,1.08,-0.02,-1.82,120000,6,130900,0,0,0,0,0,0,0,120000,-120000,-120000
20200528,05963P,貿聯國票97售02,,,,,0.00,0.00,0,0,0,0,0,0,0,0,0,0,0,0,0
20200528,059640,聯詠凱基99購04,1.74,1.74,1.73,1.73,+0.01,0.58,101000,2,175450,0,0,0,0,0,0,0,101000,-101000,-101000
20200528,059641,群創凱基99購06,1.18,1.18,1.17,1.17,-0.01,-0.85,82000,2,96340,0,0,0,0,0,0,42000,40000,2000,2000
20200528,059642,健策凱基99購04,3.63,3.70,3.63,3.70,+0.20,5.71,81000,12,297000,0,0,0,0,0,0,81000,0,81000,81000
20200528,059643,日月光凱基99購02,1.39,1.39,1.34,1.34,-0.01,-0.74,120000,6,165610,0,0,0,0,0,0,84000,36000,48000,48000
20200528,059644,茂林凱基99購03,3.30,3.30,3.21,3.21,-0.65,-16.84,58000,13,188720,0,0,0,0,0,0,58000,0,58000,58000
20200528,059645,祥碩凱基99購05,3.49,3.55,3.49,3.55,+0.13,3.8,12000,2,42000,0,0,0,0,0,0,2000,10000,-8000,-8000
20200528,059646,聯茂凱基99購06,0.94,0.99,0.94,0.97,+0.04,4.3,96000,6,91090,0,0,0,0,0,0,0,96000,-96000,-96000
20200528,059647,超眾凱基99購04,1.03,1.05,1.03,1.05,0.00,0.00,200000,2,208000,0,0,0,0,0,0,0,200000,-200000,-200000
20200528,059648,台表科凱基99購03,,,,,0.00,0.00,0,0,0,0,0,0,0,0,0,0,0,0,0
20200528,059649,矽力凱基99購02,3.68,3.96,3.68,3.89,+0.24,6.58,27000,4,103350,0,0,0,0,0,0,10000,17000,-7000,-7000
20200528,05964P,華通凱基96售06,,,,,0.00,0.00,0,0,0,0,0,0,0,0,0,0,0,0,0
20200528,059650,緯穎凱基99購04,1.99,1.99,1.99,1.99,0.00,0.00,10000,1,19900,0,0,0,0,0,0,0,10000,-10000,-10000
20200528,059651,台灣50元大99購06,,,,,0.00,0.00,0,0,0,0,0,0,0,0,0,0,0,0,0
20200528,059652,台灣50元大99購07,,,,,0.00,0.00,0,0,0,0,0,0,0,0,0,0,0,0,0
20200528,059653,台灣50元大99購08,,,,,0.00,0.00,0,0,0,0,0,0,0,0,0,0,0,0,0
20200528,059654,T50反1元大99購09,,,,,0.00,0.00,0,0,0,0,0,0,0,0,0,0,0,0,0
20200528,059655,T50反1元大99購10,,,,,0.00,0.00,0,0,0,0,0,0,0,0,0,0,0,0,0
20200528,059656,T50反1元大99購11,0.39,0.42,0.38,0.42,+0.02,5.0,262000,9,103270,0,0,0,0,0,0,154000,98000,56000,56000
20200528,059657,華通元大99購09,14.40,14.40,14.40,14.40,+0.60,4.35,4000,1,57600,0,0,0,0,0,0,4000,4000,0,0
20200528,059658,國巨元大9A購03,,,,,0.00,0.00,0,0,0,0,0,0,0,0,0,0,0,0,0
20200528,059659,旺宏元大9A購03,,,,,0.00,0.00,0,0,0,0,0,0,0,0,0,0,0,0,0
20200528,05965P,健策凱基96售05,,,,,0.00,0.00,0,0,0,0,0,0,0,0,0,0,0,0,0
20200528,059660,華新科元大9A購04,3.20,3.20,3.20,3.20,-0.06,-1.84,36000,2,115200,0,0,0,0,0,0,36000,0,36000,36000
20200528,059661,大立光元大99購22,4.41,4.41,4.41,4.41,0.00,0.00,20000,1,88200,0,0,0,0,0,0,0,20000,-20000,-20000
20200528,059662,旭富元大9C購01,6.80,6.80,6.80,6.80,+0.10,1.49,31000,2,210800,0,0,0,0,0,0,29000,31000,-2000,-2000
20200528,059663,旭富元大9C購02,4.27,4.27,4.08,4.08,-0.04,-0.97,35000,2,143750,0,0,0,0,0,0,0,35000,-35000,-35000
20200528,059664,立積元大9C購01,5.90,5.90,5.90,5.90,+0.05,0.85,2000,1,11800,0,0,0,0,0,0,0,2000,-2000,-2000
20200528,059665,嘉聯益元大99購06,4.18,4.48,4.18,4.33,+0.21,5.1,103000,18,450220,0,0,0,0,0,0,5000,103000,-98000,-98000
20200528,059666,台表科元大9B購01,,,,,0.00,0.00,0,0,0,0,0,0,0,0,0,0,0,0,0
20200528,059667,矽力元大99購01,,,,,0.00,0.00,0,0,0,0,0,0,0,0,0,0,0,0,0
20200528,059668,台灣50元富9B購04,,,,,0.00,0.00,0,0,0,0,0,0,0,0,0,0,0,0,0
20200528,059669,台灣50元富9B購05,3.63,3.63,3.63,3.63,-0.13,-3.46,10000,1,36300,0,0,0,0,0,0,0,10000,-10000,-10000
20200528,05966P,矽力凱基96售03,,,,,0.00,0.00,0,0,0,0,0,0,0,0,0,0,0,0,0
20200528,059670,T50正2元富99購04,,,,,0.00,0.00,0,0,0,0,0,0,0,0,0,0,0,0,0
20200528,059671,滬深2X元富99購05,3.72,3.91,3.62,3.70,-0.04,-1.07,127000,13,469240,0,0,0,0,0,0,50000,77000,-27000,-27000
20200528,059672,滬深2X元富99購06,2.92,2.93,2.67,2.67,0.00,0.00,14000,8,38610,0,0,0,0,0,0,2000,12000,-10000,-10000
20200528,059673,玉山金元富99購01,5.75,5.75,5.75,5.75,-0.10,-1.71,5000,2,28750,0,0,0,0,0,0,5000,0,5000,5000
20200528,059674,玉山金元富99購02,,,,,0.00,0.00,0,0,0,0,0,0,0,0,0,0,0,0,0
20200528,059675,大立光元富99購08,3.62,3.62,3.29,3.33,-0.10,-2.92,65000,8,220820,0,0,0,0,0,0,7000,58000,-51000,-51000
20200528,059676,台積電台新99購05,1.61,1.61,1.54,1.54,0.00,0.00,21000,3,33060,0,0,0,0,0,0,0,21000,-21000,-21000
20200528,059677,大立光台新99購01,,,,,0.00,0.00,0,0,0,0,0,0,0,0,0,0,0,0,0
20200528,059678,鴻海國泰9A購03,1.93,1.93,1.93,1.93,0.00,0.00,158000,2,304940,0,0,0,0,0,0,158000,0,158000,158000
20200528,059679,國巨國泰9B購03,,,,,0.00,0.00,0,0,0,0,0,0,0,0,0,0,0,0,0
20200528,05967P,臺股指麥證96售02,,,,,0.00,0.00,0,0,0,0,0,0,0,0,0,0,0,0,0
20200528,059680,台積電國泰9A購03,2.86,2.86,2.63,2.65,-0.13,-4.68,668000,62,1838440,0,0,0,0,0,0,332000,324000,8000,8000
20200528,059681,華新科國泰9B購02,2.86,2.86,2.83,2.83,-0.11,-3.74,2000,2,5690,0,0,0,0,0,0,0,2000,-2000,-2000
20200528,059682,可成富邦9A購01,,,,,0.00,0.00,0,0,0,0,0,0,0,0,0,0,0,0,0
20200528,059683,康控富邦9C購01,1.09,1.09,1.09,1.09,-0.09,-7.63,6000,1,6540,0,0,0,0,0,0,6000,0,6000,6000
20200528,059684,台灣50永豐99購09,,,,,0.00,0.00,0,0,0,0,0,0,0,0,0,0,0,0,0
20200528,059685,T50正2永豐99購02,2.77,2.77,2.61,2.61,-0.11,-4.04,18000,4,49380,0,0,0,0,0,0,14000,0,14000,14000
20200528,059686,上証2X永豐9A購01,,,,,0.00,0.00,0,0,0,0,0,0,0,0,0,0,0,0,0
20200528,059687,卜蜂永豐99購01,2.12,2.12,2.12,2.12,-0.04,-1.85,65000,1,137800,0,0,0,0,0,0,65000,0,65000,65000
20200528,059688,燿華永豐99購01,1.96,1.96,1.88,1.88,-0.06,-3.09,40000,6,77350,0,0,0,0,0,0,10000,30000,-20000,-20000
20200528,059689,南亞科永豐99購02,1.76,1.82,1.67,1.67,+0.02,1.21,173000,18,299560,0,0,0,0,0,0,100000,73000,27000,27000
20200528,05968P,鴻海台新96售02,,,,,0.00,0.00,0,0,0,0,0,0,0,0,0,0,0,0,0
20200528,059690,建準永豐99購01,,,,,0.00,0.00,0,0,0,0,0,0,0,0,0,0,0,0,0
20200528,059691,大立光永豐99購02,1.25,1.25,1.16,1.18,-0.03,-2.48,50000,5,60100,0,0,0,0,0,0,20000,30000,-10000,-10000
20200528,059692,聯詠永豐99購01,1.91,1.91,1.90,1.90,-0.08,-4.04,22000,2,41900,0,0,0,0,0,0,12000,10000,2000,2000
20200528,059693,智原永豐99購01,2.08,2.09,2.04,2.04,+0.02,0.99,101000,15,208790,0,0,0,0,0,0,81000,15000,66000,66000
20200528,059694,創意永豐99購03,2.50,2.56,2.50,2.56,+0.06,2.4,83000,12,210860,0,0,0,0,0,0,33000,47000,-14000,-14000
20200528,059695,聯鈞永豐99購02,1.37,1.42,1.34,1.34,-0.05,-3.6,430000,22,598540,0,0,0,0,0,0,230000,200000,30000,30000
20200528,059696,立積永豐99購03,1.53,1.54,1.50,1.51,-0.02,-1.31,159000,16,242340,0,0,0,0,0,0,142000,17000,125000,125000
20200528,059697,上証2X凱基9A購03,,,,,0.00,0.00,0,0,0,0,0,0,0,0,0,0,0,0,0
20200528,059698,滬深2X凱基9A購02,,,,,0.00,0.00,0,0,0,0,0,0,0,0,0,0,0,0,0
20200528,059699,華通凱基99購04,3.23,3.24,3.23,3.24,0.00,0.00,16000,2,51740,0,0,0,0,0,0,0,16000,-16000,-16000
20200528,05969P,台積電台新96售04,,,,,0.00,0.00,0,0,0,0,0,0,0,0,0,0,0,0,0
20200528,059700,鴻海凱基9A購16,1.19,1.19,1.17,1.18,0.00,0.00,5000,3,5900,0,0,0,0,0,0,3000,5000,-2000,-2000
20200528,059701,國巨凱基9A購09,,,,,0.00,0.00,0,0,0,0,0,0,0,0,0,0,0,0,0
20200528,059702,台積電凱基9A購14,1.04,1.04,1.03,1.03,-0.04,-3.74,10000,4,10330,0,0,0,0,0,0,3000,10000,-7000,-7000
20200528,059703,旺宏凱基99購11,,,,,0.00,0.00,0,0,0,0,0,0,0,0,0,0,0,0,0
20200528,059704,聯發科凱基9A購08,2.23,2.23,2.23,2.23,0.00,0.00,1000,1,2230,0,0,0,0,0,0,0,0,0,0
20200528,059705,華新科凱基9A購07,1.90,1.90,1.82,1.82,-0.06,-3.19,15000,5,27980,0,0,0,0,0,0,12000,3000,9000,9000
20200528,059706,嘉晶凱基99購01,,,,,0.00,0.00,0,0,0,0,0,0,0,0,0,0,0,0,0
20200528,059707,健策凱基9A購03,3.97,4.00,3.69,3.69,-0.30,-7.52,78000,25,306700,0,0,0,0,0,0,70000,3000,67000,67000
20200528,059708,立積凱基9A購02,,,,,0.00,0.00,0,0,0,0,0,0,0,0,0,0,0,0,0
20200528,059709,上証2X元大9C購01,1.97,1.97,1.92,1.93,0.00,0.00,9000,3,17540,0,0,0,0,0,0,1000,8000,-7000,-7000
20200528,05970P,超眾永豐96售03,,,,,0.00,0.00,0,0,0,0,0,0,0,0,0,0,0,0,0
20200528,059710,上証2X元大9C購02,,,,,0.00,0.00,0,0,0,0,0,0,0,0,0,0,0,0,0
20200528,059711,滬深2X元大9C購02,,,,,0.00,0.00,0,0,0,0,0,0,0,0,0,0,0,0,0
20200528,059712,滬深2X元大9C購03,,,,,0.00,0.00,0,0,0,0,0,0,0,0,0,0,0,0,0
20200528,059713,滬深2X元大9C購04,1.66,1.67,1.59,1.59,-0.02,-1.24,75000,5,120770,0,0,0,0,0,0,0,75000,-75000,-75000
20200528,059714,A50正2元大9C購01,,,,,0.00,0.00,0,0,0,0,0,0,0,0,0,0,0,0,0
20200528,059715,A50正2元大9C購02,,,,,0.00,0.00,0,0,0,0,0,0,0,0,0,0,0,0,0
20200528,059716,鴻海元大99購35,4.70,4.73,4.70,4.73,+0.10,2.16,5000,5,23530,0,0,0,0,0,0,5000,5000,0,0
20200528,059717,國巨元大99購21,9.15,9.15,8.75,8.75,-0.20,-2.23,4000,4,35700,0,0,0,0,0,0,4000,4000,0,0
20200528,059718,國巨元大9A購04,,,,,0.00,0.00,0,0,0,0,0,0,0,0,0,0,0,0,0
20200528,059719,台積電元大99購42,5.45,5.45,5.45,5.45,-0.25,-4.39,10000,2,54500,0,0,0,0,0,0,0,10000,-10000,-10000
20200528,05971P,世紀鋼永豐96售04,,,,,0.00,0.00,0,0,0,0,0,0,0,0,0,0,0,0,0
20200528,059720,台積電元大99購43,5.35,5.35,5.35,5.35,+0.05,0.94,18000,1,96300,0,0,0,0,0,0,0,18000,-18000,-18000
20200528,059721,旺宏元大99購16,9.45,9.45,8.80,8.80,-0.65,-6.88,78000,8,716100,0,0,0,0,0,0,48000,65000,-17000,-17000
20200528,059722,南亞科元大99購02,6.50,6.80,6.45,6.45,+0.05,0.78,54000,14,360500,0,0,0,0,0,0,43000,2000,41000,41000
20200528,059723,美律元大9A購02,2.53,2.53,2.52,2.52,+0.10,4.13,77000,6,194160,0,0,0,0,0,0,54000,77000,-23000,-23000
20200528,059724,聯發科元大99購30,,,,,0.00,0.00,0,0,0,0,0,0,0,0,0,0,0,0,0
20200528,059725,聯發科元大99購31,,,,,0.00,0.00,0,0,0,0,0,0,0,0,0,0,0,0,0
20200528,059726,華新科元大99購18,,,,,0.00,0.00,0,0,0,0,0,0,0,0,0,0,0,0,0
20200528,059727,大立光元大9A購01,4.87,4.87,4.52,4.52,-0.25,-5.24,20000,4,93800,0,0,0,0,0,0,19000,1000,18000,18000
20200528,059728,聯鈞元大99購01,4.61,4.65,4.41,4.41,-0.09,-2.0,88000,9,398840,0,0,0,0,0,0,57000,31000,26000,26000
20200528,059729,群創元大9C購05,1.85,1.86,1.75,1.75,-0.08,-4.37,190000,13,342250,0,0,0,0,0,0,70000,120000,-50000,-50000
20200528,05972P,瑞昱元大96售01,,,,,0.00,0.00,0,0,0,0,0,0,0,0,0,0,0,0,0
20200528,059730,晶相光元大9C購02,2.01,2.01,1.95,1.95,-0.05,-2.5,174000,9,345810,0,0,0,0,0,0,159000,15000,144000,144000
20200528,059731,康控元大99購04,3.92,3.92,3.92,3.92,-0.06,-1.51,4000,1,15680,0,0,0,0,0,0,4000,4000,0,0
20200528,059732,超眾元大9A購01,3.64,3.77,3.52,3.77,-0.02,-0.53,92000,10,341540,0,0,0,0,0,0,42000,66000,-24000,-24000
20200528,059733,緯穎元大99購08,7.90,7.90,7.90,7.90,-0.65,-7.6,2000,1,15800,0,0,0,0,0,0,2000,0,2000,2000
20200528,059734,T50正2元富99購05,,,,,0.00,0.00,0,0,0,0,0,0,0,0,0,0,0,0,0
20200528,059735,T50反1元富99購06,0.40,0.43,0.40,0.43,0.00,0.00,40000,2,16600,0,0,0,0,0,0,20000,20000,0,0
20200528,059736,T50反1元富99購07,,,,,0.00,0.00,0,0,0,0,0,0,0,0,0,0,0,0,0
20200528,059737,T50反1元富99購08,,,,,0.00,0.00,0,0,0,0,0,0,0,0,0,0,0,0,0
20200528,059738,上証2X元富99購01,,,,,0.00,0.00,0,0,0,0,0,0,0,0,0,0,0,0,0
20200528,059739,華通元富99購04,,,,,0.00,0.00,0,0,0,0,0,0,0,0,0,0,0,0,0
20200528,05973P,聯詠元大96售06,,,,,0.00,0.00,0,0,0,0,0,0,0,0,0,0,0,0,0
20200528,059740,瑞昱元富99購02,5.40,5.45,5.35,5.45,+0.15,2.83,35000,5,188050,0,0,0,0,0,0,22000,13000,9000,9000
20200528,059741,聯發科元富99購07,,,,,0.00,0.00,0,0,0,0,0,0,0,0,0,0,0,0,0
20200528,059742,富邦金元富99購01,3.93,3.93,3.70,3.70,-0.26,-6.57,70000,9,267800,0,0,0,0,0,0,10000,60000,-50000,-50000
20200528,059743,開發金元富99購01,1.99,2.00,1.92,1.94,-0.06,-3.0,80000,9,156900,0,0,0,0,0,0,20000,60000,-40000,-40000
20200528,059744,禾伸堂元富99購02,,,,,0.00,0.00,0,0,0,0,0,0,0,0,0,0,0,0,0
20200528,059745,欣興元富99購04,6.15,6.20,6.15,6.20,0.00,0.00,41000,2,252200,0,0,0,0,0,0,41000,1000,40000,40000
20200528,059746,聯鈞元富99購03,,,,,0.00,0.00,0,0,0,0,0,0,0,0,0,0,0,0,0
20200528,059747,台達電台新99購01,2.01,2.01,1.90,1.90,-0.13,-6.4,36000,7,70370,0,0,0,0,0,0,9000,27000,-18000,-18000
20200528,059748,聯發科台新99購03,,,,,0.00,0.00,0,0,0,0,0,0,0,0,0,0,0,0,0
20200528,059749,台灣50群益9A購04,,,,,0.00,0.00,0,0,0,0,0,0,0,0,0,0,0,0,0
20200528,05974P,國巨富邦97售03,0.52,0.63,0.52,0.63,0.00,0.00,31000,2,16230,0,0,0,0,0,0,30000,31000,-1000,-1000
20200528,059750,台灣50群益9A購05,,,,,0.00,0.00,0,0,0,0,0,0,0,0,0,0,0,0,0
20200528,059751,華通群益9B購03,,,,,0.00,0.00,0,0,0,0,0,0,0,0,0,0,0,0,0
20200528,059752,國巨群益9B購01,,,,,0.00,0.00,0,0,0,0,0,0,0,0,0,0,0,0,0
20200528,059753,貿聯群益99購06,,,,,0.00,0.00,0,0,0,0,0,0,0,0,0,0,0,0,0
20200528,059754,訊芯群益9A購01,,,,,0.00,0.00,0,0,0,0,0,0,0,0,0,0,0,0,0
20200528,059755,宏達電國泰9A購01,2.17,2.17,2.05,2.05,-0.12,-5.53,25000,2,53890,0,0,0,0,0,0,22000,25000,-3000,-3000
20200528,059756,奇力新富邦9C購01,2.73,2.73,2.62,2.62,-0.14,-5.07,13000,3,35080,0,0,0,0,0,0,8000,5000,3000,3000
20200528,059757,上証2X永豐99購03,,,,,0.00,0.00,0,0,0,0,0,0,0,0,0,0,0,0,0
20200528,059758,滬深2X永豐99購05,,,,,0.00,0.00,0,0,0,0,0,0,0,0,0,0,0,0,0
20200528,059759,A50正2永豐99購02,,,,,0.00,0.00,0,0,0,0,0,0,0,0,0,0,0,0,0
20200528,05975P,國巨日盛99售02,,,,,0.00,0.00,0,0,0,0,0,0,0,0,0,0,0,0,0
20200528,059760,楠梓電永豐99購01,,,,,0.00,0.00,0,0,0,0,0,0,0,0,0,0,0,0,0
20200528,059761,國巨永豐99購06,,,,,0.00,0.00,0,0,0,0,0,0,0,0,0,0,0,0,0
20200528,059762,禾伸堂永豐99購02,2.17,2.19,2.14,2.14,-0.06,-2.73,100000,8,217400,0,0,0,0,0,0,40000,60000,-20000,-20000
20200528,059763,華擎永豐99購03,,,,,0.00,0.00,0,0,0,0,0,0,0,0,0,0,0,0,0
20200528,059764,健策永豐99購04,,,,,0.00,0.00,0,0,0,0,0,0,0,0,0,0,0,0,0
20200528,059765,嘉聯益永豐99購02,1.23,1.37,1.23,1.30,+0.11,9.24,236000,21,313370,0,0,0,0,0,0,3000,236000,-233000,-233000
20200528,059766,同欣電永豐99購03,2.23,2.23,2.20,2.23,-0.02,-0.89,63000,6,139620,0,0,0,0,0,0,63000,0,63000,63000
20200528,059767,矽力永豐99購01,2.85,3.22,2.85,3.03,+0.18,6.32,38000,6,117580,0,0,0,0,0,0,25000,10000,15000,15000
20200528,059768,上証2X群益9C購02,,,,,0.00,0.00,0,0,0,0,0,0,0,0,0,0,0,0,0
20200528,059769,滬深2X群益9C購01,2.67,2.67,2.67,2.67,+0.04,1.52,2000,1,5340,0,0,0,0,0,0,2000,0,2000,2000
20200528,05976P,國巨凱基96售14,0.82,0.82,0.82,0.82,0.00,0.00,223000,1,182860,0,0,0,0,0,0,223000,0,223000,223000
20200528,059770,A50正2群益9C購01,,,,,0.00,0.00,0,0,0,0,0,0,0,0,0,0,0,0,0
20200528,059771,台積電群益99購11,1.90,1.90,1.78,1.79,-0.07,-3.76,107000,10,199310,0,0,0,0,0,0,12000,95000,-83000,-83000
20200528,059772,可成群益9A購05,2.70,2.70,2.64,2.64,+0.01,0.38,67000,5,178180,0,0,0,0,0,0,21000,47000,-26000,-26000
20200528,059773,康控群益99購01,,,,,0.00,0.00,0,0,0,0,0,0,0,0,0,0,0,0,0
20200528,059774,臺股指群益99購21,9.00,9.00,9.00,9.00,0.00,0.00,1000,1,9000,0,0,0,0,0,0,1000,0,1000,1000
20200528,059775,台灣50元大9C購16,,,,,0.00,0.00,0,0,0,0,0,0,0,0,0,0,0,0,0
20200528,059776,台灣50元大9C購17,,,,,0.00,0.00,0,0,0,0,0,0,0,0,0,0,0,0,0
20200528,059777,台灣50元大9C購18,,,,,0.00,0.00,0,0,0,0,0,0,0,0,0,0,0,0,0
20200528,059778,上証2X元大9C購03,,,,,0.00,0.00,0,0,0,0,0,0,0,0,0,0,0,0,0
20200528,059779,滬深2X元大9C購05,,,,,0.00,0.00,0,0,0,0,0,0,0,0,0,0,0,0,0
20200528,05977P,旺宏永豐96售06,0.47,0.57,0.47,0.57,+0.06,11.76,158000,5,81660,0,0,0,0,0,0,0,158000,-158000,-158000
20200528,059780,滬深2X元大9C購06,,,,,0.00,0.00,0,0,0,0,0,0,0,0,0,0,0,0,0
20200528,059781,A50正2元大9C購03,,,,,0.00,0.00,0,0,0,0,0,0,0,0,0,0,0,0,0
20200528,059782,A50正2元大9C購04,1.97,2.03,1.90,1.90,0.00,0.00,43000,6,84970,0,0,0,0,0,0,17000,26000,-9000,-9000
20200528,059783,旺宏元大99購17,8.55,8.75,8.05,8.05,-0.50,-5.85,30000,7,253650,0,0,0,0,0,0,20000,11000,9000,9000
20200528,059784,台光電元大9A購01,8.05,8.05,8.05,8.05,-0.60,-6.94,5000,1,40250,0,0,0,0,0,0,0,5000,-5000,-5000
20200528,059785,美律元大9A購03,2.22,2.31,2.22,2.31,+0.10,4.52,44000,5,100110,0,0,0,0,0,0,13000,37000,-24000,-24000
20200528,059786,全新元大99購06,3.29,3.33,3.21,3.28,+0.01,0.31,234000,24,761280,0,0,0,0,0,0,234000,63000,171000,171000
20200528,059787,奇力新元大9A購02,4.89,4.89,4.76,4.76,-0.34,-6.67,29000,3,139580,0,0,0,0,0,0,23000,6000,17000,17000
20200528,059788,華新科元大9A購05,,,,,0.00,0.00,0,0,0,0,0,0,0,0,0,0,0,0,0
20200528,059789,貿聯元大9A購02,2.43,2.43,2.42,2.43,+0.06,2.53,76000,5,184580,0,0,0,0,0,0,76000,0,76000,76000
20200528,05978P,麗豐永豐96售02,0.74,0.74,0.74,0.74,-0.03,-3.9,23000,2,17020,0,0,0,0,0,0,23000,0,23000,23000
20200528,059790,立積元大9C購02,3.41,3.41,3.27,3.27,-0.18,-5.22,188000,10,631740,0,0,0,0,0,0,128000,60000,68000,68000
20200528,059791,超眾元大99購06,2.59,2.59,2.52,2.52,-0.19,-7.01,10000,2,25550,0,0,0,0,0,0,0,10000,-10000,-10000
20200528,059792,台灣50國票9A購09,,,,,0.00,0.00,0,0,0,0,0,0,0,0,0,0,0,0,0
20200528,059793,滬深2X國票99購03,,,,,0.00,0.00,0,0,0,0,0,0,0,0,0,0,0,0,0
20200528,059794,滬深2X國票99購04,,,,,0.00,0.00,0,0,0,0,0,0,0,0,0,0,0,0,0
20200528,059795,鴻海國票99購07,2.30,2.30,2.30,2.30,-0.01,-0.43,7000,1,16100,0,0,0,0,0,0,7000,7000,0,0
20200528,059796,台積電國票99購10,,,,,0.00,0.00,0,0,0,0,0,0,0,0,0,0,0,0,0
20200528,059797,大立光國票99購01,,,,,0.00,0.00,0,0,0,0,0,0,0,0,0,0,0,0,0
20200528,059798,臺股指國票99購21,,,,,0.00,0.00,0,0,0,0,0,0,0,0,0,0,0,0,0
20200528,059799,台灣50元富01購05,,,,,0.00,0.00,0,0,0,0,0,0,0,0,0,0,0,0,0
20200528,05979P,華新科中信96售02,0.36,0.41,0.36,0.41,0.00,0.00,24000,3,9240,0,0,0,0,0,0,12000,12000,0,0
20200528,059800,T50反1元富99購09,,,,,0.00,0.00,0,0,0,0,0,0,0,0,0,0,0,0,0
20200528,059801,T50反1元富99購10,,,,,0.00,0.00,0,0,0,0,0,0,0,0,0,0,0,0,0
20200528,059802,上証2X元富99購02,,,,,0.00,0.00,0,0,0,0,0,0,0,0,0,0,0,0,0
20200528,059803,S&P正2元富9B購03,,,,,0.00,0.00,0,0,0,0,0,0,0,0,0,0,0,0,0
20200528,059804,台積電元富99購01,,,,,0.00,0.00,0,0,0,0,0,0,0,0,0,0,0,0,0
20200528,059805,台積電元富99購02,3.02,3.02,2.90,2.90,-0.07,-2.36,75000,4,218900,0,0,0,0,0,0,10000,65000,-55000,-55000
20200528,059806,聯發科元富99購08,,,,,0.00,0.00,0,0,0,0,0,0,0,0,0,0,0,0,0
20200528,059807,大立光元富99購09,2.06,2.06,1.89,1.89,-0.06,-3.08,201000,13,395230,0,0,0,0,0,0,83000,118000,-35000,-35000
20200528,059808,創意元富99購01,,,,,0.00,0.00,0,0,0,0,0,0,0,0,0,0,0,0,0
20200528,059809,貿聯元富99購01,,,,,0.00,0.00,0,0,0,0,0,0,0,0,0,0,0,0,0
20200528,05980P,台積電永昌96售09,1.68,1.87,1.68,1.84,+0.11,6.36,993000,7,1830370,0,0,0,0,0,0,993000,978000,15000,15000
20200528,059810,台灣50台新99購04,,,,,0.00,0.00,0,0,0,0,0,0,0,0,0,0,0,0,0
20200528,059811,高股息凱基99購02,1.92,1.92,1.87,1.88,-0.01,-0.53,25000,3,47100,0,0,0,0,0,0,5000,20000,-15000,-15000
20200528,059812,上証2X凱基9A購04,,,,,0.00,0.00,0,0,0,0,0,0,0,0,0,0,0,0,0
20200528,059813,滬深2X凱基9B購01,,,,,0.00,0.00,0,0,0,0,0,0,0,0,0,0,0,0,0
20200528,059814,SP黃豆凱基9A購02,1.25,1.25,1.24,1.24,+0.01,0.81,66000,5,82340,0,0,0,0,0,0,66000,0,66000,66000
20200528,059815,SP黃豆凱基9A購03,0.77,0.77,0.77,0.77,-0.01,-1.28,10000,2,7700,0,0,0,0,0,0,5000,5000,0,0
20200528,059816,聯電凱基99購03,1.18,1.21,1.18,1.21,0.00,0.00,198000,8,239200,0,0,0,0,0,0,0,189000,-189000,-189000
20200528,059817,華通凱基99購05,2.67,2.80,2.67,2.80,0.00,0.00,26000,3,71300,0,0,0,0,0,0,0,26000,-26000,-26000
20200528,059818,鴻海凱基99購14,0.79,0.79,0.78,0.78,+0.02,2.63,133000,8,104440,0,0,0,0,0,0,133000,0,133000,133000
20200528,059819,台積電凱基99購17,0.70,0.71,0.70,0.71,-0.02,-2.74,13000,2,9200,0,0,0,0,0,0,3000,10000,-7000,-7000
20200528,05981P,可成永昌98售02,,,,,0.00,0.00,0,0,0,0,0,0,0,0,0,0,0,0,0
20200528,059820,南亞科凱基99購07,1.32,1.32,1.32,1.32,+0.07,5.6,20000,3,26400,0,0,0,0,0,0,10000,10000,0,0
20200528,059821,美律凱基99購08,1.09,1.11,1.07,1.07,+0.02,1.9,31000,4,33970,0,0,0,0,0,0,1000,30000,-29000,-29000
20200528,059822,聯發科凱基99購19,1.50,1.50,1.50,1.50,-0.04,-2.6,3000,1,4500,0,0,0,0,0,0,0,3000,-3000,-3000
20200528,059823,奇力新凱基99購07,,,,,0.00,0.00,0,0,0,0,0,0,0,0,0,0,0,0,0
20200528,059824,大立光凱基99購13,,,,,0.00,0.00,0,0,0,0,0,0,0,0,0,0,0,0,0
20200528,059825,嘉晶凱基99購02,,,,,0.00,0.00,0,0,0,0,0,0,0,0,0,0,0,0,0
20200528,059826,欣興凱基99購06,,,,,0.00,0.00,0,0,0,0,0,0,0,0,0,0,0,0,0
20200528,059827,晶技凱基99購03,1.91,1.91,1.91,1.91,-0.06,-3.05,10000,3,19100,0,0,0,0,0,0,10000,0,10000,10000
20200528,059828,健策凱基99購05,3.58,3.63,3.54,3.63,+0.10,2.83,71000,20,253820,0,0,0,0,0,0,71000,0,71000,71000
20200528,059829,超眾凱基99購05,0.94,0.99,0.94,0.99,-0.03,-2.94,121000,4,118790,0,0,0,0,0,0,10000,111000,-101000,-101000
20200528,05982P,漢唐國票96售03,0.79,0.90,0.79,0.90,+0.05,5.88,354000,8,297150,0,0,0,0,0,0,50000,304000,-254000,-254000
20200528,059830,台郡凱基99購05,1.22,1.23,1.19,1.19,-0.05,-4.03,205000,10,247700,0,0,0,0,0,0,20000,181000,-161000,-161000
20200528,059831,聯詠康和99購01,2.40,2.40,2.40,2.40,-0.04,-1.64,3000,1,7200,0,0,0,0,0,0,0,3000,-3000,-3000
20200528,059832,超眾康和99購01,1.66,1.67,1.64,1.67,-0.10,-5.65,111000,3,184340,0,0,0,0,0,0,111000,0,111000,111000
20200528,059833,緯穎康和99購01,2.93,2.95,2.93,2.93,-0.09,-2.98,12000,3,35320,0,0,0,0,0,0,4000,8000,-4000,-4000
20200528,059834,友達國泰9B購01,,,,,0.00,0.00,0,0,0,0,0,0,0,0,0,0,0,0,0
20200528,059835,聯發科國泰9B購01,,,,,0.00,0.00,0,0,0,0,0,0,0,0,0,0,0,0,0
20200528,059836,大立光國泰9B購02,1.96,1.96,1.80,1.80,-0.08,-4.26,225000,11,411150,0,0,0,0,0,0,14000,211000,-197000,-197000
20200528,059837,健策國泰9B購01,,,,,0.00,0.00,0,0,0,0,0,0,0,0,0,0,0,0,0
20200528,059838,茂林國泰9B購01,,,,,0.00,0.00,0,0,0,0,0,0,0,0,0,0,0,0,0
20200528,059839,T50反1富邦99購02,,,,,0.00,0.00,0,0,0,0,0,0,0,0,0,0,0,0,0
20200528,05983P,聯詠國票96售02,0.94,0.94,0.94,0.94,0.00,0.00,45000,1,42300,0,0,0,0,0,0,0,45000,-45000,-45000
20200528,059840,鴻海富邦9A購02,,,,,0.00,0.00,0,0,0,0,0,0,0,0,0,0,0,0,0
20200528,059841,國巨富邦9C購01,1.41,1.43,1.35,1.35,-0.04,-2.88,546000,22,755360,0,0,0,0,0,0,469000,81000,388000,388000
20200528,059842,台積電富邦9C購05,,,,,0.00,0.00,0,0,0,0,0,0,0,0,0,0,0,0,0
20200528,059843,華新科富邦9B購03,,,,,0.00,0.00,0,0,0,0,0,0,0,0,0,0,0,0,0
20200528,059844,大立光富邦9C購04,0.81,0.81,0.79,0.79,-0.01,-1.25,60000,2,47600,0,0,0,0,0,0,10000,50000,-40000,-40000
20200528,059845,欣興富邦9A購02,,,,,0.00,0.00,0,0,0,0,0,0,0,0,0,0,0,0,0
20200528,059846,力山永豐99購01,,,,,0.00,0.00,0,0,0,0,0,0,0,0,0,0,0,0,0
20200528,059847,喬山永豐99購01,3.09,3.09,2.79,2.79,-0.24,-7.92,106000,11,323940,0,0,0,0,0,0,104000,2000,102000,102000
20200528,059848,智邦永豐99購01,2.78,2.85,2.56,2.56,+0.15,6.22,78000,6,214250,0,0,0,0,0,0,65000,13000,52000,52000
20200528,059849,興勤永豐99購01,1.32,1.35,1.27,1.33,-0.01,-0.75,1124000,71,1468970,5000,10000,-5000,0,0,0,919000,195000,724000,719000
20200528,05984P,台積電統一98售01,1.34,1.34,1.34,1.34,0.00,0.00,169000,2,226460,0,0,0,0,0,0,169000,169000,0,0
20200528,059850,日電貿永豐99購01,2.23,2.23,2.21,2.21,+0.01,0.45,62000,9,137600,0,0,0,0,0,0,62000,0,62000,62000
20200528,059851,晶相光永豐99購02,1.11,1.11,1.09,1.09,-0.08,-6.84,312000,9,345230,0,0,0,0,0,0,312000,0,312000,312000
20200528,059852,康控永豐99購02,1.62,1.66,1.56,1.56,-0.06,-3.7,150000,3,241100,0,0,0,0,0,0,105000,45000,60000,60000
20200528,059853,超眾永豐99購03,0.90,0.90,0.90,0.90,-0.08,-8.16,15000,1,13500,0,0,0,0,0,0,15000,0,15000,15000
20200528,059854,台表科永豐99購03,,,,,0.00,0.00,0,0,0,0,0,0,0,0,0,0,0,0,0
20200528,059855,緯穎永豐99購04,1.73,1.73,1.60,1.60,-0.19,-10.61,64000,3,105570,0,0,0,0,0,0,0,64000,-64000,-64000
20200528,059856,昇陽半永豐99購03,1.32,1.32,1.32,1.32,+0.06,4.76,87000,6,114840,0,0,0,0,0,0,0,87000,-87000,-87000
20200528,059857,台灣50群益99購06,,,,,0.00,0.00,0,0,0,0,0,0,0,0,0,0,0,0,0
20200528,059858,台灣50群益9A購09,,,,,0.00,0.00,0,0,0,0,0,0,0,0,0,0,0,0,0
20200528,059859,國巨群益9A購03,,,,,0.00,0.00,0,0,0,0,0,0,0,0,0,0,0,0,0
20200528,05985P,燿華統一96售03,,,,,0.00,0.00,0,0,0,0,0,0,0,0,0,0,0,0,0
20200528,059860,台積電群益9A購02,3.79,3.79,3.58,3.59,-0.14,-3.75,83000,7,310370,0,0,0,0,0,0,0,83000,-83000,-83000
20200528,059861,聯發科群益9A購01,5.60,5.60,5.60,5.60,-0.20,-3.45,10000,1,56000,0,0,0,0,0,0,10000,0,10000,10000
20200528,059862,全新群益99購04,1.05,1.09,1.05,1.08,-0.03,-2.7,630000,20,673030,0,0,0,0,0,0,528000,137000,391000,391000
20200528,059863,和大凱基99購01,1.90,1.93,1.90,1.93,0.00,0.00,30000,3,57600,0,0,0,0,0,0,0,30000,-30000,-30000
20200528,059864,亞德客凱基99購01,2.05,2.11,2.05,2.06,0.00,0.00,64000,13,131830,0,0,0,0,0,0,64000,9000,55000,55000
20200528,059865,國巨凱基01購01,1.28,1.28,1.22,1.22,-0.03,-2.4,194000,13,239160,0,0,0,0,0,0,15000,179000,-164000,-164000
20200528,059866,國巨凱基99購18,1.57,1.57,1.50,1.50,0.00,0.00,57000,6,88140,0,0,0,0,0,0,2000,55000,-53000,-53000
20200528,059867,華邦電凱基99購02,1.59,1.64,1.41,1.45,+0.01,0.69,318000,29,508690,0,0,0,0,0,0,248000,40000,208000,208000
20200528,059868,台光電凱基99購03,1.90,2.03,1.88,2.03,-0.06,-2.87,22000,5,42120,0,0,0,0,0,0,16000,6000,10000,10000
20200528,059869,友達凱基99購07,0.94,0.98,0.91,0.91,-0.08,-8.08,135000,5,128950,0,0,0,0,0,0,55000,80000,-25000,-25000
20200528,05986P,大立光統一97售03,,,,,0.00,0.00,0,0,0,0,0,0,0,0,0,0,0,0,0
20200528,059870,全新凱基99購05,0.86,0.90,0.86,0.88,+0.01,1.15,528000,10,466670,0,0,0,0,0,0,523000,45000,478000,478000
20200528,059871,義隆凱基99購03,1.28,1.34,1.26,1.30,+0.07,5.69,333000,27,428640,0,0,0,0,0,0,201000,134000,67000,67000
20200528,059872,華新科凱基01購01,0.95,0.95,0.91,0.92,-0.03,-3.16,121000,6,111470,0,0,0,0,0,0,120000,1000,119000,119000
20200528,059873,華新科凱基99購09,,,,,0.00,0.00,0,0,0,0,0,0,0,0,0,0,0,0,0
20200528,059874,大立光凱基99購15,,,,,0.00,0.00,0,0,0,0,0,0,0,0,0,0,0,0,0
20200528,059875,信邦凱基99購02,1.51,1.57,1.49,1.52,+0.01,0.66,146000,9,223140,0,0,0,0,0,0,91000,55000,36000,36000
20200528,059876,智易凱基99購02,1.43,1.52,1.42,1.42,+0.01,0.71,180000,20,264950,0,0,0,0,0,0,40000,140000,-100000,-100000
20200528,059877,康控凱基99購05,1.65,1.65,1.65,1.65,-0.03,-1.79,6000,1,9900,0,0,0,0,0,0,6000,6000,0,0
20200528,059878,聯茂凱基99購07,0.90,0.95,0.90,0.93,+0.05,5.68,203000,8,183770,0,0,0,0,0,0,41000,162000,-121000,-121000
20200528,059879,GIS凱基99購03,2.21,2.21,2.21,2.21,-0.10,-4.33,8000,1,17680,0,0,0,0,0,0,8000,0,8000,8000
20200528,05987P,健策統一96售02,0.29,0.34,0.29,0.34,0.00,0.00,138000,5,44770,0,0,0,0,0,0,0,138000,-138000,-138000
20200528,059880,世紀鋼凱基99購02,1.08,1.30,1.07,1.23,+0.12,10.81,459000,55,542340,0,0,0,0,0,0,175000,284000,-109000,-109000
20200528,059881,臺股指凱基99購46,2.21,2.21,2.21,2.21,0.00,0.00,1000,1,2210,0,0,0,0,0,0,1000,0,1000,1000
20200528,059882,臺股指凱基9C購06,1.78,1.81,1.62,1.66,-0.08,-4.6,761000,40,1307660,0,0,0,0,0,0,328000,433000,-105000,-105000
20200528,059883,T50反1國票99購02,0.54,0.54,0.54,0.54,0.00,0.00,18000,1,9720,0,0,0,0,0,0,0,18000,-18000,-18000
20200528,059884,鴻海國票99購09,1.00,1.00,1.00,1.00,-0.07,-6.54,1000,1,1000,0,0,0,0,0,0,1000,0,1000,1000
20200528,059885,台積電國票99購12,3.52,3.52,3.21,3.21,-0.22,-6.41,22000,5,71890,0,0,0,0,0,0,20000,2000,18000,18000
20200528,059886,可成國票99購04,1.98,1.98,1.91,1.91,-0.04,-2.05,71000,3,135880,0,0,0,0,0,0,51000,21000,30000,30000
20200528,059887,華新科國票99購02,7.75,7.75,7.75,7.75,-0.10,-1.27,11000,1,85250,0,0,0,0,0,0,11000,0,11000,11000
20200528,059888,華新科國票99購03,,,,,0.00,0.00,0,0,0,0,0,0,0,0,0,0,0,0,0
20200528,059889,華新科國票99購04,3.64,3.64,3.60,3.60,-0.06,-1.64,8000,2,28960,0,0,0,0,0,0,4000,4000,0,0
20200528,05988P,光磊元富96售02,,,,,0.00,0.00,0,0,0,0,0,0,0,0,0,0,0,0,0
20200528,059890,大立光國票99購03,,,,,0.00,0.00,0,0,0,0,0,0,0,0,0,0,0,0,0
20200528,059891,臺股指國票99購25,,,,,0.00,0.00,0,0,0,0,0,0,0,0,0,0,0,0,0
20200528,059892,台灣50台新9A購02,,,,,0.00,0.00,0,0,0,0,0,0,0,0,0,0,0,0,0
20200528,059893,台積電台新9A購02,1.11,1.11,1.11,1.11,-0.03,-2.63,3000,2,3330,0,0,0,0,0,0,3000,3000,0,0
20200528,059894,台灣50元大9C購19,,,,,0.00,0.00,0,0,0,0,0,0,0,0,0,0,0,0,0
20200528,059895,T50反1元大99購12,,,,,0.00,0.00,0,0,0,0,0,0,0,0,0,0,0,0,0
20200528,059896,T50反1元大99購13,,,,,0.00,0.00,0,0,0,0,0,0,0,0,0,0,0,0,0
20200528,059897,T50反1元大99購14,,,,,0.00,0.00,0,0,0,0,0,0,0,0,0,0,0,0,0
20200528,059898,T50反1元大99購15,0.70,0.71,0.70,0.71,0.00,0.00,35000,4,24550,0,0,0,0,0,0,35000,0,35000,35000
20200528,059899,上証2X元大9C購04,2.22,2.22,2.10,2.10,-0.05,-2.33,15000,3,32560,0,0,0,0,0,0,9000,6000,3000,3000
20200528,05989P,健策元富96售01,,,,,0.00,0.00,0,0,0,0,0,0,0,0,0,0,0,0,0
20200528,059900,上証反元大99購03,,,,,0.00,0.00,0,0,0,0,0,0,0,0,0,0,0,0,0
20200528,059901,滬深2X元大9C購07,1.43,1.43,1.43,1.43,0.00,0.00,2000,1,2860,0,0,0,0,0,0,0,2000,-2000,-2000
20200528,059902,滬深2X元大9C購08,,,,,0.00,0.00,0,0,0,0,0,0,0,0,0,0,0,0,0
20200528,059903,S&P正2元大99購02,,,,,0.00,0.00,0,0,0,0,0,0,0,0,0,0,0,0,0
20200528,059904,A50正2元大9C購05,1.98,1.98,1.98,1.98,+0.03,1.54,10000,1,19800,0,0,0,0,0,0,10000,0,10000,10000
20200528,059905,A50正2元大9C購06,,,,,0.00,0.00,0,0,0,0,0,0,0,0,0,0,0,0,0
20200528,059906,臺指反元大9C購04,,,,,0.00,0.00,0,0,0,0,0,0,0,0,0,0,0,0,0
20200528,059907,道瓊指元大99購03,2.59,2.59,2.53,2.56,+0.21,8.94,182000,6,462920,0,0,0,0,0,0,150000,32000,118000,118000
20200528,059908,元金2X元大99購01,1.45,1.48,1.44,1.48,+0.09,6.47,70000,3,101500,0,0,0,0,0,0,10000,60000,-50000,-50000
20200528,059909,鴻海元大99購36,1.67,1.67,1.61,1.61,+0.01,0.62,121000,7,198510,0,0,0,0,0,0,68000,53000,15000,15000
20200528,05990P,台積電群益96售13,4.69,4.69,4.69,4.69,+0.13,2.85,50000,1,234500,0,0,0,0,0,0,50000,50000,0,0
20200528,059910,鴻海元大99購37,3.18,3.18,3.18,3.18,+0.04,1.27,1000,1,3180,0,0,0,0,0,0,1000,1000,0,0
20200528,059911,國巨元大99購27,2.54,2.54,2.44,2.44,-0.04,-1.61,101000,8,249990,0,0,0,0,0,0,1000,100000,-99000,-99000
20200528,059912,國巨元大99購28,4.99,4.99,4.65,4.65,-0.07,-1.48,46000,8,220550,0,0,0,0,0,0,38000,13000,25000,25000
20200528,059913,台積電元大99購44,1.88,1.88,1.88,1.88,-0.02,-1.05,50000,1,94000,0,0,0,0,0,0,50000,0,50000,50000
20200528,059914,台積電元大99購47,1.97,1.97,1.97,1.97,+0.01,0.51,50000,1,98500,0,0,0,0,0,0,0,50000,-50000,-50000
20200528,059915,聯發科元大99購32,3.52,3.54,3.41,3.41,-0.03,-0.87,59000,7,207410,0,0,0,0,0,0,59000,1000,58000,58000
20200528,059916,聯發科元大99購33,,,,,0.00,0.00,0,0,0,0,0,0,0,0,0,0,0,0,0
20200528,059917,華新科元大99購19,2.74,2.74,2.62,2.62,-0.16,-5.76,91000,4,245140,0,0,0,0,0,0,48000,43000,5000,5000
20200528,059918,華新科元大99購20,,,,,0.00,0.00,0,0,0,0,0,0,0,0,0,0,0,0,0
20200528,059919,宏達電元大99購06,2.53,2.53,2.22,2.22,-0.30,-11.9,71000,7,169630,0,0,0,0,0,0,32000,57000,-25000,-25000
20200528,05991P,聯茂群益96售05,0.24,0.24,0.24,0.24,-0.04,-14.29,10000,1,2400,0,0,0,0,0,0,10000,0,10000,10000
20200528,059920,宏達電元大99購07,2.54,2.56,2.24,2.24,-0.25,-10.04,280000,13,665400,0,0,0,0,0,0,139000,158000,-19000,-19000
20200528,059921,大立光元大99購24,1.60,1.60,1.49,1.49,-0.07,-4.49,147000,4,220140,0,0,0,0,0,0,78000,69000,9000,9000
20200528,059922,大立光元大99購25,1.22,1.22,1.13,1.13,-0.05,-4.24,157000,14,184130,0,0,0,0,0,0,77000,80000,-3000,-3000
20200528,059923,緯穎元大99購09,4.83,4.84,4.45,4.45,-0.43,-8.81,55000,9,260990,0,0,0,0,0,0,39000,16000,23000,23000
20200528,059924,世紀鋼元大99購06,2.55,3.07,2.53,2.87,+0.32,12.55,497000,37,1392950,0,0,0,0,0,0,240000,277000,-37000,-37000
20200528,059925,可成國泰9B購01,2.49,2.49,2.48,2.48,+0.04,1.64,11000,3,27380,0,0,0,0,0,0,10000,1000,9000,9000
20200528,059926,世紀鋼國泰9B購01,2.40,2.76,2.38,2.76,+0.35,14.52,135000,12,341120,0,0,0,0,0,0,31000,104000,-73000,-73000
20200528,059927,台灣50富邦9A購01,,,,,0.00,0.00,0,0,0,0,0,0,0,0,0,0,0,0,0
20200528,059928,道瓊銀富邦03購01,1.07,1.08,1.07,1.08,+0.06,5.88,66000,5,70740,0,0,0,0,0,0,53000,13000,40000,40000
20200528,059929,華新科富邦9C購03,0.73,0.73,0.72,0.73,-0.01,-1.35,20000,17,14550,0,0,0,0,0,0,20000,0,20000,20000
20200528,05992P,華通元大96售05,,,,,0.00,0.00,0,0,0,0,0,0,0,0,0,0,0,0,0
20200528,059930,健策富邦9B購01,,,,,0.00,0.00,0,0,0,0,0,0,0,0,0,0,0,0,0
20200528,059931,緯穎富邦9A購01,0.93,0.99,0.89,0.89,-0.05,-5.32,588000,30,539350,0,0,0,0,0,0,74000,497000,-423000,-423000
20200528,059932,世紀鋼富邦9A購02,0.69,0.85,0.68,0.81,+0.11,15.71,1280000,88,990940,0,0,0,0,0,0,418000,838000,-420000,-420000
20200528,059933,台灣50永豐99購11,,,,,0.00,0.00,0,0,0,0,0,0,0,0,0,0,0,0,0
20200528,059934,華通永豐99購02,1.89,2.05,1.89,1.92,+0.14,7.87,143000,8,280150,0,0,0,0,0,0,86000,57000,29000,29000
20200528,059935,國巨永豐99購07,1.49,1.49,1.49,1.49,0.00,0.00,9000,1,13410,0,0,0,0,0,0,9000,0,9000,9000
20200528,059936,台積電永豐99購06,,,,,0.00,0.00,0,0,0,0,0,0,0,0,0,0,0,0,0
20200528,059937,旺宏永豐99購03,1.27,1.27,1.26,1.27,-0.02,-1.55,20000,15,25260,0,0,0,0,0,0,20000,0,20000,20000
20200528,059938,凱美永豐99購01,1.61,1.75,1.61,1.69,+0.09,5.62,661000,34,1094500,0,0,0,0,0,0,0,661000,-661000,-661000
20200528,059939,技嘉永豐99購01,,,,,0.00,0.00,0,0,0,0,0,0,0,0,0,0,0,0,0
20200528,05993P,國巨元大96售13,,,,,0.00,0.00,0,0,0,0,0,0,0,0,0,0,0,0,0
20200528,059940,微星永豐99購01,1.57,1.57,1.55,1.55,-0.28,-15.3,26000,2,40500,0,0,0,0,0,0,0,26000,-26000,-26000
20200528,059941,聯發科永豐99購04,,,,,0.00,0.00,0,0,0,0,0,0,0,0,0,0,0,0,0
20200528,059942,全新永豐99購04,1.11,1.11,1.10,1.10,-0.04,-3.51,110000,2,121300,0,0,0,0,0,0,110000,0,110000,110000
20200528,059943,信邦永豐99購01,1.18,1.21,1.18,1.21,+0.03,2.54,461000,15,549430,0,0,0,0,0,0,152000,309000,-157000,-157000
20200528,059944,欣興永豐99購03,1.54,1.64,1.54,1.57,+0.05,3.29,305000,12,479950,0,0,0,0,0,0,0,305000,-305000,-305000
20200528,059945,嘉澤永豐99購03,,,,,0.00,0.00,0,0,0,0,0,0,0,0,0,0,0,0,0
20200528,059946,健策永豐99購05,2.95,2.95,2.65,2.65,-0.29,-9.86,47000,14,136910,0,0,0,0,0,0,47000,1000,46000,46000
20200528,059947,貿聯永豐99購03,1.57,1.61,1.56,1.60,+0.07,4.58,163000,18,257220,0,0,0,0,0,0,98000,65000,33000,33000
20200528,059948,正文永豐99購01,1.07,1.13,1.07,1.11,+0.04,3.74,258000,8,280640,0,0,0,0,0,0,88000,170000,-82000,-82000
20200528,059949,啟碁永豐99購01,1.61,1.63,1.60,1.60,0.00,0.00,239000,8,384580,0,0,0,0,0,0,227000,0,227000,227000
20200528,05994P,奇鋐元大96售02,0.23,0.23,0.19,0.19,-0.08,-29.63,20000,2,4200,0,0,0,0,0,0,0,20000,-20000,-20000
20200528,059950,百和永豐99購02,1.78,1.80,1.71,1.74,+0.02,1.16,439000,14,775530,0,0,0,0,0,0,351000,78000,273000,273000
20200528,059951,台塑康和99購01,1.76,1.76,1.76,1.76,+0.01,0.57,68000,1,119680,0,0,0,0,0,0,68000,0,68000,68000
20200528,059952,旺宏康和99購01,2.58,2.58,2.56,2.56,-0.08,-3.03,69000,14,176820,0,0,0,0,0,0,69000,0,69000,69000
20200528,059953,聯發科康和99購01,,,,,0.00,0.00,0,0,0,0,0,0,0,0,0,0,0,0,0
20200528,059954,華新科康和99購01,2.23,2.25,2.11,2.11,-0.18,-7.86,130000,12,287390,0,0,0,0,0,0,110000,20000,90000,90000
20200528,059955,美食康和99購01,3.96,3.96,3.79,3.79,-0.10,-2.57,70000,3,274300,0,0,0,0,0,0,70000,0,70000,70000
20200528,059956,玉山金康和99購01,,,,,0.00,0.00,0,0,0,0,0,0,0,0,0,0,0,0,0
20200528,059957,中信金康和99購01,1.99,1.99,1.94,1.94,-0.04,-2.02,55000,3,108750,0,0,0,0,0,0,45000,10000,35000,35000
20200528,059958,鎧勝康和99購01,2.23,2.23,2.16,2.16,-0.01,-0.46,41000,3,89490,0,0,0,0,0,0,1000,40000,-39000,-39000
20200528,059959,訊芯康和99購01,2.38,2.38,2.38,2.38,+0.01,0.42,11000,1,26180,0,0,0,0,0,0,0,11000,-11000,-11000
20200528,05995P,T50正2中信9C售01,2.85,2.98,2.83,2.98,+0.07,2.41,427000,21,1236140,0,0,0,0,0,0,212000,215000,-3000,-3000
20200528,059960,健策國票99購01,,,,,0.00,0.00,0,0,0,0,0,0,0,0,0,0,0,0,0
20200528,059961,T50反1凱基99購09,,,,,0.00,0.00,0,0,0,0,0,0,0,0,0,0,0,0,0
20200528,059962,S&P正2凱基99購02,,,,,0.00,0.00,0,0,0,0,0,0,0,0,0,0,0,0,0
20200528,059963,臺指反凱基99購01,,,,,0.00,0.00,0,0,0,0,0,0,0,0,0,0,0,0,0
20200528,059964,元金2X凱基99購02,1.26,1.26,1.26,1.26,+0.03,2.44,10000,1,12600,0,0,0,0,0,0,10000,0,10000,10000
20200528,059965,鴻海凱基99購16,0.60,0.60,0.60,0.60,+0.01,1.69,2000,1,1200,0,0,0,0,0,0,0,2000,-2000,-2000
20200528,059966,台積電凱基99購19,0.79,0.79,0.79,0.79,0.00,0.00,5000,1,3950,0,0,0,0,0,0,0,5000,-5000,-5000
20200528,059967,聯發科凱基99購20,1.43,1.43,1.43,1.43,0.00,0.00,1000,1,1430,0,0,0,0,0,0,0,1000,-1000,-1000
20200528,059968,世紀鋼凱基99購03,0.95,0.97,0.93,0.93,+0.09,10.71,102000,11,97570,0,0,0,0,0,0,69000,33000,36000,36000
20200528,059969,台灣50元大9B購06,,,,,0.00,0.00,0,0,0,0,0,0,0,0,0,0,0,0,0
20200528,05996P,華新科群益96售03,,,,,0.00,0.00,0,0,0,0,0,0,0,0,0,0,0,0,0
20200528,059970,台灣50元大9B購07,,,,,0.00,0.00,0,0,0,0,0,0,0,0,0,0,0,0,0
20200528,059971,台灣50元大9B購08,,,,,0.00,0.00,0,0,0,0,0,0,0,0,0,0,0,0,0
20200528,059972,S&P正2元大99購03,,,,,0.00,0.00,0,0,0,0,0,0,0,0,0,0,0,0,0
20200528,059973,A50正2元大99購02,1.33,1.33,1.20,1.22,-0.02,-1.61,46000,6,58300,0,0,0,0,0,0,20000,26000,-6000,-6000
20200528,059974,臺指反元大9C購05,1.56,1.56,1.56,1.56,+0.04,2.63,10000,1,15600,0,0,0,0,0,0,10000,0,10000,10000
20200528,059975,元金2X元大99購02,1.43,1.47,1.41,1.47,+0.08,5.76,412000,16,595120,0,0,0,0,0,0,105000,301000,-196000,-196000
20200528,059976,道瓊銀元大99購01,1.55,1.55,1.53,1.55,+0.09,6.16,230000,7,354420,0,0,0,0,0,0,230000,0,230000,230000
20200528,059977,鴻海元大99購40,1.75,1.75,1.75,1.75,+0.04,2.34,68000,1,119000,0,0,0,0,0,0,0,68000,-68000,-68000
20200528,059978,國巨元大99購29,2.51,2.51,2.51,2.51,-0.01,-0.4,1000,1,2510,0,0,0,0,0,0,0,1000,-1000,-1000
20200528,059979,台積電元大99購49,1.87,1.87,1.84,1.84,0.00,0.00,85000,5,157650,0,0,0,0,0,0,50000,35000,15000,15000
20200528,05997P,嘉聯益群益96售02,,,,,0.00,0.00,0,0,0,0,0,0,0,0,0,0,0,0,0
20200528,059980,台積電元大99購50,1.80,1.80,1.71,1.71,-0.09,-5.0,66000,7,118100,0,0,0,0,0,0,50000,16000,34000,34000
20200528,059981,聯發科元大99購36,3.36,3.38,3.14,3.14,-0.14,-4.27,74000,9,245310,0,0,0,0,0,0,65000,24000,41000,41000
20200528,059982,聯發科元大99購37,4.52,4.55,4.52,4.55,0.00,0.00,2000,2,9070,0,0,0,0,0,0,2000,0,2000,2000
20200528,059983,聯發科元大99購38,,,,,0.00,0.00,0,0,0,0,0,0,0,0,0,0,0,0,0
20200528,059984,華新科元大99購21,1.90,1.91,1.90,1.91,-0.02,-1.04,27000,3,51470,0,0,0,0,0,0,27000,0,27000,27000
20200528,059985,華新科元大99購22,2.67,2.69,2.54,2.54,-0.13,-4.87,83000,8,219780,0,0,0,0,0,0,63000,20000,43000,43000
20200528,059986,宏達電元大99購08,2.11,2.11,1.82,1.82,-0.25,-12.08,97000,6,189190,0,0,0,0,0,0,51000,64000,-13000,-13000
20200528,059987,大立光元大99購28,1.76,1.76,1.76,1.76,+0.05,2.92,10000,1,17600,0,0,0,0,0,0,10000,0,10000,10000
20200528,059988,大立光元大9A購02,1.53,1.53,1.53,1.53,-0.07,-4.38,16000,1,24480,0,0,0,0,0,0,16000,0,16000,16000
20200528,059989,嘉晶元大9A購01,,,,,0.00,0.00,0,0,0,0,0,0,0,0,0,0,0,0,0
20200528,05998P,台積電元大97售12,2.26,2.26,2.26,2.26,0.00,0.00,10000,1,22600,0,0,0,0,0,0,10000,0,10000,10000
20200528,059990,健策元大9A購01,7.15,7.15,6.70,6.70,-0.40,-5.63,5000,2,35300,0,0,0,0,0,0,4000,1000,3000,3000
20200528,059991,超眾元大9A購02,3.02,3.11,2.98,3.05,-0.08,-2.56,84000,8,258390,0,0,0,0,0,0,26000,58000,-32000,-32000
20200528,059992,S&P正2元富9B購04,2.30,2.30,2.30,2.30,+0.10,4.55,1000,1,2300,0,0,0,0,0,0,0,1000,-1000,-1000
20200528,059993,上銀元富99購01,,,,,0.00,0.00,0,0,0,0,0,0,0,0,0,0,0,0,0
20200528,059994,國巨元富99購01,3.69,3.69,3.68,3.69,+0.10,2.79,20000,4,73760,0,0,0,0,0,0,16000,4000,12000,12000
20200528,059995,南亞科元富99購01,2.71,2.80,2.50,2.52,-0.03,-1.18,532000,56,1448690,0,0,0,0,0,0,253000,281000,-28000,-28000
20200528,059996,美律元富99購01,2.38,2.45,2.38,2.45,+0.16,6.99,191000,5,459580,0,0,0,0,0,0,29000,162000,-133000,-133000
20200528,059997,華航元富99購01,2.09,2.09,2.00,2.00,-0.06,-2.91,25000,3,51400,0,0,0,0,0,0,15000,10000,5000,5000
20200528,059998,華航元富99購02,2.46,2.46,2.46,2.46,0.00,0.00,5000,1,12300,0,0,0,0,0,0,5000,0,5000,5000
20200528,059999,緯穎元富99購01,3.81,3.91,3.64,3.64,-0.14,-3.7,147000,29,561040,0,0,0,0,0,0,107000,40000,67000,67000
20200528,05999P,世芯元大96售01,,,,,0.00,0.00,0,0,0,0,0,0,0,0,0,0,0,0,0
20200528,060000,國巨台新99購01,,,,,0.00,0.00,0,0,0,0,0,0,0,0,0,0,0,0,0
20200528,060001,台灣50群益9A購10,,,,,0.00,0.00,0,0,0,0,0,0,0,0,0,0,0,0,0
20200528,060002,T50反1群益9A購01,0.35,0.36,0.35,0.36,0.00,0.00,280000,5,98300,0,0,0,0,0,0,280000,0,280000,280000
20200528,060003,上証2X群益9B購02,,,,,0.00,0.00,0,0,0,0,0,0,0,0,0,0,0,0,0
20200528,060004,臺指反群益9A購01,,,,,0.00,0.00,0,0,0,0,0,0,0,0,0,0,0,0,0
20200528,060005,上銀群益99購03,,,,,0.00,0.00,0,0,0,0,0,0,0,0,0,0,0,0,0
20200528,060006,華通群益9A購04,,,,,0.00,0.00,0,0,0,0,0,0,0,0,0,0,0,0,0
20200528,060007,鴻海群益99購04,,,,,0.00,0.00,0,0,0,0,0,0,0,0,0,0,0,0,0
20200528,060008,華邦電群益9A購01,2.17,2.26,1.85,1.94,-0.11,-5.37,801000,38,1702780,0,0,0,0,0,0,538000,250000,288000,288000
20200528,060009,南亞科群益99購03,2.54,2.63,2.36,2.37,-0.02,-0.84,235000,16,591450,0,0,0,0,0,0,133000,102000,31000,31000
20200528,06000P,GIS元大96售04,0.57,0.77,0.57,0.77,+0.16,26.23,92000,2,60840,0,0,0,0,0,0,50000,42000,8000,8000
20200528,060010,義隆群益99購02,3.72,3.86,3.65,3.67,+0.16,4.56,178000,32,662250,0,0,0,0,0,0,134000,90000,44000,44000
20200528,060011,臺股指群益9C購06,3.70,3.72,3.57,3.57,-0.09,-2.46,18000,4,66180,0,0,0,0,0,0,6000,12000,-6000,-6000
20200528,060012,電子類群益99購02,3.40,3.40,3.23,3.23,-0.11,-3.29,8000,3,26180,0,0,0,0,0,0,7000,1000,6000,6000
20200528,060013,S&P正2康和99購01,,,,,0.00,0.00,0,0,0,0,0,0,0,0,0,0,0,0,0
20200528,060014,中鋼康和99購01,1.38,1.38,1.38,1.38,+0.03,2.22,100000,1,138000,0,0,0,0,0,0,0,100000,-100000,-100000
20200528,060015,國巨康和99購03,2.99,3.02,2.80,2.80,-0.08,-2.78,67000,4,199380,0,0,0,0,0,0,1000,67000,-66000,-66000
20200528,060016,廣達康和99購01,2.16,2.16,2.16,2.16,0.00,0.00,200000,1,432000,0,0,0,0,0,0,0,200000,-200000,-200000
20200528,060017,全新康和99購01,1.74,1.83,1.74,1.83,-0.05,-2.66,102000,7,178780,0,0,0,0,0,0,88000,14000,74000,74000
20200528,060018,國產康和99購01,,,,,0.00,0.00,0,0,0,0,0,0,0,0,0,0,0,0,0
20200528,060019,彰銀康和99購01,1.10,1.10,1.10,1.10,-0.04,-3.51,68000,1,74800,0,0,0,0,0,0,68000,0,68000,68000
20200528,06001P,樺漢台新96售01,,,,,0.00,0.00,0,0,0,0,0,0,0,0,0,0,0,0,0
20200528,060020,康控康和99購01,2.41,2.41,2.37,2.41,+0.06,2.55,24000,3,57680,0,0,0,0,0,0,19000,20000,-1000,-1000
20200528,060021,立積康和99購01,1.83,1.83,1.83,1.83,-0.03,-1.61,77000,2,140910,0,0,0,0,0,0,77000,0,77000,77000
20200528,060022,勤誠康和99購01,3.20,3.20,3.02,3.02,0.00,0.00,23000,3,72460,0,0,0,0,0,0,10000,13000,-3000,-3000
20200528,060023,T50反1國泰9A購03,0.62,0.65,0.60,0.65,+0.01,1.56,1385000,40,857100,0,0,0,0,0,0,50000,1325000,-1275000,-1275000
20200528,060024,T50反1國泰9B購02,,,,,0.00,0.00,0,0,0,0,0,0,0,0,0,0,0,0,0
20200528,060025,台積電富邦9C購06,0.73,0.73,0.73,0.73,-0.03,-3.95,40000,1,29200,0,0,0,0,0,0,0,40000,-40000,-40000
20200528,060026,聯發科富邦9B購05,2.47,2.47,2.35,2.35,-0.09,-3.69,25000,3,61150,0,0,0,0,0,0,20000,5000,15000,15000
20200528,060027,元金2X永豐99購02,0.76,0.76,0.76,0.76,+0.02,2.7,2000,1,1520,0,0,0,0,0,0,2000,0,2000,2000
20200528,060028,國揚永豐99購01,1.50,1.63,1.47,1.55,-0.06,-3.73,1112000,47,1722540,0,0,0,0,0,0,991000,101000,890000,890000
20200528,060029,嘉晶永豐99購03,2.22,2.22,2.22,2.22,-0.08,-3.48,7000,1,15540,0,0,0,0,0,0,7000,0,7000,7000
20200528,06002P,華通康和96售01,,,,,0.00,0.00,0,0,0,0,0,0,0,0,0,0,0,0,0
20200528,060030,晶相光永豐99購03,1.13,1.13,1.10,1.10,-0.09,-7.56,288000,9,320810,0,0,0,0,0,0,288000,0,288000,288000
20200528,060031,旭富永豐99購02,0.65,0.68,0.65,0.65,-0.03,-4.41,82000,6,54180,0,0,0,0,0,0,12000,70000,-58000,-58000
20200528,060032,利勤永豐99購01,1.18,1.20,1.07,1.08,-0.06,-5.26,303000,24,339220,0,0,0,0,0,0,53000,250000,-197000,-197000
20200528,060033,臻鼎永豐99購01,1.42,1.45,1.33,1.35,-0.06,-4.26,127000,13,177870,0,0,0,0,0,0,78000,45000,33000,33000
20200528,060034,立積永豐99購04,1.12,1.12,1.11,1.11,-0.02,-1.77,422000,29,469790,0,0,0,0,0,0,397000,25000,372000,372000
20200528,060035,臺股指永豐99購04,,,,,0.00,0.00,0,0,0,0,0,0,0,0,0,0,0,0,0
20200528,060036,上証2X國票99購03,,,,,0.00,0.00,0,0,0,0,0,0,0,0,0,0,0,0,0
20200528,060037,鴻海國票99購10,2.66,2.66,2.66,2.66,+0.04,1.53,7000,2,18620,0,0,0,0,0,0,7000,7000,0,0
20200528,060038,台積電國票99購13,2.43,2.43,2.43,2.43,+0.04,1.67,6000,1,14580,0,0,0,0,0,0,0,6000,-6000,-6000
20200528,060039,大立光國票99購04,2.08,2.08,2.08,2.08,+0.08,4.0,14000,1,29120,0,0,0,0,0,0,0,14000,-14000,-14000
20200528,06003P,亞光康和96售02,,,,,0.00,0.00,0,0,0,0,0,0,0,0,0,0,0,0,0
20200528,060040,康控國票99購04,6.50,6.50,6.40,6.40,+0.05,0.79,30000,6,193300,0,0,0,0,0,0,8000,22000,-14000,-14000
20200528,060041,T50反1群益99購04,0.73,0.78,0.73,0.78,0.00,0.00,20000,2,15100,0,0,0,0,0,0,10000,10000,0,0
20200528,060042,台積電群益99購12,1.35,1.36,1.28,1.28,-0.05,-3.76,138000,9,182190,0,0,0,0,0,0,20000,118000,-98000,-98000
20200528,060043,全新群益9B購02,1.87,1.91,1.86,1.90,+0.02,1.06,238000,13,447130,0,0,0,0,0,0,180000,93000,87000,87000
20200528,060044,大立光群益99購09,,,,,0.00,0.00,0,0,0,0,0,0,0,0,0,0,0,0,0
20200528,060045,嘉晶群益99購02,,,,,0.00,0.00,0,0,0,0,0,0,0,0,0,0,0,0,0
20200528,060046,S&P反1凱基99購02,0.27,0.29,0.27,0.29,-0.01,-3.33,510000,7,145000,0,0,0,0,0,0,120000,390000,-270000,-270000
20200528,060047,道瓊反凱基99購01,0.24,0.25,0.23,0.25,-0.03,-10.71,355000,7,87250,0,0,0,0,0,0,80000,275000,-195000,-195000
20200528,060048,元金2X凱基99購03,1.14,1.16,1.14,1.16,+0.06,5.45,90000,3,103800,0,0,0,0,0,0,40000,50000,-10000,-10000
20200528,060049,華通凱基99購06,2.08,2.08,2.04,2.04,+0.16,8.51,30000,2,61600,0,0,0,0,0,0,20000,10000,10000,10000
20200528,06004P,奇力新永豐96售02,1.03,1.13,1.03,1.13,+0.11,10.78,310000,11,329460,0,0,0,0,0,0,10000,300000,-290000,-290000
20200528,060050,鴻海凱基9B購01,1.35,1.35,1.35,1.35,+0.04,3.05,1000,1,1350,0,0,0,0,0,0,0,1000,-1000,-1000
20200528,060051,台積電凱基9B購01,0.95,0.95,0.95,0.95,-0.01,-1.04,110000,3,104500,0,0,0,0,0,0,80000,30000,50000,50000
20200528,060052,宏碁凱基99購01,1.35,1.38,1.32,1.32,-0.04,-2.94,135000,5,182100,0,0,0,0,0,0,100000,35000,65000,65000
20200528,060053,聯發科凱基9B購02,,,,,0.00,0.00,0,0,0,0,0,0,0,0,0,0,0,0,0
20200528,060054,華新科凱基9B購04,1.27,1.27,1.27,1.27,0.00,0.00,8000,1,10160,0,0,0,0,0,0,8000,8000,0,0
20200528,060055,宏達電凱基99購06,0.79,0.79,0.77,0.77,-0.06,-7.23,8000,2,6240,0,0,0,0,0,0,8000,8000,0,0
20200528,060056,大立光凱基9B購01,0.87,0.88,0.87,0.88,0.00,0.00,30000,2,26200,0,0,0,0,0,0,20000,10000,10000,10000
20200528,060057,欣興凱基9B購01,1.43,1.52,1.43,1.50,+0.07,4.9,27000,4,40340,0,0,0,0,0,0,0,27000,-27000,-27000
20200528,060058,牧德凱基9B購01,1.65,1.65,1.59,1.59,-0.09,-5.36,82000,3,134700,0,0,0,0,0,0,0,82000,-82000,-82000
20200528,060059,鴻海兆豐99購06,1.61,1.61,1.61,1.61,+0.05,3.21,20000,2,32200,0,0,0,0,0,0,10000,10000,0,0
20200528,06005P,晶豪科永豐96售04,0.36,0.38,0.34,0.38,+0.01,2.7,61000,8,21980,0,0,0,0,0,0,13000,48000,-35000,-35000
20200528,060060,台積電兆豐99購05,0.76,0.76,0.73,0.73,-0.03,-3.95,24000,2,17640,0,0,0,0,0,0,24000,0,24000,24000
20200528,060061,旺宏兆豐99購02,1.86,1.87,1.85,1.87,+0.04,2.19,68000,27,126080,0,0,0,0,0,0,68000,0,68000,68000
20200528,060062,聯發科兆豐99購04,,,,,0.00,0.00,0,0,0,0,0,0,0,0,0,0,0,0,0
20200528,060063,可成兆豐9B購01,2.25,2.27,2.18,2.18,-0.04,-1.8,27000,5,60470,0,0,0,0,0,0,8000,20000,-12000,-12000
20200528,060064,華新科兆豐99購07,1.69,1.69,1.69,1.69,-0.03,-1.74,20000,3,33800,0,0,0,0,0,0,20000,0,20000,20000
20200528,060065,大立光兆豐9B購01,1.65,1.65,1.55,1.56,-0.05,-3.11,40000,8,64340,0,0,0,0,0,0,1000,39000,-38000,-38000
20200528,060066,欣興兆豐9B購01,1.75,1.85,1.75,1.85,+0.09,5.11,90000,4,160740,0,0,0,0,0,0,90000,0,90000,90000
20200528,060067,T50反1元富99購11,,,,,0.00,0.00,0,0,0,0,0,0,0,0,0,0,0,0,0
20200528,060068,T50反1元富99購12,,,,,0.00,0.00,0,0,0,0,0,0,0,0,0,0,0,0,0
20200528,060069,T50反1元富99購13,,,,,0.00,0.00,0,0,0,0,0,0,0,0,0,0,0,0,0
20200528,06006P,欣興永豐96售04,0.16,0.16,0.16,0.16,0.00,0.00,20000,1,3200,0,0,0,0,0,0,20000,0,20000,20000
20200528,060070,國巨元富99購02,,,,,0.00,0.00,0,0,0,0,0,0,0,0,0,0,0,0,0
20200528,060071,國巨元富99購03,3.23,3.23,3.07,3.07,-0.08,-2.54,11000,3,34620,0,0,0,0,0,0,5000,6000,-1000,-1000
20200528,060072,國巨元富99購04,2.79,2.80,2.68,2.68,-0.07,-2.55,90000,4,248800,0,0,0,0,0,0,50000,40000,10000,10000
20200528,060073,台積電元富99購03,1.95,1.95,1.88,1.89,-0.06,-3.08,66000,4,125430,0,0,0,0,0,0,12000,54000,-42000,-42000
20200528,060074,台積電元富99購04,,,,,0.00,0.00,0,0,0,0,0,0,0,0,0,0,0,0,0
20200528,060075,台積電元富99購05,1.76,1.76,1.68,1.68,0.00,0.00,30000,3,52100,0,0,0,0,0,0,20000,10000,10000,10000
20200528,060076,台灣50台新9B購05,,,,,0.00,0.00,0,0,0,0,0,0,0,0,0,0,0,0,0
20200528,060077,台積電台新9B購01,1.07,1.07,1.02,1.02,-0.04,-3.77,70000,3,72800,0,0,0,0,0,0,20000,50000,-30000,-30000
20200528,060078,旺宏台新99購03,,,,,0.00,0.00,0,0,0,0,0,0,0,0,0,0,0,0,0
20200528,060079,台郡台新99購03,,,,,0.00,0.00,0,0,0,0,0,0,0,0,0,0,0,0,0
20200528,06007P,世芯永豐96售01,,,,,0.00,0.00,0,0,0,0,0,0,0,0,0,0,0,0,0
20200528,060080,台灣50元大02購01,,,,,0.00,0.00,0,0,0,0,0,0,0,0,0,0,0,0,0
20200528,060081,台灣50元大02購02,,,,,0.00,0.00,0,0,0,0,0,0,0,0,0,0,0,0,0
20200528,060082,臺指反元大9C購06,,,,,0.00,0.00,0,0,0,0,0,0,0,0,0,0,0,0,0
20200528,060083,和大元大99購02,3.18,3.32,3.18,3.32,+0.16,5.06,122000,4,396100,0,0,0,0,0,0,0,122000,-122000,-122000
20200528,060084,聯電元大99購02,1.76,1.82,1.76,1.79,+0.08,4.68,88000,4,157970,0,0,0,0,0,0,41000,47000,-6000,-6000
20200528,060085,華通元大99購10,3.62,3.92,3.59,3.89,+0.45,13.08,140000,11,530750,0,0,0,0,0,0,59000,82000,-23000,-23000
20200528,060086,鴻海元大99購42,2.72,2.72,2.72,2.72,+0.12,4.62,29000,3,78880,0,0,0,0,0,0,29000,0,29000,29000
20200528,060087,鴻海元大99購43,2.37,2.37,2.31,2.31,-0.02,-0.86,101000,7,238810,0,0,0,0,0,0,51000,51000,0,0
20200528,060088,國巨元大99購30,4.90,4.90,4.88,4.88,-0.12,-2.4,7000,2,34200,0,0,0,0,0,0,2000,7000,-5000,-5000
20200528,060089,台積電元大99購54,1.86,1.86,1.85,1.85,0.00,0.00,50000,4,92800,0,0,0,0,0,0,50000,0,50000,50000
20200528,06008P,燿華統一96售04,,,,,0.00,0.00,0,0,0,0,0,0,0,0,0,0,0,0,0
20200528,060090,台積電元大99購55,,,,,0.00,0.00,0,0,0,0,0,0,0,0,0,0,0,0,0
20200528,060091,技嘉元大99購03,3.77,3.77,3.67,3.67,-0.15,-3.93,50000,3,184800,0,0,0,0,0,0,30000,20000,10000,10000
20200528,060092,瑞昱元大99購03,3.01,3.01,2.96,2.96,+0.04,1.37,173000,18,518330,0,0,0,0,0,0,68000,173000,-105000,-105000
20200528,060093,友達元大03購01,2.23,2.26,2.13,2.13,-0.06,-2.74,282000,11,616470,0,0,0,0,0,0,4000,276000,-272000,-272000
20200528,060094,聯發科元大99購41,,,,,0.00,0.00,0,0,0,0,0,0,0,0,0,0,0,0,0
20200528,060095,聯發科元大99購42,6.35,6.35,6.35,6.35,0.00,0.00,5000,1,31750,0,0,0,0,0,0,0,5000,-5000,-5000
20200528,060096,聯發科元大99購43,3.85,3.87,3.60,3.60,-0.16,-4.26,32000,5,123160,0,0,0,0,0,0,32000,1000,31000,31000
20200528,060097,華新科元大99購23,3.05,3.05,3.05,3.05,-0.07,-2.24,36000,2,109800,0,0,0,0,0,0,36000,0,36000,36000
20200528,060098,華新科元大99購24,2.56,2.56,2.48,2.48,-0.13,-4.98,65000,4,164430,0,0,0,0,0,0,55000,10000,45000,45000
20200528,060099,宏達電元大99購09,2.07,2.07,1.83,1.83,-0.20,-9.85,100000,10,192540,0,0,0,0,0,0,35000,85000,-50000,-50000
20200528,06009P,宏達電元富96售03,,,,,0.00,0.00,0,0,0,0,0,0,0,0,0,0,0,0,0
20200528,060100,新光金元大9C購01,1.49,1.49,1.49,1.49,-0.03,-1.97,68000,1,101320,0,0,0,0,0,0,0,68000,-68000,-68000
20200528,060101,大立光元大99購31,1.88,1.88,1.88,1.88,0.00,0.00,50000,1,94000,0,0,0,0,0,0,0,50000,-50000,-50000
20200528,060102,禾伸堂元大99購06,,,,,0.00,0.00,0,0,0,0,0,0,0,0,0,0,0,0,0
20200528,060103,聯詠元大99購01,3.21,3.24,3.21,3.24,-0.04,-1.22,79000,4,254550,0,0,0,0,0,0,51000,79000,-28000,-28000
20200528,060104,新日興元大99購03,2.43,2.64,2.43,2.43,+0.04,1.67,266000,20,672430,0,0,0,0,0,0,89000,177000,-88000,-88000
20200528,060105,牧德元大9B購01,4.70,4.79,4.70,4.79,0.00,0.00,10000,2,47360,0,0,0,0,0,0,10000,10000,0,0
20200528,060106,旭富元大99購02,,,,,0.00,0.00,0,0,0,0,0,0,0,0,0,0,0,0,0
20200528,060107,旭富元大99購03,,,,,0.00,0.00,0,0,0,0,0,0,0,0,0,0,0,0,0
20200528,060108,泰鼎元大99購04,,,,,0.00,0.00,0,0,0,0,0,0,0,0,0,0,0,0,0
20200528,060109,茂林元大99購05,3.42,3.42,3.22,3.22,-0.09,-2.72,19000,3,63080,0,0,0,0,0,0,19000,0,19000,19000
20200528,06010P,國泰金元富96售01,1.04,1.23,1.04,1.23,+0.11,9.82,450000,41,501810,0,0,0,0,0,0,100000,350000,-250000,-250000
20200528,060110,茂林元大99購06,,,,,0.00,0.00,0,0,0,0,0,0,0,0,0,0,0,0,0
20200528,060111,臻鼎元大99購04,3.37,3.43,3.22,3.22,-0.15,-4.45,471000,15,1576240,0,0,0,0,0,0,15000,455000,-440000,-440000
20200528,060112,祥碩元大99購04,,,,,0.00,0.00,0,0,0,0,0,0,0,0,0,0,0,0,0
20200528,060113,祥碩元大9B購01,6.25,6.80,6.15,6.80,+0.55,8.8,45000,7,285900,0,0,0,0,0,0,35000,11000,24000,24000
20200528,060114,緯穎元大99購10,3.34,3.38,3.11,3.11,-0.16,-4.89,9000,5,29100,0,0,0,0,0,0,3000,6000,-3000,-3000
20200528,060115,南電元大99購06,2.33,2.39,2.22,2.22,-0.09,-3.9,180000,15,416400,0,0,0,0,0,0,40000,140000,-100000,-100000
20200528,060116,世紀鋼元大99購07,2.73,3.05,2.73,3.05,0.00,0.00,52000,6,154070,0,0,0,0,0,0,0,51000,-51000,-51000
20200528,060117,國巨國泰9B購04,,,,,0.00,0.00,0,0,0,0,0,0,0,0,0,0,0,0,0
20200528,060118,臺指反富邦9C購01,1.17,1.17,1.17,1.17,0.00,0.00,1000,1,1170,0,0,0,0,0,0,0,1000,-1000,-1000
20200528,060119,上銀富邦9B購03,3.15,3.15,3.15,3.15,-0.04,-1.25,3000,1,9450,0,0,0,0,0,0,3000,0,3000,3000
20200528,06011P,貿聯元富96售04,,,,,0.00,0.00,0,0,0,0,0,0,0,0,0,0,0,0,0
20200528,060120,聯電富邦9B購01,,,,,0.00,0.00,0,0,0,0,0,0,0,0,0,0,0,0,0
20200528,060121,新光金富邦99購01,0.76,0.76,0.70,0.70,-0.04,-5.41,70000,5,50100,0,0,0,0,0,0,20000,50000,-30000,-30000
20200528,060122,亞德客永豐99購02,1.41,1.50,1.40,1.41,+0.01,0.71,385000,27,558800,0,0,0,0,0,0,360000,96000,264000,264000
20200528,060123,光罩永豐99購02,0.89,0.89,0.89,0.89,0.00,0.00,20000,2,17800,0,0,0,0,0,0,0,20000,-20000,-20000
20200528,060124,奇力新永豐99購03,,,,,0.00,0.00,0,0,0,0,0,0,0,0,0,0,0,0,0
20200528,060125,強茂永豐99購01,1.55,1.58,1.52,1.52,-0.07,-4.4,51000,4,79470,0,0,0,0,0,0,20000,31000,-11000,-11000
20200528,060126,創意永豐99購04,1.31,1.35,1.26,1.26,-0.02,-1.56,167000,16,217360,0,0,0,0,0,0,96000,75000,21000,21000
20200528,060127,牧德永豐99購02,1.60,1.60,1.60,1.60,-0.04,-2.44,1000,1,1600,0,0,0,0,0,0,1000,0,1000,1000
20200528,060128,健策永豐99購06,1.86,1.87,1.68,1.68,-0.06,-3.45,164000,24,299360,0,0,0,0,0,0,137000,27000,110000,110000
20200528,060129,祥碩永豐99購03,2.26,2.31,2.26,2.27,0.00,0.00,87000,5,197420,0,0,0,0,0,0,1000,87000,-86000,-86000
20200528,06012P,世芯國票96售01,0.04,0.04,0.04,0.04,0.00,0.00,40000,1,1600,0,0,0,0,0,0,40000,0,40000,40000
20200528,060130,瀚宇博永豐99購02,1.01,1.05,1.00,1.04,+0.02,1.96,471000,15,483620,0,0,0,0,0,0,271000,200000,71000,71000
20200528,060131,GIS永豐99購03,,,,,0.00,0.00,0,0,0,0,0,0,0,0,0,0,0,0,0
20200528,060132,滬深2X群益9C購02,,,,,0.00,0.00,0,0,0,0,0,0,0,0,0,0,0,0,0
20200528,060133,牧德群益9B購01,2.34,2.38,2.25,2.25,-0.11,-4.66,650000,26,1500250,0,0,0,0,0,0,74000,576000,-502000,-502000
20200528,060134,鈺齊群益9A購01,1.79,1.86,1.73,1.73,+0.08,4.85,310000,26,551060,0,0,0,0,0,0,275000,35000,240000,240000
20200528,060135,台灣50國票9C購02,,,,,0.00,0.00,0,0,0,0,0,0,0,0,0,0,0,0,0
20200528,060136,T50反1國票9A購01,,,,,0.00,0.00,0,0,0,0,0,0,0,0,0,0,0,0,0
20200528,060137,T50反1國票9A購02,,,,,0.00,0.00,0,0,0,0,0,0,0,0,0,0,0,0,0
20200528,060138,T50反1國票9A購03,,,,,0.00,0.00,0,0,0,0,0,0,0,0,0,0,0,0,0
20200528,060139,T50反1國票9A購04,,,,,0.00,0.00,0,0,0,0,0,0,0,0,0,0,0,0,0
20200528,06013P,世芯國泰97售03,0.17,0.17,0.15,0.15,+0.02,15.38,128000,3,19600,0,0,0,0,0,0,108000,20000,88000,88000
20200528,060140,T50反1國票9A購05,,,,,0.00,0.00,0,0,0,0,0,0,0,0,0,0,0,0,0
20200528,060141,T50反1國票9B購02,,,,,0.00,0.00,0,0,0,0,0,0,0,0,0,0,0,0,0
20200528,060142,臺指反國票9B購01,,,,,0.00,0.00,0,0,0,0,0,0,0,0,0,0,0,0,0
20200528,060143,台積電國票9B購03,3.69,3.69,3.69,3.69,+0.02,0.54,15000,1,55350,0,0,0,0,0,0,15000,0,15000,15000
20200528,060144,全新國票9B購01,2.33,2.36,2.32,2.32,-0.14,-5.69,182000,14,425570,0,0,0,0,0,0,182000,20000,162000,162000
20200528,060145,牧德國票9A購02,6.65,6.80,6.65,6.80,-0.10,-1.45,10000,2,67250,0,0,0,0,0,0,0,10000,-10000,-10000
20200528,060146,健策國票9A購03,7.15,7.45,6.20,6.20,-0.55,-8.15,425000,23,3034750,0,0,0,0,0,0,151000,348000,-197000,-197000
20200528,060147,臺股指國票9A購07,,,,,0.00,0.00,0,0,0,0,0,0,0,0,0,0,0,0,0
20200528,060148,臺股指國票9A購08,,,,,0.00,0.00,0,0,0,0,0,0,0,0,0,0,0,0,0
20200528,060149,元金2X富邦04購01,,,,,0.00,0.00,0,0,0,0,0,0,0,0,0,0,0,0,0
20200528,06014P,聯發科富邦97售02,0.15,0.15,0.15,0.15,0.00,0.00,110000,1,16500,0,0,0,0,0,0,110000,0,110000,110000
20200528,060150,華通富邦9B購01,,,,,0.00,0.00,0,0,0,0,0,0,0,0,0,0,0,0,0
20200528,060151,旺宏富邦9A購02,1.16,1.16,1.07,1.07,-0.08,-6.96,35000,13,39940,0,0,0,0,0,0,20000,15000,5000,5000
20200528,060152,上証2X永豐9A購02,,,,,0.00,0.00,0,0,0,0,0,0,0,0,0,0,0,0,0
20200528,060153,A50正2永豐9A購01,,,,,0.00,0.00,0,0,0,0,0,0,0,0,0,0,0,0,0
20200528,060154,堤維西永豐9A購01,1.09,1.09,1.07,1.09,0.00,0.00,192000,17,207240,0,0,0,0,0,0,192000,0,192000,192000
20200528,060155,友訊永豐9A購01,0.73,0.76,0.73,0.76,+0.01,1.33,126000,4,93720,0,0,0,0,0,0,68000,58000,10000,10000
20200528,060156,光磊永豐9A購01,1.10,1.14,1.09,1.14,+0.02,1.79,324000,11,359890,0,0,0,0,0,0,167000,159000,8000,8000
20200528,060157,致茂永豐9A購02,0.76,0.79,0.75,0.77,-0.02,-2.53,308000,13,235790,0,0,0,0,0,0,295000,13000,282000,282000
20200528,060158,廣達永豐9A購01,1.30,1.31,1.27,1.31,-0.02,-1.5,246000,17,317080,0,0,0,0,0,0,105000,141000,-36000,-36000
20200528,060159,健和興永豐9A購01,2.39,2.56,1.87,1.93,-0.22,-10.23,368000,55,845040,0,0,0,0,0,0,210000,133000,77000,77000
20200528,06015P,大立光富邦98售04,0.40,0.40,0.40,0.40,0.00,0.00,9000,1,3600,0,0,0,0,0,0,0,0,0,0
20200528,060160,聯陽永豐9A購01,2.70,2.70,2.70,2.70,+0.03,1.12,5000,1,13500,0,0,0,0,0,0,0,5000,-5000,-5000
20200528,060161,牧德永豐9A購02,1.54,1.54,1.54,1.54,-0.06,-3.75,10000,1,15400,0,0,0,0,0,0,0,10000,-10000,-10000
20200528,060162,碩天永豐9A購01,1.12,1.14,1.12,1.14,+0.03,2.7,348000,6,393240,0,0,0,0,0,0,0,348000,-348000,-348000
20200528,060163,健策永豐9B購01,1.87,1.87,1.70,1.71,-0.19,-10.0,106000,16,196810,0,0,0,0,0,0,94000,12000,82000,82000
20200528,060164,合勤控永豐9A購01,1.53,1.53,1.44,1.44,-0.13,-8.28,703000,54,1049680,0,0,0,0,0,0,693000,10000,683000,683000
20200528,060165,上緯控永豐9A購01,2.29,2.29,2.03,2.03,-0.16,-7.31,564000,52,1238790,0,0,0,0,0,0,500000,19000,481000,481000
20200528,060166,佐登永豐9A購01,1.30,1.32,1.30,1.32,0.00,0.00,28000,4,36620,0,0,0,0,0,0,17000,11000,6000,6000
20200528,060167,禾聯碩永豐9A購01,,,,,0.00,0.00,0,0,0,0,0,0,0,0,0,0,0,0,0
20200528,060168,台表科永豐9A購01,,,,,0.00,0.00,0,0,0,0,0,0,0,0,0,0,0,0,0
20200528,060169,群電永豐9A購01,1.84,1.94,1.71,1.74,-0.08,-4.4,311000,24,553060,0,0,0,0,0,0,275000,32000,243000,243000
20200528,06016P,京元電凱基96售03,0.49,0.50,0.49,0.50,+0.05,11.11,15000,3,7470,0,0,0,0,0,0,0,15000,-15000,-15000
20200528,060170,世紀鋼永豐9A購01,1.20,1.47,1.20,1.47,+0.20,15.75,397000,37,528800,0,0,0,0,0,0,158000,239000,-81000,-81000
20200528,060171,宏達電台新9A購01,1.12,1.12,1.00,1.00,-0.09,-8.26,32000,2,34640,0,0,0,0,0,0,32000,0,32000,32000
20200528,060172,智原台新9A購01,1.38,1.38,1.29,1.29,-0.06,-4.44,128000,12,173200,0,0,0,0,0,0,78000,50000,28000,28000
20200528,060173,台灣50元富02購01,,,,,0.00,0.00,0,0,0,0,0,0,0,0,0,0,0,0,0
20200528,060174,T50反1元富04購01,0.76,0.78,0.76,0.78,0.00,0.00,10000,2,7700,0,0,0,0,0,0,5000,5000,0,0
20200528,060175,T50反1元富04購02,,,,,0.00,0.00,0,0,0,0,0,0,0,0,0,0,0,0,0
20200528,060176,T50反1元富04購03,,,,,0.00,0.00,0,0,0,0,0,0,0,0,0,0,0,0,0
20200528,060177,T50反1元富04購04,,,,,0.00,0.00,0,0,0,0,0,0,0,0,0,0,0,0,0
20200528,060178,T50反1元富04購05,,,,,0.00,0.00,0,0,0,0,0,0,0,0,0,0,0,0,0
20200528,060179,T50反1元富04購06,,,,,0.00,0.00,0,0,0,0,0,0,0,0,0,0,0,0,0
20200528,06017P,亞光凱基96售04,2.23,2.33,2.23,2.33,0.00,0.00,20000,2,45600,0,0,0,0,0,0,0,20000,-20000,-20000
20200528,060180,上証2X元富9A購02,,,,,0.00,0.00,0,0,0,0,0,0,0,0,0,0,0,0,0
20200528,060181,華通元富9A購01,,,,,0.00,0.00,0,0,0,0,0,0,0,0,0,0,0,0,0
20200528,060182,旺宏元富9A購01,,,,,0.00,0.00,0,0,0,0,0,0,0,0,0,0,0,0,0
20200528,060183,南亞科元富9A購01,3.11,3.21,2.91,2.91,0.00,0.00,258000,40,804250,0,0,0,0,0,0,162000,96000,66000,66000
20200528,060184,建準元富9A購01,,,,,0.00,0.00,0,0,0,0,0,0,0,0,0,0,0,0,0
20200528,060185,聯發科元富04購01,3.28,3.28,3.15,3.21,-0.01,-0.31,11000,5,35060,0,0,0,0,0,0,1000,10000,-9000,-9000
20200528,060186,義隆元富9A購01,1.65,1.81,1.65,1.71,+0.05,3.01,1770000,116,3061260,0,0,0,0,0,0,1148000,468000,680000,680000
20200528,060187,華新科元富9A購02,1.59,1.60,1.53,1.53,-0.05,-3.16,175000,24,276580,0,0,0,0,0,0,165000,10000,155000,155000
20200528,060188,華新科元富9A購03,1.93,1.95,1.83,1.83,-0.12,-6.15,87000,22,166710,0,0,0,0,0,0,79000,8000,71000,71000
20200528,060189,宏達電元富9B購03,1.13,1.13,1.08,1.08,-0.02,-1.82,116000,2,126830,0,0,0,0,0,0,31000,85000,-54000,-54000
20200528,06018P,康控凱基96售03,1.21,1.21,1.21,1.21,+0.01,0.83,1000,1,1210,0,0,0,0,0,0,1000,0,1000,1000
20200528,060190,國泰金元富9A購01,2.74,2.76,2.59,2.59,-0.10,-3.72,18000,4,48810,0,0,0,0,0,0,13000,5000,8000,8000
20200528,060191,亞光元富9A購02,1.97,2.00,1.80,1.80,-0.15,-7.69,143000,15,281700,0,0,0,0,0,0,131000,12000,119000,119000
20200528,060192,欣興元富9A購01,,,,,0.00,0.00,0,0,0,0,0,0,0,0,0,0,0,0,0
20200528,060193,群創元富9A購01,1.28,1.28,1.26,1.26,+0.01,0.8,174000,2,220800,0,0,0,0,0,0,96000,78000,18000,18000
20200528,060194,旭富元富9A購01,1.37,1.41,1.37,1.41,+0.01,0.71,160000,2,222400,0,0,0,0,0,0,80000,80000,0,0
20200528,060195,旭富元富9A購02,,,,,0.00,0.00,0,0,0,0,0,0,0,0,0,0,0,0,0
20200528,060196,泰鼎元富9A購01,,,,,0.00,0.00,0,0,0,0,0,0,0,0,0,0,0,0,0
20200528,060197,臻鼎元富9A購02,2.45,2.48,2.22,2.22,-0.17,-7.11,320000,19,755000,0,0,0,0,0,0,159000,136000,23000,23000
20200528,060198,祥碩元富9A購02,,,,,0.00,0.00,0,0,0,0,0,0,0,0,0,0,0,0,0
20200528,060199,台郡元富9A購01,2.34,2.34,2.27,2.34,-0.05,-2.09,122000,17,281290,0,0,0,0,0,0,122000,0,122000,122000
20200528,06019P,緯穎凱基96售03,,,,,0.00,0.00,0,0,0,0,0,0,0,0,0,0,0,0,0
20200528,060200,同欣電元富9A購01,4.01,4.01,4.01,4.01,0.00,0.00,2000,1,8020,0,0,0,0,0,0,0,2000,-2000,-2000
20200528,060201,台表科元富9A購01,,,,,0.00,0.00,0,0,0,0,0,0,0,0,0,0,0,0,0
20200528,060202,康友元富9A購01,,,,,0.00,0.00,0,0,0,0,0,0,0,0,0,0,0,0,0
20200528,060203,緯穎元富9A購01,3.60,3.70,3.34,3.35,-0.36,-9.7,285000,36,1028040,0,0,0,0,0,0,243000,42000,201000,201000
20200528,060204,矽創元富9A購01,2.46,2.74,2.44,2.54,+0.24,10.43,629000,44,1659700,0,0,0,0,0,0,97000,522000,-425000,-425000
20200528,060205,台灣50麥證02購01,,,,,0.00,0.00,0,0,0,0,0,0,0,0,0,0,0,0,0
20200528,060206,臺股指麥證9A購01,,,,,0.00,0.00,0,0,0,0,0,0,0,0,0,0,0,0,0
20200528,060207,臺股指麥證9A購02,,,,,0.00,0.00,0,0,0,0,0,0,0,0,0,0,0,0,0
20200528,060208,卜蜂康和9A購01,2.43,2.43,2.37,2.43,0.00,0.00,37000,7,89340,0,0,0,0,0,0,5000,32000,-27000,-27000
20200528,060209,喬山康和9A購01,4.10,4.12,3.58,3.59,-0.38,-9.57,114000,15,457980,0,0,0,0,0,0,99000,15000,84000,84000
20200528,06020P,燿華元富96售04,,,,,0.00,0.00,0,0,0,0,0,0,0,0,0,0,0,0,0
20200528,060210,上銀康和9A購01,,,,,0.00,0.00,0,0,0,0,0,0,0,0,0,0,0,0,0
20200528,060211,智邦康和9A購01,,,,,0.00,0.00,0,0,0,0,0,0,0,0,0,0,0,0,0
20200528,060212,華航康和9A購01,1.26,1.27,1.17,1.17,-0.06,-4.88,138000,10,173140,0,0,0,0,0,0,124000,14000,110000,110000
20200528,060213,牧德康和9A購01,,,,,0.00,0.00,0,0,0,0,0,0,0,0,0,0,0,0,0
20200528,060214,茂林康和9A購01,2.93,2.93,2.80,2.80,-0.05,-1.75,108000,33,312940,0,0,0,0,0,0,106000,2000,104000,104000
20200528,060215,柏文康和9A購01,,,,,0.00,0.00,0,0,0,0,0,0,0,0,0,0,0,0,0
20200528,060216,鴻海凱基9A購17,1.06,1.06,1.06,1.06,0.00,0.00,1000,1,1060,0,0,0,0,0,0,1000,1000,0,0
20200528,060217,國巨凱基9A購10,,,,,0.00,0.00,0,0,0,0,0,0,0,0,0,0,0,0,0
20200528,060218,台積電凱基9A購15,,,,,0.00,0.00,0,0,0,0,0,0,0,0,0,0,0,0,0
20200528,060219,聯發科凱基9A購09,,,,,0.00,0.00,0,0,0,0,0,0,0,0,0,0,0,0,0
20200528,06021P,世紀鋼元富96售03,0.24,0.25,0.24,0.25,-0.12,-32.43,71000,5,17270,0,0,0,0,0,0,0,71000,-71000,-71000
20200528,060220,華新科凱基9A購08,1.26,1.26,1.26,1.26,-0.05,-3.82,50000,5,63000,0,0,0,0,0,0,0,50000,-50000,-50000
20200528,060221,大立光凱基9A購07,0.81,0.81,0.81,0.81,-0.02,-2.41,2000,1,1620,0,0,0,0,0,0,0,2000,-2000,-2000
20200528,060222,貿聯凱基9A購02,1.48,1.52,1.43,1.43,-0.02,-1.38,232000,26,342520,0,0,0,0,0,0,52000,180000,-128000,-128000
20200528,060223,台灣50元大9A購05,,,,,0.00,0.00,0,0,0,0,0,0,0,0,0,0,0,0,0
20200528,060224,台灣50元大9A購09,,,,,0.00,0.00,0,0,0,0,0,0,0,0,0,0,0,0,0
20200528,060225,S&P反1元大9A購02,0.34,0.34,0.34,0.34,0.00,0.00,1000,1,340,0,0,0,0,0,0,0,0,0,0
20200528,060226,道瓊反元大9A購01,0.33,0.35,0.33,0.34,-0.14,-29.17,106000,11,35890,0,0,0,0,0,0,38000,66000,-28000,-28000
20200528,060227,和大元大9A購01,3.35,3.52,3.35,3.50,+0.18,5.42,52000,5,180900,0,0,0,0,0,0,25000,27000,-2000,-2000
20200528,060228,亞德客元大9A購01,3.96,4.15,3.54,3.54,-0.25,-6.6,243000,25,942000,0,0,0,0,0,0,193000,115000,78000,78000
20200528,060229,楠梓電元大9C購01,3.70,3.71,3.47,3.47,-0.17,-4.67,51000,6,188490,0,0,0,0,0,0,1000,50000,-49000,-49000
20200528,06022P,緯穎永豐96售03,,,,,0.00,0.00,0,0,0,0,0,0,0,0,0,0,0,0,0
20200528,060230,台積電元大9A購07,2.30,2.30,2.20,2.20,-0.06,-2.65,87000,5,196440,0,0,0,0,0,0,4000,87000,-83000,-83000
20200528,060231,台積電元大9A購08,1.85,1.85,1.75,1.75,-0.04,-2.23,31000,3,54350,0,0,0,0,0,0,0,31000,-31000,-31000
20200528,060232,友訊元大9C購01,1.55,1.57,1.52,1.57,+0.01,0.64,186000,7,288740,0,0,0,0,0,0,43000,143000,-100000,-100000
20200528,060233,宏碁元大9A購01,1.60,1.60,1.52,1.52,-0.05,-3.18,131000,8,206640,0,0,0,0,0,0,116000,5000,111000,111000
20200528,060234,凱美元大9C購01,2.92,3.13,2.90,3.05,+0.16,5.54,630000,39,1882600,0,0,0,0,0,0,194000,428000,-234000,-234000
20200528,060235,瑞昱元大9A購01,3.78,3.93,3.78,3.85,+0.07,1.85,108000,19,418770,0,0,0,0,0,0,72000,97000,-25000,-25000
20200528,060236,精元元大9C購01,3.43,3.75,3.33,3.59,+0.40,12.54,834000,66,2949440,8000,0,8000,0,0,0,101000,752000,-651000,-643000
20200528,060237,友達元大9A購06,1.96,1.99,1.87,1.87,-0.06,-3.11,137000,8,268230,0,0,0,0,0,0,57000,82000,-25000,-25000
20200528,060238,強茂元大9C購01,3.76,3.76,3.60,3.60,-0.16,-4.26,256000,16,953900,0,0,0,0,0,0,244000,12000,232000,232000
20200528,060239,國揚元大9C購01,2.62,2.76,2.56,2.76,+0.14,5.34,451000,24,1201930,0,0,0,0,0,0,323000,123000,200000,200000
20200528,06023P,超眾國票96售03,1.21,1.21,1.21,1.21,-0.04,-3.2,4000,1,4840,0,0,0,0,0,0,0,4000,-4000,-4000
20200528,060240,富邦金元大9A購01,3.04,3.04,2.78,2.79,-0.19,-6.38,193000,7,551870,0,0,0,0,0,0,25000,168000,-143000,-143000
20200528,060241,國泰金元大9A購01,2.77,2.77,2.77,2.77,-0.02,-0.72,43000,1,119110,0,0,0,0,0,0,0,43000,-43000,-43000
20200528,060242,潤泰全元大9C購01,1.23,1.24,1.15,1.15,-0.05,-4.17,507000,18,617850,0,0,0,0,0,0,397000,110000,287000,287000
20200528,060243,潤泰全元大9C購02,1.10,1.11,1.07,1.07,-0.01,-0.93,516000,21,563810,0,0,0,0,0,0,366000,150000,216000,216000
20200528,060244,大立光元大9B購02,2.23,2.23,2.11,2.11,-0.07,-3.21,100000,3,217000,0,0,0,0,0,0,50000,50000,0,0
20200528,060245,聯陽元大9C購01,4.63,4.63,4.52,4.52,-0.07,-1.53,79000,7,361020,0,0,0,0,0,0,69000,10000,59000,59000
20200528,060246,晶相光元大9C購03,2.53,2.53,2.40,2.40,-0.19,-7.34,140000,13,350360,0,0,0,0,0,0,129000,11000,118000,118000
20200528,060247,牧德元大9A購02,,,,,0.00,0.00,0,0,0,0,0,0,0,0,0,0,0,0,0
20200528,060248,日月光元大9A購01,2.26,2.26,2.17,2.21,+0.02,0.91,193000,7,426750,0,0,0,0,0,0,140000,53000,87000,87000
20200528,060249,正文元大9C購01,2.26,2.33,2.25,2.25,+0.01,0.45,203000,9,465090,0,0,0,0,0,0,30000,173000,-143000,-143000
20200528,06024P,台郡國票97售05,,,,,0.00,0.00,0,0,0,0,0,0,0,0,0,0,0,0,0
20200528,060250,台表科元大9A購01,,,,,0.00,0.00,0,0,0,0,0,0,0,0,0,0,0,0,0
20200528,060251,易華電元大9C購01,2.76,2.76,2.68,2.68,-0.18,-6.29,7000,3,18840,0,0,0,0,0,0,4000,3000,1000,1000
20200528,060252,緯穎元大9A購02,3.33,3.40,3.27,3.40,+0.02,0.59,113000,10,377390,0,0,0,0,0,0,50000,63000,-13000,-13000
20200528,060253,昇陽半元大9C購01,3.38,3.52,3.32,3.32,-0.02,-0.6,144000,15,501450,0,0,0,0,0,0,0,144000,-144000,-144000
20200528,060254,世紀鋼元大9A購01,2.52,2.90,2.51,2.90,+0.37,14.62,395000,33,1066130,0,0,0,0,0,0,106000,287000,-181000,-181000
20200528,060255,臺股指元大9B購06,,,,,0.00,0.00,0,0,0,0,0,0,0,0,0,0,0,0,0
20200528,060256,臺股指元大9B購07,,,,,0.00,0.00,0,0,0,0,0,0,0,0,0,0,0,0,0
20200528,060257,臺股指元大9B購08,,,,,0.00,0.00,0,0,0,0,0,0,0,0,0,0,0,0,0
20200528,060258,T50反1凱基9A購06,0.84,0.91,0.84,0.91,+0.04,4.6,130000,5,113600,0,0,0,0,0,0,50000,80000,-30000,-30000
20200528,060259,潤泰全凱基9C購01,0.83,0.85,0.82,0.83,0.00,0.00,123000,7,102160,0,0,0,0,0,0,117000,6000,111000,111000
20200528,06025P,臺股指元大99售02,1.85,1.91,1.85,1.91,+0.04,2.14,66000,9,125090,0,0,0,0,0,0,66000,0,66000,66000
20200528,060260,京鼎凱基9C購01,2.37,2.38,2.35,2.37,+0.05,2.16,49000,4,115910,0,0,0,0,0,0,39000,27000,12000,12000
20200528,060261,臺股指凱基9A購04,,,,,0.00,0.00,0,0,0,0,0,0,0,0,0,0,0,0,0
20200528,060262,臺股指凱基9B購02,4.77,4.77,4.39,4.41,-0.28,-5.97,35000,10,160120,0,0,0,0,0,0,33000,2000,31000,31000
20200528,060263,臺指反國票9C購01,,,,,0.00,0.00,0,0,0,0,0,0,0,0,0,0,0,0,0
20200528,060264,華新科國票9A購02,4.87,4.87,4.81,4.81,+0.10,2.12,6000,2,29040,0,0,0,0,0,0,3000,3000,0,0
20200528,060265,宏達電國票9A購02,2.00,2.00,1.83,1.83,-0.17,-8.5,518000,6,958080,0,0,0,0,0,0,443000,75000,368000,368000
20200528,060266,潤泰全國票9A購01,1.72,1.72,1.71,1.71,+0.02,1.18,44000,2,75580,0,0,0,0,0,0,34000,10000,24000,24000
20200528,060267,上緯控國票9C購01,3.97,4.03,3.82,3.82,-0.21,-5.21,48000,4,190460,0,0,0,0,0,0,28000,20000,8000,8000
20200528,060268,台灣50元大9C購20,,,,,0.00,0.00,0,0,0,0,0,0,0,0,0,0,0,0,0
20200528,060269,台灣50元大9C購21,,,,,0.00,0.00,0,0,0,0,0,0,0,0,0,0,0,0,0
20200528,06026P,華通台新97售01,,,,,0.00,0.00,0,0,0,0,0,0,0,0,0,0,0,0,0
20200528,060270,台灣50元大9C購22,,,,,0.00,0.00,0,0,0,0,0,0,0,0,0,0,0,0,0
20200528,060271,台灣50元大9C購23,,,,,0.00,0.00,0,0,0,0,0,0,0,0,0,0,0,0,0
20200528,060272,台灣50元大9C購25,,,,,0.00,0.00,0,0,0,0,0,0,0,0,0,0,0,0,0
20200528,060273,T50反1元大9A購03,,,,,0.00,0.00,0,0,0,0,0,0,0,0,0,0,0,0,0
20200528,060274,T50反1元大9A購04,,,,,0.00,0.00,0,0,0,0,0,0,0,0,0,0,0,0,0
20200528,060275,元黃金元大9A購01,1.22,1.27,1.22,1.26,+0.06,5.0,230000,4,281900,0,0,0,0,0,0,200000,30000,170000,170000
20200528,060276,S&P反1元大9A購03,,,,,0.00,0.00,0,0,0,0,0,0,0,0,0,0,0,0,0
20200528,060277,道瓊反元大9A購02,0.55,0.57,0.55,0.57,-0.08,-12.31,549000,2,302950,0,0,0,0,0,0,499000,50000,449000,449000
20200528,060278,道瓊反元大9A購03,0.55,0.55,0.55,0.55,0.00,0.00,15000,1,8250,0,0,0,0,0,0,15000,0,15000,15000
20200528,060279,SP黃豆元大9A購01,0.71,0.71,0.71,0.71,0.00,0.00,10000,1,7100,0,0,0,0,0,0,10000,0,10000,10000
20200528,06027P,鴻海台新96售04,,,,,0.00,0.00,0,0,0,0,0,0,0,0,0,0,0,0,0
20200528,060280,元金2X元大9A購01,,,,,0.00,0.00,0,0,0,0,0,0,0,0,0,0,0,0,0
20200528,060281,卜蜂元大9C購01,3.34,3.44,3.33,3.44,-0.01,-0.29,100000,5,340990,0,0,0,0,0,0,91000,9000,82000,82000
20200528,060282,聚陽元大9A購01,5.05,5.10,4.86,4.91,-0.39,-7.36,31000,8,155220,0,0,0,0,0,0,16000,20000,-4000,-4000
20200528,060283,台肥元大9C購01,2.44,2.46,2.43,2.43,-0.01,-0.41,169000,10,412150,0,0,0,0,0,0,15000,151000,-136000,-136000
20200528,060284,南港元大01購01,2.07,2.11,1.93,1.93,-0.16,-7.66,741000,30,1515250,0,0,0,0,0,0,381000,350000,31000,31000
20200528,060285,聯電元大9C購01,1.79,1.87,1.79,1.86,+0.09,5.08,220000,9,404960,0,0,0,0,0,0,50000,170000,-120000,-120000
20200528,060286,佳世達元大9C購01,2.13,2.15,2.13,2.13,+0.05,2.4,69000,5,147270,0,0,0,0,0,0,34000,35000,-1000,-1000
20200528,060287,燿華元大9A購01,2.85,2.85,2.80,2.80,-0.08,-2.78,45000,4,127340,0,0,0,0,0,0,0,45000,-45000,-45000
20200528,060288,群光元大9C購01,2.56,2.67,2.55,2.58,0.00,0.00,557000,46,1441530,0,0,0,0,0,0,434000,179000,255000,255000
20200528,060289,京元電元大9A購01,2.01,2.01,1.90,1.91,-0.08,-4.02,361000,21,704820,30000,0,30000,0,0,0,147000,264000,-117000,-87000
20200528,06028P,智邦台新97售01,,,,,0.00,0.00,0,0,0,0,0,0,0,0,0,0,0,0,0
20200528,060290,興富發元大9C購01,2.57,2.64,2.52,2.53,0.00,0.00,1041000,40,2695780,0,0,0,0,0,0,4000,1037000,-1033000,-1033000
20200528,060291,高鐵元大9A購01,9.25,9.25,8.70,8.70,-0.25,-2.79,25000,4,229100,0,0,0,0,0,0,20000,5000,15000,15000
20200528,060292,聯詠元大9A購01,,,,,0.00,0.00,0,0,0,0,0,0,0,0,0,0,0,0,0
20200528,060293,緯創元大9A購01,3.08,3.11,3.01,3.01,-0.02,-0.66,204000,24,629110,0,0,0,0,0,0,116000,88000,28000,28000
20200528,060294,嘉澤元大9A購01,6.45,6.45,6.45,6.45,-0.20,-3.01,1000,1,6450,0,0,0,0,0,0,0,1000,-1000,-1000
20200528,060295,貿聯元大9A購03,3.34,3.39,3.34,3.39,+0.11,3.35,203000,11,680170,0,0,0,0,0,0,93000,110000,-17000,-17000
20200528,060296,和碩元大9A購01,2.50,2.55,2.46,2.47,-0.12,-4.63,181000,6,454280,0,0,0,0,0,0,0,181000,-181000,-181000
20200528,060297,和碩元大9A購02,2.11,2.12,2.05,2.05,-0.09,-4.21,233000,8,491460,0,0,0,0,0,0,50000,183000,-133000,-133000
20200528,060298,鎧勝元大9C購01,3.50,3.50,3.45,3.45,+0.05,1.47,65000,2,226750,15000,0,15000,0,0,0,0,65000,-65000,-50000
20200528,060299,友訊國泰9B購01,1.00,1.00,0.99,0.99,-0.02,-1.98,108000,4,107400,0,0,0,0,0,0,0,108000,-108000,-108000
20200528,06029P,聯發科台新96售02,,,,,0.00,0.00,0,0,0,0,0,0,0,0,0,0,0,0,0
20200528,060300,佐登國泰9B購01,1.81,1.81,1.81,1.81,-0.08,-4.23,1000,1,1810,0,0,0,0,0,0,1000,0,1000,1000
20200528,060301,國巨富邦9C購02,1.26,1.27,1.26,1.27,+0.02,1.6,50000,5,63200,0,0,0,0,0,0,50000,0,50000,50000
20200528,060302,台積電富邦02購01,0.87,0.87,0.83,0.83,-0.02,-2.35,309000,6,266150,0,0,0,0,0,0,180000,129000,51000,51000
20200528,060303,宏達電富邦9B購01,0.76,0.76,0.69,0.69,-0.06,-8.0,158000,13,114840,0,0,0,0,0,0,158000,16000,142000,142000
20200528,060304,大立光富邦9C購05,,,,,0.00,0.00,0,0,0,0,0,0,0,0,0,0,0,0,0
20200528,060305,得力永豐9A購01,1.55,1.55,1.50,1.50,-0.10,-6.25,98000,3,148430,0,0,0,0,0,0,98000,0,98000,98000
20200528,060306,台肥永豐9A購01,1.31,1.31,1.29,1.29,-0.02,-1.53,44000,4,56960,0,0,0,0,0,0,10000,34000,-24000,-24000
20200528,060307,南港永豐9A購01,0.97,1.00,0.97,1.00,+0.01,1.01,162000,5,158440,0,0,0,0,0,0,162000,0,162000,162000
20200528,060308,劍麟永豐9A購01,1.15,1.20,1.10,1.10,-0.06,-5.17,1444000,94,1681700,0,0,0,0,0,0,1406000,33000,1373000,1373000
20200528,060309,佳世達永豐9A購01,0.88,0.89,0.88,0.89,+0.01,1.14,181000,3,160520,0,0,0,0,0,0,57000,124000,-67000,-67000
20200528,06030P,友達兆豐96售02,,,,,0.00,0.00,0,0,0,0,0,0,0,0,0,0,0,0,0
20200528,060310,瑞昱永豐9A購01,1.29,1.31,1.29,1.30,+0.05,4.0,82000,8,106580,0,0,0,0,0,0,22000,40000,-18000,-18000
20200528,060311,盟立永豐9A購01,1.29,1.29,1.29,1.29,0.00,0.00,10000,1,12900,0,0,0,0,0,0,0,0,0,0
20200528,060312,潤泰全永豐9A購01,0.65,0.66,0.64,0.66,-0.01,-1.49,392000,17,254880,0,0,0,0,0,0,392000,0,392000,392000
20200528,060313,淘帝永豐9A購01,0.69,0.69,0.66,0.66,-0.05,-7.04,89000,4,60380,0,0,0,0,0,0,9000,80000,-71000,-71000
20200528,060314,元翎永豐9A購01,1.09,1.18,1.07,1.07,-0.11,-9.32,119000,7,132780,0,0,0,0,0,0,98000,21000,77000,77000
20200528,060315,易華電永豐9A購01,1.43,1.43,1.31,1.31,-0.11,-7.75,25000,4,34970,0,0,0,0,0,0,12000,13000,-1000,-1000
20200528,060316,福懋科永豐9A購01,,,,,0.00,0.00,0,0,0,0,0,0,0,0,0,0,0,0,0
20200528,060317,台灣50群益02購01,2.39,2.39,2.35,2.38,0.00,0.00,35000,6,83350,0,0,0,0,0,0,0,35000,-35000,-35000
20200528,060318,上証2X群益9C購03,,,,,0.00,0.00,0,0,0,0,0,0,0,0,0,0,0,0,0
20200528,060319,臺指反群益9A購02,,,,,0.00,0.00,0,0,0,0,0,0,0,0,0,0,0,0,0
20200528,06031P,新光金兆豐96售02,,,,,0.00,0.00,0,0,0,0,0,0,0,0,0,0,0,0,0
20200528,060320,元金2X群益02購01,,,,,0.00,0.00,0,0,0,0,0,0,0,0,0,0,0,0,0
20200528,060321,元金2X群益9B購01,1.79,1.79,1.79,1.79,0.00,0.00,5000,1,8950,0,0,0,0,0,0,5000,0,5000,5000
20200528,060322,卜蜂群益9A購01,2.52,2.55,2.52,2.55,-0.02,-0.78,37000,3,94260,0,0,0,0,0,0,30000,7000,23000,23000
20200528,060323,華通群益9C購01,2.54,2.54,2.54,2.54,+0.31,13.9,30000,1,76200,0,0,0,0,0,0,30000,0,30000,30000
20200528,060324,台積電群益9B購02,1.90,1.90,1.81,1.81,-0.06,-3.21,71000,2,134180,0,0,0,0,0,0,0,71000,-71000,-71000
20200528,060325,旺宏群益9A購02,,,,,0.00,0.00,0,0,0,0,0,0,0,0,0,0,0,0,0
20200528,060326,群光群益9A購01,2.63,2.75,2.58,2.62,+0.02,0.77,440000,32,1156530,0,0,0,0,0,0,355000,48000,307000,307000
20200528,060327,美律群益9A購02,1.45,1.47,1.42,1.42,+0.06,4.41,375000,5,541380,0,0,0,0,0,0,85000,290000,-205000,-205000
20200528,060328,可成群益9A購06,2.75,2.76,2.67,2.67,-0.07,-2.55,17000,4,45910,0,0,0,0,0,0,7000,12000,-5000,-5000
20200528,060329,鎧勝群益9B購01,1.81,1.81,1.73,1.74,-0.01,-0.57,210000,5,371860,0,0,0,0,0,0,106000,104000,2000,2000
20200528,06032P,健策群益97售03,,,,,0.00,0.00,0,0,0,0,0,0,0,0,0,0,0,0,0
20200528,060330,台灣50麥證9A購03,,,,,0.00,0.00,0,0,0,0,0,0,0,0,0,0,0,0,0
20200528,060331,台積電麥證9A購01,,,,,0.00,0.00,0,0,0,0,0,0,0,0,0,0,0,0,0
20200528,060332,聯發科麥證9A購01,,,,,0.00,0.00,0,0,0,0,0,0,0,0,0,0,0,0,0
20200528,060333,金寶康和9A購01,1.72,1.77,1.69,1.69,0.00,0.00,42000,3,72940,0,0,0,0,0,0,0,42000,-42000,-42000
20200528,060334,群光康和9A購01,3.72,3.82,3.69,3.82,+0.10,2.69,48000,3,178630,0,0,0,0,0,0,41000,7000,34000,34000
20200528,060335,明泰康和9A購01,,,,,0.00,0.00,0,0,0,0,0,0,0,0,0,0,0,0,0
20200528,060336,南電康和9A購01,1.33,1.33,1.19,1.19,-0.03,-2.46,42000,5,53600,0,0,0,0,0,0,10000,32000,-22000,-22000
20200528,060337,FBVIX統一9A購01,0.41,0.43,0.41,0.43,+0.01,2.38,132000,8,56420,0,0,0,0,0,0,12000,120000,-108000,-108000
20200528,060338,鴻海統一9C購02,0.92,0.92,0.92,0.92,+0.01,1.1,49000,1,45080,0,0,0,0,0,0,0,49000,-49000,-49000
20200528,060339,國巨統一01購01,1.92,1.95,1.86,1.86,-0.05,-2.62,76000,5,146520,0,0,0,0,0,0,36000,40000,-4000,-4000
20200528,06033P,可成凱基96售09,,,,,0.00,0.00,0,0,0,0,0,0,0,0,0,0,0,0,0
20200528,060340,國巨統一01購02,1.43,1.43,1.41,1.41,-0.02,-1.4,20000,2,28500,0,0,0,0,0,0,5000,15000,-10000,-10000
20200528,060341,國巨統一9C購02,1.38,1.38,1.34,1.34,0.00,0.00,150000,6,204260,0,0,0,0,0,0,69000,81000,-12000,-12000
20200528,060342,台積電統一02購01,1.24,1.24,1.20,1.20,0.00,0.00,31000,3,37600,0,0,0,0,0,0,0,31000,-31000,-31000
20200528,060343,台積電統一9C購02,,,,,0.00,0.00,0,0,0,0,0,0,0,0,0,0,0,0,0
20200528,060344,聯發科統一01購01,,,,,0.00,0.00,0,0,0,0,0,0,0,0,0,0,0,0,0
20200528,060345,聯發科統一9B購05,,,,,0.00,0.00,0,0,0,0,0,0,0,0,0,0,0,0,0
20200528,060346,華新科統一01購01,1.54,1.54,1.48,1.48,-0.04,-2.63,160000,5,242150,0,0,0,0,0,0,100000,60000,40000,40000
20200528,060347,大立光統一02購01,1.03,1.03,0.97,0.97,-0.04,-3.96,37000,2,37090,0,0,0,0,0,0,17000,20000,-3000,-3000
20200528,060348,上証2X元富9A購03,,,,,0.00,0.00,0,0,0,0,0,0,0,0,0,0,0,0,0
20200528,060349,上証2X元富9A購04,,,,,0.00,0.00,0,0,0,0,0,0,0,0,0,0,0,0,0
20200528,06034P,世芯凱基96售03,,,,,0.00,0.00,0,0,0,0,0,0,0,0,0,0,0,0,0
20200528,060350,元黃金元富9B購01,1.55,1.58,1.55,1.58,+0.06,3.95,45000,3,69780,0,0,0,0,0,0,34000,11000,23000,23000
20200528,060351,滬深2X元富9A購01,1.94,2.10,1.91,1.91,-0.07,-3.54,34000,6,65880,0,0,0,0,0,0,8000,34000,-26000,-26000
20200528,060352,滬深2X元富9A購02,1.54,1.54,1.54,1.54,-0.09,-5.52,15000,2,23100,0,0,0,0,0,0,0,15000,-15000,-15000
20200528,060353,A50正2元富9A購01,,,,,0.00,0.00,0,0,0,0,0,0,0,0,0,0,0,0,0
20200528,060354,A50正2元富9A購02,,,,,0.00,0.00,0,0,0,0,0,0,0,0,0,0,0,0,0
20200528,060355,元金2X元富9C購01,1.55,1.68,1.55,1.68,+0.16,10.53,23000,15,36340,0,0,0,0,0,0,5000,16000,-11000,-11000
20200528,060356,上銀元富9A購01,,,,,0.00,0.00,0,0,0,0,0,0,0,0,0,0,0,0,0
20200528,060357,上銀元富9A購02,,,,,0.00,0.00,0,0,0,0,0,0,0,0,0,0,0,0,0
20200528,060358,國巨元富9A購01,,,,,0.00,0.00,0,0,0,0,0,0,0,0,0,0,0,0,0
20200528,060359,國巨元富9A購02,,,,,0.00,0.00,0,0,0,0,0,0,0,0,0,0,0,0,0
20200528,06035P,同欣電凱基96售03,0.31,0.31,0.31,0.31,0.00,0.00,10000,1,3100,0,0,0,0,0,0,10000,0,10000,10000
20200528,060360,南亞科元富9A購02,2.61,2.70,2.52,2.52,+0.10,4.13,314000,14,826960,0,0,0,0,0,0,68000,246000,-178000,-178000
20200528,060361,南亞科元富9A購03,2.20,2.28,2.01,2.01,-0.05,-2.43,318000,39,706170,0,0,0,0,0,0,208000,110000,98000,98000
20200528,060362,建準元富9A購02,,,,,0.00,0.00,0,0,0,0,0,0,0,0,0,0,0,0,0
20200528,060363,美律元富9A購01,1.83,1.88,1.83,1.88,+0.11,6.21,360000,8,664400,0,0,0,0,0,0,168000,200000,-32000,-32000
20200528,060364,奇力新元富9A購01,3.08,3.08,2.84,2.88,-0.19,-6.19,120000,5,353720,0,0,0,0,0,0,100000,20000,80000,80000
20200528,060365,京鼎元富9A購01,,,,,0.00,0.00,0,0,0,0,0,0,0,0,0,0,0,0,0
20200528,060366,健策元富9A購01,2.67,2.71,2.48,2.48,-0.18,-6.77,59000,19,155200,0,0,0,0,0,0,39000,20000,19000,19000
20200528,060367,緯穎元富9A購02,3.38,3.48,3.12,3.12,-0.20,-6.02,187000,30,631170,0,0,0,0,0,0,135000,62000,73000,73000
20200528,060368,緯穎元富9A購03,3.77,3.77,3.77,3.77,-0.23,-5.75,1000,1,3770,0,0,0,0,0,0,0,1000,-1000,-1000
20200528,060369,滬深2X元富01購01,,,,,0.00,0.00,0,0,0,0,0,0,0,0,0,0,0,0,0
20200528,06036P,台表科凱基96售04,,,,,0.00,0.00,0,0,0,0,0,0,0,0,0,0,0,0,0
20200528,060370,滬深2X元富04購01,2.02,2.02,1.90,1.94,-0.04,-2.02,55000,9,107500,0,0,0,0,0,0,15000,40000,-25000,-25000
20200528,060371,A50正2元富01購01,2.83,2.83,2.83,2.83,+0.04,1.43,10000,1,28300,0,0,0,0,0,0,10000,0,10000,10000
20200528,060372,A50正2元富9A購04,,,,,0.00,0.00,0,0,0,0,0,0,0,0,0,0,0,0,0
20200528,060373,元金2X元富9A購01,1.20,1.22,1.20,1.22,+0.01,0.83,45000,3,54250,0,0,0,0,0,0,45000,0,45000,45000
20200528,060374,儒鴻元富9A購01,3.78,3.80,3.44,3.44,-0.31,-8.27,224000,29,819180,0,0,0,0,0,0,109000,80000,29000,29000
20200528,060375,葡萄王元富9A購01,1.22,1.22,1.17,1.17,-0.10,-7.87,353000,5,415760,0,0,0,0,0,0,255000,98000,157000,157000
20200528,060376,瑞祺元富9A購01,2.78,3.02,2.69,2.75,-0.06,-2.14,525000,21,1496970,0,0,0,0,0,0,196000,329000,-133000,-133000
20200528,060377,鴻海台新9A購01,,,,,0.00,0.00,0,0,0,0,0,0,0,0,0,0,0,0,0
20200528,060378,台灣50凱基04購01,,,,,0.00,0.00,0,0,0,0,0,0,0,0,0,0,0,0,0
20200528,060379,T50反1凱基9A購07,0.45,0.48,0.45,0.48,+0.02,4.35,21000,2,9480,0,0,0,0,0,0,0,21000,-21000,-21000
20200528,06037P,超眾國票98售02,,,,,0.00,0.00,0,0,0,0,0,0,0,0,0,0,0,0,0
20200528,060380,T50反1凱基9A購08,0.66,0.71,0.66,0.71,+0.01,1.43,50000,3,33500,0,0,0,0,0,0,10000,40000,-30000,-30000
20200528,060381,元黃金凱基9A購01,0.51,0.51,0.51,0.51,+0.01,2.0,51000,4,26010,0,0,0,0,0,0,41000,10000,31000,31000
20200528,060382,儒鴻凱基9A購01,2.72,2.75,2.72,2.72,-0.08,-2.86,150000,18,410240,0,0,0,0,0,0,145000,0,145000,145000
20200528,060383,葡萄王凱基9A購01,0.74,0.74,0.69,0.69,-0.06,-8.0,114000,9,81800,0,0,0,0,0,0,66000,48000,18000,18000
20200528,060384,葡萄王凱基9B購01,,,,,0.00,0.00,0,0,0,0,0,0,0,0,0,0,0,0,0
20200528,060385,台勝科凱基9A購01,1.44,1.45,1.33,1.36,-0.06,-4.23,361000,15,495300,0,0,0,0,0,0,346000,13000,333000,333000
20200528,060386,台勝科凱基9B購01,,,,,0.00,0.00,0,0,0,0,0,0,0,0,0,0,0,0,0
20200528,060387,盛群凱基9A購01,1.46,1.46,1.44,1.44,-0.01,-0.69,120000,3,174900,0,0,0,0,0,0,0,120000,-120000,-120000
20200528,060388,世紀鋼凱基9B購01,1.79,2.13,1.78,2.13,+0.30,16.39,560000,56,1072690,0,0,0,0,0,0,195000,355000,-160000,-160000
20200528,060389,世紀鋼凱基9B購02,0.89,1.02,0.89,1.00,+0.09,9.89,180000,18,168610,0,0,0,0,0,0,160000,20000,140000,140000
20200528,06038P,國泰金台新96售01,,,,,0.00,0.00,0,0,0,0,0,0,0,0,0,0,0,0,0
20200528,060390,聯鈞群益9A購01,0.94,0.96,0.94,0.96,+0.01,1.05,134000,4,127880,0,0,0,0,0,0,30000,104000,-74000,-74000
20200528,060391,華擎群益9C購01,2.76,2.76,2.76,2.76,0.00,0.00,15000,1,41400,0,0,0,0,0,0,15000,0,15000,15000
20200528,060392,華擎群益9C購02,3.16,3.23,3.08,3.08,-0.04,-1.28,139000,16,436790,0,0,0,0,0,0,17000,127000,-110000,-110000
20200528,060393,泰鼎群益9A購01,,,,,0.00,0.00,0,0,0,0,0,0,0,0,0,0,0,0,0
20200528,060394,欣興麥證9A購01,2.64,2.86,2.63,2.74,+0.02,0.74,148000,11,409080,15000,133000,-118000,0,0,0,15000,133000,-118000,-118000
20200528,060395,儒鴻國票9A購01,5.55,5.65,5.10,5.10,-0.50,-8.93,464000,8,2397800,0,0,0,0,0,0,25000,439000,-414000,-414000
20200528,060396,友達國票9A購01,,,,,0.00,0.00,0,0,0,0,0,0,0,0,0,0,0,0,0
20200528,060397,群創國票9A購01,0.86,0.86,0.85,0.85,-0.06,-6.59,20000,2,17100,0,0,0,0,0,0,0,20000,-20000,-20000
20200528,060398,立積國票9B購01,1.73,1.73,1.73,1.73,-0.03,-1.7,129000,4,223170,0,0,0,0,0,0,129000,0,129000,129000
20200528,060399,康友國票9A購02,2.58,2.62,2.49,2.49,-0.08,-3.11,25000,4,64760,0,0,0,0,0,0,2000,25000,-23000,-23000
20200528,06039P,亞光台新96售03,,,,,0.00,0.00,0,0,0,0,0,0,0,0,0,0,0,0,0
20200528,060400,南電國票9A購03,2.99,3.05,2.87,2.87,-0.10,-3.37,89000,6,266620,0,0,0,0,0,0,18000,71000,-53000,-53000
20200528,060401,世紀鋼國票9B購01,3.10,3.66,3.10,3.61,+0.48,15.34,123000,15,407640,0,0,0,0,0,0,53000,58000,-5000,-5000
20200528,060402,神隆國泰9B購01,1.69,1.75,1.69,1.72,-0.02,-1.15,138000,3,239700,0,0,0,0,0,0,118000,20000,98000,98000
20200528,060403,上銀國泰9B購01,3.90,3.90,3.90,3.90,-0.10,-2.5,1000,1,3900,0,0,0,0,0,0,1000,0,1000,1000
20200528,060404,台勝科國泰9B購01,2.09,2.09,2.09,2.09,-0.15,-6.7,75000,1,156750,0,0,0,0,0,0,75000,0,75000,75000
20200528,060405,中租國泰9C購01,3.41,3.41,3.41,3.41,-0.18,-5.01,1000,1,3410,0,0,0,0,0,0,1000,1000,0,0
20200528,060406,瑞祺國泰9B購01,1.79,1.84,1.71,1.71,-0.04,-2.29,298000,7,544560,0,0,0,0,0,0,10000,276000,-266000,-266000
20200528,060407,南六國泰9C購01,,,,,0.00,0.00,0,0,0,0,0,0,0,0,0,0,0,0,0
20200528,060408,和潤國泰9C購01,2.40,2.40,2.40,2.40,+0.02,0.84,11000,1,26400,0,0,0,0,0,0,11000,0,11000,11000
20200528,060409,味全永豐9A購01,1.05,1.09,1.05,1.06,+0.01,0.95,175000,8,187000,0,0,0,0,0,0,30000,145000,-115000,-115000
20200528,06040P,亞光康和96售03,,,,,0.00,0.00,0,0,0,0,0,0,0,0,0,0,0,0,0
20200528,060410,台苯永豐9A購01,,,,,0.00,0.00,0,0,0,0,0,0,0,0,0,0,0,0,0
20200528,060411,達新永豐9A購01,1.16,1.19,1.13,1.13,-0.02,-1.74,89000,9,104930,2000,0,2000,0,0,0,14000,75000,-61000,-59000
20200528,060412,儒鴻永豐9A購01,1.78,1.78,1.61,1.61,-0.16,-9.04,434000,40,743250,0,0,0,0,0,0,178000,233000,-55000,-55000
20200528,060413,東元永豐9A購01,1.84,1.86,1.77,1.77,+0.03,1.72,10000,3,18280,0,0,0,0,0,0,0,10000,-10000,-10000
20200528,060414,中興電永豐9A購01,1.57,1.77,1.57,1.75,+0.18,11.46,749000,73,1266980,0,0,0,0,0,0,376000,250000,126000,126000
20200528,060415,葡萄王永豐9A購01,0.64,0.64,0.60,0.61,0.00,0.00,145000,4,91950,0,0,0,0,0,0,60000,85000,-25000,-25000
20200528,060416,神隆永豐9A購01,0.89,0.96,0.89,0.93,-0.04,-4.12,52000,4,47190,0,0,0,0,0,0,30000,22000,8000,8000
20200528,060417,正隆永豐9A購01,1.36,1.41,1.31,1.31,-0.03,-2.24,122000,11,167400,0,0,0,0,0,0,60000,62000,-2000,-2000
20200528,060418,中橡永豐9A購01,0.92,0.94,0.90,0.90,-0.04,-4.26,164000,4,150980,0,0,0,0,0,0,96000,68000,28000,28000
20200528,060419,漢翔永豐9A購01,0.99,1.07,0.99,1.01,+0.04,4.12,218000,15,229340,0,0,0,0,0,0,213000,0,213000,213000
20200528,06041P,全新永豐96售03,,,,,0.00,0.00,0,0,0,0,0,0,0,0,0,0,0,0,0
20200528,060420,神基永豐9A購01,0.97,0.98,0.93,0.93,-0.04,-4.12,295000,10,280890,0,0,0,0,0,0,145000,150000,-5000,-5000
20200528,060421,華擎永豐9A購01,1.03,1.03,0.97,0.97,0.00,0.00,715000,4,703830,0,0,0,0,0,0,700000,15000,685000,685000
20200528,060422,台勝科永豐9A購01,1.13,1.13,1.05,1.05,-0.07,-6.25,78000,4,82940,0,0,0,0,0,0,50000,28000,22000,22000
20200528,060423,智易永豐9A購01,1.39,1.48,1.34,1.34,-0.01,-0.74,340000,23,489480,0,0,0,0,0,0,202000,138000,64000,64000
20200528,060424,中租永豐9A購01,1.60,1.60,1.58,1.58,-0.01,-0.63,154000,4,245220,0,0,0,0,0,0,68000,86000,-18000,-18000
20200528,060425,凌華永豐9A購01,0.79,0.84,0.78,0.84,+0.06,7.69,573000,18,466600,0,0,0,0,0,0,237000,281000,-44000,-44000
20200528,060426,盛群永豐9A購01,,,,,0.00,0.00,0,0,0,0,0,0,0,0,0,0,0,0,0
20200528,060427,聯茂永豐9A購01,0.69,0.74,0.69,0.73,+0.02,2.82,211000,13,147170,0,0,0,0,0,0,184000,27000,157000,157000
20200528,060428,瑞祺永豐9A購01,1.00,1.08,1.00,1.07,+0.05,4.9,631000,13,661250,0,0,0,0,0,0,257000,374000,-117000,-117000
20200528,060429,南六永豐9A購01,2.26,2.32,2.22,2.22,-0.02,-0.89,60000,12,134480,0,0,0,0,0,0,50000,10000,40000,40000
20200528,06042P,華新科永豐96售04,0.24,0.28,0.24,0.28,+0.03,12.0,120000,3,31600,0,0,0,0,0,0,80000,40000,40000,40000
20200528,060430,和潤永豐9A購01,1.55,1.57,1.52,1.52,-0.03,-1.94,72000,9,111290,0,0,0,0,0,0,12000,60000,-48000,-48000
20200528,060431,復盛永豐9A購01,1.09,1.15,1.09,1.09,0.00,0.00,38000,9,42270,0,0,0,0,0,0,20000,16000,4000,4000
20200528,060432,達方永豐9A購01,1.24,1.25,1.21,1.23,0.00,0.00,476000,18,586980,0,0,0,0,0,0,340000,136000,204000,204000
20200528,060433,億豐永豐9A購01,,,,,0.00,0.00,0,0,0,0,0,0,0,0,0,0,0,0,0
20200528,060434,台汽電永豐9A購01,1.42,1.43,1.42,1.43,-0.08,-5.3,220000,10,314500,0,0,0,0,0,0,100000,120000,-20000,-20000
20200528,060435,鈺齊永豐9A購01,1.19,1.27,1.15,1.17,+0.06,5.41,110000,13,132050,0,0,0,0,0,0,50000,60000,-10000,-10000
20200528,060436,巨大永豐9A購01,3.12,3.12,3.06,3.06,-0.15,-4.67,40000,3,123400,0,0,0,0,0,0,40000,0,40000,40000
20200528,060437,宏全永豐9A購01,1.10,1.12,1.10,1.11,+0.01,0.91,610000,9,676550,0,0,0,0,0,0,0,610000,-610000,-610000
20200528,060438,台灣50元大9A購11,,,,,0.00,0.00,0,0,0,0,0,0,0,0,0,0,0,0,0
20200528,060439,台灣50元大9C購26,,,,,0.00,0.00,0,0,0,0,0,0,0,0,0,0,0,0,0
20200528,06043P,創意永豐96售06,,,,,0.00,0.00,0,0,0,0,0,0,0,0,0,0,0,0,0
20200528,060440,台灣50元大9C購27,,,,,0.00,0.00,0,0,0,0,0,0,0,0,0,0,0,0,0
20200528,060441,上証2X元大9A購01,,,,,0.00,0.00,0,0,0,0,0,0,0,0,0,0,0,0,0
20200528,060442,滬深2X元大9A購02,1.57,1.57,1.57,1.57,0.00,0.00,2000,1,3140,0,0,0,0,0,0,2000,0,2000,2000
20200528,060443,滬深2X元大9A購03,,,,,0.00,0.00,0,0,0,0,0,0,0,0,0,0,0,0,0
20200528,060444,滬深2X元大9A購04,,,,,0.00,0.00,0,0,0,0,0,0,0,0,0,0,0,0,0
20200528,060445,S&P反1元大9A購04,,,,,0.00,0.00,0,0,0,0,0,0,0,0,0,0,0,0,0
20200528,060446,A50正2元大9A購01,,,,,0.00,0.00,0,0,0,0,0,0,0,0,0,0,0,0,0
20200528,060447,A50正2元大9A購02,,,,,0.00,0.00,0,0,0,0,0,0,0,0,0,0,0,0,0
20200528,060448,道瓊反元大9A購04,,,,,0.00,0.00,0,0,0,0,0,0,0,0,0,0,0,0,0
20200528,060449,元金2X元大9A購02,1.89,1.95,1.89,1.95,+0.11,5.98,28000,3,53300,0,0,0,0,0,0,23000,5000,18000,18000
20200528,06044P,同欣電永豐96售03,0.43,0.43,0.43,0.43,0.00,0.00,12000,2,5160,0,0,0,0,0,0,2000,10000,-8000,-8000
20200528,060450,南亞元大9A購02,2.62,2.62,2.56,2.56,-0.05,-1.92,114000,7,294740,0,0,0,0,0,0,64000,50000,14000,14000
20200528,060451,中石化元大9C購02,1.47,1.48,1.47,1.48,-0.04,-2.63,46000,3,67780,0,0,0,0,0,0,16000,46000,-30000,-30000
20200528,060452,儒鴻元大9A購01,4.84,4.90,4.38,4.38,-0.39,-8.18,79000,13,370030,0,0,0,0,0,0,62000,17000,45000,45000
20200528,060453,儒鴻元大9A購02,4.00,4.04,3.62,3.66,-0.35,-8.73,108000,10,414680,0,0,0,0,0,0,75000,33000,42000,42000
20200528,060454,葡萄王元大9A購01,1.50,1.50,1.50,1.50,0.00,0.00,68000,1,102000,0,0,0,0,0,0,0,68000,-68000,-68000
20200528,060455,葡萄王元大9A購02,1.58,1.58,1.52,1.53,-0.11,-6.71,154000,6,237960,0,0,0,0,0,0,81000,73000,8000,8000
20200528,060456,正隆元大9A購01,3.08,3.19,2.95,2.95,-0.06,-1.99,305000,17,923690,0,0,0,0,0,0,211000,111000,100000,100000
20200528,060457,中橡元大9A購02,2.09,2.12,2.02,2.02,-0.05,-2.42,372000,13,774450,0,0,0,0,0,0,108000,214000,-106000,-106000
20200528,060458,華通元大9A購02,3.44,3.59,3.44,3.59,+0.27,8.13,37000,4,131180,0,0,0,0,0,0,37000,3000,34000,34000
20200528,060459,鴻海元大9A購07,2.89,2.89,2.89,2.89,+0.09,3.21,10000,1,28900,0,0,0,0,0,0,10000,0,10000,10000
20200528,06045P,臺股指永豐96售03,,,,,0.00,0.00,0,0,0,0,0,0,0,0,0,0,0,0,0
20200528,060460,鴻海元大9A購08,2.41,2.41,2.40,2.40,+0.03,1.27,51000,6,122500,0,0,0,0,0,0,51000,1000,50000,50000
20200528,060461,鴻海元大9A購09,,,,,0.00,0.00,0,0,0,0,0,0,0,0,0,0,0,0,0
20200528,060462,鴻海元大9A購10,2.28,2.28,2.28,2.28,+0.05,2.24,50000,1,114000,0,0,0,0,0,0,0,50000,-50000,-50000
20200528,060463,台積電元大9A購10,2.00,2.00,2.00,2.00,+0.01,0.5,6000,1,12000,0,0,0,0,0,0,6000,0,6000,6000
20200528,060464,台積電元大9A購11,3.57,3.57,3.57,3.57,+0.03,0.85,1000,1,3570,0,0,0,0,0,0,1000,0,1000,1000
20200528,060465,聯發科元大9A購02,,,,,0.00,0.00,0,0,0,0,0,0,0,0,0,0,0,0,0
20200528,060466,玉山金元大9A購01,3.03,3.03,3.02,3.02,-0.03,-0.98,93000,4,281450,0,0,0,0,0,0,43000,51000,-8000,-8000
20200528,060467,神基元大9A購01,2.24,2.25,2.01,2.03,-0.11,-5.14,1152000,48,2500040,0,0,0,0,0,0,257000,835000,-578000,-578000
20200528,060468,聯鈞元大9A購02,2.33,2.35,2.21,2.21,-0.09,-3.91,274000,19,627210,0,0,0,0,0,0,159000,115000,44000,44000
20200528,060469,台勝科元大9A購02,3.33,3.33,3.18,3.18,-0.20,-5.92,215000,3,705090,0,0,0,0,0,0,178000,37000,141000,141000
20200528,06046P,健策統一96售03,0.57,0.74,0.57,0.72,+0.05,7.46,432000,15,286940,0,0,0,0,0,0,177000,255000,-78000,-78000
20200528,060470,台勝科元大9A購03,2.40,2.40,2.40,2.40,-0.17,-6.61,4000,1,9600,0,0,0,0,0,0,4000,0,4000,4000
20200528,060471,台勝科元大9B購01,4.00,4.00,4.00,4.00,-0.09,-2.2,1000,1,4000,0,0,0,0,0,0,1000,0,1000,1000
20200528,060472,中租元大9A購02,4.30,4.30,4.15,4.15,-0.07,-1.66,77000,12,327950,0,0,0,0,0,0,64000,29000,35000,35000
20200528,060473,中租元大9A購03,,,,,0.00,0.00,0,0,0,0,0,0,0,0,0,0,0,0,0
20200528,060474,中租元大9B購01,3.27,3.27,3.23,3.27,-0.01,-0.3,117000,8,379830,0,0,0,0,0,0,80000,47000,33000,33000
20200528,060475,瑞祺元大9A購01,2.85,3.02,2.73,2.76,-0.06,-2.13,1249000,34,3587360,0,0,0,0,0,0,1050000,204000,846000,846000
20200528,060476,瑞祺元大9A購02,2.73,2.93,2.67,2.69,-0.08,-2.89,479000,30,1332280,0,0,0,0,0,0,229000,254000,-25000,-25000
20200528,060477,和潤元大9A購01,3.38,3.41,3.32,3.32,-0.02,-0.6,93000,9,314080,0,0,0,0,0,0,23000,70000,-47000,-47000
20200528,060478,南電元大9A購01,2.67,2.67,2.61,2.61,0.00,0.00,22000,3,58380,0,0,0,0,0,0,0,22000,-22000,-22000
20200528,060479,億豐元大9A購01,4.96,4.96,4.68,4.68,-0.23,-4.68,41000,3,200760,0,0,0,0,0,0,0,41000,-41000,-41000
20200528,06047P,聯發科富邦99售04,2.84,2.91,2.84,2.87,0.00,0.00,268000,8,777750,0,0,0,0,0,0,10000,258000,-248000,-248000
20200528,060480,億豐元大9A購02,,,,,0.00,0.00,0,0,0,0,0,0,0,0,0,0,0,0,0
20200528,060481,巨大元大9A購01,7.80,7.80,7.80,7.80,0.00,0.00,1000,1,7800,0,0,0,0,0,0,1000,0,1000,1000
20200528,060482,東元富邦9A購01,0.82,0.82,0.79,0.79,0.00,0.00,6000,2,4830,0,0,0,0,0,0,6000,0,6000,6000
20200528,060483,友達富邦9A購01,,,,,0.00,0.00,0,0,0,0,0,0,0,0,0,0,0,0,0
20200528,060484,聯發科富邦9C購02,2.34,2.35,2.29,2.29,-0.02,-0.87,23000,4,53890,0,0,0,0,0,0,22000,1000,21000,21000
20200528,060485,華新科富邦9C購04,0.77,0.77,0.75,0.75,-0.04,-5.06,296000,4,227320,0,0,0,0,0,0,266000,30000,236000,236000
20200528,060486,中租富邦9A購01,,,,,0.00,0.00,0,0,0,0,0,0,0,0,0,0,0,0,0
20200528,060487,盛群富邦9B購01,,,,,0.00,0.00,0,0,0,0,0,0,0,0,0,0,0,0,0
20200528,060488,台灣50群益9C購01,,,,,0.00,0.00,0,0,0,0,0,0,0,0,0,0,0,0,0
20200528,060489,世紀鋼群益9A購01,1.10,1.30,1.09,1.21,+0.23,23.47,568000,23,691890,0,0,0,0,0,0,0,468000,-468000,-468000
20200528,06048P,大立光富邦96售05,,,,,0.00,0.00,0,0,0,0,0,0,0,0,0,0,0,0,0
20200528,060490,華新科台新9A購01,,,,,0.00,0.00,0,0,0,0,0,0,0,0,0,0,0,0,0
20200528,060491,台灣50元富04購01,,,,,0.00,0.00,0,0,0,0,0,0,0,0,0,0,0,0,0
20200528,060492,元黃金元富9A購01,,,,,0.00,0.00,0,0,0,0,0,0,0,0,0,0,0,0,0
20200528,060493,美律元富01購01,2.27,2.31,2.24,2.29,+0.09,4.09,434000,15,991740,0,0,0,0,0,0,187000,247000,-60000,-60000
20200528,060494,台灣50元大01購12,,,,,0.00,0.00,0,0,0,0,0,0,0,0,0,0,0,0,0
20200528,060495,台灣50元大01購13,,,,,0.00,0.00,0,0,0,0,0,0,0,0,0,0,0,0,0
20200528,060496,滬深2X元大9A購05,1.85,1.99,1.85,1.99,+0.11,5.85,40000,2,76800,0,0,0,0,0,0,20000,20000,0,0
20200528,060497,臺指反元大01購02,,,,,0.00,0.00,0,0,0,0,0,0,0,0,0,0,0,0,0
20200528,060498,華通元大9A購03,2.71,2.74,2.62,2.62,+0.13,5.22,85000,6,229150,0,0,0,0,0,0,50000,35000,15000,15000
20200528,060499,鴻海元大9A購11,,,,,0.00,0.00,0,0,0,0,0,0,0,0,0,0,0,0,0
20200528,06049P,創意亞東97售01,,,,,0.00,0.00,0,0,0,0,0,0,0,0,0,0,0,0,0
20200528,060500,鴻海元大9A購12,1.33,1.33,1.27,1.27,-0.04,-3.05,199000,6,260040,0,0,0,0,0,0,199000,0,199000,199000
20200528,060501,鴻海元大9A購13,1.92,1.93,1.88,1.88,-0.02,-1.05,9000,6,17190,0,0,0,0,0,0,0,9000,-9000,-9000
20200528,060502,國巨元大9A購07,5.25,5.25,5.00,5.00,-0.20,-3.85,31000,7,156700,0,0,0,0,0,0,29000,7000,22000,22000
20200528,060503,技嘉元大9A購01,1.49,1.49,1.37,1.37,-0.12,-8.05,259000,16,363350,0,0,0,0,0,0,244000,19000,225000,225000
20200528,060504,技嘉元大9A購02,2.12,2.13,1.96,1.97,-0.16,-7.51,105000,8,213450,0,0,0,0,0,0,53000,50000,3000,3000
20200528,060505,友達元大9C購05,1.75,1.79,1.70,1.70,-0.06,-3.41,176000,5,306900,0,0,0,0,0,0,66000,110000,-44000,-44000
20200528,060506,京元電元大9A購02,1.14,1.15,1.07,1.08,-0.05,-4.42,469000,19,522530,0,0,0,0,0,0,196000,308000,-112000,-112000
20200528,060507,聯發科元大9A購03,,,,,0.00,0.00,0,0,0,0,0,0,0,0,0,0,0,0,0
20200528,060508,聯發科元大9A購04,4.12,4.12,4.12,4.12,0.00,0.00,3000,1,12360,0,0,0,0,0,0,0,3000,-3000,-3000
20200528,060509,宏達電元大9A購02,1.56,1.56,1.41,1.41,-0.17,-10.76,152000,8,222190,0,0,0,0,0,0,84000,84000,0,0
20200528,06050P,玉晶光國票98售01,3.60,3.71,3.45,3.71,-0.26,-6.55,208000,13,755790,0,0,0,0,0,0,104000,104000,0,0
20200528,060510,大立光元大9A購03,1.06,1.06,1.06,1.06,-0.05,-4.5,10000,1,10600,0,0,0,0,0,0,0,10000,-10000,-10000
20200528,060511,群創元大9B購08,1.44,1.44,1.36,1.36,-0.08,-5.56,75000,2,102560,0,0,0,0,0,0,0,75000,-75000,-75000
20200528,060512,祥碩元大9A購02,2.16,2.37,2.12,2.23,+0.13,6.19,64000,6,147570,0,0,0,0,0,0,36000,54000,-18000,-18000
20200528,060513,緯穎元大9B購01,2.48,2.50,2.28,2.28,-0.13,-5.39,155000,13,373600,0,0,0,0,0,0,25000,120000,-95000,-95000
20200528,060514,南電元大9A購02,1.57,1.57,1.50,1.50,-0.05,-3.23,166000,9,258040,0,0,0,0,0,0,58000,107000,-49000,-49000
20200528,060515,臺股指元大9B購12,,,,,0.00,0.00,0,0,0,0,0,0,0,0,0,0,0,0,0
20200528,060516,臺股指元大9B購13,2.30,2.30,2.30,2.30,0.00,0.00,1000,1,2300,0,0,0,0,0,0,1000,0,1000,1000
20200528,060517,臺股指元大9B購14,,,,,0.00,0.00,0,0,0,0,0,0,0,0,0,0,0,0,0
20200528,060518,台灣50中信01購01,,,,,0.00,0.00,0,0,0,0,0,0,0,0,0,0,0,0,0
20200528,060519,S&P500中信01購01,,,,,0.00,0.00,0,0,0,0,0,0,0,0,0,0,0,0,0
20200528,06051P,嘉聯益國票97售04,2.07,2.07,1.97,2.06,-0.18,-8.04,42000,3,86070,0,0,0,0,0,0,34000,8000,26000,26000
20200528,060520,臺指2X中信01購02,3.00,3.00,2.82,2.82,-0.11,-3.75,12000,2,35640,0,0,0,0,0,0,0,12000,-12000,-12000
20200528,060521,鴻海中信01購03,0.93,0.93,0.93,0.93,0.00,0.00,10000,1,9300,0,0,0,0,0,0,10000,0,10000,10000
20200528,060522,鴻海中信9A購03,0.95,0.95,0.94,0.94,+0.01,1.08,138000,7,130620,0,0,0,0,0,0,108000,30000,78000,78000
20200528,060523,鴻海中信9C購03,,,,,0.00,0.00,0,0,0,0,0,0,0,0,0,0,0,0,0
20200528,060524,國巨中信9A購03,1.75,1.75,1.66,1.66,-0.05,-2.92,18000,3,31230,0,0,0,0,0,0,15000,3000,12000,12000
20200528,060525,台積電中信01購04,1.34,1.34,1.31,1.31,-0.06,-4.38,13000,3,17120,0,0,0,0,0,0,3000,13000,-10000,-10000
20200528,060526,台積電中信9A購02,1.40,1.41,1.35,1.36,-0.04,-2.86,36000,7,50130,0,0,0,0,0,0,30000,9000,21000,21000
20200528,060527,台積電中信9C購04,1.39,1.39,1.39,1.39,-0.04,-2.8,3000,2,4170,0,0,0,0,0,0,3000,3000,0,0
20200528,060528,友達中信9C購01,1.35,1.37,1.35,1.37,+0.04,3.01,137000,4,185650,0,0,0,0,0,0,0,137000,-137000,-137000
20200528,060529,聯發科中信9A購04,1.56,1.56,1.45,1.49,-0.05,-3.25,65000,11,97100,0,0,0,0,0,0,25000,40000,-15000,-15000
20200528,06052P,台郡國票97售06,,,,,0.00,0.00,0,0,0,0,0,0,0,0,0,0,0,0,0
20200528,060530,聯發科中信9C購03,1.29,1.29,1.27,1.27,-0.06,-4.51,10000,2,12840,0,0,0,0,0,0,7000,3000,4000,4000
20200528,060531,大立光中信9A購04,,,,,0.00,0.00,0,0,0,0,0,0,0,0,0,0,0,0,0
20200528,060532,欣興中信9A購01,1.35,1.48,1.35,1.36,+0.01,0.74,114000,12,159360,0,0,0,0,0,0,89000,28000,61000,61000
20200528,060533,臺股指中信9B購05,1.92,1.92,1.83,1.83,-0.08,-4.19,62000,4,116160,0,0,0,0,0,0,40000,22000,18000,18000
20200528,060534,友達麥證9A購01,1.21,1.21,1.21,1.21,-0.01,-0.82,300000,2,363000,0,300000,-300000,0,0,0,0,300000,-300000,-300000
20200528,060535,群創麥證9A購01,,,,,0.00,0.00,0,0,0,0,0,0,0,0,0,0,0,0,0
20200528,060536,祥碩麥證9A購01,3.24,3.49,3.24,3.49,+0.38,12.22,20000,2,69550,1000,19000,-18000,0,0,0,1000,19000,-18000,-18000
20200528,060537,台灣50凱基9B購01,1.97,1.97,1.97,1.97,+0.03,1.55,4000,2,7880,0,0,0,0,0,0,4000,0,4000,4000
20200528,060538,S&P反1凱基9A購01,0.52,0.52,0.52,0.52,0.00,0.00,10000,1,5200,0,0,0,0,0,0,0,10000,-10000,-10000
20200528,060539,道瓊反凱基9A購01,0.43,0.43,0.43,0.43,-0.05,-10.42,110000,5,47300,0,0,0,0,0,0,0,110000,-110000,-110000
20200528,06053P,緯穎國票97售05,,,,,0.00,0.00,0,0,0,0,0,0,0,0,0,0,0,0,0
20200528,060540,南亞凱基9A購01,1.86,1.87,1.75,1.76,-0.11,-5.88,100000,5,179260,0,0,0,0,0,0,30000,70000,-40000,-40000
20200528,060541,正隆凱基9A購01,2.50,2.57,2.39,2.39,-0.06,-2.45,165000,8,415960,0,0,0,0,0,0,120000,45000,75000,75000
20200528,060542,上銀凱基9A購04,3.49,3.59,3.49,3.59,-0.04,-1.1,42000,10,148330,0,0,0,0,0,0,42000,0,42000,42000
20200528,060543,鴻海凱基9B購02,,,,,0.00,0.00,0,0,0,0,0,0,0,0,0,0,0,0,0
20200528,060544,國巨凱基9B購03,,,,,0.00,0.00,0,0,0,0,0,0,0,0,0,0,0,0,0
20200528,060545,台積電凱基9B購02,1.25,1.25,1.20,1.20,-0.06,-4.76,24000,5,29180,0,0,0,0,0,0,4000,23000,-19000,-19000
20200528,060546,旺宏凱基9A購02,2.19,2.24,2.13,2.13,-0.13,-5.75,113000,19,247690,0,0,0,0,0,0,113000,0,113000,113000
20200528,060547,瑞昱凱基9A購01,1.77,1.83,1.77,1.81,+0.01,0.56,94000,7,170920,0,0,0,0,0,0,18000,86000,-68000,-68000
20200528,060548,友達凱基9B購03,1.68,1.71,1.68,1.71,+0.01,0.59,30000,3,50800,0,0,0,0,0,0,20000,10000,10000,10000
20200528,060549,聯發科凱基9B購03,,,,,0.00,0.00,0,0,0,0,0,0,0,0,0,0,0,0,0
20200528,06054P,臺股指中信9A售01,2.57,2.57,2.57,2.57,0.00,0.00,5000,1,12850,0,0,0,0,0,0,5000,0,5000,5000
20200528,060550,可成凱基9A購02,,,,,0.00,0.00,0,0,0,0,0,0,0,0,0,0,0,0,0
20200528,060551,大立光凱基9B購02,,,,,0.00,0.00,0,0,0,0,0,0,0,0,0,0,0,0,0
20200528,060552,群創凱基9B購05,1.35,1.35,1.29,1.29,-0.05,-3.73,50000,2,67380,0,0,0,0,0,0,0,50000,-50000,-50000
20200528,060553,祥碩凱基9A購01,2.35,2.35,2.35,2.35,+0.25,11.9,10000,1,23500,0,0,0,0,0,0,0,10000,-10000,-10000
20200528,060554,中租凱基9A購01,2.26,2.27,2.26,2.27,-0.01,-0.44,16000,2,36310,0,0,0,0,0,0,16000,0,16000,16000
20200528,060555,台表科凱基9A購03,,,,,0.00,0.00,0,0,0,0,0,0,0,0,0,0,0,0,0
20200528,060556,緯穎凱基9A購04,2.32,2.37,2.18,2.18,-0.20,-8.4,62000,5,146080,0,0,0,0,0,0,60000,2000,58000,58000
20200528,060557,南電凱基9A購02,1.21,1.22,1.15,1.15,-0.04,-3.36,161000,15,194450,0,0,0,0,0,0,131000,27000,104000,104000
20200528,060558,億豐凱基9A購01,,,,,0.00,0.00,0,0,0,0,0,0,0,0,0,0,0,0,0
20200528,060559,世紀鋼凱基9C購01,1.62,1.94,1.62,1.94,+0.28,16.87,620000,51,1120040,0,0,0,0,0,0,432000,188000,244000,244000
20200528,06055P,華通凱基97售04,1.07,1.07,0.98,0.98,-0.24,-19.67,3000,2,3030,0,0,0,0,0,0,1000,2000,-1000,-1000
20200528,060560,欣興國泰9C購01,2.31,2.47,2.31,2.36,-0.02,-0.84,230000,18,546000,0,0,0,0,0,0,108000,124000,-16000,-16000
20200528,060561,台積電富邦04購01,0.89,0.89,0.83,0.83,-0.04,-4.6,688000,31,588480,0,0,0,0,0,0,137000,501000,-364000,-364000
20200528,060562,旺宏富邦9C購02,1.34,1.36,1.34,1.36,+0.02,1.49,306000,35,412290,0,0,0,0,0,0,306000,17000,289000,289000
20200528,060563,智邦富邦9A購01,2.02,2.02,2.02,2.02,0.00,0.00,1000,1,2020,0,0,0,0,0,0,1000,0,1000,1000
20200528,060564,南亞科富邦9C購01,1.19,1.19,1.11,1.11,+0.01,0.91,200000,3,228000,0,0,0,0,0,0,0,200000,-200000,-200000
20200528,060565,大立光富邦01購01,0.37,0.37,0.35,0.35,0.00,0.00,22000,3,7840,0,0,0,0,0,0,2000,20000,-18000,-18000
20200528,060566,聯詠富邦9C購01,,,,,0.00,0.00,0,0,0,0,0,0,0,0,0,0,0,0,0
20200528,060567,華擎富邦9C購01,1.15,1.15,1.15,1.15,0.00,0.00,2000,1,2300,0,0,0,0,0,0,2000,0,2000,2000
20200528,060568,SP黃豆永豐9A購01,,,,,0.00,0.00,0,0,0,0,0,0,0,0,0,0,0,0,0
20200528,060569,台積電永豐9A購01,,,,,0.00,0.00,0,0,0,0,0,0,0,0,0,0,0,0,0
20200528,06056P,台積電凱基98售02,0.33,0.33,0.33,0.33,0.00,0.00,30000,3,9900,0,0,0,0,0,0,0,30000,-30000,-30000
20200528,060570,南亞科永豐9A購01,1.10,1.10,1.09,1.09,+0.08,7.92,81000,3,88900,0,0,0,0,0,0,0,81000,-81000,-81000
20200528,060571,京元電永豐9A購01,0.89,0.89,0.84,0.84,-0.04,-4.55,235000,6,202510,0,0,0,0,0,0,112000,167000,-55000,-55000
20200528,060572,景碩永豐9A購01,1.03,1.07,1.03,1.06,+0.05,4.95,304000,9,315810,0,0,0,0,0,0,0,304000,-304000,-304000
20200528,060573,力成永豐9A購01,1.04,1.06,1.04,1.05,+0.01,0.96,194000,8,203120,0,0,0,0,0,0,64000,130000,-66000,-66000
20200528,060574,高股息中信9C購01,,,,,0.00,0.00,0,0,0,0,0,0,0,0,0,0,0,0,0
20200528,060575,大立光中信9B購02,,,,,0.00,0.00,0,0,0,0,0,0,0,0,0,0,0,0,0
20200528,060576,欣興中信9B購01,2.16,2.34,2.14,2.19,+0.05,2.34,246000,27,543980,0,0,0,0,0,0,18000,231000,-213000,-213000
20200528,060577,玉晶光中信9A購02,,,,,0.00,0.00,0,0,0,0,0,0,0,0,0,0,0,0,0
20200528,060578,臺股指中信9C購03,1.15,1.15,1.15,1.15,-0.07,-5.74,25000,1,28750,0,0,0,0,0,0,25000,0,25000,25000
20200528,060579,上証2X群益9C購04,,,,,0.00,0.00,0,0,0,0,0,0,0,0,0,0,0,0,0
20200528,06057P,大立光凱基98售01,7.30,7.60,7.30,7.60,0.00,0.00,42000,2,310800,0,0,0,0,0,0,28000,14000,14000,14000
20200528,060580,A50正2群益9C購03,,,,,0.00,0.00,0,0,0,0,0,0,0,0,0,0,0,0,0
20200528,060581,玉晶光群益9B購02,2.53,2.53,2.53,2.53,0.00,0.00,5000,1,12650,0,0,0,0,0,0,0,5000,-5000,-5000
20200528,060582,玉晶光群益9C購01,2.69,2.69,2.69,2.69,+0.20,8.03,28000,1,75320,0,0,0,0,0,0,0,28000,-28000,-28000
20200528,060583,南亞科元富9A購05,2.10,2.18,2.10,2.11,+0.14,7.11,381000,33,811910,0,0,0,0,0,0,247000,134000,113000,113000
20200528,060584,玉晶光元富9A購01,3.52,3.69,3.47,3.47,+0.05,1.46,60000,10,215280,0,0,0,0,0,0,11000,49000,-38000,-38000
20200528,060585,玉晶光元富9A購02,2.78,2.78,2.78,2.78,+0.16,6.11,10000,1,27800,0,0,0,0,0,0,0,10000,-10000,-10000
20200528,060586,玉晶光元富9A購03,3.13,3.20,3.09,3.09,+0.14,4.75,41000,5,129400,0,0,0,0,0,0,0,41000,-41000,-41000
20200528,060587,牧德元富9A購01,,,,,0.00,0.00,0,0,0,0,0,0,0,0,0,0,0,0,0
20200528,060588,台灣50台新9A購03,,,,,0.00,0.00,0,0,0,0,0,0,0,0,0,0,0,0,0
20200528,060589,台灣50台新9B購06,,,,,0.00,0.00,0,0,0,0,0,0,0,0,0,0,0,0,0
20200528,06058P,玉晶光凱基97售04,1.31,1.31,1.31,1.31,-0.20,-13.25,80000,1,104800,0,0,0,0,0,0,80000,0,80000,80000
20200528,060590,台積電台新9C購02,,,,,0.00,0.00,0,0,0,0,0,0,0,0,0,0,0,0,0
20200528,060591,富邦金台新9A購01,1.66,1.66,1.66,1.66,-0.07,-4.05,30000,1,49800,0,0,0,0,0,0,0,30000,-30000,-30000
20200528,060592,上銀麥證9A購01,,,,,0.00,0.00,0,0,0,0,0,0,0,0,0,0,0,0,0
20200528,060593,華通麥證9A購01,3.52,3.69,3.52,3.66,+0.46,14.37,142000,8,509450,0,142000,-142000,0,0,0,0,142000,-142000,-142000
20200528,060594,國巨麥證9A購01,2.68,2.68,2.68,2.68,+0.05,1.9,1000,1,2680,0,1000,-1000,0,0,0,0,1000,-1000,-1000
20200528,060595,台灣50凱基04購04,,,,,0.00,0.00,0,0,0,0,0,0,0,0,0,0,0,0,0
20200528,060596,元黃金凱基9A購02,0.29,0.29,0.29,0.29,+0.01,3.57,3000,2,870,0,0,0,0,0,0,0,1000,-1000,-1000
20200528,060597,華通凱基9A購04,2.03,2.03,2.03,2.03,0.00,0.00,10000,1,20300,0,0,0,0,0,0,0,10000,-10000,-10000
20200528,060598,鴻海凱基9A購20,,,,,0.00,0.00,0,0,0,0,0,0,0,0,0,0,0,0,0
20200528,060599,國巨凱基9C購01,2.17,2.20,2.09,2.09,-0.04,-1.88,109000,11,235040,0,0,0,0,0,0,27000,82000,-55000,-55000
20200528,06059P,泰碩元大97售02,,,,,0.00,0.00,0,0,0,0,0,0,0,0,0,0,0,0,0
20200528,060600,台積電凱基9C購01,,,,,0.00,0.00,0,0,0,0,0,0,0,0,0,0,0,0,0
20200528,060601,技嘉凱基9A購02,1.33,1.33,1.25,1.27,-0.09,-6.62,150000,11,193990,0,0,0,0,0,0,102000,95000,7000,7000
20200528,060602,京元電凱基9A購01,1.06,1.06,1.01,1.01,-0.05,-4.72,89000,5,93780,0,0,0,0,0,0,0,89000,-89000,-89000
20200528,060603,聯發科凱基9A購12,,,,,0.00,0.00,0,0,0,0,0,0,0,0,0,0,0,0,0
20200528,060604,宏達電凱基9B購01,1.37,1.37,1.34,1.34,-0.12,-8.22,8000,2,10840,0,0,0,0,0,0,8000,8000,0,0
20200528,060605,大立光凱基9C購01,1.28,1.28,1.28,1.28,+0.01,0.79,95000,2,121600,0,0,0,0,0,0,95000,0,95000,95000
20200528,060606,玉晶光凱基9A購05,1.28,1.28,1.28,1.28,0.00,0.00,80000,1,102400,0,0,0,0,0,0,0,80000,-80000,-80000
20200528,060607,玉晶光凱基9A購06,,,,,0.00,0.00,0,0,0,0,0,0,0,0,0,0,0,0,0
20200528,060608,玉晶光凱基9A購08,1.20,1.22,1.19,1.19,+0.07,6.25,257000,6,306800,0,0,0,0,0,0,0,257000,-257000,-257000
20200528,060609,玉晶光凱基9B購01,,,,,0.00,0.00,0,0,0,0,0,0,0,0,0,0,0,0,0
20200528,06060P,玉晶光元大97售03,1.30,1.30,1.30,1.30,-0.20,-13.33,1000,1,1300,0,0,0,0,0,0,1000,0,1000,1000
20200528,060610,玉晶光凱基9B購02,3.38,3.57,3.38,3.57,+0.31,9.51,62000,14,216270,0,0,0,0,0,0,18000,52000,-34000,-34000
20200528,060611,同欣電凱基9A購02,1.40,1.41,1.36,1.37,-0.02,-1.44,146000,17,203250,0,0,0,0,0,0,53000,93000,-40000,-40000
20200528,060612,世紀鋼凱基9A購01,1.39,1.69,1.38,1.62,+0.19,13.29,335000,47,511650,0,0,0,0,0,0,157000,187000,-30000,-30000
20200528,060613,T50反1元大9A購05,,,,,0.00,0.00,0,0,0,0,0,0,0,0,0,0,0,0,0
20200528,060614,T50反1元大9A購06,,,,,0.00,0.00,0,0,0,0,0,0,0,0,0,0,0,0,0
20200528,060615,T50反1元大9A購07,,,,,0.00,0.00,0,0,0,0,0,0,0,0,0,0,0,0,0
20200528,060616,宏碁元大9A購02,1.80,1.80,1.78,1.78,-0.01,-0.56,110000,5,196000,0,0,0,0,0,0,100000,10000,90000,90000
20200528,060617,華新科元大9A購08,,,,,0.00,0.00,0,0,0,0,0,0,0,0,0,0,0,0,0
20200528,060618,玉晶光元大9A購02,,,,,0.00,0.00,0,0,0,0,0,0,0,0,0,0,0,0,0
20200528,060619,玉晶光元大9A購03,2.17,2.29,2.14,2.14,+0.02,0.94,155000,7,346850,0,0,0,0,0,0,14000,141000,-127000,-127000
20200528,06061P,訊芯統一97售01,,,,,0.00,0.00,0,0,0,0,0,0,0,0,0,0,0,0,0
20200528,060620,玉晶光元大9A購04,2.20,2.21,2.20,2.21,0.00,0.00,34000,3,75050,0,0,0,0,0,0,0,31000,-31000,-31000
20200528,060621,玉晶光元大9A購05,2.91,3.07,2.91,3.07,+0.33,12.04,42000,7,124200,0,0,0,0,0,0,4000,42000,-38000,-38000
20200528,060622,玉晶光元大9B購02,1.69,1.69,1.68,1.68,+0.10,6.33,150000,3,253000,0,0,0,0,0,0,0,150000,-150000,-150000
20200528,060623,玉晶光元大9C購01,1.67,1.73,1.64,1.64,+0.03,1.86,399000,13,669260,0,0,0,0,0,0,2000,395000,-393000,-393000
20200528,060624,玉晶光元大9C購02,3.11,3.27,3.09,3.11,+0.09,2.98,99000,7,315380,0,0,0,0,0,0,45000,56000,-11000,-11000
20200528,060625,華擎元大9A購01,1.70,1.70,1.58,1.60,-0.03,-1.84,563000,17,910600,0,0,0,0,0,0,115000,462000,-347000,-347000
20200528,060626,貿聯元大9A購04,1.67,1.69,1.61,1.63,-0.01,-0.61,866000,41,1431810,0,0,0,0,0,0,639000,197000,442000,442000
20200528,060627,國巨國泰9B購05,,,,,0.00,0.00,0,0,0,0,0,0,0,0,0,0,0,0,0
20200528,060628,和大富邦9B購01,1.24,1.26,1.24,1.25,+0.04,3.31,252000,8,315320,0,0,0,0,0,0,0,232000,-232000,-232000
20200528,060629,鴻海富邦9B購01,1.20,1.21,1.16,1.18,-0.01,-0.84,159000,10,190940,0,0,0,0,0,0,149000,10000,139000,139000
20200528,06062P,宏達電元富97售01,3.10,3.10,3.10,3.10,0.00,0.00,1000,1,3100,0,0,0,0,0,0,1000,0,1000,1000
20200528,060630,國巨富邦9C購03,1.00,1.01,1.00,1.01,+0.03,3.06,254000,26,255940,0,0,0,0,0,0,254000,0,254000,254000
20200528,060631,微星富邦9B購01,0.75,0.77,0.73,0.77,+0.04,5.48,198000,24,148720,0,0,0,0,0,0,96000,46000,50000,50000
20200528,060632,可成富邦9B購01,0.67,0.68,0.64,0.65,-0.01,-1.52,166000,10,109200,0,0,0,0,0,0,33000,125000,-92000,-92000
20200528,060633,玉晶光富邦02購01,1.40,1.41,1.35,1.35,0.00,0.00,358000,15,501000,0,0,0,0,0,0,203000,358000,-155000,-155000
20200528,060634,矽創富邦9B購01,0.98,1.08,0.98,1.00,+0.09,9.89,615000,33,635140,0,0,0,0,0,0,406000,249000,157000,157000
20200528,060635,義隆永豐9A購01,1.51,1.58,1.47,1.47,+0.03,2.08,559000,43,849800,0,0,0,0,0,0,336000,248000,88000,88000
20200528,060636,大毅永豐9A購02,1.35,1.36,1.35,1.36,-0.03,-2.16,56000,3,75960,0,0,0,0,0,0,56000,0,56000,56000
20200528,060637,玉晶光永豐9A購03,,,,,0.00,0.00,0,0,0,0,0,0,0,0,0,0,0,0,0
20200528,060638,玉晶光永豐9A購04,,,,,0.00,0.00,0,0,0,0,0,0,0,0,0,0,0,0,0
20200528,060639,玉晶光永豐9A購05,1.87,1.97,1.84,1.84,+0.02,1.1,649000,11,1248220,0,0,0,0,0,0,0,649000,-649000,-649000
20200528,06063P,玉晶光元富97售01,,,,,0.00,0.00,0,0,0,0,0,0,0,0,0,0,0,0,0
20200528,060640,京鼎永豐9A購01,1.51,1.52,1.43,1.43,-0.08,-5.3,127000,8,188370,0,0,0,0,0,0,82000,46000,36000,36000
20200528,060641,聯鈞永豐9A購01,0.85,0.85,0.83,0.83,+0.02,2.47,92000,4,76720,0,0,0,0,0,0,74000,18000,56000,56000
20200528,060642,華擎永豐9A購02,0.78,0.78,0.77,0.77,0.00,0.00,26000,4,20160,0,0,0,0,0,0,24000,2000,22000,22000
20200528,060643,牧德永豐9A購03,1.22,1.22,1.22,1.22,0.00,0.00,1000,1,1220,0,0,0,0,0,0,0,1000,-1000,-1000
20200528,060644,泰鼎永豐9A購02,1.97,1.98,1.91,1.91,0.00,0.00,26000,3,51260,0,0,0,0,0,0,0,26000,-26000,-26000
20200528,060645,台表科永豐9A購02,2.27,2.27,2.15,2.15,-0.17,-7.33,50000,3,112300,0,0,0,0,0,0,40000,10000,30000,30000
20200528,060646,南電永豐9A購01,0.88,0.91,0.86,0.86,-0.04,-4.44,752000,3,657870,0,0,0,0,0,0,752000,0,752000,752000
20200528,060647,T50反1第一9A購01,,,,,0.00,0.00,0,0,0,0,0,0,0,0,0,0,0,0,0
20200528,060648,鴻海第一9A購01,,,,,0.00,0.00,0,0,0,0,0,0,0,0,0,0,0,0,0
20200528,060649,國巨第一9A購01,1.08,1.08,1.05,1.05,-0.02,-1.87,39000,4,41220,0,0,0,0,0,0,24000,15000,9000,9000
20200528,06064P,台積電台新98售01,,,,,0.00,0.00,0,0,0,0,0,0,0,0,0,0,0,0,0
20200528,060650,奇力新中信9A購01,,,,,0.00,0.00,0,0,0,0,0,0,0,0,0,0,0,0,0
20200528,060651,瑞儀中信9B購01,1.13,1.14,1.10,1.10,-0.01,-0.9,245000,10,274060,0,0,0,0,0,0,140000,100000,40000,40000
20200528,060652,滬深2X群益9C購04,,,,,0.00,0.00,0,0,0,0,0,0,0,0,0,0,0,0,0
20200528,060653,全新群益9A購02,1.57,1.62,1.56,1.61,0.00,0.00,504000,23,803150,0,0,0,0,0,0,504000,40000,464000,464000
20200528,060654,大毅群益9B購01,1.07,1.08,1.04,1.04,-0.02,-1.89,67000,10,70420,0,0,0,0,0,0,10000,57000,-47000,-47000
20200528,060655,國巨統一9B購06,1.25,1.25,1.25,1.25,-0.02,-1.57,10000,1,12500,0,0,0,0,0,0,0,10000,-10000,-10000
20200528,060656,國巨統一9C購03,,,,,0.00,0.00,0,0,0,0,0,0,0,0,0,0,0,0,0
20200528,060657,旺宏統一9B購05,1.05,1.05,1.00,1.00,-0.07,-6.54,24000,20,25000,0,0,0,0,0,0,21000,3000,18000,18000
20200528,060658,台灣50凱基01購04,1.77,1.77,1.77,1.77,0.00,0.00,1000,1,1770,0,0,0,0,0,0,1000,0,1000,1000
20200528,060659,鴻海凱基9B購03,,,,,0.00,0.00,0,0,0,0,0,0,0,0,0,0,0,0,0
20200528,06065P,大立光台新97售01,,,,,0.00,0.00,0,0,0,0,0,0,0,0,0,0,0,0,0
20200528,060660,國巨凱基9B購04,,,,,0.00,0.00,0,0,0,0,0,0,0,0,0,0,0,0,0
20200528,060661,台積電凱基9A購18,1.38,1.38,1.36,1.37,-0.04,-2.84,19000,4,26090,0,0,0,0,0,0,5000,14000,-9000,-9000
20200528,060662,旺宏凱基9A購03,,,,,0.00,0.00,0,0,0,0,0,0,0,0,0,0,0,0,0
20200528,060663,聯發科凱基9A購13,5.95,6.00,5.95,6.00,0.00,0.00,10000,2,59750,0,0,0,0,0,0,5000,5000,0,0
20200528,060664,聯詠凱基9A購01,1.37,1.37,1.34,1.34,-0.03,-2.19,9000,2,12210,0,0,0,0,0,0,5000,4000,1000,1000
20200528,060665,康控凱基9A購01,,,,,0.00,0.00,0,0,0,0,0,0,0,0,0,0,0,0,0
20200528,060666,聯茂凱基9A購02,0.81,0.81,0.81,0.81,+0.02,2.53,51000,2,41310,0,0,0,0,0,0,50000,1000,49000,49000
20200528,060667,力成凱基9A購01,1.33,1.37,1.25,1.27,-0.06,-4.51,233000,19,307120,0,0,0,0,0,0,167000,66000,101000,101000
20200528,060668,上証2X元大9A購02,,,,,0.00,0.00,0,0,0,0,0,0,0,0,0,0,0,0,0
20200528,060669,上証2X元大9A購03,,,,,0.00,0.00,0,0,0,0,0,0,0,0,0,0,0,0,0
20200528,06066P,群創台新98售01,,,,,0.00,0.00,0,0,0,0,0,0,0,0,0,0,0,0,0
20200528,060670,臺指反元大01購03,0.64,0.65,0.64,0.65,0.00,0.00,22000,3,14280,0,0,0,0,0,0,2000,20000,-18000,-18000
20200528,060671,亞德客元大9A購03,2.37,2.46,2.17,2.18,-0.09,-3.96,433000,33,1017040,0,0,0,0,0,0,284000,155000,129000,129000
20200528,060672,鴻海元大9A購14,,,,,0.00,0.00,0,0,0,0,0,0,0,0,0,0,0,0,0
20200528,060673,旺宏元大9A購04,1.77,1.79,1.77,1.79,+0.01,0.56,50000,5,89100,0,0,0,0,0,0,50000,0,50000,50000
20200528,060674,瑞昱元大9A購03,2.33,2.35,2.28,2.32,+0.06,2.65,169000,22,394790,20000,0,20000,0,0,0,29000,166000,-137000,-117000
20200528,060675,南亞科元大9A購02,1.95,2.00,1.92,1.92,+0.09,4.92,95000,10,185200,0,0,0,0,0,0,85000,10000,75000,75000
20200528,060676,京元電元大9A購03,0.96,0.96,0.90,0.91,-0.04,-4.21,156000,4,142980,0,0,0,0,0,0,38000,118000,-80000,-80000
20200528,060677,京元電元大9A購04,1.35,1.35,1.26,1.26,-0.08,-5.97,213000,15,276830,0,0,0,0,0,0,149000,77000,72000,72000
20200528,060678,聯詠元大9A購03,,,,,0.00,0.00,0,0,0,0,0,0,0,0,0,0,0,0,0
20200528,060679,聯詠元大9A購04,1.98,2.02,1.96,1.98,-0.03,-1.49,120000,5,236920,0,0,0,0,0,0,53000,70000,-17000,-17000
20200528,06067P,華新科康和97售01,0.65,0.73,0.65,0.73,+0.04,5.8,277000,14,189190,0,0,0,0,0,0,157000,120000,37000,37000
20200528,060680,玉晶光元大9C購03,3.90,4.12,3.85,3.85,+0.08,2.12,72000,20,287970,0,0,0,0,0,0,17000,67000,-50000,-50000
20200528,060681,華擎元大9A購02,2.08,2.08,2.08,2.08,0.00,0.00,1000,1,2080,0,0,0,0,0,0,0,1000,-1000,-1000
20200528,060682,牧德元大9A購03,1.52,1.54,1.47,1.48,-0.08,-5.13,129000,6,192430,0,0,0,0,0,0,90000,39000,51000,51000
20200528,060683,泰鼎元大9A購02,3.94,3.98,3.81,3.89,-0.03,-0.77,161000,6,615560,0,0,0,0,0,0,159000,11000,148000,148000
20200528,060684,同欣電元大9A購01,2.13,2.13,2.01,2.01,-0.10,-4.74,170000,16,355280,0,0,0,0,0,0,105000,64000,41000,41000
20200528,060685,康友元大9A購01,,,,,0.00,0.00,0,0,0,0,0,0,0,0,0,0,0,0,0
20200528,060686,康友元大9A購02,1.41,1.41,1.41,1.41,-0.02,-1.4,80000,1,112800,0,0,0,0,0,0,80000,0,80000,80000
20200528,060687,GIS元大9A購01,3.58,3.58,3.58,3.58,+0.21,6.23,5000,1,17900,0,0,0,0,0,0,5000,0,5000,5000
20200528,060688,世紀鋼元大9C購01,2.11,2.50,2.11,2.39,+0.25,11.68,382000,39,884680,0,0,0,0,0,0,132000,256000,-124000,-124000
20200528,060689,臺股指元大9A購43,,,,,0.00,0.00,0,0,0,0,0,0,0,0,0,0,0,0,0
20200528,06068P,玉晶光康和97售01,0.61,0.78,0.61,0.78,+0.03,4.0,53000,7,35700,0,0,0,0,0,0,32000,20000,12000,12000
20200528,060690,臺股指元大9A購46,,,,,0.00,0.00,0,0,0,0,0,0,0,0,0,0,0,0,0
20200528,060691,臺股指元大9A購47,,,,,0.00,0.00,0,0,0,0,0,0,0,0,0,0,0,0,0
20200528,060692,鴻海麥證9A購01,1.69,1.69,1.69,1.69,+0.06,3.68,9000,1,15210,9000,0,9000,0,0,0,9000,0,9000,9000
20200528,060693,台積電麥證9A購02,,,,,0.00,0.00,0,0,0,0,0,0,0,0,0,0,0,0,0
20200528,060694,旺宏麥證9A購02,1.80,1.80,1.80,1.80,0.00,0.00,10000,1,18000,0,10000,-10000,0,0,0,0,10000,-10000,-10000
20200528,060695,同欣電麥證9A購01,1.13,1.13,1.07,1.07,-0.06,-5.31,108000,6,116890,80000,23000,57000,0,0,0,80000,23000,57000,57000
20200528,060696,道瓊反國泰9C購01,0.76,0.77,0.76,0.77,-0.08,-9.41,213000,4,161910,0,0,0,0,0,0,213000,0,213000,213000
20200528,060697,鴻海國泰9C購01,1.71,1.71,1.66,1.66,+0.05,3.11,4000,3,6790,0,0,0,0,0,0,4000,4000,0,0
20200528,060698,旺宏國泰9C購01,2.02,2.03,1.88,1.88,-0.16,-7.84,772000,64,1547390,6000,0,6000,0,0,0,736000,68000,668000,674000
20200528,060699,華新科國泰9B購03,1.96,1.97,1.89,1.91,-0.04,-2.05,78000,18,151810,0,0,0,0,0,0,58000,20000,38000,38000
20200528,06069P,台積電永豐97售01,,,,,0.00,0.00,0,0,0,0,0,0,0,0,0,0,0,0,0
20200528,060700,華新科國泰9C購01,1.82,1.83,1.73,1.73,-0.10,-5.46,178000,26,320330,0,0,0,0,0,0,167000,11000,156000,156000
20200528,060701,玉晶光國泰9C購01,1.92,2.03,1.90,2.01,+0.18,9.84,199000,17,394930,0,0,0,0,0,0,114000,86000,28000,28000
20200528,060702,玉晶光國泰9C購02,1.72,1.82,1.71,1.71,+0.04,2.4,79000,13,138090,0,0,0,0,0,0,45000,29000,16000,16000
20200528,060703,T50反1富邦9C購01,0.58,0.59,0.58,0.59,0.00,0.00,16000,2,9290,0,0,0,0,0,0,0,16000,-16000,-16000
20200528,060704,台積電富邦01購01,0.74,0.74,0.70,0.70,-0.02,-2.78,30000,3,21400,0,0,0,0,0,0,10000,20000,-10000,-10000
20200528,060705,台光電富邦9B購01,,,,,0.00,0.00,0,0,0,0,0,0,0,0,0,0,0,0,0
20200528,060706,群創富邦9A購01,0.61,0.61,0.61,0.61,0.00,0.00,16000,1,9760,0,0,0,0,0,0,0,16000,-16000,-16000
20200528,060707,台郡富邦9A購01,0.61,0.61,0.59,0.59,-0.02,-3.28,173000,16,104600,0,0,0,0,0,0,138000,35000,103000,103000
20200528,060708,康友富邦9B購01,0.61,0.61,0.61,0.61,-0.03,-4.69,160000,1,97600,0,0,0,0,0,0,160000,0,160000,160000
20200528,060709,緯穎富邦9B購01,0.79,0.83,0.73,0.74,-0.04,-5.13,358000,17,280260,0,0,0,0,0,0,207000,141000,66000,66000
20200528,06070P,漢唐永豐97售01,,,,,0.00,0.00,0,0,0,0,0,0,0,0,0,0,0,0,0
20200528,060710,上銀永豐9A購01,2.27,2.32,2.22,2.32,+0.03,1.31,41000,18,92380,0,0,0,0,0,0,41000,0,41000,41000
20200528,060711,旺宏永豐9A購01,,,,,0.00,0.00,0,0,0,0,0,0,0,0,0,0,0,0,0
20200528,060712,建準永豐9A購01,2.84,3.06,2.67,2.71,+0.06,2.26,101000,13,279590,1000,0,1000,0,0,0,11000,90000,-79000,-78000
20200528,060713,聯詠永豐9A購01,1.05,1.05,1.02,1.02,-0.04,-3.77,137000,5,141260,0,0,0,0,0,0,14000,123000,-109000,-109000
20200528,060714,晶技永豐9A購02,1.46,1.47,1.44,1.46,-0.10,-6.41,99000,16,144560,0,0,0,0,0,0,99000,0,99000,99000
20200528,060715,日電貿永豐9A購01,1.14,1.15,1.10,1.10,-0.04,-3.51,473000,25,537090,0,0,0,0,0,0,421000,52000,369000,369000
20200528,060716,新唐永豐9A購01,1.11,1.20,1.11,1.15,+0.08,7.48,669000,25,782950,0,0,0,0,0,0,2000,487000,-485000,-485000
20200528,060717,康控永豐9A購01,0.78,0.78,0.75,0.75,-0.03,-3.85,6000,2,4650,0,0,0,0,0,0,6000,5000,1000,1000
20200528,060718,中磊永豐9A購01,1.34,1.35,1.27,1.27,-0.06,-4.51,93000,8,124170,0,0,0,0,0,0,72000,85000,-13000,-13000
20200528,060719,瀚宇博永豐9A購01,0.69,0.72,0.69,0.72,+0.04,5.88,618000,10,442710,0,0,0,0,0,0,80000,538000,-458000,-458000
20200528,06071P,大立光永豐97售01,,,,,0.00,0.00,0,0,0,0,0,0,0,0,0,0,0,0,0
20200528,060720,嘉聯益永豐9A購02,0.71,0.78,0.71,0.77,0.00,0.00,179000,9,135740,0,0,0,0,0,0,0,179000,-179000,-179000
20200528,060721,瑞儀永豐9A購01,1.27,1.30,1.24,1.27,+0.03,2.42,604000,22,760510,0,0,0,0,0,0,323000,281000,42000,42000
20200528,060722,矽格永豐9A購01,1.19,1.19,1.19,1.19,+0.02,1.71,8000,1,9520,0,0,0,0,0,0,8000,0,8000,8000
20200528,060723,致新永豐9A購01,1.34,1.49,1.34,1.49,+0.17,12.88,583000,60,829050,0,0,0,0,0,0,239000,339000,-100000,-100000
20200528,060724,台灣50第一9A購02,0.79,0.79,0.79,0.79,0.00,0.00,5000,1,3950,0,0,0,0,0,0,0,5000,-5000,-5000
20200528,060725,台積電第一9A購01,,,,,0.00,0.00,0,0,0,0,0,0,0,0,0,0,0,0,0
20200528,060726,聯發科第一9A購01,,,,,0.00,0.00,0,0,0,0,0,0,0,0,0,0,0,0,0
20200528,060727,高股息中信9C購02,,,,,0.00,0.00,0,0,0,0,0,0,0,0,0,0,0,0,0
20200528,060728,上証2X群益9C購05,,,,,0.00,0.00,0,0,0,0,0,0,0,0,0,0,0,0,0
20200528,060729,國巨群益9A購05,,,,,0.00,0.00,0,0,0,0,0,0,0,0,0,0,0,0,0
20200528,06072P,牧德永豐97售01,,,,,0.00,0.00,0,0,0,0,0,0,0,0,0,0,0,0,0
20200528,060730,台積電群益9A購03,1.99,1.99,1.99,1.99,-0.17,-7.87,30000,1,59700,0,0,0,0,0,0,0,30000,-30000,-30000
20200528,060731,奇力新群益9A購01,0.84,0.84,0.84,0.84,0.00,0.00,6000,1,5040,0,0,0,0,0,0,0,6000,-6000,-6000
20200528,060732,玉晶光群益9C購02,1.79,1.85,1.77,1.77,+0.02,1.14,298000,6,539380,0,0,0,0,0,0,0,298000,-298000,-298000
20200528,060733,和大統一9C購01,1.20,1.22,1.20,1.22,+0.04,3.39,210000,3,254040,0,0,0,0,0,0,0,210000,-210000,-210000
20200528,060734,華通統一9C購01,1.20,1.31,1.20,1.25,+0.09,7.76,237000,16,299810,0,0,0,0,0,0,103000,145000,-42000,-42000
20200528,060735,鴻海統一9C購03,0.92,0.92,0.92,0.92,+0.01,1.1,92000,1,84640,0,0,0,0,0,0,92000,0,92000,92000
20200528,060736,旺宏統一01購01,1.15,1.15,1.08,1.08,-0.07,-6.09,68000,10,75710,0,0,0,0,0,0,10000,58000,-48000,-48000
20200528,060737,瑞儀統一9C購01,1.33,1.34,1.32,1.34,0.00,0.00,63000,5,83250,0,0,0,0,0,0,1000,62000,-61000,-61000
20200528,060738,矽格統一9C購01,1.30,1.30,1.26,1.26,-0.04,-3.08,26000,3,33400,0,0,0,0,0,0,16000,10000,6000,6000
20200528,060739,台灣50台新9A購04,,,,,0.00,0.00,0,0,0,0,0,0,0,0,0,0,0,0,0
20200528,06073P,健策永豐97售01,0.40,0.45,0.40,0.45,0.00,0.00,128000,3,54250,0,0,0,0,0,0,0,128000,-128000,-128000
20200528,060740,T50反1台新9C購02,,,,,0.00,0.00,0,0,0,0,0,0,0,0,0,0,0,0,0
20200528,060741,滬深2X國票9A購05,,,,,0.00,0.00,0,0,0,0,0,0,0,0,0,0,0,0,0
20200528,060742,臺指反國票9B購02,0.34,0.37,0.34,0.37,+0.02,5.71,140000,6,50130,0,0,0,0,0,0,0,140000,-140000,-140000
20200528,060743,鴻海國票9A購03,,,,,0.00,0.00,0,0,0,0,0,0,0,0,0,0,0,0,0
20200528,060744,鴻海國票9A購04,1.48,1.48,1.37,1.41,-0.05,-3.42,220000,15,314470,0,0,0,0,0,0,45000,175000,-130000,-130000
20200528,060745,京元電國票9A購01,0.56,0.56,0.56,0.56,-0.05,-8.2,40000,4,22400,0,0,0,0,0,0,0,40000,-40000,-40000
20200528,060746,玉晶光國票9B購02,2.15,2.28,2.10,2.12,+0.07,3.41,640000,32,1411690,0,0,0,0,0,0,570000,66000,504000,504000
20200528,060747,聯鈞國票9A購02,2.64,2.71,2.61,2.61,+0.04,1.56,70000,7,186280,0,0,0,0,0,0,10000,60000,-50000,-50000
20200528,060748,臻鼎國票9A購01,2.12,2.13,1.91,1.91,-0.15,-7.28,131000,10,263850,0,0,0,0,0,0,25000,106000,-81000,-81000
20200528,060749,祥碩國票9A購01,,,,,0.00,0.00,0,0,0,0,0,0,0,0,0,0,0,0,0
20200528,06074P,台積電凱基98售04,,,,,0.00,0.00,0,0,0,0,0,0,0,0,0,0,0,0,0
20200528,060750,高股息元大9A購01,,,,,0.00,0.00,0,0,0,0,0,0,0,0,0,0,0,0,0
20200528,060751,高股息元大9B購01,1.53,1.54,1.53,1.54,+0.02,1.32,2000,2,3070,0,0,0,0,0,0,1000,1000,0,0
20200528,060752,上銀元大9A購04,,,,,0.00,0.00,0,0,0,0,0,0,0,0,0,0,0,0,0
20200528,060753,上銀元大9A購05,,,,,0.00,0.00,0,0,0,0,0,0,0,0,0,0,0,0,0
20200528,060754,華通元大9A購04,2.52,2.76,2.52,2.58,+0.17,7.05,188000,13,495130,0,0,0,0,0,0,0,188000,-188000,-188000
20200528,060755,鴻海元大9A購15,1.45,1.45,1.43,1.45,+0.03,2.11,111000,6,160100,0,0,0,0,0,0,100000,11000,89000,89000
20200528,060756,鴻海元大9A購16,1.37,1.37,1.37,1.37,+0.02,1.48,68000,1,93160,0,0,0,0,0,0,68000,0,68000,68000
20200528,060757,台積電元大9A購18,2.27,2.27,2.24,2.24,-0.11,-4.68,3000,2,6750,0,0,0,0,0,0,2000,1000,1000,1000
20200528,060758,台積電元大9A購19,1.22,1.22,1.14,1.15,-0.04,-3.36,437000,18,515410,0,0,0,0,0,0,147000,290000,-143000,-143000
20200528,060759,南亞科元大9A購03,1.67,1.72,1.66,1.71,+0.16,10.32,208000,17,351380,0,0,0,0,0,0,208000,0,208000,208000
20200528,06075P,智邦凱基97售02,,,,,0.00,0.00,0,0,0,0,0,0,0,0,0,0,0,0,0
20200528,060760,南亞科元大9A購04,2.44,2.46,2.32,2.32,+0.02,0.87,92000,10,224430,0,0,0,0,0,0,60000,32000,28000,28000
20200528,060761,南亞科元大9A購05,1.35,1.35,1.22,1.23,0.00,0.00,296000,12,372170,0,0,0,0,0,0,69000,224000,-155000,-155000
20200528,060762,長榮航元大9A購02,2.61,2.61,2.42,2.42,-0.14,-5.47,246000,10,620260,0,0,0,0,0,0,197000,49000,148000,148000
20200528,060763,聯鈞元大9A購03,1.28,1.30,1.25,1.25,+0.01,0.81,541000,20,687600,0,0,0,0,0,0,412000,129000,283000,283000
20200528,060764,華擎元大9A購03,1.51,1.51,1.42,1.42,-0.03,-2.07,102000,11,148350,0,0,0,0,0,0,100000,2000,98000,98000
20200528,060765,世芯元大9A購01,,,,,0.00,0.00,0,0,0,0,0,0,0,0,0,0,0,0,0
20200528,060766,世芯元大9A購02,2.86,2.86,2.70,2.82,+0.06,2.17,78000,7,215050,0,0,0,0,0,0,17000,61000,-44000,-44000
20200528,060767,世紀鋼元大9A購02,1.09,1.23,1.09,1.18,+0.14,13.46,212000,15,249610,0,0,0,0,0,0,56000,195000,-139000,-139000
20200528,060768,鴻海麥證9A購02,1.26,1.26,1.20,1.20,-0.02,-1.64,62000,3,76240,32000,30000,2000,0,0,0,32000,32000,0,0
20200528,060769,國巨麥證9A購02,,,,,0.00,0.00,0,0,0,0,0,0,0,0,0,0,0,0,0
20200528,06076P,大立光凱基98售03,,,,,0.00,0.00,0,0,0,0,0,0,0,0,0,0,0,0,0
20200528,060770,宏達電麥證9A購01,1.54,1.54,1.54,1.54,-0.07,-4.35,6000,1,9240,0,6000,-6000,0,0,0,0,6000,-6000,-6000
20200528,060771,滬深2X凱基9B購02,,,,,0.00,0.00,0,0,0,0,0,0,0,0,0,0,0,0,0
20200528,060772,FBVIX凱基9A購03,,,,,0.00,0.00,0,0,0,0,0,0,0,0,0,0,0,0,0
20200528,060773,FBVIX凱基9A購04,,,,,0.00,0.00,0,0,0,0,0,0,0,0,0,0,0,0,0
20200528,060774,南亞科凱基9A購01,1.03,1.04,0.98,0.98,+0.02,2.08,75000,5,76880,0,0,0,0,0,0,30000,45000,-15000,-15000
20200528,060775,世芯凱基9A購02,2.58,2.65,2.55,2.64,-0.09,-3.3,24000,4,62270,0,0,0,0,0,0,6000,18000,-12000,-12000
20200528,060776,世芯凱基9B購01,2.03,2.13,2.03,2.13,+0.03,1.43,203000,5,416920,0,0,0,0,0,0,144000,59000,85000,85000
20200528,060777,茂林凱基9C購01,1.84,1.85,1.79,1.81,-0.04,-2.16,189000,20,345760,0,0,0,0,0,0,157000,22000,135000,135000
20200528,060778,臺股指凱基9A購06,2.88,2.88,2.60,2.60,-0.21,-7.47,46000,3,122680,0,0,0,0,0,0,46000,0,46000,46000
20200528,060779,臺股指凱基9A購07,3.60,3.62,3.30,3.33,-0.20,-5.67,35000,8,121140,0,0,0,0,0,0,9000,26000,-17000,-17000
20200528,06077P,GIS凱基97售02,0.60,0.78,0.60,0.78,+0.05,6.85,150000,3,100800,0,0,0,0,0,0,150000,0,150000,150000
20200528,060780,祥碩國泰9B購01,,,,,0.00,0.00,0,0,0,0,0,0,0,0,0,0,0,0,0
20200528,060781,台郡國泰9B購01,1.85,1.87,1.83,1.84,0.00,0.00,175000,16,324060,0,20000,-20000,0,0,0,130000,45000,85000,65000
20200528,060782,道瓊指富邦9C購01,0.89,0.89,0.88,0.89,+0.07,8.54,5000,4,4420,0,0,0,0,0,0,3000,2000,1000,1000
20200528,060783,亞德客富邦9B購01,1.37,1.45,1.23,1.23,-0.11,-8.21,1602000,155,2230310,0,0,0,0,0,0,1327000,281000,1046000,1046000
20200528,060784,鴻海富邦9C購01,0.80,0.81,0.77,0.77,0.00,0.00,98000,11,78380,0,0,0,0,0,0,80000,18000,62000,62000
20200528,060785,國巨富邦9B購04,0.74,0.76,0.71,0.71,-0.02,-2.74,887000,23,658320,0,0,0,0,0,0,739000,554000,185000,185000
20200528,060786,聯發科富邦9B購06,1.80,1.80,1.80,1.80,0.00,0.00,1000,1,1800,0,0,0,0,0,0,0,0,0,0
20200528,060787,奇力新富邦9A購01,,,,,0.00,0.00,0,0,0,0,0,0,0,0,0,0,0,0,0
20200528,060788,嘉晶富邦9B購01,1.62,1.64,1.52,1.53,-0.17,-10.0,24000,7,37730,0,0,0,0,0,0,7000,15000,-8000,-8000
20200528,060789,禾伸堂富邦9B購02,1.07,1.07,1.07,1.07,0.00,0.00,5000,2,5350,0,0,0,0,0,0,5000,2000,3000,3000
20200528,06078P,臺股指凱基9A售01,,,,,0.00,0.00,0,0,0,0,0,0,0,0,0,0,0,0,0
20200528,060790,日月光富邦9A購01,0.47,0.47,0.46,0.46,-0.01,-2.13,13000,2,6080,0,0,0,0,0,0,10000,3000,7000,7000
20200528,060791,聯茂富邦9A購02,0.45,0.45,0.45,0.45,0.00,0.00,21000,2,9450,0,0,0,0,0,0,0,21000,-21000,-21000
20200528,060792,信錦永豐9A購01,1.17,1.17,1.16,1.16,-0.03,-2.52,406000,24,473060,0,0,0,0,0,0,406000,0,406000,406000
20200528,060793,微星永豐9A購01,2.54,2.59,2.54,2.59,+0.07,2.78,70000,5,179280,0,0,0,0,0,0,38000,32000,6000,6000
20200528,060794,景碩永豐9A購02,1.56,1.63,1.56,1.56,+0.02,1.3,244000,20,390320,0,0,0,0,0,0,10000,234000,-224000,-224000
20200528,060795,世芯永豐9A購02,2.11,2.11,2.11,2.11,+0.01,0.48,10000,1,21100,0,0,0,0,0,0,10000,0,10000,10000
20200528,060796,世芯永豐9A購03,1.96,2.02,1.93,2.02,0.00,0.00,126000,9,248220,0,0,0,0,0,0,68000,58000,10000,10000
20200528,060797,世芯永豐9A購04,,,,,0.00,0.00,0,0,0,0,0,0,0,0,0,0,0,0,0
20200528,060798,旭富永豐9A購01,0.52,0.53,0.52,0.52,-0.02,-3.7,102000,8,53120,0,0,0,0,0,0,8000,94000,-86000,-86000
20200528,060799,茂林永豐9A購01,1.16,1.17,1.10,1.10,-0.08,-6.78,161000,21,187120,0,0,0,0,0,0,160000,1000,159000,159000
20200528,06079P,燿華群益98售02,,,,,0.00,0.00,0,0,0,0,0,0,0,0,0,0,0,0,0
20200528,060800,華新科第一9A購01,0.85,0.85,0.85,0.85,-0.01,-1.16,20000,3,17000,0,0,0,0,0,0,20000,0,20000,20000
20200528,060801,滬深2X中信01購01,,,,,0.00,0.00,0,0,0,0,0,0,0,0,0,0,0,0,0
20200528,060802,道瓊指中信9C購03,0.92,0.92,0.92,0.92,+0.08,9.52,7000,1,6440,0,0,0,0,0,0,7000,0,7000,7000
20200528,060803,台灣50群益9A購13,,,,,0.00,0.00,0,0,0,0,0,0,0,0,0,0,0,0,0
20200528,060804,T50反1群益9A購02,0.37,0.39,0.37,0.39,+0.01,2.63,284000,6,108320,0,0,0,0,0,0,14000,270000,-256000,-256000
20200528,060805,國巨群益9A購06,,,,,0.00,0.00,0,0,0,0,0,0,0,0,0,0,0,0,0
20200528,060806,華新科群益9A購03,,,,,0.00,0.00,0,0,0,0,0,0,0,0,0,0,0,0,0
20200528,060807,新光金群益9A購01,0.70,0.70,0.64,0.64,-0.06,-8.57,371000,6,247700,0,0,0,0,0,0,21000,350000,-329000,-329000
20200528,060808,欣興群益9A購01,2.24,2.27,2.24,2.27,0.00,0.00,6000,3,13470,0,0,0,0,0,0,1000,6000,-5000,-5000
20200528,060809,康友群益9A購01,1.23,1.24,1.14,1.14,-0.13,-10.24,158000,3,192420,0,0,0,0,0,0,0,158000,-158000,-158000
20200528,06080P,景碩群益98售02,,,,,0.00,0.00,0,0,0,0,0,0,0,0,0,0,0,0,0
20200528,060810,滬深2X凱基9B購03,,,,,0.00,0.00,0,0,0,0,0,0,0,0,0,0,0,0,0
20200528,060811,亞德客凱基9A購02,2.02,2.15,1.86,1.86,-0.13,-6.53,89000,15,179390,0,0,0,0,0,0,53000,42000,11000,11000
20200528,060812,智邦凱基9A購01,2.66,2.74,2.39,2.39,0.00,0.00,95000,9,238930,0,0,0,0,0,0,11000,84000,-73000,-73000
20200528,060813,高鐵凱基9A購01,2.11,2.11,1.91,1.91,-0.09,-4.5,214000,50,438140,0,0,0,0,0,0,210000,4000,206000,206000
20200528,060814,健策凱基9B購01,2.20,2.24,2.06,2.06,-0.15,-6.79,83000,22,184010,0,0,0,0,0,0,82000,1000,81000,81000
20200528,060815,茂林凱基9B購01,1.98,1.98,1.96,1.96,-0.07,-3.45,109000,10,214480,0,0,0,0,0,0,109000,0,109000,109000
20200528,060816,世紀鋼凱基9C購02,0.73,0.87,0.73,0.82,+0.07,9.33,1108000,72,896700,0,0,0,0,0,0,477000,576000,-99000,-99000
20200528,060817,華邦電台新9A購01,1.60,1.69,1.38,1.38,-0.02,-1.43,930000,36,1469320,0,0,0,0,0,0,768000,142000,626000,626000
20200528,060818,上銀統一9C購01,2.07,2.08,2.04,2.04,-0.06,-2.86,41000,11,84400,0,0,0,0,0,0,41000,0,41000,41000
20200528,060819,國巨統一9C購04,0.94,0.94,0.89,0.89,-0.02,-2.2,362000,6,327180,0,0,0,0,0,0,202000,160000,42000,42000
20200528,06081P,深中小元大97售02,,,,,0.00,0.00,0,0,0,0,0,0,0,0,0,0,0,0,0
20200528,060820,上証2X元大9A購04,,,,,0.00,0.00,0,0,0,0,0,0,0,0,0,0,0,0,0
20200528,060821,SP黃豆元大9A購02,1.06,1.06,1.05,1.05,0.00,0.00,35000,2,36800,0,0,0,0,0,0,30000,5000,25000,25000
20200528,060822,華通元大9A購05,3.11,3.13,3.11,3.11,0.00,0.00,14000,6,43560,0,0,0,0,0,0,14000,14000,0,0
20200528,060823,旺宏元大9A購05,1.74,1.77,1.70,1.70,-0.07,-3.95,74000,4,129860,0,0,0,0,0,0,18000,56000,-38000,-38000
20200528,060824,旺宏元大9A購06,2.73,2.75,2.52,2.52,-0.22,-8.03,105000,6,275000,0,0,0,0,0,0,35000,75000,-40000,-40000
20200528,060825,聯詠元大9A購05,1.85,1.85,1.77,1.83,0.00,0.00,149000,10,271960,0,0,0,0,0,0,84000,69000,15000,15000
20200528,060826,牧德元大9B購02,1.52,1.52,1.43,1.43,-0.06,-4.03,39000,6,57160,0,0,0,0,0,0,4000,35000,-31000,-31000
20200528,060827,健策元大9A購02,2.70,2.70,2.70,2.70,+0.04,1.5,5000,1,13500,0,0,0,0,0,0,5000,0,5000,5000
20200528,060828,高股息國票9A購01,,,,,0.00,0.00,0,0,0,0,0,0,0,0,0,0,0,0,0
20200528,060829,T50反1國票9A購06,0.50,0.54,0.50,0.54,+0.03,5.88,130000,4,67800,0,0,0,0,0,0,70000,60000,10000,10000
20200528,06082P,華通統一98售01,1.66,1.66,1.66,1.66,0.00,0.00,10000,1,16600,0,0,0,0,0,0,0,10000,-10000,-10000
20200528,060830,T50反1國票9A購07,,,,,0.00,0.00,0,0,0,0,0,0,0,0,0,0,0,0,0
20200528,060831,T50反1國票9B購03,0.56,0.57,0.55,0.57,0.00,0.00,230000,9,128700,0,0,0,0,0,0,0,230000,-230000,-230000
20200528,060832,臺指反國票9A購01,,,,,0.00,0.00,0,0,0,0,0,0,0,0,0,0,0,0,0
20200528,060833,道瓊反國票9A購01,0.52,0.53,0.52,0.53,-0.07,-11.67,228000,2,120540,0,0,0,0,0,0,30000,198000,-168000,-168000
20200528,060834,道瓊反國票9C購01,0.80,0.80,0.80,0.80,-0.10,-11.11,2000,1,1600,0,0,0,0,0,0,0,2000,-2000,-2000
20200528,060835,亞德客國票9A購01,3.39,3.57,2.97,2.97,-0.30,-9.17,104000,14,351390,0,0,0,0,0,0,99000,21000,78000,78000
20200528,060836,上銀國票9A購03,7.85,8.05,7.30,7.30,-1.00,-12.05,68000,18,529800,0,0,0,0,0,0,53000,15000,38000,38000
20200528,060837,上銀國票9A購04,,,,,0.00,0.00,0,0,0,0,0,0,0,0,0,0,0,0,0
20200528,060838,華通國票9A購05,7.15,7.45,6.95,6.95,+0.70,11.2,20000,4,147300,0,0,0,0,0,0,7000,20000,-13000,-13000
20200528,060839,聯發科國票9A購02,5.05,5.05,5.05,5.05,0.00,0.00,2000,1,10100,0,0,0,0,0,0,0,2000,-2000,-2000
20200528,06083P,華通統一98售02,1.60,1.60,1.60,1.60,0.00,0.00,2000,1,3200,0,0,0,0,0,0,0,2000,-2000,-2000
20200528,060840,可成國票9B購01,2.34,2.38,2.34,2.38,+0.08,3.48,16000,3,37720,0,0,0,0,0,0,6000,10000,-4000,-4000
20200528,060841,宏達電國票9B購01,1.38,1.38,1.22,1.22,-0.13,-9.63,267000,7,334160,0,0,0,0,0,0,127000,140000,-13000,-13000
20200528,060842,新光金國票9B購01,,,,,0.00,0.00,0,0,0,0,0,0,0,0,0,0,0,0,0
20200528,060843,大立光國票9A購06,2.30,2.33,2.14,2.14,-0.13,-5.73,77000,4,175510,0,0,0,0,0,0,57000,20000,37000,37000
20200528,060844,大立光國票9A購07,2.38,2.38,2.21,2.21,-0.12,-5.15,50000,3,118510,0,0,0,0,0,0,47000,3000,44000,44000
20200528,060845,欣興國票9A購01,4.44,4.83,4.44,4.83,+0.49,11.29,63000,6,290240,0,0,0,0,0,0,22000,41000,-19000,-19000
20200528,060846,欣興國票9A購02,3.89,4.22,3.89,3.95,+0.16,4.22,117000,11,470840,0,0,0,0,0,0,44000,110000,-66000,-66000
20200528,060847,康控國票9A購01,2.60,2.62,2.60,2.62,-0.04,-1.5,18000,2,46980,0,0,0,0,0,0,9000,9000,0,0
20200528,060848,聯茂國票9A購02,1.66,1.68,1.66,1.68,+0.13,8.39,21000,2,35080,0,0,0,0,0,0,11000,10000,1000,1000
20200528,060849,力成國票9A購01,3.89,4.03,3.89,4.03,+0.14,3.6,52000,3,203260,0,0,0,0,0,0,45000,7000,38000,38000
20200528,06084P,宏達電元富97售02,2.41,2.41,2.41,2.41,0.00,0.00,1000,1,2410,0,0,0,0,0,0,1000,0,1000,1000
20200528,060850,康友國票9A購03,1.98,2.01,1.92,1.92,-0.12,-5.88,49000,7,96850,0,0,0,0,0,0,14000,37000,-23000,-23000
20200528,060851,國巨國泰9C購01,2.36,2.37,2.22,2.22,-0.09,-3.9,501000,25,1151020,0,0,0,0,0,0,307000,207000,100000,100000
20200528,060852,京鼎國泰9B購01,2.35,2.35,2.35,2.35,0.00,0.00,10000,1,23500,0,0,0,0,0,0,10000,0,10000,10000
20200528,060853,健策國泰9B購02,2.77,2.77,2.77,2.77,-0.39,-12.34,2000,1,5540,0,0,0,0,0,0,2000,2000,0,0
20200528,060854,台積電富邦9C購08,0.64,0.64,0.64,0.64,-0.02,-3.03,13000,2,8320,0,0,0,0,0,0,0,13000,-13000,-13000
20200528,060855,華新科富邦01購01,0.63,0.63,0.62,0.62,-0.01,-1.59,40000,8,24930,0,0,0,0,0,0,34000,6000,28000,28000
20200528,060856,健策富邦9B購02,1.23,1.23,1.07,1.11,-0.06,-5.13,313000,37,363770,0,0,0,0,0,0,280000,122000,158000,158000
20200528,060857,旭富富邦9B購01,0.48,0.49,0.46,0.46,-0.05,-9.8,232000,12,111200,0,0,0,0,0,0,152000,75000,77000,77000
20200528,060858,T50反1永豐9A購01,,,,,0.00,0.00,0,0,0,0,0,0,0,0,0,0,0,0,0
20200528,060859,鴻海永豐9A購01,,,,,0.00,0.00,0,0,0,0,0,0,0,0,0,0,0,0,0
20200528,06085P,義隆台新97售01,,,,,0.00,0.00,0,0,0,0,0,0,0,0,0,0,0,0,0
20200528,060860,國巨永豐9A購02,,,,,0.00,0.00,0,0,0,0,0,0,0,0,0,0,0,0,0
20200528,060861,漢唐永豐9A購01,1.59,1.60,1.49,1.50,-0.08,-5.06,121000,14,186700,0,0,0,0,0,0,43000,78000,-35000,-35000
20200528,060862,美律永豐9A購01,1.01,1.02,1.01,1.02,+0.05,5.15,166000,3,168490,0,0,0,0,0,0,0,166000,-166000,-166000
20200528,060863,聯發科永豐9A購02,,,,,0.00,0.00,0,0,0,0,0,0,0,0,0,0,0,0,0
20200528,060864,可成永豐9A購01,1.09,1.09,1.01,1.01,-0.08,-7.34,17000,2,18290,0,0,0,0,0,0,17000,0,17000,17000
20200528,060865,創意永豐9A購01,0.92,0.96,0.91,0.93,+0.01,1.09,397000,17,371130,0,0,0,0,0,0,177000,220000,-43000,-43000
20200528,060866,世芯永豐9B購01,,,,,0.00,0.00,0,0,0,0,0,0,0,0,0,0,0,0,0
20200528,060867,智伸科永豐9A購01,1.24,1.24,1.12,1.13,-0.09,-7.38,419000,29,496290,0,0,0,0,0,0,291000,128000,163000,163000
20200528,060868,致伸永豐9A購01,1.02,1.07,1.02,1.04,0.00,0.00,169000,11,178160,0,0,0,0,0,0,0,169000,-169000,-169000
20200528,060869,超眾永豐9A購02,0.77,0.77,0.77,0.77,-0.12,-13.48,80000,2,61600,0,0,0,0,0,0,80000,0,80000,80000
20200528,06086P,台積電康和97售01,,,,,0.00,0.00,0,0,0,0,0,0,0,0,0,0,0,0,0
20200528,060870,旭富群益9A購01,,,,,0.00,0.00,0,0,0,0,0,0,0,0,0,0,0,0,0
20200528,060871,台灣50中信01購03,0.92,0.92,0.87,0.87,-0.03,-3.33,440000,7,394550,0,0,0,0,0,0,440000,0,440000,440000
20200528,060872,高股息中信02購01,0.97,0.97,0.97,0.97,-0.01,-1.02,27000,1,26190,0,0,0,0,0,0,0,27000,-27000,-27000
20200528,060873,道瓊反中信9C購01,0.67,0.67,0.67,0.67,-0.05,-6.94,23000,1,15410,0,0,0,0,0,0,0,23000,-23000,-23000
20200528,060874,中鋼中信02購01,0.96,0.98,0.96,0.96,+0.01,1.05,40000,6,38840,0,0,0,0,0,0,2000,38000,-36000,-36000
20200528,060875,華通中信02購01,1.66,1.73,1.66,1.73,+0.19,12.34,12000,2,20060,0,0,0,0,0,0,0,12000,-12000,-12000
20200528,060876,國巨中信9A購04,1.35,1.35,1.26,1.26,-0.05,-3.82,168000,6,217240,0,0,0,0,0,0,168000,0,168000,168000
20200528,060877,華邦電中信02購01,1.11,1.15,1.11,1.11,+0.11,11.0,74000,19,83460,0,0,0,0,0,0,74000,0,74000,74000
20200528,060878,奇力新中信9C購01,,,,,0.00,0.00,0,0,0,0,0,0,0,0,0,0,0,0,0
20200528,060879,華新科中信9A購02,0.85,0.85,0.84,0.85,-0.01,-1.16,20000,11,16960,0,0,0,0,0,0,20000,0,20000,20000
20200528,06087P,國巨永豐97售01,0.95,0.95,0.95,0.95,-0.02,-2.06,10000,1,9500,0,0,0,0,0,0,0,10000,-10000,-10000
20200528,060880,中壽中信9C購01,0.83,0.83,0.76,0.76,-0.07,-8.43,241000,10,194810,0,0,0,0,0,0,235000,6000,229000,229000
20200528,060881,玉山金中信02購01,,,,,0.00,0.00,0,0,0,0,0,0,0,0,0,0,0,0,0
20200528,060882,大立光中信9A購05,,,,,0.00,0.00,0,0,0,0,0,0,0,0,0,0,0,0,0
20200528,060884,超眾中信9B購01,0.64,0.66,0.64,0.64,+0.01,1.59,197000,10,126420,0,0,0,0,0,0,195000,2000,193000,193000
20200528,060885,世紀鋼中信9A購01,0.67,0.72,0.67,0.70,+0.07,11.11,100000,10,70620,0,0,0,0,0,0,75000,25000,50000,50000
20200528,060886,國巨統一01購03,1.59,1.59,1.58,1.58,+0.02,1.28,30000,5,47650,0,0,0,0,0,0,26000,4000,22000,22000
20200528,060887,台積電統一01購01,1.09,1.09,1.09,1.09,-0.02,-1.8,83000,4,90470,0,0,0,0,0,0,3000,83000,-80000,-80000
20200528,060888,金像電統一9C購01,1.51,1.51,1.39,1.42,-0.02,-1.39,190000,22,276190,0,0,0,0,0,0,102000,64000,38000,38000
20200528,060889,國泰金統一9C購01,1.40,1.40,1.40,1.40,+0.03,2.19,48000,1,67200,0,0,0,0,0,0,48000,0,48000,48000
20200528,06088P,建準永豐97售01,,,,,0.00,0.00,0,0,0,0,0,0,0,0,0,0,0,0,0
20200528,060890,大立光統一01購01,0.92,0.92,0.86,0.87,-0.02,-2.25,204000,16,183820,0,0,0,0,0,0,92000,112000,-20000,-20000
20200528,060891,世芯統一9A購01,,,,,0.00,0.00,0,0,0,0,0,0,0,0,0,0,0,0,0
20200528,060892,超眾統一9C購01,,,,,0.00,0.00,0,0,0,0,0,0,0,0,0,0,0,0,0
20200528,060893,台灣50凱基01購07,,,,,0.00,0.00,0,0,0,0,0,0,0,0,0,0,0,0,0
20200528,060894,奇力新凱基9A購03,0.99,0.99,0.99,0.99,-0.06,-5.71,3000,1,2970,0,0,0,0,0,0,3000,0,3000,3000
20200528,060895,華新科凱基9B購05,1.50,1.51,1.43,1.43,-0.09,-5.92,30000,5,44320,0,0,0,0,0,0,20000,10000,10000,10000
20200528,060896,晶技凱基9A購02,1.41,1.42,1.38,1.40,-0.08,-5.41,375000,52,525690,0,0,0,0,0,0,233000,132000,101000,101000
20200528,060897,健策凱基9A購04,2.22,2.22,2.02,2.02,-0.18,-8.18,54000,17,119600,0,0,0,0,0,0,54000,0,54000,54000
20200528,060898,世芯凱基9A購03,1.94,2.11,1.94,2.11,-0.12,-5.38,12000,3,23560,0,0,0,0,0,0,10000,0,10000,10000
20200528,060899,超眾凱基9A購01,1.01,1.01,1.01,1.01,-0.12,-10.62,10000,1,10100,0,0,0,0,0,0,10000,0,10000,10000
20200528,06089P,矽創永豐97售01,0.46,0.46,0.46,0.46,-0.18,-28.12,2000,1,920,0,0,0,0,0,0,0,2000,-2000,-2000
20200528,060900,超眾凱基9B購01,1.23,1.23,1.23,1.23,-0.05,-3.91,10000,1,12300,0,0,0,0,0,0,10000,0,10000,10000
20200528,060901,臺股指凱基9A購13,2.97,3.00,2.67,2.69,-0.21,-7.24,187000,19,543100,0,0,0,0,0,0,119000,68000,51000,51000
20200528,060902,上証2X元大9A購05,,,,,0.00,0.00,0,0,0,0,0,0,0,0,0,0,0,0,0
20200528,060903,臺指反元大9A購01,,,,,0.00,0.00,0,0,0,0,0,0,0,0,0,0,0,0,0
20200528,060904,臺指反元大9C購07,,,,,0.00,0.00,0,0,0,0,0,0,0,0,0,0,0,0,0
20200528,060905,台積電元大9A購20,2.84,2.84,2.84,2.84,+0.02,0.71,42000,1,119280,0,0,0,0,0,0,0,42000,-42000,-42000
20200528,060906,旺宏元大9A購07,3.34,3.43,3.34,3.37,-0.01,-0.3,140000,16,473990,0,0,0,0,0,0,127000,13000,114000,114000
20200528,060907,金像電元大9A購02,4.10,4.10,3.76,3.87,+0.04,1.04,123000,13,483050,0,0,0,0,0,0,47000,76000,-29000,-29000
20200528,060908,金像電元大9A購03,3.40,3.40,3.21,3.21,-0.04,-1.23,216000,12,705350,0,0,0,0,0,0,44000,172000,-128000,-128000
20200528,060909,金像電元大9B購01,6.15,6.20,5.60,5.75,-0.10,-1.71,90000,12,537100,0,0,0,0,0,0,31000,59000,-28000,-28000
20200528,06090P,旺宏統一97售06,2.15,2.32,2.15,2.32,+0.17,7.91,72000,3,163640,0,0,0,0,0,0,0,72000,-72000,-72000
20200528,060910,聯發科元大9A購05,5.00,5.00,4.84,4.84,-0.16,-3.2,21000,2,103240,0,0,0,0,0,0,0,21000,-21000,-21000
20200528,060911,大毅元大9A購01,2.79,2.79,2.70,2.70,-0.05,-1.82,141000,7,389120,0,0,0,0,0,0,89000,52000,37000,37000
20200528,060912,華新科元大9A購10,1.65,1.66,1.57,1.57,-0.10,-5.99,30000,4,49000,0,0,0,0,0,0,20000,10000,10000,10000
20200528,060913,宏達電元大9A購03,1.88,1.88,1.64,1.64,-0.20,-10.87,94000,8,168490,0,0,0,0,0,0,21000,89000,-68000,-68000
20200528,060914,健策元大9A購03,2.00,2.00,1.82,1.82,-0.06,-3.19,177000,11,350930,0,0,0,0,0,0,172000,5000,167000,167000
20200528,060915,旭富元大9A購01,1.20,1.24,1.18,1.18,-0.05,-4.07,568000,13,688440,0,0,0,0,0,0,213000,355000,-142000,-142000
20200528,060916,金像電國泰9C購01,2.60,2.60,2.33,2.46,0.00,0.00,305000,37,752520,0,0,0,0,0,0,204000,143000,61000,61000
20200528,060917,台表科國泰9B購01,,,,,0.00,0.00,0,0,0,0,0,0,0,0,0,0,0,0,0
20200528,060918,康友國泰9C購01,1.50,1.51,1.48,1.48,-0.01,-0.67,63000,8,93990,0,0,0,0,0,0,16000,50000,-34000,-34000
20200528,060919,滬深2X富邦9B購01,,,,,0.00,0.00,0,0,0,0,0,0,0,0,0,0,0,0,0
20200528,06091P,華新科統一97售01,2.76,2.80,2.76,2.80,+0.10,3.7,69000,3,192040,0,0,0,0,0,0,0,69000,-69000,-69000
20200528,060920,超眾富邦9B購01,0.35,0.37,0.33,0.34,-0.01,-2.86,585000,19,204030,0,0,0,0,0,0,506000,277000,229000,229000
20200528,060921,中橡永豐9A購02,0.71,0.71,0.69,0.69,-0.01,-1.43,143000,2,101330,0,0,0,0,0,0,0,143000,-143000,-143000
20200528,060922,金像電永豐9A購01,1.82,1.82,1.68,1.69,-0.01,-0.59,82000,26,143740,0,0,0,0,0,0,40000,36000,4000,4000
20200528,060923,全新永豐9A購01,0.83,0.83,0.83,0.83,0.00,0.00,15000,2,12450,0,0,0,0,0,0,0,15000,-15000,-15000
20200528,060924,大毅永豐9A購03,1.11,1.11,1.11,1.11,-0.03,-2.63,20000,2,22200,0,0,0,0,0,0,20000,0,20000,20000
20200528,060925,華新科永豐9A購01,1.05,1.06,1.05,1.06,-0.01,-0.93,20000,4,21020,0,0,0,0,0,0,20000,0,20000,20000
20200528,060926,宏達電永豐9A購01,1.33,1.33,1.25,1.25,-0.12,-8.76,77000,8,98140,0,0,0,0,0,0,31000,50000,-19000,-19000
20200528,060927,嘉晶永豐9A購01,,,,,0.00,0.00,0,0,0,0,0,0,0,0,0,0,0,0,0
20200528,060928,明泰永豐9A購01,,,,,0.00,0.00,0,0,0,0,0,0,0,0,0,0,0,0,0
20200528,060929,健策永豐9A購01,1.71,1.71,1.68,1.68,-0.02,-1.18,69000,10,117590,0,0,0,0,0,0,69000,0,69000,69000
20200528,06092P,嘉聯益統一97售01,,,,,0.00,0.00,0,0,0,0,0,0,0,0,0,0,0,0,0
20200528,060930,超眾永豐9A購03,0.63,0.64,0.63,0.64,-0.04,-5.88,66000,2,42140,0,0,0,0,0,0,10000,56000,-46000,-46000
20200528,060931,GIS永豐9A購01,2.26,2.26,1.96,1.96,-0.14,-6.67,130000,8,277520,0,0,0,0,0,0,90000,40000,50000,50000
20200528,060932,南六永豐9A購02,1.77,1.86,1.75,1.75,-0.06,-3.31,211000,23,379680,0,0,0,0,0,0,149000,62000,87000,87000
20200528,060933,南電永豐9A購02,0.72,0.72,0.72,0.72,-0.05,-6.49,1000,1,720,0,0,0,0,0,0,1000,0,1000,1000
20200528,060934,台汽電永豐9A購02,1.06,1.06,1.06,1.06,-0.01,-0.93,5000,1,5300,0,0,0,0,0,0,0,5000,-5000,-5000
20200528,060935,T50反1國票9A購08,,,,,0.00,0.00,0,0,0,0,0,0,0,0,0,0,0,0,0
20200528,060936,T50反1國票9A購09,0.70,0.76,0.70,0.76,+0.04,5.56,50000,3,36400,0,0,0,0,0,0,30000,20000,10000,10000
20200528,060937,T50反1國票9A購10,0.50,0.55,0.50,0.55,+0.02,3.77,692000,16,374040,0,0,0,0,0,0,652000,10000,642000,642000
20200528,060938,臺指反國票9B購03,,,,,0.00,0.00,0,0,0,0,0,0,0,0,0,0,0,0,0
20200528,060939,鴻海國票9A購06,,,,,0.00,0.00,0,0,0,0,0,0,0,0,0,0,0,0,0
20200528,06093P,華通元富97售03,,,,,0.00,0.00,0,0,0,0,0,0,0,0,0,0,0,0,0
20200528,060940,國巨國票9B購03,3.77,3.79,3.57,3.57,-0.12,-3.25,3000,3,11130,0,0,0,0,0,0,3000,3000,0,0
20200528,060941,台積電國票9B購04,3.17,3.17,3.17,3.17,+0.01,0.32,1000,1,3170,0,0,0,0,0,0,1000,0,1000,1000
20200528,060942,智邦國票9A購02,4.71,4.84,3.99,4.19,+0.29,7.44,314000,14,1332810,0,0,0,0,0,0,259000,238000,21000,21000
20200528,060943,宏達電國票9B購02,2.23,2.23,2.23,2.23,-0.21,-8.61,11000,1,24530,0,0,0,0,0,0,0,11000,-11000,-11000
20200528,060944,國泰金國票9A購01,1.66,1.66,1.50,1.51,-0.20,-11.7,87000,5,137760,0,0,0,0,0,0,38000,49000,-11000,-11000
20200528,060945,緯穎國票9A購02,,,,,0.00,0.00,0,0,0,0,0,0,0,0,0,0,0,0,0
20200528,060946,世紀鋼國票9A購02,1.84,2.37,1.83,2.18,+0.29,15.34,681000,31,1436970,0,0,0,0,0,0,45000,636000,-591000,-591000
20200528,060947,台積電統一9C購03,1.21,1.21,1.19,1.19,0.00,0.00,8000,3,9620,0,0,0,0,0,0,3000,8000,-5000,-5000
20200528,060948,可成第一9A購01,0.66,0.66,0.65,0.65,0.00,0.00,20000,2,13150,0,0,0,0,0,0,20000,0,20000,20000
20200528,060949,祥碩中信9A購01,2.18,2.27,2.04,2.27,+0.11,5.09,75000,6,156970,0,0,0,0,0,0,52000,23000,29000,29000
20200528,06094P,台達電中信97售01,0.56,0.58,0.56,0.58,0.00,0.00,78000,2,43720,0,0,0,0,0,0,78000,76000,2000,2000
20200528,060950,T50反1群益9A購03,,,,,0.00,0.00,0,0,0,0,0,0,0,0,0,0,0,0,0
20200528,060951,元黃金群益9A購01,,,,,0.00,0.00,0,0,0,0,0,0,0,0,0,0,0,0,0
20200528,060952,滬深2X群益9C購05,,,,,0.00,0.00,0,0,0,0,0,0,0,0,0,0,0,0,0
20200528,060953,富邦金群益9A購01,1.63,1.63,1.47,1.47,-0.15,-9.26,57000,5,88340,0,0,0,0,0,0,17000,51000,-34000,-34000
20200528,060954,國泰金群益9A購02,1.12,1.12,1.09,1.09,-0.12,-9.92,110000,2,120260,0,0,0,0,0,0,110000,0,110000,110000
20200528,060955,大立光群益9A購02,,,,,0.00,0.00,0,0,0,0,0,0,0,0,0,0,0,0,0
20200528,060956,超眾群益9A購01,0.98,0.98,0.92,0.92,-0.13,-12.38,95000,2,91900,0,0,0,0,0,0,95000,0,95000,95000
20200528,060957,SP黃豆凱基9A購04,0.99,0.99,0.97,0.97,-0.01,-1.02,120000,2,118400,0,0,0,0,0,0,120000,0,120000,120000
20200528,060958,儒鴻凱基9A購02,1.09,1.09,0.97,0.98,-0.11,-10.09,1100000,59,1148180,0,0,0,0,0,0,821000,272000,549000,549000
20200528,060959,金像電凱基9A購01,1.97,2.00,1.84,1.92,+0.02,1.05,178000,28,343460,0,0,0,0,0,0,120000,50000,70000,70000
20200528,06095P,燿華永豐97售01,,,,,0.00,0.00,0,0,0,0,0,0,0,0,0,0,0,0,0
20200528,060960,金像電凱基9B購01,2.53,2.59,2.41,2.42,-0.04,-1.63,88000,20,219910,0,10000,-10000,0,0,0,67000,16000,51000,41000
20200528,060961,台光電凱基9A購03,1.96,1.97,1.92,1.92,-0.09,-4.48,95000,4,185550,0,0,0,0,0,0,95000,0,95000,95000
20200528,060962,義隆凱基9B購01,0.69,0.73,0.68,0.69,+0.03,4.55,689000,28,483690,0,0,0,0,0,0,272000,417000,-145000,-145000
20200528,060963,禾伸堂凱基9A購01,1.51,1.52,1.51,1.52,+0.01,0.66,30000,3,45400,0,0,0,0,0,0,20000,10000,10000,10000
20200528,060964,日月光凱基9A購01,0.70,0.70,0.70,0.70,-0.01,-1.41,20000,1,14000,0,0,0,0,0,0,20000,0,20000,20000
20200528,060965,中租凱基9B購01,1.13,1.15,1.11,1.11,-0.01,-0.89,423000,13,481810,0,0,0,0,0,0,393000,108000,285000,285000
20200528,060966,台表科凱基9B購01,2.29,2.29,2.05,2.17,-0.02,-0.91,100000,6,213020,0,0,0,0,0,0,80000,90000,-10000,-10000
20200528,060967,鈺齊凱基9A購02,1.64,1.75,1.57,1.59,+0.09,6.0,557000,42,919230,0,0,0,0,0,0,70000,492000,-422000,-422000
20200528,060968,台灣50元大9C購28,,,,,0.00,0.00,0,0,0,0,0,0,0,0,0,0,0,0,0
20200528,060969,台灣50元大9C購29,,,,,0.00,0.00,0,0,0,0,0,0,0,0,0,0,0,0,0
20200528,06096P,全新永豐97售02,1.42,1.42,1.42,1.42,+0.02,1.43,10000,1,14200,0,0,0,0,0,0,10000,0,10000,10000
20200528,060970,T50反1元大9A購08,,,,,0.00,0.00,0,0,0,0,0,0,0,0,0,0,0,0,0
20200528,060971,T50反1元大9A購09,,,,,0.00,0.00,0,0,0,0,0,0,0,0,0,0,0,0,0
20200528,060972,T50反1元大9A購10,,,,,0.00,0.00,0,0,0,0,0,0,0,0,0,0,0,0,0
20200528,060973,T50反1元大9A購11,1.20,1.20,1.20,1.20,0.00,0.00,5000,1,6000,0,0,0,0,0,0,5000,0,5000,5000
20200528,060974,滬深2X元大01購01,,,,,0.00,0.00,0,0,0,0,0,0,0,0,0,0,0,0,0
20200528,060975,滬深2X元大01購02,,,,,0.00,0.00,0,0,0,0,0,0,0,0,0,0,0,0,0
20200528,060976,SP黃豆元大9A購03,,,,,0.00,0.00,0,0,0,0,0,0,0,0,0,0,0,0,0
20200528,060977,亞德客元大9A購04,4.36,4.53,3.88,3.91,-0.27,-6.46,179000,37,761990,0,0,0,0,0,0,112000,115000,-3000,-3000
20200528,060978,國巨元大9A購13,2.52,2.52,2.39,2.40,-0.08,-3.23,169000,10,415400,0,0,0,0,0,0,101000,68000,33000,33000
20200528,060979,國巨元大9A購14,1.86,1.86,1.86,1.86,+0.02,1.09,10000,1,18600,0,0,0,0,0,0,0,10000,-10000,-10000
20200528,06097P,茂林永豐97售01,,,,,0.00,0.00,0,0,0,0,0,0,0,0,0,0,0,0,0
20200528,060980,台積電元大9A購21,,,,,0.00,0.00,0,0,0,0,0,0,0,0,0,0,0,0,0
20200528,060981,旺宏元大9A購08,2.79,2.87,2.77,2.77,-0.07,-2.46,194000,16,546060,0,0,0,0,0,0,119000,75000,44000,44000
20200528,060982,旺宏元大9A購09,3.05,3.10,3.05,3.06,-0.01,-0.33,144000,12,441680,0,0,0,0,0,0,144000,0,144000,144000
20200528,060983,南亞科元大9A購06,2.40,2.42,2.25,2.26,+0.01,0.44,147000,15,350050,0,0,0,0,0,0,75000,72000,3000,3000
20200528,060984,南亞科元大9A購07,2.45,2.46,2.28,2.28,-0.02,-0.87,27000,5,65140,0,0,0,0,0,0,17000,17000,0,0
20200528,060985,聯發科元大9A購06,5.40,5.40,5.40,5.40,-0.25,-4.42,11000,1,59400,0,0,0,0,0,0,11000,0,11000,11000
20200528,060986,聯發科元大9A購07,2.79,2.81,2.76,2.81,0.00,0.00,90000,5,250300,0,0,0,0,0,0,0,90000,-90000,-90000
20200528,060987,華新科元大9A購11,1.61,1.61,1.55,1.55,-0.10,-6.06,78000,3,123380,0,0,0,0,0,0,58000,28000,30000,30000
20200528,060988,華新科元大9A購12,1.12,1.16,1.10,1.11,-0.04,-3.48,118000,10,131640,0,0,0,0,0,0,101000,17000,84000,84000
20200528,060989,國泰金元大9A購02,2.35,2.35,2.20,2.20,-0.12,-5.17,110000,6,251320,0,0,0,0,0,0,66000,44000,22000,22000
20200528,06098P,T50反1日盛97售02,,,,,0.00,0.00,0,0,0,0,0,0,0,0,0,0,0,0,0
20200528,060990,新光金元大9B購03,,,,,0.00,0.00,0,0,0,0,0,0,0,0,0,0,0,0,0
20200528,060991,京鼎元大9A購01,2.42,2.42,2.31,2.31,-0.04,-1.7,112000,4,268340,0,0,0,0,0,0,106000,8000,98000,98000
20200528,060992,健策元大9A購05,2.11,2.11,1.89,1.89,-0.09,-4.55,90000,9,186500,0,0,0,0,0,0,80000,10000,70000,70000
20200528,060993,健策元大9B購03,1.96,1.96,1.73,1.73,-0.07,-3.89,95000,10,182080,0,0,0,0,0,0,34000,82000,-48000,-48000
20200528,060994,世芯元大9A購03,3.58,3.58,3.58,3.58,-0.28,-7.25,5000,1,17900,0,0,0,0,0,0,5000,5000,0,0
20200528,060995,泰鼎元大9A購03,3.29,3.31,3.14,3.14,-0.08,-2.48,139000,9,451920,0,0,0,0,0,0,129000,33000,96000,96000
20200528,060996,臻鼎元大9A購01,,,,,0.00,0.00,0,0,0,0,0,0,0,0,0,0,0,0,0
20200528,060997,上銀兆豐9B購01,,,,,0.00,0.00,0,0,0,0,0,0,0,0,0,0,0,0,0
20200528,060998,華通兆豐9A購01,1.18,1.31,1.18,1.21,+0.07,6.14,310000,14,384450,0,0,0,0,0,0,138000,172000,-34000,-34000
20200528,060999,國巨兆豐9A購01,2.10,2.11,2.06,2.06,0.00,0.00,37000,4,77400,0,0,0,0,0,0,37000,0,37000,37000
20200528,06099P,鴻海日盛97售03,,,,,0.00,0.00,0,0,0,0,0,0,0,0,0,0,0,0,0
20200528,061000,旺宏兆豐9A購02,1.38,1.38,1.31,1.31,-0.10,-7.09,61000,27,83670,0,0,0,0,0,0,60000,1000,59000,59000
20200528,061001,智邦兆豐9B購01,2.08,2.08,1.90,1.90,+0.12,6.74,27000,7,53760,0,0,0,0,0,0,23000,0,23000,23000
20200528,061002,瑞昱兆豐9B購01,1.60,1.60,1.57,1.60,+0.03,1.91,66000,3,105510,0,0,0,0,0,0,13000,53000,-40000,-40000
20200528,061003,南亞科兆豐9A購01,1.42,1.45,1.39,1.39,+0.09,6.92,107000,5,153110,0,0,0,0,0,0,12000,95000,-83000,-83000
20200528,061004,友達兆豐9A購01,1.19,1.23,1.19,1.23,-0.01,-0.81,641000,9,780790,0,0,0,0,0,0,41000,600000,-559000,-559000
20200528,061005,可成兆豐9A購01,1.06,1.06,1.00,1.01,-0.02,-1.94,241000,12,244550,0,0,0,0,0,0,3000,241000,-238000,-238000
20200528,061006,新光金兆豐9A購01,0.78,0.78,0.72,0.72,-0.05,-6.49,194000,8,147150,0,0,0,0,0,0,94000,100000,-6000,-6000
20200528,061007,聯詠兆豐9A購01,1.18,1.18,1.18,1.18,0.00,0.00,10000,1,11800,0,0,0,0,0,0,0,10000,-10000,-10000
20200528,061008,群創兆豐9A購02,0.84,0.84,0.80,0.80,0.00,0.00,187000,4,149720,0,0,0,0,0,0,0,187000,-187000,-187000
20200528,061009,台灣50麥證02購02,,,,,0.00,0.00,0,0,0,0,0,0,0,0,0,0,0,0,0
20200528,06100P,台積電日盛97售03,1.20,1.23,1.20,1.23,+0.14,12.84,30000,3,36300,0,0,0,0,0,0,20000,10000,10000,10000
20200528,061010,上銀麥證9A購02,4.55,4.55,4.52,4.52,+0.01,0.22,7000,2,31730,3000,4000,-1000,0,0,0,3000,4000,-1000,-1000
20200528,061011,華通麥證9A購02,1.84,1.93,1.83,1.90,+0.24,14.46,151000,7,283700,25000,126000,-101000,0,0,0,25000,126000,-101000,-101000
20200528,061012,國巨麥證9A購03,,,,,0.00,0.00,0,0,0,0,0,0,0,0,0,0,0,0,0
20200528,061013,台積電麥證9A購03,1.76,1.76,1.63,1.63,-0.12,-6.86,309000,2,504840,0,309000,-309000,0,0,0,0,309000,-309000,-309000
20200528,061014,台積電麥證9A購04,,,,,0.00,0.00,0,0,0,0,0,0,0,0,0,0,0,0,0
20200528,061015,旺宏麥證9A購03,2.49,2.50,2.31,2.31,-0.18,-7.23,23000,4,56750,16000,7000,9000,0,0,0,16000,7000,9000,9000
20200528,061016,可成麥證9A購01,,,,,0.00,0.00,0,0,0,0,0,0,0,0,0,0,0,0,0
20200528,061017,國泰金麥證9A購01,,,,,0.00,0.00,0,0,0,0,0,0,0,0,0,0,0,0,0
20200528,061018,台積電國票9B購05,,,,,0.00,0.00,0,0,0,0,0,0,0,0,0,0,0,0,0
20200528,061019,大毅國票9A購01,3.19,3.19,3.06,3.06,-0.22,-6.71,22000,3,68530,0,0,0,0,0,0,21000,1000,20000,20000
20200528,06101P,聯發科日盛97售03,,,,,0.00,0.00,0,0,0,0,0,0,0,0,0,0,0,0,0
20200528,061020,超眾國票9A購02,1.74,1.79,1.74,1.74,-0.24,-12.12,95000,3,166100,0,0,0,0,0,0,79000,16000,63000,63000
20200528,061021,聯電國泰9B購01,1.28,1.36,1.28,1.32,+0.06,4.76,829000,20,1086690,0,0,0,0,0,0,296000,523000,-227000,-227000
20200528,061022,健策國泰9B購03,,,,,0.00,0.00,0,0,0,0,0,0,0,0,0,0,0,0,0
20200528,061023,茂林國泰9B購02,3.10,3.10,2.97,3.02,-0.07,-2.27,28000,5,85690,0,0,0,0,0,0,23000,10000,13000,13000
20200528,061024,南電國泰9B購01,1.25,1.31,1.22,1.22,-0.03,-2.4,293000,15,368740,0,0,0,0,0,0,5000,238000,-233000,-233000
20200528,061025,創意富邦9B購01,0.66,0.68,0.64,0.65,0.00,0.00,295000,12,196560,0,0,0,0,0,0,128000,162000,-34000,-34000
20200528,061026,南電富邦9B購01,0.43,0.43,0.43,0.43,+0.01,2.38,10000,1,4300,0,0,0,0,0,0,10000,0,10000,10000
20200528,061027,儒鴻永豐9A購02,1.00,1.00,0.90,0.90,-0.10,-10.0,316000,26,300150,0,0,0,0,0,0,156000,160000,-4000,-4000
20200528,061028,聚陽永豐9A購01,1.25,1.26,1.19,1.19,-0.09,-7.03,158000,13,192790,0,0,0,0,0,0,95000,63000,32000,32000
20200528,061029,力山永豐9A購01,3.00,3.00,3.00,3.00,0.00,0.00,6000,1,18000,0,0,0,0,0,0,6000,0,6000,6000
20200528,06102P,智邦凱基97售03,,,,,0.00,0.00,0,0,0,0,0,0,0,0,0,0,0,0,0
20200528,061030,喬山永豐9A購01,1.73,1.73,1.57,1.57,-0.10,-5.99,168000,15,271800,0,0,0,0,0,0,58000,100000,-42000,-42000
20200528,061031,神隆永豐9A購02,0.75,0.75,0.74,0.74,-0.01,-1.33,20000,2,14900,0,0,0,0,0,0,10000,10000,0,0
20200528,061032,金像電永豐9A購03,1.47,1.51,1.35,1.42,0.00,0.00,531000,68,772130,0,0,0,0,0,0,388000,129000,259000,259000
20200528,061033,台光電永豐9A購01,1.31,1.33,1.21,1.22,-0.10,-7.58,201000,18,257290,0,0,0,0,0,0,45000,151000,-106000,-106000
20200528,061034,晶豪科永豐9A購01,1.30,1.34,1.30,1.34,+0.09,7.2,81000,3,107590,0,0,0,0,0,0,10000,71000,-61000,-61000
20200528,061035,亞光永豐9A購01,0.80,0.80,0.80,0.80,-0.02,-2.44,24000,1,19200,0,0,0,0,0,0,24000,0,24000,24000
20200528,061036,晶技永豐9A購03,0.98,1.04,0.98,1.04,-0.02,-1.89,215000,6,220090,0,0,0,0,0,0,215000,0,215000,215000
20200528,061037,嘉澤永豐9A購01,1.96,1.96,1.86,1.87,-0.27,-12.62,36000,4,69750,0,0,0,0,0,0,16000,20000,-4000,-4000
20200528,061038,TPK永豐9A購01,0.79,0.82,0.79,0.82,+0.03,3.8,51000,10,40980,0,0,0,0,0,0,51000,0,51000,51000
20200528,061039,台表科永豐9A購03,1.69,1.69,1.69,1.69,-0.17,-9.14,10000,1,16900,0,0,0,0,0,0,10000,0,10000,10000
20200528,06103P,漢唐凱基97售02,,,,,0.00,0.00,0,0,0,0,0,0,0,0,0,0,0,0,0
20200528,061040,康友永豐9A購01,,,,,0.00,0.00,0,0,0,0,0,0,0,0,0,0,0,0,0
20200528,061041,南電永豐9A購03,,,,,0.00,0.00,0,0,0,0,0,0,0,0,0,0,0,0,0
20200528,061042,致新永豐9A購02,1.14,1.27,1.13,1.27,+0.17,15.45,1428000,56,1687310,0,0,0,0,0,0,955000,473000,482000,482000
20200528,061043,百和永豐9A購01,1.03,1.05,1.00,1.00,-0.01,-0.99,357000,13,370080,0,0,0,0,0,0,342000,13000,329000,329000
20200528,061044,世紀鋼永豐9A購02,0.95,1.23,0.95,1.23,+0.27,28.13,373000,16,422770,0,0,0,0,0,0,17000,356000,-339000,-339000
20200528,061045,儒鴻第一9A購01,1.12,1.13,1.05,1.05,-0.08,-7.08,95000,15,104710,0,0,0,0,0,0,93000,2000,91000,91000
20200528,061046,上銀第一9A購01,,,,,0.00,0.00,0,0,0,0,0,0,0,0,0,0,0,0,0
20200528,061047,大立光第一9A購01,,,,,0.00,0.00,0,0,0,0,0,0,0,0,0,0,0,0,0
20200528,061048,國巨中信9A購05,0.75,0.75,0.75,0.75,0.00,0.00,5000,1,3750,0,0,0,0,0,0,0,5000,-5000,-5000
20200528,061049,奇力新中信9A購02,,,,,0.00,0.00,0,0,0,0,0,0,0,0,0,0,0,0,0
20200528,06104P,大立光凱基97售04,,,,,0.00,0.00,0,0,0,0,0,0,0,0,0,0,0,0,0
20200528,061050,康友中信9A購01,,,,,0.00,0.00,0,0,0,0,0,0,0,0,0,0,0,0,0
20200528,061051,臺股指中信9A購06,,,,,0.00,0.00,0,0,0,0,0,0,0,0,0,0,0,0,0
20200528,061052,和大群益9A購01,1.83,1.90,1.83,1.88,0.00,0.00,229000,5,428740,0,0,0,0,0,0,24000,229000,-205000,-205000
20200528,061053,國巨群益9A購08,2.19,2.19,2.19,2.19,+0.11,5.29,5000,1,10950,0,0,0,0,0,0,0,5000,-5000,-5000
20200528,061054,台積電群益9A購04,2.23,2.23,2.19,2.19,0.00,0.00,76000,3,168760,0,0,0,0,0,0,23000,53000,-30000,-30000
20200528,061055,康控群益9A購01,1.42,1.42,1.42,1.42,+0.05,3.65,6000,1,8520,0,0,0,0,0,0,6000,6000,0,0
20200528,061056,臺指反國票02購01,1.22,1.31,1.22,1.29,+0.03,2.38,213000,4,276210,0,0,0,0,0,0,18000,195000,-177000,-177000
20200528,061057,華新科國票9A購04,5.20,5.20,5.20,5.20,-0.30,-5.45,50000,1,260000,0,0,0,0,0,0,0,50000,-50000,-50000
20200528,061058,健策國票9A購05,7.35,7.50,6.55,6.55,-0.70,-9.66,18000,9,129050,0,0,0,0,0,0,14000,4000,10000,10000
20200528,061059,世芯國票9B購01,5.90,5.95,5.60,5.95,+0.25,4.39,63000,8,363950,0,0,0,0,0,0,45000,18000,27000,27000
20200528,06105P,國巨國票98售02,3.83,3.83,3.83,3.83,0.00,0.00,10000,1,38300,0,0,0,0,0,0,0,10000,-10000,-10000
20200528,061060,台灣50麥證9B購01,,,,,0.00,0.00,0,0,0,0,0,0,0,0,0,0,0,0,0
20200528,061061,聯發科麥證9A購02,,,,,0.00,0.00,0,0,0,0,0,0,0,0,0,0,0,0,0
20200528,061062,和大凱基9A購02,1.44,1.47,1.35,1.35,-0.05,-3.57,95000,4,135950,0,0,0,0,0,0,50000,45000,5000,5000
20200528,061063,國巨凱基9A購14,,,,,0.00,0.00,0,0,0,0,0,0,0,0,0,0,0,0,0
20200528,061064,可成凱基9B購02,,,,,0.00,0.00,0,0,0,0,0,0,0,0,0,0,0,0,0
20200528,061065,神基凱基9A購01,0.76,0.77,0.74,0.76,+0.03,4.11,140000,11,106200,0,0,0,0,0,0,140000,0,140000,140000
20200528,061066,嘉晶凱基9B購01,1.86,1.89,1.77,1.80,-0.11,-5.76,168000,15,303090,0,0,0,0,0,0,34000,134000,-100000,-100000
20200528,061067,貿聯凱基9A購03,1.15,1.20,1.13,1.15,-0.01,-0.86,266000,32,307760,0,0,0,0,0,0,163000,100000,63000,63000
20200528,061068,祥碩凱基9B購01,2.53,2.54,2.53,2.54,-0.17,-6.27,20000,2,50700,0,0,0,0,0,0,10000,20000,-10000,-10000
20200528,061069,嘉聯益凱基9A購01,0.79,0.87,0.75,0.81,+0.06,8.0,808000,17,668920,0,0,0,0,0,0,70000,753000,-683000,-683000
20200528,06106P,國巨群益97售02,,,,,0.00,0.00,0,0,0,0,0,0,0,0,0,0,0,0,0
20200528,061070,超眾凱基9C購01,1.15,1.15,1.15,1.15,0.00,0.00,68000,1,78200,0,0,0,0,0,0,0,68000,-68000,-68000
20200528,061071,復盛凱基9A購01,1.56,1.57,1.48,1.49,-0.04,-2.61,299000,15,460630,0,0,0,0,0,0,125000,149000,-24000,-24000
20200528,061072,南電凱基9B購01,0.66,0.66,0.66,0.66,+0.01,1.54,11000,1,7260,0,0,0,0,0,0,11000,0,11000,11000
20200528,061073,T50反1兆豐9A購01,,,,,0.00,0.00,0,0,0,0,0,0,0,0,0,0,0,0,0
20200528,061074,儒鴻兆豐9B購01,1.28,1.28,1.15,1.15,-0.11,-8.73,565000,28,697410,0,0,0,0,0,0,469000,96000,373000,373000
20200528,061075,亞德客兆豐9A購01,1.69,1.79,1.52,1.54,-0.12,-7.23,264000,24,448400,0,0,0,0,0,0,232000,41000,191000,191000
20200528,061076,台達電兆豐9A購01,1.23,1.23,1.15,1.15,-0.09,-7.26,45000,8,54210,0,0,0,0,0,0,25000,20000,5000,5000
20200528,061077,國巨兆豐9B購01,1.07,1.07,1.07,1.07,+0.01,0.94,5000,1,5350,0,0,0,0,0,0,0,5000,-5000,-5000
20200528,061078,台積電兆豐9A購01,1.25,1.25,1.17,1.17,-0.08,-6.4,56000,5,68450,0,0,0,0,0,0,41000,15000,26000,26000
20200528,061079,台積電兆豐9A購02,,,,,0.00,0.00,0,0,0,0,0,0,0,0,0,0,0,0,0
20200528,06107P,美律群益98售02,,,,,0.00,0.00,0,0,0,0,0,0,0,0,0,0,0,0,0
20200528,061080,華邦電兆豐9B購01,1.27,1.33,1.09,1.09,-0.13,-10.66,1845000,141,2326610,0,0,0,0,0,0,1564000,189000,1375000,1375000
20200528,061081,宏碁兆豐9A購01,0.84,0.86,0.82,0.85,0.00,0.00,217000,10,181700,0,0,0,0,0,0,89000,128000,-39000,-39000
20200528,061082,台光電兆豐9A購01,1.91,1.91,1.91,1.91,-0.19,-9.05,10000,1,19100,0,0,0,0,0,0,0,10000,-10000,-10000
20200528,061083,京元電兆豐9A購01,,,,,0.00,0.00,0,0,0,0,0,0,0,0,0,0,0,0,0
20200528,061084,京元電兆豐9A購02,0.58,0.58,0.56,0.56,-0.03,-5.08,128000,4,73340,0,0,0,0,0,0,127000,1000,126000,126000
20200528,061085,聯茂兆豐9A購01,0.42,0.47,0.41,0.45,+0.03,7.14,581000,24,259280,0,0,0,0,0,0,285000,296000,-11000,-11000
20200528,061086,FBVIX統一01購01,0.90,0.90,0.90,0.90,0.00,0.00,61000,1,54900,0,0,0,0,0,0,0,61000,-61000,-61000
20200528,061087,國巨統一01購04,1.10,1.10,1.04,1.04,-0.03,-2.8,141000,8,152550,0,0,0,0,0,0,117000,24000,93000,93000
20200528,061088,國巨統一9C購05,1.09,1.09,1.08,1.08,+0.01,0.93,2000,2,2170,0,0,0,0,0,0,0,2000,-2000,-2000
20200528,061089,台積電統一9C購04,,,,,0.00,0.00,0,0,0,0,0,0,0,0,0,0,0,0,0
20200528,06108P,奇力新群益97售05,,,,,0.00,0.00,0,0,0,0,0,0,0,0,0,0,0,0,0
20200528,061090,奇力新統一9C購01,,,,,0.00,0.00,0,0,0,0,0,0,0,0,0,0,0,0,0
20200528,061091,奇力新統一9C購02,0.62,0.62,0.60,0.60,-0.04,-6.25,437000,5,269840,0,0,0,0,0,0,29000,408000,-379000,-379000
20200528,061092,可成統一9C購02,0.90,0.92,0.89,0.90,+0.01,1.12,61000,6,55410,0,0,0,0,0,0,11000,50000,-39000,-39000
20200528,061093,華新科統一9B購03,0.80,0.80,0.80,0.80,0.00,0.00,20000,1,16000,0,0,0,0,0,0,20000,0,20000,20000
20200528,061094,彩晶統一9B購02,0.68,0.69,0.68,0.69,+0.03,4.55,203000,6,138400,0,0,0,0,0,0,0,203000,-203000,-203000
20200528,061095,台積電台新9B購03,0.86,0.86,0.82,0.82,-0.03,-3.53,55000,5,46600,0,0,0,0,0,0,0,35000,-35000,-35000
20200528,061096,上証2X元大9A購06,,,,,0.00,0.00,0,0,0,0,0,0,0,0,0,0,0,0,0
20200528,061097,上証2X元大9A購07,,,,,0.00,0.00,0,0,0,0,0,0,0,0,0,0,0,0,0
20200528,061098,滬深2X元大9A購06,,,,,0.00,0.00,0,0,0,0,0,0,0,0,0,0,0,0,0
20200528,061099,滬深2X元大9A購07,,,,,0.00,0.00,0,0,0,0,0,0,0,0,0,0,0,0,0
20200528,06109P,華新科群益97售05,,,,,0.00,0.00,0,0,0,0,0,0,0,0,0,0,0,0,0
20200528,061100,SP黃豆元大9A購04,0.48,0.48,0.47,0.47,-0.01,-2.08,35000,2,16750,0,0,0,0,0,0,35000,0,35000,35000
20200528,061101,道瓊銀元大9A購02,1.74,1.74,1.70,1.74,+0.13,8.07,301000,14,522140,0,0,0,0,0,0,300000,101000,199000,199000
20200528,061102,台積電元大9A購22,1.59,1.59,1.59,1.59,-0.01,-0.62,65000,1,103350,0,0,0,0,0,0,65000,0,65000,65000
20200528,061103,聯發科元大9A購08,6.15,6.15,6.15,6.15,0.00,0.00,19000,1,116850,0,0,0,0,0,0,0,19000,-19000,-19000
20200528,061104,華新科元大9A購13,1.63,1.63,1.63,1.63,+0.05,3.16,1000,1,1630,0,0,0,0,0,0,1000,0,1000,1000
20200528,061105,宏達電元大9A購04,1.81,1.81,1.64,1.64,-0.16,-8.89,162000,11,279480,0,0,0,0,0,0,94000,85000,9000,9000
20200528,061106,群創元大9B購09,1.19,1.19,1.18,1.18,-0.03,-2.48,136000,2,161160,0,0,0,0,0,0,68000,68000,0,0
20200528,061107,世芯元大9A購05,3.52,3.52,3.52,3.52,-0.28,-7.37,5000,1,17600,0,0,0,0,0,0,5000,5000,0,0
20200528,061108,臻鼎元大9A購02,2.02,2.02,1.92,1.92,-0.08,-4.0,10000,2,19700,0,0,0,0,0,0,10000,0,10000,10000
20200528,061109,臻鼎元大9A購03,2.16,2.16,2.02,2.02,-0.08,-3.81,123000,8,263370,0,0,0,0,0,0,52000,71000,-19000,-19000
20200528,06110P,國巨國泰98售02,2.08,2.08,2.04,2.04,-0.05,-2.39,31000,3,63740,0,0,0,0,0,0,31000,31000,0,0
20200528,061110,超眾元大9A購03,1.78,1.85,1.74,1.85,-0.18,-8.87,164000,10,295340,0,0,0,0,0,0,114000,50000,64000,64000
20200528,061111,台表科元大9A購02,2.62,2.62,2.57,2.60,0.00,0.00,63000,4,163080,0,0,0,0,0,0,4000,59000,-55000,-55000
20200528,061112,台表科元大9A購03,3.72,3.72,3.47,3.47,-0.19,-5.19,25000,4,87930,0,0,0,0,0,0,25000,24000,1000,1000
20200528,061113,南電元大9A購03,1.20,1.20,1.20,1.20,-0.09,-6.98,68000,1,81600,0,0,0,0,0,0,68000,0,68000,68000
20200528,061114,南電元大9A購04,0.90,0.90,0.90,0.90,0.00,0.00,18000,2,16200,0,0,0,0,0,0,18000,0,18000,18000
20200528,061115,電子類元大9A購02,2.94,2.94,2.94,2.94,0.00,0.00,2000,1,5880,0,0,0,0,0,0,2000,0,2000,2000
20200528,061116,金融類元大9A購02,,,,,0.00,0.00,0,0,0,0,0,0,0,0,0,0,0,0,0
20200528,061117,美律國泰9C購01,1.68,1.73,1.65,1.65,+0.03,1.85,102000,7,172970,0,0,0,0,0,0,59000,65000,-6000,-6000
20200528,061118,GIS富邦9A購01,1.42,1.42,1.26,1.26,-0.02,-1.56,4000,4,5480,0,0,0,0,0,0,3000,1000,2000,2000
20200528,061119,國巨永豐9A購03,1.00,1.00,1.00,1.00,0.00,0.00,200000,1,200000,0,0,0,0,0,0,200000,0,200000,200000
20200528,06111P,上銀兆豐98售01,,,,,0.00,0.00,0,0,0,0,0,0,0,0,0,0,0,0,0
20200528,061120,台積電永豐9A購03,1.12,1.12,1.12,1.12,+0.03,2.75,1000,1,1120,0,0,0,0,0,0,1000,0,1000,1000
20200528,061121,智邦永豐9A購02,1.63,1.86,1.59,1.61,+0.11,7.33,186000,21,319800,0,0,0,0,0,0,69000,117000,-48000,-48000
20200528,061122,敬鵬永豐9A購01,0.78,0.81,0.73,0.73,-0.04,-5.19,175000,9,137350,0,0,0,0,0,0,13000,162000,-149000,-149000
20200528,061123,燿華永豐9A購01,0.86,0.88,0.86,0.88,+0.02,2.33,80000,2,69400,0,0,0,0,0,0,80000,0,80000,80000
20200528,061124,微星永豐9A購02,1.07,1.09,1.03,1.09,+0.07,6.86,206000,6,217040,0,0,0,0,0,0,85000,121000,-36000,-36000
20200528,061125,億光永豐9A購01,1.06,1.06,1.05,1.05,-0.01,-0.94,26000,4,27540,0,0,0,0,0,0,2000,13000,-11000,-11000
20200528,061126,京元電永豐9A購02,0.35,0.35,0.34,0.34,-0.02,-5.56,214000,5,74410,0,0,0,0,0,0,204000,10000,194000,194000
20200528,061127,美食永豐9A購01,1.82,1.82,1.79,1.79,-0.01,-0.56,40000,2,72500,0,0,0,0,0,0,30000,10000,20000,20000
20200528,061128,大立光永豐9A購02,,,,,0.00,0.00,0,0,0,0,0,0,0,0,0,0,0,0,0
20200528,061129,文曄永豐9A購01,0.85,0.85,0.85,0.85,0.00,0.00,8000,1,6800,0,0,0,0,0,0,0,8000,-8000,-8000
20200528,06112P,台積電兆豐97售01,,,,,0.00,0.00,0,0,0,0,0,0,0,0,0,0,0,0,0
20200528,061130,牧德永豐9A購04,,,,,0.00,0.00,0,0,0,0,0,0,0,0,0,0,0,0,0
20200528,061131,崇越永豐9A購01,1.01,1.01,0.95,0.95,-0.04,-4.04,136000,2,133280,0,0,0,0,0,0,68000,68000,0,0
20200528,061132,志超永豐9A購01,1.28,1.39,1.27,1.35,+0.10,8.0,1095000,70,1475620,0,0,0,0,0,0,175000,896000,-721000,-721000
20200528,061133,玉晶光第一9A購01,0.92,0.96,0.92,0.96,0.00,0.00,30000,3,28100,0,0,0,0,0,0,30000,0,30000,30000
20200528,061134,大成鋼統一9C購01,0.91,1.01,0.91,1.00,+0.08,8.7,660000,16,637660,0,0,0,0,0,0,3000,657000,-654000,-654000
20200528,061135,聯發科統一9C購03,,,,,0.00,0.00,0,0,0,0,0,0,0,0,0,0,0,0,0
20200528,061136,可成統一9A購01,0.75,0.75,0.71,0.71,-0.01,-1.39,82000,3,58780,0,0,0,0,0,0,62000,20000,42000,42000
20200528,061137,晶技統一9B購01,0.56,0.57,0.54,0.55,-0.02,-3.51,765000,11,425190,0,0,0,0,0,0,236000,499000,-263000,-263000
20200528,061138,晶技統一9C購01,0.57,0.57,0.55,0.55,-0.05,-8.33,77000,5,43470,0,0,0,0,0,0,2000,75000,-73000,-73000
20200528,061139,玉晶光統一9C購02,1.03,1.09,1.03,1.06,+0.06,6.0,39000,5,41940,0,0,0,0,0,0,12000,27000,-15000,-15000
20200528,06113P,台積電群益97售01,,,,,0.00,0.00,0,0,0,0,0,0,0,0,0,0,0,0,0
20200528,061140,華擎統一9C購01,0.97,0.97,0.97,0.97,-0.03,-3.0,1000,1,970,0,0,0,0,0,0,1000,0,1000,1000
20200528,061141,臻鼎統一9A購01,1.23,1.23,1.13,1.13,-0.10,-8.13,153000,4,185770,0,0,0,0,0,0,100000,53000,47000,47000
20200528,061142,南電統一9A購01,0.44,0.44,0.42,0.42,0.00,0.00,155000,3,66620,0,0,0,0,0,0,76000,79000,-3000,-3000
20200528,061143,道瓊指中信9C購04,0.84,0.84,0.84,0.84,+0.04,5.0,5000,1,4200,0,0,0,0,0,0,5000,0,5000,5000
20200528,061144,玉晶光中信9B購02,0.63,0.63,0.63,0.63,+0.03,5.0,48000,1,30240,0,0,0,0,0,0,0,48000,-48000,-48000
20200528,061145,臻鼎中信9A購02,0.97,0.97,0.88,0.88,-0.05,-5.38,231000,10,218530,0,0,0,0,0,0,90000,141000,-51000,-51000
20200528,061146,台表科中信9A購02,1.60,1.61,1.60,1.60,-0.04,-2.44,40000,3,64200,0,0,0,0,0,0,20000,20000,0,0
20200528,061147,上証2X群益9C購06,,,,,0.00,0.00,0,0,0,0,0,0,0,0,0,0,0,0,0
20200528,061148,道瓊反群益9A購02,,,,,0.00,0.00,0,0,0,0,0,0,0,0,0,0,0,0,0
20200528,061149,華通群益9A購05,2.50,2.61,2.40,2.44,+0.19,8.44,85000,11,214290,0,0,0,0,0,0,40000,45000,-5000,-5000
20200528,06114P,台積電統一97售03,,,,,0.00,0.00,0,0,0,0,0,0,0,0,0,0,0,0,0
20200528,061150,國巨群益9A購09,2.09,2.09,2.05,2.05,0.00,0.00,103000,7,213350,0,0,0,0,0,0,0,103000,-103000,-103000
20200528,061151,友訊群益9A購01,1.51,1.54,1.50,1.53,+0.02,1.32,181000,9,274720,0,0,0,0,0,0,100000,81000,19000,19000
20200528,061152,微星群益9A購01,2.56,2.56,2.51,2.51,-0.05,-1.95,7000,2,17820,0,0,0,0,0,0,7000,0,7000,7000
20200528,061153,奇力新群益9A購02,,,,,0.00,0.00,0,0,0,0,0,0,0,0,0,0,0,0,0
20200528,061154,可成群益9B購04,1.44,1.44,1.37,1.37,-0.01,-0.72,27000,2,37340,0,0,0,0,0,0,22000,5000,17000,17000
20200528,061155,華新科群益9A購06,1.44,1.44,1.40,1.40,-0.02,-1.41,104000,3,149360,0,0,0,0,0,0,94000,10000,84000,84000
20200528,061156,玉晶光群益9A購07,1.70,1.78,1.66,1.66,+0.02,1.22,361000,11,630170,0,0,0,0,0,0,0,361000,-361000,-361000
20200528,061157,聯鈞群益9A購02,0.91,0.92,0.91,0.92,+0.01,1.1,162000,5,147600,0,0,0,0,0,0,144000,18000,126000,126000
20200528,061158,世芯群益9A購02,,,,,0.00,0.00,0,0,0,0,0,0,0,0,0,0,0,0,0
20200528,061159,同欣電群益9A購01,1.48,1.51,1.40,1.43,-0.04,-2.72,403000,26,590940,0,0,0,0,0,0,137000,266000,-129000,-129000
20200528,06115P,台積電統一97售04,,,,,0.00,0.00,0,0,0,0,0,0,0,0,0,0,0,0,0
20200528,061160,瑞祺群益9A購01,1.65,1.70,1.65,1.70,+0.10,6.25,122000,4,203700,0,0,0,0,0,0,6000,106000,-100000,-100000
20200528,061161,南六群益9A購01,2.70,2.87,2.70,2.82,+0.12,4.44,9000,5,24590,0,0,0,0,0,0,0,9000,-9000,-9000
20200528,061162,南電群益9A購02,,,,,0.00,0.00,0,0,0,0,0,0,0,0,0,0,0,0,0
20200528,061163,台灣50兆豐9A購04,,,,,0.00,0.00,0,0,0,0,0,0,0,0,0,0,0,0,0
20200528,061164,燿華兆豐9B購01,1.01,1.03,0.97,0.98,-0.03,-2.97,346000,11,348050,0,0,0,0,0,0,154000,192000,-38000,-38000
20200528,061165,美律兆豐9A購01,1.00,1.02,1.00,1.02,+0.07,7.37,242000,5,244490,0,0,0,0,0,0,75000,167000,-92000,-92000
20200528,061166,玉晶光兆豐9B購01,1.20,1.20,1.07,1.07,-0.03,-2.73,23000,3,26300,0,0,0,0,0,0,0,23000,-23000,-23000
20200528,061167,臻鼎兆豐9B購01,1.59,1.61,1.53,1.53,-0.08,-4.97,86000,11,136460,0,0,0,0,0,0,8000,78000,-70000,-70000
20200528,061168,力成兆豐9A購01,1.10,1.14,1.06,1.06,-0.02,-1.85,663000,34,736410,0,0,0,0,0,0,186000,467000,-281000,-281000
20200528,061169,GIS兆豐9A購01,2.57,2.57,2.30,2.30,-0.06,-2.54,144000,6,352710,0,0,0,0,0,0,144000,0,144000,144000
20200528,06116P,臺股指日盛97售01,,,,,0.00,0.00,0,0,0,0,0,0,0,0,0,0,0,0,0
20200528,061170,南茂兆豐9B購01,1.14,1.14,1.08,1.08,-0.09,-7.69,329000,15,370940,0,0,0,0,0,0,299000,30000,269000,269000
20200528,061171,大立光麥證9A購01,1.41,1.41,1.30,1.30,-0.11,-7.8,21000,3,28510,11000,10000,1000,0,0,0,11000,10000,1000,1000
20200528,061172,大立光麥證9A購02,,,,,0.00,0.00,0,0,0,0,0,0,0,0,0,0,0,0,0
20200528,061173,T50反1凱基04購01,,,,,0.00,0.00,0,0,0,0,0,0,0,0,0,0,0,0,0
20200528,061174,鴻海凱基9A購23,,,,,0.00,0.00,0,0,0,0,0,0,0,0,0,0,0,0,0
20200528,061175,台積電凱基9A購19,3.27,3.27,3.27,3.27,-0.03,-0.91,3000,1,9810,0,0,0,0,0,0,0,3000,-3000,-3000
20200528,061176,聯發科凱基9A購14,,,,,0.00,0.00,0,0,0,0,0,0,0,0,0,0,0,0,0
20200528,061177,大立光凱基9A購10,2.77,2.77,2.77,2.77,+0.06,2.21,10000,1,27700,0,0,0,0,0,0,10000,0,10000,10000
20200528,061178,晶技凱基9B購01,,,,,0.00,0.00,0,0,0,0,0,0,0,0,0,0,0,0,0
20200528,061179,華擎凱基9A購01,1.50,1.53,1.50,1.53,+0.06,4.08,2000,2,3030,0,0,0,0,0,0,1000,1000,0,0
20200528,06117P,臺股指日盛97售02,7.10,7.10,7.10,7.10,0.00,0.00,1000,1,7100,0,0,0,0,0,0,0,1000,-1000,-1000
20200528,061180,華擎凱基9B購01,1.94,1.94,1.94,1.94,+0.04,2.11,61000,1,118340,0,0,0,0,0,0,0,61000,-61000,-61000
20200528,061181,牧德凱基9A購01,1.00,1.00,1.00,1.00,-0.06,-5.66,5000,1,5000,0,0,0,0,0,0,5000,0,5000,5000
20200528,061182,南六凱基9A購01,1.72,1.72,1.69,1.69,+0.01,0.6,72000,2,121740,0,0,0,0,0,0,72000,0,72000,72000
20200528,061183,友達國泰9B購02,1.40,1.43,1.36,1.36,0.00,0.00,55000,4,76900,0,0,0,0,0,0,31000,41000,-10000,-10000
20200528,061184,大立光國泰9C購01,1.53,1.53,1.42,1.42,-0.06,-4.05,153000,11,226920,0,0,0,0,0,0,103000,135000,-32000,-32000
20200528,061185,嘉晶國泰9B購01,,,,,0.00,0.00,0,0,0,0,0,0,0,0,0,0,0,0,0
20200528,061186,牧德國泰9C購01,1.59,1.61,1.51,1.52,-0.08,-5.0,159000,13,247410,0,0,0,0,0,0,53000,101000,-48000,-48000
20200528,061187,瀚宇博國泰9C購01,1.40,1.41,1.37,1.38,0.00,0.00,1233000,58,1708760,0,0,0,0,0,0,833000,440000,393000,393000
20200528,061188,大成鋼富邦9B購01,0.78,0.87,0.76,0.80,+0.03,3.9,1159000,37,934360,0,0,0,0,0,0,270000,729000,-459000,-459000
20200528,061189,可成富邦9B購02,,,,,0.00,0.00,0,0,0,0,0,0,0,0,0,0,0,0,0
20200528,06118P,上証2X凱基98售03,2.82,2.82,2.82,2.82,0.00,0.00,2000,1,5640,0,0,0,0,0,0,0,2000,-2000,-2000
20200528,061190,力山永豐9A購02,2.41,2.43,2.29,2.29,-0.01,-0.43,79000,6,185830,0,0,0,0,0,0,20000,59000,-39000,-39000
20200528,061191,可成永豐9A購02,0.64,0.66,0.64,0.66,0.00,0.00,20000,2,13000,0,0,0,0,0,0,10000,10000,0,0
20200528,061192,奇鋐永豐9A購01,1.01,1.11,1.01,1.10,0.00,0.00,251000,10,273420,0,0,0,0,0,0,0,251000,-251000,-251000
20200528,061193,玉晶光永豐9B購02,2.02,2.12,2.02,2.11,+0.15,7.65,602000,8,1252000,0,0,0,0,0,0,0,602000,-602000,-602000
20200528,061194,聯鈞永豐9A購02,0.60,0.60,0.60,0.60,+0.04,7.14,9000,4,5400,0,0,0,0,0,0,8000,1000,7000,7000
20200528,061195,健策永豐9B購02,1.30,1.30,1.17,1.17,-0.12,-9.3,846000,28,1021600,0,0,0,0,0,0,726000,120000,606000,606000
20200528,061196,世芯永豐9A購06,1.62,1.62,1.53,1.56,-0.03,-1.89,112000,4,173720,0,0,0,0,0,0,102000,10000,92000,92000
20200528,061197,矽創永豐9A購02,1.04,1.20,1.04,1.09,+0.14,14.74,1630000,99,1835540,0,0,0,0,0,0,518000,1071000,-553000,-553000
20200528,061198,世紀鋼永豐9A購03,2.01,2.43,2.01,2.43,+0.38,18.54,223000,48,491790,0,0,0,0,0,0,72000,137000,-65000,-65000
20200528,061199,道瓊反元大9A購05,,,,,0.00,0.00,0,0,0,0,0,0,0,0,0,0,0,0,0
20200528,06119P,大立光凱基98售04,5.25,5.25,5.25,5.25,-0.30,-5.41,8000,1,42000,0,0,0,0,0,0,8000,0,8000,8000
20200528,061200,道瓊反元大9A購06,0.84,0.84,0.83,0.83,-0.10,-10.75,46000,5,38630,0,0,0,0,0,0,1000,45000,-44000,-44000
20200528,061201,FBVIX元大01購03,1.11,1.12,1.11,1.12,0.00,0.00,140000,7,155600,0,0,0,0,0,0,0,140000,-140000,-140000
20200528,061202,和大元大9A購02,2.17,2.24,2.01,2.01,-0.09,-4.29,300000,10,637970,0,0,0,0,0,0,103000,197000,-94000,-94000
20200528,061203,國巨元大9A購15,1.91,1.91,1.91,1.91,-0.05,-2.55,1000,1,1910,0,0,0,0,0,0,1000,0,1000,1000
20200528,061204,國巨元大9A購16,3.59,3.59,3.42,3.42,-0.09,-2.56,2000,2,7010,0,0,0,0,0,0,2000,2000,0,0
20200528,061205,旺宏元大9A購11,2.04,2.06,1.92,1.92,-0.12,-5.88,259000,5,526640,0,0,0,0,0,0,199000,60000,139000,139000
20200528,061206,旺宏元大9A購12,2.28,2.32,2.13,2.13,-0.17,-7.39,130000,13,295400,0,0,0,0,0,0,110000,20000,90000,90000
20200528,061207,美律元大9A購04,1.89,1.89,1.89,1.89,+0.16,9.25,19000,1,35910,0,0,0,0,0,0,0,19000,-19000,-19000
20200528,061208,聯發科元大9A購09,3.03,3.03,3.03,3.03,-0.14,-4.42,6000,1,18180,0,0,0,0,0,0,0,6000,-6000,-6000
20200528,061209,聯發科元大9A購10,,,,,0.00,0.00,0,0,0,0,0,0,0,0,0,0,0,0,0
20200528,06120P,大立光凱基98售05,7.40,7.40,7.40,7.40,-0.10,-1.33,3000,1,22200,0,0,0,0,0,0,3000,0,3000,3000
20200528,061210,玉山金元大9A購02,1.97,1.97,1.97,1.97,-0.01,-0.51,13000,2,25610,0,0,0,0,0,0,13000,0,13000,13000
20200528,061211,玉晶光元大9A購12,0.99,1.00,0.96,0.96,+0.07,7.87,20000,3,19700,0,0,0,0,0,0,10000,10000,0,0
20200528,061212,聯鈞元大9A購04,1.51,1.53,1.43,1.43,-0.07,-4.67,251000,16,371400,0,0,0,0,0,0,147000,104000,43000,43000
20200528,061213,群創元大9A購05,1.11,1.11,1.10,1.10,-0.07,-5.98,69000,2,76580,0,0,0,0,0,0,68000,1000,67000,67000
20200528,061214,華擎元大9A購04,1.88,1.90,1.86,1.86,-0.01,-0.53,437000,4,813020,0,0,0,0,0,0,433000,34000,399000,399000
20200528,061215,健策元大9A購06,1.97,2.00,1.73,1.73,-0.12,-6.49,167000,24,324550,0,0,0,0,0,0,141000,53000,88000,88000
20200528,061216,世芯元大9A購06,3.39,3.39,3.19,3.37,+0.09,2.74,68000,7,228190,0,0,0,0,0,0,28000,45000,-17000,-17000
20200528,061217,臺股指元大9A購54,,,,,0.00,0.00,0,0,0,0,0,0,0,0,0,0,0,0,0
20200528,061218,臺股指元大9A購55,,,,,0.00,0.00,0,0,0,0,0,0,0,0,0,0,0,0,0
20200528,061219,臺股指元大9A購56,,,,,0.00,0.00,0,0,0,0,0,0,0,0,0,0,0,0,0
20200528,06121P,同欣電凱基97售02,,,,,0.00,0.00,0,0,0,0,0,0,0,0,0,0,0,0,0
20200528,061220,臺股指元大9A購57,,,,,0.00,0.00,0,0,0,0,0,0,0,0,0,0,0,0,0
20200528,061221,臺股指元大9A購58,,,,,0.00,0.00,0,0,0,0,0,0,0,0,0,0,0,0,0
20200528,061222,台灣50中信9A購02,,,,,0.00,0.00,0,0,0,0,0,0,0,0,0,0,0,0,0
20200528,061223,T50反1中信01購01,0.86,0.91,0.86,0.91,+0.01,1.11,46000,3,41110,0,0,0,0,0,0,25000,21000,4000,4000
20200528,061224,道瓊反中信01購01,0.97,0.98,0.97,0.98,-0.06,-5.77,37000,5,35990,0,0,0,0,0,0,22000,15000,7000,7000
20200528,061225,台積電中信9A購04,,,,,0.00,0.00,0,0,0,0,0,0,0,0,0,0,0,0,0
20200528,061226,台積電中信9A購05,,,,,0.00,0.00,0,0,0,0,0,0,0,0,0,0,0,0,0
20200528,061227,日月光中信9B購01,0.86,0.86,0.85,0.85,+0.01,1.19,18000,2,15400,0,0,0,0,0,0,18000,0,18000,18000
20200528,061228,聯茂中信9A購01,0.55,0.59,0.55,0.59,+0.02,3.51,26000,14,14540,0,0,0,0,0,0,20000,6000,14000,14000
20200528,061229,緯穎中信9B購01,1.17,1.17,1.09,1.09,-0.08,-6.84,45000,5,51700,0,0,0,0,0,0,26000,19000,7000,7000
20200528,06122P,亞光元大98售01,,,,,0.00,0.00,0,0,0,0,0,0,0,0,0,0,0,0,0
20200528,061230,臺指反元大01購04,,,,,0.00,0.00,0,0,0,0,0,0,0,0,0,0,0,0,0
20200528,061231,聚陽元大9A購02,2.09,2.09,1.91,1.93,-0.16,-7.66,264000,46,531480,0,0,0,0,0,0,189000,69000,120000,120000
20200528,061232,和大元大9A購03,2.68,2.72,2.51,2.53,-0.03,-1.17,243000,10,644770,0,0,0,0,0,0,11000,232000,-221000,-221000
20200528,061233,國巨元大9A購17,1.08,1.08,1.05,1.05,-0.03,-2.78,42000,6,44570,0,0,0,0,0,0,0,42000,-42000,-42000
20200528,061234,國巨元大9A購18,2.59,2.59,2.59,2.59,0.00,0.00,19000,1,49210,0,0,0,0,0,0,0,19000,-19000,-19000
20200528,061235,台積電元大9A購23,,,,,0.00,0.00,0,0,0,0,0,0,0,0,0,0,0,0,0
20200528,061236,台積電元大9A購24,2.12,2.12,2.12,2.12,0.00,0.00,23000,1,48760,0,0,0,0,0,0,0,23000,-23000,-23000
20200528,061237,晶技元大9A購01,1.34,1.36,1.31,1.33,-0.09,-6.34,196000,17,260980,0,0,0,0,0,0,196000,0,196000,196000
20200528,061238,晶技元大9A購02,1.13,1.14,1.09,1.09,-0.08,-6.84,140000,11,157550,0,0,0,0,0,0,102000,38000,64000,64000
20200528,061239,聯發科兆豐9A購01,2.78,2.79,2.78,2.79,0.00,0.00,2000,2,5570,0,0,0,0,0,0,2000,0,2000,2000
20200528,06123P,玉晶光元大97售04,1.08,1.08,1.08,1.08,-0.06,-5.26,50000,1,54000,0,0,0,0,0,0,50000,0,50000,50000
20200528,061240,華新科兆豐9A購01,0.96,0.97,0.90,0.90,-0.08,-8.16,33000,9,31130,0,0,0,0,0,0,20000,13000,7000,7000
20200528,061241,晶技兆豐9A購01,0.93,0.97,0.91,0.91,-0.05,-5.21,749000,36,703220,0,0,0,0,0,0,597000,152000,445000,445000
20200528,061242,玉晶光兆豐9B購02,1.09,1.09,1.09,1.09,+0.08,7.92,3000,1,3270,0,0,0,0,0,0,0,3000,-3000,-3000
20200528,061243,麗豐兆豐9A購01,1.37,1.37,1.32,1.32,-0.07,-5.04,49000,4,65530,0,0,0,0,0,0,30000,19000,11000,11000
20200528,061244,和碩兆豐9A購01,0.79,0.79,0.77,0.78,-0.02,-2.5,174000,5,134680,0,0,0,0,0,0,19000,155000,-136000,-136000
20200528,061245,晶技群益9A購01,1.01,1.02,0.99,0.99,-0.10,-9.17,113000,3,113980,0,0,0,0,0,0,98000,15000,83000,83000
20200528,061246,玉晶光群益9A購08,3.01,3.19,2.94,2.94,+0.13,4.63,25000,18,75800,0,0,0,0,0,0,25000,17000,8000,8000
20200528,061247,玉晶光群益9A購09,1.96,2.07,1.96,2.07,+0.25,13.74,193000,11,383750,0,0,0,0,0,0,13000,181000,-168000,-168000
20200528,061248,健策群益9A購03,1.30,1.33,1.13,1.14,-0.08,-6.56,1211000,39,1458840,0,0,0,0,0,0,558000,839000,-281000,-281000
20200528,061249,億豐群益9A購01,2.31,2.31,2.31,2.31,-0.06,-2.53,19000,1,43890,0,0,0,0,0,0,19000,0,19000,19000
20200528,06124P,超眾元大97售03,,,,,0.00,0.00,0,0,0,0,0,0,0,0,0,0,0,0,0
20200528,061250,臺股指群益9A購01,,,,,0.00,0.00,0,0,0,0,0,0,0,0,0,0,0,0,0
20200528,061251,臺股指群益9A購02,4.19,4.19,3.90,3.90,0.00,0.00,4000,3,16120,0,0,0,0,0,0,1000,3000,-2000,-2000
20200528,061252,臺股指群益9A購03,3.17,3.17,3.17,3.17,+0.04,1.28,3000,1,9510,0,0,0,0,0,0,3000,0,3000,3000
20200528,061253,臺股指群益9A購04,2.48,2.48,2.17,2.17,-0.23,-9.58,62000,10,151540,0,0,0,0,0,0,22000,40000,-18000,-18000
20200528,061254,道瓊反凱基9A購02,,,,,0.00,0.00,0,0,0,0,0,0,0,0,0,0,0,0,0
20200528,061255,道瓊反凱基9C購01,1.17,1.18,1.16,1.18,-0.10,-7.81,8000,5,9380,0,0,0,0,0,0,4000,4000,0,0
20200528,061256,亞德客凱基9B購01,1.56,1.61,1.37,1.38,-0.15,-9.8,99000,14,151140,0,0,0,0,0,0,54000,51000,3000,3000
20200528,061257,上銀凱基9A購06,2.26,2.33,2.14,2.14,-0.19,-8.15,52000,15,118780,0,0,0,0,0,0,52000,0,52000,52000
20200528,061258,華通凱基9A購06,1.67,1.75,1.62,1.62,+0.12,8.0,314000,18,536030,0,0,0,0,0,0,0,314000,-314000,-314000
20200528,061259,台積電凱基9A購21,,,,,0.00,0.00,0,0,0,0,0,0,0,0,0,0,0,0,0
20200528,06125P,楠梓電元富99售01,,,,,0.00,0.00,0,0,0,0,0,0,0,0,0,0,0,0,0
20200528,061260,台積電凱基9A購23,,,,,0.00,0.00,0,0,0,0,0,0,0,0,0,0,0,0,0
20200528,061261,台積電凱基9B購03,0.85,0.85,0.85,0.85,0.00,0.00,20000,1,17000,0,0,0,0,0,0,20000,0,20000,20000
20200528,061262,智邦凱基9A購02,1.60,1.76,1.58,1.58,+0.18,12.86,57000,6,95020,0,0,0,0,0,0,15000,32000,-17000,-17000
20200528,061263,微星凱基9A購01,1.21,1.21,1.21,1.21,+0.05,4.31,3000,1,3630,0,0,0,0,0,0,3000,0,3000,3000
20200528,061264,全新凱基9B購01,0.72,0.72,0.72,0.72,-0.02,-2.7,54000,2,38880,0,0,0,0,0,0,54000,0,54000,54000
20200528,061265,富邦金凱基9B購01,1.39,1.39,1.36,1.36,-0.01,-0.73,23000,2,31820,0,0,0,0,0,0,23000,0,23000,23000
20200528,061266,國泰金凱基9B購01,,,,,0.00,0.00,0,0,0,0,0,0,0,0,0,0,0,0,0
20200528,061267,玉山金凱基9B購01,0.91,0.91,0.91,0.91,-0.02,-2.15,11000,2,10010,0,0,0,0,0,0,10000,1000,9000,9000
20200528,061268,玉晶光凱基9B購04,1.09,1.09,1.09,1.09,0.00,0.00,80000,1,87200,0,0,0,0,0,0,0,80000,-80000,-80000
20200528,061269,嘉澤凱基9A購01,1.88,1.88,1.85,1.85,-0.02,-1.07,104000,3,194880,0,0,0,0,0,0,94000,10000,84000,84000
20200528,06126P,凌陽元富97售02,,,,,0.00,0.00,0,0,0,0,0,0,0,0,0,0,0,0,0
20200528,061270,彩晶凱基9A購02,0.82,0.86,0.80,0.80,-0.01,-1.23,212000,12,177660,0,0,0,0,0,0,60000,152000,-92000,-92000
20200528,061271,聯茂凱基9A購04,,,,,0.00,0.00,0,0,0,0,0,0,0,0,0,0,0,0,0
20200528,061272,超眾凱基9A購03,,,,,0.00,0.00,0,0,0,0,0,0,0,0,0,0,0,0,0
20200528,061273,臺股指凱基9A購23,3.35,3.35,3.12,3.12,0.00,0.00,2000,2,6470,0,0,0,0,0,0,0,2000,-2000,-2000
20200528,061274,臺股指凱基9A購24,2.91,2.93,2.50,2.53,-0.22,-8.0,618000,38,1746800,0,0,0,0,0,0,152000,466000,-314000,-314000
20200528,061275,臺股指凱基9A購25,2.62,2.62,2.16,2.21,-0.24,-9.8,185000,20,455080,0,0,0,0,0,0,120000,65000,55000,55000
20200528,061276,T50反1台新9A購03,,,,,0.00,0.00,0,0,0,0,0,0,0,0,0,0,0,0,0
20200528,061277,智邦台新9A購01,,,,,0.00,0.00,0,0,0,0,0,0,0,0,0,0,0,0,0
20200528,061278,和大統一9A購01,1.27,1.30,1.22,1.22,-0.02,-1.61,256000,5,328020,0,0,0,0,0,0,34000,256000,-222000,-222000
20200528,061279,鴻海統一9C購04,,,,,0.00,0.00,0,0,0,0,0,0,0,0,0,0,0,0,0
20200528,06127P,泰碩元富97售01,,,,,0.00,0.00,0,0,0,0,0,0,0,0,0,0,0,0,0
20200528,061280,國巨統一9C購06,,,,,0.00,0.00,0,0,0,0,0,0,0,0,0,0,0,0,0
20200528,061281,台積電統一9C購05,,,,,0.00,0.00,0,0,0,0,0,0,0,0,0,0,0,0,0
20200528,061282,台積電統一9C購06,0.75,0.75,0.75,0.75,+0.02,2.74,9000,1,6750,0,0,0,0,0,0,9000,0,9000,9000
20200528,061283,智邦統一9A購01,1.32,1.53,1.29,1.31,+0.07,5.65,1259000,56,1790200,1000,0,1000,0,0,0,818000,392000,426000,427000
20200528,061284,友達統一9C購01,1.03,1.04,1.03,1.04,+0.01,0.97,29000,2,29970,0,0,0,0,0,0,19000,10000,9000,9000
20200528,061285,大立光統一9A購04,,,,,0.00,0.00,0,0,0,0,0,0,0,0,0,0,0,0,0
20200528,061286,大立光統一9A購05,2.36,2.36,2.36,2.36,+0.09,3.96,13000,1,30680,0,0,0,0,0,0,0,13000,-13000,-13000
20200528,061287,大立光統一9B購06,,,,,0.00,0.00,0,0,0,0,0,0,0,0,0,0,0,0,0
20200528,061288,大立光統一9C購01,0.73,0.73,0.70,0.70,-0.01,-1.41,32000,3,22960,0,0,0,0,0,0,25000,7000,18000,18000
20200528,061289,玉晶光統一01購03,1.21,1.29,1.21,1.21,+0.03,2.54,145000,9,183920,0,0,0,0,0,0,33000,112000,-79000,-79000
20200528,06128P,玉晶光元富97售05,,,,,0.00,0.00,0,0,0,0,0,0,0,0,0,0,0,0,0
20200528,061290,玉晶光統一01購04,,,,,0.00,0.00,0,0,0,0,0,0,0,0,0,0,0,0,0
20200528,061291,玉晶光統一01購05,,,,,0.00,0.00,0,0,0,0,0,0,0,0,0,0,0,0,0
20200528,061292,玉晶光統一01購06,1.50,1.57,1.50,1.57,+0.10,6.8,90000,3,140630,0,0,0,0,0,0,10000,80000,-70000,-70000
20200528,061293,聯茂統一9A購01,0.62,0.67,0.62,0.64,+0.02,3.23,745000,13,472360,0,0,0,0,0,0,238000,507000,-269000,-269000
20200528,061294,奇力新麥證9A購01,0.98,0.98,0.98,0.98,0.00,0.00,2000,1,1960,0,2000,-2000,0,0,0,0,2000,-2000,-2000
20200528,061295,台積電國泰9B購02,2.27,2.27,2.14,2.17,-0.03,-1.36,56000,7,125450,0,0,0,0,0,0,21000,40000,-19000,-19000
20200528,061296,台積電國泰9C購01,1.93,1.93,1.85,1.85,-0.03,-1.6,65000,10,124250,0,0,0,0,0,0,22000,47000,-25000,-25000
20200528,061297,台積電富邦9C購09,,,,,0.00,0.00,0,0,0,0,0,0,0,0,0,0,0,0,0
20200528,061298,華新科富邦01購02,0.64,0.64,0.64,0.64,-0.02,-3.03,4000,1,2560,0,0,0,0,0,0,0,4000,-4000,-4000
20200528,061299,臺股指富邦9A購01,,,,,0.00,0.00,0,0,0,0,0,0,0,0,0,0,0,0,0
20200528,06129P,玉晶光元富97售06,,,,,0.00,0.00,0,0,0,0,0,0,0,0,0,0,0,0,0
20200528,061300,臺股指富邦9A購02,,,,,0.00,0.00,0,0,0,0,0,0,0,0,0,0,0,0,0
20200528,061301,華新科永豐9A購03,,,,,0.00,0.00,0,0,0,0,0,0,0,0,0,0,0,0,0
20200528,061302,晶技永豐9A購04,0.62,0.65,0.62,0.65,-0.06,-8.45,154000,3,98630,0,0,0,0,0,0,154000,0,154000,154000
20200528,061303,玉晶光永豐9B購03,,,,,0.00,0.00,0,0,0,0,0,0,0,0,0,0,0,0,0
20200528,061304,創意永豐9A購02,0.65,0.65,0.61,0.61,0.00,0.00,70000,2,45100,0,0,0,0,0,0,0,70000,-70000,-70000
20200528,061305,帆宣永豐9A購01,1.36,1.36,1.36,1.36,+0.16,13.33,5000,1,6800,0,0,0,0,0,0,5000,0,5000,5000
20200528,061306,瑞祺永豐9A購02,0.90,0.90,0.90,0.90,-0.04,-4.26,251000,3,225900,0,0,0,0,0,0,251000,0,251000,251000
20200528,061307,和潤永豐9A購02,0.96,0.96,0.93,0.93,-0.03,-3.12,105000,7,98620,0,0,0,0,0,0,10000,95000,-85000,-85000
20200528,061308,元金2X中信9A購01,0.71,0.75,0.71,0.75,+0.05,7.14,269000,14,200200,0,0,0,0,0,0,26000,233000,-207000,-207000
20200528,061309,鴻海統一9C購05,0.77,0.77,0.74,0.74,-0.02,-2.63,164000,6,124760,0,0,0,0,0,0,119000,45000,74000,74000
20200528,06130P,玉晶光元富97售07,,,,,0.00,0.00,0,0,0,0,0,0,0,0,0,0,0,0,0
20200528,061310,華新科麥證9A購01,,,,,0.00,0.00,0,0,0,0,0,0,0,0,0,0,0,0,0
20200528,061311,元黃金凱基9A購03,0.98,0.98,0.98,0.98,-0.02,-2.0,2000,2,1960,0,0,0,0,0,0,2000,0,2000,2000
20200528,061312,滬深2X凱基9A購05,,,,,0.00,0.00,0,0,0,0,0,0,0,0,0,0,0,0,0
20200528,061313,滬深2X凱基9B購05,1.55,1.55,1.55,1.55,0.00,0.00,2000,1,3100,0,0,0,0,0,0,2000,0,2000,2000
20200528,061314,滬深2X凱基9B購06,,,,,0.00,0.00,0,0,0,0,0,0,0,0,0,0,0,0,0
20200528,061315,滬深2X凱基9C購06,,,,,0.00,0.00,0,0,0,0,0,0,0,0,0,0,0,0,0
20200528,061316,台積電凱基9A購24,1.29,1.29,1.23,1.23,0.00,0.00,20000,6,24860,0,0,0,0,0,0,9000,14000,-5000,-5000
20200528,061317,旺宏凱基9A購05,1.38,1.39,1.31,1.31,-0.08,-5.76,157000,24,214910,0,0,0,0,0,0,157000,35000,122000,122000
20200528,061318,智邦凱基9B購01,1.48,1.62,1.37,1.43,+0.11,8.33,507000,71,770440,0,0,0,0,0,0,252000,243000,9000,9000
20200528,061319,聯發科凱基9A購16,2.74,2.74,2.58,2.60,-0.11,-4.06,210000,14,557550,0,0,0,0,0,0,200000,10000,190000,190000
20200528,06131P,京鼎元富97售02,,,,,0.00,0.00,0,0,0,0,0,0,0,0,0,0,0,0,0
20200528,061320,奇力新凱基9A購04,0.90,0.90,0.90,0.90,0.00,0.00,15000,1,13500,0,0,0,0,0,0,15000,0,15000,15000
20200528,061321,華新科凱基9A購09,1.08,1.09,1.08,1.09,+0.01,0.93,56000,2,60940,0,0,0,0,0,0,56000,0,56000,56000
20200528,061322,華新科凱基9A購12,,,,,0.00,0.00,0,0,0,0,0,0,0,0,0,0,0,0,0
20200528,061323,華新科凱基9B購06,,,,,0.00,0.00,0,0,0,0,0,0,0,0,0,0,0,0,0
20200528,061324,華新科凱基9C購01,1.34,1.34,1.27,1.27,-0.09,-6.62,404000,11,527580,0,0,0,0,0,0,180000,224000,-44000,-44000
20200528,061325,晶技凱基9A購03,,,,,0.00,0.00,0,0,0,0,0,0,0,0,0,0,0,0,0
20200528,061326,新日興凱基9B購01,1.15,1.18,1.13,1.13,+0.05,4.63,147000,8,171710,0,0,0,0,0,0,10000,137000,-127000,-127000
20200528,061327,台郡凱基9A購02,1.13,1.14,1.13,1.13,-0.02,-1.74,86000,5,97630,0,0,0,0,0,0,70000,16000,54000,54000
20200528,061328,T50反1元大9A購12,1.34,1.34,1.34,1.34,-0.02,-1.47,10000,1,13400,0,0,0,0,0,0,10000,0,10000,10000
20200528,061329,T50反1元大9A購13,,,,,0.00,0.00,0,0,0,0,0,0,0,0,0,0,0,0,0
20200528,06132P,正文元富97售01,,,,,0.00,0.00,0,0,0,0,0,0,0,0,0,0,0,0,0
20200528,061330,T50反1元大9A購14,1.27,1.27,1.27,1.27,-0.04,-3.05,8000,1,10160,0,0,0,0,0,0,8000,0,8000,8000
20200528,061331,T50反1元大9A購15,,,,,0.00,0.00,0,0,0,0,0,0,0,0,0,0,0,0,0
20200528,061332,T50反1元大9A購16,,,,,0.00,0.00,0,0,0,0,0,0,0,0,0,0,0,0,0
20200528,061333,華通元大9A購08,3.73,4.01,3.73,3.85,+0.31,8.76,119000,17,460980,0,0,0,0,0,0,38000,89000,-51000,-51000
20200528,061334,華通元大9A購09,3.48,3.76,3.48,3.69,+0.35,10.48,119000,7,438850,0,0,0,0,0,0,1000,119000,-118000,-118000
20200528,061335,國巨元大9A購19,1.95,1.95,1.95,1.95,-0.03,-1.52,50000,1,97500,0,0,0,0,0,0,50000,0,50000,50000
20200528,061336,國巨元大9A購20,2.81,2.84,2.67,2.67,-0.06,-2.2,44000,11,122390,0,0,0,0,0,0,39000,5000,34000,34000
20200528,061337,台積電元大9A購27,1.42,1.42,1.42,1.42,+0.01,0.71,53000,2,75260,0,0,0,0,0,0,0,53000,-53000,-53000
20200528,061338,台積電元大9A購28,2.41,2.41,2.30,2.30,-0.13,-5.35,55000,2,132000,0,0,0,0,0,0,50000,5000,45000,45000
20200528,061339,京元電元大9A購05,1.07,1.07,1.00,1.00,-0.05,-4.76,182000,9,191000,0,0,0,0,0,0,102000,80000,22000,22000
20200528,06133P,帆宣元富97售02,,,,,0.00,0.00,0,0,0,0,0,0,0,0,0,0,0,0,0
20200528,061340,義隆元大9A購01,2.61,2.69,2.50,2.54,+0.11,4.53,239000,32,612260,0,0,0,0,0,0,208000,70000,138000,138000
20200528,061341,華新科元大9A購16,2.35,2.35,2.35,2.35,+0.02,0.86,1000,1,2350,0,0,0,0,0,0,1000,0,1000,1000
20200528,061342,華新科元大9A購17,,,,,0.00,0.00,0,0,0,0,0,0,0,0,0,0,0,0,0
20200528,061343,大立光元大9A購04,2.59,2.59,2.59,2.59,-0.07,-2.63,10000,1,25900,0,0,0,0,0,0,0,10000,-10000,-10000
20200528,061344,禾伸堂元大9A購02,2.01,2.03,1.92,1.92,-0.15,-7.25,175000,16,350050,0,0,0,0,0,0,81000,137000,-56000,-56000
20200528,061345,玉晶光元大9A購14,1.28,1.35,1.26,1.29,+0.01,0.78,36000,15,46970,0,0,0,0,0,0,32000,4000,28000,28000
20200528,061346,玉晶光元大9B購03,1.28,1.33,1.26,1.27,+0.02,1.6,145000,8,187440,0,0,0,0,0,0,0,145000,-145000,-145000
20200528,061347,創意元大9A購02,1.24,1.32,1.24,1.24,0.00,0.00,579000,44,740680,0,0,0,0,0,0,224000,354000,-130000,-130000
20200528,061348,聯鈞元大9A購05,1.12,1.12,1.12,1.12,+0.01,0.9,188000,2,210560,0,0,0,0,0,0,94000,94000,0,0
20200528,061349,嘉澤元大9A購02,3.24,3.24,3.24,3.24,-0.15,-4.42,8000,1,25920,0,0,0,0,0,0,8000,8000,0,0
20200528,06134P,緯穎元富97售03,,,,,0.00,0.00,0,0,0,0,0,0,0,0,0,0,0,0,0
20200528,061350,牧德元大9B購03,1.41,1.41,1.33,1.34,-0.08,-5.63,25000,7,33600,0,0,0,0,0,0,3000,22000,-19000,-19000
20200528,061351,智伸科元大9A購01,2.07,2.10,1.86,1.88,-0.13,-6.47,674000,29,1337820,0,0,0,0,0,0,431000,223000,208000,208000
20200528,061352,茂林元大9A購04,3.13,3.13,3.06,3.06,-0.64,-17.3,84000,5,260660,0,0,0,0,0,0,36000,48000,-12000,-12000
20200528,061353,康控元大9A購01,1.62,1.62,1.59,1.62,+0.04,2.53,163000,6,261810,0,0,0,0,0,0,163000,9000,154000,154000
20200528,061354,瑞儀元大9A購01,2.15,2.17,2.12,2.13,+0.01,0.47,161000,15,347620,0,0,0,0,0,0,63000,88000,-25000,-25000
20200528,061355,康友元大9A購03,1.54,1.54,1.54,1.54,-0.04,-2.53,8000,1,12320,0,0,0,0,0,0,0,8000,-8000,-8000
20200528,061356,南電元大9A購06,1.31,1.34,1.26,1.26,-0.03,-2.33,138000,8,179500,0,0,0,0,0,0,93000,45000,48000,48000
20200528,061357,寶成元大9A購01,2.17,2.19,1.96,1.98,-0.19,-8.76,322000,22,666960,0,0,0,0,0,0,243000,74000,169000,169000
20200528,061358,世紀鋼元大9A購04,3.33,4.12,3.25,3.79,+0.45,13.47,619000,69,2267950,0,0,0,0,0,0,315000,397000,-82000,-82000
20200528,061359,台灣50兆豐9C購02,,,,,0.00,0.00,0,0,0,0,0,0,0,0,0,0,0,0,0
20200528,06135P,志超元富97售01,0.11,0.11,0.10,0.10,-0.04,-28.57,4000,2,420,0,0,0,0,0,0,0,4000,-4000,-4000
20200528,061360,智邦兆豐9B購02,1.74,1.81,1.58,1.63,+0.14,9.4,170000,34,290380,0,0,0,0,0,0,127000,43000,84000,84000
20200528,061361,世紀鋼兆豐9A購01,1.13,1.41,1.13,1.29,+0.14,12.17,1039000,66,1290510,0,0,0,0,0,0,422000,605000,-183000,-183000
20200528,061362,台塑國票9B購01,2.57,2.57,2.35,2.35,-0.24,-9.27,30000,5,72430,0,0,0,0,0,0,2000,28000,-26000,-26000
20200528,061363,儒鴻國票9B購01,3.20,3.22,2.91,2.91,-0.36,-11.01,585000,19,1767000,0,0,0,0,0,0,169000,416000,-247000,-247000
20200528,061364,國巨國票9A購09,3.72,3.73,3.53,3.53,-0.11,-3.02,10000,6,36830,0,0,0,0,0,0,10000,4000,6000,6000
20200528,061365,國巨國票9B購05,4.27,4.30,4.07,4.07,-0.07,-1.69,13000,6,54100,0,0,0,0,0,0,4000,13000,-9000,-9000
20200528,061366,台勝科國票9A購01,2.11,2.11,1.91,1.91,-0.19,-9.05,308000,8,617260,0,0,0,0,0,0,278000,30000,248000,248000
20200528,061367,瑞祺國票9A購01,2.14,2.37,2.08,2.08,-0.04,-1.89,287000,16,635940,0,0,0,0,0,0,107000,180000,-73000,-73000
20200528,061368,南六國票9A購01,3.64,3.91,3.61,3.61,-0.03,-0.82,141000,21,529870,0,0,0,0,0,0,63000,73000,-10000,-10000
20200528,061369,T50反1國泰9B購03,,,,,0.00,0.00,0,0,0,0,0,0,0,0,0,0,0,0,0
20200528,06136P,華新科國泰99售02,,,,,0.00,0.00,0,0,0,0,0,0,0,0,0,0,0,0,0
20200528,061370,晶技國泰9C購01,1.42,1.50,1.39,1.39,-0.09,-6.08,1601000,59,2295720,0,0,0,0,0,0,1137000,438000,699000,699000
20200528,061371,嘉澤國泰9C購01,,,,,0.00,0.00,0,0,0,0,0,0,0,0,0,0,0,0,0
20200528,061372,世紀鋼國泰9C購01,1.75,1.99,1.62,1.87,+0.21,12.65,4103000,176,7346260,0,0,0,0,0,0,863000,3196000,-2333000,-2333000
20200528,061373,華通富邦9A購02,0.82,0.93,0.82,0.87,+0.08,10.13,1112000,57,962200,0,0,0,0,0,0,165000,947000,-782000,-782000
20200528,061374,力山永豐9A購04,1.38,1.41,1.30,1.30,-0.05,-3.7,91000,9,125770,0,0,0,0,0,0,31000,60000,-29000,-29000
20200528,061375,華通永豐9A購02,1.28,1.36,1.28,1.29,+0.15,13.16,357000,8,479170,0,0,0,0,0,0,80000,277000,-197000,-197000
20200528,061376,瑞昱永豐9A購02,1.10,1.10,1.10,1.10,+0.05,4.76,1000,1,1100,0,0,0,0,0,0,1000,0,1000,1000
20200528,061377,聯發科永豐9A購04,2.55,2.55,2.37,2.37,-0.13,-5.2,225000,22,569790,0,0,0,0,0,0,220000,5000,215000,215000
20200528,061378,南六永豐9A購03,1.29,1.38,1.28,1.29,-0.04,-3.01,247000,25,328620,0,0,0,0,0,0,143000,104000,39000,39000
20200528,061379,鈺齊永豐9A購02,1.03,1.08,1.01,1.01,+0.08,8.6,291000,9,308300,0,0,0,0,0,0,74000,214000,-140000,-140000
20200528,06137P,玉晶光永豐97售04,0.67,0.68,0.62,0.66,-0.07,-9.59,197000,6,129580,0,0,0,0,0,0,64000,133000,-69000,-69000
20200528,061380,巨大永豐9A購02,2.71,2.71,2.66,2.66,-0.04,-1.48,64000,2,173240,0,0,0,0,0,0,64000,0,64000,64000
20200528,061381,台灣50群益9B購07,,,,,0.00,0.00,0,0,0,0,0,0,0,0,0,0,0,0,0
20200528,061382,台灣50群益9C購02,,,,,0.00,0.00,0,0,0,0,0,0,0,0,0,0,0,0,0
20200528,061383,高股息群益9A購01,,,,,0.00,0.00,0,0,0,0,0,0,0,0,0,0,0,0,0
20200528,061384,T50反1群益9A購04,0.68,0.72,0.68,0.72,+0.02,2.86,82000,5,56370,0,0,0,0,0,0,4000,78000,-74000,-74000
20200528,061385,上証2X群益9C購07,,,,,0.00,0.00,0,0,0,0,0,0,0,0,0,0,0,0,0
20200528,061386,道瓊銀群益9A購03,,,,,0.00,0.00,0,0,0,0,0,0,0,0,0,0,0,0,0
20200528,061387,鴻海群益9A購05,2.63,2.63,2.52,2.52,-0.03,-1.18,34000,2,88870,0,0,0,0,0,0,29000,5000,24000,24000
20200528,061388,台積電群益9A購05,,,,,0.00,0.00,0,0,0,0,0,0,0,0,0,0,0,0,0
20200528,061389,華新科群益9B購01,2.17,2.17,2.14,2.14,+0.02,0.94,15000,2,32400,0,0,0,0,0,0,10000,5000,5000,5000
20200528,06138P,台積電中信99售01,1.08,1.12,1.08,1.12,-0.03,-2.61,70000,5,77100,0,0,0,0,0,0,70000,0,70000,70000
20200528,061390,大立光群益9A購04,1.15,1.15,1.06,1.06,-0.06,-5.36,16000,2,18310,0,0,0,0,0,0,16000,0,16000,16000
20200528,061391,晶技群益9A購02,0.66,0.68,0.65,0.65,-0.05,-7.14,206000,7,135580,0,0,0,0,0,0,206000,0,206000,206000
20200528,061392,泰鼎群益9A購02,2.74,2.74,2.66,2.66,-0.04,-1.48,15000,2,40700,0,0,0,0,0,0,5000,10000,-5000,-5000
20200528,061393,緯穎群益9A購01,,,,,0.00,0.00,0,0,0,0,0,0,0,0,0,0,0,0,0
20200528,061394,FBVIX統一9B購01,0.69,0.70,0.69,0.70,0.00,0.00,105000,3,72950,0,0,0,0,0,0,0,105000,-105000,-105000
20200528,061395,健策統一9C購02,1.34,1.34,1.19,1.19,-0.07,-5.56,778000,51,988010,0,2000,-2000,0,0,0,629000,349000,280000,278000
20200528,061396,台灣50台新9C購03,1.47,1.47,1.47,1.47,0.00,0.00,2000,1,2940,0,0,0,0,0,0,2000,0,2000,2000
20200528,061397,上銀台新9A購01,,,,,0.00,0.00,0,0,0,0,0,0,0,0,0,0,0,0,0
20200528,061398,力成中信9A購01,0.74,0.75,0.69,0.69,-0.03,-4.17,60000,4,44300,0,0,0,0,0,0,0,60000,-60000,-60000
20200528,061399,喬山兆豐9B購01,2.23,2.25,2.08,2.08,-0.23,-9.96,45000,6,96240,0,0,0,0,0,0,32000,13000,19000,19000
20200528,06139P,台積電中信99售02,0.89,0.94,0.89,0.94,+0.03,3.3,171000,6,157720,0,0,0,0,0,0,60000,111000,-51000,-51000
20200528,061400,可成兆豐9B購02,,,,,0.00,0.00,0,0,0,0,0,0,0,0,0,0,0,0,0
20200528,061401,華擎兆豐9B購01,,,,,0.00,0.00,0,0,0,0,0,0,0,0,0,0,0,0,0
20200528,061402,矽創兆豐9B購01,1.91,2.02,1.89,1.89,+0.15,8.62,252000,34,493840,0,0,0,0,0,0,77000,161000,-84000,-84000
20200528,061403,滬深2X國票9A購06,2.34,2.34,2.14,2.14,0.00,0.00,6000,2,13640,0,0,0,0,0,0,0,6000,-6000,-6000
20200528,061404,臺指反國票04購01,0.98,0.98,0.98,0.98,0.00,0.00,2000,1,1960,0,0,0,0,0,0,0,2000,-2000,-2000
20200528,061405,亞德客國票9B購01,,,,,0.00,0.00,0,0,0,0,0,0,0,0,0,0,0,0,0
20200528,061406,華通國票9A購06,5.10,5.40,4.90,4.90,+0.32,6.99,44000,6,226500,0,0,0,0,0,0,20000,24000,-4000,-4000
20200528,061407,鴻海國票9A購07,1.61,1.61,1.54,1.55,-0.02,-1.27,118000,8,186680,0,0,0,0,0,0,58000,60000,-2000,-2000
20200528,061408,華新科國票9A購06,2.06,2.06,2.01,2.01,-0.02,-0.99,17000,3,34940,0,0,0,0,0,0,15000,2000,13000,13000
20200528,061409,力成國票9A購02,3.60,3.72,3.36,3.36,-0.21,-5.88,60000,3,208320,0,0,0,0,0,0,52000,8000,44000,44000
20200528,06140P,華新科群益97售06,,,,,0.00,0.00,0,0,0,0,0,0,0,0,0,0,0,0,0
20200528,061410,緯穎國票9A購03,6.05,6.10,6.05,6.10,+0.40,7.02,14000,2,84900,0,0,0,0,0,0,14000,4000,10000,10000
20200528,061411,T50反1群益9A購05,0.46,0.51,0.44,0.51,+0.03,6.25,309000,19,143390,0,0,0,0,0,0,213000,96000,117000,117000
20200528,061412,儒鴻群益9A購01,4.10,4.18,3.75,3.85,-0.35,-8.33,150000,15,594320,0,0,0,0,0,0,123000,25000,98000,98000
20200528,061413,台勝科群益9A購01,1.41,1.41,1.36,1.36,-0.12,-8.11,11000,2,15210,0,0,0,0,0,0,5000,6000,-1000,-1000
20200528,061414,牧德群益9B購02,0.95,0.95,0.95,0.95,-0.02,-2.06,3000,1,2850,0,0,0,0,0,0,3000,0,3000,3000
20200528,061415,健策群益9A購04,1.88,1.88,1.82,1.82,-0.07,-3.7,121000,7,224180,0,0,0,0,0,0,121000,0,121000,121000
20200528,061416,聯茂群益9A購01,1.11,1.18,1.10,1.15,+0.06,5.5,240000,9,268820,0,0,0,0,0,0,20000,220000,-200000,-200000
20200528,061417,力成群益9A購01,1.23,1.24,1.15,1.15,-0.10,-8.0,363000,12,441520,0,0,0,0,0,0,260000,103000,157000,157000
20200528,061418,世紀鋼群益9A購02,1.60,2.00,1.60,1.85,+0.24,14.91,1642000,43,3057430,0,0,0,0,0,0,878000,758000,120000,120000
20200528,061419,國巨元大9A購21,,,,,0.00,0.00,0,0,0,0,0,0,0,0,0,0,0,0,0
20200528,06141P,大立光日盛97售01,3.15,3.15,3.15,3.15,0.00,0.00,5000,1,15750,0,0,0,0,0,0,5000,0,5000,5000
20200528,061420,國巨元大9A購22,,,,,0.00,0.00,0,0,0,0,0,0,0,0,0,0,0,0,0
20200528,061421,台積電元大9A購29,1.39,1.39,1.39,1.39,+0.01,0.72,68000,1,94520,0,0,0,0,0,0,0,68000,-68000,-68000
20200528,061422,台積電元大9A購30,,,,,0.00,0.00,0,0,0,0,0,0,0,0,0,0,0,0,0
20200528,061423,廣達元大9A購01,2.22,2.23,2.14,2.20,+0.04,1.85,374000,27,814070,0,0,0,0,0,0,212000,162000,50000,50000
20200528,061424,華新科元大9A購18,,,,,0.00,0.00,0,0,0,0,0,0,0,0,0,0,0,0,0
20200528,061425,華新科元大9A購19,2.93,2.93,2.89,2.89,-0.10,-3.34,67000,3,194670,0,0,0,0,0,0,67000,0,67000,67000
20200528,061426,玉晶光元大9A購15,1.31,1.31,1.25,1.25,+0.04,3.31,147000,5,190960,0,0,0,0,0,0,110000,37000,73000,73000
20200528,061427,旭富元大9A購02,1.34,1.39,1.34,1.35,-0.02,-1.46,123000,6,169230,0,0,0,0,0,0,115000,8000,107000,107000
20200528,061428,南六元大9A購01,2.74,2.74,2.63,2.71,+0.09,3.44,109000,9,292670,0,0,0,0,0,0,109000,0,109000,109000
20200528,061429,南六元大9A購02,2.17,2.22,2.10,2.10,-0.08,-3.67,323000,16,685610,0,0,0,0,0,0,187000,175000,12000,12000
20200528,06142P,台虹康和97售02,0.31,0.35,0.31,0.35,+0.01,2.94,30000,2,9900,0,0,0,0,0,0,0,30000,-30000,-30000
20200528,061430,致新元大9A購01,2.37,2.55,2.37,2.49,+0.08,3.32,540000,33,1319190,0,0,0,0,0,0,445000,240000,205000,205000
20200528,061431,鈺齊元大9A購01,2.85,2.95,2.74,2.79,+0.17,6.49,229000,20,652470,0,0,0,0,0,0,94000,123000,-29000,-29000
20200528,061432,世紀鋼元大9A購05,1.27,1.56,1.27,1.46,+0.18,14.06,441000,19,632760,0,0,0,0,0,0,89000,360000,-271000,-271000
20200528,061433,華通麥證9A購03,1.60,1.70,1.60,1.64,+0.21,14.69,221000,7,359170,0,221000,-221000,0,0,0,0,221000,-221000,-221000
20200528,061434,國巨麥證9A購04,,,,,0.00,0.00,0,0,0,0,0,0,0,0,0,0,0,0,0
20200528,061435,元金2X凱基9C購03,1.37,1.39,1.36,1.39,+0.06,4.51,97000,8,133580,0,0,0,0,0,0,10000,87000,-77000,-77000
20200528,061436,上銀凱基9A購07,1.99,2.08,1.99,2.01,-0.08,-3.83,37000,8,74340,0,0,0,0,0,0,37000,0,37000,37000
20200528,061437,燿華凱基9A購01,1.19,1.19,1.13,1.13,-0.03,-2.59,56000,4,65440,0,0,0,0,0,0,41000,15000,26000,26000
20200528,061438,牧德凱基9B購02,,,,,0.00,0.00,0,0,0,0,0,0,0,0,0,0,0,0,0
20200528,061439,寶成凱基9A購01,1.60,1.62,1.47,1.47,-0.17,-10.37,402000,36,617940,0,0,0,0,0,0,239000,157000,82000,82000
20200528,06143P,鴻海永豐97售02,,,,,0.00,0.00,0,0,0,0,0,0,0,0,0,0,0,0,0
20200528,061440,台灣50永豐9A購04,,,,,0.00,0.00,0,0,0,0,0,0,0,0,0,0,0,0,0
20200528,061441,大毅永豐9A購04,,,,,0.00,0.00,0,0,0,0,0,0,0,0,0,0,0,0,0
20200528,061442,玉晶光永豐9A購07,,,,,0.00,0.00,0,0,0,0,0,0,0,0,0,0,0,0,0
20200528,061443,大立光統一9C購02,0.89,0.89,0.88,0.88,-0.03,-3.3,21000,2,18680,0,0,0,0,0,0,20000,1000,19000,19000
20200528,061444,聯發科台新9A購01,,,,,0.00,0.00,0,0,0,0,0,0,0,0,0,0,0,0,0
20200528,061445,道瓊指中信9A購01,1.00,1.00,1.00,1.00,+0.07,7.53,19000,5,19000,0,0,0,0,0,0,0,19000,-19000,-19000
20200528,061446,鴻海中信04購01,1.35,1.36,1.31,1.32,-0.01,-0.75,95000,10,126460,0,0,0,0,0,0,23000,80000,-57000,-57000
20200528,061447,鴻海中信04購02,1.08,1.09,1.07,1.07,-0.01,-0.93,92000,5,100200,0,0,0,0,0,0,92000,7000,85000,85000
20200528,061448,旺宏中信9A購02,0.77,0.78,0.77,0.77,-0.03,-3.75,16000,7,12450,0,0,0,0,0,0,16000,0,16000,16000
20200528,061449,大立光中信9C購02,,,,,0.00,0.00,0,0,0,0,0,0,0,0,0,0,0,0,0
20200528,06144P,台光電永豐97售01,0.18,0.22,0.18,0.22,+0.03,15.79,64000,3,12600,0,0,0,0,0,0,27000,37000,-10000,-10000
20200528,061450,嘉晶中信9A購01,1.68,1.68,1.66,1.66,-0.05,-2.92,60000,4,99800,0,0,0,0,0,0,40000,20000,20000,20000
20200528,061451,南電中信9A購03,0.31,0.31,0.29,0.29,-0.02,-6.45,136000,7,40300,0,0,0,0,0,0,36000,100000,-64000,-64000
20200528,061452,大成鋼凱基9A購01,1.23,1.34,1.23,1.25,+0.03,2.46,423000,40,545990,0,0,0,0,0,0,123000,223000,-100000,-100000
20200528,061453,台達電凱基9B購01,,,,,0.00,0.00,0,0,0,0,0,0,0,0,0,0,0,0,0
20200528,061454,國巨凱基9A購16,3.78,3.82,3.62,3.62,-0.06,-1.63,50000,3,185920,0,0,0,0,0,0,47000,3000,44000,44000
20200528,061455,京元電凱基9B購01,0.72,0.72,0.69,0.69,-0.04,-5.48,149000,7,103580,0,0,0,0,0,0,110000,39000,71000,71000
20200528,061456,玉晶光凱基9B購05,1.57,1.67,1.56,1.56,+0.01,0.65,306000,17,497120,0,0,0,0,0,0,37000,269000,-232000,-232000
20200528,061457,TPK凱基9A購01,1.00,1.08,0.95,0.95,-0.05,-5.0,607000,23,619610,0,0,0,0,0,0,323000,287000,36000,36000
20200528,061458,臻鼎凱基9A購02,1.47,1.48,1.39,1.40,-0.08,-5.41,17000,5,24660,0,0,0,0,0,0,6000,10000,-4000,-4000
20200528,061459,台灣50群益9B購08,,,,,0.00,0.00,0,0,0,0,0,0,0,0,0,0,0,0,0
20200528,06145P,華新科永豐97售02,,,,,0.00,0.00,0,0,0,0,0,0,0,0,0,0,0,0,0
20200528,061460,FBVIX群益9A購02,0.78,0.78,0.78,0.78,0.00,0.00,3000,1,2340,0,0,0,0,0,0,0,3000,-3000,-3000
20200528,061461,元金2X群益9A購01,,,,,0.00,0.00,0,0,0,0,0,0,0,0,0,0,0,0,0
20200528,061462,國巨群益9A購11,1.60,1.60,1.60,1.60,+0.01,0.63,8000,1,12800,0,0,0,0,0,0,8000,0,8000,8000
20200528,061463,智邦群益9A購02,2.89,3.00,2.55,2.55,+0.13,5.37,192000,11,560930,0,0,0,0,0,0,103000,93000,10000,10000
20200528,061464,瑞昱群益9A購01,1.75,1.76,1.73,1.73,+0.07,4.22,886000,18,1546980,0,0,0,0,0,0,310000,576000,-266000,-266000
20200528,061465,聯詠群益9A購01,2.28,2.33,2.28,2.29,-0.02,-0.87,31000,3,71100,0,0,0,0,0,0,9000,26000,-17000,-17000
20200528,061466,創意群益9A購01,1.37,1.37,1.27,1.27,0.00,0.00,630000,12,835340,0,0,0,0,0,0,0,380000,-380000,-380000
20200528,061467,嘉澤群益9A購01,,,,,0.00,0.00,0,0,0,0,0,0,0,0,0,0,0,0,0
20200528,061468,神達群益9A購01,2.41,2.46,2.39,2.40,-0.01,-0.41,551000,13,1338760,0,0,0,0,0,0,340000,225000,115000,115000
20200528,061469,瑞祺群益9A購02,1.27,1.39,1.27,1.32,+0.04,3.12,799000,19,1063400,0,0,0,0,0,0,274000,515000,-241000,-241000
20200528,06146P,S&P反1元大97售03,,,,,0.00,0.00,0,0,0,0,0,0,0,0,0,0,0,0,0
20200528,061470,鈺齊群益9A購02,2.15,2.37,2.11,2.13,+0.11,5.45,274000,17,603250,0,0,0,0,0,0,111000,163000,-52000,-52000
20200528,061471,台積電元大9A購31,1.46,1.46,1.35,1.35,-0.07,-4.93,162000,9,226180,0,0,0,0,0,0,100000,62000,38000,38000
20200528,061472,台積電元大9A購32,,,,,0.00,0.00,0,0,0,0,0,0,0,0,0,0,0,0,0
20200528,061473,台積電元大9A購33,1.41,1.41,1.41,1.41,-0.07,-4.73,1000,1,1410,0,0,0,0,0,0,0,1000,-1000,-1000
20200528,061474,瑞昱元大9A購04,2.25,2.28,2.24,2.28,+0.13,6.05,198000,17,446730,0,0,0,0,0,0,67000,149000,-82000,-82000
20200528,061475,漢唐元大9A購01,2.11,2.17,2.04,2.04,-0.11,-5.12,52000,5,109520,0,0,0,0,0,0,2000,50000,-48000,-48000
20200528,061476,大毅元大9A購02,1.69,1.69,1.64,1.64,-0.02,-1.2,105000,6,174650,0,0,0,0,0,0,20000,85000,-65000,-65000
20200528,061477,晶豪科元大9A購01,2.04,2.07,2.04,2.07,+0.12,6.15,115000,2,236550,0,0,0,0,0,0,65000,50000,15000,15000
20200528,061478,奇鋐元大9A購01,2.02,2.19,2.02,2.07,+0.15,7.81,365000,22,775150,0,0,0,0,0,0,101000,319000,-218000,-218000
20200528,061479,泰碩元大9A購02,1.82,1.86,1.78,1.78,-0.06,-3.26,85000,3,154900,0,0,0,0,0,0,15000,70000,-55000,-55000
20200528,06147P,國巨元大97售05,1.49,1.49,1.49,1.49,+0.04,2.76,33000,1,49170,0,0,0,0,0,0,33000,0,33000,33000
20200528,061480,泰碩元大9B購01,1.61,1.61,1.56,1.57,-0.10,-5.99,23000,3,35950,0,0,0,0,0,0,1000,22000,-21000,-21000
20200528,061481,嘉澤元大9A購03,4.00,4.20,3.98,3.98,-0.24,-5.69,58000,4,233640,0,0,0,0,0,0,18000,48000,-30000,-30000
20200528,061482,健策元大9C購01,4.77,4.77,4.23,4.23,-0.43,-9.23,42000,7,190330,0,0,0,0,0,0,36000,21000,15000,15000
20200528,061483,TPK元大9A購01,2.36,2.45,2.22,2.22,-0.10,-4.31,1910000,38,4403370,0,0,0,0,0,0,1797000,82000,1715000,1715000
20200528,061484,華通兆豐9B購01,1.61,1.75,1.61,1.65,+0.11,7.14,526000,16,888030,0,0,0,0,0,0,193000,281000,-88000,-88000
20200528,061485,鴻海兆豐9A購01,1.23,1.23,1.20,1.20,0.00,0.00,29000,4,35560,0,0,0,0,0,0,17000,16000,1000,1000
20200528,061486,國巨兆豐9B購02,2.20,2.21,2.11,2.11,-0.05,-2.31,34000,4,73770,0,0,0,0,0,0,27000,7000,20000,20000
20200528,061487,聯發科兆豐9B購02,,,,,0.00,0.00,0,0,0,0,0,0,0,0,0,0,0,0,0
20200528,061488,奇力新兆豐9A購01,0.97,0.97,0.96,0.96,0.00,0.00,30000,2,28900,0,0,0,0,0,0,20000,10000,10000,10000
20200528,061489,高鐵兆豐9A購01,2.49,2.49,2.20,2.20,-0.17,-7.17,104000,24,254510,0,0,0,0,0,0,95000,17000,78000,78000
20200528,06148P,台積電元大97售17,4.43,4.43,4.43,4.43,+0.20,4.73,40000,1,177200,0,0,0,0,0,0,40000,40000,0,0
20200528,061490,茂林兆豐9B購01,1.45,1.45,1.45,1.45,-0.05,-3.33,10000,1,14500,0,0,0,0,0,0,0,10000,-10000,-10000
20200528,061491,嘉聯益兆豐9B購01,1.10,1.20,1.10,1.12,+0.04,3.7,628000,25,731270,0,0,0,0,0,0,53000,578000,-525000,-525000
20200528,061492,超眾兆豐9B購01,0.80,0.85,0.78,0.85,-0.01,-1.16,316000,8,256910,0,0,0,0,0,0,187000,129000,58000,58000
20200528,061493,T50反1國票9B購04,0.43,0.43,0.43,0.43,0.00,0.00,22000,2,9460,0,0,0,0,0,0,0,22000,-22000,-22000
20200528,061494,聯發科國票9A購04,7.50,7.50,7.45,7.45,-0.35,-4.49,2000,2,14950,0,0,0,0,0,0,0,2000,-2000,-2000
20200528,061495,聯發科國票9B購01,,,,,0.00,0.00,0,0,0,0,0,0,0,0,0,0,0,0,0
20200528,061496,華新科國票9A購07,3.08,3.23,3.08,3.08,-0.03,-0.96,55000,5,169670,0,0,0,0,0,0,52000,3000,49000,49000
20200528,061497,大立光國票9A購09,2.16,2.16,2.16,2.16,-0.05,-2.26,14000,1,30240,0,0,0,0,0,0,0,14000,-14000,-14000
20200528,061498,大立光國票9A購10,2.55,2.55,2.34,2.34,-0.10,-4.1,13000,3,32040,0,0,0,0,0,0,6000,7000,-1000,-1000
20200528,061499,嘉晶國票9A購03,,,,,0.00,0.00,0,0,0,0,0,0,0,0,0,0,0,0,0
20200528,06149P,台積電元大97售18,,,,,0.00,0.00,0,0,0,0,0,0,0,0,0,0,0,0,0
20200528,061500,京鼎國票9B購01,,,,,0.00,0.00,0,0,0,0,0,0,0,0,0,0,0,0,0
20200528,061501,嘉澤國票9A購01,7.10,7.15,6.80,6.80,-1.00,-12.82,46000,5,321800,0,0,0,0,0,0,24000,22000,2000,2000
20200528,061502,嘉澤國票9A購02,5.75,5.75,5.75,5.75,0.00,0.00,3000,1,17250,0,0,0,0,0,0,0,3000,-3000,-3000
20200528,061503,臻鼎國票9B購01,3.63,3.65,3.36,3.36,-0.29,-7.95,51000,7,179050,0,0,0,0,0,0,16000,35000,-19000,-19000
20200528,061504,祥碩國票9A購02,,,,,0.00,0.00,0,0,0,0,0,0,0,0,0,0,0,0,0
20200528,061505,力成國票9A購03,3.30,3.37,3.06,3.06,-0.22,-6.71,190000,14,617680,0,0,0,0,0,0,80000,110000,-30000,-30000
20200528,061506,瑞祺國票9A購02,3.26,3.26,3.26,3.26,+0.16,5.16,10000,1,32600,0,0,0,0,0,0,10000,0,10000,10000
20200528,061507,南電國票9A購05,2.89,3.06,2.75,2.75,-0.19,-6.46,36000,6,104460,0,0,0,0,0,0,16000,20000,-4000,-4000
20200528,061508,南六國泰9C購02,2.32,2.38,2.24,2.37,+0.10,4.41,335000,37,779900,0,0,0,0,0,0,270000,125000,145000,145000
20200528,061509,SP黃豆富邦9C購01,0.77,0.77,0.77,0.77,0.00,0.00,100000,1,77000,0,0,0,0,0,0,0,100000,-100000,-100000
20200528,06150P,奇力新元大97售06,1.41,1.50,1.41,1.50,+0.10,7.14,432000,10,627940,0,0,0,0,0,0,0,432000,-432000,-432000
20200528,061510,嘉澤富邦9C購01,1.10,1.16,1.10,1.12,-0.05,-4.27,49000,7,54400,0,0,0,0,0,0,42000,7000,35000,35000
20200528,061511,緯穎富邦9B購02,1.27,1.27,1.19,1.19,-0.08,-6.3,63000,11,77110,0,0,0,0,0,0,0,63000,-63000,-63000
20200528,061512,國巨永豐9A購04,,,,,0.00,0.00,0,0,0,0,0,0,0,0,0,0,0,0,0
20200528,061513,華新科永豐9A購04,0.56,0.56,0.54,0.54,-0.04,-6.9,3000,2,1640,0,0,0,0,0,0,1000,2000,-1000,-1000
20200528,061514,泰碩永豐9A購02,0.90,0.91,0.85,0.85,-0.07,-7.61,522000,9,463260,0,0,0,0,0,0,472000,10000,462000,462000
20200528,061515,泰碩永豐9A購03,,,,,0.00,0.00,0,0,0,0,0,0,0,0,0,0,0,0,0
20200528,061516,力成永豐9A購02,0.77,0.77,0.76,0.76,-0.01,-1.3,159000,3,121700,0,0,0,0,0,0,73000,86000,-13000,-13000
20200528,061517,瑞祺永豐9A購03,0.89,0.98,0.88,0.88,-0.02,-2.22,759000,11,707290,0,0,0,0,0,0,180000,579000,-399000,-399000
20200528,061518,達方永豐9A購02,0.78,0.81,0.76,0.80,+0.01,1.27,320000,18,251880,0,0,0,0,0,0,200000,120000,80000,80000
20200528,061519,T50反1中信03購01,0.73,0.73,0.73,0.73,0.00,0.00,70000,1,51100,0,0,0,0,0,0,0,70000,-70000,-70000
20200528,06151P,華新科元大97售07,1.77,1.87,1.77,1.87,+0.07,3.89,74000,2,133380,0,0,0,0,0,0,0,74000,-74000,-74000
20200528,061520,健策中信9A購01,1.03,1.03,0.85,0.85,-0.08,-8.6,647000,28,611750,0,0,0,0,0,0,646000,182000,464000,464000
20200528,061521,亞光兆豐9A購02,1.02,1.05,1.00,1.00,-0.03,-2.91,242000,8,252180,0,0,0,0,0,0,187000,55000,132000,132000
20200528,061522,元黃金凱基01購01,1.17,1.17,1.17,1.17,0.00,0.00,10000,1,11700,0,0,0,0,0,0,10000,0,10000,10000
20200528,061523,SP黃豆凱基9B購01,,,,,0.00,0.00,0,0,0,0,0,0,0,0,0,0,0,0,0
20200528,061524,華通凱基9A購07,3.36,3.71,3.36,3.46,+0.23,7.12,589000,20,2059210,0,0,0,0,0,0,481000,108000,373000,373000
20200528,061525,華新科凱基9A購13,,,,,0.00,0.00,0,0,0,0,0,0,0,0,0,0,0,0,0
20200528,061526,宏達電凱基9A購04,3.17,3.19,2.74,2.74,-0.46,-14.37,13000,5,37930,0,0,0,0,0,0,8000,13000,-5000,-5000
20200528,061527,牧德凱基9A購02,1.23,1.23,1.23,1.23,0.00,0.00,40000,1,49200,0,0,0,0,0,0,40000,0,40000,40000
20200528,061528,超眾凱基9A購04,,,,,0.00,0.00,0,0,0,0,0,0,0,0,0,0,0,0,0
20200528,061529,國巨台新9A購02,,,,,0.00,0.00,0,0,0,0,0,0,0,0,0,0,0,0,0
20200528,06152P,玉晶光元大98售06,,,,,0.00,0.00,0,0,0,0,0,0,0,0,0,0,0,0,0
20200528,061530,智邦台新9A購02,3.03,3.03,3.03,3.03,0.00,0.00,8000,1,24240,0,0,0,0,0,0,0,8000,-8000,-8000
20200528,061531,奇鋐台新9A購01,1.85,1.85,1.85,1.85,+0.19,11.45,100000,1,185000,0,0,0,0,0,0,0,100000,-100000,-100000
20200528,061532,和大統一9C購02,1.16,1.19,1.10,1.11,-0.03,-2.63,406000,8,469860,0,0,0,0,0,0,193000,223000,-30000,-30000
20200528,061533,友達統一9C購02,0.97,0.98,0.95,0.95,-0.02,-2.06,59000,6,57270,0,0,0,0,0,0,45000,14000,31000,31000
20200528,061534,聯發科統一9C購04,,,,,0.00,0.00,0,0,0,0,0,0,0,0,0,0,0,0,0
20200528,061535,群創統一9C購01,0.90,0.92,0.90,0.90,0.00,0.00,190000,5,172300,0,0,0,0,0,0,71000,119000,-48000,-48000
20200528,061536,華擎統一9C購02,0.99,1.00,0.94,0.96,0.00,0.00,501000,7,481090,0,0,0,0,0,0,435000,66000,369000,369000
20200528,061537,SP黃豆群益9A購02,,,,,0.00,0.00,0,0,0,0,0,0,0,0,0,0,0,0,0
20200528,061538,SP黃豆群益9A購03,0.70,0.70,0.70,0.70,0.00,0.00,499000,4,349300,0,0,0,0,0,0,0,499000,-499000,-499000
20200528,061539,國巨群益9B購03,,,,,0.00,0.00,0,0,0,0,0,0,0,0,0,0,0,0,0
20200528,06153P,健策元大97售04,0.28,0.28,0.28,0.28,+0.01,3.7,5000,1,1400,0,0,0,0,0,0,5000,0,5000,5000
20200528,061540,台積電群益9A購07,2.91,2.91,2.71,2.71,-0.14,-4.91,103000,10,293690,0,0,0,0,0,0,57000,46000,11000,11000
20200528,061541,旺宏群益9A購03,2.90,2.94,2.70,2.73,-0.21,-7.14,186000,13,537020,0,0,0,0,0,0,176000,20000,156000,156000
20200528,061542,旺宏群益9A購04,2.25,2.30,2.22,2.23,-0.08,-3.46,620000,21,1392670,0,0,0,0,0,0,620000,0,620000,620000
20200528,061543,南亞科群益9A購01,2.14,2.21,1.96,1.96,-0.05,-2.49,260000,22,553230,0,0,0,0,0,0,161000,74000,87000,87000
20200528,061544,大毅群益9B購02,1.96,1.98,1.88,1.88,-0.04,-2.08,565000,11,1094490,0,0,0,0,0,0,54000,511000,-457000,-457000
20200528,061545,華新科群益9A購09,1.83,1.86,1.83,1.86,-0.01,-0.53,20000,5,36840,0,0,0,0,0,0,20000,0,20000,20000
20200528,061546,大立光群益9A購05,3.73,3.73,3.48,3.48,-0.15,-4.13,34000,5,118750,0,0,0,0,0,0,1000,33000,-32000,-32000
20200528,061547,禾伸堂群益9A購01,1.74,1.74,1.74,1.74,+0.03,1.75,42000,1,73080,0,0,0,0,0,0,42000,0,42000,42000
20200528,061548,聯詠群益9A購02,2.17,2.17,2.13,2.13,-0.08,-3.62,33000,2,71210,0,0,0,0,0,0,0,33000,-33000,-33000
20200528,061549,泰碩群益9A購01,1.58,1.58,1.55,1.55,-0.11,-6.63,50000,2,78400,0,0,0,0,0,0,0,20000,-20000,-20000
20200528,06154P,超眾元大98售01,,,,,0.00,0.00,0,0,0,0,0,0,0,0,0,0,0,0,0
20200528,061550,聯鈞群益9A購03,0.99,0.99,0.97,0.98,+0.02,2.08,336000,12,330420,0,0,0,0,0,0,118000,218000,-100000,-100000
20200528,061551,GIS群益9A購01,,,,,0.00,0.00,0,0,0,0,0,0,0,0,0,0,0,0,0
20200528,061552,南六群益9A購02,1.65,1.65,1.52,1.52,+0.08,5.56,66000,4,106500,0,0,0,0,0,0,5000,61000,-56000,-56000
20200528,061553,南電群益9A購03,0.59,0.61,0.57,0.57,-0.02,-3.39,229000,10,139150,0,0,0,0,0,0,28000,201000,-173000,-173000
20200528,061554,T50反1國票9B購05,,,,,0.00,0.00,0,0,0,0,0,0,0,0,0,0,0,0,0
20200528,061555,聯電國票9B購01,0.78,0.84,0.78,0.84,0.00,0.00,216000,8,178300,0,0,0,0,0,0,61000,155000,-94000,-94000
20200528,061556,台積電國票9A購08,1.96,1.96,1.96,1.96,0.00,0.00,8000,1,15680,0,0,0,0,0,0,0,8000,-8000,-8000
20200528,061557,台積電國票9C購02,,,,,0.00,0.00,0,0,0,0,0,0,0,0,0,0,0,0,0
20200528,061558,旺宏國票9B購02,1.70,1.70,1.58,1.58,-0.18,-10.23,209000,8,344820,0,0,0,0,0,0,154000,55000,99000,99000
20200528,061559,南亞科國票9A購02,3.38,3.52,3.27,3.27,+0.19,6.17,36000,5,122080,0,0,0,0,0,0,10000,26000,-16000,-16000
20200528,06155P,智邦統一97售02,0.20,0.21,0.20,0.21,0.00,0.00,42000,3,8600,0,0,0,0,0,0,0,42000,-42000,-42000
20200528,061560,友達國票9B購01,,,,,0.00,0.00,0,0,0,0,0,0,0,0,0,0,0,0,0
20200528,061561,義隆國票9A購02,1.58,1.65,1.55,1.55,+0.02,1.31,181000,4,283700,0,0,0,0,0,0,172000,9000,163000,163000
20200528,061562,群創國票9B購01,1.14,1.16,1.14,1.16,+0.02,1.75,57000,3,65160,0,0,0,0,0,0,48000,9000,39000,39000
20200528,061563,群創國票9B購02,,,,,0.00,0.00,0,0,0,0,0,0,0,0,0,0,0,0,0
20200528,061564,華擎國票9A購02,2.83,2.83,2.83,2.83,+0.08,2.91,7000,1,19810,0,0,0,0,0,0,7000,0,7000,7000
20200528,061565,滬深2X元大9A購08,,,,,0.00,0.00,0,0,0,0,0,0,0,0,0,0,0,0,0
20200528,061566,華通元大9A購10,4.10,4.46,4.07,4.18,+0.29,7.46,132000,24,567050,0,0,0,0,0,0,66000,95000,-29000,-29000
20200528,061567,華通元大9A購11,2.64,2.88,2.61,2.84,+0.35,14.06,95000,9,266110,0,0,0,0,0,0,23000,80000,-57000,-57000
20200528,061568,國巨元大9A購25,2.88,2.88,2.76,2.76,-0.03,-1.08,130000,7,369820,0,0,0,0,0,0,89000,41000,48000,48000
20200528,061569,旺宏元大9A購14,3.01,3.08,3.00,3.03,-0.03,-0.98,264000,15,801940,0,0,0,0,0,0,184000,80000,104000,104000
20200528,06156P,大立光統一97售05,5.55,5.60,5.55,5.60,0.00,0.00,120000,3,667000,0,0,0,0,0,0,120000,120000,0,0
20200528,061570,瑞昱元大9A購05,1.94,1.94,1.90,1.90,+0.07,3.83,100000,13,192920,0,0,0,0,0,0,20000,100000,-80000,-80000
20200528,061571,奇力新元大9A購03,2.31,2.31,2.18,2.20,-0.15,-6.38,116000,7,256460,0,0,0,0,0,0,65000,51000,14000,14000
20200528,061572,奇力新元大9A購04,2.75,2.75,2.57,2.57,-0.24,-8.54,68000,2,182500,0,0,0,0,0,0,0,68000,-68000,-68000
20200528,061573,義隆元大9A購02,1.58,1.62,1.52,1.54,+0.08,5.48,244000,34,379140,0,0,0,0,0,0,104000,175000,-71000,-71000
20200528,061574,大毅元大9B購01,2.48,2.48,2.40,2.40,-0.09,-3.61,60000,2,147840,0,0,0,0,0,0,12000,48000,-36000,-36000
20200528,061575,華新科元大9A購20,2.16,2.16,2.16,2.16,+0.08,3.85,10000,1,21600,0,0,0,0,0,0,10000,0,10000,10000
20200528,061576,華新科元大9A購21,2.33,2.33,2.31,2.31,-0.03,-1.28,55000,5,127450,0,0,0,0,0,0,55000,0,55000,55000
20200528,061577,泰碩元大9A購03,1.49,1.51,1.43,1.43,-0.14,-8.92,29000,5,43070,0,0,0,0,0,0,1000,28000,-27000,-27000
20200528,061578,玉晶光元大9A購16,1.72,1.80,1.69,1.69,+0.04,2.42,304000,9,531370,0,0,0,0,0,0,27000,277000,-250000,-250000
20200528,061579,京鼎元大9A購02,2.30,2.30,2.15,2.15,-0.08,-3.59,163000,10,369440,0,0,0,0,0,0,83000,82000,1000,1000
20200528,06157P,聯鈞統一97售02,,,,,0.00,0.00,0,0,0,0,0,0,0,0,0,0,0,0,0
20200528,061580,華擎元大9A購06,2.04,2.04,1.97,1.97,+0.02,1.03,101000,7,201070,0,0,0,0,0,0,51000,50000,1000,1000
20200528,061581,貿聯元大9A購05,1.93,1.97,1.85,1.85,-0.05,-2.63,393000,30,750550,0,0,0,0,0,0,195000,198000,-3000,-3000
20200528,061582,麗豐元大9A購01,2.01,2.04,1.95,1.95,-0.04,-2.01,267000,13,533050,0,0,0,0,0,0,127000,170000,-43000,-43000
20200528,061583,矽創元大9A購01,2.12,2.38,2.12,2.22,+0.18,8.82,561000,54,1287560,0,0,0,0,0,0,181000,466000,-285000,-285000
20200528,061584,勤誠元大9A購01,1.69,1.69,1.61,1.61,-0.07,-4.17,95000,7,158290,0,0,0,0,0,0,22000,73000,-51000,-51000
20200528,061585,台積電富邦9B購06,0.68,0.68,0.65,0.65,0.00,0.00,23000,4,15020,0,0,0,0,0,0,1000,21000,-20000,-20000
20200528,061586,智邦富邦9A購02,1.32,1.32,1.18,1.18,+0.04,3.51,26000,5,32870,0,0,0,0,0,0,23000,3000,20000,20000
20200528,061587,美律富邦9A購02,0.47,0.47,0.47,0.47,+0.02,4.44,130000,1,61100,0,0,0,0,0,0,130000,0,130000,130000
20200528,061588,聯發科富邦9B購07,,,,,0.00,0.00,0,0,0,0,0,0,0,0,0,0,0,0,0
20200528,061589,世紀鋼富邦9B購01,0.67,0.84,0.67,0.77,+0.08,11.59,2400000,89,1806010,0,0,0,0,0,0,710000,1681000,-971000,-971000
20200528,06158P,玉晶光元富97售08,,,,,0.00,0.00,0,0,0,0,0,0,0,0,0,0,0,0,0
20200528,061590,金寶永豐9A購01,0.54,0.54,0.53,0.53,+0.03,6.0,130000,3,69600,0,0,0,0,0,0,0,130000,-130000,-130000
20200528,061591,旺宏永豐9A購02,,,,,0.00,0.00,0,0,0,0,0,0,0,0,0,0,0,0,0
20200528,061592,義隆永豐9A購03,0.81,0.81,0.80,0.80,+0.06,8.11,70000,2,56210,0,0,0,0,0,0,21000,49000,-28000,-28000
20200528,061593,智原永豐9A購01,0.79,0.79,0.79,0.79,-0.02,-2.47,86000,1,67940,0,0,0,0,0,0,86000,0,86000,86000
20200528,061594,玉晶光永豐9A購08,,,,,0.00,0.00,0,0,0,0,0,0,0,0,0,0,0,0,0
20200528,061595,智易永豐9A購02,1.06,1.16,1.05,1.06,0.00,0.00,293000,28,319860,0,0,0,0,0,0,175000,118000,57000,57000
20200528,061596,健策永豐9A購03,1.41,1.43,1.36,1.38,-0.03,-2.13,340000,27,471220,0,0,0,0,0,0,319000,21000,298000,298000
20200528,061597,南六永豐9A購04,0.98,1.05,0.97,1.04,+0.01,0.97,107000,10,109760,0,0,0,0,0,0,107000,0,107000,107000
20200528,061598,南電永豐9A購04,,,,,0.00,0.00,0,0,0,0,0,0,0,0,0,0,0,0,0
20200528,061599,元金反中信9C購01,0.83,0.83,0.83,0.83,-0.03,-3.49,12000,3,9960,0,0,0,0,0,0,10000,2000,8000,8000
20200528,06159P,牧德元富97售02,,,,,0.00,0.00,0,0,0,0,0,0,0,0,0,0,0,0,0
20200528,061600,聯電凱基9B購01,0.76,0.77,0.76,0.77,0.00,0.00,106000,6,80900,0,0,0,0,0,0,0,106000,-106000,-106000
20200528,061601,台積電凱基9A購26,,,,,0.00,0.00,0,0,0,0,0,0,0,0,0,0,0,0,0
20200528,061602,旺宏凱基9A購06,1.31,1.33,1.25,1.25,-0.10,-7.41,33000,8,43060,0,0,0,0,0,0,33000,13000,20000,20000
20200528,061603,瑞昱凱基9A購02,,,,,0.00,0.00,0,0,0,0,0,0,0,0,0,0,0,0,0
20200528,061604,台光電凱基9B購01,2.02,2.02,2.02,2.02,-0.05,-2.42,2000,1,4040,0,0,0,0,0,0,2000,0,2000,2000
20200528,061605,華新科凱基9A購14,0.68,0.69,0.65,0.65,-0.04,-5.8,208000,19,141270,0,0,0,0,0,0,110000,88000,22000,22000
20200528,061606,景碩凱基9A購02,0.83,0.86,0.83,0.86,+0.05,6.17,55000,2,46100,0,0,0,0,0,0,0,55000,-55000,-55000
20200528,061607,台表科凱基9B購02,1.99,1.99,1.79,1.86,-0.03,-1.59,82000,6,148680,0,0,0,0,0,0,63000,69000,-6000,-6000
20200528,061608,SP黃豆統一9A購01,,,,,0.00,0.00,0,0,0,0,0,0,0,0,0,0,0,0,0
20200528,061609,華新科統一9C購01,0.46,0.46,0.44,0.44,-0.02,-4.35,26000,3,11700,0,0,0,0,0,0,0,26000,-26000,-26000
20200528,06160P,台達電群益97售01,,,,,0.00,0.00,0,0,0,0,0,0,0,0,0,0,0,0,0
20200528,061610,力成統一9C購01,0.65,0.67,0.62,0.63,-0.03,-4.55,940000,16,609250,0,0,0,0,0,0,186000,754000,-568000,-568000
20200528,061611,南六統一01購01,0.67,0.67,0.67,0.67,+0.04,6.35,6000,2,4020,0,0,0,0,0,0,5000,1000,4000,4000
20200528,061612,南六統一9A購01,0.87,0.92,0.86,0.86,0.00,0.00,349000,21,307960,0,0,0,0,0,0,209000,178000,31000,31000
20200528,061613,南六統一9C購01,0.87,0.92,0.86,0.86,0.00,0.00,251000,18,219480,0,0,0,0,0,0,216000,35000,181000,181000
20200528,061614,亞德客群益9A購01,4.55,4.73,4.55,4.73,+0.34,7.74,26000,10,121040,0,0,0,0,0,0,26000,2000,24000,24000
20200528,061615,鴻海群益9A購06,2.79,2.79,2.77,2.77,+0.04,1.47,43000,5,119850,0,0,0,0,0,0,43000,3000,40000,40000
20200528,061616,鴻海群益9A購07,1.93,1.93,1.90,1.93,+0.05,2.66,72000,5,138840,0,0,0,0,0,0,72000,4000,68000,68000
20200528,061617,微星群益9A購02,2.63,2.67,2.58,2.67,+0.09,3.49,77000,4,201710,0,0,0,0,0,0,72000,5000,67000,67000
20200528,061618,友達群益9A購04,1.32,1.34,1.26,1.26,-0.11,-8.03,221000,5,288360,0,0,0,0,0,0,132000,89000,43000,43000
20200528,061619,大立光群益9B購01,2.47,2.47,2.47,2.47,+0.06,2.49,1000,1,2470,0,0,0,0,0,0,1000,0,1000,1000
20200528,06161P,聯發科群益97售03,1.37,1.57,1.37,1.47,+0.06,4.26,117000,20,176230,0,0,0,0,0,0,43000,74000,-31000,-31000
20200528,061620,禾伸堂群益9A購02,1.44,1.44,1.44,1.44,-0.03,-2.04,42000,1,60480,0,0,0,0,0,0,0,42000,-42000,-42000
20200528,061621,健策群益9A購05,3.32,3.33,2.91,2.91,-0.43,-12.87,117000,16,370330,0,0,0,0,0,0,107000,10000,97000,97000
20200528,061622,臻鼎群益9A購01,2.67,2.67,2.59,2.59,-0.27,-9.44,40000,2,106400,0,0,0,0,0,0,40000,5000,35000,35000
20200528,061623,祥碩群益9A購01,,,,,0.00,0.00,0,0,0,0,0,0,0,0,0,0,0,0,0
20200528,061624,中租群益9A購01,3.10,3.14,3.03,3.03,-0.06,-1.94,339000,10,1043950,0,0,0,0,0,0,331000,0,331000,331000
20200528,061625,聯茂群益9A購02,1.21,1.28,1.21,1.28,+0.09,7.56,726000,15,889940,0,0,0,0,0,0,468000,258000,210000,210000
20200528,061626,超眾群益9A購02,1.93,2.01,1.93,2.01,+0.03,1.52,44000,2,85080,0,0,0,0,0,0,42000,2000,40000,40000
20200528,061627,台表科群益9A購01,,,,,0.00,0.00,0,0,0,0,0,0,0,0,0,0,0,0,0
20200528,061628,緯穎群益9A購04,3.41,3.52,3.22,3.22,-0.14,-4.17,138000,17,463070,0,0,0,0,0,0,90000,117000,-27000,-27000
20200528,061629,FBVIX元大9A購01,,,,,0.00,0.00,0,0,0,0,0,0,0,0,0,0,0,0,0
20200528,06162P,大立光群益97售02,1.25,1.25,1.25,1.25,+0.09,7.76,5000,1,6250,0,0,0,0,0,0,5000,5000,0,0
20200528,061630,FBVIX元大9A購02,,,,,0.00,0.00,0,0,0,0,0,0,0,0,0,0,0,0,0
20200528,061631,SP黃豆元大9A購05,0.72,0.72,0.72,0.72,0.00,0.00,220000,2,158400,0,0,0,0,0,0,0,220000,-220000,-220000
20200528,061632,SP黃豆元大9A購06,,,,,0.00,0.00,0,0,0,0,0,0,0,0,0,0,0,0,0
20200528,061633,統一元大9A購01,2.56,2.56,2.41,2.41,-0.10,-3.98,86000,7,213300,0,0,0,0,0,0,0,86000,-86000,-86000
20200528,061634,遠東新元大9A購01,2.18,2.18,2.11,2.11,-0.10,-4.52,290000,18,623990,0,0,0,0,0,0,169000,187000,-18000,-18000
20200528,061635,台積電元大9A購34,2.15,2.15,2.13,2.13,-0.02,-0.93,130000,6,278500,0,0,0,0,0,0,80000,50000,30000,30000
20200528,061636,聯發科元大9A購11,,,,,0.00,0.00,0,0,0,0,0,0,0,0,0,0,0,0,0
20200528,061637,華新科元大9A購22,1.56,1.56,1.56,1.56,-0.03,-1.89,50000,1,78000,0,0,0,0,0,0,50000,0,50000,50000
20200528,061638,國泰金元大9A購03,2.50,2.50,2.33,2.33,-0.14,-5.67,62000,7,153200,0,0,0,0,0,0,62000,0,62000,62000
20200528,061639,晶豪科元大9A購02,2.69,2.78,2.67,2.74,+0.12,4.58,356000,17,965010,0,0,0,0,0,0,352000,42000,310000,310000
20200528,06163P,聯詠群益97售01,,,,,0.00,0.00,0,0,0,0,0,0,0,0,0,0,0,0,0
20200528,061640,智原元大9A購01,2.46,2.47,2.30,2.30,-0.07,-2.95,732000,43,1768420,0,0,0,0,0,0,293000,421000,-128000,-128000
20200528,061641,玉晶光元大9A購17,2.03,2.14,2.01,2.01,+0.06,3.08,205000,15,425540,0,0,0,0,0,0,70000,139000,-69000,-69000
20200528,061642,創意元大9A購04,1.38,1.47,1.38,1.38,0.00,0.00,1378000,100,1943990,0,0,0,0,0,0,259000,1047000,-788000,-788000
20200528,061643,嘉澤元大9A購05,4.51,4.51,4.51,4.51,-0.28,-5.85,11000,2,49610,0,0,0,0,0,0,0,11000,-11000,-11000
20200528,061644,健策元大9C購02,3.85,3.85,3.36,3.36,-0.40,-10.64,40000,7,144460,0,0,0,0,0,0,38000,12000,26000,26000
20200528,061645,超眾元大9A購06,1.39,1.40,1.36,1.38,-0.13,-8.61,73000,8,100480,0,0,0,0,0,0,61000,12000,49000,49000
20200528,061646,力成元大9A購02,1.36,1.41,1.28,1.29,-0.04,-3.01,181000,12,250040,0,0,0,0,0,0,75000,127000,-52000,-52000
20200528,061647,南六元大9A購03,2.17,2.17,2.09,2.09,-0.03,-1.42,109000,8,233810,0,0,0,0,0,0,46000,67000,-21000,-21000
20200528,061648,緯穎元大9A購04,3.50,3.53,3.35,3.35,-0.19,-5.37,10000,5,34340,0,0,0,0,0,0,2000,8000,-6000,-6000
20200528,061649,緯穎元大9A購06,3.64,3.64,3.64,3.64,-0.20,-5.21,10000,1,36400,0,0,0,0,0,0,10000,0,10000,10000
20200528,06164P,臺股指凱基97售04,,,,,0.00,0.00,0,0,0,0,0,0,0,0,0,0,0,0,0
20200528,061650,南電元大9A購07,1.31,1.35,1.25,1.25,-0.09,-6.72,50000,4,66250,0,0,0,0,0,0,25000,25000,0,0
20200528,061651,世紀鋼元大9C購02,2.59,2.97,2.55,2.94,+0.35,13.51,302000,38,792150,0,0,0,0,0,0,256000,46000,210000,210000
20200528,061652,T50反1國票9C購01,0.55,0.55,0.55,0.55,0.00,0.00,30000,1,16500,0,0,0,0,0,0,0,30000,-30000,-30000
20200528,061653,上証2X國票9A購02,,,,,0.00,0.00,0,0,0,0,0,0,0,0,0,0,0,0,0
20200528,061654,旺宏國票9A購02,2.56,2.61,2.56,2.61,-0.07,-2.61,152000,9,390520,0,0,0,0,0,0,152000,0,152000,152000
20200528,061655,微星國票9A購01,4.04,4.04,4.04,4.04,0.00,0.00,7000,1,28280,0,0,0,0,0,0,0,7000,-7000,-7000
20200528,061656,華新科國票9A購08,2.22,2.22,2.17,2.17,-0.02,-0.91,15000,2,33250,0,0,0,0,0,0,14000,1000,13000,13000
20200528,061657,智原國票9A購01,2.87,2.92,2.65,2.65,-0.30,-10.17,131000,6,367420,0,0,0,0,0,0,84000,47000,37000,37000
20200528,061658,聯茂富邦9A購03,0.42,0.46,0.41,0.45,+0.02,4.65,689000,21,301840,0,0,0,0,0,0,329000,360000,-31000,-31000
20200528,061659,信邦永豐9A購01,0.99,1.03,0.99,1.02,+0.01,0.99,512000,13,519850,0,0,0,0,0,0,345000,167000,178000,178000
20200528,06165P,臺股指凱基9A售03,1.66,1.95,1.64,1.95,0.00,0.00,1401000,20,2417640,0,0,0,0,0,0,1109000,1381000,-272000,-272000
20200528,061660,禾伸堂永豐9A購01,0.75,0.76,0.75,0.76,-0.01,-1.3,97000,2,73670,0,0,0,0,0,0,0,97000,-97000,-97000
20200528,061661,京鼎永豐9A購02,1.20,1.20,1.11,1.12,-0.06,-5.08,344000,23,398080,0,0,0,0,0,0,15000,330000,-315000,-315000
20200528,061662,瑞儀永豐9A購02,1.18,1.24,1.18,1.20,+0.01,0.84,332000,8,400820,0,0,0,0,0,0,289000,43000,246000,246000
20200528,061663,南六永豐9A購05,0.91,0.94,0.88,0.94,+0.03,3.3,56000,17,51040,0,0,0,0,0,0,56000,0,56000,56000
20200528,061664,上銀中信9A購01,1.82,1.84,1.63,1.63,-0.19,-10.44,76000,17,134900,0,0,0,0,0,0,64000,12000,52000,52000
20200528,061665,旺宏中信9C購01,0.51,0.51,0.51,0.51,-0.05,-8.93,2000,1,1020,0,0,0,0,0,0,0,2000,-2000,-2000
20200528,061666,友達中信01購01,0.95,0.95,0.95,0.95,0.00,0.00,48000,1,45600,0,0,0,0,0,0,48000,0,48000,48000
20200528,061667,友達中信9A購02,,,,,0.00,0.00,0,0,0,0,0,0,0,0,0,0,0,0,0
20200528,061668,信邦中信9B購01,1.01,1.05,1.01,1.04,+0.03,2.97,236000,10,242880,0,0,0,0,0,0,63000,173000,-110000,-110000
20200528,061669,崇越中信9A購01,0.81,0.81,0.80,0.80,+0.01,1.27,96000,2,77280,0,0,0,0,0,0,48000,48000,0,0
20200528,06166P,大立光國票98售01,,,,,0.00,0.00,0,0,0,0,0,0,0,0,0,0,0,0,0
20200528,061670,台灣50元大9A購20,,,,,0.00,0.00,0,0,0,0,0,0,0,0,0,0,0,0,0
20200528,061671,台灣50元大9A購21,,,,,0.00,0.00,0,0,0,0,0,0,0,0,0,0,0,0,0
20200528,061672,臺指反元大01購05,0.50,0.50,0.50,0.50,0.00,0.00,20000,1,10000,0,0,0,0,0,0,0,20000,-20000,-20000
20200528,061673,仁寶元大9B購01,1.32,1.32,1.26,1.26,-0.07,-5.26,326000,5,424960,0,0,0,0,0,0,248000,78000,170000,170000
20200528,061674,聯發科元大9A購12,6.20,6.25,6.20,6.25,-0.15,-2.34,30000,2,186900,0,0,0,0,0,0,18000,12000,6000,6000
20200528,061675,華新科元大9A購23,,,,,0.00,0.00,0,0,0,0,0,0,0,0,0,0,0,0,0
20200528,061676,新光金元大9A購03,,,,,0.00,0.00,0,0,0,0,0,0,0,0,0,0,0,0,0
20200528,061677,泰碩元大9A購05,1.49,1.49,1.49,1.49,-0.05,-3.25,25000,1,37250,0,0,0,0,0,0,0,25000,-25000,-25000
20200528,061678,玉晶光元大9B購04,1.89,1.99,1.89,1.99,+0.14,7.57,85000,3,163900,0,0,0,0,0,0,0,85000,-85000,-85000
20200528,061679,健策元大9B購04,1.89,1.92,1.67,1.68,-0.10,-5.62,159000,19,292090,0,0,0,0,0,0,112000,47000,65000,65000
20200528,06167P,欣興國票97售05,1.20,1.20,1.20,1.20,0.00,0.00,2000,1,2400,0,0,0,0,0,0,0,2000,-2000,-2000
20200528,061680,崇越元大9A購01,1.81,1.81,1.76,1.76,-0.03,-1.68,132000,6,235560,0,0,0,0,0,0,72000,60000,12000,12000
20200528,061681,南電元大9A購08,0.79,0.79,0.74,0.74,-0.04,-5.13,30000,4,22870,0,0,0,0,0,0,0,30000,-30000,-30000
20200528,061682,南電元大9B購01,0.89,0.89,0.87,0.87,-0.04,-4.4,637000,7,565320,0,0,0,0,0,0,634000,3000,631000,631000
20200528,061683,台灣50群益9B購09,0.87,0.87,0.87,0.87,0.00,0.00,20000,1,17400,0,0,0,0,0,0,20000,0,20000,20000
20200528,061684,T50反1群益9A購06,,,,,0.00,0.00,0,0,0,0,0,0,0,0,0,0,0,0,0
20200528,061685,道瓊反群益9A購03,1.00,1.01,0.99,0.99,0.00,0.00,1076000,5,1079910,0,0,0,0,0,0,0,1076000,-1076000,-1076000
20200528,061686,SP黃豆群益9A購04,,,,,0.00,0.00,0,0,0,0,0,0,0,0,0,0,0,0,0
20200528,061687,大成鋼群益9A購01,1.77,2.04,1.74,1.88,+0.16,9.3,437000,20,827210,0,0,0,0,0,0,281000,183000,98000,98000
20200528,061688,華通群益9A購07,3.23,3.23,3.14,3.14,0.00,0.00,22000,2,70880,0,0,0,0,0,0,0,22000,-22000,-22000
20200528,061689,國巨群益9A購12,3.21,3.21,2.90,2.90,-0.14,-4.61,82000,7,262280,0,0,0,0,0,0,82000,3000,79000,79000
20200528,06168P,台表科國票97售06,0.85,0.92,0.83,0.89,+0.02,2.3,398000,10,344460,0,0,0,0,0,0,172000,226000,-54000,-54000
20200528,061690,旺宏群益9A購05,2.78,2.78,2.72,2.72,-0.01,-0.37,78000,4,213720,0,0,0,0,0,0,78000,0,78000,78000
20200528,061691,聯發科群益9A購03,,,,,0.00,0.00,0,0,0,0,0,0,0,0,0,0,0,0,0
20200528,061692,聯發科群益9A購04,,,,,0.00,0.00,0,0,0,0,0,0,0,0,0,0,0,0,0
20200528,061693,華新科群益9B購02,2.24,2.28,2.13,2.13,-0.21,-8.97,173000,8,384410,0,0,0,0,0,0,173000,0,173000,173000
20200528,061694,玉山金群益9A購01,2.20,2.20,2.17,2.17,-0.04,-1.81,109000,3,237940,0,0,0,0,0,0,55000,54000,1000,1000
20200528,061695,群創群益9A購01,0.82,0.82,0.82,0.82,0.00,0.00,91000,1,74620,0,0,0,0,0,0,0,91000,-91000,-91000
20200528,061696,南茂群益9A購01,1.65,1.65,1.50,1.51,-0.18,-10.65,124000,7,189670,0,0,0,0,0,0,16000,124000,-108000,-108000
20200528,061697,世紀鋼群益9A購03,2.09,2.56,2.09,2.44,+0.28,12.96,250000,10,542060,0,0,0,0,0,0,230000,20000,210000,210000
20200528,061698,智邦國票9A購04,,,,,0.00,0.00,0,0,0,0,0,0,0,0,0,0,0,0,0
20200528,061699,燿華國票9A購01,1.92,1.92,1.89,1.91,+0.02,1.06,25000,4,47910,0,0,0,0,0,0,5000,20000,-15000,-15000
20200528,06169P,華新科元富97售02,2.78,2.93,2.78,2.93,+0.11,3.9,46000,10,131560,0,0,0,0,0,0,6000,40000,-34000,-34000
20200528,061700,瑞昱國票9A購02,,,,,0.00,0.00,0,0,0,0,0,0,0,0,0,0,0,0,0
20200528,061701,友達國票9B購02,,,,,0.00,0.00,0,0,0,0,0,0,0,0,0,0,0,0,0
20200528,061702,奇鋐國票9A購02,2.91,3.30,2.91,3.30,+0.50,17.86,80000,5,257800,0,0,0,0,0,0,0,80000,-80000,-80000
20200528,061703,信邦國票9A購01,2.40,2.50,2.40,2.45,+0.02,0.82,53000,4,129600,0,0,0,0,0,0,48000,5000,43000,43000
20200528,061704,景碩國票9A購01,,,,,0.00,0.00,0,0,0,0,0,0,0,0,0,0,0,0,0
20200528,061705,健策國票9A購06,8.25,8.75,8.05,8.05,+0.25,3.21,119000,16,999450,0,0,0,0,0,0,116000,3000,113000,113000
20200528,061706,旭富國票9A購02,,,,,0.00,0.00,0,0,0,0,0,0,0,0,0,0,0,0,0
20200528,061707,超眾國票9B購01,1.86,1.96,1.86,1.92,-0.09,-4.48,135000,5,257020,0,0,0,0,0,0,75000,80000,-5000,-5000
20200528,061708,同欣電國票9A購02,2.35,2.35,2.27,2.28,-0.28,-10.94,94000,9,220300,0,0,0,0,0,0,84000,10000,74000,74000
20200528,061709,SP黃豆凱基01購02,0.63,0.63,0.63,0.63,0.00,0.00,100000,1,63000,0,0,0,0,0,0,100000,0,100000,100000
20200528,06170P,禾伸堂元富97售02,0.38,0.38,0.38,0.38,-0.01,-2.56,79000,1,30020,0,0,0,0,0,0,0,79000,-79000,-79000
20200528,061710,國巨凱基9A購18,2.54,2.54,2.54,2.54,-0.08,-3.05,1000,1,2540,0,0,0,0,0,0,1000,1000,0,0
20200528,061711,台積電凱基9A購27,,,,,0.00,0.00,0,0,0,0,0,0,0,0,0,0,0,0,0
20200528,061712,旺宏凱基9A購08,,,,,0.00,0.00,0,0,0,0,0,0,0,0,0,0,0,0,0
20200528,061713,華邦電凱基9A購01,1.53,1.58,1.44,1.44,+0.07,5.11,203000,34,312960,0,0,0,0,0,0,201000,12000,189000,189000
20200528,061714,華新科凱基9A購15,0.94,0.94,0.94,0.94,-0.01,-1.05,46000,4,43240,0,0,0,0,0,0,46000,0,46000,46000
20200528,061715,牧德凱基9B購03,1.22,1.22,1.16,1.16,-0.08,-6.45,73000,2,84980,0,0,0,0,0,0,73000,0,73000,73000
20200528,061716,瑞儀凱基9B購01,0.87,0.87,0.85,0.85,+0.01,1.19,60000,5,51600,0,0,0,0,0,0,20000,35000,-15000,-15000
20200528,061717,力成凱基9B購01,0.86,0.90,0.80,0.80,-0.06,-6.98,148000,10,128310,0,0,0,0,0,0,82000,66000,16000,16000
20200528,061718,GIS凱基9B購01,1.55,1.57,1.35,1.39,-0.09,-6.08,812000,61,1217930,0,0,0,0,0,0,545000,240000,305000,305000
20200528,061719,緯穎凱基9A購06,4.10,4.25,4.09,4.25,-0.01,-0.23,72000,15,295900,0,0,0,0,0,0,70000,2000,68000,68000
20200528,06171P,台積電統一97售06,,,,,0.00,0.00,0,0,0,0,0,0,0,0,0,0,0,0,0
20200528,061720,智邦國泰9C購01,2.06,2.32,1.97,2.03,+0.13,6.84,293000,36,630330,0,0,0,0,0,0,132000,215000,-83000,-83000
20200528,061721,道瓊反富邦9B購01,0.39,0.39,0.39,0.39,0.00,0.00,10000,1,3900,0,0,0,0,0,0,0,10000,-10000,-10000
20200528,061722,健策永豐9B購03,1.34,1.35,1.19,1.20,-0.16,-11.76,238000,25,305570,0,0,0,0,0,0,135000,103000,32000,32000
20200528,061723,嘉聯益永豐9A購03,0.66,0.73,0.66,0.73,+0.08,12.31,451000,11,326170,0,0,0,0,0,0,20000,431000,-411000,-411000
20200528,061724,訊芯永豐9A購01,0.57,0.57,0.55,0.55,-0.04,-6.78,136000,2,76160,0,0,0,0,0,0,68000,68000,0,0
20200528,061725,國巨麥證9A購05,,,,,0.00,0.00,0,0,0,0,0,0,0,0,0,0,0,0,0
20200528,061726,台積電麥證9A購05,,,,,0.00,0.00,0,0,0,0,0,0,0,0,0,0,0,0,0
20200528,061727,旺宏麥證9A購04,,,,,0.00,0.00,0,0,0,0,0,0,0,0,0,0,0,0,0
20200528,061728,華新科麥證9A購02,,,,,0.00,0.00,0,0,0,0,0,0,0,0,0,0,0,0,0
20200528,061729,祥碩麥證9A購02,,,,,0.00,0.00,0,0,0,0,0,0,0,0,0,0,0,0,0
20200528,06172P,台虹永豐97售02,,,,,0.00,0.00,0,0,0,0,0,0,0,0,0,0,0,0,0
20200528,061730,旺宏統一01購02,,,,,0.00,0.00,0,0,0,0,0,0,0,0,0,0,0,0,0
20200528,061731,旺宏統一9B購06,1.18,1.19,1.17,1.18,+0.01,0.85,147000,33,173030,0,0,0,0,0,0,147000,0,147000,147000
20200528,061732,智邦中信9B購01,1.04,1.08,0.94,0.95,0.00,0.00,210000,6,216900,0,0,0,0,0,0,20000,190000,-170000,-170000
20200528,061733,聯發科中信01購01,1.20,1.20,1.20,1.20,0.00,0.00,5000,1,6000,0,0,0,0,0,0,0,5000,-5000,-5000
20200528,061734,全新中信9B購02,0.57,0.57,0.56,0.57,-0.01,-1.72,52000,27,29420,0,0,0,0,0,0,52000,0,52000,52000
20200528,061735,上銀凱基9B購01,5.30,5.50,5.30,5.50,0.00,0.00,16000,9,85350,0,0,0,0,0,0,16000,0,16000,16000
20200528,061736,國巨凱基9B購05,,,,,0.00,0.00,0,0,0,0,0,0,0,0,0,0,0,0,0
20200528,061737,南亞科凱基9B購01,1.78,1.78,1.78,1.78,+0.13,7.88,20000,2,35600,0,0,0,0,0,0,10000,10000,0,0
20200528,061738,聯發科凱基9B購04,3.13,3.13,2.91,2.91,-0.16,-5.21,158000,11,475790,0,0,0,0,0,0,158000,0,158000,158000
20200528,061739,奇力新凱基9C購01,0.71,0.71,0.67,0.67,-0.04,-5.63,27000,2,18170,0,0,0,0,0,0,25000,2000,23000,23000
20200528,06173P,華通元大97售02,1.04,1.08,1.04,1.05,-0.17,-13.93,15000,4,16030,0,0,0,0,0,0,3000,12000,-9000,-9000
20200528,061740,華新科凱基03購01,0.76,0.76,0.71,0.71,0.00,0.00,521000,15,385370,0,0,0,0,0,0,0,521000,-521000,-521000
20200528,061741,新光金凱基9B購01,0.98,0.98,0.98,0.98,-0.02,-2.0,15000,1,14700,0,0,0,0,0,0,15000,0,15000,15000
20200528,061742,奇鋐凱基9B購01,0.88,0.98,0.88,0.94,+0.08,9.3,120000,12,111860,0,0,0,0,0,0,5000,115000,-110000,-110000
20200528,061743,祥碩凱基9B購02,2.03,2.27,2.03,2.15,+0.16,8.04,193000,19,420650,0,0,0,0,0,0,126000,158000,-32000,-32000
20200528,061744,超眾凱基9B購02,,,,,0.00,0.00,0,0,0,0,0,0,0,0,0,0,0,0,0
20200528,061745,南電凱基9B購02,0.42,0.42,0.39,0.39,0.00,0.00,4000,2,1590,0,0,0,0,0,0,4000,0,4000,4000
20200528,061746,國巨統一9C購07,,,,,0.00,0.00,0,0,0,0,0,0,0,0,0,0,0,0,0
20200528,061747,南亞科統一01購01,0.64,0.67,0.62,0.62,+0.01,1.64,158000,13,102830,0,0,0,0,0,0,101000,57000,44000,44000
20200528,061748,華新科統一9C購02,,,,,0.00,0.00,0,0,0,0,0,0,0,0,0,0,0,0,0
20200528,061749,群創統一9C購02,0.83,0.83,0.82,0.83,+0.01,1.22,218000,3,180880,0,0,0,0,0,0,67000,151000,-84000,-84000
20200528,06174P,國巨元大97售07,,,,,0.00,0.00,0,0,0,0,0,0,0,0,0,0,0,0,0
20200528,061750,台達電台新9B購01,0.88,0.88,0.88,0.88,0.00,0.00,34000,1,29920,0,0,0,0,0,0,34000,0,34000,34000
20200528,061751,華通台新9B購01,2.63,2.63,2.50,2.50,+0.24,10.62,103000,2,259450,0,0,0,0,0,0,88000,15000,73000,73000
20200528,061752,瑞昱台新9B購01,1.86,1.89,1.83,1.87,+0.09,5.06,118000,12,221260,0,0,0,0,0,0,54000,85000,-31000,-31000
20200528,061753,南亞科台新9B購01,1.48,1.48,1.48,1.48,+0.18,13.85,10000,1,14800,0,0,0,0,0,0,0,10000,-10000,-10000
20200528,061754,晶技麥證9B購01,0.81,0.82,0.78,0.78,-0.04,-4.88,66000,4,52100,18000,48000,-30000,0,0,0,18000,48000,-30000,-30000
20200528,061755,台灣50元大9B購11,,,,,0.00,0.00,0,0,0,0,0,0,0,0,0,0,0,0,0
20200528,061756,台灣50元大9B購12,,,,,0.00,0.00,0,0,0,0,0,0,0,0,0,0,0,0,0
20200528,061757,T50反1元大9B購01,1.18,1.18,1.18,1.18,0.00,0.00,5000,1,5900,0,0,0,0,0,0,0,5000,-5000,-5000
20200528,061758,T50反1元大9B購02,,,,,0.00,0.00,0,0,0,0,0,0,0,0,0,0,0,0,0
20200528,061759,上証反元大02購01,,,,,0.00,0.00,0,0,0,0,0,0,0,0,0,0,0,0,0
20200528,06175P,台積電元大97售21,4.14,4.75,4.14,4.75,0.00,0.00,12000,2,50900,0,0,0,0,0,0,10000,2000,8000,8000
20200528,061760,臺指反元大01購06,,,,,0.00,0.00,0,0,0,0,0,0,0,0,0,0,0,0,0
20200528,061761,臺指反元大02購01,,,,,0.00,0.00,0,0,0,0,0,0,0,0,0,0,0,0,0
20200528,061762,台塑元大9B購01,3.07,3.08,2.86,2.89,-0.20,-6.47,277000,8,823620,0,0,0,0,0,0,0,277000,-277000,-277000
20200528,061763,聯電元大9C購02,1.50,1.57,1.50,1.55,+0.02,1.31,159000,7,243480,0,0,0,0,0,0,52000,107000,-55000,-55000
20200528,061764,旺宏元大9B購01,2.52,2.57,2.47,2.47,-0.14,-5.36,105000,6,264550,0,0,0,0,0,0,65000,40000,25000,25000
20200528,061765,義隆元大9B購01,2.50,2.55,2.38,2.40,+0.11,4.8,388000,44,943580,0,0,0,0,0,0,324000,74000,250000,250000
20200528,061766,華新科元大9B購02,2.10,2.10,2.10,2.10,+0.01,0.48,14000,1,29400,0,0,0,0,0,0,14000,0,14000,14000
20200528,061767,信邦元大9B購01,2.21,2.27,2.19,2.25,+0.05,2.27,340000,13,757200,0,0,0,0,0,0,220000,254000,-34000,-34000
20200528,061768,晶技元大9B購02,1.53,1.55,1.47,1.50,-0.09,-5.66,346000,20,522940,0,0,0,0,0,0,232000,114000,118000,118000
20200528,061769,晶技元大9B購03,1.35,1.40,1.31,1.31,-0.09,-6.43,794000,41,1066520,0,0,0,0,0,0,605000,169000,436000,436000
20200528,06176P,台積電元大97售22,1.85,1.85,1.85,1.85,0.00,0.00,1000,1,1850,0,0,0,0,0,0,0,1000,-1000,-1000
20200528,061770,泰碩元大9B購02,2.45,2.52,2.34,2.34,-0.25,-9.65,78000,4,186410,0,0,0,0,0,0,1000,77000,-76000,-76000
20200528,061771,玉晶光元大9C購04,2.00,2.09,1.99,1.99,+0.02,1.02,120000,5,243600,0,0,0,0,0,0,0,120000,-120000,-120000
20200528,061772,健策元大9B購06,1.69,1.69,1.46,1.48,-0.07,-4.52,270000,28,436900,0,0,0,0,0,0,238000,52000,186000,186000
20200528,061773,和潤元大9B購01,2.02,2.05,1.99,1.99,-0.03,-1.49,482000,12,971330,0,0,0,0,0,0,200000,282000,-82000,-82000
20200528,061774,T50反1國票9B購06,0.77,0.85,0.76,0.84,+0.03,3.7,283000,16,224940,0,0,0,0,0,0,60000,223000,-163000,-163000
20200528,061775,臺指反國票9B購04,0.98,1.06,0.98,1.04,+0.05,5.05,540000,8,561000,0,0,0,0,0,0,10000,530000,-520000,-520000
20200528,061776,晶技國票9B購01,3.85,3.85,3.80,3.80,0.00,0.00,9000,2,34450,0,0,0,0,0,0,0,9000,-9000,-9000
20200528,061777,臺指反群益9B購01,,,,,0.00,0.00,0,0,0,0,0,0,0,0,0,0,0,0,0
20200528,061778,元金2X群益9B購02,1.10,1.10,1.10,1.10,+0.08,7.84,10000,1,11000,0,0,0,0,0,0,0,10000,-10000,-10000
20200528,061779,上銀群益9B購01,,,,,0.00,0.00,0,0,0,0,0,0,0,0,0,0,0,0,0
20200528,06177P,玉晶光元大98售07,1.70,1.70,1.61,1.70,-0.07,-3.95,42000,9,70210,0,0,0,0,0,0,1000,41000,-40000,-40000
20200528,061780,國巨群益9C購01,1.27,1.27,1.27,1.27,-0.08,-5.93,10000,1,12700,0,0,0,0,0,0,0,10000,-10000,-10000
20200528,061781,台積電群益9C購01,3.55,3.55,3.35,3.35,-0.11,-3.18,60000,2,211000,0,0,0,0,0,0,60000,0,60000,60000
20200528,061782,智邦群益9B購01,2.53,2.66,2.35,2.35,+0.22,10.33,245000,11,637970,0,0,0,0,0,0,141000,104000,37000,37000
20200528,061783,友達群益9B購01,0.95,0.97,0.95,0.95,0.00,0.00,709000,9,684630,0,0,0,0,0,0,279000,430000,-151000,-151000
20200528,061784,聯發科群益9B購02,7.30,7.30,7.30,7.30,0.00,0.00,6000,1,43800,0,0,0,0,0,0,0,6000,-6000,-6000
20200528,061785,奇力新群益9B購01,0.85,0.85,0.85,0.85,-0.10,-10.53,41000,3,34850,0,0,0,0,0,0,40000,1000,39000,39000
20200528,061786,義隆群益9B購01,1.26,1.29,1.23,1.27,+0.09,7.63,866000,43,1078630,0,0,0,0,0,0,775000,105000,670000,670000
20200528,061787,華新科群益9C購01,1.94,1.96,1.86,1.86,-0.07,-3.63,179000,7,348000,0,0,0,0,0,0,111000,68000,43000,43000
20200528,061788,信邦群益9B購01,1.11,1.11,1.11,1.11,0.00,0.00,10000,1,11100,0,0,0,0,0,0,0,10000,-10000,-10000
20200528,061789,群創群益9B購01,0.69,0.70,0.69,0.70,+0.03,4.48,136000,2,94840,0,0,0,0,0,0,36000,100000,-64000,-64000
20200528,06178P,大立光第一99售01,,,,,0.00,0.00,0,0,0,0,0,0,0,0,0,0,0,0,0
20200528,061790,中租群益9B購01,2.20,2.20,2.11,2.11,-0.07,-3.21,254000,8,550010,0,0,0,0,0,0,243000,0,243000,243000
20200528,061791,康友群益9B購01,,,,,0.00,0.00,0,0,0,0,0,0,0,0,0,0,0,0,0
20200528,061792,和大永豐9B購01,1.19,1.19,1.19,1.19,+0.08,7.21,58000,2,69020,0,0,0,0,0,0,0,58000,-58000,-58000
20200528,061793,上銀永豐9B購01,1.92,1.97,1.87,1.87,-0.09,-4.59,123000,31,235040,0,0,0,0,0,0,97000,26000,71000,71000
20200528,061794,國巨永豐9B購01,,,,,0.00,0.00,0,0,0,0,0,0,0,0,0,0,0,0,0
20200528,061795,智邦永豐9B購01,1.25,1.25,1.20,1.20,+0.20,20.0,115000,4,143400,0,0,0,0,0,0,1000,114000,-113000,-113000
20200528,061796,興勤永豐9B購01,0.95,0.97,0.92,0.97,+0.01,1.04,998000,48,931550,0,0,0,0,0,0,883000,115000,768000,768000
20200528,061797,聯發科永豐9B購01,2.34,2.34,2.18,2.18,-0.11,-4.8,325000,25,748770,0,0,0,0,0,0,275000,50000,225000,225000
20200528,061798,晶豪科永豐9B購01,0.94,0.94,0.89,0.89,-0.01,-1.11,207000,5,186380,0,0,0,0,0,0,0,207000,-207000,-207000
20200528,061799,奇鋐永豐9B購01,0.68,0.74,0.68,0.69,+0.04,6.15,184000,3,135460,0,0,0,0,0,0,0,184000,-184000,-184000
20200528,06179P,國巨群益97售04,3.94,4.28,3.94,4.28,0.00,0.00,43000,4,181960,0,0,0,0,0,0,32000,11000,21000,21000
20200528,061800,泰鼎永豐9B購01,1.46,1.50,1.42,1.42,-0.04,-2.74,100000,10,146600,0,0,0,0,0,0,80000,20000,60000,60000
20200528,061801,祥碩永豐9B購01,2.12,2.12,2.03,2.05,+0.24,13.26,214000,8,437360,0,0,0,0,0,0,1000,214000,-213000,-213000
20200528,061802,勤誠永豐9B購01,0.86,0.86,0.86,0.86,0.00,0.00,10000,1,8600,0,0,0,0,0,0,10000,0,10000,10000
20200528,061803,巨大永豐9B購01,2.15,2.19,2.09,2.09,-0.08,-3.69,223000,16,479810,0,0,0,0,0,0,109000,114000,-5000,-5000
20200528,061804,國巨中信9B購02,,,,,0.00,0.00,0,0,0,0,0,0,0,0,0,0,0,0,0
20200528,061805,華新科中信9B購01,,,,,0.00,0.00,0,0,0,0,0,0,0,0,0,0,0,0,0
20200528,061806,元黃金統一9B購01,,,,,0.00,0.00,0,0,0,0,0,0,0,0,0,0,0,0,0
20200528,061807,元金2X統一9B購01,,,,,0.00,0.00,0,0,0,0,0,0,0,0,0,0,0,0,0
20200528,061808,聯發科統一01購02,1.59,1.59,1.42,1.49,-0.05,-3.25,854000,36,1280470,0,0,0,0,0,0,125000,729000,-604000,-604000
20200528,061809,聯發科統一9C購05,2.06,2.06,2.06,2.06,+0.04,1.98,25000,1,51500,0,0,0,0,0,0,25000,0,25000,25000
20200528,06180P,禾伸堂群益97售01,0.48,0.48,0.48,0.48,-0.02,-4.0,70000,2,33600,0,0,0,0,0,0,70000,0,70000,70000
20200528,061810,S&P反1群益9B購02,0.91,0.91,0.91,0.91,-0.06,-6.19,10000,1,9100,0,0,0,0,0,0,10000,0,10000,10000
20200528,061811,A50正2群益01購03,,,,,0.00,0.00,0,0,0,0,0,0,0,0,0,0,0,0,0
20200528,061812,臺指反群益9B購02,0.95,0.95,0.95,0.95,0.00,0.00,50000,1,47500,0,0,0,0,0,0,50000,0,50000,50000
20200528,061813,鴻海群益9B購02,1.46,1.46,1.46,1.46,-0.01,-0.68,51000,1,74460,0,0,0,0,0,0,51000,0,51000,51000
20200528,061814,聯發科群益9B購04,3.01,3.02,3.00,3.00,+0.03,1.01,144000,10,433350,0,0,0,0,0,0,144000,0,144000,144000
20200528,061815,奇力新群益9B購02,1.31,1.31,1.31,1.31,-0.01,-0.76,38000,1,49780,0,0,0,0,0,0,38000,0,38000,38000
20200528,061816,長榮航群益9B購02,2.05,2.07,1.92,1.94,-0.14,-6.73,573000,27,1138310,0,0,0,0,0,0,423000,123000,300000,300000
20200528,061817,高鐵群益9B購01,3.40,3.40,2.90,2.97,-0.32,-9.73,290000,35,941240,0,0,0,0,0,0,206000,56000,150000,150000
20200528,061818,富邦金群益9C購01,1.97,1.99,1.78,1.78,-0.21,-10.55,100000,7,181750,0,0,0,0,0,0,20000,92000,-72000,-72000
20200528,061819,茂林群益9B購01,2.43,2.43,2.30,2.34,-0.66,-22.0,98000,13,232610,0,0,0,0,0,0,45000,53000,-8000,-8000
20200528,06181P,國巨中信97售02,,,,,0.00,0.00,0,0,0,0,0,0,0,0,0,0,0,0,0
20200528,061820,康控群益9B購02,1.46,1.46,1.41,1.41,+0.01,0.71,112000,2,162170,0,0,0,0,0,0,112000,27000,85000,85000
20200528,061821,祥碩群益9B購02,,,,,0.00,0.00,0,0,0,0,0,0,0,0,0,0,0,0,0
20200528,061822,和潤群益9B購01,1.82,1.83,1.82,1.83,0.00,0.00,92000,4,167900,0,0,0,0,0,0,0,92000,-92000,-92000
20200528,061823,勤誠群益9B購01,1.69,1.76,1.61,1.61,-0.13,-7.47,197000,7,332920,0,0,0,0,0,0,97000,100000,-3000,-3000
20200528,061824,聯電麥證9B購01,,,,,0.00,0.00,0,0,0,0,0,0,0,0,0,0,0,0,0
20200528,061825,聯發科麥證9B購01,,,,,0.00,0.00,0,0,0,0,0,0,0,0,0,0,0,0,0
20200528,061826,台郡麥證9B購01,1.06,1.06,1.06,1.06,0.00,0.00,85000,1,90100,0,85000,-85000,0,0,0,0,85000,-85000,-85000
20200528,061827,台灣50凱基02購01,,,,,0.00,0.00,0,0,0,0,0,0,0,0,0,0,0,0,0
20200528,061828,T50反1凱基02購01,,,,,0.00,0.00,0,0,0,0,0,0,0,0,0,0,0,0,0
20200528,061829,T50反1凱基9C購02,1.32,1.35,1.32,1.35,0.00,0.00,102000,3,135200,0,0,0,0,0,0,0,102000,-102000,-102000
20200528,06182P,群創兆豐97售03,2.09,2.19,2.09,2.19,+0.07,3.3,30000,4,64500,0,0,0,0,0,0,10000,20000,-10000,-10000
20200528,061830,元金2X凱基01購01,1.08,1.08,1.08,1.08,+0.05,4.85,10000,1,10800,0,0,0,0,0,0,0,10000,-10000,-10000
20200528,061831,智邦凱基9B購02,1.33,1.53,1.29,1.29,+0.14,12.17,38000,5,53340,0,0,0,0,0,0,23000,15000,8000,8000
20200528,061832,聯發科凱基9B購06,1.58,1.58,1.55,1.55,0.00,0.00,4000,2,6230,0,0,0,0,0,0,1000,3000,-2000,-2000
20200528,061833,華新科凱基02購01,1.01,1.01,0.98,0.98,0.00,0.00,7000,2,6920,0,0,0,0,0,0,0,7000,-7000,-7000
20200528,061834,華新科凱基02購02,1.22,1.23,1.22,1.23,+0.02,1.65,20000,8,24410,0,0,0,0,0,0,20000,0,20000,20000
20200528,061835,華新科凱基02購03,,,,,0.00,0.00,0,0,0,0,0,0,0,0,0,0,0,0,0
20200528,061836,華新科凱基05購01,2.23,2.27,2.23,2.27,0.00,0.00,26000,12,58160,0,0,0,0,0,0,26000,0,26000,26000
20200528,061837,華新科凱基05購02,1.58,1.60,1.50,1.50,-0.06,-3.85,83000,8,130850,0,0,0,0,0,0,61000,22000,39000,39000
20200528,061838,華新科凱基05購03,,,,,0.00,0.00,0,0,0,0,0,0,0,0,0,0,0,0,0
20200528,061839,華新科凱基05購04,0.98,0.98,0.96,0.96,-0.04,-4.0,11000,2,10580,0,0,0,0,0,0,1000,10000,-9000,-9000
20200528,06183P,大立光元大97售05,1.87,2.13,1.87,2.13,+0.08,3.9,130000,6,266900,0,0,0,0,0,0,130000,130000,0,0
20200528,061840,長榮航凱基9C購01,1.15,1.15,1.07,1.07,-0.08,-6.96,343000,30,382390,0,0,0,0,0,0,317000,24000,293000,293000
20200528,061841,晶技凱基9C購01,0.71,0.71,0.71,0.71,-0.04,-5.33,35000,2,24850,0,0,0,0,0,0,0,35000,-35000,-35000
20200528,061842,牧德凱基9C購01,,,,,0.00,0.00,0,0,0,0,0,0,0,0,0,0,0,0,0
20200528,061843,億豐凱基9C購01,1.22,1.22,1.18,1.19,0.00,0.00,115000,3,139750,0,0,0,0,0,0,0,115000,-115000,-115000
20200528,061844,T50反1國票9C購02,0.99,1.07,0.99,1.05,+0.04,3.96,230000,8,239100,0,0,0,0,0,0,145000,85000,60000,60000
20200528,061845,SP黃豆國票9B購02,,,,,0.00,0.00,0,0,0,0,0,0,0,0,0,0,0,0,0
20200528,061846,元金2X國票9C購01,2.34,2.38,2.34,2.38,+0.03,1.28,20000,2,47200,0,0,0,0,0,0,10000,10000,0,0
20200528,061847,力山國票9B購01,4.39,4.49,4.02,4.02,-0.30,-6.94,135000,11,588290,0,0,0,0,0,0,66000,69000,-3000,-3000
20200528,061848,國巨國票9B購07,2.04,2.04,2.04,2.04,+0.05,2.51,1000,1,2040,0,0,0,0,0,0,1000,0,1000,1000
20200528,061849,國巨國票9B購08,,,,,0.00,0.00,0,0,0,0,0,0,0,0,0,0,0,0,0
20200528,06184P,大立光元大97售06,2.69,2.69,2.69,2.69,-0.20,-6.92,5000,1,13450,0,0,0,0,0,0,5000,0,5000,5000
20200528,061850,國巨國票9C購02,,,,,0.00,0.00,0,0,0,0,0,0,0,0,0,0,0,0,0
20200528,061851,智邦國票9B購01,9.50,9.50,8.95,8.95,+1.10,14.01,2000,2,18450,0,0,0,0,0,0,0,2000,-2000,-2000
20200528,061852,大立光國票9B購02,2.17,2.17,2.17,2.17,+0.10,4.83,14000,2,30380,0,0,0,0,0,0,14000,0,14000,14000
20200528,061853,晶技國票9B購02,2.25,2.34,2.19,2.19,-0.24,-9.88,82000,13,185130,0,0,0,0,0,0,65000,17000,48000,48000
20200528,061854,祥碩國票9B購02,,,,,0.00,0.00,0,0,0,0,0,0,0,0,0,0,0,0,0
20200528,061855,台郡國票9B購01,2.51,2.51,2.42,2.42,-0.24,-9.02,88000,9,218630,0,0,0,0,0,0,35000,48000,-13000,-13000
20200528,061856,台郡國票9B購02,1.47,1.49,1.43,1.43,-0.02,-1.38,284000,13,413970,0,0,0,0,0,0,132000,152000,-20000,-20000
20200528,061857,康友國票9B購01,2.26,2.29,2.09,2.09,-0.16,-7.11,67000,6,151870,0,0,0,0,0,0,3000,67000,-64000,-64000
20200528,061858,南電國票9B購02,1.83,1.83,1.70,1.70,-0.25,-12.82,48000,5,85980,0,0,0,0,0,0,34000,14000,20000,20000
20200528,061859,勤誠國票9B購01,2.22,2.22,2.22,2.22,-0.16,-6.72,35000,1,77700,0,0,0,0,0,0,35000,0,35000,35000
20200528,06185P,台表科元大97售05,0.68,0.81,0.65,0.76,+0.02,2.7,493000,16,357770,0,0,0,0,0,0,214000,269000,-55000,-55000
20200528,061860,臺股指國票9B購04,4.02,4.04,3.59,3.66,-0.18,-4.69,35000,10,135000,0,0,0,0,0,0,8000,27000,-19000,-19000
20200528,061861,臺股指國票9B購05,,,,,0.00,0.00,0,0,0,0,0,0,0,0,0,0,0,0,0
20200528,061862,台灣50元大9C購35,,,,,0.00,0.00,0,0,0,0,0,0,0,0,0,0,0,0,0
20200528,061863,台灣50元大9C購36,,,,,0.00,0.00,0,0,0,0,0,0,0,0,0,0,0,0,0
20200528,061864,臺指反元大01購07,,,,,0.00,0.00,0,0,0,0,0,0,0,0,0,0,0,0,0
20200528,061865,力山元大9B購01,2.21,2.30,2.10,2.11,-0.05,-2.31,398000,28,882140,0,0,0,0,0,0,331000,70000,261000,261000
20200528,061866,力山元大9C購01,2.89,2.99,2.71,2.74,-0.06,-2.14,430000,29,1233000,0,0,0,0,0,0,363000,67000,296000,296000
20200528,061867,旺宏元大9B購02,1.66,1.69,1.55,1.55,-0.13,-7.74,219000,15,353070,0,0,0,0,0,0,89000,116000,-27000,-27000
20200528,061868,旺宏元大9B購03,2.65,2.71,2.51,2.51,-0.18,-6.69,168000,22,442900,0,0,0,0,0,0,144000,68000,76000,76000
20200528,061869,智邦元大9B購01,2.26,2.53,2.18,2.22,+0.12,5.71,333000,40,801410,0,0,0,0,0,0,107000,235000,-128000,-128000
20200528,06186P,鴻海統一97售02,,,,,0.00,0.00,0,0,0,0,0,0,0,0,0,0,0,0,0
20200528,061870,智邦元大9B購02,3.21,3.62,3.10,3.10,+0.12,4.03,272000,29,939730,0,0,0,0,0,0,102000,204000,-102000,-102000
20200528,061871,瑞昱元大9B購01,3.23,3.29,3.20,3.27,+0.19,6.17,147000,16,478550,0,0,0,0,0,0,64000,107000,-43000,-43000
20200528,061872,友達元大9C購06,1.76,1.79,1.74,1.79,+0.07,4.07,213000,9,375420,0,0,0,0,0,0,103000,110000,-7000,-7000
20200528,061873,友達元大9C購07,1.33,1.34,1.33,1.34,-0.04,-2.9,117000,3,156610,0,0,0,0,0,0,17000,100000,-83000,-83000
20200528,061874,義隆元大9B購02,2.89,2.95,2.78,2.78,+0.10,3.73,960000,58,2693380,0,0,0,0,0,0,907000,77000,830000,830000
20200528,061875,華新科元大9B購03,1.75,1.75,1.75,1.75,0.00,0.00,10000,1,17500,0,0,0,0,0,0,10000,0,10000,10000
20200528,061876,明泰元大9B購01,3.16,3.16,3.13,3.13,-0.03,-0.95,77000,13,243030,0,0,0,0,0,0,76000,1000,75000,75000
20200528,061877,貿聯元大9B購01,2.25,2.30,2.20,2.22,+0.01,0.45,292000,27,655940,0,0,0,0,0,0,174000,118000,56000,56000
20200528,061878,茂林元大9B購01,2.98,2.98,2.82,2.85,-0.02,-0.7,30000,4,86560,0,0,0,0,0,0,23000,7000,16000,16000
20200528,061879,超眾元大9C購01,1.64,1.68,1.59,1.63,+0.01,0.62,310000,23,511170,0,0,0,0,0,0,221000,170000,51000,51000
20200528,06187P,國巨統一97售05,2.36,2.53,2.36,2.53,0.00,0.00,120000,6,292210,0,0,0,0,0,0,0,120000,-120000,-120000
20200528,061880,台郡元大9B購02,1.74,1.76,1.69,1.71,-0.01,-0.58,230000,13,396600,0,0,0,0,0,0,177000,60000,117000,117000
20200528,061881,緯穎元大9B購02,5.00,5.05,5.00,5.05,-0.05,-0.98,10000,2,50200,0,0,0,0,0,0,10000,0,10000,10000
20200528,061882,矽創元大9B購01,2.25,2.49,2.21,2.29,+0.22,10.63,880000,70,2058340,0,0,0,0,0,0,227000,741000,-514000,-514000
20200528,061883,臺股指元大9B購15,,,,,0.00,0.00,0,0,0,0,0,0,0,0,0,0,0,0,0
20200528,061884,臺股指元大9B購18,2.18,2.18,2.05,2.05,-0.09,-4.21,13000,4,27010,0,0,0,0,0,0,0,13000,-13000,-13000
20200528,061885,臺股指元大9B購19,,,,,0.00,0.00,0,0,0,0,0,0,0,0,0,0,0,0,0
20200528,061886,力山國泰01購01,2.08,2.15,1.98,1.99,-0.09,-4.33,812000,69,1712860,0,0,0,0,0,0,594000,205000,389000,389000
20200528,061887,祥碩國泰9C購01,,,,,0.00,0.00,0,0,0,0,0,0,0,0,0,0,0,0,0
20200528,061888,元金2X富邦9C購01,,,,,0.00,0.00,0,0,0,0,0,0,0,0,0,0,0,0,0
20200528,061889,祥碩富邦9B購01,1.52,1.73,1.52,1.68,+0.19,12.75,114000,13,191240,0,0,0,0,0,0,12000,102000,-90000,-90000
20200528,06188P,大立光元富97售01,2.90,3.05,2.90,3.05,0.00,0.00,249000,9,729940,0,0,0,0,0,0,193000,56000,137000,137000
20200528,061890,元金2X永豐9B購01,,,,,0.00,0.00,0,0,0,0,0,0,0,0,0,0,0,0,0
20200528,061891,力山永豐9B購01,1.05,1.06,1.01,1.03,0.00,0.00,227000,13,234830,0,0,0,0,0,0,197000,30000,167000,167000
20200528,061892,亞德客永豐9B購01,1.00,1.02,0.86,0.86,-0.15,-14.85,70000,7,68640,0,0,0,0,0,0,70000,0,70000,70000
20200528,061893,鴻海永豐9B購01,1.08,1.08,1.08,1.08,0.00,0.00,5000,3,5400,0,0,0,0,0,0,5000,5000,0,0
20200528,061894,台積電永豐9B購01,,,,,0.00,0.00,0,0,0,0,0,0,0,0,0,0,0,0,0
20200528,061895,旺宏永豐9B購01,,,,,0.00,0.00,0,0,0,0,0,0,0,0,0,0,0,0,0
20200528,061896,景碩永豐9B購01,,,,,0.00,0.00,0,0,0,0,0,0,0,0,0,0,0,0,0
20200528,061897,泰碩永豐9B購01,0.55,0.55,0.55,0.55,0.00,0.00,10000,1,5500,0,0,0,0,0,0,10000,0,10000,10000
20200528,061898,茂林永豐9B購01,0.91,0.91,0.88,0.90,-0.25,-21.74,175000,11,156040,0,0,0,0,0,0,169000,6000,163000,163000
20200528,061899,復盛永豐9B購01,1.00,1.05,0.99,1.00,-0.02,-1.96,436000,15,443400,0,0,0,0,0,0,5000,431000,-426000,-426000
20200528,06189P,華新科永豐97售03,,,,,0.00,0.00,0,0,0,0,0,0,0,0,0,0,0,0,0
20200528,061900,志超永豐9B購01,0.99,1.04,0.98,1.01,+0.06,6.32,1181000,44,1193090,0,0,0,0,0,0,381000,790000,-409000,-409000
20200528,061901,柏文永豐9B購01,1.24,1.27,1.23,1.23,-0.05,-3.91,540000,17,672300,0,0,0,0,0,0,522000,18000,504000,504000
20200528,061902,百和永豐9B購01,0.85,0.86,0.80,0.80,-0.02,-2.44,90000,9,75490,0,0,0,0,0,0,75000,10000,65000,65000
20200528,061903,宏全永豐9B購01,0.87,0.87,0.85,0.85,-0.02,-2.3,234000,2,202220,0,0,0,0,0,0,68000,166000,-98000,-98000
20200528,061904,台灣50中信9B購01,,,,,0.00,0.00,0,0,0,0,0,0,0,0,0,0,0,0,0
20200528,061905,上証反中信03購01,,,,,0.00,0.00,0,0,0,0,0,0,0,0,0,0,0,0,0
20200528,061906,統一中信9B購01,0.93,0.93,0.90,0.90,-0.04,-4.26,16000,4,14760,0,0,0,0,0,0,3000,13000,-10000,-10000
20200528,061907,裕隆中信9B購01,1.43,1.52,1.41,1.41,0.00,0.00,320000,26,465560,0,0,0,0,0,0,22000,298000,-276000,-276000
20200528,061908,台積電中信05購01,0.85,0.85,0.82,0.82,-0.02,-2.38,65000,6,54050,0,0,0,0,0,0,8000,57000,-49000,-49000
20200528,061909,台積電中信05購02,,,,,0.00,0.00,0,0,0,0,0,0,0,0,0,0,0,0,0
20200528,06190P,玉晶光永豐97售05,,,,,0.00,0.00,0,0,0,0,0,0,0,0,0,0,0,0,0
20200528,061910,台積電中信05購03,1.04,1.04,1.03,1.03,-0.02,-1.9,32000,3,33250,0,0,0,0,0,0,32000,3000,29000,29000
20200528,061911,台積電中信05購04,1.14,1.14,1.14,1.14,-0.02,-1.72,3000,2,3420,0,0,0,0,0,0,3000,3000,0,0
20200528,061912,台積電中信05購05,1.28,1.28,1.23,1.23,-0.02,-1.6,167000,18,210640,0,0,0,0,0,0,153000,17000,136000,136000
20200528,061913,宏碁中信9B購01,,,,,0.00,0.00,0,0,0,0,0,0,0,0,0,0,0,0,0
20200528,061914,台光電中信9B購01,,,,,0.00,0.00,0,0,0,0,0,0,0,0,0,0,0,0,0
20200528,061915,T50反1凱基02購02,1.86,1.91,1.86,1.91,+0.02,1.06,1198000,9,2281980,0,0,0,0,0,0,983000,215000,768000,768000
20200528,061916,元金2X凱基02購01,,,,,0.00,0.00,0,0,0,0,0,0,0,0,0,0,0,0,0
20200528,061917,亞德客凱基9B購02,1.07,1.15,0.96,0.99,-0.06,-5.71,205000,34,223990,0,0,0,0,0,0,193000,24000,169000,169000
20200528,061918,上銀凱基9B購02,1.71,1.76,1.56,1.56,-0.13,-7.69,47000,13,79130,0,0,0,0,0,0,39000,8000,31000,31000
20200528,061919,國巨凱基9B購06,,,,,0.00,0.00,0,0,0,0,0,0,0,0,0,0,0,0,0
20200528,06191P,鴻海群益97售03,,,,,0.00,0.00,0,0,0,0,0,0,0,0,0,0,0,0,0
20200528,061920,台積電凱基9C購02,,,,,0.00,0.00,0,0,0,0,0,0,0,0,0,0,0,0,0
20200528,061921,旺宏凱基9B購03,,,,,0.00,0.00,0,0,0,0,0,0,0,0,0,0,0,0,0
20200528,061922,瑞昱凱基9B購01,1.29,1.29,1.29,1.29,0.00,0.00,20000,1,25800,0,0,0,0,0,0,0,20000,-20000,-20000
20200528,061923,友達凱基9B購04,1.07,1.11,1.07,1.10,+0.03,2.8,268000,8,293080,0,0,0,0,0,0,125000,143000,-18000,-18000
20200528,061924,聯發科凱基9C購01,1.44,1.46,1.44,1.46,-0.06,-3.95,22000,2,31720,0,0,0,0,0,0,20000,2000,18000,18000
20200528,061925,禾伸堂凱基9C購01,1.06,1.06,1.06,1.06,-0.01,-0.93,10000,1,10600,0,0,0,0,0,0,10000,0,10000,10000
20200528,061926,晶技凱基9B購02,0.98,1.01,0.98,1.01,-0.02,-1.94,3000,3,2980,0,0,0,0,0,0,1000,2000,-1000,-1000
20200528,061927,玉晶光凱基9C購01,1.31,1.34,1.31,1.34,0.00,0.00,120000,2,159600,0,0,0,0,0,0,0,120000,-120000,-120000
20200528,061928,群創凱基9B購06,0.91,0.91,0.91,0.91,-0.02,-2.15,10000,1,9100,0,0,0,0,0,0,0,10000,-10000,-10000
20200528,061929,嘉澤凱基9B購01,,,,,0.00,0.00,0,0,0,0,0,0,0,0,0,0,0,0,0
20200528,06192P,高股息中信98售01,,,,,0.00,0.00,0,0,0,0,0,0,0,0,0,0,0,0,0
20200528,061930,臺股指凱基9B購05,1.26,1.26,1.07,1.12,-0.08,-6.67,152000,4,167290,0,0,0,0,0,0,148000,4000,144000,144000
20200528,061931,力山國票9B購02,3.71,3.74,3.47,3.47,-0.22,-5.96,101000,13,364390,0,0,0,0,0,0,101000,0,101000,101000
20200528,061932,上銀國票9B購01,5.65,5.85,5.65,5.70,-0.20,-3.39,53000,18,301500,0,0,0,0,0,0,53000,0,53000,53000
20200528,061933,光寶科國票9B購01,,,,,0.00,0.00,0,0,0,0,0,0,0,0,0,0,0,0,0
20200528,061934,台積電國票9B購06,,,,,0.00,0.00,0,0,0,0,0,0,0,0,0,0,0,0,0
20200528,061935,台積電國票9B購07,1.21,1.21,1.21,1.21,-0.10,-7.63,10000,2,12100,0,0,0,0,0,0,0,10000,-10000,-10000
20200528,061936,旺宏國票9B購03,1.54,1.54,1.54,1.54,-0.08,-4.94,40000,6,61600,0,0,0,0,0,0,40000,0,40000,40000
20200528,061937,聯發科國票9B購02,2.74,2.74,2.48,2.54,-0.14,-5.22,45000,6,115180,0,0,0,0,0,0,28000,17000,11000,11000
20200528,061938,大立光國票9B購03,2.01,2.01,1.95,2.01,-0.09,-4.29,39000,4,77730,0,0,0,0,0,0,26000,13000,13000,13000
20200528,061939,中租國票9B購01,2.05,2.08,1.99,1.99,-0.05,-2.45,141000,5,288000,0,0,0,0,0,0,38000,103000,-65000,-65000
20200528,06193P,台積電元富97售04,,,,,0.00,0.00,0,0,0,0,0,0,0,0,0,0,0,0,0
20200528,061940,世紀鋼國票9C購01,3.54,4.46,3.53,4.16,+0.49,13.35,179000,29,719940,0,0,0,0,0,0,48000,131000,-83000,-83000
20200528,061941,道瓊指群益9B購01,,,,,0.00,0.00,0,0,0,0,0,0,0,0,0,0,0,0,0
20200528,061942,亞德客群益9B購01,3.44,3.52,3.02,3.11,-0.17,-5.18,531000,43,1788410,0,0,0,0,0,0,463000,61000,402000,402000
20200528,061943,上銀群益9B購02,2.60,2.69,2.45,2.45,-0.21,-7.89,232000,13,608110,0,0,0,0,0,0,232000,0,232000,232000
20200528,061944,聯電群益9B購01,0.62,0.65,0.62,0.64,+0.03,4.92,727000,10,467510,0,0,0,0,0,0,10000,717000,-707000,-707000
20200528,061945,華通群益9B購04,2.59,2.76,2.57,2.57,+0.27,11.74,140000,9,367260,0,0,0,0,0,0,50000,90000,-40000,-40000
20200528,061946,鴻海群益9B購03,1.91,1.91,1.85,1.86,-0.04,-2.11,35000,3,65180,0,0,0,0,0,0,35000,2000,33000,33000
20200528,061947,旺宏群益9B購02,1.82,1.89,1.68,1.68,-0.21,-11.11,958000,30,1767590,0,0,0,0,0,0,934000,24000,910000,910000
20200528,061948,美食群益9B購01,3.12,3.12,2.75,2.75,-0.33,-10.71,32000,6,96750,0,0,0,0,0,0,19000,27000,-8000,-8000
20200528,061949,大立光群益9B購03,0.76,0.76,0.76,0.76,-0.04,-5.0,118000,1,89680,0,0,0,0,0,0,118000,0,118000,118000
20200528,06194P,台積電元富97售05,1.43,1.43,1.43,1.43,0.00,0.00,109000,1,155870,0,0,0,0,0,0,109000,109000,0,0
20200528,061950,日月光群益9B購01,2.46,2.46,2.37,2.38,-0.07,-2.86,56000,4,134230,0,0,0,0,0,0,20000,36000,-16000,-16000
20200528,061951,南電群益9B購01,0.58,0.58,0.54,0.54,-0.03,-5.26,138000,4,79240,0,0,0,0,0,0,0,138000,-138000,-138000
20200528,061952,臺股指群益9B購01,1.96,1.96,1.82,1.83,-0.12,-6.15,13000,3,24020,0,0,0,0,0,0,8000,5000,3000,3000
20200528,061953,台積電台新9B購04,0.81,0.82,0.81,0.82,0.00,0.00,26000,4,21120,0,0,0,0,0,0,16000,10000,6000,6000
20200528,061954,元金2X統一9B購02,,,,,0.00,0.00,0,0,0,0,0,0,0,0,0,0,0,0,0
20200528,061955,FANG+統一9B購01,0.91,0.91,0.89,0.89,-0.06,-6.32,2000,2,1800,0,0,0,0,0,0,0,2000,-2000,-2000
20200528,061956,和大統一01購01,0.79,0.79,0.76,0.76,0.00,0.00,196000,3,154090,0,0,0,0,0,0,0,196000,-196000,-196000
20200528,061957,上銀統一01購01,1.27,1.31,1.15,1.16,-0.09,-7.2,914000,45,1085750,0,0,0,0,0,0,791000,103000,688000,688000
20200528,061958,鴻海統一01購01,1.67,1.68,1.62,1.62,-0.02,-1.22,15000,7,25060,0,0,0,0,0,0,15000,15000,0,0
20200528,061959,鴻海統一9B購04,1.73,1.73,1.65,1.65,-0.04,-2.37,14000,7,24060,0,0,0,0,0,0,14000,14000,0,0
20200528,06195P,台積電元富97售06,,,,,0.00,0.00,0,0,0,0,0,0,0,0,0,0,0,0,0
20200528,061960,國巨統一01購05,0.71,0.71,0.66,0.67,0.00,0.00,50000,5,34050,0,0,0,0,0,0,25000,25000,0,0
20200528,061961,台積電統一01購02,0.66,0.66,0.66,0.66,0.00,0.00,2000,1,1320,0,0,0,0,0,0,0,2000,-2000,-2000
20200528,061962,台積電統一01購03,1.41,1.41,1.35,1.35,-0.05,-3.57,26000,3,36420,0,0,0,0,0,0,26000,4000,22000,22000
20200528,061963,台積電統一01購04,1.71,1.71,1.63,1.64,-0.06,-3.53,186000,6,311880,0,0,0,0,0,0,104000,86000,18000,18000
20200528,061964,台積電統一01購05,1.31,1.31,1.31,1.31,-0.04,-2.96,4000,2,5240,0,0,0,0,0,0,4000,4000,0,0
20200528,061965,台積電統一02購02,1.08,1.08,1.08,1.08,0.00,0.00,10000,1,10800,0,0,0,0,0,0,10000,0,10000,10000
20200528,061966,旺宏統一01購03,0.95,0.95,0.94,0.95,+0.01,1.06,92000,30,87280,0,0,0,0,0,0,92000,0,92000,92000
20200528,061967,旺宏統一01購04,0.58,0.58,0.55,0.55,-0.03,-5.17,58000,3,32550,0,0,0,0,0,0,0,58000,-58000,-58000
20200528,061968,聯發科統一01購03,1.54,1.54,1.54,1.54,0.00,0.00,1000,1,1540,0,0,0,0,0,0,0,1000,-1000,-1000
20200528,061969,大立光統一01購02,0.60,0.60,0.58,0.59,-0.02,-3.28,109000,4,63310,0,0,0,0,0,0,0,109000,-109000,-109000
20200528,06196P,元上證元大97售01,,,,,0.00,0.00,0,0,0,0,0,0,0,0,0,0,0,0,0
20200528,061970,大立光統一9C購03,1.39,1.39,1.39,1.39,0.00,0.00,22000,1,30580,0,0,0,0,0,0,0,22000,-22000,-22000
20200528,061971,力山元大9C購02,2.75,2.78,2.60,2.60,-0.06,-2.26,335000,20,910970,0,0,0,0,0,0,231000,104000,127000,127000
20200528,061972,華新元大9B購01,2.45,2.69,2.20,2.20,-0.06,-2.65,1253000,91,3123410,0,0,0,0,0,0,946000,258000,688000,688000
20200528,061973,上銀元大9B購01,4.46,4.46,4.46,4.46,+0.01,0.22,2000,1,8920,0,0,0,0,0,0,2000,0,2000,2000
20200528,061974,光寶科元大9B購01,3.32,3.36,3.10,3.13,-0.19,-5.72,549000,46,1788110,0,0,0,0,0,0,445000,124000,321000,321000
20200528,061975,華通元大9B購01,3.78,4.09,3.78,3.82,+0.32,9.14,152000,26,597890,0,0,0,0,0,0,73000,111000,-38000,-38000
20200528,061976,國巨元大9B購01,1.86,1.86,1.80,1.80,-0.01,-0.55,20000,2,36600,0,0,0,0,0,0,0,20000,-20000,-20000
20200528,061977,國巨元大9B購02,2.58,2.58,2.56,2.56,-0.05,-1.92,20000,2,51400,0,0,0,0,0,0,20000,0,20000,20000
20200528,061978,旺宏元大9C購01,2.50,2.57,2.37,2.39,-0.20,-7.72,227000,24,566730,0,0,0,0,0,0,227000,34000,193000,193000
20200528,061979,友達元大9C購08,1.55,1.56,1.48,1.48,-0.10,-6.33,180000,4,275700,0,0,0,0,0,0,80000,100000,-20000,-20000
20200528,06197P,國巨元大97售08,,,,,0.00,0.00,0,0,0,0,0,0,0,0,0,0,0,0,0
20200528,061980,聯發科元大9B購01,4.74,4.78,4.30,4.45,-0.27,-5.72,63000,16,290510,0,0,0,0,0,0,42000,22000,20000,20000
20200528,061981,聯發科元大9B購02,3.95,3.98,3.95,3.97,+0.09,2.32,44000,7,174390,0,0,0,0,0,0,44000,0,44000,44000
20200528,061982,聯發科元大9B購03,4.92,4.95,4.92,4.93,+0.13,2.71,32000,5,157760,0,0,0,0,0,0,32000,1000,31000,31000
20200528,061983,華新科元大9B購04,2.16,2.18,2.15,2.18,-0.01,-0.46,39000,4,84500,0,0,0,0,0,0,39000,0,39000,39000
20200528,061984,華新科元大9B購05,1.66,1.67,1.57,1.57,-0.07,-4.27,90000,6,148890,0,0,0,0,0,0,85000,5000,80000,80000
20200528,061985,富邦金元大9B購01,2.82,2.82,2.63,2.63,-0.14,-5.05,84000,4,226600,0,0,0,0,0,0,16000,68000,-52000,-52000
20200528,061986,晶豪科元大9B購01,2.53,2.61,2.39,2.39,-0.06,-2.45,146000,8,372200,0,0,0,0,0,0,66000,80000,-14000,-14000
20200528,061987,大立光元大9B購03,2.28,2.28,2.28,2.28,-0.19,-7.69,33000,1,75240,0,0,0,0,0,0,0,33000,-33000,-33000
20200528,061988,大立光元大9B購04,2.59,2.59,2.41,2.41,-0.11,-4.37,84000,2,208740,0,0,0,0,0,0,35000,49000,-14000,-14000
20200528,061989,晶技元大9B購04,2.38,2.43,2.29,2.29,-0.15,-6.15,274000,22,646750,0,0,0,0,0,0,240000,34000,206000,206000
20200528,06198P,台積電元大98售06,2.19,2.19,2.19,2.19,0.00,0.00,80000,1,175200,0,0,0,0,0,0,80000,80000,0,0
20200528,061990,台勝科元大9C購01,2.01,2.01,1.89,1.89,-0.15,-7.35,100000,4,193200,0,0,0,0,0,0,35000,65000,-30000,-30000
20200528,061991,牧德元大9C購01,2.41,2.41,2.25,2.25,-0.10,-4.26,141000,6,325670,0,0,0,0,0,0,77000,64000,13000,13000
20200528,061992,祥碩元大9B購02,5.70,5.95,5.65,5.65,+0.25,4.63,24000,3,136550,0,0,0,0,0,0,2000,24000,-22000,-22000
20200528,061993,祥碩元大9C購01,4.40,4.40,4.40,4.40,+0.17,4.02,15000,1,66000,0,0,0,0,0,0,0,15000,-15000,-15000
20200528,061994,瑞儀元大9B購01,2.72,2.76,2.72,2.72,-0.01,-0.37,38000,5,104080,0,0,0,0,0,0,13000,25000,-12000,-12000
20200528,061995,超眾元大01購01,2.88,2.97,2.88,2.97,-0.16,-5.11,83000,6,245320,0,0,0,0,0,0,13000,70000,-57000,-57000
20200528,061996,矽格元大9B購01,1.50,1.50,1.40,1.40,-0.07,-4.76,146000,5,216020,0,0,0,0,0,0,146000,11000,135000,135000
20200528,061997,台郡元大9B購03,2.20,2.23,2.14,2.14,-0.07,-3.17,173000,11,378620,0,0,0,0,0,0,131000,59000,72000,72000
20200528,061998,緯穎元大9B購03,5.05,5.10,5.05,5.10,-0.05,-0.97,10000,2,50750,0,0,0,0,0,0,10000,0,10000,10000
20200528,061999,臺股指元大9B購23,,,,,0.00,0.00,0,0,0,0,0,0,0,0,0,0,0,0,0
20200528,06199P,聯發科元大97售17,,,,,0.00,0.00,0,0,0,0,0,0,0,0,0,0,0,0,0
20200528,062000,臺股指元大9B購24,,,,,0.00,0.00,0,0,0,0,0,0,0,0,0,0,0,0,0
20200528,062001,臺股指元大9B購25,,,,,0.00,0.00,0,0,0,0,0,0,0,0,0,0,0,0,0
20200528,062002,鴻海國泰01購01,1.40,1.41,1.38,1.38,-0.02,-1.43,191000,10,267490,0,0,0,0,0,0,180000,20000,160000,160000
20200528,062003,國巨國泰01購01,1.78,1.80,1.66,1.66,-0.06,-3.49,792000,15,1367070,30000,0,30000,0,0,0,742000,50000,692000,722000
20200528,062004,國巨國泰9C購03,1.93,1.95,1.83,1.83,-0.04,-2.14,110000,8,210300,0,0,0,0,0,0,73000,75000,-2000,-2000
20200528,062005,旺宏國泰01購01,1.16,1.18,1.16,1.17,-0.03,-2.5,377000,41,441780,0,0,0,0,0,0,377000,0,377000,377000
20200528,062006,瑞昱國泰9C購01,,,,,0.00,0.00,0,0,0,0,0,0,0,0,0,0,0,0,0
20200528,062007,台光電國泰9C購01,2.23,2.24,2.03,2.03,-0.18,-8.14,66000,4,138190,0,0,0,0,0,0,60000,6000,54000,54000
20200528,062008,南亞科國泰9C購01,1.42,1.45,1.30,1.30,-0.01,-0.76,1157000,33,1621840,0,0,0,0,0,0,553000,508000,45000,45000
20200528,062009,聯發科國泰01購01,2.53,2.53,2.39,2.39,-0.05,-2.05,30000,3,75000,0,0,0,0,0,0,25000,5000,20000,20000
20200528,06200P,聯發科元大97售18,,,,,0.00,0.00,0,0,0,0,0,0,0,0,0,0,0,0,0
20200528,062010,台灣50富邦9B購03,,,,,0.00,0.00,0,0,0,0,0,0,0,0,0,0,0,0,0
20200528,062011,上銀富邦9C購01,1.33,1.35,1.27,1.27,-0.03,-2.31,95000,25,125310,0,0,0,0,0,0,65000,30000,35000,35000
20200528,062012,燿華富邦9C購01,1.03,1.05,1.03,1.05,+0.02,1.94,54000,2,55700,0,0,0,0,0,0,50000,4000,46000,46000
20200528,062013,奇鋐富邦9B購01,0.49,0.51,0.47,0.47,+0.04,9.3,109000,7,53690,0,0,0,0,0,0,2000,107000,-105000,-105000
20200528,062014,牧德富邦9C購01,,,,,0.00,0.00,0,0,0,0,0,0,0,0,0,0,0,0,0
20200528,062015,喬山永豐9B購01,1.10,1.11,0.99,0.99,-0.14,-12.39,165000,11,173190,0,0,0,0,0,0,165000,0,165000,165000
20200528,062016,美食永豐9B購01,1.18,1.18,1.10,1.10,-0.09,-7.56,142000,9,166170,0,0,0,0,0,0,125000,17000,108000,108000
20200528,062017,京鼎永豐9B購01,0.90,0.90,0.84,0.84,-0.03,-3.45,248000,15,216720,0,0,0,0,0,0,0,248000,-248000,-248000
20200528,062018,台勝科永豐9B購01,0.82,0.82,0.82,0.82,-0.04,-4.65,1000,1,820,0,0,0,0,0,0,1000,0,1000,1000
20200528,062019,嘉澤永豐9B購01,1.64,1.65,1.60,1.60,-0.04,-2.44,29000,3,47250,0,0,0,0,0,0,20000,9000,11000,11000
20200528,06201P,可成元大97售01,1.34,1.34,1.34,1.34,0.00,0.00,1000,1,1340,0,0,0,0,0,0,0,1000,-1000,-1000
20200528,062020,智伸科永豐9B購01,0.97,0.97,0.87,0.87,-0.09,-9.38,465000,22,415220,0,0,0,0,0,0,443000,2000,441000,441000
20200528,062021,康控永豐9B購01,0.57,0.57,0.55,0.55,-0.03,-5.17,87000,2,49550,0,0,0,0,0,0,2000,85000,-83000,-83000
20200528,062022,緯穎永豐9B購01,1.34,1.34,1.34,1.34,-0.03,-2.19,1000,1,1340,0,0,0,0,0,0,0,1000,-1000,-1000
20200528,062023,寶成永豐9B購01,1.09,1.11,1.07,1.08,-0.12,-10.0,34000,7,36870,0,0,0,0,0,0,21000,13000,8000,8000
20200528,062024,臺股指中信9C購05,1.18,1.19,1.18,1.19,-0.05,-4.03,103000,2,122540,0,0,0,0,0,0,0,103000,-103000,-103000
20200528,062025,台達電群益9B購01,1.71,1.71,1.68,1.68,-0.13,-7.18,95000,2,160440,0,0,0,0,0,0,95000,0,95000,95000
20200528,062026,華邦電群益9B購01,1.55,1.66,1.27,1.27,-0.09,-6.62,387000,23,549720,0,0,0,0,0,0,327000,0,327000,327000
20200528,062027,國泰金群益9B購01,1.81,1.81,1.68,1.68,-0.12,-6.67,145000,5,256310,0,0,0,0,0,0,27000,118000,-91000,-91000
20200528,062028,晶技群益9B購01,1.57,1.58,1.54,1.57,-0.08,-4.85,125000,8,194050,0,0,0,0,0,0,125000,0,125000,125000
20200528,062029,牧德群益9B購03,,,,,0.00,0.00,0,0,0,0,0,0,0,0,0,0,0,0,0
20200528,06202P,大立光元大98售06,3.98,3.98,3.98,3.98,0.00,0.00,180000,1,716400,0,0,0,0,0,0,180000,180000,0,0
20200528,062030,旭富群益9B購01,2.67,2.67,2.67,2.67,0.00,0.00,20000,1,53400,0,0,0,0,0,0,20000,0,20000,20000
20200528,062031,臻鼎群益9B購01,2.06,2.06,1.95,1.95,-0.11,-5.34,114000,4,233680,0,0,0,0,0,0,0,114000,-114000,-114000
20200528,062032,崇越群益9B購01,1.80,1.80,1.74,1.74,0.00,0.00,141000,4,251100,0,0,0,0,0,0,0,71000,-71000,-71000
20200528,062033,瀚宇博群益9B購01,1.52,1.56,1.51,1.52,+0.06,4.11,719000,22,1099920,0,0,0,0,0,0,321000,398000,-77000,-77000
20200528,062034,同欣電群益9B購01,2.18,2.21,2.10,2.12,-0.04,-1.85,306000,16,665290,0,0,0,0,0,0,231000,75000,156000,156000
20200528,062035,瑞祺群益9B購01,1.67,1.82,1.62,1.62,-0.05,-2.99,1194000,37,2063550,0,0,0,0,0,0,553000,626000,-73000,-73000
20200528,062036,致新群益9B購01,2.08,2.32,2.08,2.30,+0.18,8.49,1311000,41,2944340,0,0,0,0,0,0,509000,773000,-264000,-264000
20200528,062037,華新凱基9B購01,1.90,2.04,1.65,1.65,+0.06,3.77,168000,30,322050,0,0,0,0,0,0,126000,42000,84000,84000
20200528,062038,鴻海凱基9B購05,,,,,0.00,0.00,0,0,0,0,0,0,0,0,0,0,0,0,0
20200528,062039,聯發科凱基9B購07,2.00,2.00,1.87,1.89,-0.08,-4.06,301000,15,576200,0,0,0,0,0,0,281000,20000,261000,261000
20200528,06203P,奇力新中信98售02,,,,,0.00,0.00,0,0,0,0,0,0,0,0,0,0,0,0,0
20200528,062040,玉晶光凱基01購01,1.46,1.46,1.46,1.46,+0.09,6.57,118000,1,172280,0,0,0,0,0,0,0,118000,-118000,-118000
20200528,062041,華擎凱基9C購01,,,,,0.00,0.00,0,0,0,0,0,0,0,0,0,0,0,0,0
20200528,062042,台勝科凱基9C購01,1.07,1.07,0.98,1.00,-0.05,-4.76,171000,5,175600,0,0,0,0,0,0,90000,81000,9000,9000
20200528,062043,牧德凱基9B購04,,,,,0.00,0.00,0,0,0,0,0,0,0,0,0,0,0,0,0
20200528,062044,健策凱基9B購02,2.15,2.23,2.03,2.03,-0.14,-6.45,95000,16,207390,0,0,0,0,0,0,75000,20000,55000,55000
20200528,062045,崇越凱基9B購01,0.94,0.94,0.92,0.92,-0.06,-6.12,98000,2,91520,0,0,0,0,0,0,30000,68000,-38000,-38000
20200528,062046,矽格凱基9B購01,1.02,1.04,0.97,1.00,-0.02,-1.96,636000,11,640690,0,0,0,0,0,0,521000,115000,406000,406000
20200528,062047,緯穎凱基9B購01,4.93,4.93,4.93,4.93,-0.27,-5.19,6000,1,29580,0,0,0,0,0,0,0,6000,-6000,-6000
20200528,062048,義隆台新9B購01,1.13,1.20,1.12,1.20,+0.12,11.11,80000,5,91700,0,0,0,0,0,0,20000,60000,-40000,-40000
20200528,062049,亞德客統一01購01,0.79,0.84,0.72,0.75,-0.03,-3.85,1390000,66,1061250,0,0,0,0,0,0,708000,682000,26000,26000
20200528,06204P,鴻海群益97售04,,,,,0.00,0.00,0,0,0,0,0,0,0,0,0,0,0,0,0
20200528,062050,亞德客統一9C購01,0.99,1.06,0.91,0.91,-0.05,-5.21,462000,56,465670,0,0,0,0,0,0,211000,257000,-46000,-46000
20200528,062051,上銀統一9C購02,1.41,1.41,1.34,1.34,-0.04,-2.9,360000,13,486440,0,0,0,0,0,0,360000,0,360000,360000
20200528,062052,華通統一01購01,1.04,1.14,1.04,1.06,+0.07,7.07,881000,27,982050,0,0,0,0,0,0,474000,416000,58000,58000
20200528,062053,華通統一9C購02,1.09,1.19,1.08,1.10,+0.07,6.8,190000,15,211690,0,0,0,0,0,0,117000,94000,23000,23000
20200528,062054,鴻海統一9C購06,,,,,0.00,0.00,0,0,0,0,0,0,0,0,0,0,0,0,0
20200528,062055,鴻海統一9C購07,,,,,0.00,0.00,0,0,0,0,0,0,0,0,0,0,0,0,0
20200528,062056,國巨統一9C購08,,,,,0.00,0.00,0,0,0,0,0,0,0,0,0,0,0,0,0
20200528,062057,華邦電統一01購01,1.00,1.04,0.87,0.89,-0.02,-2.2,791000,56,794810,0,0,0,0,0,0,507000,261000,246000,246000
20200528,062058,瑞昱統一01購01,0.87,0.87,0.86,0.87,+0.05,6.1,237000,7,205490,0,0,0,0,0,0,17000,220000,-203000,-203000
20200528,062059,聯發科統一9C購06,,,,,0.00,0.00,0,0,0,0,0,0,0,0,0,0,0,0,0
20200528,06205P,台積電群益97售03,1.51,1.51,1.51,1.51,0.00,0.00,10000,1,15100,0,0,0,0,0,0,10000,10000,0,0
20200528,062060,奇鋐統一9C購01,0.69,0.77,0.69,0.72,+0.04,5.88,742000,22,547780,0,0,0,0,0,0,84000,658000,-574000,-574000
20200528,062061,台勝科統一01購01,0.81,0.82,0.80,0.80,-0.01,-1.23,217000,6,176720,0,0,0,0,0,0,117000,100000,17000,17000
20200528,062062,貿聯統一01購01,0.86,0.87,0.82,0.83,-0.02,-2.35,1380000,41,1181190,0,0,0,0,0,0,754000,622000,132000,132000
20200528,062063,世紀鋼統一9C購01,0.83,1.02,0.82,0.95,+0.09,10.47,1019000,43,935010,0,0,0,0,0,0,518000,501000,17000,17000
20200528,062064,台灣50元大9B購13,,,,,0.00,0.00,0,0,0,0,0,0,0,0,0,0,0,0,0
20200528,062065,台灣50元大9B購14,,,,,0.00,0.00,0,0,0,0,0,0,0,0,0,0,0,0,0
20200528,062066,元黃金元大9B購01,0.54,0.54,0.54,0.54,+0.02,3.85,1000,1,540,0,0,0,0,0,0,0,1000,-1000,-1000
20200528,062067,滬深2X元大9B購01,,,,,0.00,0.00,0,0,0,0,0,0,0,0,0,0,0,0,0
20200528,062068,滬深2X元大9B購02,1.04,1.05,1.03,1.05,+0.05,5.0,50000,4,52000,0,0,0,0,0,0,20000,30000,-10000,-10000
20200528,062069,喬山元大9B購01,2.32,2.38,2.01,2.01,-0.23,-10.27,606000,39,1344200,0,0,0,0,0,0,488000,115000,373000,373000
20200528,06206P,台積電凱基97售11,,,,,0.00,0.00,0,0,0,0,0,0,0,0,0,0,0,0,0
20200528,062070,金寶元大9B購01,0.90,0.94,0.86,0.86,-0.02,-2.27,556000,13,508240,0,0,0,0,0,0,60000,466000,-406000,-406000
20200528,062071,華通元大9B購02,3.63,3.83,3.56,3.56,+0.23,6.91,89000,14,330420,0,0,0,0,0,0,25000,69000,-44000,-44000
20200528,062072,國巨元大9B購05,2.46,2.46,2.46,2.46,+0.05,2.07,12000,1,29520,0,0,0,0,0,0,12000,0,12000,12000
20200528,062073,國巨元大9B購06,2.70,2.70,2.70,2.70,-0.07,-2.53,1000,1,2700,0,0,0,0,0,0,1000,1000,0,0
20200528,062074,旺宏元大9B購04,2.42,2.46,2.41,2.41,-0.10,-3.98,86000,6,208660,0,0,0,0,0,0,85000,1000,84000,84000
20200528,062075,智邦元大9B購03,3.58,3.86,3.35,3.37,+0.14,4.33,211000,25,784470,0,0,0,0,0,0,75000,171000,-96000,-96000
20200528,062076,美律元大9B購02,2.56,2.60,2.44,2.44,+0.01,0.41,70000,4,177200,0,0,0,0,0,0,0,70000,-70000,-70000
20200528,062077,聯發科元大9B購04,6.05,6.05,5.85,5.90,-0.25,-4.07,44000,5,261200,0,0,0,0,0,0,7000,37000,-30000,-30000
20200528,062078,聯發科元大9B購05,,,,,0.00,0.00,0,0,0,0,0,0,0,0,0,0,0,0,0
20200528,062079,聯發科元大9B購06,4.97,4.97,4.97,4.97,0.00,0.00,1000,1,4970,0,0,0,0,0,0,1000,0,1000,1000
20200528,06207P,聯發科凱基97售07,4.12,4.12,4.12,4.12,0.00,0.00,10000,1,41200,0,0,0,0,0,0,0,10000,-10000,-10000
20200528,062080,奇力新元大9B購02,2.05,2.05,2.03,2.03,-0.14,-6.45,95000,2,194210,0,0,0,0,0,0,68000,27000,41000,41000
20200528,062081,華新科元大9B購06,1.58,1.58,1.58,1.58,-0.02,-1.25,10000,1,15800,0,0,0,0,0,0,10000,0,10000,10000
20200528,062082,嘉晶元大9B購01,,,,,0.00,0.00,0,0,0,0,0,0,0,0,0,0,0,0,0
20200528,062083,健策元大9C購03,3.00,3.00,2.67,2.67,-0.11,-3.96,258000,21,739140,0,0,0,0,0,0,158000,182000,-24000,-24000
20200528,062084,台郡元大9B購04,1.67,1.70,1.63,1.63,-0.05,-2.98,226000,8,377260,0,0,0,0,0,0,75000,176000,-101000,-101000
20200528,062085,同欣電元大9B購01,2.59,2.59,2.44,2.47,-0.06,-2.37,201000,20,506260,0,0,0,0,0,0,179000,26000,153000,153000
20200528,062086,瑞祺元大9B購01,1.83,1.95,1.77,1.78,-0.03,-1.66,484000,25,897050,0,0,0,0,0,0,216000,268000,-52000,-52000
20200528,062087,瑞祺元大9B購02,1.63,1.73,1.56,1.57,-0.04,-2.48,2657000,83,4310320,0,0,0,0,0,0,2080000,480000,1600000,1600000
20200528,062088,緯穎元大9B購04,5.00,5.00,4.67,4.67,-0.20,-4.11,52000,10,257070,0,0,0,0,0,0,52000,5000,47000,47000
20200528,062089,矽創元大9B購02,3.05,3.38,3.03,3.11,+0.35,12.68,514000,33,1662340,0,0,0,0,0,0,232000,427000,-195000,-195000
20200528,06208P,台郡凱基97售03,0.97,0.97,0.97,0.97,0.00,0.00,50000,1,48500,0,0,0,0,0,0,0,50000,-50000,-50000
20200528,062090,南電元大9B購02,1.74,1.74,1.64,1.64,-0.05,-2.96,110000,3,184140,0,0,0,0,0,0,67000,43000,24000,24000
20200528,062091,世紀鋼元大9B購01,2.46,3.03,2.40,2.80,+0.35,14.29,747000,62,1998200,0,0,0,0,0,0,501000,492000,9000,9000
20200528,062092,臺指反富邦9C購02,,,,,0.00,0.00,0,0,0,0,0,0,0,0,0,0,0,0,0
20200528,062093,台積電富邦9C購11,0.46,0.46,0.46,0.46,0.00,0.00,100000,1,46000,0,0,0,0,0,0,0,100000,-100000,-100000
20200528,062094,台積電富邦9C購12,,,,,0.00,0.00,0,0,0,0,0,0,0,0,0,0,0,0,0
20200528,062095,旺宏富邦9C購03,0.51,0.51,0.51,0.51,+0.04,8.51,10000,1,5100,0,0,0,0,0,0,10000,0,10000,10000
20200528,062096,神隆永豐9B購01,0.74,0.74,0.70,0.70,-0.03,-4.11,260000,4,187700,0,0,0,0,0,0,110000,150000,-40000,-40000
20200528,062097,台光電永豐9B購01,1.19,1.19,1.12,1.12,-0.07,-5.88,23000,2,26670,0,0,0,0,0,0,10000,13000,-3000,-3000
20200528,062098,億光永豐9B購01,,,,,0.00,0.00,0,0,0,0,0,0,0,0,0,0,0,0,0
20200528,062099,牧德永豐9B購01,0.90,0.90,0.88,0.88,-0.13,-12.87,15000,2,13400,0,0,0,0,0,0,5000,15000,-10000,-10000
20200528,06209P,旺宏統一97售07,1.85,2.03,1.85,2.03,0.00,0.00,29000,2,57430,0,0,0,0,0,0,0,29000,-29000,-29000
20200528,062100,矽格永豐9B購01,0.85,0.85,0.85,0.85,0.00,0.00,5000,1,4250,0,0,0,0,0,0,0,5000,-5000,-5000
20200528,062101,T50反1國票01購01,,,,,0.00,0.00,0,0,0,0,0,0,0,0,0,0,0,0,0
20200528,062102,T50反1國票9B購07,,,,,0.00,0.00,0,0,0,0,0,0,0,0,0,0,0,0,0
20200528,062103,T50反1國票9B購08,,,,,0.00,0.00,0,0,0,0,0,0,0,0,0,0,0,0,0
20200528,062104,上証2X國票9B購03,,,,,0.00,0.00,0,0,0,0,0,0,0,0,0,0,0,0,0
20200528,062105,國巨國票9C購03,,,,,0.00,0.00,0,0,0,0,0,0,0,0,0,0,0,0,0
20200528,062106,華邦電國票9B購02,1.41,1.47,1.12,1.12,-0.18,-13.85,330000,38,452460,0,0,0,0,0,0,199000,131000,68000,68000
20200528,062107,台光電國票9B購01,3.25,3.27,2.87,2.87,-0.35,-10.87,103000,11,329040,0,0,0,0,0,0,35000,68000,-33000,-33000
20200528,062108,晶豪科國票9B購01,1.32,1.34,1.23,1.23,-0.05,-3.91,125000,5,161680,0,0,0,0,0,0,61000,125000,-64000,-64000
20200528,062109,聯詠國票9C購01,2.90,2.90,2.85,2.87,-0.03,-1.03,68000,4,194390,0,0,0,0,0,0,46000,68000,-22000,-22000
20200528,06210P,元油反元大97售01,,,,,0.00,0.00,0,0,0,0,0,0,0,0,0,0,0,0,0
20200528,062110,華擎國票9B購01,2.81,2.85,2.70,2.70,-0.02,-0.74,824000,4,2286760,0,0,0,0,0,0,816000,8000,808000,808000
20200528,062111,台勝科國票9B購01,2.52,2.65,2.52,2.63,+0.06,2.33,18000,3,46610,0,0,0,0,0,0,9000,9000,0,0
20200528,062112,祥碩國票9C購01,4.86,5.40,4.86,5.40,-0.15,-2.7,33000,6,171300,0,0,0,0,0,0,4000,29000,-25000,-25000
20200528,062113,瑞祺國票9B購01,2.73,2.89,2.67,2.72,-0.16,-5.56,137000,8,373900,0,0,0,0,0,0,128000,9000,119000,119000
20200528,062114,GIS國票9C購01,2.31,2.31,2.24,2.24,-0.07,-3.03,3000,2,6790,0,0,0,0,0,0,0,3000,-3000,-3000
20200528,062115,臺股指國票9B購09,,,,,0.00,0.00,0,0,0,0,0,0,0,0,0,0,0,0,0
20200528,062116,元金2X第一9B購01,0.51,0.53,0.51,0.53,+0.03,6.0,256000,7,133050,0,0,0,0,0,0,43000,213000,-170000,-170000
20200528,062117,燿華中信9B購01,0.68,0.68,0.68,0.68,-0.04,-5.56,30000,1,20400,0,0,0,0,0,0,30000,0,30000,30000
20200528,062118,華新科中信9B購02,0.61,0.61,0.61,0.61,-0.02,-3.17,92000,1,56120,0,0,0,0,0,0,92000,92000,0,0
20200528,062119,世紀鋼中信9B購01,0.73,0.80,0.73,0.78,0.00,0.00,200000,14,152170,0,0,0,0,0,0,0,200000,-200000,-200000
20200528,06211P,鴻海元大98售04,,,,,0.00,0.00,0,0,0,0,0,0,0,0,0,0,0,0,0
20200528,062120,國巨台新9B購01,,,,,0.00,0.00,0,0,0,0,0,0,0,0,0,0,0,0,0
20200528,062121,奇鋐台新9B購01,1.31,1.32,1.31,1.31,0.00,0.00,84000,5,110640,0,0,0,0,0,0,0,84000,-84000,-84000
20200528,062122,國巨統一02購01,0.86,0.86,0.86,0.86,+0.02,2.38,10000,1,8600,0,0,0,0,0,0,10000,0,10000,10000
20200528,062123,台積電統一9B購13,,,,,0.00,0.00,0,0,0,0,0,0,0,0,0,0,0,0,0
20200528,062124,大立光統一9B購09,0.66,0.66,0.66,0.66,-0.03,-4.35,9000,2,5940,0,0,0,0,0,0,0,9000,-9000,-9000
20200528,062125,嘉晶統一9B購01,1.93,1.93,1.83,1.83,-0.13,-6.63,23000,3,42990,0,0,0,0,0,0,0,23000,-23000,-23000
20200528,062126,創意統一9B購01,0.71,0.75,0.70,0.70,+0.01,1.45,1770000,51,1270380,0,0,0,0,0,0,195000,1570000,-1375000,-1375000
20200528,062127,台勝科統一01購02,0.62,0.62,0.58,0.58,-0.04,-6.45,105000,5,63300,0,0,0,0,0,0,65000,40000,25000,25000
20200528,062128,祥碩統一01購01,1.56,1.71,1.53,1.67,+0.09,5.7,46000,6,75180,0,0,0,0,0,0,11000,29000,-18000,-18000
20200528,062129,世紀鋼統一02購01,0.67,0.74,0.67,0.70,+0.07,11.11,221000,11,155500,0,0,0,0,0,0,176000,45000,131000,131000
20200528,06212P,華新科元大97售11,2.04,2.12,2.04,2.12,+0.06,2.91,52000,2,106240,0,0,0,0,0,0,0,52000,-52000,-52000
20200528,062130,T50反1群益9B購01,,,,,0.00,0.00,0,0,0,0,0,0,0,0,0,0,0,0,0
20200528,062131,臺指反群益9B購03,,,,,0.00,0.00,0,0,0,0,0,0,0,0,0,0,0,0,0
20200528,062132,神隆群益9B購01,1.56,1.61,1.56,1.56,-0.07,-4.29,191000,3,301660,0,0,0,0,0,0,98000,93000,5000,5000
20200528,062133,大成鋼群益9B購01,1.54,1.76,1.54,1.76,+0.28,18.92,223000,22,372980,0,0,0,0,0,0,19000,204000,-185000,-185000
20200528,062134,國巨群益9B購04,1.70,1.70,1.61,1.61,0.00,0.00,5000,2,8320,0,0,0,0,0,0,0,5000,-5000,-5000
20200528,062135,國巨群益9B購05,1.26,1.28,1.18,1.21,-0.08,-6.2,75000,18,91330,0,0,0,0,0,0,37000,38000,-1000,-1000
20200528,062136,南亞科群益9B購01,1.72,1.76,1.71,1.71,+0.07,4.27,150000,9,260500,0,0,0,0,0,0,135000,0,135000,135000
20200528,062137,華新科群益9B購04,,,,,0.00,0.00,0,0,0,0,0,0,0,0,0,0,0,0,0
20200528,062138,力成群益9B購01,1.55,1.57,1.47,1.47,-0.09,-5.77,127000,6,188710,0,0,0,0,0,0,127000,0,127000,127000
20200528,062139,臺指反國票9C購02,0.91,0.91,0.91,0.91,0.00,0.00,45000,1,40950,0,0,0,0,0,0,45000,0,45000,45000
20200528,06213P,大立光元大98售07,,,,,0.00,0.00,0,0,0,0,0,0,0,0,0,0,0,0,0
20200528,062140,元金2X國票9B購03,2.36,2.41,2.36,2.41,+0.04,1.69,40000,4,95900,0,0,0,0,0,0,30000,10000,20000,20000
20200528,062141,遠東新國票9B購01,,,,,0.00,0.00,0,0,0,0,0,0,0,0,0,0,0,0,0
20200528,062142,喬山國票9B購01,3.23,3.23,2.77,2.77,-0.35,-11.22,291000,15,915730,0,0,0,0,0,0,241000,50000,191000,191000
20200528,062143,大成鋼國票9B購01,1.46,1.67,1.41,1.54,+0.09,6.21,517000,13,804260,0,0,0,0,0,0,231000,286000,-55000,-55000
20200528,062144,華通國票9B購01,4.26,4.57,4.19,4.19,+0.54,14.79,73000,5,322400,0,0,0,0,0,0,0,73000,-73000,-73000
20200528,062145,億光國票9B購01,1.62,1.62,1.62,1.62,-0.08,-4.71,15000,1,24300,0,0,0,0,0,0,0,15000,-15000,-15000
20200528,062146,大毅國票9B購01,5.30,5.30,5.00,5.10,-0.15,-2.86,15000,3,78800,0,0,0,0,0,0,15000,1000,14000,14000
20200528,062147,大毅國票9B購02,3.13,3.17,3.04,3.13,-0.09,-2.8,138000,6,428320,0,0,0,0,0,0,119000,19000,100000,100000
20200528,062148,奇鋐國票9B購01,2.10,2.40,2.10,2.37,+0.21,9.72,154000,13,353460,0,0,0,0,0,0,46000,108000,-62000,-62000
20200528,062149,牧德國票9B購01,6.05,6.05,6.05,6.05,-0.95,-13.57,26000,1,157300,0,0,0,0,0,0,26000,26000,0,0
20200528,06214P,國巨國票98售04,3.72,3.72,3.69,3.69,-0.07,-1.86,30000,2,111300,0,0,0,0,0,0,0,30000,-30000,-30000
20200528,062150,南六國票9B購01,3.96,4.08,3.93,4.08,-0.16,-3.77,60000,11,238110,0,0,0,0,0,0,60000,0,60000,60000
20200528,062151,世紀鋼國票01購01,1.67,1.77,1.67,1.70,+0.26,18.06,56000,5,94050,0,0,0,0,0,0,0,56000,-56000,-56000
20200528,062152,國巨麥證9C購01,,,,,0.00,0.00,0,0,0,0,0,0,0,0,0,0,0,0,0
20200528,062153,智邦麥證9B購01,1.45,1.58,1.32,1.38,0.00,0.00,124000,12,176160,61000,63000,-2000,0,0,0,61000,63000,-2000,-2000
20200528,062154,國巨凱基9C購02,,,,,0.00,0.00,0,0,0,0,0,0,0,0,0,0,0,0,0
20200528,062155,國巨凱基9C購03,0.85,0.86,0.81,0.81,-0.03,-3.57,40000,4,34180,0,0,0,0,0,0,7000,33000,-26000,-26000
20200528,062156,美律凱基9B購01,,,,,0.00,0.00,0,0,0,0,0,0,0,0,0,0,0,0,0
20200528,062157,聯發科凱基9B購08,4.87,4.87,4.56,4.56,-0.28,-5.79,140000,13,663770,0,0,0,0,0,0,140000,20000,120000,120000
20200528,062158,禾伸堂凱基9B購01,0.53,0.53,0.53,0.53,-0.03,-5.36,68000,1,36040,0,0,0,0,0,0,0,68000,-68000,-68000
20200528,062159,聯詠凱基9B購01,1.79,1.79,1.77,1.77,-0.03,-1.67,55000,2,97410,0,0,0,0,0,0,55000,0,55000,55000
20200528,06215P,康控永豐97售02,,,,,0.00,0.00,0,0,0,0,0,0,0,0,0,0,0,0,0
20200528,062160,南六凱基9B購01,0.99,1.03,0.96,0.96,-0.02,-2.04,24000,4,23490,0,0,0,0,0,0,15000,9000,6000,6000
20200528,062161,南六凱基9C購01,1.46,1.46,1.46,1.46,+0.03,2.1,68000,1,99280,0,0,0,0,0,0,68000,0,68000,68000
20200528,062162,世紀鋼凱基9B購03,1.02,1.27,1.02,1.26,+0.21,20.0,200000,26,235380,0,0,0,0,0,0,9000,191000,-182000,-182000
20200528,062163,大毅國泰01購01,1.47,1.48,1.44,1.45,-0.03,-2.03,281000,13,411600,0,0,0,0,0,0,247000,54000,193000,193000
20200528,062164,禾伸堂國泰01購01,0.99,0.99,0.99,0.99,+0.02,2.06,123000,4,121770,0,0,0,0,0,0,0,123000,-123000,-123000
20200528,062165,聯茂國泰01購01,1.13,1.22,1.12,1.19,+0.07,6.25,1277000,60,1479630,0,0,0,0,0,0,658000,623000,35000,35000
20200528,062166,致新國泰01購01,2.24,2.30,2.22,2.28,+0.13,6.05,218000,16,492750,0,0,0,0,0,0,3000,218000,-215000,-215000
20200528,062167,燿華永豐9B購01,0.73,0.73,0.73,0.73,+0.03,4.29,7000,1,5110,0,0,0,0,0,0,7000,0,7000,7000
20200528,062168,大毅永豐9B購01,,,,,0.00,0.00,0,0,0,0,0,0,0,0,0,0,0,0,0
20200528,062169,禾伸堂永豐9B購01,0.53,0.53,0.53,0.53,-0.01,-1.85,67000,1,35510,0,0,0,0,0,0,67000,0,67000,67000
20200528,06216P,上銀元富97售03,0.74,0.91,0.69,0.91,+0.11,13.75,95000,16,75530,0,0,0,0,0,0,67000,28000,39000,39000
20200528,062170,健策永豐9B購04,1.30,1.30,1.16,1.16,-0.13,-10.08,90000,20,114120,0,0,0,0,0,0,80000,10000,70000,70000
20200528,062171,中磊永豐9B購01,0.81,0.81,0.81,0.81,0.00,0.00,75000,1,60750,0,0,0,0,0,0,0,75000,-75000,-75000
20200528,062172,南六永豐9B購01,0.77,0.77,0.75,0.76,-0.01,-1.3,20000,12,15220,0,0,0,0,0,0,20000,0,20000,20000
20200528,062173,世紀鋼永豐9B購01,0.77,0.91,0.76,0.85,0.00,0.00,328000,19,278460,0,0,0,0,0,0,0,328000,-328000,-328000
20200528,062174,T50反1元大9B購03,,,,,0.00,0.00,0,0,0,0,0,0,0,0,0,0,0,0,0
20200528,062175,臺指反元大02購02,,,,,0.00,0.00,0,0,0,0,0,0,0,0,0,0,0,0,0
20200528,062176,元金2X元大9B購01,1.25,1.27,1.25,1.27,+0.05,4.1,26000,3,32900,0,0,0,0,0,0,0,26000,-26000,-26000
20200528,062177,上銀元大9B購02,4.54,4.54,4.54,4.54,-0.06,-1.3,1000,1,4540,0,0,0,0,0,0,1000,0,1000,1000
20200528,062178,上銀元大9B購03,4.62,4.62,4.18,4.18,-0.30,-6.7,22000,3,93090,0,0,0,0,0,0,17000,5000,12000,12000
20200528,062179,旺宏元大9B購05,1.94,1.98,1.93,1.94,-0.02,-1.02,76000,8,148440,0,0,0,0,0,0,60000,16000,44000,44000
20200528,06217P,鴻海元富97售05,,,,,0.00,0.00,0,0,0,0,0,0,0,0,0,0,0,0,0
20200528,062180,瑞昱元大9B購03,3.38,3.42,3.32,3.38,+0.14,4.32,149000,16,505640,0,0,0,0,0,0,54000,115000,-61000,-61000
20200528,062181,義隆元大9B購03,2.62,2.67,2.52,2.52,+0.11,4.56,197000,36,505500,0,0,0,0,0,0,166000,57000,109000,109000
20200528,062182,華新科元大9B購07,,,,,0.00,0.00,0,0,0,0,0,0,0,0,0,0,0,0,0
20200528,062183,奇鋐元大9B購01,1.27,1.37,1.27,1.29,0.00,0.00,219000,7,288110,0,0,0,0,0,0,0,219000,-219000,-219000
20200528,062184,奇鋐元大9B購02,1.99,2.21,1.99,2.06,+0.17,8.99,387000,15,811420,0,0,0,0,0,0,118000,319000,-201000,-201000
20200528,062185,禾伸堂元大9B購01,1.41,1.41,1.39,1.39,-0.07,-4.79,123000,5,173270,0,0,0,0,0,0,64000,81000,-17000,-17000
20200528,062186,晶技元大9B購05,2.57,2.60,2.53,2.60,-0.04,-1.52,276000,23,706260,0,0,0,0,0,0,230000,46000,184000,184000
20200528,062187,台勝科元大9B購02,,,,,0.00,0.00,0,0,0,0,0,0,0,0,0,0,0,0,0
20200528,062188,貿聯元大9B購02,3.28,3.38,3.28,3.38,+0.11,3.36,364000,23,1209000,0,0,0,0,0,0,239000,125000,114000,114000
20200528,062189,康控元大9B購02,1.81,1.81,1.79,1.79,+0.03,1.7,69000,2,124830,0,0,0,0,0,0,3000,69000,-66000,-66000
20200528,06218P,鴻海元富97售06,,,,,0.00,0.00,0,0,0,0,0,0,0,0,0,0,0,0,0
20200528,062190,瀚宇博元大9B購01,2.15,2.17,2.12,2.14,+0.01,0.47,230000,14,490350,0,0,0,0,0,0,178000,66000,112000,112000
20200528,062191,台郡元大9B購05,3.11,3.16,3.02,3.02,-0.11,-3.51,148000,10,459610,0,0,0,0,0,0,73000,98000,-25000,-25000
20200528,062192,南六元大9B購01,3.17,3.17,3.07,3.17,-0.01,-0.31,32000,4,100440,0,0,0,0,0,0,32000,0,32000,32000
20200528,062193,瑞昱第一9B購01,0.98,1.00,0.98,0.99,+0.03,3.12,164000,11,163150,0,0,0,0,0,0,46000,159000,-113000,-113000
20200528,062194,遠東新中信9C購01,0.99,0.99,0.96,0.96,-0.05,-4.95,127000,5,125560,0,0,0,0,0,0,117000,10000,107000,107000
20200528,062195,聚陽中信9C購01,2.11,2.11,2.01,2.01,-0.18,-8.22,142000,8,297120,0,0,0,0,0,0,122000,20000,102000,102000
20200528,062196,聯發科中信01購02,1.14,1.14,1.11,1.11,-0.06,-5.13,90000,3,101100,0,0,0,0,0,0,50000,40000,10000,10000
20200528,062197,聯發科中信01購03,,,,,0.00,0.00,0,0,0,0,0,0,0,0,0,0,0,0,0
20200528,062198,臺指反國票01購01,0.76,0.76,0.76,0.76,-0.01,-1.3,25000,1,19000,0,0,0,0,0,0,25000,0,25000,25000
20200528,062199,臺指反國票02購02,,,,,0.00,0.00,0,0,0,0,0,0,0,0,0,0,0,0,0
20200528,06219P,國巨元富97售05,,,,,0.00,0.00,0,0,0,0,0,0,0,0,0,0,0,0,0
20200528,062200,臺指反國票03購01,1.21,1.29,1.21,1.29,+0.05,4.03,222000,4,285000,0,0,0,0,0,0,0,222000,-222000,-222000
20200528,062201,臺指反國票9B購05,,,,,0.00,0.00,0,0,0,0,0,0,0,0,0,0,0,0,0
20200528,062202,國巨國票9C購04,,,,,0.00,0.00,0,0,0,0,0,0,0,0,0,0,0,0,0
20200528,062203,燿華國票9C購01,1.54,1.56,1.47,1.47,-0.07,-4.55,270000,8,409000,0,0,0,0,0,0,178000,92000,86000,86000
20200528,062204,京元電國票9C購01,1.30,1.30,1.23,1.23,-0.08,-6.11,35000,5,44610,0,0,0,0,0,0,19000,16000,3000,3000
20200528,062205,奇力新國票9C購01,1.13,1.13,1.13,1.13,-0.02,-1.74,43000,1,48590,0,0,0,0,0,0,43000,0,43000,43000
20200528,062206,緯創國票9B購01,,,,,0.00,0.00,0,0,0,0,0,0,0,0,0,0,0,0,0
20200528,062207,牧德國票9B購02,0.95,0.95,0.94,0.94,-0.12,-11.32,20000,2,18810,0,0,0,0,0,0,20000,0,20000,20000
20200528,062208,旭富國票9C購01,1.60,1.60,1.58,1.58,-0.05,-3.07,20000,2,31800,0,0,0,0,0,0,0,20000,-20000,-20000
20200528,062209,台積電台新9B購05,0.91,0.91,0.91,0.91,-0.02,-2.15,1000,1,910,0,0,0,0,0,0,1000,0,1000,1000
20200528,06220P,廣宇元富97售02,,,,,0.00,0.00,0,0,0,0,0,0,0,0,0,0,0,0,0
20200528,062210,聯發科台新9B購01,2.28,2.28,2.28,2.28,+0.04,1.79,27000,1,61560,0,0,0,0,0,0,27000,0,27000,27000
20200528,062211,玉晶光台新9B購01,1.59,1.59,1.51,1.51,+0.02,1.34,32000,2,50720,0,0,0,0,0,0,0,32000,-32000,-32000
20200528,062212,臻鼎台新9B購01,1.23,1.23,1.13,1.13,-0.07,-5.83,63000,7,75170,0,0,0,0,0,0,53000,25000,28000,28000
20200528,062213,和大統一9B購02,0.93,0.95,0.88,0.88,-0.03,-3.3,138000,3,127730,0,0,0,0,0,0,0,138000,-138000,-138000
20200528,062214,金寶統一01購01,0.64,0.67,0.63,0.63,-0.01,-1.56,957000,12,620140,0,0,0,0,0,0,504000,453000,51000,51000
20200528,062215,華通統一9B購01,1.21,1.34,1.20,1.22,+0.09,7.96,1013000,33,1275510,0,0,0,0,0,0,807000,214000,593000,593000
20200528,062216,國巨統一9B購11,,,,,0.00,0.00,0,0,0,0,0,0,0,0,0,0,0,0,0
20200528,062217,旺宏統一9C購01,,,,,0.00,0.00,0,0,0,0,0,0,0,0,0,0,0,0,0
20200528,062218,燿華統一01購01,0.69,0.69,0.67,0.67,-0.02,-2.9,45000,6,30650,0,0,0,0,0,0,20000,25000,-5000,-5000
20200528,062219,燿華統一9B購01,0.80,0.80,0.76,0.76,-0.02,-2.56,40000,3,31600,0,0,0,0,0,0,40000,0,40000,40000
20200528,062220,台光電統一01購01,0.96,0.97,0.88,0.89,-0.07,-7.29,856000,36,787040,0,0,0,0,0,0,492000,349000,143000,143000
20200528,062221,奇力新統一01購01,0.54,0.54,0.52,0.52,-0.02,-3.7,40000,3,21300,0,0,0,0,0,0,0,40000,-40000,-40000
20200528,062222,華新科統一9B購04,0.70,0.72,0.70,0.72,0.00,0.00,22000,16,15540,0,0,0,0,0,0,22000,0,22000,22000
20200528,062223,大立光統一9C購04,,,,,0.00,0.00,0,0,0,0,0,0,0,0,0,0,0,0,0
20200528,062224,玉晶光統一9C購03,0.94,0.95,0.94,0.95,0.00,0.00,20000,2,18900,0,0,0,0,0,0,0,20000,-20000,-20000
20200528,062225,華擎統一01購01,1.18,1.24,1.16,1.16,-0.01,-0.85,121000,6,147060,0,0,0,0,0,0,3000,118000,-115000,-115000
20200528,062226,臻鼎統一9B購01,0.87,0.87,0.87,0.87,-0.07,-7.45,20000,2,17400,0,0,0,0,0,0,0,20000,-20000,-20000
20200528,062227,南六統一01購02,0.66,0.66,0.66,0.66,+0.01,1.54,5000,1,3300,0,0,0,0,0,0,0,5000,-5000,-5000
20200528,062228,南六統一02購01,0.61,0.61,0.58,0.58,-0.01,-1.69,377000,6,222210,0,0,0,0,0,0,140000,237000,-97000,-97000
20200528,062229,南六統一9B購01,0.68,0.68,0.67,0.68,+0.01,1.49,50000,10,33960,0,0,0,0,0,0,20000,30000,-10000,-10000
20200528,06222P,致茂元富97售02,,,,,0.00,0.00,0,0,0,0,0,0,0,0,0,0,0,0,0
20200528,062230,緯穎統一01購01,1.04,1.07,0.97,0.97,-0.06,-5.83,1273000,25,1290940,0,0,0,0,0,0,1000000,366000,634000,634000
20200528,062231,台光電麥證9C購01,1.67,1.67,1.61,1.61,-0.09,-5.29,37000,3,60390,27000,10000,17000,0,0,0,27000,10000,17000,17000
20200528,062232,聯詠麥證9C購01,1.32,1.32,1.32,1.32,-0.04,-2.94,15000,2,19800,0,15000,-15000,0,0,0,0,15000,-15000,-15000
20200528,062233,神隆凱基9B購01,1.23,1.23,1.23,1.23,-0.08,-6.11,4000,1,4920,0,0,0,0,0,0,4000,0,4000,4000
20200528,062234,廣達凱基9B購01,1.47,1.49,1.43,1.48,+0.04,2.78,553000,33,809880,0,0,0,0,0,0,415000,138000,277000,277000
20200528,062235,億光凱基9B購01,1.24,1.24,1.16,1.16,-0.08,-6.45,111000,4,134760,0,0,0,0,0,0,0,111000,-111000,-111000
20200528,062236,信邦凱基9B購01,1.07,1.12,1.07,1.11,+0.03,2.78,173000,6,190810,0,0,0,0,0,0,73000,100000,-27000,-27000
20200528,062237,緯創凱基9B購01,1.94,1.95,1.91,1.94,+0.09,4.86,30000,6,58100,0,0,0,0,0,0,30000,12000,18000,18000
20200528,062238,臻鼎凱基9C購01,1.19,1.19,1.15,1.15,-0.06,-4.96,21000,6,24310,0,0,0,0,0,0,6000,15000,-9000,-9000
20200528,062239,台汽電凱基9B購01,1.90,1.90,1.89,1.89,0.00,0.00,51000,2,96590,0,0,0,0,0,0,51000,31000,20000,20000
20200528,06223P,漢唐元富97售02,,,,,0.00,0.00,0,0,0,0,0,0,0,0,0,0,0,0,0
20200528,062240,上証2X元大9B購01,,,,,0.00,0.00,0,0,0,0,0,0,0,0,0,0,0,0,0
20200528,062241,滬深2X元大9B購03,,,,,0.00,0.00,0,0,0,0,0,0,0,0,0,0,0,0,0
20200528,062242,臺指反元大02購03,1.16,1.16,1.16,1.16,0.00,0.00,20000,1,23200,0,0,0,0,0,0,0,20000,-20000,-20000
20200528,062243,臺指反元大02購04,,,,,0.00,0.00,0,0,0,0,0,0,0,0,0,0,0,0,0
20200528,062244,臺指反元大02購05,,,,,0.00,0.00,0,0,0,0,0,0,0,0,0,0,0,0,0
20200528,062245,臺指反元大02購06,,,,,0.00,0.00,0,0,0,0,0,0,0,0,0,0,0,0,0
20200528,062246,力山元大9B購02,2.49,2.55,2.43,2.48,+0.05,2.06,408000,34,1015440,0,0,0,0,0,0,348000,108000,240000,240000
20200528,062247,國巨元大9B購07,2.33,2.33,2.28,2.28,-0.02,-0.87,55000,2,127900,0,0,0,0,0,0,50000,5000,45000,45000
20200528,062248,國巨元大9B購08,2.33,2.33,2.33,2.33,0.00,0.00,29000,1,67570,0,0,0,0,0,0,0,29000,-29000,-29000
20200528,062249,台積電元大9B購01,2.83,2.83,2.83,2.83,+0.02,0.71,45000,1,127350,0,0,0,0,0,0,0,45000,-45000,-45000
20200528,06224P,可成元富97售02,,,,,0.00,0.00,0,0,0,0,0,0,0,0,0,0,0,0,0
20200528,062250,台積電元大9B購02,2.99,2.99,2.93,2.93,-0.04,-1.35,73000,2,216590,0,0,0,0,0,0,28000,45000,-17000,-17000
20200528,062251,旺宏元大9B購06,2.30,2.34,2.30,2.30,-0.09,-3.77,36000,5,83700,0,0,0,0,0,0,36000,0,36000,36000
20200528,062252,華邦電元大9C購01,3.59,3.74,3.13,3.16,-0.07,-2.17,569000,47,2010160,0,0,0,0,0,0,352000,294000,58000,58000
20200528,062253,燿華元大9B購02,2.57,2.57,2.52,2.57,+0.06,2.39,104000,6,263180,0,0,0,0,0,0,47000,57000,-10000,-10000
20200528,062254,台光電元大9B購02,4.01,4.01,3.82,3.82,-0.13,-3.29,45000,3,177100,0,0,0,0,0,0,15000,30000,-15000,-15000
20200528,062255,聯發科元大9B購07,4.06,4.09,3.85,3.85,-0.18,-4.47,92000,8,366780,0,0,0,0,0,0,92000,1000,91000,91000
20200528,062256,聯發科元大9B購08,,,,,0.00,0.00,0,0,0,0,0,0,0,0,0,0,0,0,0
20200528,062257,聯發科元大9B購09,4.91,4.94,4.55,4.55,-0.31,-6.38,92000,8,441470,0,0,0,0,0,0,92000,1000,91000,91000
20200528,062258,奇力新元大9B購03,,,,,0.00,0.00,0,0,0,0,0,0,0,0,0,0,0,0,0
20200528,062259,可成元大9B購03,2.28,2.28,2.20,2.20,-0.06,-2.65,42000,2,94160,0,0,0,0,0,0,22000,20000,2000,2000
20200528,06225P,華新科元富97售04,,,,,0.00,0.00,0,0,0,0,0,0,0,0,0,0,0,0,0
20200528,062260,華新科元大9B購09,,,,,0.00,0.00,0,0,0,0,0,0,0,0,0,0,0,0,0
20200528,062261,嘉晶元大9B購02,7.10,7.10,6.80,6.80,-0.35,-4.9,98000,6,674850,0,0,0,0,0,0,47000,51000,-4000,-4000
20200528,062262,茂林元大9B購02,3.23,3.23,3.23,3.23,-0.58,-15.22,20000,2,64600,0,0,0,0,0,0,20000,0,20000,20000
20200528,062263,康控元大9B購03,1.87,1.87,1.83,1.83,-0.05,-2.66,78000,5,145400,0,0,0,0,0,0,3000,78000,-75000,-75000
20200528,062264,南六元大9B購02,1.53,1.53,1.51,1.51,0.00,0.00,98000,2,148580,0,0,0,0,0,0,30000,68000,-38000,-38000
20200528,062265,南茂元大9B購01,1.49,1.49,1.33,1.33,-0.17,-11.33,447000,17,648460,0,0,0,0,0,0,267000,180000,87000,87000
20200528,062266,世紀鋼元大9B購02,1.94,2.37,1.88,2.23,+0.31,16.15,682000,41,1452030,0,0,0,0,0,0,240000,464000,-224000,-224000
20200528,062267,滬深2X群益01購05,,,,,0.00,0.00,0,0,0,0,0,0,0,0,0,0,0,0,0
20200528,062268,力山群益9B購01,2.79,2.93,2.74,2.93,+0.19,6.93,215000,14,601830,0,0,0,0,0,0,173000,42000,131000,131000
20200528,062269,葡萄王群益9B購01,1.51,1.51,1.51,1.51,-0.14,-8.48,2000,1,3020,0,0,0,0,0,0,0,2000,-2000,-2000
20200528,06226P,聯發科麥證97售03,,,,,0.00,0.00,0,0,0,0,0,0,0,0,0,0,0,0,0
20200528,062270,上銀群益9B購03,2.57,2.63,2.39,2.39,-0.17,-6.64,240000,15,594880,0,0,0,0,0,0,223000,17000,206000,206000
20200528,062271,華通群益9C購02,2.45,2.70,2.45,2.55,+0.19,8.05,80000,4,203040,0,0,0,0,0,0,54000,26000,28000,28000
20200528,062272,鴻海群益9B購05,2.29,2.31,2.29,2.31,-0.04,-1.7,145000,6,332250,0,0,0,0,0,0,137000,15000,122000,122000
20200528,062273,國巨群益9C購02,1.63,1.63,1.58,1.58,+0.03,1.94,429000,4,692480,0,0,0,0,0,0,65000,364000,-299000,-299000
20200528,062274,台積電群益9B購04,1.01,1.01,0.95,0.95,-0.05,-5.0,21000,3,20570,0,0,0,0,0,0,11000,10000,1000,1000
20200528,062275,燿華群益9B購01,1.35,1.39,1.30,1.31,-0.07,-5.07,252000,5,332550,0,0,0,0,0,0,154000,103000,51000,51000
20200528,062276,瑞昱群益9B購01,3.51,3.56,3.51,3.51,+0.18,5.41,155000,5,549820,0,0,0,0,0,0,15000,140000,-125000,-125000
20200528,062277,廣達群益9B購01,2.54,2.54,2.44,2.51,-0.02,-0.79,620000,18,1529550,0,0,0,0,0,0,397000,223000,174000,174000
20200528,062278,聯發科群益9C購01,3.59,3.61,3.37,3.37,-0.20,-5.6,157000,12,556080,0,0,0,0,0,0,129000,28000,101000,101000
20200528,062279,晶豪科群益9B購01,2.71,2.80,2.71,2.76,+0.14,5.34,244000,5,675980,0,0,0,0,0,0,144000,100000,44000,44000
20200528,06227P,大立光群益97售04,,,,,0.00,0.00,0,0,0,0,0,0,0,0,0,0,0,0,0
20200528,062280,大立光群益9C購01,1.86,1.86,1.86,1.86,0.00,0.00,64000,1,119040,0,0,0,0,0,0,0,64000,-64000,-64000
20200528,062281,奇鋐群益9B購01,2.31,2.53,2.31,2.42,0.00,0.00,427000,11,1012530,0,0,0,0,0,0,199000,427000,-228000,-228000
20200528,062282,禾伸堂群益9B購01,,,,,0.00,0.00,0,0,0,0,0,0,0,0,0,0,0,0,0
20200528,062283,玉晶光群益01購01,3.30,3.49,3.27,3.27,+0.03,0.93,42000,10,139070,0,0,0,0,0,0,38000,11000,27000,27000
20200528,062284,華擎群益9C購03,,,,,0.00,0.00,0,0,0,0,0,0,0,0,0,0,0,0,0
20200528,062285,台勝科群益9B購01,2.57,2.57,2.37,2.37,-0.25,-9.54,26000,3,63920,0,0,0,0,0,0,26000,0,26000,26000
20200528,062286,台郡群益9B購01,1.60,1.60,1.57,1.57,-0.02,-1.26,5000,2,7940,0,0,0,0,0,0,0,5000,-5000,-5000
20200528,062287,康友群益9B購02,,,,,0.00,0.00,0,0,0,0,0,0,0,0,0,0,0,0,0
20200528,062288,南六群益9B購01,,,,,0.00,0.00,0,0,0,0,0,0,0,0,0,0,0,0,0
20200528,062289,緯穎群益9B購01,4.33,4.33,3.92,3.92,-0.59,-13.08,41000,4,172930,1000,0,1000,0,0,0,40000,11000,29000,30000
20200528,06228P,亞德客凱基97售04,,,,,0.00,0.00,0,0,0,0,0,0,0,0,0,0,0,0,0
20200528,062290,聯發科富邦9C購04,1.34,1.34,1.34,1.34,-0.09,-6.29,50000,1,67000,0,0,0,0,0,0,50000,0,50000,50000
20200528,062291,力成富邦9B購01,0.61,0.63,0.60,0.61,+0.01,1.67,290000,15,176270,0,0,0,0,0,0,287000,3000,284000,284000
20200528,062292,旭富永豐9B購01,0.67,0.67,0.67,0.67,-0.02,-2.9,235000,3,157450,0,0,0,0,0,0,215000,20000,195000,195000
20200528,062293,麗豐永豐9B購01,0.86,0.86,0.84,0.84,-0.01,-1.18,76000,5,64960,0,0,0,0,0,0,10000,66000,-56000,-56000
20200528,062294,盛群永豐9B購01,,,,,0.00,0.00,0,0,0,0,0,0,0,0,0,0,0,0,0
20200528,062295,康友永豐9B購01,0.56,0.56,0.52,0.52,0.00,0.00,195000,5,104850,0,0,0,0,0,0,165000,30000,135000,135000
20200528,062296,南六永豐9B購02,0.65,0.65,0.65,0.65,+0.06,10.17,6000,1,3900,0,0,0,0,0,0,0,6000,-6000,-6000
20200528,062297,億豐永豐9B購01,1.09,1.09,1.05,1.05,-0.01,-0.94,170000,4,184900,0,0,0,0,0,0,0,170000,-170000,-170000
20200528,062298,國巨第一9B購01,0.65,0.65,0.65,0.65,0.00,0.00,2000,1,1300,0,0,0,0,0,0,0,2000,-2000,-2000
20200528,062299,台積電第一9B購01,,,,,0.00,0.00,0,0,0,0,0,0,0,0,0,0,0,0,0
20200528,06229P,欣興凱基97售07,,,,,0.00,0.00,0,0,0,0,0,0,0,0,0,0,0,0,0
20200528,062300,T50反1中信03購02,,,,,0.00,0.00,0,0,0,0,0,0,0,0,0,0,0,0,0
20200528,062301,聯詠中信05購01,1.21,1.21,1.21,1.21,-0.02,-1.63,10000,1,12100,0,0,0,0,0,0,10000,0,10000,10000
20200528,062302,聯詠中信05購02,1.35,1.35,1.35,1.35,-0.02,-1.46,11000,1,14850,0,0,0,0,0,0,0,11000,-11000,-11000
20200528,062303,台表科中信01購01,1.27,1.27,1.23,1.24,-0.02,-1.59,131000,6,165230,0,0,0,0,0,0,100000,31000,69000,69000
20200528,062304,臺指反凱基9B購01,,,,,0.00,0.00,0,0,0,0,0,0,0,0,0,0,0,0,0
20200528,062305,遠東新凱基9B購01,1.36,1.36,1.33,1.33,-0.03,-2.21,87000,7,117610,0,0,0,0,0,0,0,87000,-87000,-87000
20200528,062306,華通凱基9B購01,3.23,3.57,3.23,3.57,+0.44,14.06,181000,13,631700,0,0,0,0,0,0,14000,171000,-157000,-157000
20200528,062307,華通凱基9C購01,1.70,1.79,1.70,1.79,+0.24,15.48,114000,10,202820,0,0,0,0,0,0,2000,114000,-112000,-112000
20200528,062308,旺宏凱基9B購04,2.57,2.62,2.45,2.45,-0.19,-7.2,105000,18,269110,0,0,0,0,0,0,105000,17000,88000,88000
20200528,062309,燿華凱基9B購01,2.89,2.89,2.89,2.89,+0.04,1.4,35000,1,101150,0,0,0,0,0,0,35000,0,35000,35000
20200528,06230P,亞德客永豐97售03,0.38,0.47,0.38,0.46,-0.01,-2.13,211000,5,92480,0,0,0,0,0,0,0,211000,-211000,-211000
20200528,062310,南亞科凱基9B購02,2.76,2.81,2.71,2.71,+0.16,6.27,33000,5,91330,0,0,0,0,0,0,10000,23000,-13000,-13000
20200528,062311,奇力新凱基9B購01,,,,,0.00,0.00,0,0,0,0,0,0,0,0,0,0,0,0,0
20200528,062312,大立光凱基9B購03,,,,,0.00,0.00,0,0,0,0,0,0,0,0,0,0,0,0,0
20200528,062313,聯詠凱基9C購01,2.07,2.07,2.04,2.04,-0.13,-5.99,78000,3,161160,0,0,0,0,0,0,0,78000,-78000,-78000
20200528,062314,玉晶光凱基9B購06,2.81,3.02,2.81,3.02,+0.34,12.69,62000,16,177810,0,0,0,0,0,0,52000,24000,28000,28000
20200528,062315,健策凱基9C購01,3.82,3.92,3.43,3.50,-0.16,-4.37,254000,27,938970,0,0,0,0,0,0,224000,99000,125000,125000
20200528,062316,康控凱基9B購03,,,,,0.00,0.00,0,0,0,0,0,0,0,0,0,0,0,0,0
20200528,062317,祥碩凱基9B購03,6.05,6.85,6.05,6.70,+0.15,2.29,43000,6,273400,0,0,0,0,0,0,37000,28000,9000,9000
20200528,062318,台郡凱基9B購01,1.91,1.91,1.91,1.91,+0.04,2.14,20000,1,38200,0,0,0,0,0,0,20000,0,20000,20000
20200528,062319,南六凱基9B購02,2.13,2.21,2.13,2.14,-0.02,-0.93,92000,7,201600,0,0,0,0,0,0,57000,35000,22000,22000
20200528,06231P,台積電永豐97售05,0.78,0.78,0.78,0.78,0.00,0.00,143000,1,111540,0,0,0,0,0,0,143000,143000,0,0
20200528,062320,南電凱基9B購03,1.58,1.58,1.58,1.58,-0.05,-3.07,22000,1,34760,0,0,0,0,0,0,0,22000,-22000,-22000
20200528,062321,力成台新9B購01,0.90,0.95,0.85,0.85,-0.05,-5.56,463000,23,412060,0,0,0,0,0,0,316000,147000,169000,169000
20200528,062322,元金2X統一01購01,1.54,1.54,1.54,1.54,-0.01,-0.65,12000,2,18480,0,0,0,0,0,0,0,12000,-12000,-12000
20200528,062323,上銀統一9B購03,1.63,1.70,1.43,1.43,-0.15,-9.49,312000,27,494520,0,0,0,0,0,0,265000,46000,219000,219000
20200528,062324,上銀統一9B購04,1.42,1.45,1.26,1.26,-0.19,-13.1,111000,20,156960,0,0,0,0,0,0,89000,22000,67000,67000
20200528,062325,鴻海統一9B購05,0.99,0.99,0.99,0.99,+0.03,3.12,30000,2,29700,0,0,0,0,0,0,0,30000,-30000,-30000
20200528,062326,國巨統一9C購09,,,,,0.00,0.00,0,0,0,0,0,0,0,0,0,0,0,0,0
20200528,062327,燿華統一9B購02,,,,,0.00,0.00,0,0,0,0,0,0,0,0,0,0,0,0,0
20200528,062328,南亞科統一9C購01,1.65,1.69,1.52,1.53,0.00,0.00,309000,7,495370,0,0,0,0,0,0,53000,276000,-223000,-223000
20200528,062329,奇力新統一9C購03,,,,,0.00,0.00,0,0,0,0,0,0,0,0,0,0,0,0,0
20200528,06232P,智易永豐97售01,0.86,0.86,0.86,0.86,0.00,0.00,52000,1,44720,0,0,0,0,0,0,0,52000,-52000,-52000
20200528,062330,可成統一9B購03,0.56,0.56,0.54,0.54,-0.02,-3.57,205000,2,114700,0,0,0,0,0,0,200000,5000,195000,195000
20200528,062331,大立光統一9B購10,,,,,0.00,0.00,0,0,0,0,0,0,0,0,0,0,0,0,0
20200528,062332,大立光統一9B購11,,,,,0.00,0.00,0,0,0,0,0,0,0,0,0,0,0,0,0
20200528,062333,嘉晶統一9C購01,1.91,1.95,1.81,1.82,-0.14,-7.14,159000,19,297380,0,0,0,0,0,0,40000,119000,-79000,-79000
20200528,062334,健策統一9B購02,1.67,1.67,1.45,1.45,-0.11,-7.05,216000,23,338900,0,0,0,0,0,0,197000,106000,91000,91000
20200528,062335,茂林統一01購01,0.69,0.69,0.65,0.65,-0.05,-7.14,64000,21,43690,0,0,0,0,0,0,62000,2000,60000,60000
20200528,062336,茂林統一01購02,0.85,0.85,0.80,0.80,-0.03,-3.61,198000,29,165890,0,0,0,0,0,0,191000,6000,185000,185000
20200528,062337,台表科統一01購01,1.03,1.06,0.97,1.00,-0.04,-3.85,572000,29,580930,0,0,0,0,0,0,375000,192000,183000,183000
20200528,062338,鴻海麥證9B購01,1.52,1.52,1.52,1.52,+0.06,4.11,10000,1,15200,10000,0,10000,0,0,0,10000,0,10000,10000
20200528,062339,瑞昱麥證9C購01,1.15,1.15,1.12,1.14,+0.05,4.59,142000,7,162060,10000,132000,-122000,0,0,0,50000,132000,-82000,-82000
20200528,06233P,訊芯永豐97售03,,,,,0.00,0.00,0,0,0,0,0,0,0,0,0,0,0,0,0
20200528,062340,力成麥證9B購01,0.81,0.81,0.81,0.81,-0.01,-1.22,61000,1,49410,61000,0,61000,0,0,0,61000,0,61000,61000
20200528,062341,台表科麥證9C購01,1.94,1.94,1.90,1.90,-0.10,-5.0,13000,2,24820,0,13000,-13000,0,0,0,0,13000,-13000,-13000
20200528,062342,上証2X群益01購03,,,,,0.00,0.00,0,0,0,0,0,0,0,0,0,0,0,0,0
20200528,062343,中石化群益9B購01,0.70,0.70,0.70,0.70,+0.02,2.94,98000,1,68600,0,0,0,0,0,0,98000,0,98000,98000
20200528,062344,力山群益9B購02,1.50,1.56,1.48,1.52,+0.02,1.33,530000,23,803220,0,0,0,0,0,0,435000,95000,340000,340000
20200528,062345,和大群益9B購01,1.43,1.43,1.43,1.43,+0.07,5.15,88000,1,125840,0,0,0,0,0,0,0,88000,-88000,-88000
20200528,062346,智邦群益9B購02,4.58,4.80,4.39,4.39,+0.43,10.86,60000,5,277560,0,0,0,0,0,0,60000,0,60000,60000
20200528,062347,台光電群益9B購02,2.56,2.56,2.56,2.56,-0.28,-9.86,5000,1,12800,0,0,0,0,0,0,0,5000,-5000,-5000
20200528,062348,聯發科群益9B購06,4.06,4.06,3.61,3.73,-0.31,-7.67,116000,14,455520,0,0,0,0,0,0,104000,12000,92000,92000
20200528,062349,新日興群益9B購02,1.79,1.90,1.78,1.78,+0.12,7.23,254000,8,465620,0,0,0,0,0,0,126000,131000,-5000,-5000
20200528,06234P,亞德客元大97售02,,,,,0.00,0.00,0,0,0,0,0,0,0,0,0,0,0,0,0
20200528,062350,台表科群益9B購01,1.39,1.46,1.26,1.31,-0.08,-5.76,297000,23,406910,15000,0,15000,0,0,0,238000,59000,179000,194000
20200528,062351,瑞祺群益9C購01,1.77,1.90,1.70,1.70,-0.06,-3.41,1103000,17,2017250,0,0,0,0,0,0,398000,705000,-307000,-307000
20200528,062352,南六群益9B購02,1.03,1.03,1.03,1.03,0.00,0.00,15000,2,15450,0,0,0,0,0,0,15000,0,15000,15000
20200528,062353,亞德客元大9B購01,3.05,3.18,2.91,2.91,-0.05,-1.69,302000,28,922010,0,0,0,0,0,0,190000,163000,27000,27000
20200528,062354,台達電元大9B購01,3.16,3.16,3.06,3.06,-0.12,-3.77,68000,4,208930,0,0,0,0,0,0,68000,0,68000,68000
20200528,062355,華通元大9B購03,3.30,3.57,3.30,3.57,+0.45,14.42,127000,9,440560,0,0,0,0,0,0,45000,86000,-41000,-41000
20200528,062356,國巨元大9B購10,,,,,0.00,0.00,0,0,0,0,0,0,0,0,0,0,0,0,0
20200528,062357,國巨元大9B購11,,,,,0.00,0.00,0,0,0,0,0,0,0,0,0,0,0,0,0
20200528,062358,國巨元大9B購12,2.25,2.25,2.25,2.25,-0.02,-0.88,13000,1,29250,0,0,0,0,0,0,13000,0,13000,13000
20200528,062359,旺宏元大9C購02,1.40,1.42,1.32,1.32,-0.09,-6.38,159000,15,223490,0,0,0,0,0,0,103000,59000,44000,44000
20200528,06235P,國巨元大97售12,,,,,0.00,0.00,0,0,0,0,0,0,0,0,0,0,0,0,0
20200528,062360,華邦電元大9B購01,2.04,2.13,1.79,1.80,-0.31,-14.69,1186000,70,2391840,0,0,0,0,0,0,777000,241000,536000,536000
20200528,062361,智邦元大9B購06,3.70,4.22,3.55,3.70,+0.29,8.5,204000,24,813570,0,0,0,0,0,0,87000,194000,-107000,-107000
20200528,062362,致茂元大9B購01,1.71,1.75,1.68,1.68,-0.03,-1.75,279000,11,485550,0,0,0,0,0,0,87000,192000,-105000,-105000
20200528,062363,燿華元大9B購03,1.78,1.79,1.78,1.79,+0.04,2.29,15000,2,26780,0,0,0,0,0,0,15000,0,15000,15000
20200528,062364,瑞昱元大9B購04,2.91,2.95,2.86,2.88,+0.13,4.73,430000,52,1248180,0,0,0,0,0,0,97000,387000,-290000,-290000
20200528,062365,台光電元大9B購03,2.82,2.82,2.64,2.64,-0.18,-6.38,55000,8,149340,0,0,0,0,0,0,49000,14000,35000,35000
20200528,062366,義隆元大9B購04,2.85,2.91,2.70,2.73,+0.13,5.0,285000,42,795980,0,0,0,0,0,0,170000,157000,13000,13000
20200528,062367,禾伸堂元大9B購02,2.06,2.06,2.03,2.03,-0.02,-0.98,105000,4,215790,0,0,0,0,0,0,55000,67000,-12000,-12000
20200528,062368,聯詠元大9B購01,3.47,3.47,3.44,3.47,-0.05,-1.42,71000,3,244390,0,0,0,0,0,0,70000,71000,-1000,-1000
20200528,062369,創意元大9B購01,3.01,3.09,2.91,2.91,-0.02,-0.68,176000,20,530720,0,0,0,0,0,0,5000,171000,-166000,-166000
20200528,06236P,台積電元大97售25,6.40,6.85,6.40,6.85,+0.20,3.01,117000,2,793350,0,0,0,0,0,0,117000,99000,18000,18000
20200528,062370,華擎元大9B購01,,,,,0.00,0.00,0,0,0,0,0,0,0,0,0,0,0,0,0
20200528,062371,健策元大9B購08,4.20,4.20,3.62,3.62,-0.21,-5.48,86000,7,347460,0,0,0,0,0,0,84000,27000,57000,57000
20200528,062372,旭富元大9B購01,,,,,0.00,0.00,0,0,0,0,0,0,0,0,0,0,0,0,0
20200528,062373,泰鼎元大9B購01,3.07,3.10,2.93,2.93,+0.02,0.69,162000,8,488340,0,0,0,0,0,0,104000,83000,21000,21000
20200528,062374,茂林元大9B購03,2.94,2.94,2.80,2.80,-0.42,-13.04,72000,4,205350,0,0,0,0,0,0,72000,25000,47000,47000
20200528,062375,祥碩元大9B購03,5.60,5.85,5.50,5.80,+0.35,6.42,189000,8,1091050,0,0,0,0,0,0,174000,15000,159000,159000
20200528,062376,中租元大9B購02,2.90,2.90,2.79,2.79,-0.09,-3.12,158000,6,454580,0,0,0,0,0,0,117000,116000,1000,1000
20200528,062377,力成元大9B購01,1.90,1.96,1.77,1.79,-0.07,-3.76,254000,18,477910,0,0,0,0,0,0,113000,167000,-54000,-54000
20200528,062378,台表科元大9C購01,4.47,4.56,4.18,4.26,-0.18,-4.05,142000,12,626380,0,0,0,0,0,0,116000,142000,-26000,-26000
20200528,062379,致新元大9B購01,2.55,2.82,2.55,2.82,+0.21,8.05,587000,39,1591500,0,0,0,0,0,0,250000,418000,-168000,-168000
20200528,06237P,台積電元大97售26,,,,,0.00,0.00,0,0,0,0,0,0,0,0,0,0,0,0,0
20200528,062380,巨大元大9B購01,3.34,3.35,3.34,3.35,-0.02,-0.59,47000,2,157000,0,0,0,0,0,0,0,47000,-47000,-47000
20200528,062381,上銀國泰9C購01,2.11,2.11,2.05,2.09,+0.04,1.95,132000,15,275670,0,0,0,0,0,0,132000,0,132000,132000
20200528,062382,燿華國泰9C購01,1.44,1.44,1.37,1.37,-0.04,-2.84,61000,9,86520,0,0,0,0,0,0,53000,53000,0,0
20200528,062383,大立光國泰01購01,0.98,0.98,0.91,0.91,-0.09,-9.0,41000,4,40110,0,0,0,0,0,0,21000,20000,1000,1000
20200528,062384,聯詠國泰9C購01,1.39,1.41,1.39,1.40,-0.06,-4.11,49000,4,68590,0,0,0,0,0,0,2000,47000,-45000,-45000
20200528,062385,玉晶光國泰01購01,1.74,1.84,1.74,1.84,+0.15,8.88,77000,4,141060,0,0,0,0,0,0,1000,77000,-76000,-76000
20200528,062386,京鼎國泰9C購01,1.25,1.25,1.16,1.17,0.00,0.00,402000,5,492320,0,0,0,0,0,0,0,402000,-402000,-402000
20200528,062387,健策國泰01購01,2.10,2.12,1.83,1.84,-0.11,-5.64,147000,19,300100,0,0,0,0,0,0,119000,28000,91000,91000
20200528,062388,旭富國泰01購01,1.60,1.65,1.57,1.57,-0.06,-3.68,130000,7,208430,0,0,0,0,0,0,38000,92000,-54000,-54000
20200528,062389,台表科國泰01購01,2.46,2.46,2.33,2.37,-0.40,-14.44,52000,5,123940,0,0,0,0,0,0,40000,12000,28000,28000
20200528,06238P,台積電元大98售07,,,,,0.00,0.00,0,0,0,0,0,0,0,0,0,0,0,0,0
20200528,062390,元黃金富邦9C購01,1.75,1.77,1.75,1.77,+0.06,3.51,25000,2,44150,0,0,0,0,0,0,0,25000,-25000,-25000
20200528,062391,台達電富邦9C購01,0.76,0.76,0.72,0.72,-0.04,-5.26,36000,7,26660,0,0,0,0,0,0,11000,25000,-14000,-14000
20200528,062392,國巨富邦02購01,0.58,0.58,0.54,0.55,-0.02,-3.51,599000,17,333240,0,0,0,0,0,0,297000,302000,-5000,-5000
20200528,062393,智邦富邦9B購01,0.69,0.71,0.61,0.62,+0.04,6.9,688000,17,466570,0,0,0,0,0,0,169000,499000,-330000,-330000
20200528,062394,大立光富邦02購01,,,,,0.00,0.00,0,0,0,0,0,0,0,0,0,0,0,0,0
20200528,062395,台表科富邦9C購01,0.98,0.98,0.87,0.92,-0.02,-2.13,726000,19,677780,0,0,0,0,0,0,685000,36000,649000,649000
20200528,062396,華通永豐9B購01,0.97,1.02,0.95,0.95,+0.07,7.95,162000,9,160810,0,0,0,0,0,0,1000,161000,-160000,-160000
20200528,062397,國巨永豐9B購02,,,,,0.00,0.00,0,0,0,0,0,0,0,0,0,0,0,0,0
20200528,062398,建準永豐9B購01,2.07,2.29,1.96,1.96,+0.03,1.55,214000,28,465050,0,0,0,0,0,0,122000,80000,42000,42000
20200528,062399,神基永豐9B購01,0.70,0.70,0.70,0.70,+0.07,11.11,85000,2,59500,0,0,0,0,0,0,0,85000,-85000,-85000
20200528,06239P,奇力新元大97售08,2.69,2.96,2.69,2.96,+0.19,6.86,177000,8,503230,0,0,0,0,0,0,2000,175000,-173000,-173000
20200528,062400,晶豪科永豐9B購02,0.76,0.79,0.72,0.72,-0.03,-4.0,43000,7,32970,0,0,0,0,0,0,13000,30000,-17000,-17000
20200528,062401,信邦永豐9B購01,0.80,0.82,0.80,0.81,+0.01,1.25,152000,3,122320,0,0,0,0,0,0,85000,67000,18000,18000
20200528,062402,台勝科永豐9B購02,0.68,0.68,0.64,0.64,-0.06,-8.57,73000,3,46920,0,0,0,0,0,0,5000,68000,-63000,-63000
20200528,062403,健策永豐9B購06,1.90,1.91,1.69,1.69,-0.11,-6.11,134000,23,245030,0,0,0,0,0,0,107000,27000,80000,80000
20200528,062404,新唐永豐9B購01,0.82,0.85,0.81,0.81,0.00,0.00,228000,7,187060,0,0,0,0,0,0,20000,208000,-188000,-188000
20200528,062405,泰鼎永豐9B購02,1.25,1.25,1.25,1.25,+0.04,3.31,5000,1,6250,0,0,0,0,0,0,5000,0,5000,5000
20200528,062406,臻鼎永豐9B購01,0.79,0.79,0.77,0.77,+0.01,1.32,63000,5,49180,0,0,0,0,0,0,29000,34000,-5000,-5000
20200528,062407,同欣電永豐9B購01,0.85,0.87,0.83,0.84,-0.07,-7.69,408000,17,346290,0,0,0,0,0,0,397000,16000,381000,381000
20200528,062408,致新永豐9B購01,0.90,1.01,0.90,1.01,+0.08,8.6,1241000,37,1170890,0,0,0,0,0,0,941000,300000,641000,641000
20200528,062409,巨大永豐9B購02,1.56,1.62,1.51,1.53,-0.06,-3.77,517000,15,806380,0,0,0,0,0,0,116000,381000,-265000,-265000
20200528,06240P,奇力新元富97售03,1.49,1.60,1.49,1.57,+0.14,9.79,346000,16,533460,0,0,0,0,0,0,0,346000,-346000,-346000
20200528,062410,台積電第一9B購02,0.36,0.36,0.33,0.33,-0.02,-5.71,12000,2,4260,0,0,0,0,0,0,10000,2000,8000,8000
20200528,062411,玉晶光第一9B購01,0.71,0.71,0.69,0.69,0.00,0.00,150000,2,104500,0,0,0,0,0,0,0,150000,-150000,-150000
20200528,062412,道瓊指中信9C購05,,,,,0.00,0.00,0,0,0,0,0,0,0,0,0,0,0,0,0
20200528,062413,台光電中信9B購02,,,,,0.00,0.00,0,0,0,0,0,0,0,0,0,0,0,0,0
20200528,062414,臻鼎中信01購01,0.67,0.67,0.62,0.62,-0.03,-4.62,152000,10,99040,0,0,0,0,0,0,60000,92000,-32000,-32000
20200528,062415,聯茂中信9C購01,0.56,0.60,0.56,0.60,0.00,0.00,91000,2,51200,0,0,0,0,0,0,0,91000,-91000,-91000
20200528,062416,和大統一01購02,0.61,0.61,0.61,0.61,-0.01,-1.61,25000,1,15250,0,0,0,0,0,0,0,25000,-25000,-25000
20200528,062417,鴻海統一9C購08,0.94,0.94,0.94,0.94,+0.03,3.3,164000,1,154160,0,0,0,0,0,0,164000,0,164000,164000
20200528,062418,台積電統一01購06,0.84,0.84,0.84,0.84,-0.03,-3.45,47000,2,39480,0,0,0,0,0,0,0,47000,-47000,-47000
20200528,062419,台積電統一9B購15,1.06,1.06,1.06,1.06,-0.04,-3.64,4000,2,4240,0,0,0,0,0,0,4000,4000,0,0
20200528,06241P,大立光元富9A售01,3.12,3.15,3.12,3.15,0.00,0.00,57000,2,178050,0,0,0,0,0,0,57000,57000,0,0
20200528,062420,台積電統一9C購08,1.28,1.28,1.28,1.28,-0.06,-4.48,4000,2,5120,0,0,0,0,0,0,4000,4000,0,0
20200528,062421,台積電統一9C購09,0.81,0.81,0.81,0.81,0.00,0.00,100000,1,81000,0,0,0,0,0,0,0,100000,-100000,-100000
20200528,062422,億光統一01購01,0.63,0.63,0.63,0.63,0.00,0.00,25000,1,15750,0,0,0,0,0,0,0,25000,-25000,-25000
20200528,062423,聯發科統一9C購07,1.40,1.40,1.23,1.29,-0.05,-3.73,1478000,58,1901960,0,0,0,0,0,0,262000,1216000,-954000,-954000
20200528,062424,聯發科統一9C購08,1.29,1.29,1.21,1.21,-0.08,-6.2,36000,4,45180,0,0,0,0,0,0,10000,26000,-16000,-16000
20200528,062425,可成統一01購01,0.59,0.59,0.58,0.58,+0.01,1.75,112000,3,65780,0,0,0,0,0,0,0,112000,-112000,-112000
20200528,062426,大立光統一02購02,0.66,0.66,0.62,0.62,-0.04,-6.06,145000,2,91700,0,0,0,0,0,0,0,145000,-145000,-145000
20200528,062427,嘉澤統一01購01,1.24,1.24,1.19,1.19,-0.05,-4.03,74000,7,90050,0,0,0,0,0,0,60000,14000,46000,46000
20200528,062428,超眾統一9B購01,0.79,0.79,0.76,0.79,-0.02,-2.47,229000,14,178390,0,0,0,0,0,0,153000,76000,77000,77000
20200528,062429,A50正2元大9B購01,,,,,0.00,0.00,0,0,0,0,0,0,0,0,0,0,0,0,0
20200528,06242P,大立光元富9A售02,4.46,4.64,4.46,4.64,+0.13,2.88,15000,4,67080,0,0,0,0,0,0,15000,0,15000,15000
20200528,062430,A50正2元大9B購02,,,,,0.00,0.00,0,0,0,0,0,0,0,0,0,0,0,0,0
20200528,062431,元金2X元大9B購02,,,,,0.00,0.00,0,0,0,0,0,0,0,0,0,0,0,0,0
20200528,062432,上銀元大9B購04,4.59,4.59,4.59,4.59,+0.13,2.91,8000,1,36720,0,0,0,0,0,0,0,8000,-8000,-8000
20200528,062433,上銀元大9B購05,4.05,4.06,4.05,4.06,+0.08,2.01,8000,2,32410,0,0,0,0,0,0,8000,0,8000,8000
20200528,062434,華通元大9B購04,2.90,3.21,2.88,3.02,+0.26,9.42,158000,11,483270,0,0,0,0,0,0,13000,148000,-135000,-135000
20200528,062435,國巨元大9B購13,2.67,2.67,2.53,2.53,-0.06,-2.32,247000,6,629910,0,0,0,0,0,0,247000,0,247000,247000
20200528,062436,國巨元大9B購14,1.94,1.96,1.93,1.93,-0.06,-3.02,205000,3,397740,0,0,0,0,0,0,200000,5000,195000,195000
20200528,062437,廣達元大9B購01,4.04,4.06,3.88,3.92,-0.09,-2.24,142000,11,562580,0,0,0,0,0,0,40000,112000,-72000,-72000
20200528,062438,台光電元大9B購04,2.36,2.36,2.15,2.15,-0.20,-8.51,121000,10,275670,0,0,0,0,0,0,71000,50000,21000,21000
20200528,062439,聯發科元大9B購10,3.15,3.17,2.93,2.95,-0.11,-3.59,111000,10,339240,0,0,0,0,0,0,90000,22000,68000,68000
20200528,06243P,亞光元富97售01,3.73,3.92,3.73,3.92,+0.09,2.35,151000,4,572080,0,0,0,0,0,0,0,151000,-151000,-151000
20200528,062440,聯發科元大9B購11,4.48,4.48,4.10,4.19,-0.19,-4.34,32000,4,133890,0,0,0,0,0,0,20000,13000,7000,7000
20200528,062441,華新科元大9C購01,2.26,2.26,2.17,2.17,-0.08,-3.56,14000,3,31090,0,0,0,0,0,0,4000,10000,-6000,-6000
20200528,062442,華新科元大9C購02,1.73,1.74,1.64,1.64,-0.10,-5.75,219000,12,376990,0,0,0,0,0,0,140000,79000,61000,61000
20200528,062443,大立光元大9B購05,,,,,0.00,0.00,0,0,0,0,0,0,0,0,0,0,0,0,0
20200528,062444,大立光元大9C購01,1.55,1.55,1.55,1.55,-0.04,-2.52,5000,1,7750,0,0,0,0,0,0,5000,0,5000,5000
20200528,062445,大立光元大9C購02,2.64,2.64,2.55,2.55,-0.12,-4.49,31000,4,80950,0,0,0,0,0,0,31000,6000,25000,25000
20200528,062446,聯詠元大9B購02,3.05,3.10,3.05,3.07,-0.04,-1.29,19000,3,58410,0,0,0,0,0,0,6000,17000,-11000,-11000
20200528,062447,華擎元大9C購01,2.68,2.68,2.56,2.56,-0.07,-2.66,5000,3,13280,0,0,0,0,0,0,4000,1000,3000,3000
20200528,062448,健策元大9C購04,1.92,1.92,1.78,1.80,+0.61,51.26,232000,10,440520,0,0,0,0,0,0,222000,10000,212000,212000
20200528,062449,臻鼎元大9B購01,2.00,2.00,2.00,2.00,-0.01,-0.5,25000,1,50000,0,0,0,0,0,0,0,25000,-25000,-25000
20200528,06244P,智易元富97售02,,,,,0.00,0.00,0,0,0,0,0,0,0,0,0,0,0,0,0
20200528,062450,臻鼎元大9B購02,1.99,1.99,1.87,1.87,-0.16,-7.88,56000,2,109040,0,0,0,0,0,0,0,56000,-56000,-56000
20200528,062451,瀚宇博元大9B購02,1.72,1.73,1.69,1.72,+0.02,1.18,398000,32,681670,0,0,0,0,0,0,219000,305000,-86000,-86000
20200528,062452,A50正2群益01購04,1.51,1.53,1.46,1.46,0.00,0.00,15000,5,22620,0,0,0,0,0,0,0,15000,-15000,-15000
20200528,062453,聚陽群益9C購01,2.94,3.03,2.77,2.85,-0.13,-4.36,136000,12,388560,0,0,0,0,0,0,71000,65000,6000,6000
20200528,062454,華通群益9C購03,,,,,0.00,0.00,0,0,0,0,0,0,0,0,0,0,0,0,0
20200528,062455,鴻海群益9C購01,,,,,0.00,0.00,0,0,0,0,0,0,0,0,0,0,0,0,0
20200528,062456,台積電群益9B購05,,,,,0.00,0.00,0,0,0,0,0,0,0,0,0,0,0,0,0
20200528,062457,京元電群益9B購01,0.83,0.83,0.78,0.78,-0.04,-4.88,193000,7,153590,0,0,0,0,0,0,158000,35000,123000,123000
20200528,062458,全新群益9B購03,1.29,1.31,1.29,1.31,-0.08,-5.76,158000,5,205690,0,0,0,0,0,0,158000,0,158000,158000
20200528,062459,聯詠群益9B購01,,,,,0.00,0.00,0,0,0,0,0,0,0,0,0,0,0,0,0
20200528,06245P,健策元富97售03,0.40,0.45,0.40,0.45,0.00,0.00,147000,4,64070,0,0,0,0,0,0,0,147000,-147000,-147000
20200528,062460,京鼎群益9C購01,1.74,1.75,1.63,1.63,-0.05,-2.98,403000,14,687280,0,0,0,0,0,0,68000,317000,-249000,-249000
20200528,062461,智伸科群益9B購01,2.09,2.09,1.95,1.95,-0.13,-6.25,288000,16,585370,0,0,0,0,0,0,276000,10000,266000,266000
20200528,062462,GIS群益9B購01,2.13,2.16,1.77,1.83,-0.15,-7.58,419000,40,826170,0,0,0,0,0,0,191000,247000,-56000,-56000
20200528,062463,世紀鋼麥證9B購01,0.97,1.19,0.97,1.13,+0.13,13.0,849000,37,933540,311000,538000,-227000,0,0,0,311000,538000,-227000,-227000
20200528,062464,T50反1凱基9C購03,0.67,0.67,0.67,0.67,+0.03,4.69,150000,2,100500,0,0,0,0,0,0,150000,0,150000,150000
20200528,062465,臺指反凱基01購01,,,,,0.00,0.00,0,0,0,0,0,0,0,0,0,0,0,0,0
20200528,062466,FBVIX凱基9B購01,1.00,1.02,0.99,1.02,+0.01,0.99,15000,5,15200,0,0,0,0,0,0,3000,12000,-9000,-9000
20200528,062467,國巨凱基9B購08,1.77,1.77,1.63,1.63,0.00,0.00,279000,3,492570,0,0,0,0,0,0,1000,278000,-277000,-277000
20200528,062468,台積電凱基9B購06,,,,,0.00,0.00,0,0,0,0,0,0,0,0,0,0,0,0,0
20200528,062469,旺宏凱基9B購05,1.96,1.97,1.94,1.97,0.00,0.00,71000,16,138590,0,0,0,0,0,0,51000,0,51000,51000
20200528,06246P,茂林元富97售03,0.47,0.52,0.46,0.51,-0.02,-3.77,612000,30,295780,0,0,0,0,0,0,275000,327000,-52000,-52000
20200528,062470,智邦凱基9C購01,4.50,4.76,3.97,3.97,+0.30,8.17,38000,14,173080,0,0,0,0,0,0,5000,33000,-28000,-28000
20200528,062471,國泰金凱基9B購02,3.27,3.27,3.27,3.27,+0.02,0.62,11000,1,35970,0,0,0,0,0,0,11000,0,11000,11000
20200528,062472,大立光凱基9B購04,,,,,0.00,0.00,0,0,0,0,0,0,0,0,0,0,0,0,0
20200528,062473,同欣電凱基9B購01,2.55,2.56,2.55,2.56,-0.21,-7.58,27000,3,68900,0,0,0,0,0,0,22000,5000,17000,17000
20200528,062474,台表科凱基9C購01,2.95,2.95,2.95,2.95,-0.15,-4.84,2000,1,5900,0,0,0,0,0,0,0,2000,-2000,-2000
20200528,062475,道瓊反國票9B購02,1.22,1.25,1.22,1.22,-0.15,-10.95,103000,12,127380,15000,0,15000,0,0,0,6000,97000,-91000,-76000
20200528,062476,神隆國票9B購01,2.03,2.03,2.03,2.03,-0.12,-5.58,10000,1,20300,0,0,0,0,0,0,10000,0,10000,10000
20200528,062477,聯詠國票9B購01,2.60,2.60,2.60,2.60,-0.11,-4.06,37000,1,96200,0,0,0,0,0,0,0,37000,-37000,-37000
20200528,062478,牧德國票9B購03,,,,,0.00,0.00,0,0,0,0,0,0,0,0,0,0,0,0,0
20200528,062479,TPK國票9B購01,3.45,3.64,3.17,3.17,-0.33,-9.43,133000,18,472530,0,0,0,0,0,0,110000,23000,87000,87000
20200528,06247P,同欣電元富97售02,,,,,0.00,0.00,0,0,0,0,0,0,0,0,0,0,0,0,0
20200528,062480,茂林國票9B購01,2.41,2.41,2.33,2.37,-0.49,-17.13,146000,16,345390,0,0,0,0,0,0,136000,10000,126000,126000
20200528,062481,同欣電國票9B購01,2.88,2.96,2.76,2.84,-0.07,-2.41,349000,8,994360,0,0,0,0,0,0,296000,53000,243000,243000
20200528,062482,台表科國票9B購01,5.15,5.20,5.05,5.05,+0.18,3.7,11000,3,56750,0,0,0,0,0,0,5000,6000,-1000,-1000
20200528,062483,致新國票9B購01,3.47,3.91,3.47,3.91,+0.34,9.52,234000,31,852240,0,0,0,0,0,0,19000,215000,-196000,-196000
20200528,062484,臺股指國票9B購10,2.53,2.53,2.53,2.53,0.00,0.00,5000,1,12650,0,0,0,0,0,0,0,5000,-5000,-5000
20200528,062485,華通國泰01購01,1.55,1.70,1.55,1.58,+0.13,8.97,1070000,40,1723200,0,0,0,0,0,0,137000,941000,-804000,-804000
20200528,062486,瑞昱富邦9B購01,0.60,0.63,0.60,0.61,+0.02,3.39,757000,18,463620,0,0,0,0,0,0,365000,657000,-292000,-292000
20200528,062487,中興電永豐9B購01,1.09,1.21,1.09,1.21,+0.13,12.04,1023000,67,1168300,0,0,0,0,0,0,708000,287000,421000,421000
20200528,062488,台光電永豐9B購02,0.94,0.94,0.85,0.85,-0.08,-8.6,34000,5,30450,0,0,0,0,0,0,15000,19000,-4000,-4000
20200528,062489,可成永豐9B購02,,,,,0.00,0.00,0,0,0,0,0,0,0,0,0,0,0,0,0
20200528,06248P,國巨統一97售07,2.01,2.03,2.01,2.03,0.00,0.00,100000,2,202000,0,0,0,0,0,0,100000,100000,0,0
20200528,062490,聯茂永豐9B購01,0.55,0.57,0.55,0.57,0.00,0.00,128000,2,72920,0,0,0,0,0,0,128000,0,128000,128000
20200528,062491,矽創永豐9B購01,0.92,0.95,0.86,0.86,+0.08,10.26,866000,15,790650,0,0,0,0,0,0,459000,407000,52000,52000
20200528,062492,牧德第一9B購01,0.46,0.46,0.45,0.45,-0.02,-4.26,50000,2,22900,0,0,0,0,0,0,50000,0,50000,50000
20200528,062493,元金反中信9B購01,,,,,0.00,0.00,0,0,0,0,0,0,0,0,0,0,0,0,0
20200528,062494,中石化中信9C購01,,,,,0.00,0.00,0,0,0,0,0,0,0,0,0,0,0,0,0
20200528,062495,友達中信01購02,,,,,0.00,0.00,0,0,0,0,0,0,0,0,0,0,0,0,0
20200528,062496,矽創中信9B購01,0.72,0.82,0.71,0.75,+0.11,17.19,1020000,71,779940,0,0,0,0,0,0,267000,792000,-525000,-525000
20200528,062497,遠東新群益9B購01,2.05,2.07,2.01,2.01,-0.14,-6.51,266000,5,542180,0,0,0,0,0,0,158000,108000,50000,50000
20200528,062498,華通群益9C購04,2.36,2.62,2.36,2.44,+0.17,7.49,460000,13,1150540,0,0,0,0,0,0,26000,434000,-408000,-408000
20200528,062499,鴻海群益01購01,2.78,2.81,2.68,2.68,-0.05,-1.83,10000,7,27650,0,0,0,0,0,0,10000,10000,0,0
20200528,06249P,億光統一97售02,,,,,0.00,0.00,0,0,0,0,0,0,0,0,0,0,0,0,0
20200528,062500,國巨群益01購01,3.53,3.53,3.35,3.35,-0.10,-2.9,57000,3,201030,0,0,0,0,0,0,57000,1000,56000,56000
20200528,062501,台積電群益9C購03,3.67,3.67,3.29,3.29,-0.27,-7.58,164000,4,554040,0,0,0,0,0,0,39000,127000,-88000,-88000
20200528,062502,旺宏群益9C購01,,,,,0.00,0.00,0,0,0,0,0,0,0,0,0,0,0,0,0
20200528,062503,玉晶光群益01購03,2.91,3.07,2.86,2.86,+0.07,2.51,219000,10,640720,0,0,0,0,0,0,15000,209000,-194000,-194000
20200528,062504,旭富群益9B購02,2.08,2.12,2.08,2.12,-0.06,-2.75,210000,3,438400,0,0,0,0,0,0,125000,125000,0,0
20200528,062505,祥碩群益9B購03,4.46,4.73,4.46,4.61,+0.33,7.71,41000,3,184630,0,0,0,0,0,0,11000,31000,-20000,-20000
20200528,062506,巨大群益9C購01,4.23,4.35,4.17,4.17,-0.23,-5.23,99000,4,418170,0,0,0,0,0,0,44000,55000,-11000,-11000
20200528,062507,臺股指群益9B購02,,,,,0.00,0.00,0,0,0,0,0,0,0,0,0,0,0,0,0
20200528,062508,臺股指群益9B購03,,,,,0.00,0.00,0,0,0,0,0,0,0,0,0,0,0,0,0
20200528,062509,SP黃豆國票9B購03,1.57,1.57,1.57,1.57,+0.02,1.29,2000,1,3140,0,0,0,0,0,0,0,2000,-2000,-2000
20200528,06250P,臺股指永昌97售02,,,,,0.00,0.00,0,0,0,0,0,0,0,0,0,0,0,0,0
20200528,062510,台積電國票01購01,2.09,2.09,1.95,1.95,-0.09,-4.41,36000,5,71640,0,0,0,0,0,0,0,36000,-36000,-36000
20200528,062511,台光電國票9B購02,3.79,3.84,3.35,3.47,-0.31,-8.2,14000,4,49540,0,0,0,0,0,0,0,14000,-14000,-14000
20200528,062512,美食國票9B購01,3.62,3.62,3.50,3.50,-0.14,-3.85,10000,2,35960,0,0,0,0,0,0,10000,0,10000,10000
20200528,062513,玉晶光國票9C購01,2.48,2.70,2.48,2.70,+0.33,13.92,27000,6,69080,0,0,0,0,0,0,4000,26000,-22000,-22000
20200528,062514,玉晶光國票9C購02,1.49,1.49,1.49,1.49,+0.02,1.36,10000,1,14900,0,0,0,0,0,0,10000,0,10000,10000
20200528,062515,台灣50元大9B購15,,,,,0.00,0.00,0,0,0,0,0,0,0,0,0,0,0,0,0
20200528,062516,台灣50元大9B購16,,,,,0.00,0.00,0,0,0,0,0,0,0,0,0,0,0,0,0
20200528,062517,滬深2X元大9B購05,,,,,0.00,0.00,0,0,0,0,0,0,0,0,0,0,0,0,0
20200528,062518,臺指反元大02購07,,,,,0.00,0.00,0,0,0,0,0,0,0,0,0,0,0,0,0
20200528,062519,元金2X元大9B購03,1.49,1.49,1.49,1.49,+0.05,3.47,1000,1,1490,0,0,0,0,0,0,1000,0,1000,1000
20200528,06251P,臺股指永昌97售03,,,,,0.00,0.00,0,0,0,0,0,0,0,0,0,0,0,0,0
20200528,062520,晶豪科元大9B購02,2.63,2.78,2.63,2.78,+0.20,7.75,78000,5,213040,0,0,0,0,0,0,0,78000,-78000,-78000
20200528,062521,玉晶光元大9C購05,2.96,3.09,2.96,3.06,+0.22,7.75,135000,9,409150,0,0,0,0,0,0,31000,105000,-74000,-74000
20200528,062522,同欣電元大9B購02,2.75,2.75,2.61,2.61,-0.07,-2.61,76000,15,205340,0,0,0,0,0,0,61000,30000,31000,31000
20200528,062523,世紀鋼元大9C購03,1.12,1.34,1.10,1.26,+0.12,10.53,845000,39,1062550,0,0,0,0,0,0,560000,431000,129000,129000
20200528,062524,鴻海統一9C購09,0.79,0.79,0.79,0.79,+0.02,2.6,35000,2,27650,0,0,0,0,0,0,35000,0,35000,35000
20200528,062525,鴻海統一9C購10,0.81,0.81,0.81,0.81,+0.02,2.53,24000,1,19440,0,0,0,0,0,0,24000,0,24000,24000
20200528,062526,友達統一01購01,0.73,0.74,0.73,0.74,-0.01,-1.33,40000,2,29340,0,0,0,0,0,0,26000,14000,12000,12000
20200528,062527,美律統一01購01,0.75,0.75,0.73,0.73,0.00,0.00,160000,3,119000,0,0,0,0,0,0,50000,110000,-60000,-60000
20200528,062528,全新統一9C購01,0.74,0.75,0.73,0.75,-0.01,-1.32,605000,5,446010,0,0,0,0,0,0,605000,0,605000,605000
20200528,062529,可成統一9C購03,,,,,0.00,0.00,0,0,0,0,0,0,0,0,0,0,0,0,0
20200528,06252P,臺股指兆豐97售02,,,,,0.00,0.00,0,0,0,0,0,0,0,0,0,0,0,0,0
20200528,062530,大立光統一01購03,,,,,0.00,0.00,0,0,0,0,0,0,0,0,0,0,0,0,0
20200528,062531,大立光統一9C購06,,,,,0.00,0.00,0,0,0,0,0,0,0,0,0,0,0,0,0
20200528,062532,聯詠統一9C購01,0.82,0.85,0.82,0.85,-0.01,-1.16,325000,2,275500,0,0,0,0,0,0,325000,0,325000,325000
20200528,062533,嘉澤統一9C購01,1.44,1.44,1.44,1.44,-0.19,-11.66,10000,1,14400,0,0,0,0,0,0,0,10000,-10000,-10000
20200528,062534,力成統一01購01,0.62,0.63,0.62,0.63,+0.04,6.78,271000,4,169020,0,0,0,0,0,0,0,271000,-271000,-271000
20200528,062535,台積電麥證02購01,,,,,0.00,0.00,0,0,0,0,0,0,0,0,0,0,0,0,0
20200528,062536,玉晶光麥證9B購01,,,,,0.00,0.00,0,0,0,0,0,0,0,0,0,0,0,0,0
20200528,062537,聯電國泰9C購01,1.02,1.08,1.02,1.08,+0.11,11.34,114000,2,117120,0,0,0,0,0,0,114000,0,114000,114000
20200528,062538,台積電國泰9C購02,3.96,3.96,3.70,3.75,-0.12,-3.1,19000,4,73930,0,0,0,0,0,0,6000,19000,-13000,-13000
20200528,062539,可成國泰01購01,1.02,1.03,0.96,0.97,-0.02,-2.02,712000,22,696360,0,0,0,0,0,0,250000,620000,-370000,-370000
20200528,06253P,臺股指兆豐97售03,,,,,0.00,0.00,0,0,0,0,0,0,0,0,0,0,0,0,0
20200528,062540,茂林國泰9C購01,1.76,1.77,1.64,1.68,-0.06,-3.45,416000,45,706510,0,0,0,0,0,0,406000,116000,290000,290000
20200528,062541,臻鼎國泰01購01,1.72,1.73,1.58,1.58,-0.09,-5.39,852000,20,1387870,0,0,0,0,0,0,417000,451000,-34000,-34000
20200528,062542,南電國泰9C購01,1.62,1.62,1.53,1.53,-0.11,-6.71,252000,8,389190,0,0,0,0,0,0,235000,17000,218000,218000
20200528,062543,華通富邦9C購01,0.48,0.54,0.48,0.49,+0.04,8.89,676000,21,338320,0,0,0,0,0,0,70000,606000,-536000,-536000
20200528,062544,信錦永豐9B購01,,,,,0.00,0.00,0,0,0,0,0,0,0,0,0,0,0,0,0
20200528,062545,嘉晶永豐9B購01,2.02,2.02,1.91,1.91,-0.20,-9.48,90000,5,176820,0,0,0,0,0,0,85000,5000,80000,80000
20200528,062546,新日興永豐9B購01,0.67,0.73,0.67,0.73,+0.07,10.61,75000,3,53850,0,0,0,0,0,0,0,75000,-75000,-75000
20200528,062547,玉晶光永豐9B購05,,,,,0.00,0.00,0,0,0,0,0,0,0,0,0,0,0,0,0
20200528,062548,智易永豐9B購01,0.77,0.82,0.76,0.76,+0.04,5.56,85000,7,65930,0,0,0,0,0,0,30000,55000,-25000,-25000
20200528,062549,中租永豐9B購01,0.69,0.70,0.67,0.67,-0.01,-1.47,568000,16,390450,0,0,0,0,0,0,409000,159000,250000,250000
20200528,06254P,臺股指群益97售07,1.72,2.02,1.68,2.02,+0.07,3.59,485000,28,890380,0,0,0,0,0,0,234000,247000,-13000,-13000
20200528,062550,啟碁永豐9B購01,0.95,0.96,0.94,0.95,0.00,0.00,1198000,47,1132400,0,0,0,0,0,0,1198000,0,1198000,1198000
20200528,062551,緯穎永豐9B購02,,,,,0.00,0.00,0,0,0,0,0,0,0,0,0,0,0,0,0
20200528,062552,南電永豐9B購01,,,,,0.00,0.00,0,0,0,0,0,0,0,0,0,0,0,0,0
20200528,062553,台積電凱基9B購07,,,,,0.00,0.00,0,0,0,0,0,0,0,0,0,0,0,0,0
20200528,062554,台積電凱基9B購08,,,,,0.00,0.00,0,0,0,0,0,0,0,0,0,0,0,0,0
20200528,062555,旺宏凱基9B購06,1.08,1.09,1.08,1.09,-0.02,-1.8,40000,21,43210,0,0,0,0,0,0,40000,0,40000,40000
20200528,062556,瑞昱凱基9B購02,2.96,3.05,2.96,2.99,+0.10,3.46,120000,6,361080,0,0,0,0,0,0,40000,80000,-40000,-40000
20200528,062557,台光電凱基9B購02,1.02,1.06,0.94,0.98,-0.06,-5.77,72000,7,71840,0,0,0,0,0,0,52000,20000,32000,32000
20200528,062558,義隆凱基9B購02,1.58,1.66,1.55,1.61,+0.15,10.27,174000,28,277550,0,0,0,0,0,0,111000,82000,29000,29000
20200528,062559,嘉晶凱基9B購02,5.20,5.20,5.00,5.00,0.00,0.00,18000,4,92000,0,0,0,0,0,0,6000,18000,-12000,-12000
20200528,06255P,臺股指群益97售08,,,,,0.00,0.00,0,0,0,0,0,0,0,0,0,0,0,0,0
20200528,062560,奇鋐凱基9B購02,2.32,2.57,2.32,2.49,+0.25,11.16,327000,41,823430,0,0,0,0,0,0,25000,327000,-302000,-302000
20200528,062561,瀚宇博凱基9B購01,0.93,0.96,0.93,0.96,+0.03,3.23,282000,18,265680,0,0,0,0,0,0,282000,40000,242000,242000
20200528,062562,瑞儀凱基9B購02,1.34,1.40,1.32,1.32,-0.01,-0.75,51000,7,70560,0,0,0,0,0,0,31000,34000,-3000,-3000
20200528,062563,緯穎凱基9B購03,,,,,0.00,0.00,0,0,0,0,0,0,0,0,0,0,0,0,0
20200528,062564,矽創凱基9B購01,1.73,1.99,1.73,1.77,+0.17,10.62,671000,92,1253090,0,0,0,0,0,0,281000,426000,-145000,-145000
20200528,062565,漢唐中信9C購01,0.77,0.77,0.70,0.70,-0.06,-7.89,319000,3,227630,0,0,0,0,0,0,100000,219000,-119000,-119000
20200528,062566,嘉晶中信9C購01,1.56,1.59,1.48,1.48,-0.13,-8.07,146000,12,224740,0,0,0,0,0,0,79000,40000,39000,39000
20200528,062567,祥碩中信9C購01,1.04,1.19,1.02,1.17,+0.11,10.38,68000,13,75590,0,0,0,0,0,0,20000,38000,-18000,-18000
20200528,062568,緯穎中信9C購01,0.67,0.67,0.59,0.59,-0.05,-7.81,77000,13,47530,0,0,0,0,0,0,20000,57000,-37000,-37000
20200528,062569,南電中信01購01,,,,,0.00,0.00,0,0,0,0,0,0,0,0,0,0,0,0,0
20200528,06256P,臺股指群益97售09,4.23,4.23,4.23,4.23,-0.19,-4.3,10000,1,42300,0,0,0,0,0,0,0,10000,-10000,-10000
20200528,062570,T50反1群益9B購02,,,,,0.00,0.00,0,0,0,0,0,0,0,0,0,0,0,0,0
20200528,062571,臺指反群益9B購04,,,,,0.00,0.00,0,0,0,0,0,0,0,0,0,0,0,0,0
20200528,062572,元金反群益9C購01,,,,,0.00,0.00,0,0,0,0,0,0,0,0,0,0,0,0,0
20200528,062573,大毅群益9B購03,1.77,1.77,1.69,1.71,-0.06,-3.39,140000,8,240520,0,0,0,0,0,0,51000,89000,-38000,-38000
20200528,062574,美食群益9B購02,2.88,2.88,2.49,2.49,-0.32,-11.39,28000,4,75570,0,0,0,0,0,0,28000,15000,13000,13000
20200528,062575,景碩群益9B購01,1.12,1.17,1.12,1.16,+0.07,6.42,587000,7,675300,0,0,0,0,0,0,0,587000,-587000,-587000
20200528,062576,華擎群益9B購02,1.95,2.03,1.87,1.89,+0.01,0.53,211000,9,409370,0,0,0,0,0,0,146000,87000,59000,59000
20200528,062577,泰鼎群益9B購01,1.97,2.04,1.90,1.96,+0.01,0.51,533000,11,1050940,0,0,0,0,0,0,222000,311000,-89000,-89000
20200528,062578,超眾群益9B購01,1.02,1.06,0.97,1.05,-0.06,-5.41,325000,6,334520,0,0,0,0,0,0,131000,194000,-63000,-63000
20200528,062579,華通統一01購02,0.80,0.84,0.80,0.84,+0.08,10.53,40000,2,32400,0,0,0,0,0,0,10000,0,10000,10000
20200528,06257P,臺股指群益97售10,5.30,5.95,5.30,5.80,+0.20,3.57,7000,7,40350,0,0,0,0,0,0,1000,6000,-5000,-5000
20200528,062580,華通統一9C購03,,,,,0.00,0.00,0,0,0,0,0,0,0,0,0,0,0,0,0
20200528,062581,鴻海統一01購02,,,,,0.00,0.00,0,0,0,0,0,0,0,0,0,0,0,0,0
20200528,062582,鴻海統一9C購11,,,,,0.00,0.00,0,0,0,0,0,0,0,0,0,0,0,0,0
20200528,062583,鴻海統一9C購12,,,,,0.00,0.00,0,0,0,0,0,0,0,0,0,0,0,0,0
20200528,062584,鴻海統一9C購13,0.84,0.84,0.84,0.84,+0.02,2.44,48000,2,40320,0,0,0,0,0,0,48000,0,48000,48000
20200528,062585,鴻海統一9C購14,,,,,0.00,0.00,0,0,0,0,0,0,0,0,0,0,0,0,0
20200528,062586,國巨統一01購06,,,,,0.00,0.00,0,0,0,0,0,0,0,0,0,0,0,0,0
20200528,062587,國巨統一9B購13,,,,,0.00,0.00,0,0,0,0,0,0,0,0,0,0,0,0,0
20200528,062588,國巨統一9B購14,,,,,0.00,0.00,0,0,0,0,0,0,0,0,0,0,0,0,0
20200528,062589,友達統一9C購03,1.22,1.24,1.22,1.24,-0.01,-0.8,24000,2,29440,0,0,0,0,0,0,16000,8000,8000,8000
20200528,06258P,臺股指群益97售11,,,,,0.00,0.00,0,0,0,0,0,0,0,0,0,0,0,0,0
20200528,062590,亞光統一9B購01,0.87,0.87,0.80,0.81,-0.03,-3.57,201000,7,172170,0,0,0,0,0,0,52000,149000,-97000,-97000
20200528,062591,新日興統一9C購01,0.83,0.89,0.82,0.84,+0.04,5.0,866000,31,740690,0,0,0,0,0,0,377000,489000,-112000,-112000
20200528,062592,牧德統一01購01,0.86,0.88,0.84,0.84,-0.04,-4.55,116000,6,100910,0,0,0,0,0,0,2000,114000,-112000,-112000
20200528,062593,健策統一9B購03,1.09,1.09,0.93,0.93,-0.09,-8.82,317000,25,318910,0,0,0,0,0,0,241000,158000,83000,83000
20200528,062594,祥碩統一01購02,1.30,1.42,1.30,1.40,+0.12,9.38,392000,16,541620,0,0,0,0,0,0,62000,328000,-266000,-266000
20200528,062595,祥碩統一9B購01,,,,,0.00,0.00,0,0,0,0,0,0,0,0,0,0,0,0,0
20200528,062596,緯穎統一01購02,0.78,0.80,0.73,0.74,-0.07,-8.64,533000,16,403410,0,0,0,0,0,0,294000,239000,55000,55000
20200528,062597,世紀鋼統一01購01,0.73,0.86,0.73,0.83,+0.08,10.67,962000,34,782440,0,0,0,0,0,0,480000,472000,8000,8000
20200528,062598,華通台新9B購02,0.93,0.99,0.90,0.90,+0.11,13.92,199000,10,187940,0,0,0,0,0,0,40000,159000,-119000,-119000
20200528,062599,鴻海台新9B購01,,,,,0.00,0.00,0,0,0,0,0,0,0,0,0,0,0,0,0
20200528,06259P,臺股指群益97售12,,,,,0.00,0.00,0,0,0,0,0,0,0,0,0,0,0,0,0
20200528,062600,可成台新9B購01,,,,,0.00,0.00,0,0,0,0,0,0,0,0,0,0,0,0,0
20200528,062601,富邦金台新9B購01,1.06,1.07,1.01,1.01,-0.07,-6.48,43000,6,45700,0,0,0,0,0,0,43000,43000,0,0
20200528,062602,華通麥證9C購01,1.39,1.39,1.39,1.39,+0.21,17.8,50000,1,69500,0,50000,-50000,0,0,0,0,50000,-50000,-50000
20200528,062603,台化凱基9B購01,0.99,0.99,0.96,0.96,-0.02,-2.04,50000,4,48500,0,0,0,0,0,0,0,50000,-50000,-50000
20200528,062604,東元凱基9B購01,1.54,1.68,1.54,1.54,-0.09,-5.52,105000,7,164080,0,0,0,0,0,0,35000,70000,-35000,-35000
20200528,062605,上銀凱基9B購03,1.79,1.85,1.79,1.81,-0.02,-1.09,68000,16,122840,0,0,0,0,0,0,68000,10000,58000,58000
20200528,062606,聯電凱基9C購02,0.82,0.87,0.82,0.83,+0.02,2.47,340000,12,284270,0,0,0,0,0,0,153000,187000,-34000,-34000
20200528,062607,美食凱基9B購01,,,,,0.00,0.00,0,0,0,0,0,0,0,0,0,0,0,0,0
20200528,062608,智易凱基9B購01,0.93,1.01,0.92,0.92,+0.02,2.22,1262000,43,1199140,0,0,0,0,0,0,701000,346000,355000,355000
20200528,062609,帆宣凱基9B購01,1.25,1.27,1.17,1.17,+0.08,7.34,224000,21,271730,0,0,0,0,0,0,60000,157000,-97000,-97000
20200528,06260P,臺股指群益97售13,,,,,0.00,0.00,0,0,0,0,0,0,0,0,0,0,0,0,0
20200528,062610,啟碁凱基9B購01,1.05,1.09,1.03,1.04,0.00,0.00,613000,35,652850,0,0,0,0,0,0,399000,214000,185000,185000
20200528,062611,台灣50元大9B購18,,,,,0.00,0.00,0,0,0,0,0,0,0,0,0,0,0,0,0
20200528,062612,台灣50元大9B購19,,,,,0.00,0.00,0,0,0,0,0,0,0,0,0,0,0,0,0
20200528,062613,臺指反元大02購10,,,,,0.00,0.00,0,0,0,0,0,0,0,0,0,0,0,0,0
20200528,062614,臺指反元大02購11,,,,,0.00,0.00,0,0,0,0,0,0,0,0,0,0,0,0,0
20200528,062615,亞德客元大9B購02,3.09,3.21,2.72,2.81,-0.14,-4.75,202000,38,621700,0,0,0,0,0,0,176000,39000,137000,137000
20200528,062616,玉晶光元大9C購06,1.52,1.55,1.52,1.55,+0.12,8.39,150000,2,229500,0,0,0,0,0,0,0,150000,-150000,-150000
20200528,062617,京鼎元大9B購01,2.16,2.18,2.03,2.05,-0.10,-4.65,313000,14,661950,0,0,0,0,0,0,52000,313000,-261000,-261000
20200528,062618,祥碩元大9B購04,5.60,6.15,5.60,5.75,+0.15,2.68,32000,6,186850,0,0,0,0,0,0,5000,29000,-24000,-24000
20200528,062619,台表科元大9B購03,3.63,3.67,3.33,3.40,-0.13,-3.68,62000,7,219030,0,0,0,0,0,0,32000,52000,-20000,-20000
20200528,06261P,上銀凱基97售03,,,,,0.00,0.00,0,0,0,0,0,0,0,0,0,0,0,0,0
20200528,062620,台表科元大9B購04,2.82,2.85,2.66,2.66,-0.08,-2.92,48000,3,134590,0,0,0,0,0,0,1000,48000,-47000,-47000
20200528,062621,緯穎元大9B購05,3.11,3.17,3.05,3.17,0.00,0.00,53000,8,164550,0,0,0,0,0,0,50000,3000,47000,47000
20200528,062622,南電元大9B購03,1.16,1.16,1.16,1.16,+0.04,3.57,100000,1,116000,0,0,0,0,0,0,0,100000,-100000,-100000
20200528,062623,元金2X國票01購01,,,,,0.00,0.00,0,0,0,0,0,0,0,0,0,0,0,0,0
20200528,062624,大成鋼國票9B購02,0.93,1.10,0.93,1.10,0.00,0.00,65000,3,67250,0,0,0,0,0,0,0,65000,-65000,-65000
20200528,062625,華通國票9B購02,2.53,2.91,2.53,2.65,+0.20,8.16,195000,14,551960,0,0,0,0,0,0,41000,154000,-113000,-113000
20200528,062626,台積電國票9C購04,,,,,0.00,0.00,0,0,0,0,0,0,0,0,0,0,0,0,0
20200528,062627,旺宏國票9C購01,1.19,1.19,1.19,1.19,-0.02,-1.65,41000,1,48790,0,0,0,0,0,0,41000,0,41000,41000
20200528,062628,廣達國票9B購01,,,,,0.00,0.00,0,0,0,0,0,0,0,0,0,0,0,0,0
20200528,062629,聯發科國票9C購01,,,,,0.00,0.00,0,0,0,0,0,0,0,0,0,0,0,0,0
20200528,06262P,國巨凱基97售07,1.38,1.51,1.33,1.51,+0.02,1.34,201000,13,287530,0,0,0,0,0,0,17000,184000,-167000,-167000
20200528,062630,全新國票9B購02,,,,,0.00,0.00,0,0,0,0,0,0,0,0,0,0,0,0,0
20200528,062631,奇力新國票9B購01,,,,,0.00,0.00,0,0,0,0,0,0,0,0,0,0,0,0,0
20200528,062632,嘉晶國票9B購01,11.00,11.00,10.80,10.80,-0.20,-1.82,4000,2,43600,0,0,0,0,0,0,0,4000,-4000,-4000
20200528,062633,亞光國票9B購01,,,,,0.00,0.00,0,0,0,0,0,0,0,0,0,0,0,0,0
20200528,062634,玉晶光國票9B購03,2.40,2.52,2.36,2.52,+0.16,6.78,47000,5,111600,0,0,0,0,0,0,9000,41000,-32000,-32000
20200528,062635,創意國票9B購01,4.38,4.42,4.11,4.11,-0.09,-2.14,69000,13,297840,0,0,0,0,0,0,0,69000,-69000,-69000
20200528,062636,聯鈞國票9B購01,2.68,2.68,2.66,2.66,+0.04,1.53,21000,2,56080,0,0,0,0,0,0,21000,0,21000,21000
20200528,062637,智易國票9B購01,3.88,4.17,3.88,4.17,+0.43,11.5,50000,5,201830,0,0,0,0,0,0,8000,42000,-34000,-34000
20200528,062638,茂林國票9C購01,,,,,0.00,0.00,0,0,0,0,0,0,0,0,0,0,0,0,0
20200528,062639,臻鼎國票9C購01,2.36,2.36,2.09,2.14,-0.21,-8.94,30000,4,67630,0,0,0,0,0,0,19000,20000,-1000,-1000
20200528,06263P,燿華凱基97售04,0.56,0.56,0.56,0.56,-0.16,-22.22,1000,1,560,0,0,0,0,0,0,1000,0,1000,1000
20200528,062640,訊連國票9C購01,1.45,1.45,1.32,1.32,-0.15,-10.2,63000,4,88620,0,0,0,0,0,0,54000,9000,45000,45000
20200528,062641,瀚宇博國票9B購01,2.14,2.20,2.13,2.13,+0.07,3.4,120000,5,259920,0,0,0,0,0,0,36000,84000,-48000,-48000
20200528,062642,帆宣國票9B購01,3.16,3.20,2.92,2.96,+0.15,5.34,429000,20,1337630,0,0,0,0,0,0,270000,159000,111000,111000
20200528,062643,緯穎國票9B購01,,,,,0.00,0.00,0,0,0,0,0,0,0,0,0,0,0,0,0
20200528,062644,中環國泰9C購01,1.08,1.09,0.99,0.99,-0.10,-9.17,67000,5,72020,0,0,0,0,0,0,0,67000,-67000,-67000
20200528,062645,國巨國泰9B購08,2.63,2.73,2.51,2.51,-0.11,-4.2,182000,13,489340,0,0,0,0,0,0,119000,65000,54000,54000
20200528,062646,聯發科國泰01購02,2.04,2.04,1.90,1.90,-0.11,-5.47,201000,11,397990,16000,0,16000,0,0,0,160000,41000,119000,135000
20200528,062647,南電國泰9C購02,0.65,0.66,0.61,0.61,-0.04,-6.15,246000,12,157550,0,0,0,0,0,0,101000,145000,-44000,-44000
20200528,062648,聯茂富邦9B購01,0.36,0.37,0.36,0.37,+0.04,12.12,320000,2,115400,0,0,0,0,0,0,0,320000,-320000,-320000
20200528,062649,緯穎富邦9B購03,,,,,0.00,0.00,0,0,0,0,0,0,0,0,0,0,0,0,0
20200528,06264P,友達凱基98售06,,,,,0.00,0.00,0,0,0,0,0,0,0,0,0,0,0,0,0
20200528,062650,南電富邦01購01,0.25,0.26,0.25,0.25,0.00,0.00,65000,5,16350,0,0,0,0,0,0,5000,60000,-55000,-55000
20200528,062651,世紀鋼富邦9C購01,0.57,0.60,0.57,0.57,+0.07,14.0,640000,16,370470,0,0,0,0,0,0,340000,300000,40000,40000
20200528,062652,上証2X永豐9B購01,,,,,0.00,0.00,0,0,0,0,0,0,0,0,0,0,0,0,0
20200528,062653,正隆永豐9B購01,1.05,1.09,1.04,1.04,-0.01,-0.95,211000,6,223190,0,0,0,0,0,0,68000,143000,-75000,-75000
20200528,062654,技嘉永豐9B購01,1.09,1.09,1.05,1.07,0.00,0.00,44000,4,47100,0,0,0,0,0,0,0,44000,-44000,-44000
20200528,062655,漢唐永豐9B購01,1.00,1.02,1.00,1.01,-0.03,-2.88,177000,3,178660,0,0,0,0,0,0,177000,0,177000,177000
20200528,062656,全新永豐9B購01,,,,,0.00,0.00,0,0,0,0,0,0,0,0,0,0,0,0,0
20200528,062657,華新科第一9B購01,0.60,0.60,0.60,0.60,-0.01,-1.64,20000,3,12000,0,0,0,0,0,0,20000,0,20000,20000
20200528,062658,聯茂第一9B購01,0.35,0.38,0.35,0.37,+0.03,8.82,153000,10,55510,0,0,0,0,0,0,130000,23000,107000,107000
20200528,062659,台灣50群益9B購10,3.27,3.32,3.01,3.01,-0.14,-4.44,12000,7,38680,0,0,0,0,0,0,8000,4000,4000,4000
20200528,06265P,美律凱基97售01,1.36,1.37,1.32,1.37,-0.14,-9.27,132000,8,180300,0,0,0,0,0,0,82000,50000,32000,32000
20200528,062660,神隆群益9B購02,0.96,0.96,0.96,0.96,-0.05,-4.95,108000,2,103680,0,0,0,0,0,0,0,108000,-108000,-108000
20200528,062661,華通群益9B購05,2.01,2.15,1.99,1.99,+0.20,11.17,178000,6,364540,0,0,0,0,0,0,80000,98000,-18000,-18000
20200528,062662,友達群益9B購02,1.25,1.28,1.25,1.28,+0.01,0.79,244000,4,311250,0,0,0,0,0,0,44000,200000,-156000,-156000
20200528,062663,聯發科群益9B購07,3.09,3.09,2.70,2.82,-0.23,-7.54,326000,22,958660,0,0,0,0,0,0,207000,119000,88000,88000
20200528,062664,群創群益9B購02,1.04,1.04,1.04,1.04,+0.02,1.96,72000,1,74880,0,0,0,0,0,0,0,72000,-72000,-72000
20200528,062665,智易群益9B購01,1.79,1.91,1.77,1.77,+0.05,2.91,328000,18,602180,0,0,0,0,0,0,111000,172000,-61000,-61000
20200528,062666,和碩群益9B購01,1.79,1.81,1.71,1.71,-0.10,-5.52,762000,6,1360150,0,0,0,0,0,0,66000,696000,-630000,-630000
20200528,062667,立積群益9B購01,0.92,0.92,0.92,0.92,0.00,0.00,98000,1,90160,0,0,0,0,0,0,0,98000,-98000,-98000
20200528,062668,國巨中信9B購04,,,,,0.00,0.00,0,0,0,0,0,0,0,0,0,0,0,0,0
20200528,062669,微星中信03購01,1.36,1.41,1.36,1.41,+0.05,3.68,372000,10,518230,0,0,0,0,0,0,141000,231000,-90000,-90000
20200528,06266P,大立光凱基97售11,8.00,8.65,8.00,8.65,0.00,0.00,20000,2,166500,0,0,0,0,0,0,10000,10000,0,0
20200528,062670,瑞昱中信03購01,1.35,1.35,1.34,1.35,+0.04,3.05,83000,7,111750,0,0,0,0,0,0,31000,72000,-41000,-41000
20200528,062671,國泰金中信03購01,1.18,1.18,1.12,1.12,-0.07,-5.88,45000,6,51910,0,0,0,0,0,0,0,45000,-45000,-45000
20200528,062672,兆豐金中信03購01,,,,,0.00,0.00,0,0,0,0,0,0,0,0,0,0,0,0,0
20200528,062673,台新金中信03購01,1.18,1.18,1.16,1.16,+0.02,1.75,233000,5,271490,0,0,0,0,0,0,185000,48000,137000,137000
20200528,062674,百和中信03購01,1.53,1.57,1.47,1.50,+0.02,1.35,60000,18,91990,0,0,0,0,0,0,52000,8000,44000,44000
20200528,062675,台積電台新9B購06,0.96,0.96,0.96,0.96,0.00,0.00,30000,2,28800,0,0,0,0,0,0,0,30000,-30000,-30000
20200528,062676,南六台新9B購01,1.13,1.18,1.13,1.18,+0.03,2.61,41000,10,47410,0,0,0,0,0,0,20000,21000,-1000,-1000
20200528,062677,儒鴻統一01購01,1.22,1.22,1.12,1.12,-0.09,-7.44,1091000,45,1285900,0,0,0,0,0,0,677000,404000,273000,273000
20200528,062678,華通統一9C購04,,,,,0.00,0.00,0,0,0,0,0,0,0,0,0,0,0,0,0
20200528,062679,技嘉統一01購01,0.86,0.88,0.83,0.83,-0.07,-7.78,164000,12,142150,0,0,0,0,0,0,72000,92000,-20000,-20000
20200528,06267P,大立光凱基97售12,,,,,0.00,0.00,0,0,0,0,0,0,0,0,0,0,0,0,0
20200528,062680,微星統一01購01,0.71,0.73,0.70,0.71,+0.02,2.9,320000,15,226540,0,0,0,0,0,0,164000,156000,8000,8000
20200528,062681,全新統一01購01,0.48,0.48,0.47,0.48,-0.01,-2.04,301000,4,142480,0,0,0,0,0,0,0,301000,-301000,-301000
20200528,062682,全新統一9B購01,0.68,0.71,0.68,0.70,-0.04,-5.41,345000,15,242100,0,0,0,0,0,0,197000,148000,49000,49000
20200528,062683,可成統一9B購04,0.57,0.57,0.57,0.57,-0.02,-3.39,20000,1,11400,0,0,0,0,0,0,20000,0,20000,20000
20200528,062684,華新科統一01購02,0.81,0.83,0.78,0.78,-0.03,-3.7,144000,22,115610,0,0,0,0,0,0,89000,55000,34000,34000
20200528,062685,華新科統一9C購03,0.87,0.88,0.87,0.88,+0.02,2.33,89000,10,77440,0,0,0,0,0,0,89000,0,89000,89000
20200528,062686,群創統一9C購03,1.08,1.09,1.07,1.09,+0.02,1.87,176000,4,191270,0,0,0,0,0,0,52000,124000,-72000,-72000
20200528,062687,華擎統一01購02,0.96,0.98,0.91,0.91,-0.02,-2.15,92000,6,85370,0,0,0,0,0,0,55000,37000,18000,18000
20200528,062688,華擎統一01購03,0.89,0.89,0.84,0.85,+0.01,1.19,54000,3,46090,0,0,0,0,0,0,0,54000,-54000,-54000
20200528,062689,華擎統一02購01,0.90,0.90,0.85,0.85,-0.01,-1.16,184000,4,159240,0,0,0,0,0,0,121000,63000,58000,58000
20200528,06268P,聯詠凱基97售02,,,,,0.00,0.00,0,0,0,0,0,0,0,0,0,0,0,0,0
20200528,062690,華擎統一9B購01,1.20,1.20,1.20,1.20,+0.07,6.19,4000,1,4800,0,0,0,0,0,0,0,4000,-4000,-4000
20200528,062691,T50反1元大9B購04,1.64,1.71,1.64,1.71,+0.04,2.4,20000,2,33500,0,0,0,0,0,0,10000,10000,0,0
20200528,062692,T50反1元大9B購05,,,,,0.00,0.00,0,0,0,0,0,0,0,0,0,0,0,0,0
20200528,062693,中石化元大02購01,,,,,0.00,0.00,0,0,0,0,0,0,0,0,0,0,0,0,0
20200528,062694,遠東新元大9B購01,2.99,2.99,2.96,2.96,-0.07,-2.31,57000,3,169230,0,0,0,0,0,0,17000,40000,-23000,-23000
20200528,062695,華通元大9C購01,1.92,2.00,1.88,1.89,+0.13,7.39,85000,5,164600,0,0,0,0,0,0,0,85000,-85000,-85000
20200528,062696,國巨元大9B購16,,,,,0.00,0.00,0,0,0,0,0,0,0,0,0,0,0,0,0
20200528,062697,國巨元大9C購01,1.29,1.29,1.27,1.27,-0.02,-1.55,20000,2,25600,0,0,0,0,0,0,0,20000,-20000,-20000
20200528,062698,台積電元大01購01,1.65,1.65,1.63,1.63,+0.03,1.88,110000,3,181300,0,0,0,0,0,0,0,110000,-110000,-110000
20200528,062699,台積電元大01購02,1.68,1.70,1.68,1.70,+0.05,3.03,35000,3,59100,0,0,0,0,0,0,20000,15000,5000,5000
20200528,06269P,群創凱基98售10,3.31,3.31,3.31,3.31,0.00,0.00,20000,2,66200,0,0,0,0,0,0,0,20000,-20000,-20000
20200528,062700,台光電元大9B購05,3.84,3.84,3.68,3.68,-0.19,-4.91,24000,2,90240,0,0,0,0,0,0,12000,12000,0,0
20200528,062701,漢唐元大9B購01,2.96,2.96,2.78,2.78,-0.13,-4.47,163000,7,471210,0,0,0,0,0,0,94000,99000,-5000,-5000
20200528,062702,可成元大9C購01,1.32,1.32,1.25,1.25,-0.02,-1.57,232000,9,295230,0,0,0,0,0,0,100000,132000,-32000,-32000
20200528,062703,可成元大9C購02,1.25,1.25,1.21,1.21,-0.02,-1.63,20000,2,24800,0,0,0,0,0,0,0,20000,-20000,-20000
20200528,062704,大毅元大9C購01,1.74,1.74,1.74,1.74,0.00,0.00,80000,2,139200,0,0,0,0,0,0,0,80000,-80000,-80000
20200528,062705,美食元大9B購01,3.29,3.29,3.22,3.22,-0.05,-1.53,103000,8,332760,0,0,0,0,0,0,53000,50000,3000,3000
20200528,062706,大立光元大9B購06,2.77,2.77,2.75,2.76,-0.04,-1.43,25000,3,69000,0,0,0,0,0,0,25000,0,25000,25000
20200528,062707,致伸元大9B購01,2.46,2.58,2.46,2.55,+0.12,4.94,201000,31,511870,0,0,0,0,0,0,20000,181000,-161000,-161000
20200528,062708,立積元大9B購01,1.44,1.44,1.44,1.44,+0.05,3.6,100000,1,144000,0,0,0,0,0,0,0,100000,-100000,-100000
20200528,062709,帆宣元大9B購01,2.72,2.72,2.59,2.59,+0.16,6.58,713000,36,1883030,0,0,0,0,0,0,553000,80000,473000,473000
20200528,06270P,致伸凱基97售03,0.70,0.70,0.70,0.70,-0.08,-10.26,70000,3,49000,0,0,0,0,0,0,70000,0,70000,70000
20200528,062710,盛群元大9B購01,2.04,2.06,2.00,2.00,-0.06,-2.91,175000,12,355710,0,0,0,0,0,0,50000,125000,-75000,-75000
20200528,062711,台表科元大9B購05,2.49,2.51,2.32,2.34,-0.13,-5.26,55000,8,132490,0,0,0,0,0,0,55000,33000,22000,22000
20200528,062712,晶技麥證9B購02,1.53,1.53,1.47,1.47,-0.17,-10.37,29000,4,42790,3000,26000,-23000,0,0,0,3000,26000,-23000,-23000
20200528,062713,台灣50凱基02購03,,,,,0.00,0.00,0,0,0,0,0,0,0,0,0,0,0,0,0
20200528,062714,台灣50凱基9C購10,,,,,0.00,0.00,0,0,0,0,0,0,0,0,0,0,0,0,0
20200528,062715,T50反1凱基03購01,,,,,0.00,0.00,0,0,0,0,0,0,0,0,0,0,0,0,0
20200528,062716,鴻海凱基9B購06,,,,,0.00,0.00,0,0,0,0,0,0,0,0,0,0,0,0,0
20200528,062717,華邦電凱基9C購01,2.68,2.79,2.30,2.30,-0.08,-3.36,321000,44,846550,0,0,0,0,0,0,278000,42000,236000,236000
20200528,062718,技嘉凱基9B購01,1.82,1.82,1.71,1.71,-0.19,-10.0,17000,4,29920,0,0,0,0,0,0,15000,2000,13000,13000
20200528,062719,微星凱基9B購01,1.14,1.14,1.14,1.14,0.00,0.00,8000,1,9120,0,0,0,0,0,0,0,8000,-8000,-8000
20200528,06271P,彩晶凱基97售01,1.96,2.02,1.96,2.02,+0.01,0.5,22000,4,43330,0,0,0,0,0,0,0,22000,-22000,-22000
20200528,062720,南亞科凱基9B購03,1.44,1.50,1.34,1.34,0.00,0.00,383000,12,538050,0,0,0,0,0,0,45000,338000,-293000,-293000
20200528,062721,美律凱基9B購02,,,,,0.00,0.00,0,0,0,0,0,0,0,0,0,0,0,0,0
20200528,062722,京元電凱基9B購02,0.67,0.67,0.63,0.63,-0.04,-5.97,99000,4,63760,0,0,0,0,0,0,69000,30000,39000,39000
20200528,062723,聯發科凱基9B購09,2.40,2.40,2.38,2.38,+0.04,1.71,25000,2,59700,0,0,0,0,0,0,25000,15000,10000,10000
20200528,062724,可成凱基9B購04,1.30,1.30,1.25,1.25,-0.11,-8.09,140000,2,181000,0,0,0,0,0,0,140000,120000,20000,20000
20200528,062725,大立光凱基9B購06,,,,,0.00,0.00,0,0,0,0,0,0,0,0,0,0,0,0,0
20200528,062726,華擎凱基9B購02,1.97,1.97,1.97,1.97,0.00,0.00,60000,1,118200,0,0,0,0,0,0,0,60000,-60000,-60000
20200528,062727,華擎凱基9B購03,2.72,2.72,2.72,2.72,-0.01,-0.37,3000,1,8160,0,0,0,0,0,0,3000,3000,0,0
20200528,062728,健策凱基9B購04,2.31,2.34,2.03,2.03,-0.16,-7.31,205000,25,450730,0,0,0,0,0,0,122000,117000,5000,5000
20200528,062729,神達凱基9B購02,2.48,2.52,2.48,2.48,+0.01,0.4,92000,6,230340,0,0,0,0,0,0,78000,38000,40000,40000
20200528,06272P,台郡凱基97售04,0.73,0.73,0.73,0.73,0.00,0.00,10000,1,7300,0,0,0,0,0,0,0,10000,-10000,-10000
20200528,062730,致伸凱基9B購01,0.88,0.92,0.88,0.90,0.00,0.00,99000,16,89200,0,0,0,0,0,0,0,99000,-99000,-99000
20200528,062731,力成凱基9B購02,0.64,0.66,0.60,0.60,-0.03,-4.76,433000,13,280240,0,0,0,0,0,0,16000,417000,-401000,-401000
20200528,062732,南六凱基9B購03,2.86,2.86,2.83,2.83,+0.18,6.79,53000,2,150860,0,0,0,0,0,0,24000,29000,-5000,-5000
20200528,062733,巨大凱基9B購01,2.17,2.25,2.17,2.17,-0.02,-0.91,129000,5,284410,0,0,0,0,0,0,73000,56000,17000,17000
20200528,062734,臺指反國票9C購03,1.35,1.35,1.34,1.34,+0.06,4.69,20000,2,26900,0,0,0,0,0,0,20000,0,20000,20000
20200528,062735,和大國票9B購01,3.85,4.05,3.85,3.99,+0.12,3.1,30000,4,119560,0,0,0,0,0,0,0,30000,-30000,-30000
20200528,062736,漢唐國票9B購01,3.72,3.72,3.72,3.72,-0.17,-4.37,38000,1,141360,0,0,0,0,0,0,38000,0,38000,38000
20200528,062737,聯發科國票9B購03,4.61,4.61,4.47,4.47,-0.05,-1.11,12000,2,54620,0,0,0,0,0,0,7000,5000,2000,2000
20200528,062738,可成國票9B購02,1.26,1.26,1.21,1.21,-0.03,-2.42,27000,3,33440,0,0,0,0,0,0,3000,27000,-24000,-24000
20200528,062739,嘉晶國票9B購02,8.90,8.90,8.90,8.90,0.00,0.00,2000,1,17800,0,0,0,0,0,0,0,2000,-2000,-2000
20200528,06273P,台表科凱基97售04,0.80,0.80,0.36,0.40,-0.05,-11.11,468000,10,170720,0,0,0,0,0,0,466000,0,466000,466000
20200528,062740,致伸國票9B購01,2.31,2.44,2.31,2.44,+0.16,7.02,88000,23,212640,0,0,0,0,0,0,8000,80000,-72000,-72000
20200528,062741,立積國票9B購02,3.56,3.70,3.51,3.70,+0.01,0.27,19000,3,67520,0,0,0,0,0,0,19000,0,19000,19000
20200528,062742,技嘉國泰01購01,1.70,1.70,1.67,1.68,-0.10,-5.62,31000,5,52170,0,0,0,0,0,0,15000,16000,-1000,-1000
20200528,062743,微星國泰01購01,1.47,1.52,1.47,1.47,-0.03,-2.0,294000,6,433480,0,0,0,0,0,0,98000,186000,-88000,-88000
20200528,062744,超眾國泰9C購01,2.36,2.40,2.34,2.35,-0.01,-0.42,271000,11,642740,0,0,0,0,0,0,15000,256000,-241000,-241000
20200528,062745,聯詠永豐9B購01,0.82,0.82,0.78,0.79,-0.03,-3.66,47000,4,38110,0,0,0,0,0,0,28000,19000,9000,9000
20200528,062746,致伸永豐9B購01,0.73,0.76,0.73,0.74,0.00,0.00,125000,5,91580,0,0,0,0,0,0,0,125000,-125000,-125000
20200528,062747,立積永豐9B購01,,,,,0.00,0.00,0,0,0,0,0,0,0,0,0,0,0,0,0
20200528,062748,祥碩永豐9B購02,1.59,1.74,1.56,1.72,+0.19,12.42,572000,27,953040,0,0,0,0,0,0,33000,550000,-517000,-517000
20200528,062749,元金2X中信9B購01,1.00,1.00,1.00,1.00,-0.04,-3.85,25000,1,25000,0,0,0,0,0,0,25000,0,25000,25000
20200528,06274P,臺股指凱基97售06,,,,,0.00,0.00,0,0,0,0,0,0,0,0,0,0,0,0,0
20200528,062750,可成中信9B購01,0.45,0.45,0.45,0.45,-0.03,-6.25,70000,1,31500,0,0,0,0,0,0,70000,0,70000,70000
20200528,062751,華擎中信9C購01,0.73,0.73,0.72,0.73,+0.02,2.82,25000,4,18240,0,0,0,0,0,0,24000,1000,23000,23000
20200528,062752,世芯中信9B購01,0.98,0.99,0.93,0.99,+0.02,2.06,121000,4,116840,0,0,0,0,0,0,50000,71000,-21000,-21000
20200528,062753,台積電麥證9B購01,1.40,1.40,1.40,1.40,-0.01,-0.71,6000,1,8400,0,6000,-6000,0,0,0,0,6000,-6000,-6000
20200528,062754,台勝科麥證9B購01,0.97,0.97,0.97,0.97,-0.08,-7.62,180000,2,174600,180000,0,180000,0,0,0,180000,0,180000,180000
20200528,062755,茂林麥證9B購01,1.50,1.50,1.45,1.45,-0.04,-2.68,60000,3,89500,0,60000,-60000,0,0,0,0,60000,-60000,-60000
20200528,062756,臺指反凱基9C購01,,,,,0.00,0.00,0,0,0,0,0,0,0,0,0,0,0,0,0
20200528,062757,華通凱基9B購02,1.44,1.51,1.40,1.40,+0.14,11.11,244000,8,358160,0,0,0,0,0,0,0,244000,-244000,-244000
20200528,062758,國巨凱基9B購09,,,,,0.00,0.00,0,0,0,0,0,0,0,0,0,0,0,0,0
20200528,062759,旺宏凱基9B購07,1.53,1.56,1.43,1.45,-0.10,-6.45,163000,20,248370,0,0,0,0,0,0,163000,33000,130000,130000
20200528,06275P,臺股指凱基97售07,,,,,0.00,0.00,0,0,0,0,0,0,0,0,0,0,0,0,0
20200528,062760,漢唐凱基9B購01,1.85,1.85,1.78,1.79,-0.12,-6.28,240000,5,428200,0,0,0,0,0,0,0,240000,-240000,-240000
20200528,062761,嘉晶凱基9C購01,2.50,2.56,2.37,2.41,-0.22,-8.37,1214000,45,2975360,0,0,0,0,0,0,992000,222000,770000,770000
20200528,062762,聯詠凱基9B購02,,,,,0.00,0.00,0,0,0,0,0,0,0,0,0,0,0,0,0
20200528,062763,華擎凱基9C購02,2.34,2.34,2.34,2.34,0.00,0.00,1000,1,2340,0,0,0,0,0,0,1000,0,1000,1000
20200528,062764,世芯凱基9B購02,3.36,3.42,3.30,3.30,-0.09,-2.65,62000,5,209480,0,0,0,0,0,0,61000,1000,60000,60000
20200528,062765,祥碩凱基9B購04,2.15,2.45,2.15,2.36,+0.20,9.26,82000,7,187400,0,0,0,0,0,0,51000,82000,-31000,-31000
20200528,062766,台郡凱基9B購02,1.05,1.06,1.02,1.02,-0.01,-0.97,432000,30,448020,0,0,0,0,0,0,48000,379000,-331000,-331000
20200528,062767,GIS凱基9B購02,2.90,2.94,2.57,2.58,-0.13,-4.8,39000,8,111570,0,0,0,0,0,0,25000,14000,11000,11000
20200528,062768,南電凱基9B購04,1.23,1.23,1.23,1.23,+0.02,1.65,49000,1,60270,0,0,0,0,0,0,0,49000,-49000,-49000
20200528,062769,臺股指凱基9B購13,,,,,0.00,0.00,0,0,0,0,0,0,0,0,0,0,0,0,0
20200528,06276P,臺股指凱基97售08,,,,,0.00,0.00,0,0,0,0,0,0,0,0,0,0,0,0,0
20200528,062770,臺股指凱基9B購14,2.13,2.13,2.13,2.13,-0.14,-6.17,2000,2,4260,0,0,0,0,0,0,1000,1000,0,0
20200528,062771,臺股指凱基9B購15,,,,,0.00,0.00,0,0,0,0,0,0,0,0,0,0,0,0,0
20200528,062772,T50反1元大9B購06,,,,,0.00,0.00,0,0,0,0,0,0,0,0,0,0,0,0,0
20200528,062773,臺指反元大02購12,,,,,0.00,0.00,0,0,0,0,0,0,0,0,0,0,0,0,0
20200528,062774,儒鴻元大9C購01,3.94,3.96,3.57,3.58,-0.32,-8.21,265000,35,1012650,0,0,0,0,0,0,175000,50000,125000,125000
20200528,062775,大成鋼元大9B購02,2.06,2.29,2.03,2.12,+0.08,3.92,400000,25,861350,0,0,0,0,0,0,129000,300000,-171000,-171000
20200528,062776,鴻海元大9B購03,1.37,1.37,1.37,1.37,0.00,0.00,136000,2,186320,0,0,0,0,0,0,68000,68000,0,0
20200528,062777,鴻海元大9C購03,,,,,0.00,0.00,0,0,0,0,0,0,0,0,0,0,0,0,0
20200528,062778,國巨元大9B購17,,,,,0.00,0.00,0,0,0,0,0,0,0,0,0,0,0,0,0
20200528,062779,台積電元大9B購03,1.76,1.76,1.65,1.65,-0.09,-5.17,69000,4,118960,0,0,0,0,0,0,20000,49000,-29000,-29000
20200528,06277P,臺股指凱基97售09,7.45,7.45,7.45,7.45,+0.35,4.93,2000,1,14900,0,0,0,0,0,0,2000,0,2000,2000
20200528,062780,旺宏元大01購01,3.00,3.04,2.82,2.82,-0.21,-6.93,205000,24,604420,0,0,0,0,0,0,132000,109000,23000,23000
20200528,062781,微星元大9C購01,1.95,2.02,1.92,1.98,+0.09,4.76,285000,21,555450,0,0,0,0,0,0,166000,119000,47000,47000
20200528,062782,聯發科元大9B購12,2.65,2.67,2.50,2.50,-0.09,-3.47,77000,9,202150,0,0,0,0,0,0,61000,17000,44000,44000
20200528,062783,大立光元大9C購03,,,,,0.00,0.00,0,0,0,0,0,0,0,0,0,0,0,0,0
20200528,062784,世芯元大9B購01,2.90,2.94,2.77,2.93,-0.03,-1.01,179000,7,510190,0,0,0,0,0,0,68000,111000,-43000,-43000
20200528,062785,世芯元大9C購01,1.47,1.48,1.40,1.48,+0.02,1.37,257000,10,367500,0,0,0,0,0,0,138000,119000,19000,19000
20200528,062786,立積元大9C購03,1.20,1.20,1.18,1.18,-0.05,-4.07,221000,8,263060,0,0,0,0,0,0,211000,10000,201000,201000
20200528,062787,超眾元大9C購02,1.94,1.97,1.92,1.92,-0.24,-11.11,89000,4,174890,0,0,0,0,0,0,13000,76000,-63000,-63000
20200528,062788,臺股指元大9B購31,,,,,0.00,0.00,0,0,0,0,0,0,0,0,0,0,0,0,0
20200528,062789,臺股指元大9B購32,1.28,1.28,1.28,1.28,0.00,0.00,8000,1,10240,0,0,0,0,0,0,0,8000,-8000,-8000
20200528,06278P,臺股指凱基97售10,,,,,0.00,0.00,0,0,0,0,0,0,0,0,0,0,0,0,0
20200528,062790,臺股指元大9B購33,1.48,1.48,1.40,1.40,-0.04,-2.78,14000,2,19760,2000,0,2000,0,0,0,0,14000,-14000,-12000
20200528,062791,臺股指元大9B購34,,,,,0.00,0.00,0,0,0,0,0,0,0,0,0,0,0,0,0
20200528,062792,臺股指元大9B購35,,,,,0.00,0.00,0,0,0,0,0,0,0,0,0,0,0,0,0
20200528,062793,鴻海統一9B購06,,,,,0.00,0.00,0,0,0,0,0,0,0,0,0,0,0,0,0
20200528,062794,鴻海統一9C購15,,,,,0.00,0.00,0,0,0,0,0,0,0,0,0,0,0,0,0
20200528,062795,國巨統一9B購15,1.26,1.26,1.19,1.19,-0.05,-4.03,20000,2,24500,0,0,0,0,0,0,10000,10000,0,0
20200528,062796,技嘉統一9C購01,0.86,0.86,0.85,0.85,-0.12,-12.37,6000,2,5110,0,0,0,0,0,0,0,6000,-6000,-6000
20200528,062797,瑞昱統一9B購01,1.17,1.17,1.15,1.16,+0.02,1.75,344000,7,398760,0,0,0,0,0,0,29000,335000,-306000,-306000
20200528,062798,台光電統一9B購01,1.47,1.47,1.32,1.34,-0.12,-8.22,131000,10,183970,0,0,0,0,0,0,82000,31000,51000,51000
20200528,062799,聯發科統一9C購09,1.14,1.14,1.13,1.14,-0.06,-5.0,12000,3,13670,0,0,0,0,0,0,11000,1000,10000,10000
20200528,06279P,臺股指凱基97售11,,,,,0.00,0.00,0,0,0,0,0,0,0,0,0,0,0,0,0
20200528,062800,奇力新統一01購02,0.59,0.59,0.59,0.59,-0.02,-3.28,4000,1,2360,0,0,0,0,0,0,0,4000,-4000,-4000
20200528,062801,宏達電統一01購01,0.97,0.97,0.86,0.86,-0.10,-10.42,307000,9,276390,0,0,0,0,0,0,292000,15000,277000,277000
20200528,062802,宏達電統一9B購01,1.28,1.28,1.15,1.15,-0.11,-8.73,50000,3,62950,0,0,0,0,0,0,50000,0,50000,50000
20200528,062803,嘉晶統一9B購02,1.72,1.72,1.60,1.60,-0.20,-11.11,41000,5,66530,0,0,0,0,0,0,34000,7000,27000,27000
20200528,062804,玉晶光統一9C購04,,,,,0.00,0.00,0,0,0,0,0,0,0,0,0,0,0,0,0
20200528,062805,台勝科統一9C購01,0.82,0.82,0.81,0.81,-0.01,-1.22,45000,4,36700,0,0,0,0,0,0,40000,5000,35000,35000
20200528,062806,世芯統一02購01,0.98,0.98,0.92,0.97,+0.03,3.19,265000,18,250880,0,0,0,0,0,0,54000,211000,-157000,-157000
20200528,062807,和碩統一9B購01,0.87,0.87,0.84,0.84,-0.04,-4.55,48000,4,41420,0,0,0,0,0,0,0,48000,-48000,-48000
20200528,062808,祥碩統一9C購01,1.16,1.30,1.12,1.22,+0.11,9.91,2268000,51,2751720,0,0,0,0,0,0,878000,2163000,-1285000,-1285000
20200528,062809,同欣電統一9C購01,0.90,0.90,0.86,0.86,-0.03,-3.37,541000,31,476900,0,0,0,0,0,0,457000,107000,350000,350000
20200528,06280P,臺股指凱基97售12,,,,,0.00,0.00,0,0,0,0,0,0,0,0,0,0,0,0,0
20200528,062810,華通兆豐9B購02,0.70,0.70,0.70,0.70,+0.07,11.11,120000,1,84000,0,0,0,0,0,0,0,120000,-120000,-120000
20200528,062811,鴻海兆豐9B購01,0.99,0.99,0.99,0.99,-0.01,-1.0,5000,2,4950,0,0,0,0,0,0,5000,5000,0,0
20200528,062812,國巨兆豐9B購03,,,,,0.00,0.00,0,0,0,0,0,0,0,0,0,0,0,0,0
20200528,062813,台積電兆豐9B購01,1.30,1.30,1.30,1.30,+0.04,3.17,2000,1,2600,0,0,0,0,0,0,2000,0,2000,2000
20200528,062814,台光電兆豐9B購01,1.54,1.54,1.54,1.54,0.00,0.00,10000,1,15400,0,0,0,0,0,0,0,10000,-10000,-10000
20200528,062815,聯發科兆豐9B購03,2.44,2.44,2.44,2.44,+0.11,4.72,6000,1,14640,0,0,0,0,0,0,6000,0,6000,6000
20200528,062816,華新科兆豐9B購01,0.92,0.93,0.92,0.93,-0.01,-1.06,20000,5,18500,0,0,0,0,0,0,20000,0,20000,20000
20200528,062817,富邦金兆豐9B購01,1.37,1.37,1.26,1.26,-0.11,-8.03,62000,8,84270,0,0,0,0,0,0,60000,7000,53000,53000
20200528,062818,大立光兆豐9C購01,,,,,0.00,0.00,0,0,0,0,0,0,0,0,0,0,0,0,0
20200528,062819,奇鋐兆豐9B購01,1.15,1.27,1.15,1.18,+0.05,4.42,1352000,46,1640650,0,0,0,0,0,0,46000,1352000,-1306000,-1306000
20200528,06281P,臺股指凱基97售13,,,,,0.00,0.00,0,0,0,0,0,0,0,0,0,0,0,0,0
20200528,062820,禾伸堂兆豐9B購01,1.20,1.21,1.19,1.20,-0.01,-0.83,434000,10,518950,0,0,0,0,0,0,312000,122000,190000,190000
20200528,062821,華擎兆豐9C購01,1.36,1.36,1.22,1.22,-0.08,-6.15,208000,12,274510,0,0,0,0,0,0,119000,89000,30000,30000
20200528,062822,力成兆豐9B購01,0.78,0.80,0.78,0.80,+0.02,2.56,93000,8,72940,0,0,0,0,0,0,73000,20000,53000,53000
20200528,062823,台表科兆豐9B購01,2.45,2.49,2.42,2.42,-0.23,-8.68,161000,3,392750,0,0,0,0,0,0,80000,81000,-1000,-1000
20200528,062824,國巨群益9C購03,1.84,1.84,1.84,1.84,+0.06,3.37,2000,1,3680,0,0,0,0,0,0,2000,0,2000,2000
20200528,062825,聯發科群益9B購08,3.27,3.27,3.27,3.27,+0.12,3.81,3000,1,9810,0,0,0,0,0,0,3000,0,3000,3000
20200528,062826,奇力新群益9C購01,,,,,0.00,0.00,0,0,0,0,0,0,0,0,0,0,0,0,0
20200528,062827,神基群益9B購01,2.52,2.58,2.47,2.47,-0.01,-0.4,70000,3,174500,0,0,0,0,0,0,60000,10000,50000,50000
20200528,062828,聯詠群益9B購02,1.95,1.95,1.92,1.92,-0.07,-3.52,113000,2,218790,0,0,0,0,0,0,61000,52000,9000,9000
20200528,062829,泰碩群益9B購01,1.27,1.27,1.23,1.23,-0.05,-3.91,12000,3,15070,0,0,0,0,0,0,0,12000,-12000,-12000
20200528,06282P,聯鈞永豐97售02,1.30,1.37,1.29,1.37,-0.07,-4.86,147000,10,192620,0,0,0,0,0,0,125000,22000,103000,103000
20200528,062830,玉晶光群益01購05,2.47,2.60,2.47,2.60,+0.21,8.79,277000,7,697990,0,0,0,0,0,0,0,277000,-277000,-277000
20200528,062831,嘉澤群益9B購01,2.47,2.47,2.47,2.47,-0.03,-1.2,12000,1,29640,0,0,0,0,0,0,0,12000,-12000,-12000
20200528,062832,嘉澤群益9B購02,2.04,2.04,2.00,2.00,-0.26,-11.5,23000,2,46320,0,0,0,0,0,0,8000,15000,-7000,-7000
20200528,062833,世芯群益9B購01,1.80,1.81,1.76,1.81,-0.22,-10.84,100000,6,177500,0,0,0,0,0,0,1000,99000,-98000,-98000
20200528,062834,立積群益9B購02,1.49,1.49,1.49,1.49,+0.06,4.2,41000,1,61090,0,0,0,0,0,0,41000,0,41000,41000
20200528,062835,瑞儀群益9B購01,2.05,2.15,2.04,2.09,+0.06,2.96,476000,13,981880,0,0,0,0,0,0,438000,135000,303000,303000
20200528,062836,同欣電群益9B購02,2.39,2.42,2.28,2.31,-0.05,-2.12,392000,12,925320,0,0,0,0,0,0,360000,32000,328000,328000
20200528,062837,復盛群益9B購01,2.80,2.94,2.75,2.78,-0.06,-2.11,193000,11,550350,0,0,0,0,0,0,103000,112000,-9000,-9000
20200528,062838,臺股指群益9B購05,,,,,0.00,0.00,0,0,0,0,0,0,0,0,0,0,0,0,0
20200528,062839,臺股指群益9B購06,3.75,3.75,3.75,3.75,0.00,0.00,3000,1,11250,0,0,0,0,0,0,0,3000,-3000,-3000
20200528,06283P,祥碩永豐97售01,0.08,0.08,0.08,0.08,0.00,0.00,5000,1,400,0,0,0,0,0,0,0,0,0,0
20200528,062840,臺股指群益9B購07,,,,,0.00,0.00,0,0,0,0,0,0,0,0,0,0,0,0,0
20200528,062841,臺股指群益9B購08,,,,,0.00,0.00,0,0,0,0,0,0,0,0,0,0,0,0,0
20200528,062842,臺股指群益9B購09,4.01,4.01,3.63,3.63,-0.25,-6.44,22000,2,80620,0,0,0,0,0,0,2000,20000,-18000,-18000
20200528,062843,臺股指群益9B購10,,,,,0.00,0.00,0,0,0,0,0,0,0,0,0,0,0,0,0
20200528,062844,T50反1國泰9C購01,0.60,0.61,0.60,0.61,0.00,0.00,51000,2,30610,0,0,0,0,0,0,0,51000,-51000,-51000
20200528,062845,微星富邦01購01,,,,,0.00,0.00,0,0,0,0,0,0,0,0,0,0,0,0,0
20200528,062846,國泰金富邦9C購01,1.11,1.11,1.03,1.03,-0.07,-6.36,314000,5,325220,0,0,0,0,0,0,299000,15000,284000,284000
20200528,062847,臺股指富邦9B購01,0.94,0.94,0.94,0.94,0.00,0.00,3000,1,2820,0,0,0,0,0,0,3000,0,3000,3000
20200528,062848,臺股指富邦9B購02,,,,,0.00,0.00,0,0,0,0,0,0,0,0,0,0,0,0,0
20200528,062849,中興電永豐9B購02,0.98,1.05,0.95,1.04,+0.11,11.83,1691000,78,1649330,0,0,0,0,0,0,1233000,458000,775000,775000
20200528,06284P,台積電國票98售03,,,,,0.00,0.00,0,0,0,0,0,0,0,0,0,0,0,0,0
20200528,062850,友訊永豐9B購01,0.67,0.67,0.67,0.67,0.00,0.00,60000,3,40200,0,0,0,0,0,0,0,60000,-60000,-60000
20200528,062851,建準永豐9B購02,1.32,1.45,1.21,1.21,0.00,0.00,274000,15,353720,0,0,0,0,0,0,177000,96000,81000,81000
20200528,062852,聯發科永豐9B購02,2.08,2.10,1.91,1.98,-0.06,-2.94,478000,31,990420,0,0,0,0,0,0,431000,47000,384000,384000
20200528,062853,大毅永豐9B購03,0.91,0.93,0.91,0.93,0.00,0.00,12000,4,10950,0,0,0,0,0,0,10000,2000,8000,8000
20200528,062854,日電貿永豐9B購01,0.91,0.91,0.89,0.89,-0.04,-4.3,195000,12,176850,0,0,0,0,0,0,195000,0,195000,195000
20200528,062855,嘉澤永豐9B購02,1.11,1.11,1.06,1.06,-0.04,-3.64,17000,2,18720,0,0,0,0,0,0,3000,14000,-11000,-11000
20200528,062856,世芯永豐9B購02,1.09,1.17,1.09,1.17,-0.02,-1.68,90000,2,102900,0,0,0,0,0,0,30000,60000,-30000,-30000
20200528,062857,SP黃豆國票9C購01,,,,,0.00,0.00,0,0,0,0,0,0,0,0,0,0,0,0,0
20200528,062858,微星國票9B購01,0.93,0.96,0.90,0.96,+0.04,4.35,306000,7,283800,0,0,0,0,0,0,157000,149000,8000,8000
20200528,062859,玉晶光國票01購02,1.98,2.08,1.94,1.97,+0.05,2.6,285000,17,568630,0,0,0,0,0,0,136000,252000,-116000,-116000
20200528,06285P,台積電國票98售04,,,,,0.00,0.00,0,0,0,0,0,0,0,0,0,0,0,0,0
20200528,062860,華擎國票9B購02,3.17,3.30,3.12,3.12,+0.08,2.63,23000,5,73500,0,0,0,0,0,0,16000,7000,9000,9000
20200528,062861,世芯國票9C購01,4.25,4.25,4.00,4.03,-0.31,-7.14,13000,3,53400,0,0,0,0,0,0,8000,5000,3000,3000
20200528,062862,瑞儀國票9B購01,2.87,2.93,2.82,2.82,0.00,0.00,132000,8,379490,0,0,0,0,0,0,66000,66000,0,0
20200528,062863,聯茂國票9B購01,1.30,1.40,1.30,1.40,+0.11,8.53,70000,7,94040,0,0,0,0,0,0,42000,28000,14000,14000
20200528,062864,臺股指國票9B購21,3.10,3.10,2.75,2.81,-0.17,-5.7,49000,5,139070,0,0,0,0,0,0,3000,46000,-43000,-43000
20200528,062865,臺股指國票9B購22,,,,,0.00,0.00,0,0,0,0,0,0,0,0,0,0,0,0,0
20200528,062866,臺股指國票9B購23,,,,,0.00,0.00,0,0,0,0,0,0,0,0,0,0,0,0,0
20200528,062867,東元中信9B購01,0.90,0.97,0.88,0.90,0.00,0.00,152000,16,137090,0,0,0,0,0,0,81000,71000,10000,10000
20200528,062868,葡萄王中信9B購01,0.69,0.69,0.69,0.69,0.00,0.00,85000,1,58650,0,0,0,0,0,0,0,85000,-85000,-85000
20200528,062869,帆宣中信9B購01,1.24,1.24,1.14,1.16,+0.09,8.41,215000,11,255720,0,0,0,0,0,0,118000,97000,21000,21000
20200528,06286P,世芯國票97售02,0.29,0.31,0.29,0.31,+0.01,3.33,110000,3,33500,0,0,0,0,0,0,30000,80000,-50000,-50000
20200528,062870,亞德客兆豐9C購01,1.38,1.44,1.26,1.26,-0.11,-8.03,646000,36,903860,0,0,0,0,0,0,532000,129000,403000,403000
20200528,062871,大成鋼兆豐9B購01,1.07,1.24,1.07,1.20,+0.10,9.09,555000,23,644230,0,0,0,0,0,0,0,555000,-555000,-555000
20200528,062872,華通兆豐9C購01,0.89,0.97,0.89,0.93,+0.07,8.14,27000,5,25290,0,0,0,0,0,0,13000,14000,-1000,-1000
20200528,062873,國巨兆豐9C購01,,,,,0.00,0.00,0,0,0,0,0,0,0,0,0,0,0,0,0
20200528,062874,微星兆豐9B購01,1.13,1.15,1.09,1.15,+0.05,4.55,103000,7,116590,0,0,0,0,0,0,40000,63000,-23000,-23000
20200528,062875,瑞昱兆豐9C購01,1.41,1.42,1.41,1.41,+0.07,5.22,205000,6,289750,0,0,0,0,0,0,11000,194000,-183000,-183000
20200528,062876,全新兆豐9B購01,,,,,0.00,0.00,0,0,0,0,0,0,0,0,0,0,0,0,0
20200528,062877,可成兆豐9C購01,1.02,1.03,0.97,0.97,-0.03,-3.0,386000,12,385830,0,0,0,0,0,0,351000,36000,315000,315000
20200528,062878,宏達電兆豐9B購01,1.59,1.59,1.49,1.49,-0.07,-4.49,121000,4,183810,0,0,0,0,0,0,36000,85000,-49000,-49000
20200528,062879,美食兆豐9B購01,1.69,1.69,1.58,1.58,-0.07,-4.24,71000,3,114460,0,0,0,0,0,0,1000,70000,-69000,-69000
20200528,06287P,臺股指國票97售01,,,,,0.00,0.00,0,0,0,0,0,0,0,0,0,0,0,0,0
20200528,062880,大立光兆豐9B購02,,,,,0.00,0.00,0,0,0,0,0,0,0,0,0,0,0,0,0
20200528,062881,緯創兆豐9C購01,1.26,1.30,1.24,1.25,-0.01,-0.79,320000,23,408260,0,0,0,0,0,0,167000,128000,39000,39000
20200528,062882,新日興兆豐9C購01,1.30,1.39,1.30,1.31,+0.04,3.15,751000,33,1010820,0,0,0,0,0,0,132000,636000,-504000,-504000
20200528,062883,智易兆豐9C購01,1.14,1.21,1.11,1.11,+0.02,1.83,333000,16,387190,0,0,0,0,0,0,173000,160000,13000,13000
20200528,062884,康控兆豐9C購01,0.90,0.90,0.90,0.90,-0.03,-3.23,11000,2,9900,0,0,0,0,0,0,0,11000,-11000,-11000
20200528,062885,臻鼎兆豐9C購01,0.94,0.94,0.85,0.86,-0.05,-5.49,546000,20,496220,0,0,0,0,0,0,210000,336000,-126000,-126000
20200528,062886,中興電群益9B購01,,,,,0.00,0.00,0,0,0,0,0,0,0,0,0,0,0,0,0
20200528,062887,台積電群益9C購05,1.06,1.06,1.06,1.06,+0.01,0.95,1000,1,1060,0,0,0,0,0,0,1000,0,1000,1000
20200528,062888,漢唐群益9B購01,1.45,1.45,1.42,1.44,-0.06,-4.0,266000,5,377890,0,0,0,0,0,0,5000,261000,-256000,-256000
20200528,062889,可成群益9C購01,1.10,1.10,1.10,1.10,-0.01,-0.9,310000,1,341000,0,0,0,0,0,0,310000,310000,0,0
20200528,06288P,臺股指國票97售02,,,,,0.00,0.00,0,0,0,0,0,0,0,0,0,0,0,0,0
20200528,062890,祥碩群益9B購04,1.53,1.73,1.53,1.67,+0.21,14.38,1714000,38,2855570,0,0,0,0,0,0,1131000,769000,362000,362000
20200528,062891,台汽電群益9B購01,1.40,1.40,1.40,1.40,-0.03,-2.1,31000,1,43400,0,0,0,0,0,0,31000,31000,0,0
20200528,062892,臺指反元大02購13,,,,,0.00,0.00,0,0,0,0,0,0,0,0,0,0,0,0,0
20200528,062893,元金2X元大9C購01,,,,,0.00,0.00,0,0,0,0,0,0,0,0,0,0,0,0,0
20200528,062894,道瓊銀元大9B購02,1.44,1.44,1.44,1.44,0.00,0.00,1000,1,1440,0,0,0,0,0,0,0,1000,-1000,-1000
20200528,062895,道瓊銀元大9C購01,1.71,1.71,1.68,1.68,0.00,0.00,11000,5,18660,0,0,0,0,0,0,0,11000,-11000,-11000
20200528,062896,中興電元大9B購01,2.08,2.37,2.08,2.32,+0.27,13.17,1909000,107,4239990,0,0,0,0,0,0,558000,1060000,-502000,-502000
20200528,062897,上銀元大9B購06,2.85,2.86,2.78,2.78,+0.04,1.46,71000,6,201530,0,0,0,0,0,0,71000,0,71000,71000
20200528,062898,華通元大9B購05,2.05,2.13,1.99,2.00,+0.15,8.11,185000,16,380350,0,0,0,0,0,0,0,183000,-183000,-183000
20200528,062899,鴻海元大9C購04,,,,,0.00,0.00,0,0,0,0,0,0,0,0,0,0,0,0,0
20200528,06289P,臺股指國票97售03,,,,,0.00,0.00,0,0,0,0,0,0,0,0,0,0,0,0,0
20200528,062900,台積電元大9B購04,,,,,0.00,0.00,0,0,0,0,0,0,0,0,0,0,0,0,0
20200528,062901,台積電元大9B購05,,,,,0.00,0.00,0,0,0,0,0,0,0,0,0,0,0,0,0
20200528,062902,智邦元大9B購07,4.62,4.90,4.14,4.14,+0.21,5.34,124000,19,588440,0,0,0,0,0,0,82000,77000,5000,5000
20200528,062903,燿華元大9B購04,2.13,2.13,2.06,2.06,-0.02,-0.96,135000,11,283050,0,0,0,0,0,0,135000,0,135000,135000
20200528,062904,台光電元大9B購06,1.96,1.96,1.80,1.80,-0.15,-7.69,142000,8,271470,0,0,0,0,0,0,0,142000,-142000,-142000
20200528,062905,聯發科元大9B購13,4.48,4.51,4.32,4.32,-0.05,-1.14,31000,4,139020,0,0,0,0,0,0,31000,1000,30000,30000
20200528,062906,全新元大9B購03,1.71,1.71,1.67,1.70,-0.04,-2.3,282000,16,477040,0,0,0,0,0,0,282000,36000,246000,246000
20200528,062907,可成元大9C購03,1.85,1.85,1.76,1.78,-0.03,-1.66,157000,16,285430,0,0,0,0,0,0,110000,47000,63000,63000
20200528,062908,晶豪科元大9B購03,1.43,1.53,1.39,1.40,-0.05,-3.45,513000,12,756680,0,0,0,0,0,0,228000,285000,-57000,-57000
20200528,062909,大立光元大9C購04,1.41,1.41,1.41,1.41,-0.01,-0.7,20000,1,28200,0,0,0,0,0,0,0,20000,-20000,-20000
20200528,06290P,臺股指國票97售04,,,,,0.00,0.00,0,0,0,0,0,0,0,0,0,0,0,0,0
20200528,062910,亞光元大9B購01,2.40,2.45,2.27,2.27,-0.09,-3.81,133000,9,319680,0,0,0,0,0,0,53000,80000,-27000,-27000
20200528,062911,聯詠元大9B購03,1.68,1.69,1.65,1.67,0.00,0.00,258000,7,429760,0,0,0,0,0,0,172000,90000,82000,82000
20200528,062912,新日興元大9B購01,1.78,1.90,1.77,1.80,+0.10,5.88,333000,21,612050,0,0,0,0,0,0,69000,264000,-195000,-195000
20200528,062913,創意元大9B購02,2.29,2.36,2.22,2.23,+0.01,0.45,541000,74,1229650,0,0,0,0,0,0,54000,477000,-423000,-423000
20200528,062914,嘉澤元大9B購02,2.90,2.90,2.76,2.87,-0.01,-0.35,44000,4,127300,0,0,0,0,0,0,2000,42000,-40000,-40000
20200528,062915,嘉澤元大9B購03,2.12,2.12,1.99,1.99,-0.14,-6.57,89000,5,184850,0,0,0,0,0,0,4000,85000,-81000,-81000
20200528,062916,智易元大9B購01,2.65,2.86,2.60,2.60,0.00,0.00,361000,23,995170,0,0,0,0,0,0,116000,297000,-181000,-181000
20200528,062917,旭富元大9C購03,2.07,2.12,2.07,2.08,-0.01,-0.48,150000,3,313500,0,0,0,0,0,0,50000,100000,-50000,-50000
20200528,062918,祥碩元大9C購02,4.42,4.60,4.42,4.60,-0.25,-5.15,18000,3,80640,0,0,0,0,0,0,2000,18000,-16000,-16000
20200528,062919,聯茂元大9B購01,1.73,1.76,1.73,1.74,+0.04,2.35,165000,6,286920,0,0,0,0,0,0,27000,138000,-111000,-111000
20200528,06291P,臺股指國票97售05,,,,,0.00,0.00,0,0,0,0,0,0,0,0,0,0,0,0,0
20200528,062920,康友元大9B購01,,,,,0.00,0.00,0,0,0,0,0,0,0,0,0,0,0,0,0
20200528,062921,GIS元大9B購01,2.45,2.45,2.09,2.16,-0.11,-4.85,1226000,53,2817990,0,0,0,0,0,0,653000,496000,157000,157000
20200528,062922,南六元大9B購03,1.61,1.61,1.55,1.55,-0.05,-3.12,90000,2,140820,0,0,0,0,0,0,22000,68000,-46000,-46000
20200528,062923,緯穎元大9B購06,3.92,3.99,3.83,3.83,+0.01,0.26,42000,8,165460,0,0,0,0,0,0,33000,12000,21000,21000
20200528,062924,世紀鋼元大9C購04,1.34,1.59,1.33,1.51,+0.16,11.85,1095000,48,1590870,0,0,0,0,0,0,686000,776000,-90000,-90000
20200528,062925,建準國票9B購01,3.70,4.30,3.63,3.63,-0.06,-1.63,179000,9,706810,0,0,0,0,0,0,48000,131000,-83000,-83000
20200528,062926,嘉澤國票9B購01,4.41,4.41,4.15,4.15,-0.52,-11.13,31000,2,131770,0,0,0,0,0,0,31000,0,31000,31000
20200528,062927,同欣電國票9B購02,2.29,2.32,2.17,2.20,-0.26,-10.57,182000,10,412880,0,0,0,0,0,0,136000,46000,90000,90000
20200528,062928,富邦金台新9B購02,1.10,1.10,1.03,1.03,-0.11,-9.65,36000,6,39350,0,0,0,0,0,0,36000,14000,22000,22000
20200528,062929,SP黃豆統一9B購01,,,,,0.00,0.00,0,0,0,0,0,0,0,0,0,0,0,0,0
20200528,06292P,臺股指國票97售06,,,,,0.00,0.00,0,0,0,0,0,0,0,0,0,0,0,0,0
20200528,062930,旺宏統一9C購02,0.98,0.98,0.91,0.91,-0.07,-7.14,50000,15,48250,0,0,0,0,0,0,40000,10000,30000,30000
20200528,062931,上証2X凱基01購01,,,,,0.00,0.00,0,0,0,0,0,0,0,0,0,0,0,0,0
20200528,062932,滬深2X凱基01購01,,,,,0.00,0.00,0,0,0,0,0,0,0,0,0,0,0,0,0
20200528,062933,滬深2X凱基9B購07,,,,,0.00,0.00,0,0,0,0,0,0,0,0,0,0,0,0,0
20200528,062934,大成鋼凱基9B購02,1.88,2.09,1.88,1.95,+0.01,0.52,203000,36,409860,0,0,0,0,0,0,0,203000,-203000,-203000
20200528,062935,華通凱基9C購02,1.44,1.52,1.39,1.42,+0.12,9.23,276000,14,406470,0,0,0,0,0,0,8000,276000,-268000,-268000
20200528,062936,鴻海凱基9B購07,1.44,1.45,1.44,1.45,+0.05,3.57,40000,3,57700,0,0,0,0,0,0,40000,30000,10000,10000
20200528,062937,旺宏凱基9B購08,3.29,3.34,3.09,3.09,-0.29,-8.58,132000,25,430280,0,0,0,0,0,0,132000,46000,86000,86000
20200528,062938,聯發科凱基9B購10,3.52,3.52,3.23,3.23,-0.15,-4.44,66000,7,224140,0,0,0,0,0,0,38000,48000,-10000,-10000
20200528,062939,奇力新凱基9B購02,2.24,2.24,2.11,2.11,-0.18,-7.86,66000,2,140560,0,0,0,0,0,0,10000,56000,-46000,-46000
20200528,06293P,臺股指國票97售07,,,,,0.00,0.00,0,0,0,0,0,0,0,0,0,0,0,0,0
20200528,062940,華新科凱基9C購02,,,,,0.00,0.00,0,0,0,0,0,0,0,0,0,0,0,0,0
20200528,062941,大立光凱基9B購07,,,,,0.00,0.00,0,0,0,0,0,0,0,0,0,0,0,0,0
20200528,062942,嘉澤凱基9B購02,,,,,0.00,0.00,0,0,0,0,0,0,0,0,0,0,0,0,0
20200528,062943,世芯凱基9B購03,1.86,1.86,1.86,1.86,-0.12,-6.06,1000,1,1860,0,0,0,0,0,0,1000,1000,0,0
20200528,062944,茂林凱基9B購02,3.06,3.06,3.01,3.06,-0.72,-19.05,70000,15,213500,0,0,0,0,0,0,70000,0,70000,70000
20200528,062945,世芯國泰01購01,1.62,1.62,1.59,1.61,+0.02,1.26,11000,4,17720,0,0,0,0,0,0,5000,11000,-6000,-6000
20200528,062946,祥碩國泰9C購02,2.39,2.59,2.39,2.53,+0.19,8.12,621000,29,1560730,0,0,0,0,0,0,154000,609000,-455000,-455000
20200528,062947,國巨富邦01購01,0.65,0.67,0.62,0.63,-0.02,-3.08,1007000,32,648840,0,0,0,0,0,0,605000,392000,213000,213000
20200528,062948,台積電富邦01購02,0.75,0.76,0.71,0.71,-0.03,-4.05,67000,5,49030,0,0,0,0,0,0,35000,32000,3000,3000
20200528,062949,聯發科富邦01購01,0.96,0.96,0.91,0.95,0.00,0.00,28000,6,26220,0,0,0,0,0,0,2000,26000,-24000,-24000
20200528,06294P,臺股指國票97售08,,,,,0.00,0.00,0,0,0,0,0,0,0,0,0,0,0,0,0
20200528,062950,貿聯富邦01購01,0.92,0.94,0.88,0.91,0.00,0.00,1476000,53,1360580,0,0,0,0,0,0,557000,849000,-292000,-292000
20200528,062951,鴻海永豐9B購02,,,,,0.00,0.00,0,0,0,0,0,0,0,0,0,0,0,0,0
20200528,062952,台積電永豐9B購02,,,,,0.00,0.00,0,0,0,0,0,0,0,0,0,0,0,0,0
20200528,062953,大立光永豐9B購01,,,,,0.00,0.00,0,0,0,0,0,0,0,0,0,0,0,0,0
20200528,062954,世芯永豐9B購03,1.00,1.00,0.96,0.96,-0.02,-2.04,25000,2,24200,0,0,0,0,0,0,25000,5000,20000,20000
20200528,062955,立積永豐9B購02,0.78,0.80,0.78,0.78,-0.04,-4.88,599000,21,468970,0,0,0,0,0,0,514000,85000,429000,429000
20200528,062956,同欣電永豐9B購02,0.87,0.87,0.85,0.85,-0.03,-3.41,57000,5,48650,0,0,0,0,0,0,57000,0,57000,57000
20200528,062957,鴻海麥證9C購01,,,,,0.00,0.00,0,0,0,0,0,0,0,0,0,0,0,0,0
20200528,062958,長榮航麥證9B購01,1.08,1.08,1.08,1.08,-0.07,-6.09,10000,4,10800,10000,0,10000,0,0,0,10000,0,10000,10000
20200528,062959,上証2X元富9B購01,,,,,0.00,0.00,0,0,0,0,0,0,0,0,0,0,0,0,0
20200528,06295P,國巨元大97售14,,,,,0.00,0.00,0,0,0,0,0,0,0,0,0,0,0,0,0
20200528,062960,上証2X元富9B購02,,,,,0.00,0.00,0,0,0,0,0,0,0,0,0,0,0,0,0
20200528,062961,S&P反1元富9B購01,,,,,0.00,0.00,0,0,0,0,0,0,0,0,0,0,0,0,0
20200528,062962,道瓊反元富9B購01,,,,,0.00,0.00,0,0,0,0,0,0,0,0,0,0,0,0,0
20200528,062963,道瓊反元富9B購02,,,,,0.00,0.00,0,0,0,0,0,0,0,0,0,0,0,0,0
20200528,062964,FBVIX元富9B購01,,,,,0.00,0.00,0,0,0,0,0,0,0,0,0,0,0,0,0
20200528,062965,FBVIX元富9C購01,,,,,0.00,0.00,0,0,0,0,0,0,0,0,0,0,0,0,0
20200528,062966,元金2X元富9B購02,,,,,0.00,0.00,0,0,0,0,0,0,0,0,0,0,0,0,0
20200528,062967,上銀元富9B購01,3.52,3.73,3.16,3.16,-0.45,-12.47,414000,51,1456070,0,0,0,0,0,0,256000,213000,43000,43000
20200528,062968,仁寶元富9B購01,1.79,1.79,1.78,1.78,-0.04,-2.2,228000,5,407620,0,0,0,0,0,0,178000,50000,128000,128000
20200528,062969,旺宏元富9B購01,1.72,1.74,1.63,1.63,-0.12,-6.86,270000,17,460490,0,0,0,0,0,0,235000,35000,200000,200000
20200528,06296P,燿華元大98售01,1.72,1.76,1.72,1.76,-0.01,-0.56,29000,2,51000,0,0,0,0,0,0,0,29000,-29000,-29000
20200528,062970,智邦元富9B購01,2.74,2.89,2.48,2.48,+0.11,4.64,492000,21,1357250,0,0,0,0,0,0,106000,411000,-305000,-305000
20200528,062971,英業達元富9B購01,2.52,2.53,2.38,2.38,-0.06,-2.46,381000,16,944780,0,0,0,0,0,0,233000,148000,85000,85000
20200528,062972,京元電元富9B購01,,,,,0.00,0.00,0,0,0,0,0,0,0,0,0,0,0,0,0
20200528,062973,聯發科元富05購01,3.50,3.50,3.32,3.32,-0.14,-4.05,133000,4,452500,0,0,0,0,0,0,83000,50000,33000,33000
20200528,062974,奇力新元富9B購01,2.32,2.32,2.15,2.15,-0.21,-8.9,131000,4,295320,0,0,0,0,0,0,33000,98000,-65000,-65000
20200528,062975,京鼎元富9B購01,2.37,2.37,2.21,2.21,-0.11,-4.74,522000,12,1208660,0,0,0,0,0,0,306000,216000,90000,90000
20200528,062976,嘉澤元富9B購01,1.56,1.56,1.47,1.47,-0.07,-4.55,295000,9,448280,0,0,0,0,0,0,238000,57000,181000,181000
20200528,062977,健策元富9B購01,2.11,2.19,1.94,1.94,-0.09,-4.43,299000,35,620600,0,0,0,0,0,0,263000,34000,229000,229000
20200528,062978,世芯元富9B購01,1.43,1.43,1.36,1.36,-0.03,-2.16,90000,2,128560,0,0,0,0,0,0,88000,2000,86000,86000
20200528,062979,茂林元富9B購01,3.08,3.11,2.95,2.95,-0.61,-17.13,362000,42,1117670,0,0,0,0,0,0,294000,68000,226000,226000
20200528,06297P,美律元大97售01,,,,,0.00,0.00,0,0,0,0,0,0,0,0,0,0,0,0,0
20200528,062980,康控元富9B購01,1.40,1.40,1.38,1.38,+0.01,0.73,271000,5,377520,0,0,0,0,0,0,172000,99000,73000,73000
20200528,062981,祥碩元富9B購01,1.74,1.93,1.70,1.90,+0.15,8.57,922000,36,1711160,0,0,0,0,0,0,24000,898000,-874000,-874000
20200528,062982,同欣電元富9B購01,2.64,2.64,2.50,2.50,-0.17,-6.37,322000,10,843300,0,0,0,0,0,0,246000,76000,170000,170000
20200528,062983,緯穎元富9B購01,3.23,3.23,3.17,3.19,-0.08,-2.45,110000,20,350930,0,0,0,0,0,0,95000,5000,90000,90000
20200528,062984,致新元富9B購01,2.58,2.86,2.58,2.83,+0.35,14.11,1436000,99,3891590,0,0,0,0,0,0,641000,768000,-127000,-127000
20200528,062985,元金2X第一9B購02,,,,,0.00,0.00,0,0,0,0,0,0,0,0,0,0,0,0,0
20200528,062986,T50反1中信02購01,1.20,1.27,1.20,1.26,0.00,0.00,203000,5,254680,0,0,0,0,0,0,10000,193000,-183000,-183000
20200528,062987,祥碩中信01購01,0.64,0.69,0.60,0.68,+0.06,9.68,250000,10,164360,0,0,0,0,0,0,127000,123000,4000,4000
20200528,062988,儒鴻群益9B購01,3.71,3.71,3.34,3.34,-0.33,-8.99,153000,20,550990,0,0,0,0,0,0,120000,83000,37000,37000
20200528,062989,鴻海群益9B購07,,,,,0.00,0.00,0,0,0,0,0,0,0,0,0,0,0,0,0
20200528,06298P,聯發科元大97售20,,,,,0.00,0.00,0,0,0,0,0,0,0,0,0,0,0,0,0
20200528,062990,台積電群益9B購06,4.64,4.64,4.18,4.18,-0.36,-7.93,199000,11,856080,0,0,0,0,0,0,49000,156000,-107000,-107000
20200528,062991,台光電群益9B購03,1.37,1.37,1.37,1.37,-0.14,-9.27,3000,1,4110,0,0,0,0,0,0,0,3000,-3000,-3000
20200528,062992,聯發科群益9B購09,3.70,3.70,3.36,3.36,-0.16,-4.55,114000,13,411240,0,0,0,0,0,0,114000,0,114000,114000
20200528,062993,華新科群益9B購05,1.58,1.58,1.58,1.58,0.00,0.00,4000,1,6320,0,0,0,0,0,0,4000,4000,0,0
20200528,062994,祥碩群益9B購05,1.85,2.16,1.85,2.13,-0.17,-7.39,69000,5,141620,0,0,0,0,0,0,2000,69000,-67000,-67000
20200528,062995,聚陽國票9C購01,4.00,4.09,3.85,3.85,-0.38,-8.98,123000,7,494670,0,0,0,0,0,0,79000,44000,35000,35000
20200528,062996,致茂國票9C購01,2.15,2.17,2.15,2.17,+0.04,1.88,47000,4,101270,0,0,0,0,0,0,36000,11000,25000,25000
20200528,062997,嘉晶國票9B購03,,,,,0.00,0.00,0,0,0,0,0,0,0,0,0,0,0,0,0
20200528,062998,泰碩國票01購01,0.96,0.99,0.96,0.99,-0.02,-1.98,64000,3,62730,0,0,0,0,0,0,29000,35000,-6000,-6000
20200528,062999,聯茂國票9C購01,2.52,2.70,2.52,2.70,+0.11,4.25,163000,12,428970,0,0,0,0,0,0,43000,120000,-77000,-77000
20200528,06299P,可成元大97售04,,,,,0.00,0.00,0,0,0,0,0,0,0,0,0,0,0,0,0
20200528,063000,緯穎國票9B購03,,,,,0.00,0.00,0,0,0,0,0,0,0,0,0,0,0,0,0
20200528,063001,巨大國票9B購01,6.10,6.10,6.10,6.10,0.00,0.00,4000,1,24400,0,0,0,0,0,0,0,4000,-4000,-4000
20200528,063002,上証2X元大9B購03,,,,,0.00,0.00,0,0,0,0,0,0,0,0,0,0,0,0,0
20200528,063003,滬深2X元大9B購06,,,,,0.00,0.00,0,0,0,0,0,0,0,0,0,0,0,0,0
20200528,063004,臺指反元大02購14,,,,,0.00,0.00,0,0,0,0,0,0,0,0,0,0,0,0,0
20200528,063005,道瓊反元大9B購02,1.07,1.07,1.07,1.07,0.00,0.00,499000,2,533930,0,0,0,0,0,0,0,499000,-499000,-499000
20200528,063006,道瓊反元大9C購01,0.90,0.91,0.90,0.90,0.00,0.00,599000,4,544090,0,0,0,0,0,0,0,599000,-599000,-599000
20200528,063007,儒鴻元大9B購01,5.20,5.20,4.63,4.63,-0.47,-9.22,61000,9,308180,0,0,0,0,0,0,49000,12000,37000,37000
20200528,063008,華通元大9B購06,2.37,2.59,2.37,2.42,+0.16,7.08,120000,12,298930,0,0,0,0,0,0,25000,114000,-89000,-89000
20200528,063009,國巨元大9B購18,1.92,1.92,1.92,1.92,-0.05,-2.54,100000,1,192000,0,0,0,0,0,0,100000,0,100000,100000
20200528,06300P,緯穎元大97售04,,,,,0.00,0.00,0,0,0,0,0,0,0,0,0,0,0,0,0
20200528,063010,國巨元大9C購02,1.60,1.60,1.60,1.60,+0.02,1.27,13000,1,20800,0,0,0,0,0,0,13000,0,13000,13000
20200528,063011,台積電元大9C購01,2.14,2.14,2.13,2.13,+0.02,0.95,28000,3,59690,0,0,0,0,0,0,5000,23000,-18000,-18000
20200528,063012,技嘉元大9B購01,2.70,2.70,2.41,2.41,-0.43,-15.14,38000,14,97620,0,0,0,0,0,0,1000,37000,-36000,-36000
20200528,063013,技嘉元大9B購02,1.82,1.82,0.97,1.63,-0.18,-9.94,363000,25,615980,0,0,0,0,0,0,190000,140000,50000,50000
20200528,063014,技嘉元大9B購03,2.26,2.26,2.26,2.26,-0.16,-6.61,25000,2,56500,0,0,0,0,0,0,25000,0,25000,25000
20200528,063015,微星元大9B購01,,,,,0.00,0.00,0,0,0,0,0,0,0,0,0,0,0,0,0
20200528,063016,微星元大9C購02,2.00,2.06,1.97,2.06,+0.11,5.64,349000,23,699140,0,0,0,0,0,0,160000,179000,-19000,-19000
20200528,063017,台光電元大9B購07,2.12,2.12,2.06,2.06,-0.16,-7.21,12000,2,24840,0,0,0,0,0,0,12000,0,12000,12000
20200528,063018,聯發科元大9B購14,3.62,3.62,3.62,3.62,+0.10,2.84,1000,1,3620,0,0,0,0,0,0,1000,1000,0,0
20200528,063019,聯發科元大9C購01,2.43,2.45,2.27,2.27,-0.13,-5.42,111000,8,266240,0,0,0,0,0,0,101000,11000,90000,90000
20200528,06301P,臺股指元大97售04,,,,,0.00,0.00,0,0,0,0,0,0,0,0,0,0,0,0,0
20200528,063020,奇力新元大9B購04,2.06,2.06,2.02,2.02,0.00,0.00,68000,3,139920,0,0,0,0,0,0,0,68000,-68000,-68000
20200528,063021,大立光元大9C購05,,,,,0.00,0.00,0,0,0,0,0,0,0,0,0,0,0,0,0
20200528,063022,嘉晶元大9B購04,3.25,3.25,3.00,3.05,-0.14,-4.39,328000,27,1031450,0,0,0,0,0,0,184000,144000,40000,40000
20200528,063023,華擎元大9B購02,2.03,2.03,1.92,1.92,-0.02,-1.03,115000,9,228290,0,0,0,0,0,0,95000,24000,71000,71000
20200528,063024,祥碩元大9B購05,2.40,2.65,2.31,2.56,+0.23,9.87,241000,15,609460,0,0,0,0,0,0,92000,217000,-125000,-125000
20200528,063025,超眾元大9B購01,1.65,1.70,1.62,1.63,-0.09,-5.23,58000,4,95430,0,0,0,0,0,0,48000,47000,1000,1000
20200528,063026,南六元大9B購04,1.49,1.49,1.43,1.46,+0.02,1.39,100000,7,146000,0,0,0,0,0,0,100000,0,100000,100000
20200528,063027,台汽電元大9B購01,1.85,1.85,1.85,1.85,-0.07,-3.65,31000,1,57350,0,0,0,0,0,0,31000,31000,0,0
20200528,063028,巨大元大9B購02,3.22,3.31,3.22,3.22,-0.10,-3.01,77000,3,251990,0,0,0,0,0,0,32000,77000,-45000,-45000
20200528,063029,喬山凱基9B購01,2.15,2.15,1.88,1.88,-0.20,-9.62,146000,12,305180,0,0,0,0,0,0,109000,37000,72000,72000
20200528,06302P,臺股指元大97售06,,,,,0.00,0.00,0,0,0,0,0,0,0,0,0,0,0,0,0
20200528,063030,華通凱基9B購03,1.53,1.69,1.53,1.68,+0.24,16.67,207000,17,344910,0,0,0,0,0,0,10000,199000,-189000,-189000
20200528,063031,鴻海凱基9C購01,2.53,2.53,2.53,2.53,+0.09,3.69,6000,1,15180,0,0,0,0,0,0,6000,6000,0,0
20200528,063032,國巨凱基9C購04,,,,,0.00,0.00,0,0,0,0,0,0,0,0,0,0,0,0,0
20200528,063033,台積電凱基9B購09,,,,,0.00,0.00,0,0,0,0,0,0,0,0,0,0,0,0,0
20200528,063034,致茂凱基9B購01,1.64,1.71,1.64,1.71,-0.02,-1.16,20000,2,33500,0,0,0,0,0,0,10000,10000,0,0
20200528,063035,燿華凱基9B購02,1.88,1.88,1.88,1.88,-0.01,-0.53,18000,1,33840,0,0,0,0,0,0,0,18000,-18000,-18000
20200528,063036,聯發科凱基9B購11,2.76,2.76,2.57,2.58,-0.19,-6.86,174000,11,461260,0,0,0,0,0,0,173000,1000,172000,172000
20200528,063037,聯發科凱基9C購02,2.58,2.58,2.41,2.48,-0.07,-2.75,204000,15,507070,0,0,0,0,0,0,201000,2000,199000,199000
20200528,063038,富邦金凱基9B購02,2.54,2.54,2.54,2.54,+0.06,2.42,13000,2,33020,0,0,0,0,0,0,13000,0,13000,13000
20200528,063039,大立光凱基9C購02,1.49,1.49,1.42,1.42,-0.11,-7.19,23000,3,34070,0,0,0,0,0,0,19000,4000,15000,15000
20200528,06303P,臺股指元大97售09,9.15,9.15,9.15,9.15,0.00,0.00,1000,1,9150,0,0,0,0,0,0,0,1000,-1000,-1000
20200528,063040,聯詠凱基9B購03,3.44,3.44,3.44,3.44,+0.02,0.58,3000,1,10320,0,0,0,0,0,0,3000,3000,0,0
20200528,063041,貿聯凱基9B購01,2.64,2.71,2.53,2.53,-0.09,-3.44,280000,24,735120,0,0,0,0,0,0,112000,168000,-56000,-56000
20200528,063042,同欣電凱基9C購01,1.98,2.00,1.92,1.92,-0.09,-4.48,39000,5,77000,0,0,0,0,0,0,26000,13000,13000,13000
20200528,063043,台灣50兆豐9B購02,,,,,0.00,0.00,0,0,0,0,0,0,0,0,0,0,0,0,0
20200528,063044,滬深2X兆豐9C購01,0.89,0.90,0.89,0.90,0.00,0.00,100000,2,89150,0,0,0,0,0,0,85000,15000,70000,70000
20200528,063045,國巨兆豐9C購02,1.85,1.86,1.74,1.74,-0.07,-3.87,298000,7,538400,0,0,0,0,0,0,8000,290000,-282000,-282000
20200528,063046,聯發科兆豐9C購01,1.75,1.75,1.71,1.71,-0.04,-2.29,68000,2,118880,0,0,0,0,0,0,65000,3000,62000,62000
20200528,063047,大立光兆豐9B購03,1.24,1.24,1.23,1.23,+0.05,4.24,40000,3,49440,0,0,0,0,0,0,40000,0,40000,40000
20200528,063048,聯詠兆豐9B購01,1.43,1.43,1.38,1.38,-0.06,-4.17,182000,9,253390,0,0,0,0,0,0,169000,12000,157000,157000
20200528,063049,上海銀兆豐9B購01,1.17,1.19,1.15,1.15,-0.02,-1.71,53000,6,61970,0,0,0,0,0,0,40000,13000,27000,27000
20200528,06304P,臺股指元大97售10,,,,,0.00,0.00,0,0,0,0,0,0,0,0,0,0,0,0,0
20200528,063050,葡萄王統一01購01,0.85,0.85,0.83,0.83,-0.04,-4.6,116000,2,98480,0,0,0,0,0,0,110000,6000,104000,104000
20200528,063051,仁寶統一01購01,0.74,0.74,0.74,0.74,-0.02,-2.63,467000,3,345580,0,0,0,0,0,0,467000,0,467000,467000
20200528,063052,國巨統一9C購10,1.29,1.29,1.29,1.29,-0.05,-3.73,3000,1,3870,0,0,0,0,0,0,0,3000,-3000,-3000
20200528,063053,聯發科統一01購04,0.85,0.85,0.85,0.85,-0.03,-3.41,20000,1,17000,0,0,0,0,0,0,0,20000,-20000,-20000
20200528,063054,健鼎統一01購01,0.90,0.94,0.90,0.91,+0.02,2.25,1068000,27,982890,0,0,0,0,0,0,30000,1038000,-1008000,-1008000
20200528,063055,創意統一9B購02,1.27,1.31,1.22,1.23,+0.01,0.82,1973000,108,2480230,0,0,0,0,0,0,152000,1778000,-1626000,-1626000
20200528,063056,嘉澤統一9C購02,0.87,0.87,0.84,0.84,-0.04,-4.55,31000,3,26570,0,0,0,0,0,0,6000,25000,-19000,-19000
20200528,063057,祥碩統一03購01,0.70,0.73,0.70,0.71,+0.05,7.58,234000,11,165160,0,0,0,0,0,0,2000,232000,-230000,-230000
20200528,063058,A50正2元富02購01,,,,,0.00,0.00,0,0,0,0,0,0,0,0,0,0,0,0,0
20200528,063059,A50正2元富9B購01,,,,,0.00,0.00,0,0,0,0,0,0,0,0,0,0,0,0,0
20200528,06305P,臺股指元大97售11,6.75,6.75,6.65,6.65,-0.30,-4.32,18000,2,120700,0,0,0,0,0,0,18000,0,18000,18000
20200528,063060,華新科元富9B購03,0.90,0.91,0.90,0.91,0.00,0.00,20000,6,18010,0,0,0,0,0,0,20000,0,20000,20000
20200528,063061,華新科元富9B購04,1.00,1.00,1.00,1.00,-0.01,-0.99,20000,8,20000,0,0,0,0,0,0,20000,0,20000,20000
20200528,063062,群創元富9B購01,,,,,0.00,0.00,0,0,0,0,0,0,0,0,0,0,0,0,0
20200528,063063,泰鼎元富9B購01,2.70,2.70,2.55,2.62,-0.01,-0.38,401000,21,1052820,0,0,0,0,0,0,109000,292000,-183000,-183000
20200528,063064,台表科元富9B購01,1.54,1.64,1.46,1.46,-0.10,-6.41,512000,19,810800,0,0,0,0,0,0,318000,194000,124000,124000
20200528,063065,聯發科麥證9C購01,1.25,1.25,1.20,1.21,-0.09,-6.92,290000,9,352380,280000,0,280000,0,0,0,280000,0,280000,280000
20200528,063066,同欣電麥證9B購01,1.51,1.51,1.49,1.49,-0.06,-3.87,63000,3,94870,50000,13000,37000,0,0,0,50000,13000,37000,37000
20200528,063067,緯穎麥證9B購01,1.51,1.51,1.51,1.51,0.00,0.00,10000,1,15100,0,10000,-10000,0,0,0,0,10000,-10000,-10000
20200528,063068,聯發科國泰01購03,1.79,1.79,1.65,1.65,-0.06,-3.51,49000,4,85710,0,0,0,0,0,0,29000,20000,9000,9000
20200528,063069,道瓊銀富邦05購01,0.82,0.82,0.80,0.81,+0.03,3.85,175000,5,142860,0,0,0,0,0,0,8000,167000,-159000,-159000
20200528,06306P,臺股指元大97售12,7.90,7.90,7.90,7.90,0.00,0.00,2000,1,15800,0,0,0,0,0,0,2000,0,2000,2000
20200528,063070,奇力新富邦01購01,,,,,0.00,0.00,0,0,0,0,0,0,0,0,0,0,0,0,0
20200528,063071,華新科富邦02購01,0.72,0.72,0.71,0.72,-0.01,-1.37,20000,18,14240,0,0,0,0,0,0,20000,0,20000,20000
20200528,063072,裕隆永豐9B購01,1.07,1.17,1.07,1.10,+0.03,2.8,878000,21,992940,0,0,0,0,0,0,0,878000,-878000,-878000
20200528,063073,瑞昱永豐9B購01,1.09,1.09,1.09,1.09,+0.05,4.81,20000,1,21800,0,0,0,0,0,0,20000,20000,0,0
20200528,063074,創意永豐9B購02,1.42,1.46,1.38,1.38,-0.02,-1.43,292000,25,414470,0,0,0,0,0,0,119000,176000,-57000,-57000
20200528,063075,祥碩永豐9B購04,0.83,0.95,0.83,0.91,+0.09,10.98,769000,21,696730,0,0,0,0,0,0,88000,682000,-594000,-594000
20200528,063076,柏文永豐9B購02,1.05,1.05,0.99,0.99,-0.06,-5.71,295000,6,293140,0,0,0,0,0,0,219000,10000,209000,209000
20200528,063077,巨大永豐9B購03,1.28,1.28,1.28,1.28,+0.02,1.59,8000,1,10240,0,0,0,0,0,0,0,8000,-8000,-8000
20200528,063078,元金2X凱基02購03,,,,,0.00,0.00,0,0,0,0,0,0,0,0,0,0,0,0,0
20200528,063079,儒鴻凱基9B購01,2.38,2.38,2.15,2.16,-0.18,-7.69,890000,49,2004010,0,0,0,0,0,0,540000,400000,140000,140000
20200528,06307P,聚陽元富97售02,0.70,0.75,0.70,0.75,+0.05,7.14,24000,3,17300,0,0,0,0,0,0,0,14000,-14000,-14000
20200528,063080,裕隆凱基9B購01,0.70,0.77,0.68,0.69,0.00,0.00,155000,15,113190,0,0,0,0,0,0,78000,77000,1000,1000
20200528,063081,技嘉凱基9B購02,1.58,1.58,1.49,1.49,-0.27,-15.34,16000,3,24140,0,0,0,0,0,0,3000,13000,-10000,-10000
20200528,063082,瑞昱凱基9B購04,0.92,0.93,0.92,0.92,0.00,0.00,80000,5,73800,0,0,0,0,0,0,20000,80000,-60000,-60000
20200528,063083,聯發科凱基01購02,,,,,0.00,0.00,0,0,0,0,0,0,0,0,0,0,0,0,0
20200528,063084,可成凱基9C購01,1.83,1.83,1.79,1.79,-0.04,-2.19,4000,2,7240,0,0,0,0,0,0,0,4000,-4000,-4000
20200528,063085,嘉澤凱基9C購01,,,,,0.00,0.00,0,0,0,0,0,0,0,0,0,0,0,0,0
20200528,063086,祥碩凱基9C購01,2.09,2.09,2.07,2.07,-0.05,-2.36,19000,2,39350,0,0,0,0,0,0,1000,19000,-18000,-18000
20200528,063087,南六凱基9C購02,1.12,1.12,1.12,1.12,-0.01,-0.88,20000,2,22400,0,0,0,0,0,0,20000,0,20000,20000
20200528,063088,緯穎凱基9B購04,1.43,1.48,1.33,1.33,-0.07,-5.0,224000,10,316250,0,0,0,0,0,0,196000,224000,-28000,-28000
20200528,063089,巨大凱基9C購01,2.75,2.83,2.75,2.76,+0.01,0.36,76000,3,212690,0,0,0,0,0,0,32000,76000,-44000,-44000
20200528,06308P,國巨元富97售06,,,,,0.00,0.00,0,0,0,0,0,0,0,0,0,0,0,0,0
20200528,063090,道瓊反中信9C購02,0.80,0.81,0.79,0.81,0.00,0.00,130000,5,103400,0,0,0,0,0,0,60000,70000,-10000,-10000
20200528,063091,聯電中信9B購01,0.88,0.93,0.88,0.93,+0.06,6.9,343000,10,306840,0,0,0,0,0,0,85000,258000,-173000,-173000
20200528,063092,聯發科中信9B購03,,,,,0.00,0.00,0,0,0,0,0,0,0,0,0,0,0,0,0
20200528,063093,國產國票9B購01,1.91,1.91,1.86,1.86,-0.07,-3.63,60000,4,114020,0,0,0,0,0,0,47000,13000,34000,34000
20200528,063094,玉晶光國票01購03,3.51,3.72,3.41,3.44,+0.12,3.61,79000,44,281500,0,0,0,0,0,0,53000,71000,-18000,-18000
20200528,063095,健策國票9B購02,2.59,2.59,2.21,2.23,-0.34,-13.23,169000,12,406290,0,0,0,0,0,0,79000,164000,-85000,-85000
20200528,063096,勤誠國票9B購02,3.10,3.10,3.05,3.05,+0.02,0.66,8000,2,24550,0,0,0,0,0,0,3000,5000,-2000,-2000
20200528,063097,台灣50群益01購01,,,,,0.00,0.00,0,0,0,0,0,0,0,0,0,0,0,0,0
20200528,063098,台灣50群益01購02,,,,,0.00,0.00,0,0,0,0,0,0,0,0,0,0,0,0,0
20200528,063099,臺指反群益9B購05,,,,,0.00,0.00,0,0,0,0,0,0,0,0,0,0,0,0,0
20200528,06309P,光罩元富97售03,,,,,0.00,0.00,0,0,0,0,0,0,0,0,0,0,0,0,0
20200528,063100,聚陽群益9C購02,1.95,2.01,1.84,1.84,-0.17,-8.46,448000,26,857380,0,0,0,0,0,0,80000,368000,-288000,-288000
20200528,063101,華通群益9B購07,2.12,2.19,2.12,2.19,+0.31,16.49,36000,2,76390,0,0,0,0,0,0,0,36000,-36000,-36000
20200528,063102,旺宏群益9B購03,1.53,1.58,1.44,1.44,-0.12,-7.69,182000,14,281670,0,0,0,0,0,0,179000,6000,173000,173000
20200528,063103,技嘉群益9B購01,1.56,1.56,1.46,1.46,-0.23,-13.61,10000,2,15100,0,0,0,0,0,0,0,10000,-10000,-10000
20200528,063104,大立光群益9C購02,2.40,2.40,2.38,2.38,+0.02,0.85,20000,2,47800,0,0,0,0,0,0,10000,10000,0,0
20200528,063105,健策群益9C購01,3.51,3.55,3.06,3.12,-0.43,-12.11,191000,17,607070,0,0,0,0,0,0,81000,156000,-75000,-75000
20200528,063106,台表科群益9B購03,2.76,2.76,2.50,2.50,-0.16,-6.02,44000,2,110260,0,0,0,0,0,0,44000,0,44000,44000
20200528,063107,矽創群益9B購01,1.82,2.08,1.82,1.88,+0.19,11.24,1133000,48,2190140,0,0,0,0,0,0,123000,1035000,-912000,-912000
20200528,063108,世紀鋼群益9C購01,1.52,1.79,1.51,1.75,+0.19,12.18,478000,20,830290,0,0,0,0,0,0,7000,471000,-464000,-464000
20200528,063109,T50反1兆豐9B購01,,,,,0.00,0.00,0,0,0,0,0,0,0,0,0,0,0,0,0
20200528,06310P,精元元富97售02,,,,,0.00,0.00,0,0,0,0,0,0,0,0,0,0,0,0,0
20200528,063110,牧德兆豐9B購01,0.95,0.95,0.95,0.95,-0.10,-9.52,2000,1,1900,0,0,0,0,0,0,2000,0,2000,2000
20200528,063111,TPK兆豐9B購01,1.47,1.54,1.47,1.53,+0.05,3.38,350000,15,532950,0,0,0,0,0,0,300000,50000,250000,250000
20200528,063112,祥碩兆豐9B購01,1.22,1.28,1.22,1.22,0.00,0.00,39000,5,48590,0,0,0,0,0,0,0,39000,-39000,-39000
20200528,063113,聯茂兆豐9B購01,1.32,1.41,1.30,1.37,+0.08,6.2,267000,26,368420,0,0,0,0,0,0,50000,217000,-167000,-167000
20200528,063114,南電兆豐9B購01,,,,,0.00,0.00,0,0,0,0,0,0,0,0,0,0,0,0,0
20200528,063115,台積電麥證9B購02,1.20,1.20,1.20,1.20,-0.01,-0.83,10000,1,12000,0,10000,-10000,0,0,0,0,10000,-10000,-10000
20200528,063116,大立光麥證9C購01,,,,,0.00,0.00,0,0,0,0,0,0,0,0,0,0,0,0,0
20200528,063117,聯茂麥證9B購01,1.80,1.82,1.80,1.82,0.00,0.00,55000,2,99540,0,55000,-55000,0,0,0,0,55000,-55000,-55000
20200528,063118,中鋼元大9C購01,1.80,1.84,1.80,1.80,+0.01,0.56,135000,5,244850,0,0,0,0,0,0,0,135000,-135000,-135000
20200528,063119,華通元大9B購07,2.60,2.71,2.53,2.55,+0.18,7.59,140000,7,366250,0,0,0,0,0,0,5000,135000,-130000,-130000
20200528,06311P,嘉聯益元富97售02,,,,,0.00,0.00,0,0,0,0,0,0,0,0,0,0,0,0,0
20200528,063120,台光電元大9C購01,2.26,2.27,2.26,2.27,-0.05,-2.16,66000,3,149660,0,0,0,0,0,0,16000,66000,-50000,-50000
20200528,063121,友達元大9C購09,1.66,1.67,1.60,1.60,-0.06,-3.61,138000,6,229720,0,0,0,0,0,0,25000,113000,-88000,-88000
20200528,063122,聯發科元大9B購15,2.15,2.16,2.07,2.07,-0.02,-0.96,54000,7,115970,0,0,0,0,0,0,54000,1000,53000,53000
20200528,063123,聯發科元大9B購16,2.07,2.07,1.95,1.95,-0.07,-3.47,2000,2,4020,0,0,0,0,0,0,1000,2000,-1000,-1000
20200528,063124,奇力新元大9B購05,,,,,0.00,0.00,0,0,0,0,0,0,0,0,0,0,0,0,0
20200528,063125,華擎元大9C購02,1.94,1.94,1.89,1.89,+0.02,1.07,80000,3,153200,0,0,0,0,0,0,80000,0,80000,80000
20200528,063126,TPK元大9B購01,2.77,2.88,2.74,2.87,+0.18,6.69,102000,12,285550,0,0,0,0,0,0,102000,4000,98000,98000
20200528,063127,TPK元大9B購02,2.37,2.45,2.34,2.40,+0.09,3.9,93000,5,220940,0,0,0,0,0,0,93000,4000,89000,89000
20200528,063128,智伸科元大9B購01,1.96,1.99,1.74,1.74,-0.16,-8.42,741000,29,1382680,0,0,0,0,0,0,679000,62000,617000,617000
20200528,063129,祥碩元大9C購03,3.76,3.93,3.76,3.93,-0.22,-5.3,87000,8,334210,0,0,0,0,0,0,25000,87000,-62000,-62000
20200528,06312P,樺漢元富97售02,,,,,0.00,0.00,0,0,0,0,0,0,0,0,0,0,0,0,0
20200528,063130,聯茂元大9B購02,2.24,2.35,2.22,2.33,+0.14,6.39,118000,7,269740,0,0,0,0,0,0,15000,103000,-88000,-88000
20200528,063131,聯茂元大9B購03,1.68,1.76,1.68,1.71,+0.06,3.64,278000,10,475630,0,0,0,0,0,0,115000,163000,-48000,-48000
20200528,063132,台表科元大9C購02,2.08,2.10,1.88,1.96,-0.06,-2.97,235000,9,465540,0,0,0,0,0,0,185000,147000,38000,38000
20200528,063133,喬山統一01購01,1.03,1.03,0.91,0.92,-0.07,-7.07,983000,35,969600,0,0,0,0,0,0,898000,75000,823000,823000
20200528,063134,裕隆統一01購01,0.91,0.99,0.88,0.90,-0.02,-2.17,1404000,34,1345850,0,0,0,0,0,0,133000,1371000,-1238000,-1238000
20200528,063135,國巨統一9B購16,1.05,1.07,1.00,1.00,-0.01,-0.99,223000,7,236900,0,0,0,0,0,0,5000,218000,-213000,-213000
20200528,063136,智邦統一9B購02,1.26,1.41,1.19,1.22,+0.08,7.02,815000,45,1092270,0,0,0,0,0,0,323000,541000,-218000,-218000
20200528,063137,瑞昱統一01購02,0.84,0.84,0.83,0.84,+0.03,3.7,231000,4,193440,0,0,0,0,0,0,12000,219000,-207000,-207000
20200528,063138,聯發科統一01購05,1.10,1.10,1.02,1.02,-0.06,-5.56,18000,2,19000,0,0,0,0,0,0,0,18000,-18000,-18000
20200528,063139,聯發科統一9B購07,,,,,0.00,0.00,0,0,0,0,0,0,0,0,0,0,0,0,0
20200528,06313P,訊芯元富97售01,,,,,0.00,0.00,0,0,0,0,0,0,0,0,0,0,0,0,0
20200528,063140,聯發科統一9B購08,0.71,0.71,0.71,0.71,0.00,0.00,2000,1,1420,0,0,0,0,0,0,0,2000,-2000,-2000
20200528,063141,聯發科統一9C購10,1.40,1.40,1.40,1.40,0.00,0.00,20000,1,28000,0,0,0,0,0,0,20000,0,20000,20000
20200528,063142,奇力新統一9C購04,0.93,0.94,0.93,0.94,-0.01,-1.05,63000,2,58690,0,0,0,0,0,0,53000,10000,43000,43000
20200528,063143,嘉澤統一9B購02,,,,,0.00,0.00,0,0,0,0,0,0,0,0,0,0,0,0,0
20200528,063144,超眾統一9C購02,1.06,1.11,1.04,1.08,-0.05,-4.42,768000,28,817710,0,0,0,0,0,0,524000,253000,271000,271000
20200528,063145,台表科統一02購01,1.01,1.02,0.95,0.96,-0.04,-4.0,1216000,30,1219150,0,0,0,0,0,0,1179000,37000,1142000,1142000
20200528,063146,南六統一9B購02,0.92,0.97,0.90,0.97,+0.05,5.43,143000,30,132870,0,0,0,0,0,0,108000,58000,50000,50000
20200528,063147,東元元富9B購01,2.35,2.55,2.31,2.34,-0.12,-4.88,488000,83,1185090,0,0,0,0,0,0,337000,151000,186000,186000
20200528,063148,建準元富9B購01,1.90,2.10,1.78,1.78,+0.05,2.89,440000,43,871080,0,0,0,0,0,0,45000,350000,-305000,-305000
20200528,063149,聯發科元富05購02,2.94,2.94,2.94,2.94,+0.07,2.44,15000,2,44100,0,0,0,0,0,0,15000,0,15000,15000
20200528,06314P,GIS元富97售02,,,,,0.00,0.00,0,0,0,0,0,0,0,0,0,0,0,0,0
20200528,063150,聯發科元富05購03,2.75,2.77,2.62,2.62,-0.11,-4.03,40000,4,110550,0,0,0,0,0,0,32000,3000,29000,29000
20200528,063151,奇鋐元富9B購01,2.86,3.18,2.86,3.04,+0.24,8.57,512000,44,1548060,0,0,0,0,0,0,42000,470000,-428000,-428000
20200528,063152,健策元富9C購01,2.26,2.33,2.07,2.07,-0.19,-8.41,360000,50,813910,0,0,0,0,0,0,244000,113000,131000,131000
20200528,063153,南六元富9B購01,2.25,2.35,2.24,2.35,+0.08,3.52,195000,7,444680,0,0,0,0,0,0,67000,128000,-61000,-61000
20200528,063154,南六元富9B購02,2.26,2.38,2.26,2.38,+0.10,4.39,144000,5,335520,0,0,0,0,0,0,60000,84000,-24000,-24000
20200528,063155,緯穎元富9B購03,2.94,3.02,2.71,2.71,-0.27,-9.06,26000,5,76210,0,0,0,0,0,0,11000,15000,-4000,-4000
20200528,063156,台灣50台新9C購05,,,,,0.00,0.00,0,0,0,0,0,0,0,0,0,0,0,0,0
20200528,063157,鴻海台新9B購02,,,,,0.00,0.00,0,0,0,0,0,0,0,0,0,0,0,0,0
20200528,063158,瑞昱台新9B購02,1.75,1.75,1.73,1.73,0.00,0.00,127000,9,221450,0,0,0,0,0,0,20000,127000,-107000,-107000
20200528,063159,嘉澤國泰01購01,1.73,1.75,1.73,1.75,-0.15,-7.89,22000,2,38240,0,0,0,0,0,0,13000,9000,4000,4000
20200528,06315P,臺股指元富97售02,,,,,0.00,0.00,0,0,0,0,0,0,0,0,0,0,0,0,0
20200528,063160,牧德富邦9C購02,,,,,0.00,0.00,0,0,0,0,0,0,0,0,0,0,0,0,0
20200528,063161,祥碩富邦9B購02,0.68,0.71,0.68,0.71,+0.01,1.43,11000,2,7660,0,0,0,0,0,0,6000,5000,1000,1000
20200528,063162,國喬永豐9B購01,0.74,0.75,0.73,0.74,-0.01,-1.33,86000,4,63270,0,0,0,0,0,0,13000,73000,-60000,-60000
20200528,063163,京元電永豐9B購01,1.16,1.16,1.16,1.16,0.00,0.00,58000,1,67280,0,0,0,0,0,0,58000,58000,0,0
20200528,063164,聯發科永豐9B購03,,,,,0.00,0.00,0,0,0,0,0,0,0,0,0,0,0,0,0
20200528,063165,泰碩永豐9B購02,1.03,1.03,1.03,1.03,-0.01,-0.96,5000,1,5150,0,0,0,0,0,0,5000,0,5000,5000
20200528,063166,超眾永豐9B購01,1.41,1.44,1.39,1.43,-0.09,-5.92,243000,11,341650,0,0,0,0,0,0,210000,33000,177000,177000
20200528,063167,同欣電永豐9B購03,1.17,1.17,1.12,1.14,-0.05,-4.2,194000,13,223160,0,0,0,0,0,0,174000,20000,154000,154000
20200528,063168,台表科永豐9B購01,,,,,0.00,0.00,0,0,0,0,0,0,0,0,0,0,0,0,0
20200528,063169,台汽電永豐9B購01,,,,,0.00,0.00,0,0,0,0,0,0,0,0,0,0,0,0,0
20200528,06316P,臺股指元富97售03,,,,,0.00,0.00,0,0,0,0,0,0,0,0,0,0,0,0,0
20200528,063170,智邦第一9B購01,0.68,0.68,0.59,0.61,+0.04,7.02,118000,12,72250,0,0,0,0,0,0,6000,112000,-106000,-106000
20200528,063171,光寶科中信9B購01,0.95,0.95,0.90,0.90,-0.05,-5.26,87000,4,81840,0,0,0,0,0,0,86000,1000,85000,85000
20200528,063172,廣達中信9C購01,,,,,0.00,0.00,0,0,0,0,0,0,0,0,0,0,0,0,0
20200528,063173,矽格中信9B購01,,,,,0.00,0.00,0,0,0,0,0,0,0,0,0,0,0,0,0
20200528,063174,臺股指中信01購04,0.92,0.92,0.92,0.92,-0.04,-4.17,50000,1,46000,0,0,0,0,0,0,0,50000,-50000,-50000
20200528,063175,燿華兆豐9C購01,1.10,1.10,1.08,1.09,+0.01,0.93,178000,3,193330,0,0,0,0,0,0,178000,0,178000,178000
20200528,063176,南亞科兆豐9B購01,1.36,1.42,1.24,1.24,0.00,0.00,690000,21,908400,0,0,0,0,0,0,12000,678000,-666000,-666000
20200528,063177,友達兆豐9B購01,0.95,0.95,0.95,0.95,-0.06,-5.94,25000,1,23750,0,0,0,0,0,0,25000,0,25000,25000
20200528,063178,聯發科兆豐9B購04,,,,,0.00,0.00,0,0,0,0,0,0,0,0,0,0,0,0,0
20200528,063179,群創兆豐9B購01,0.78,0.78,0.78,0.78,0.00,0.00,70000,2,54600,0,0,0,0,0,0,70000,0,70000,70000
20200528,06317P,臺股指元富97售04,,,,,0.00,0.00,0,0,0,0,0,0,0,0,0,0,0,0,0
20200528,063180,台塑凱基9B購01,,,,,0.00,0.00,0,0,0,0,0,0,0,0,0,0,0,0,0
20200528,063181,聚陽凱基9B購01,1.79,1.80,1.68,1.68,-0.16,-8.7,144000,11,251510,0,0,0,0,0,0,2000,142000,-140000,-140000
20200528,063182,國巨凱基9B購10,,,,,0.00,0.00,0,0,0,0,0,0,0,0,0,0,0,0,0
20200528,063183,國巨凱基9B購12,,,,,0.00,0.00,0,0,0,0,0,0,0,0,0,0,0,0,0
20200528,063184,台光電凱基9B購03,1.56,1.56,1.46,1.49,-0.14,-8.59,28000,4,43040,0,2000,-2000,0,0,0,23000,5000,18000,16000
20200528,063185,聯發科凱基9C購03,,,,,0.00,0.00,0,0,0,0,0,0,0,0,0,0,0,0,0
20200528,063186,聯發科凱基9C購04,,,,,0.00,0.00,0,0,0,0,0,0,0,0,0,0,0,0,0
20200528,063187,全新凱基9B購02,2.17,2.23,2.17,2.23,-0.01,-0.45,201000,22,444270,0,0,0,0,0,0,200000,41000,159000,159000
20200528,063188,TPK凱基9B購01,1.97,2.11,1.97,2.01,+0.05,2.55,120000,14,241880,0,0,0,0,0,0,95000,68000,27000,27000
20200528,063189,臻鼎凱基9B購01,,,,,0.00,0.00,0,0,0,0,0,0,0,0,0,0,0,0,0
20200528,06318P,臺股指元富97售05,,,,,0.00,0.00,0,0,0,0,0,0,0,0,0,0,0,0,0
20200528,063190,聯茂凱基9B購01,1.86,1.97,1.84,1.95,+0.05,2.63,37000,8,70550,0,0,0,0,0,0,18000,19000,-1000,-1000
20200528,063191,台表科凱基9B購03,1.04,1.10,0.96,0.96,-0.13,-11.93,100000,7,106800,0,0,0,0,0,0,95000,5000,90000,90000
20200528,063192,技嘉台新9B購01,1.57,1.58,1.51,1.51,-0.16,-9.58,197000,8,309740,0,0,0,0,0,0,139000,58000,81000,81000
20200528,063193,聯發科台新9B購02,,,,,0.00,0.00,0,0,0,0,0,0,0,0,0,0,0,0,0
20200528,063194,華新科台新9B購01,1.92,1.92,1.89,1.89,-0.07,-3.57,56000,7,107220,0,0,0,0,0,0,46000,10000,36000,36000
20200528,063195,訊連元富9B購01,1.49,1.52,1.38,1.38,-0.15,-9.8,112000,3,167230,0,0,0,0,0,0,85000,27000,58000,58000
20200528,063196,力成元富9B購01,2.46,2.56,2.32,2.32,-0.11,-4.53,435000,39,1068510,0,0,0,0,0,0,119000,316000,-197000,-197000
20200528,063197,遠東新統一9C購01,0.98,0.98,0.98,0.98,-0.01,-1.01,51000,1,49980,0,0,0,0,0,0,51000,0,51000,51000
20200528,063198,仁寶統一01購02,,,,,0.00,0.00,0,0,0,0,0,0,0,0,0,0,0,0,0
20200528,063199,台積電統一01購07,1.40,1.40,1.39,1.39,-0.05,-3.47,14000,3,19500,0,0,0,0,0,0,4000,14000,-10000,-10000
20200528,06319P,臺股指元富97售06,,,,,0.00,0.00,0,0,0,0,0,0,0,0,0,0,0,0,0
20200528,063200,瑞昱統一9C購01,0.79,0.79,0.78,0.78,+0.02,2.63,347000,5,270790,0,0,0,0,0,0,63000,284000,-221000,-221000
20200528,063201,廣達統一01購01,0.92,0.92,0.89,0.89,-0.04,-4.3,117000,3,104280,0,0,0,0,0,0,0,117000,-117000,-117000
20200528,063202,南亞科統一9C購02,1.11,1.13,1.02,1.03,+0.01,0.98,591000,16,622430,0,0,0,0,0,0,79000,512000,-433000,-433000
20200528,063203,華新科統一9C購04,1.13,1.15,1.10,1.10,-0.02,-1.79,91000,21,103580,0,0,0,0,0,0,91000,0,91000,91000
20200528,063204,高鐵統一9C購01,1.20,1.20,1.04,1.08,-0.07,-6.09,1098000,65,1251560,0,0,0,0,0,0,841000,249000,592000,592000
20200528,063205,貿聯統一9C購01,0.98,1.01,0.98,1.00,+0.02,2.04,662000,16,657790,0,0,0,0,0,0,267000,395000,-128000,-128000
20200528,063206,貿聯統一9C購02,0.89,0.91,0.88,0.89,+0.01,1.14,1157000,24,1027910,0,0,0,0,0,0,687000,470000,217000,217000
20200528,063207,聯茂統一01購01,0.72,0.77,0.72,0.76,+0.04,5.56,277000,15,209920,0,0,0,0,0,0,20000,257000,-237000,-237000
20200528,063208,鈺齊統一9C購01,1.23,1.28,1.17,1.17,+0.06,5.41,1183000,72,1445250,0,0,0,0,0,0,460000,739000,-279000,-279000
20200528,063209,巨大統一01購01,0.82,0.84,0.79,0.80,-0.02,-2.44,295000,9,244030,0,0,0,0,0,0,101000,194000,-93000,-93000
20200528,06320P,上銀統一97售04,0.71,0.85,0.71,0.85,+0.10,13.33,248000,11,197090,0,0,0,0,0,0,48000,197000,-149000,-149000
20200528,063210,百和統一9C購01,0.96,0.98,0.93,0.94,0.00,0.00,203000,23,194300,0,0,0,0,0,0,23000,180000,-157000,-157000
20200528,063211,道瓊銀國票9B購01,2.95,2.95,2.92,2.94,+0.19,6.91,144000,9,422180,0,0,0,0,0,0,24000,120000,-96000,-96000
20200528,063212,聯發科國票9C購02,2.93,2.93,2.93,2.93,0.00,0.00,10000,1,29300,0,0,0,0,0,0,0,10000,-10000,-10000
20200528,063213,智伸科國票9C購01,3.68,3.68,3.52,3.55,-0.14,-3.79,513000,19,1867180,0,0,0,0,0,0,506000,7000,499000,499000
20200528,063214,康控國票9C購01,2.57,2.57,2.47,2.47,-0.14,-5.36,19000,2,47830,0,0,0,0,0,0,9000,10000,-1000,-1000
20200528,063215,台表科國票9C購02,3.48,3.50,3.35,3.35,-0.02,-0.59,14000,3,47960,0,0,0,0,0,0,7000,7000,0,0
20200528,063216,元黃金群益9B購02,,,,,0.00,0.00,0,0,0,0,0,0,0,0,0,0,0,0,0
20200528,063217,元金2X群益9B購03,,,,,0.00,0.00,0,0,0,0,0,0,0,0,0,0,0,0,0
20200528,063218,台塑群益9B購01,,,,,0.00,0.00,0,0,0,0,0,0,0,0,0,0,0,0,0
20200528,063219,友達群益9B購03,,,,,0.00,0.00,0,0,0,0,0,0,0,0,0,0,0,0,0
20200528,06321P,台積電統一98售03,,,,,0.00,0.00,0,0,0,0,0,0,0,0,0,0,0,0,0
20200528,063220,建準群益9B購01,1.21,1.37,1.13,1.14,+0.01,0.88,461000,29,593580,0,0,0,0,0,0,146000,390000,-244000,-244000
20200528,063221,京元電群益9B購02,1.42,1.42,1.42,1.42,-0.09,-5.96,27000,4,38340,0,0,0,0,0,0,27000,21000,6000,6000
20200528,063222,群創群益9B購03,,,,,0.00,0.00,0,0,0,0,0,0,0,0,0,0,0,0,0
20200528,063223,牧德群益9B購04,,,,,0.00,0.00,0,0,0,0,0,0,0,0,0,0,0,0,0
20200528,063224,泰鼎群益9B購02,3.49,3.49,3.49,3.49,+0.11,3.25,17000,1,59330,0,0,0,0,0,0,0,17000,-17000,-17000
20200528,063225,茂林群益9B購04,1.47,1.47,1.41,1.46,-0.25,-14.62,97000,16,141310,0,0,0,0,0,0,97000,0,97000,97000
20200528,063226,康控群益9B購03,1.58,1.58,1.58,1.58,+0.04,2.6,21000,1,33180,0,0,0,0,0,0,21000,21000,0,0
20200528,063227,祥碩群益9B購06,0.84,0.96,0.81,0.92,+0.11,13.58,523000,28,472570,0,0,0,0,0,0,76000,403000,-327000,-327000
20200528,063228,聯茂群益9B購01,2.01,2.07,2.01,2.05,+0.08,4.06,104000,7,211350,0,0,0,0,0,0,14000,88000,-74000,-74000
20200528,063229,台表科群益9B購04,1.49,1.56,1.44,1.46,-0.12,-7.59,325000,9,491550,0,0,0,0,0,0,205000,120000,85000,85000
20200528,06322P,超眾統一97售04,1.51,1.60,1.49,1.51,-0.07,-4.43,74000,7,112670,0,0,0,0,0,0,57000,17000,40000,40000
20200528,063230,緯穎群益9B購02,2.98,3.17,2.77,2.77,-0.41,-12.89,55000,14,164060,0,0,0,0,0,0,39000,26000,13000,13000
20200528,063231,台泥元大9B購01,2.77,2.78,2.69,2.69,-0.10,-3.58,144000,7,394840,0,0,0,0,0,0,104000,58000,46000,46000
20200528,063232,裕隆元大9B購01,2.10,2.20,2.10,2.20,0.00,0.00,63000,5,135320,0,0,0,0,0,0,0,63000,-63000,-63000
20200528,063233,國巨元大9B購19,2.95,3.00,2.85,2.85,-0.06,-2.06,138000,7,409510,0,0,0,0,0,0,111000,138000,-27000,-27000
20200528,063234,國巨元大9C購03,,,,,0.00,0.00,0,0,0,0,0,0,0,0,0,0,0,0,0
20200528,063235,台積電元大9B購06,3.06,3.06,3.06,3.06,0.00,0.00,8000,1,24480,0,0,0,0,0,0,0,8000,-8000,-8000
20200528,063236,旺宏元大9B購07,2.70,2.77,2.54,2.54,-0.20,-7.3,199000,29,538470,0,0,0,0,0,0,193000,48000,145000,145000
20200528,063237,微星元大9B購02,1.25,1.27,1.22,1.27,+0.06,4.96,495000,5,618150,0,0,0,0,0,0,455000,40000,415000,415000
20200528,063238,漢唐元大9B購02,2.59,2.59,2.42,2.46,-0.09,-3.53,314000,11,771600,0,0,0,0,0,0,46000,314000,-268000,-268000
20200528,063239,建準元大9B購01,2.42,2.79,2.35,2.35,+0.04,1.73,304000,33,784710,0,0,0,0,0,0,190000,254000,-64000,-64000
20200528,06323P,台郡統一97售01,1.87,1.89,1.87,1.89,0.00,0.00,172000,3,321820,0,0,0,0,0,0,0,172000,-172000,-172000
20200528,063240,聯發科元大9B購17,,,,,0.00,0.00,0,0,0,0,0,0,0,0,0,0,0,0,0
20200528,063241,聯發科元大9B購18,,,,,0.00,0.00,0,0,0,0,0,0,0,0,0,0,0,0,0
20200528,063242,聯發科元大9B購19,,,,,0.00,0.00,0,0,0,0,0,0,0,0,0,0,0,0,0
20200528,063243,聯發科元大9B購20,,,,,0.00,0.00,0,0,0,0,0,0,0,0,0,0,0,0,0
20200528,063244,華新科元大9B購11,1.69,1.70,1.68,1.68,0.00,0.00,150000,7,253250,0,0,0,0,0,0,150000,0,150000,150000
20200528,063245,富邦金元大9B購03,3.12,3.12,2.97,2.97,-0.10,-3.26,13000,2,40110,0,0,0,0,0,0,10000,3000,7000,7000
20200528,063246,嘉晶元大9C購01,2.01,2.01,1.86,1.88,-0.15,-7.39,144000,10,278950,0,0,0,0,0,0,67000,77000,-10000,-10000
20200528,063247,信邦元大9B購02,1.99,2.05,1.99,2.03,0.00,0.00,153000,5,308690,0,0,0,0,0,0,0,153000,-153000,-153000
20200528,063248,創意元大9C購01,1.68,1.74,1.62,1.62,+0.01,0.62,50000,9,83540,0,0,0,0,0,0,6000,44000,-38000,-38000
20200528,063249,祥碩元大9B購06,1.73,1.76,1.65,1.71,-0.16,-8.56,402000,18,689420,0,0,0,0,0,0,271000,402000,-131000,-131000
20200528,06324P,TXFI0永昌99售02,,,,,0.00,0.00,0,0,0,0,0,0,0,0,0,0,0,0,0
20200528,063250,同欣電元大9B購03,1.72,1.72,1.64,1.64,-0.04,-2.38,369000,19,619840,0,0,0,0,0,0,140000,229000,-89000,-89000
20200528,063251,同欣電元大9B購04,1.77,1.77,1.70,1.70,-0.22,-11.46,62000,5,107500,0,0,0,0,0,0,32000,30000,2000,2000
20200528,063252,緯穎元大9B購07,1.54,1.57,1.40,1.40,-0.09,-6.04,42000,6,63750,0,0,0,0,0,0,0,42000,-42000,-42000
20200528,063253,巨大元大9B購03,2.33,2.39,2.26,2.26,-0.14,-5.83,145000,6,338130,0,0,0,0,0,0,82000,145000,-63000,-63000
20200528,063254,臺股指元大9B購41,1.94,1.94,1.94,1.94,0.00,0.00,1000,1,1940,0,0,0,0,0,0,0,1000,-1000,-1000
20200528,063255,臺股指元大9B購42,,,,,0.00,0.00,0,0,0,0,0,0,0,0,0,0,0,0,0
20200528,063256,鴻海國泰01購02,4.51,4.73,4.49,4.49,-0.11,-2.39,52000,16,237400,0,0,0,0,0,0,32000,44000,-12000,-12000
20200528,063257,牧德國泰01購01,1.46,1.46,1.44,1.44,-0.11,-7.1,42000,2,60620,0,0,0,0,0,0,0,42000,-42000,-42000
20200528,063258,緯穎國泰9C購01,1.16,1.19,1.13,1.13,+0.01,0.89,93000,9,108310,0,0,0,0,0,0,58000,39000,19000,19000
20200528,063259,廣達富邦9C購01,0.74,0.75,0.73,0.75,+0.01,1.35,21000,3,15630,0,0,0,0,0,0,0,21000,-21000,-21000
20200528,06325P,TXFI0永昌99售03,,,,,0.00,0.00,0,0,0,0,0,0,0,0,0,0,0,0,0
20200528,063260,信邦富邦9B購01,0.60,0.62,0.60,0.61,-0.03,-4.69,105000,7,63960,0,0,0,0,0,0,55000,50000,5000,5000
20200528,063261,康控富邦03購01,0.75,0.76,0.75,0.75,0.00,0.00,138000,6,103650,0,0,0,0,0,0,138000,53000,85000,85000
20200528,063262,南六富邦9C購01,0.65,0.65,0.64,0.65,-0.01,-1.52,20000,13,12910,0,0,0,0,0,0,20000,0,20000,20000
20200528,063263,高鐵永豐9B購01,1.52,1.52,1.31,1.34,-0.16,-10.67,246000,26,350080,0,10000,-10000,0,0,0,186000,60000,126000,116000
20200528,063264,健策永豐9B購07,2.06,2.06,1.85,1.85,-0.21,-10.19,69000,17,140340,0,0,0,0,0,0,61000,8000,53000,53000
20200528,063265,瑞祺永豐9B購01,1.06,1.14,1.06,1.06,-0.01,-0.93,381000,14,412860,0,0,0,0,0,0,210000,171000,39000,39000
20200528,063266,聯發科第一9B購01,,,,,0.00,0.00,0,0,0,0,0,0,0,0,0,0,0,0,0
20200528,063267,台表科中信01購02,0.53,0.55,0.49,0.50,-0.09,-15.25,134000,7,69890,0,0,0,0,0,0,85000,49000,36000,36000
20200528,063268,GIS中信9B購01,1.24,1.25,1.09,1.09,-0.08,-6.84,258000,8,316270,0,0,0,0,0,0,143000,115000,28000,28000
20200528,063269,儒鴻兆豐9C購01,1.37,1.37,1.28,1.28,-0.10,-7.25,744000,14,990160,0,0,0,0,0,0,336000,408000,-72000,-72000
20200528,06326P,鴻海中信01售01,,,,,0.00,0.00,0,0,0,0,0,0,0,0,0,0,0,0,0
20200528,063270,喬山兆豐9C購01,1.31,1.31,1.20,1.20,-0.13,-9.77,174000,8,225350,0,0,0,0,0,0,173000,1000,172000,172000
20200528,063271,中磊兆豐9C購01,1.08,1.08,1.08,1.08,-0.05,-4.42,1000,1,1080,0,0,0,0,0,0,1000,0,1000,1000
20200528,063272,GIS兆豐9C購01,1.01,1.01,0.86,0.86,-0.08,-8.51,355000,19,327340,0,0,0,0,0,0,201000,154000,47000,47000
20200528,063273,緯穎兆豐9C購01,,,,,0.00,0.00,0,0,0,0,0,0,0,0,0,0,0,0,0
20200528,063274,鈺齊兆豐9B購01,2.31,2.50,2.27,2.28,+0.13,6.05,767000,23,1831610,0,0,0,0,0,0,86000,681000,-595000,-595000
20200528,063275,臺指反元大02購16,,,,,0.00,0.00,0,0,0,0,0,0,0,0,0,0,0,0,0
20200528,063276,和大元大9B購01,,,,,0.00,0.00,0,0,0,0,0,0,0,0,0,0,0,0,0
20200528,063277,大成鋼元大9B購03,1.63,1.84,1.63,1.71,+0.04,2.4,851000,30,1489640,0,0,0,0,0,0,199000,851000,-652000,-652000
20200528,063278,國巨元大9C購04,1.73,1.73,1.71,1.71,0.00,0.00,27000,7,46450,0,0,0,0,0,0,27000,27000,0,0
20200528,063279,國巨元大9C購05,1.67,1.67,1.61,1.61,-0.05,-3.01,13000,5,21490,0,0,0,0,0,0,11000,11000,0,0
20200528,06327P,台積電中信01售01,1.54,1.55,1.54,1.55,-0.02,-1.27,20000,2,30900,0,0,0,0,0,0,20000,10000,10000,10000
20200528,063280,燿華元大9B購05,,,,,0.00,0.00,0,0,0,0,0,0,0,0,0,0,0,0,0
20200528,063281,京元電元大9B購01,2.52,2.52,2.39,2.39,-0.13,-5.16,44000,5,108830,0,0,0,0,0,0,24000,30000,-6000,-6000
20200528,063282,奇力新元大9B購06,,,,,0.00,0.00,0,0,0,0,0,0,0,0,0,0,0,0,0
20200528,063283,華新科元大9C購03,,,,,0.00,0.00,0,0,0,0,0,0,0,0,0,0,0,0,0
20200528,063284,大立光元大9B購07,,,,,0.00,0.00,0,0,0,0,0,0,0,0,0,0,0,0,0
20200528,063285,華擎元大9B購03,,,,,0.00,0.00,0,0,0,0,0,0,0,0,0,0,0,0,0
20200528,063286,嘉澤元大9B購04,,,,,0.00,0.00,0,0,0,0,0,0,0,0,0,0,0,0,0
20200528,063287,嘉澤元大9B購05,1.52,1.52,1.44,1.44,-0.09,-5.88,37000,3,54140,0,0,0,0,0,0,25000,12000,13000,13000
20200528,063288,泰鼎元大9B購02,2.65,2.65,2.54,2.54,+0.04,1.6,59000,5,152250,0,0,0,0,0,0,57000,32000,25000,25000
20200528,063289,台表科元大9B購07,1.69,1.69,1.69,1.69,-0.30,-15.08,20000,2,33800,0,0,0,0,0,0,20000,20000,0,0
20200528,06328P,台積電中信01售02,1.15,1.19,1.15,1.19,+0.03,2.59,71000,5,82730,0,0,0,0,0,0,51000,52000,-1000,-1000
20200528,063290,GIS元大9B購02,2.34,2.34,2.02,2.02,-0.12,-5.61,628000,32,1402580,0,0,0,0,0,0,434000,144000,290000,290000
20200528,063291,緯穎元大01購01,,,,,0.00,0.00,0,0,0,0,0,0,0,0,0,0,0,0,0
20200528,063292,致新元大9B購02,1.49,1.66,1.49,1.66,+0.17,11.41,738000,23,1167450,0,0,0,0,0,0,222000,539000,-317000,-317000
20200528,063293,億豐元大9B購01,1.53,1.53,1.53,1.53,-0.04,-2.55,1000,1,1530,0,0,0,0,0,0,0,1000,-1000,-1000
20200528,063294,美律麥證9B購01,1.82,1.82,1.82,1.82,+0.01,0.55,50000,1,91000,50000,0,50000,0,0,0,50000,0,50000,50000
20200528,063295,京元電麥證9B購01,,,,,0.00,0.00,0,0,0,0,0,0,0,0,0,0,0,0,0
20200528,063296,可成麥證9B購01,,,,,0.00,0.00,0,0,0,0,0,0,0,0,0,0,0,0,0
20200528,063297,臺指反凱基02購01,,,,,0.00,0.00,0,0,0,0,0,0,0,0,0,0,0,0,0
20200528,063298,統一凱基9B購01,,,,,0.00,0.00,0,0,0,0,0,0,0,0,0,0,0,0,0
20200528,063299,金寶凱基9B購01,,,,,0.00,0.00,0,0,0,0,0,0,0,0,0,0,0,0,0
20200528,06329P,大立光兆豐97售04,2.33,2.33,2.33,2.33,0.00,0.00,40000,1,93200,0,0,0,0,0,0,40000,40000,0,0
20200528,063300,華通凱基9B購05,3.30,3.63,3.30,3.61,+0.41,12.81,213000,24,757940,0,0,0,0,0,0,24000,194000,-170000,-170000
20200528,063301,鴻海凱基9B購08,1.82,1.82,1.82,1.82,+0.06,3.41,6000,1,10920,0,0,0,0,0,0,6000,6000,0,0
20200528,063302,國巨凱基9C購05,,,,,0.00,0.00,0,0,0,0,0,0,0,0,0,0,0,0,0
20200528,063303,聯發科凱基9B購14,,,,,0.00,0.00,0,0,0,0,0,0,0,0,0,0,0,0,0
20200528,063304,大立光凱基01購02,,,,,0.00,0.00,0,0,0,0,0,0,0,0,0,0,0,0,0
20200528,063305,亞光凱基9B購01,1.41,1.41,1.41,1.41,-0.01,-0.7,10000,1,14100,0,0,0,0,0,0,10000,0,10000,10000
20200528,063306,聯茂凱基9C購01,1.26,1.30,1.26,1.29,+0.06,4.88,41000,5,52690,0,0,0,0,0,0,10000,41000,-31000,-31000
20200528,063307,同欣電凱基9B購02,1.14,1.14,1.04,1.04,-0.12,-10.34,93000,5,100700,0,0,0,0,0,0,62000,31000,31000,31000
20200528,063308,緯穎凱基9B購05,1.54,1.54,1.54,1.54,0.00,0.00,4000,1,6160,0,0,0,0,0,0,4000,4000,0,0
20200528,063309,臺指反群益9B購06,,,,,0.00,0.00,0,0,0,0,0,0,0,0,0,0,0,0,0
20200528,06330P,南亞科群益97售03,3.71,3.71,3.71,3.71,0.00,0.00,10000,1,37100,0,0,0,0,0,0,0,10000,-10000,-10000
20200528,063310,和大群益9B購02,,,,,0.00,0.00,0,0,0,0,0,0,0,0,0,0,0,0,0
20200528,063311,喬山群益9B購01,1.54,1.54,1.37,1.37,-0.17,-11.04,148000,6,223020,0,0,0,0,0,0,58000,0,58000,58000
20200528,063312,台積電群益9B購07,4.76,4.78,4.44,4.44,-0.17,-3.69,95000,8,447860,0,0,0,0,0,0,45000,53000,-8000,-8000
20200528,063313,南亞科群益9B購02,,,,,0.00,0.00,0,0,0,0,0,0,0,0,0,0,0,0,0
20200528,063314,美律群益9B購01,1.80,1.80,1.80,1.80,0.00,0.00,10000,2,18000,0,0,0,0,0,0,0,10000,-10000,-10000
20200528,063315,京元電群益9B購03,,,,,0.00,0.00,0,0,0,0,0,0,0,0,0,0,0,0,0
20200528,063316,聯發科群益9C購03,1.90,1.90,1.90,1.90,+0.05,2.7,8000,1,15200,0,0,0,0,0,0,8000,8000,0,0
20200528,063317,大立光群益9B購06,1.93,1.93,1.73,1.73,0.00,0.00,60000,4,110800,0,0,0,0,0,0,29000,60000,-31000,-31000
20200528,063318,京鼎群益9C購02,2.16,2.16,2.08,2.15,+0.06,2.87,168000,7,361520,0,0,0,0,0,0,155000,117000,38000,38000
20200528,063319,神達群益9B購01,2.62,2.64,2.62,2.64,+0.05,1.93,24000,2,63240,0,0,0,0,0,0,24000,24000,0,0
20200528,06331P,南亞科群益97售04,,,,,0.00,0.00,0,0,0,0,0,0,0,0,0,0,0,0,0
20200528,063320,旭富群益9B購03,1.55,1.55,1.55,1.55,-0.04,-2.52,90000,1,139500,0,0,0,0,0,0,90000,0,90000,90000
20200528,063321,泰鼎群益9B購03,1.56,1.56,1.56,1.56,0.00,0.00,38000,1,59280,0,0,0,0,0,0,0,38000,-38000,-38000
20200528,063322,台郡群益9B購02,0.95,0.95,0.92,0.92,-0.03,-3.16,107000,7,101150,0,0,0,0,0,0,87000,20000,67000,67000
20200528,063323,同欣電群益9B購03,1.60,1.61,1.58,1.61,-0.14,-8.0,135000,4,216550,0,0,0,0,0,0,40000,95000,-55000,-55000
20200528,063324,道瓊反國票9B購03,1.41,1.41,1.41,1.41,0.00,0.00,6000,2,8460,0,0,0,0,0,0,0,6000,-6000,-6000
20200528,063325,SP黃豆國票9C購02,,,,,0.00,0.00,0,0,0,0,0,0,0,0,0,0,0,0,0
20200528,063326,正隆國票9B購01,2.18,2.27,2.18,2.27,+0.14,6.57,78000,4,174830,0,0,0,0,0,0,11000,67000,-56000,-56000
20200528,063327,燿華國票9C購02,1.93,1.97,1.90,1.96,+0.04,2.08,55000,9,106370,0,0,0,0,0,0,53000,42000,11000,11000
20200528,063328,京元電國票9C購02,1.76,1.76,1.72,1.72,-0.08,-4.44,8000,2,13960,0,0,0,0,0,0,0,8000,-8000,-8000
20200528,063329,健策國票9C購01,6.35,6.35,5.60,5.60,-0.25,-4.27,6000,2,34350,0,0,0,0,0,0,1000,5000,-4000,-4000
20200528,06332P,世紀鋼群益98售01,0.42,0.42,0.32,0.34,0.00,0.00,221000,11,82420,0,0,0,0,0,0,0,221000,-221000,-221000
20200528,063330,神達國票9C購01,,,,,0.00,0.00,0,0,0,0,0,0,0,0,0,0,0,0,0
20200528,063331,瑞儀國票9C購01,2.38,2.49,2.38,2.42,-0.08,-3.2,160000,11,391700,0,0,0,0,0,0,30000,130000,-100000,-100000
20200528,063332,矽格國票9B購01,,,,,0.00,0.00,0,0,0,0,0,0,0,0,0,0,0,0,0
20200528,063333,同欣電國票9C購01,2.47,2.47,2.36,2.39,-0.26,-9.81,126000,5,302480,0,0,0,0,0,0,116000,10000,106000,106000
20200528,063334,復盛國票9B購01,2.25,2.34,2.24,2.34,-0.01,-0.43,79000,8,182280,0,0,0,0,0,0,10000,69000,-59000,-59000
20200528,063335,道瓊銀統一9C購01,,,,,0.00,0.00,0,0,0,0,0,0,0,0,0,0,0,0,0
20200528,063336,大成鋼統一9C購02,1.02,1.14,1.02,1.12,0.00,0.00,414000,20,446540,0,0,0,0,0,0,70000,414000,-344000,-344000
20200528,063337,國巨統一02購02,1.20,1.20,1.20,1.20,0.00,0.00,2000,1,2400,0,0,0,0,0,0,2000,0,2000,2000
20200528,063338,國巨統一9C購11,,,,,0.00,0.00,0,0,0,0,0,0,0,0,0,0,0,0,0
20200528,063339,智邦統一01購01,1.44,1.56,1.36,1.39,+0.10,7.75,608000,32,914810,0,0,0,0,0,0,53000,565000,-512000,-512000
20200528,06333P,臺股指群益9C售02,,,,,0.00,0.00,0,0,0,0,0,0,0,0,0,0,0,0,0
20200528,063340,英業達統一9B購01,1.60,1.61,1.56,1.56,-0.02,-1.27,157000,6,250980,0,0,0,0,0,0,145000,12000,133000,133000
20200528,063341,燿華統一9C購01,1.06,1.06,1.01,1.01,-0.04,-3.81,97000,8,101100,0,0,0,0,0,0,43000,54000,-11000,-11000
20200528,063342,台光電統一9B購02,1.34,1.36,1.21,1.21,-0.13,-9.7,108000,8,138860,0,0,0,0,0,0,50000,58000,-8000,-8000
20200528,063343,美律統一9C購01,0.97,0.98,0.97,0.98,0.00,0.00,339000,6,330410,0,0,0,0,0,0,11000,339000,-328000,-328000
20200528,063344,臺企銀統一9C購01,1.23,1.23,1.19,1.19,-0.02,-1.65,41000,3,49990,0,0,0,0,0,0,20000,21000,-1000,-1000
20200528,063345,嘉晶統一9C購02,1.52,1.52,1.45,1.45,-0.10,-6.45,17000,3,25490,0,0,0,0,0,0,5000,12000,-7000,-7000
20200528,063346,TPK統一9C購01,1.27,1.27,1.24,1.24,-0.03,-2.36,164000,5,205570,0,0,0,0,0,0,145000,0,145000,145000
20200528,063347,祥碩統一01購03,0.84,0.87,0.84,0.85,0.00,0.00,498000,11,422640,0,0,0,0,0,0,0,498000,-498000,-498000
20200528,063348,祥碩統一01購04,0.83,0.91,0.83,0.88,+0.06,7.32,553000,13,483340,0,0,0,0,0,0,30000,523000,-493000,-493000
20200528,063349,台郡統一9C購01,0.84,0.84,0.84,0.84,-0.02,-2.33,683000,9,573720,0,0,0,0,0,0,658000,25000,633000,633000
20200528,06334P,臺股指群益9C售03,,,,,0.00,0.00,0,0,0,0,0,0,0,0,0,0,0,0,0
20200528,063350,台表科統一02購02,0.72,0.74,0.70,0.70,-0.05,-6.67,54000,3,39200,0,0,0,0,0,0,0,54000,-54000,-54000
20200528,063351,億豐統一9B購01,1.37,1.39,1.30,1.30,-0.08,-5.8,77000,4,102190,0,0,0,0,0,0,67000,10000,57000,57000
20200528,063352,上銀元富9B購02,3.20,3.38,2.90,2.90,-0.26,-8.23,137000,10,441350,0,0,0,0,0,0,107000,30000,77000,77000
20200528,063353,上銀元富9B購03,3.34,3.41,3.09,3.09,-0.31,-9.12,98000,7,328100,0,0,0,0,0,0,91000,7000,84000,84000
20200528,063354,茂林元富9B購02,2.47,2.47,2.42,2.42,-0.42,-14.79,176000,7,430720,0,0,0,0,0,0,176000,0,176000,176000
20200528,063355,超眾元富9B購01,2.36,2.48,2.33,2.41,-0.14,-5.49,438000,28,1055160,0,0,0,0,0,0,261000,217000,44000,44000
20200528,063356,台表科元富02購01,1.09,1.13,1.03,1.03,-0.09,-8.04,325000,10,356650,0,0,0,0,0,0,105000,220000,-115000,-115000
20200528,063357,聯發科國泰01購04,,,,,0.00,0.00,0,0,0,0,0,0,0,0,0,0,0,0,0
20200528,063358,華擎國泰01購01,1.41,1.41,1.31,1.31,-0.03,-2.24,500000,10,673700,0,0,0,0,0,0,350000,150000,200000,200000
20200528,063359,泰鼎國泰01購01,1.42,1.42,1.42,1.42,0.00,0.00,70000,1,99400,0,0,0,0,0,0,0,70000,-70000,-70000
20200528,06335P,台積電麥證97售02,,,,,0.00,0.00,0,0,0,0,0,0,0,0,0,0,0,0,0
20200528,063360,茂林國泰9C購02,1.60,1.60,1.50,1.55,-0.04,-2.52,219000,16,338090,0,0,0,0,0,0,157000,207000,-50000,-50000
20200528,063361,台表科國泰01購02,1.58,1.58,1.58,1.58,0.00,0.00,150000,1,237000,0,0,0,0,0,0,0,150000,-150000,-150000
20200528,063362,台表科國泰01購03,,,,,0.00,0.00,0,0,0,0,0,0,0,0,0,0,0,0,0
20200528,063363,鴻海富邦9B購02,1.01,1.02,1.00,1.02,+0.03,3.03,452000,21,456720,0,0,0,0,0,0,452000,6000,446000,446000
20200528,063364,聯發科富邦01購02,0.83,0.83,0.78,0.78,-0.03,-3.7,46000,3,37130,0,0,0,0,0,0,25000,21000,4000,4000
20200528,063365,義隆富邦01購01,0.75,0.76,0.75,0.76,+0.03,4.11,254000,12,192950,0,0,0,0,0,0,9000,254000,-245000,-245000
20200528,063366,台表科富邦9C購02,,,,,0.00,0.00,0,0,0,0,0,0,0,0,0,0,0,0,0
20200528,063367,GIS富邦9B購01,0.83,0.83,0.70,0.70,-0.08,-10.26,1221000,24,951950,0,0,0,0,0,0,1063000,129000,934000,934000
20200528,063368,遠東新永豐9B購01,,,,,0.00,0.00,0,0,0,0,0,0,0,0,0,0,0,0,0
20200528,063369,聚陽永豐9B購01,1.03,1.04,1.03,1.04,-0.03,-2.8,101000,3,104890,0,0,0,0,0,0,101000,0,101000,101000
20200528,06336P,鴻海元大98售05,4.72,4.72,4.72,4.72,0.00,0.00,30000,1,141600,0,0,0,0,0,0,0,30000,-30000,-30000
20200528,063370,國巨永豐9B購03,,,,,0.00,0.00,0,0,0,0,0,0,0,0,0,0,0,0,0
20200528,063371,南亞科永豐9B購01,0.95,0.95,0.90,0.90,+0.01,1.12,19000,4,17800,0,0,0,0,0,0,0,19000,-19000,-19000
20200528,063372,漢翔永豐9B購01,0.87,0.87,0.87,0.87,+0.05,6.1,61000,1,53070,0,0,0,0,0,0,61000,0,61000,61000
20200528,063373,晶技永豐9B購02,1.17,1.17,1.14,1.14,-0.07,-5.79,16000,2,18630,0,0,0,0,0,0,16000,0,16000,16000
20200528,063374,嘉澤永豐9B購04,0.93,0.93,0.93,0.93,0.00,0.00,16000,1,14880,0,0,0,0,0,0,0,16000,-16000,-16000
20200528,063375,牧德永豐9B購02,,,,,0.00,0.00,0,0,0,0,0,0,0,0,0,0,0,0,0
20200528,063376,神達永豐9B購01,0.95,0.96,0.94,0.94,0.00,0.00,33000,4,31180,0,0,0,0,0,0,22000,33000,-11000,-11000
20200528,063377,泰鼎永豐9B購03,,,,,0.00,0.00,0,0,0,0,0,0,0,0,0,0,0,0,0
20200528,063378,茂林永豐9B購02,0.89,0.89,0.86,0.86,-0.13,-13.13,129000,4,112120,0,0,0,0,0,0,44000,85000,-41000,-41000
20200528,063379,帆宣永豐9B購01,1.12,1.14,1.12,1.14,+0.12,11.76,6000,2,6740,0,0,0,0,0,0,6000,0,6000,6000
20200528,06337P,祥碩元大97售05,0.07,0.08,0.06,0.07,-0.03,-30.0,385000,13,26300,0,0,0,0,0,0,65000,161000,-96000,-96000
20200528,063380,台表科永豐9B購03,,,,,0.00,0.00,0,0,0,0,0,0,0,0,0,0,0,0,0
20200528,063381,和潤永豐9B購01,0.85,0.85,0.83,0.83,0.00,0.00,132000,3,109800,0,0,0,0,0,0,0,132000,-132000,-132000
20200528,063382,南茂永豐9B購01,,,,,0.00,0.00,0,0,0,0,0,0,0,0,0,0,0,0,0
20200528,063383,億豐永豐9B購02,,,,,0.00,0.00,0,0,0,0,0,0,0,0,0,0,0,0,0
20200528,063384,巨大永豐9B購04,0.90,0.90,0.88,0.88,-0.05,-5.38,68000,2,60900,0,0,0,0,0,0,53000,15000,38000,38000
20200528,063385,可成中信9C購01,1.16,1.16,1.13,1.13,0.00,0.00,16000,3,18500,0,0,0,0,0,0,3000,16000,-13000,-13000
20200528,063386,國巨兆豐9B購04,,,,,0.00,0.00,0,0,0,0,0,0,0,0,0,0,0,0,0
20200528,063387,台積電兆豐9B購03,2.58,2.58,2.36,2.36,0.00,0.00,56000,3,135280,0,0,0,0,0,0,0,56000,-56000,-56000
20200528,063388,台光電兆豐9C購01,,,,,0.00,0.00,0,0,0,0,0,0,0,0,0,0,0,0,0
20200528,063389,大立光兆豐9C購02,1.27,1.27,1.27,1.27,0.00,0.00,12000,1,15240,0,0,0,0,0,0,0,12000,-12000,-12000
20200528,06338P,亞德客統一97售02,0.69,0.87,0.69,0.87,+0.06,7.41,579000,18,459240,0,0,0,0,0,0,160000,419000,-259000,-259000
20200528,063390,嘉晶兆豐9B購01,1.41,1.41,1.41,1.41,0.00,0.00,85000,1,119850,0,0,0,0,0,0,0,85000,-85000,-85000
20200528,063391,南電兆豐9C購01,1.18,1.18,1.12,1.12,-0.06,-5.08,51000,9,58960,0,0,0,0,0,0,0,51000,-51000,-51000
20200528,063392,聯電群益9B購02,0.66,0.66,0.66,0.66,0.00,0.00,115000,2,75900,0,0,0,0,0,0,0,115000,-115000,-115000
20200528,063393,華通群益9C購05,2.37,2.48,2.37,2.48,0.00,0.00,42000,2,100640,0,0,0,0,0,0,0,42000,-42000,-42000
20200528,063394,金像電群益9B購01,,,,,0.00,0.00,0,0,0,0,0,0,0,0,0,0,0,0,0
20200528,063395,金像電群益9B購02,3.05,3.05,3.05,3.05,-0.31,-9.23,4000,1,12200,0,0,0,0,0,0,4000,0,4000,4000
20200528,063396,金像電群益9C購01,3.03,3.03,2.80,2.80,-0.04,-1.41,105000,2,317000,0,0,0,0,0,0,100000,5000,95000,95000
20200528,063397,廣達群益9B購02,2.85,2.85,2.85,2.85,0.00,0.00,36000,2,102600,0,0,0,0,0,0,0,36000,-36000,-36000
20200528,063398,信邦群益9B購02,1.20,1.20,1.20,1.20,0.00,0.00,27000,2,32400,0,0,0,0,0,0,0,27000,-27000,-27000
20200528,063399,智原群益9B購01,1.66,1.66,1.55,1.55,0.00,0.00,48000,5,78640,0,0,0,0,0,0,33000,48000,-15000,-15000
20200528,06339P,上銀統一97售06,0.39,0.39,0.39,0.39,-0.14,-26.42,150000,1,58500,0,0,0,0,0,0,150000,0,150000,150000
20200528,063400,華擎群益9B購03,1.64,1.66,1.62,1.66,+0.09,5.73,65000,3,107760,0,0,0,0,0,0,5000,60000,-55000,-55000
20200528,063401,中租群益9B購03,,,,,0.00,0.00,0,0,0,0,0,0,0,0,0,0,0,0,0
20200528,063402,GIS群益9B購02,1.73,1.73,1.44,1.48,-0.13,-8.07,323000,6,497630,0,0,0,0,0,0,222000,101000,121000,121000
20200528,063403,鈺齊群益9B購01,2.01,2.18,1.98,1.98,+0.07,3.66,147000,10,307110,0,0,0,0,0,0,3000,147000,-144000,-144000
20200528,063404,金像電國票9B購01,,,,,0.00,0.00,0,0,0,0,0,0,0,0,0,0,0,0,0
20200528,063405,聯發科國票9C購03,3.21,3.21,3.21,3.21,0.00,0.00,7000,1,22470,0,0,0,0,0,0,0,7000,-7000,-7000
20200528,063406,麗豐國票9C購01,,,,,0.00,0.00,0,0,0,0,0,0,0,0,0,0,0,0,0
20200528,063407,泰鼎國票9C購01,,,,,0.00,0.00,0,0,0,0,0,0,0,0,0,0,0,0,0
20200528,063408,茂林國票9C購02,2.78,2.78,2.72,2.75,0.00,0.00,19000,3,52460,0,0,0,0,0,0,0,19000,-19000,-19000
20200528,063409,GIS國票9C購02,1.96,1.96,1.94,1.96,+0.09,4.81,77000,3,150680,0,0,0,0,0,0,50000,27000,23000,23000
20200528,06340P,鴻海統一98售06,,,,,0.00,0.00,0,0,0,0,0,0,0,0,0,0,0,0,0
20200528,063410,南六國票9C購01,2.78,2.78,2.65,2.65,0.00,0.00,9000,2,24890,0,0,0,0,0,0,0,9000,-9000,-9000
20200528,063411,和潤國票9C購01,2.82,2.82,2.82,2.82,0.00,0.00,9000,2,25380,0,0,0,0,0,0,0,9000,-9000,-9000
20200528,063412,寶成國票9C購01,2.59,2.59,2.59,2.59,0.00,0.00,9000,1,23310,0,0,0,0,0,0,0,9000,-9000,-9000
20200528,063413,台積電麥證01購01,,,,,0.00,0.00,0,0,0,0,0,0,0,0,0,0,0,0,0
20200528,063414,鴻海凱基03購01,,,,,0.00,0.00,0,0,0,0,0,0,0,0,0,0,0,0,0
20200528,063415,台積電凱基03購01,,,,,0.00,0.00,0,0,0,0,0,0,0,0,0,0,0,0,0
20200528,063416,台積電凱基9B購10,,,,,0.00,0.00,0,0,0,0,0,0,0,0,0,0,0,0,0
20200528,063417,金像電凱基9B購03,2.22,2.22,2.22,2.22,0.00,0.00,20000,1,44400,0,0,0,0,0,0,0,20000,-20000,-20000
20200528,063418,京元電凱基9B購03,,,,,0.00,0.00,0,0,0,0,0,0,0,0,0,0,0,0,0
20200528,063419,聯發科凱基03購01,,,,,0.00,0.00,0,0,0,0,0,0,0,0,0,0,0,0,0
20200528,06341P,大立光統一97售08,,,,,0.00,0.00,0,0,0,0,0,0,0,0,0,0,0,0,0
20200528,063420,奇力新凱基9B購03,,,,,0.00,0.00,0,0,0,0,0,0,0,0,0,0,0,0,0
20200528,063421,可成凱基9C購02,,,,,0.00,0.00,0,0,0,0,0,0,0,0,0,0,0,0,0
20200528,063422,奇鋐凱基9B購04,3.24,3.24,3.24,3.24,0.00,0.00,15000,2,48600,0,0,0,0,0,0,0,15000,-15000,-15000
20200528,063423,聯詠凱基9C購02,,,,,0.00,0.00,0,0,0,0,0,0,0,0,0,0,0,0,0
20200528,063424,新日興凱基01購01,,,,,0.00,0.00,0,0,0,0,0,0,0,0,0,0,0,0,0
20200528,063425,台勝科凱基9B購02,,,,,0.00,0.00,0,0,0,0,0,0,0,0,0,0,0,0,0
20200528,063426,茂林凱基9B購03,,,,,0.00,0.00,0,0,0,0,0,0,0,0,0,0,0,0,0
20200528,063427,南六凱基9B購04,2.30,2.30,2.30,2.30,-0.04,-1.71,7000,1,16100,0,0,0,0,0,0,7000,7000,0,0
20200528,063428,矽創凱基9B購02,3.18,3.18,3.18,3.18,+0.45,16.48,15000,2,47700,0,0,0,0,0,0,15000,15000,0,0
20200528,063429,南電凱基01購01,3.32,3.32,3.32,3.32,+0.09,2.79,3000,1,9960,0,0,0,0,0,0,0,3000,-3000,-3000
20200528,06342P,世芯統一98售01,0.64,0.65,0.62,0.62,-0.02,-3.12,27000,4,17300,0,0,0,0,0,0,0,1000,-1000,-1000
20200528,063430,台積電台新9B購07,0.83,0.83,0.83,0.83,0.00,0.00,100000,1,83000,0,0,0,0,0,0,0,100000,-100000,-100000
20200528,063431,神隆元富9B購01,,,,,0.00,0.00,0,0,0,0,0,0,0,0,0,0,0,0,0
20200528,063432,金寶元富9B購01,1.05,1.10,1.05,1.10,0.00,0.00,234000,6,248880,0,0,0,0,0,0,0,234000,-234000,-234000
20200528,063433,臻鼎元富9B購01,1.98,1.98,1.79,1.82,-0.09,-4.71,131000,8,248710,0,0,0,0,0,0,5000,131000,-126000,-126000
20200528,063434,和潤元富9B購01,2.61,2.61,2.56,2.56,0.00,0.00,83000,5,214630,0,0,0,0,0,0,0,83000,-83000,-83000
20200528,063435,儒鴻統一01購02,1.35,1.35,1.24,1.24,-0.02,-1.59,25000,2,33200,0,0,0,0,0,0,25000,25000,0,0
20200528,063436,儒鴻統一01購03,0.98,0.98,0.98,0.98,0.00,0.00,3000,2,2940,0,0,0,0,0,0,0,3000,-3000,-3000
20200528,063437,聚陽統一01購01,0.97,0.97,0.93,0.93,-0.06,-6.06,34000,4,32670,0,0,0,0,0,0,0,34000,-34000,-34000
20200528,063438,聚陽統一9C購01,1.22,1.22,1.18,1.18,-0.05,-4.07,61000,3,72780,0,0,0,0,0,0,0,61000,-61000,-61000
20200528,063439,正隆統一01購01,0.83,0.85,0.83,0.84,0.00,0.00,371000,7,308130,0,0,0,0,0,0,0,371000,-371000,-371000
20200528,06343P,臺股指統一98售01,,,,,0.00,0.00,0,0,0,0,0,0,0,0,0,0,0,0,0
20200528,063440,上銀統一01購02,2.33,2.43,2.15,2.16,-0.16,-6.9,590000,5,1283290,0,0,0,0,0,0,587000,3000,584000,584000
20200528,063441,台達電統一9C購01,1.09,1.09,1.09,1.09,0.00,0.00,22000,1,23980,0,0,0,0,0,0,0,22000,-22000,-22000
20200528,063442,金像電統一01購01,,,,,0.00,0.00,0,0,0,0,0,0,0,0,0,0,0,0,0
20200528,063443,金像電統一01購02,,,,,0.00,0.00,0,0,0,0,0,0,0,0,0,0,0,0,0
20200528,063444,金像電統一03購01,0.92,0.92,0.86,0.87,-0.01,-1.14,71000,14,63350,0,0,0,0,0,0,27000,44000,-17000,-17000
20200528,063445,金像電統一9B購01,1.41,1.41,1.27,1.32,0.00,0.00,502000,20,674230,15000,0,15000,0,0,0,432000,70000,362000,377000
20200528,063446,台光電統一01購02,0.87,0.89,0.87,0.89,0.00,0.00,30000,2,26500,0,0,0,0,0,0,0,30000,-30000,-30000
20200528,063447,聯發科統一9B購12,0.97,0.97,0.87,0.88,0.00,0.00,54000,8,48850,0,0,0,0,0,0,0,54000,-54000,-54000
20200528,063448,聯發科統一9C購11,1.00,1.00,0.96,0.97,0.00,0.00,83000,5,79740,0,0,0,0,0,0,0,83000,-83000,-83000
20200528,063449,全新統一9B購02,,,,,0.00,0.00,0,0,0,0,0,0,0,0,0,0,0,0,0
20200528,06344P,臺股指統一99售03,,,,,0.00,0.00,0,0,0,0,0,0,0,0,0,0,0,0,0
20200528,063450,華新科統一02購01,,,,,0.00,0.00,0,0,0,0,0,0,0,0,0,0,0,0,0
20200528,063451,漢翔統一9C購01,0.88,0.91,0.85,0.85,0.00,0.00,379000,14,337010,0,0,0,0,0,0,0,379000,-379000,-379000
20200528,063452,創意統一01購01,0.78,0.80,0.77,0.77,0.00,0.00,145000,4,113600,0,0,0,0,0,0,10000,135000,-125000,-125000
20200528,063453,創意統一9C購01,1.36,1.39,1.32,1.33,0.00,0.00,666000,22,904820,0,0,0,0,0,0,104000,666000,-562000,-562000
20200528,063454,瑞儀統一9B購01,1.14,1.18,1.14,1.14,0.00,0.00,296000,6,344340,0,0,0,0,0,0,0,296000,-296000,-296000
20200528,063455,T50反1元大9B購07,,,,,0.00,0.00,0,0,0,0,0,0,0,0,0,0,0,0,0
20200528,063456,T50反1元大9B購08,,,,,0.00,0.00,0,0,0,0,0,0,0,0,0,0,0,0,0
20200528,063457,臺指反元大02購17,1.16,1.17,1.16,1.17,-0.05,-4.1,110000,2,127700,0,0,0,0,0,0,100000,10000,90000,90000
20200528,063458,正隆元大9B購01,2.22,2.24,2.22,2.23,0.00,0.00,77000,4,171380,0,0,0,0,0,0,0,77000,-77000,-77000
20200528,063459,華通元大9B購08,2.76,3.02,2.75,2.83,+0.21,8.02,97000,10,278760,0,0,0,0,0,0,23000,97000,-74000,-74000
20200528,06345P,臺股指統一9A售01,,,,,0.00,0.00,0,0,0,0,0,0,0,0,0,0,0,0,0
20200528,063460,智邦元大9B購08,2.71,2.95,2.54,2.57,+0.14,5.76,213000,24,597460,0,0,0,0,0,0,115000,212000,-97000,-97000
20200528,063461,金像電元大9B購03,2.96,2.98,2.84,2.84,+0.07,2.53,125000,8,370190,0,0,0,0,0,0,32000,93000,-61000,-61000
20200528,063462,金像電元大9C購01,4.19,4.19,3.94,3.94,-0.01,-0.25,32000,12,129400,0,0,0,0,0,0,15000,17000,-2000,-2000
20200528,063463,瑞昱元大9B購05,3.35,3.38,3.29,3.29,0.00,0.00,317000,16,1050760,0,0,0,0,0,0,30000,317000,-287000,-287000
20200528,063464,廣達元大9B購02,2.25,2.25,2.25,2.25,0.00,0.00,44000,2,99000,0,0,0,0,0,0,0,44000,-44000,-44000
20200528,063465,友達元大9C購10,,,,,0.00,0.00,0,0,0,0,0,0,0,0,0,0,0,0,0
20200528,063466,美食元大9B購02,,,,,0.00,0.00,0,0,0,0,0,0,0,0,0,0,0,0,0
20200528,063467,大立光元大9C購06,,,,,0.00,0.00,0,0,0,0,0,0,0,0,0,0,0,0,0
20200528,063468,聯詠元大9B購04,3.51,3.51,3.51,3.51,0.00,0.00,4000,1,14040,0,0,0,0,0,0,4000,4000,0,0
20200528,063469,牧德元大9C購02,1.19,1.19,1.19,1.19,-0.06,-4.8,10000,1,11900,0,0,0,0,0,0,0,10000,-10000,-10000
20200528,06346P,聯鈞元富97售02,,,,,0.00,0.00,0,0,0,0,0,0,0,0,0,0,0,0,0
20200528,063470,泰鼎元大9B購03,,,,,0.00,0.00,0,0,0,0,0,0,0,0,0,0,0,0,0
20200528,063471,泰鼎元大9C購01,1.18,1.18,1.15,1.15,+0.02,1.77,41000,3,47600,0,0,0,0,0,0,36000,41000,-5000,-5000
20200528,063472,茂林元大9B購04,2.66,2.66,2.52,2.52,-0.42,-14.29,25000,2,65240,0,0,0,0,0,0,25000,25000,0,0
20200528,063473,茂林元大9B購05,,,,,0.00,0.00,0,0,0,0,0,0,0,0,0,0,0,0,0
20200528,063474,康控元大9B購04,1.67,1.67,1.58,1.58,-0.12,-7.06,8000,2,13180,0,0,0,0,0,0,6000,8000,-2000,-2000
20200528,063475,同欣電元大9C購01,1.58,1.60,1.58,1.58,-0.14,-8.14,36000,3,57100,0,0,0,0,0,0,36000,11000,25000,25000
20200528,063476,台表科元大9C購03,1.52,1.54,1.41,1.44,-0.09,-5.88,240000,8,343920,0,0,0,0,0,0,240000,40000,200000,200000
20200528,063477,訊芯元大9B購01,1.55,1.55,1.46,1.46,0.00,0.00,15000,2,22800,0,0,0,0,0,0,0,15000,-15000,-15000
20200528,063478,GIS元大9B購03,2.48,2.48,2.16,2.16,-0.40,-15.62,29000,4,69800,0,0,0,0,0,0,16000,13000,3000,3000
20200528,063479,南六元大9B購06,,,,,0.00,0.00,0,0,0,0,0,0,0,0,0,0,0,0,0
20200528,06347P,祥碩元富97售02,0.13,0.13,0.13,0.13,-0.01,-7.14,10000,1,1300,0,0,0,0,0,0,0,10000,-10000,-10000
20200528,063480,南六元大9C購01,,,,,0.00,0.00,0,0,0,0,0,0,0,0,0,0,0,0,0
20200528,063481,緯穎元大9B購08,2.48,2.48,2.48,2.48,-0.22,-8.15,1000,1,2480,0,0,0,0,0,0,0,1000,-1000,-1000
20200528,063482,緯穎元大9B購09,2.25,2.25,2.25,2.25,0.00,0.00,4000,1,9000,0,0,0,0,0,0,4000,4000,0,0
20200528,063483,致新元大9B購03,1.87,1.99,1.87,1.99,0.00,0.00,1171000,42,2274430,1000,0,1000,0,0,0,130000,1171000,-1041000,-1040000
20200528,063484,達方元大9B購01,,,,,0.00,0.00,0,0,0,0,0,0,0,0,0,0,0,0,0
20200528,063485,巨大元大9B購04,1.71,1.76,1.71,1.71,0.00,0.00,117000,3,204320,0,0,0,0,0,0,32000,117000,-85000,-85000
20200528,063486,聚陽國泰9C購01,,,,,0.00,0.00,0,0,0,0,0,0,0,0,0,0,0,0,0
20200528,063487,國巨國泰01購02,1.22,1.22,1.14,1.14,-0.03,-2.56,18000,2,21160,0,0,0,0,0,0,0,18000,-18000,-18000
20200528,063488,金像電國泰01購01,1.95,1.95,1.79,1.79,-0.10,-5.29,69000,3,126170,0,0,0,0,0,0,68000,1000,67000,67000
20200528,063489,新日興國泰01購01,1.57,1.57,1.57,1.57,+0.19,13.77,10000,1,15700,0,0,0,0,0,0,0,10000,-10000,-10000
20200528,06348P,鈺齊元富97售02,,,,,0.00,0.00,0,0,0,0,0,0,0,0,0,0,0,0,0
20200528,063490,儒鴻富邦9C購01,0.86,0.86,0.81,0.81,-0.05,-5.81,335000,6,281910,0,0,0,0,0,0,200000,335000,-135000,-135000
20200528,063491,國巨富邦02購02,0.58,0.58,0.58,0.58,-0.18,-23.68,52000,3,30160,0,0,0,0,0,0,0,52000,-52000,-52000
20200528,063492,台積電富邦02購02,0.64,0.64,0.64,0.64,0.00,0.00,10000,1,6400,0,0,0,0,0,0,0,10000,-10000,-10000
20200528,063493,金像電富邦01購01,,,,,0.00,0.00,0,0,0,0,0,0,0,0,0,0,0,0,0
20200528,063494,金像電富邦9B購01,1.00,1.00,0.97,0.97,-0.09,-8.49,55000,3,53800,0,15000,-15000,0,0,0,55000,0,55000,40000
20200528,063495,台光電富邦9C購01,0.82,0.82,0.79,0.79,0.00,0.00,40000,5,31950,0,0,0,0,0,0,0,40000,-40000,-40000
20200528,063496,儒鴻永豐9B購01,1.35,1.35,1.25,1.25,-0.14,-10.07,11000,2,14750,0,0,0,0,0,0,1000,10000,-9000,-9000
20200528,063497,東元永豐9B購01,1.10,1.10,1.06,1.06,0.00,0.00,54000,3,58900,0,0,0,0,0,0,0,54000,-54000,-54000
20200528,063498,金像電永豐9B購02,1.34,1.34,1.33,1.33,-0.10,-6.99,18000,2,24010,0,0,0,0,0,0,18000,0,18000,18000
20200528,063499,金像電永豐9B購03,,,,,0.00,0.00,0,0,0,0,0,0,0,0,0,0,0,0,0
20200528,06349P,臺股指台新99售01,2.03,2.03,2.03,2.03,0.00,0.00,10000,1,20300,0,0,0,0,0,0,10000,10000,0,0
20200528,063500,嘉晶永豐9B購02,1.27,1.27,1.18,1.18,-0.14,-10.61,46000,8,57000,0,0,0,0,0,0,22000,24000,-2000,-2000
20200528,063501,旭富永豐9B購02,,,,,0.00,0.00,0,0,0,0,0,0,0,0,0,0,0,0,0
20200528,063502,南電永豐9B購02,,,,,0.00,0.00,0,0,0,0,0,0,0,0,0,0,0,0,0
20200528,063503,香港反中信9C購01,0.84,0.93,0.84,0.89,-0.25,-21.93,482000,16,439130,0,0,0,0,0,0,0,482000,-482000,-482000
20200528,063504,國巨群益9C購06,1.40,1.40,1.37,1.37,-0.10,-6.8,6000,5,8280,0,0,0,0,0,0,0,6000,-6000,-6000
20200528,063505,奇力新群益9B購03,,,,,0.00,0.00,0,0,0,0,0,0,0,0,0,0,0,0,0
20200528,063506,嘉晶群益9B購01,0.76,0.76,0.76,0.76,+0.12,18.75,80000,2,60800,0,0,0,0,0,0,0,80000,-80000,-80000
20200528,063507,奇鋐群益9B購02,3.98,4.03,3.78,3.78,+0.44,13.17,21000,5,83940,0,0,0,0,0,0,0,21000,-21000,-21000
20200528,063508,緯創群益9B購01,,,,,0.00,0.00,0,0,0,0,0,0,0,0,0,0,0,0,0
20200528,063509,超眾群益9B購03,2.54,2.54,2.49,2.49,+0.38,18.01,9000,2,22760,0,0,0,0,0,0,0,9000,-9000,-9000
20200528,06350P,臺股指台新99售02,,,,,0.00,0.00,0,0,0,0,0,0,0,0,0,0,0,0,0
20200528,063510,台表科群益9C購01,,,,,0.00,0.00,0,0,0,0,0,0,0,0,0,0,0,0,0
20200528,063511,南電群益9B購02,,,,,0.00,0.00,0,0,0,0,0,0,0,0,0,0,0,0,0
20200528,063512,聯發科麥證9B購02,,,,,0.00,0.00,0,0,0,0,0,0,0,0,0,0,0,0,0
20200528,063513,聯發科麥證9B購03,,,,,0.00,0.00,0,0,0,0,0,0,0,0,0,0,0,0,0
20200528,063514,南電麥證9C購01,,,,,0.00,0.00,0,0,0,0,0,0,0,0,0,0,0,0,0
20200528,063515,香港2X凱基01購01,,,,,0.00,0.00,0,0,0,0,0,0,0,0,0,0,0,0,0
20200528,063516,香港反凱基03購01,0.78,0.90,0.78,0.86,-0.52,-37.68,1874000,44,1606070,0,0,0,0,0,0,0,1874000,-1874000,-1874000
20200528,063517,遠東新凱基01購01,,,,,0.00,0.00,0,0,0,0,0,0,0,0,0,0,0,0,0
20200528,063518,儒鴻凱基9B購02,,,,,0.00,0.00,0,0,0,0,0,0,0,0,0,0,0,0,0
20200528,063519,聚陽凱基9B購02,,,,,0.00,0.00,0,0,0,0,0,0,0,0,0,0,0,0,0
20200528,06351P,臺股指台新99售03,,,,,0.00,0.00,0,0,0,0,0,0,0,0,0,0,0,0,0
20200528,063520,上銀凱基9B購05,4.88,4.88,4.88,4.88,+0.87,21.7,3000,1,14640,0,0,0,0,0,0,0,3000,-3000,-3000
20200528,063521,國巨凱基03購01,,,,,0.00,0.00,0,0,0,0,0,0,0,0,0,0,0,0,0
20200528,063522,技嘉凱基9B購03,,,,,0.00,0.00,0,0,0,0,0,0,0,0,0,0,0,0,0
20200528,063523,微星凱基9B購03,,,,,0.00,0.00,0,0,0,0,0,0,0,0,0,0,0,0,0
20200528,063524,瑞昱凱基9B購05,,,,,0.00,0.00,0,0,0,0,0,0,0,0,0,0,0,0,0
20200528,063525,廣達凱基9B購02,,,,,0.00,0.00,0,0,0,0,0,0,0,0,0,0,0,0,0
20200528,063526,台光電凱基9B購04,,,,,0.00,0.00,0,0,0,0,0,0,0,0,0,0,0,0,0
20200528,063527,美食凱基01購01,,,,,0.00,0.00,0,0,0,0,0,0,0,0,0,0,0,0,0
20200528,063528,元大金凱基9B購01,,,,,0.00,0.00,0,0,0,0,0,0,0,0,0,0,0,0,0
20200528,063529,聯茂凱基9B購02,,,,,0.00,0.00,0,0,0,0,0,0,0,0,0,0,0,0,0
20200528,06352P,臺股指富邦99售02,,,,,0.00,0.00,0,0,0,0,0,0,0,0,0,0,0,0,0
20200528,063530,同欣電凱基9C購02,2.91,2.91,2.91,2.91,-0.38,-11.55,3000,1,8730,0,0,0,0,0,0,3000,3000,0,0
20200528,063531,台表科凱基9B購04,,,,,0.00,0.00,0,0,0,0,0,0,0,0,0,0,0,0,0
20200528,063532,GIS凱基9B購03,1.28,1.28,1.28,1.28,-0.21,-14.09,2000,1,2560,0,0,0,0,0,0,0,2000,-2000,-2000
20200528,063533,緯穎凱基9B購06,4.22,4.22,4.02,4.02,+0.40,11.05,2000,2,8240,0,0,0,0,0,0,0,2000,-2000,-2000
20200528,063534,鴻海統一9B購07,1.43,1.43,1.43,1.43,+0.03,2.14,1000,1,1430,0,0,0,0,0,0,1000,1000,0,0
20200528,063535,聯發科統一9B購13,1.61,1.62,1.55,1.62,-0.03,-1.82,5000,3,7880,0,0,0,0,0,0,0,5000,-5000,-5000
20200528,063536,美食統一01購01,,,,,0.00,0.00,0,0,0,0,0,0,0,0,0,0,0,0,0
20200528,063537,華擎統一9C購03,,,,,0.00,0.00,0,0,0,0,0,0,0,0,0,0,0,0,0
20200528,063538,神達統一9C購01,,,,,0.00,0.00,0,0,0,0,0,0,0,0,0,0,0,0,0
20200528,063539,世紀鋼統一9B購02,1.11,1.11,1.08,1.09,+0.20,22.47,42000,4,45820,0,0,0,0,0,0,0,42000,-42000,-42000
20200528,06353P,電子類富邦99售02,,,,,0.00,0.00,0,0,0,0,0,0,0,0,0,0,0,0,0
20200528,063540,SP黃豆元富9B購02,,,,,0.00,0.00,0,0,0,0,0,0,0,0,0,0,0,0,0
20200528,063541,華擎元富9B購02,2.00,2.00,2.00,2.00,+0.05,2.56,1000,1,2000,0,0,0,0,0,0,0,1000,-1000,-1000
20200528,063542,泰鼎元富9B購02,1.61,1.61,1.51,1.51,-0.27,-15.17,3000,2,4730,0,0,0,0,0,0,0,3000,-3000,-3000
20200528,063543,技嘉台新9B購02,,,,,0.00,0.00,0,0,0,0,0,0,0,0,0,0,0,0,0
20200528,063544,華新科台新9B購02,,,,,0.00,0.00,0,0,0,0,0,0,0,0,0,0,0,0,0
20200528,063545,華通兆豐9B購03,2.19,2.21,2.05,2.11,+0.18,9.33,425000,8,933100,0,0,0,0,0,0,0,425000,-425000,-425000
20200528,063546,國巨兆豐9C購03,,,,,0.00,0.00,0,0,0,0,0,0,0,0,0,0,0,0,0
20200528,063547,大立光兆豐9B購04,,,,,0.00,0.00,0,0,0,0,0,0,0,0,0,0,0,0,0
20200528,063548,同欣電兆豐9B購01,,,,,0.00,0.00,0,0,0,0,0,0,0,0,0,0,0,0,0
20200528,063549,國巨國票9C購05,,,,,0.00,0.00,0,0,0,0,0,0,0,0,0,0,0,0,0
20200528,06354P,大立光永豐97售04,,,,,0.00,0.00,0,0,0,0,0,0,0,0,0,0,0,0,0
20200528,063550,可成國票9C購01,2.27,2.27,2.22,2.22,+0.54,32.14,4000,2,8930,0,0,0,0,0,0,4000,4000,0,0
20200528,063551,美食國票9B購02,,,,,0.00,0.00,0,0,0,0,0,0,0,0,0,0,0,0,0
20200528,063552,晶技國票9B購03,,,,,0.00,0.00,0,0,0,0,0,0,0,0,0,0,0,0,0
20200528,063553,同欣電國票9B購03,,,,,0.00,0.00,0,0,0,0,0,0,0,0,0,0,0,0,0
20200528,063554,GIS國票9C購03,,,,,0.00,0.00,0,0,0,0,0,0,0,0,0,0,0,0,0
20200528,063555,SP黃豆元大9B購01,,,,,0.00,0.00,0,0,0,0,0,0,0,0,0,0,0,0,0
20200528,063556,儒鴻元大9B購02,2.05,2.05,2.05,2.05,+0.08,4.06,5000,1,10250,0,0,0,0,0,0,0,5000,-5000,-5000
20200528,063557,聚陽元大9B購01,,,,,0.00,0.00,0,0,0,0,0,0,0,0,0,0,0,0,0
20200528,063558,聚陽元大9B購02,,,,,0.00,0.00,0,0,0,0,0,0,0,0,0,0,0,0,0
20200528,063559,力山元大9B購04,,,,,0.00,0.00,0,0,0,0,0,0,0,0,0,0,0,0,0
20200528,06355P,聯茂永豐97售02,0.58,0.59,0.58,0.58,-0.04,-6.45,78000,3,45440,0,0,0,0,0,0,0,78000,-78000,-78000
20200528,063560,力山元大9B購05,,,,,0.00,0.00,0,0,0,0,0,0,0,0,0,0,0,0,0
20200528,063561,上銀元大9B購08,4.63,4.63,4.63,4.63,+0.84,22.16,10000,1,46300,0,0,0,0,0,0,0,10000,-10000,-10000
20200528,063562,國巨元大9C購06,1.55,1.55,1.54,1.54,-0.13,-7.78,53000,5,81720,0,0,0,0,0,0,0,53000,-53000,-53000
20200528,063563,國巨元大9C購07,,,,,0.00,0.00,0,0,0,0,0,0,0,0,0,0,0,0,0
20200528,063564,台積電元大9B購07,,,,,0.00,0.00,0,0,0,0,0,0,0,0,0,0,0,0,0
20200528,063565,旺宏元大9B購08,,,,,0.00,0.00,0,0,0,0,0,0,0,0,0,0,0,0,0
20200528,063566,台光電元大9B購08,,,,,0.00,0.00,0,0,0,0,0,0,0,0,0,0,0,0,0
20200528,063567,漢唐元大9B購03,1.84,1.84,1.78,1.78,-0.15,-7.77,8000,2,14420,0,0,0,0,0,0,0,8000,-8000,-8000
20200528,063568,高鐵元大9B購01,1.98,1.98,1.73,1.76,-0.14,-7.37,81000,10,151460,0,0,0,0,0,0,0,81000,-81000,-81000
20200528,063569,美食元大9B購03,,,,,0.00,0.00,0,0,0,0,0,0,0,0,0,0,0,0,0
20200528,06356P,啟碁永豐97售01,2.56,2.56,2.56,2.56,-0.13,-4.83,37000,1,94720,0,0,0,0,0,0,0,37000,-37000,-37000
20200528,063570,嘉晶元大9C購02,3.21,3.27,3.14,3.16,-0.51,-13.9,82000,8,258910,0,0,0,0,0,0,10000,82000,-72000,-72000
20200528,063571,TPK元大9B購03,,,,,0.00,0.00,0,0,0,0,0,0,0,0,0,0,0,0,0
20200528,063572,麗豐元大9B購01,,,,,0.00,0.00,0,0,0,0,0,0,0,0,0,0,0,0,0
20200528,063573,茂林元大9B購06,,,,,0.00,0.00,0,0,0,0,0,0,0,0,0,0,0,0,0
20200528,063574,茂林元大9B購07,,,,,0.00,0.00,0,0,0,0,0,0,0,0,0,0,0,0,0
20200528,063575,矽格元大9B購02,1.50,1.50,1.46,1.46,-0.03,-2.01,18000,3,26320,0,0,0,0,0,0,0,18000,-18000,-18000
20200528,063576,台表科元大9B購08,,,,,0.00,0.00,0,0,0,0,0,0,0,0,0,0,0,0,0
20200528,063577,台表科元大9C購04,,,,,0.00,0.00,0,0,0,0,0,0,0,0,0,0,0,0,0
20200528,063578,瑞祺元大9B購03,2.05,2.11,2.05,2.11,+0.14,7.11,21000,3,44130,0,0,0,0,0,0,3000,21000,-18000,-18000
20200528,063579,GIS元大9C購01,2.95,2.95,2.48,2.48,-0.44,-15.07,56000,4,141230,0,0,0,0,0,0,0,56000,-56000,-56000
20200528,06357P,臺股指永豐97售03,,,,,0.00,0.00,0,0,0,0,0,0,0,0,0,0,0,0,0
20200528,063580,立積國泰9C購01,,,,,0.00,0.00,0,0,0,0,0,0,0,0,0,0,0,0,0
20200528,063581,同欣電國泰9C購01,1.49,1.49,1.44,1.44,-0.03,-2.04,11000,3,16290,0,0,0,0,0,0,3000,11000,-8000,-8000
20200528,063582,瑞祺國泰9C購01,1.37,1.44,1.37,1.44,+0.02,1.41,33000,4,47090,0,0,0,0,0,0,7000,33000,-26000,-26000
20200528,063583,GIS國泰01購01,,,,,0.00,0.00,0,0,0,0,0,0,0,0,0,0,0,0,0
20200528,063584,南六國泰01購01,1.55,1.55,1.48,1.48,-0.04,-2.63,64000,4,97940,0,0,0,0,0,0,61000,64000,-3000,-3000
20200528,063585,台積電永豐9B購03,1.26,1.26,1.18,1.20,-0.07,-5.51,10000,4,12270,0,0,0,0,0,0,0,10000,-10000,-10000
20200528,063586,燿華永豐9B購02,,,,,0.00,0.00,0,0,0,0,0,0,0,0,0,0,0,0,0
20200528,063587,漢唐永豐9B購02,,,,,0.00,0.00,0,0,0,0,0,0,0,0,0,0,0,0,0
20200528,063588,華新科永豐9B購02,,,,,0.00,0.00,0,0,0,0,0,0,0,0,0,0,0,0,0
20200528,063589,美食永豐9B購02,,,,,0.00,0.00,0,0,0,0,0,0,0,0,0,0,0,0,0
20200528,06358P,力成中信97售02,,,,,0.00,0.00,0,0,0,0,0,0,0,0,0,0,0,0,0
20200528,063590,華擎永豐9B購01,,,,,0.00,0.00,0,0,0,0,0,0,0,0,0,0,0,0,0
20200528,063591,麗豐永豐9B購02,,,,,0.00,0.00,0,0,0,0,0,0,0,0,0,0,0,0,0
20200528,063592,瑞祺永豐9B購02,0.89,0.89,0.89,0.89,+0.03,3.49,1000,1,890,0,0,0,0,0,0,0,1000,-1000,-1000
20200528,063593,GIS永豐9B購01,0.69,0.69,0.69,0.69,-0.01,-1.43,20000,1,13800,0,0,0,0,0,0,0,20000,-20000,-20000
20200528,06359P,上銀群益97售03,2.06,2.25,2.06,2.25,+0.31,15.98,37000,2,81350,0,0,0,0,0,0,10000,27000,-17000,-17000
20200528,06360P,台積電群益97售05,,,,,0.00,0.00,0,0,0,0,0,0,0,0,0,0,0,0,0
20200528,06361P,聯發科群益97售06,,,,,0.00,0.00,0,0,0,0,0,0,0,0,0,0,0,0,0
20200528,06362P,臺股指麥證97售01,,,,,0.00,0.00,0,0,0,0,0,0,0,0,0,0,0,0,0
20200528,06363P,臺股指麥證97售02,,,,,0.00,0.00,0,0,0,0,0,0,0,0,0,0,0,0,0
20200528,06364P,鴻海凱基97售08,,,,,0.00,0.00,0,0,0,0,0,0,0,0,0,0,0,0,0
20200528,06365P,鴻海凱基97售09,,,,,0.00,0.00,0,0,0,0,0,0,0,0,0,0,0,0,0
20200528,06366P,鴻海凱基97售10,,,,,0.00,0.00,0,0,0,0,0,0,0,0,0,0,0,0,0
20200528,06367P,台積電凱基97售14,,,,,0.00,0.00,0,0,0,0,0,0,0,0,0,0,0,0,0
20200528,06368P,台積電凱基97售15,,,,,0.00,0.00,0,0,0,0,0,0,0,0,0,0,0,0,0
20200528,06369P,台積電凱基97售16,,,,,0.00,0.00,0,0,0,0,0,0,0,0,0,0,0,0,0
20200528,06370P,貿聯凱基97售03,0.66,0.71,0.66,0.71,0.00,0.00,466000,10,317980,0,0,0,0,0,0,150000,316000,-166000,-166000
20200528,06371P,茂林國票98售04,1.59,1.65,1.58,1.65,+0.01,0.61,495000,8,785540,0,0,0,0,0,0,481000,14000,467000,467000
20200528,06372P,聯發科元大97售21,,,,,0.00,0.00,0,0,0,0,0,0,0,0,0,0,0,0,0
20200528,06373P,聯發科元大97售22,,,,,0.00,0.00,0,0,0,0,0,0,0,0,0,0,0,0,0
20200528,06374P,台表科元大97售06,0.82,0.92,0.82,0.88,+0.02,2.33,35000,3,30400,0,0,0,0,0,0,15000,20000,-5000,-5000
20200528,06375P,矽力元大97售06,,,,,0.00,0.00,0,0,0,0,0,0,0,0,0,0,0,0,0
20200528,06376P,上銀統一99售01,1.67,1.87,1.64,1.87,+0.22,13.33,121000,9,213400,0,64000,-64000,0,0,0,71000,50000,21000,-43000
20200528,06377P,華通統一97售04,2.07,2.07,2.07,2.07,-0.51,-19.77,20000,1,41400,0,0,0,0,0,0,20000,0,20000,20000
20200528,06378P,國巨統一97售08,3.67,3.67,3.67,3.67,0.00,0.00,129000,4,473430,0,0,0,0,0,0,0,129000,-129000,-129000
20200528,06379P,群創統一97售05,,,,,0.00,0.00,0,0,0,0,0,0,0,0,0,0,0,0,0
20200528,06380P,臺股指統一98售02,,,,,0.00,0.00,0,0,0,0,0,0,0,0,0,0,0,0,0
20200528,06381P,臺股指統一98售03,,,,,0.00,0.00,0,0,0,0,0,0,0,0,0,0,0,0,0
20200528,06382P,大毅元富97售02,,,,,0.00,0.00,0,0,0,0,0,0,0,0,0,0,0,0,0
20200528,06383P,聯茂元富97售01,0.44,0.44,0.44,0.44,0.00,0.00,2000,1,880,0,0,0,0,0,0,2000,0,2000,2000
20200528,06384P,訊芯元富97售03,,,,,0.00,0.00,0,0,0,0,0,0,0,0,0,0,0,0,0
20200528,06385P,聯發科永豐97售02,0.20,0.25,0.20,0.25,0.00,0.00,28000,2,6250,0,0,0,0,0,0,28000,28000,0,0
20200528,06386P,欣興永豐97售03,2.26,2.28,2.19,2.24,-0.12,-5.08,46000,7,103930,0,0,0,0,0,0,40000,6000,34000,34000
20200528,06387P,緯穎永豐97售02,,,,,0.00,0.00,0,0,0,0,0,0,0,0,0,0,0,0,0
20200528,06388P,鴻海兆豐97售04,,,,,0.00,0.00,0,0,0,0,0,0,0,0,0,0,0,0,0
20200528,06389P,聯發科兆豐97售01,1.17,1.17,1.17,1.17,0.00,0.00,200000,2,234000,0,0,0,0,0,0,0,200000,-200000,-200000
20200528,06390P,美律國票97售03,,,,,0.00,0.00,0,0,0,0,0,0,0,0,0,0,0,0,0
20200528,06391P,上銀中信97售03,,,,,0.00,0.00,0,0,0,0,0,0,0,0,0,0,0,0,0
20200528,06392P,T50反1元大9A售01,,,,,0.00,0.00,0,0,0,0,0,0,0,0,0,0,0,0,0
20200528,06393P,台積電元大97售27,,,,,0.00,0.00,0,0,0,0,0,0,0,0,0,0,0,0,0
20200528,06394P,台積電元大97售28,,,,,0.00,0.00,0,0,0,0,0,0,0,0,0,0,0,0,0
20200528,06395P,台積電元大97售29,2.79,2.79,2.73,2.73,-0.28,-9.3,10000,2,27600,0,0,0,0,0,0,0,10000,-10000,-10000
20200528,06396P,新日興康和97售01,,,,,0.00,0.00,0,0,0,0,0,0,0,0,0,0,0,0,0
20200528,06397P,T50反1凱基9A售03,,,,,0.00,0.00,0,0,0,0,0,0,0,0,0,0,0,0,0
20200528,06398P,禾伸堂凱基97售02,,,,,0.00,0.00,0,0,0,0,0,0,0,0,0,0,0,0,0
20200528,06399P,台表科凱基97售05,0.57,0.57,0.57,0.57,0.00,0.00,15000,1,8550,0,0,0,0,0,0,0,15000,-15000,-15000
20200528,06400P,鴻海元富97售12,,,,,0.00,0.00,0,0,0,0,0,0,0,0,0,0,0,0,0
20200528,06401P,鴻海元富97售13,,,,,0.00,0.00,0,0,0,0,0,0,0,0,0,0,0,0,0
20200528,06402P,鴻海元富97售14,,,,,0.00,0.00,0,0,0,0,0,0,0,0,0,0,0,0,0
20200528,06403P,鴻海元富97售15,,,,,0.00,0.00,0,0,0,0,0,0,0,0,0,0,0,0,0
20200528,06404P,鴻海元富97售16,,,,,0.00,0.00,0,0,0,0,0,0,0,0,0,0,0,0,0
20200528,06405P,億光元富97售02,1.66,1.72,1.66,1.72,+0.02,1.18,30000,4,50900,0,0,0,0,0,0,10000,20000,-10000,-10000
20200528,06406P,可成元富97售04,,,,,0.00,0.00,0,0,0,0,0,0,0,0,0,0,0,0,0
20200528,06407P,創意元富97售02,,,,,0.00,0.00,0,0,0,0,0,0,0,0,0,0,0,0,0
20200528,06408P,聯茂元富97售02,0.54,0.54,0.54,0.54,0.00,0.00,5000,1,2700,0,0,0,0,0,0,5000,0,5000,5000
20200528,06409P,康友元富97售03,,,,,0.00,0.00,0,0,0,0,0,0,0,0,0,0,0,0,0
20200528,06410P,祥碩統一97售01,,,,,0.00,0.00,0,0,0,0,0,0,0,0,0,0,0,0,0
20200528,06411P,晶相光永豐97售03,1.25,1.29,1.25,1.28,+0.08,6.67,37000,4,47010,0,0,0,0,0,0,0,37000,-37000,-37000
20200528,06412P,南亞科日盛97售01,,,,,0.00,0.00,0,0,0,0,0,0,0,0,0,0,0,0,0
20200528,06413P,聯發科凱基97售11,,,,,0.00,0.00,0,0,0,0,0,0,0,0,0,0,0,0,0
20200528,06414P,矽力凱基97售03,,,,,0.00,0.00,0,0,0,0,0,0,0,0,0,0,0,0,0
20200528,06415P,台積電群益97售07,5.35,5.35,5.35,5.35,0.00,0.00,259000,3,1385650,0,0,0,0,0,0,259000,259000,0,0
20200528,06416P,大立光群益97售06,1.24,1.24,1.22,1.22,+0.47,62.67,8000,3,9820,0,0,0,0,0,0,0,0,0,0
20200528,06417P,台積電兆豐97售03,2.53,2.53,2.53,2.53,0.00,0.00,4000,1,10120,0,0,0,0,0,0,0,4000,-4000,-4000
20200528,06418P,T50反1統一9A售02,0.75,0.75,0.75,0.75,0.00,0.00,20000,2,15000,0,0,0,0,0,0,20000,0,20000,20000
20200528,06419P,國巨統一97售09,,,,,0.00,0.00,0,0,0,0,0,0,0,0,0,0,0,0,0
20200528,06420P,大立光統一98售06,,,,,0.00,0.00,0,0,0,0,0,0,0,0,0,0,0,0,0
20200528,06421P,嘉澤統一97售02,0.61,0.66,0.61,0.66,+0.02,3.12,760000,17,484340,0,0,0,0,0,0,233000,527000,-294000,-294000
20200528,06422P,勤誠統一98售01,,,,,0.00,0.00,0,0,0,0,0,0,0,0,0,0,0,0,0
20200528,06423P,亞光台新97售01,,,,,0.00,0.00,0,0,0,0,0,0,0,0,0,0,0,0,0
20200528,06424P,大成鋼永豐97售01,1.63,1.63,1.63,1.63,-0.03,-1.81,10000,1,16300,0,0,0,0,0,0,10000,0,10000,10000
20200528,06425P,TPK永豐97售02,1.88,1.99,1.84,1.99,+0.08,4.19,137000,10,262670,0,0,0,0,0,0,33000,104000,-71000,-71000
20200528,06426P,T50正2元大9B售01,0.62,0.76,0.62,0.76,+0.04,5.56,21000,5,14340,0,0,0,0,0,0,10000,4000,6000,6000
20200528,06427P,鴻海元大97售13,,,,,0.00,0.00,0,0,0,0,0,0,0,0,0,0,0,0,0
20200528,06428P,國巨元大97售17,,,,,0.00,0.00,0,0,0,0,0,0,0,0,0,0,0,0,0
20200528,06429P,大立光元大97售15,,,,,0.00,0.00,0,0,0,0,0,0,0,0,0,0,0,0,0
20200528,06430P,大立光元大97售16,,,,,0.00,0.00,0,0,0,0,0,0,0,0,0,0,0,0,0
20200528,06431P,新日興元大97售05,2.00,2.02,1.89,2.02,-0.14,-6.48,184000,7,362210,0,0,0,0,0,0,124000,60000,64000,64000
20200528,06432P,上銀群益98售01,,,,,0.00,0.00,0,0,0,0,0,0,0,0,0,0,0,0,0
20200528,06433P,大立光群益99售01,,,,,0.00,0.00,0,0,0,0,0,0,0,0,0,0,0,0,0
20200528,06434P,超眾群益98售02,0.63,0.63,0.58,0.61,-0.02,-3.17,271000,6,166610,0,0,0,0,0,0,51000,220000,-169000,-169000
20200528,06435P,臺股指群益98售02,,,,,0.00,0.00,0,0,0,0,0,0,0,0,0,0,0,0,0
20200528,06436P,台光電國票98售04,0.64,0.72,0.64,0.71,+0.08,12.7,474000,16,319680,0,0,0,0,0,0,131000,293000,-162000,-162000
20200528,06437P,玉晶光國票99售01,7.70,7.90,7.70,7.90,-0.20,-2.47,8000,2,62400,0,0,0,0,0,0,4000,4000,0,0
20200528,06438P,玉晶光國票99售02,,,,,0.00,0.00,0,0,0,0,0,0,0,0,0,0,0,0,0
20200528,06439P,上銀凱基98售02,,,,,0.00,0.00,0,0,0,0,0,0,0,0,0,0,0,0,0
20200528,06440P,台積電凱基98售07,,,,,0.00,0.00,0,0,0,0,0,0,0,0,0,0,0,0,0
20200528,06441P,台積電凱基98售08,3.14,3.14,3.14,3.14,0.00,0.00,1000,1,3140,0,0,0,0,0,0,1000,1000,0,0
20200528,06443P,台積電凱基99售01,,,,,0.00,0.00,0,0,0,0,0,0,0,0,0,0,0,0,0
20200528,06444P,大立光凱基98售08,,,,,0.00,0.00,0,0,0,0,0,0,0,0,0,0,0,0,0
20200528,06445P,大立光凱基98售09,4.04,4.04,4.04,4.04,0.00,0.00,5000,1,20200,0,0,0,0,0,0,0,5000,-5000,-5000
20200528,06446P,大立光凱基98售10,,,,,0.00,0.00,0,0,0,0,0,0,0,0,0,0,0,0,0
20200528,06447P,上銀元大98售01,1.34,1.58,1.34,1.58,+0.20,14.49,152000,6,231340,0,0,0,0,0,0,3000,149000,-146000,-146000
20200528,06448P,華通元大99售01,1.81,1.81,1.71,1.79,-0.11,-5.79,51000,9,88490,0,0,0,0,0,0,46000,5000,41000,41000
20200528,06449P,台積電元大98售09,5.45,5.50,5.45,5.50,0.00,0.00,6000,2,32850,0,0,0,0,0,0,0,6000,-6000,-6000
20200528,06450P,聯發科元大98售03,,,,,0.00,0.00,0,0,0,0,0,0,0,0,0,0,0,0,0
20200528,06451P,聯發科元大98售04,,,,,0.00,0.00,0,0,0,0,0,0,0,0,0,0,0,0,0
20200528,06452P,大立光元大98售08,,,,,0.00,0.00,0,0,0,0,0,0,0,0,0,0,0,0,0
20200528,06453P,群創元大9B售02,3.02,3.03,3.02,3.03,-0.03,-0.98,130000,4,393400,0,0,0,0,0,0,130000,80000,50000,50000
20200528,06454P,緯穎元大98售04,0.26,0.27,0.26,0.27,+0.03,12.5,30000,3,8000,0,0,0,0,0,0,30000,0,30000,30000
20200528,06455P,上銀統一99售03,,,,,0.00,0.00,0,0,0,0,0,0,0,0,0,0,0,0,0
20200528,06456P,聯發科統一98售03,0.36,0.39,0.36,0.36,0.00,0.00,381000,32,142610,0,0,0,0,0,0,145000,67000,78000,78000
20200528,06457P,玉晶光統一98售02,2.35,2.36,2.25,2.35,-0.10,-4.08,74000,8,171540,0,0,0,0,0,0,30000,44000,-14000,-14000
20200528,06458P,玉晶光統一9A售02,2.24,2.24,2.24,2.24,0.00,0.00,6000,1,13440,0,0,0,0,0,0,0,6000,-6000,-6000
20200528,06459P,亞德客元富98售01,,,,,0.00,0.00,0,0,0,0,0,0,0,0,0,0,0,0,0
20200528,06460P,亞德客元富98售02,,,,,0.00,0.00,0,0,0,0,0,0,0,0,0,0,0,0,0
20200528,06461P,玉晶光國泰9A售01,2.23,2.26,2.23,2.26,-0.06,-2.59,34000,4,75970,0,0,0,0,0,0,25000,9000,16000,16000
20200528,06462P,鴻海富邦98售01,,,,,0.00,0.00,0,0,0,0,0,0,0,0,0,0,0,0,0
20200528,06463P,大立光富邦9A售01,,,,,0.00,0.00,0,0,0,0,0,0,0,0,0,0,0,0,0
20200528,06464P,台光電亞東99售01,,,,,0.00,0.00,0,0,0,0,0,0,0,0,0,0,0,0,0
20200528,06465P,國巨統一98售04,1.05,1.13,1.02,1.13,+0.04,3.67,994000,38,1063700,0,0,0,0,0,0,487000,533000,-46000,-46000
20200528,06466P,台積電統一9B售01,2.88,2.93,2.88,2.93,+0.04,1.38,11000,2,31730,0,0,0,0,0,0,0,11000,-11000,-11000
20200528,06467P,旺宏統一98售01,1.84,1.99,1.84,1.99,+0.12,6.42,204000,31,391950,0,0,0,0,0,0,52000,152000,-100000,-100000
20200528,06468P,華新科統一98售02,,,,,0.00,0.00,0,0,0,0,0,0,0,0,0,0,0,0,0
20200528,06469P,臺股指凱基99售09,3.41,3.41,3.41,3.41,0.00,0.00,1000,1,3410,0,0,0,0,0,0,0,1000,-1000,-1000
20200528,06470P,臺股指凱基99售10,2.62,2.62,2.62,2.62,-0.10,-3.68,1000,1,2620,0,0,0,0,0,0,0,1000,-1000,-1000
20200528,06471P,臺股指凱基99售11,,,,,0.00,0.00,0,0,0,0,0,0,0,0,0,0,0,0,0
20200528,06472P,道瓊銀元大98售03,,,,,0.00,0.00,0,0,0,0,0,0,0,0,0,0,0,0,0
20200528,06473P,鴻海元大99售03,3.78,3.78,3.73,3.73,-0.23,-5.81,54000,2,202620,0,0,0,0,0,0,54000,54000,0,0
20200528,06474P,鴻海富邦98售03,,,,,0.00,0.00,0,0,0,0,0,0,0,0,0,0,0,0,0
20200528,06475P,牧德永豐98售03,0.95,1.04,0.95,1.04,+0.05,5.05,35000,2,34780,0,0,0,0,0,0,18000,17000,1000,1000
20200528,06476P,臺股指永豐98售01,,,,,0.00,0.00,0,0,0,0,0,0,0,0,0,0,0,0,0
20200528,06477P,緯穎國票99售02,0.48,0.48,0.48,0.48,0.00,0.00,10000,1,4800,0,0,0,0,0,0,0,10000,-10000,-10000
20200528,06478P,臺股指日盛9A售01,,,,,0.00,0.00,0,0,0,0,0,0,0,0,0,0,0,0,0
20200528,06479P,聯發科中信99售02,0.18,0.20,0.18,0.20,0.00,0.00,60000,5,11800,0,0,0,0,0,0,20000,40000,-20000,-20000
20200528,06480P,上銀凱基98售04,,,,,0.00,0.00,0,0,0,0,0,0,0,0,0,0,0,0,0
20200528,06481P,台積電凱基98售12,4.52,4.52,4.52,4.52,0.00,0.00,2000,1,9040,0,0,0,0,0,0,2000,0,2000,2000
20200528,06482P,台積電凱基98售13,2.24,2.24,2.24,2.24,0.00,0.00,25000,1,56000,0,0,0,0,0,0,25000,0,25000,25000
20200528,06483P,聯發科凱基98售10,2.82,2.82,2.82,2.82,0.00,0.00,16000,1,45120,0,0,0,0,0,0,0,16000,-16000,-16000
20200528,06484P,聯發科凱基98售11,,,,,0.00,0.00,0,0,0,0,0,0,0,0,0,0,0,0,0
20200528,06485P,玉晶光群益9A售02,3.60,3.67,3.60,3.67,-0.12,-3.17,95000,5,344020,0,0,0,0,0,0,51000,44000,7000,7000
20200528,06486P,麗豐元大98售02,0.58,0.59,0.58,0.59,-0.02,-3.28,176000,6,103350,0,0,0,0,0,0,176000,176000,0,0
20200528,06487P,聯發科統一99售02,,,,,0.00,0.00,0,0,0,0,0,0,0,0,0,0,0,0,0
20200528,06488P,台積電元富98售05,,,,,0.00,0.00,0,0,0,0,0,0,0,0,0,0,0,0,0
20200528,06489P,台積電元富98售06,0.28,0.28,0.28,0.28,-0.05,-15.15,5000,1,1400,0,0,0,0,0,0,5000,0,5000,5000
20200528,06490P,鴻海富邦99售02,,,,,0.00,0.00,0,0,0,0,0,0,0,0,0,0,0,0,0
20200528,06491P,台積電富邦99售02,1.01,1.10,1.00,1.09,+0.04,3.81,2259000,36,2368610,0,0,0,0,0,0,1129000,1100000,29000,29000
20200528,06492P,上銀永豐98售01,,,,,0.00,0.00,0,0,0,0,0,0,0,0,0,0,0,0,0
20200528,06493P,聯發科永豐98售02,,,,,0.00,0.00,0,0,0,0,0,0,0,0,0,0,0,0,0
20200528,06494P,鴻海永昌98售03,1.69,1.69,1.69,1.69,0.00,0.00,9000,1,15210,0,0,0,0,0,0,0,9000,-9000,-9000
20200528,06495P,華新科亞東9A售01,,,,,0.00,0.00,0,0,0,0,0,0,0,0,0,0,0,0,0
20200528,06496P,台灣50日盛98售01,3.32,3.32,3.32,3.32,+0.35,11.78,1000,1,3320,0,0,0,0,0,0,0,0,0,0
20200528,06497P,大立光凱基98售11,4.85,4.85,4.85,4.85,0.00,0.00,4000,1,19400,0,0,0,0,0,0,0,4000,-4000,-4000
20200528,06498P,臺股指元大9A售03,5.30,5.30,5.30,5.30,0.00,0.00,3000,1,15900,0,0,0,0,0,0,3000,0,3000,3000
20200528,06499P,臺股指元大9A售04,,,,,0.00,0.00,0,0,0,0,0,0,0,0,0,0,0,0,0
20200528,06500P,臺股指元大9A售05,,,,,0.00,0.00,0,0,0,0,0,0,0,0,0,0,0,0,0
20200528,06501P,臺股指元大9A售06,,,,,0.00,0.00,0,0,0,0,0,0,0,0,0,0,0,0,0
20200528,06502P,A50中信98售01,,,,,0.00,0.00,0,0,0,0,0,0,0,0,0,0,0,0,0
20200528,06503P,臺股指中信9A售02,0.90,0.98,0.88,0.96,+0.04,4.35,678000,30,624340,0,0,0,0,0,0,106000,572000,-466000,-466000
20200528,06504P,麗豐國票99售02,0.60,0.60,0.60,0.60,-0.02,-3.23,70000,1,42000,0,0,0,0,0,0,0,70000,-70000,-70000
20200528,06505P,康控國票99售02,2.39,2.53,2.39,2.53,+0.04,1.61,291000,14,704320,0,0,0,0,0,0,133000,158000,-25000,-25000
20200528,06506P,台郡國票99售02,,,,,0.00,0.00,0,0,0,0,0,0,0,0,0,0,0,0,0
20200528,06507P,台表科國票99售01,0.29,0.32,0.26,0.31,0.00,0.00,1142000,21,332370,0,0,0,0,0,0,565000,577000,-12000,-12000
20200528,06508P,台灣50統一98售01,,,,,0.00,0.00,0,0,0,0,0,0,0,0,0,0,0,0,0
20200528,06509P,鴻海群益98售03,3.06,3.06,3.06,3.06,0.00,0.00,2000,1,6120,0,0,0,0,0,0,2000,0,2000,2000
20200528,06510P,燿華永豐98售03,1.61,1.64,1.57,1.64,0.00,0.00,30000,3,48200,0,0,0,0,0,0,10000,20000,-10000,-10000
20200528,06511P,元油2X中信9B售01,,,,,0.00,0.00,0,0,0,0,0,0,0,0,0,0,0,0,0
20200528,06512P,元油2X凱基9B售01,,,,,0.00,0.00,0,0,0,0,0,0,0,0,0,0,0,0,0
20200528,06513P,鴻海凱基98售10,2.06,2.06,2.04,2.04,-0.07,-3.32,10000,8,20540,0,0,0,0,0,0,7000,3000,4000,4000
20200528,06514P,國巨凱基98售05,0.97,1.05,0.97,1.05,+0.02,1.94,77000,4,75070,0,0,0,0,0,0,14000,63000,-49000,-49000
20200528,06515P,國巨凱基98售06,1.91,1.95,1.91,1.95,0.00,0.00,173000,2,330550,0,0,0,0,0,0,3000,170000,-167000,-167000
20200528,06516P,國巨凱基98售08,1.57,1.63,1.57,1.63,+0.03,1.88,231000,6,369250,0,0,0,0,0,0,11000,220000,-209000,-209000
20200528,06517P,國巨凱基98售09,1.66,1.74,1.66,1.74,+0.04,2.35,47000,5,79740,0,0,0,0,0,0,30000,17000,13000,13000
20200528,06518P,奇力新兆豐99售01,,,,,0.00,0.00,0,0,0,0,0,0,0,0,0,0,0,0,0
20200528,06519P,元油2X元大98售03,,,,,0.00,0.00,0,0,0,0,0,0,0,0,0,0,0,0,0
20200528,06520P,元油2X元大98售04,,,,,0.00,0.00,0,0,0,0,0,0,0,0,0,0,0,0,0
20200528,06521P,矽力元大98售01,0.80,0.80,0.70,0.80,0.00,0.00,46000,5,33150,0,0,0,0,0,0,0,0,0,0
20200528,06522P,元油2X群益9B售03,,,,,0.00,0.00,0,0,0,0,0,0,0,0,0,0,0,0,0
20200528,06523P,台積電麥證98售02,,,,,0.00,0.00,0,0,0,0,0,0,0,0,0,0,0,0,0
20200528,06524P,臺股指麥證98售02,,,,,0.00,0.00,0,0,0,0,0,0,0,0,0,0,0,0,0
20200528,06525P,上証2X國泰99售01,1.09,1.13,1.01,1.11,+0.01,0.91,215000,9,233150,0,0,0,0,0,0,120000,95000,25000,25000
20200528,06526P,元油2X永豐98售03,,,,,0.00,0.00,0,0,0,0,0,0,0,0,0,0,0,0,0
20200528,06527P,T50正2富邦9C售01,3.88,3.97,3.88,3.97,+0.03,0.76,28000,5,109900,0,0,0,0,0,0,14000,14000,0,0
20200528,06528P,台積電富邦99售03,,,,,0.00,0.00,0,0,0,0,0,0,0,0,0,0,0,0,0
20200528,06529P,貿聯富邦99售03,0.83,0.88,0.83,0.88,-0.01,-1.12,680000,36,577390,0,0,0,0,0,0,500000,180000,320000,320000
20200528,06530P,元油2X元富98售13,,,,,0.00,0.00,0,0,0,0,0,0,0,0,0,0,0,0,0
20200528,06531P,元油2X元富98售14,,,,,0.00,0.00,0,0,0,0,0,0,0,0,0,0,0,0,0
20200528,06532P,友達元富98售04,2.61,2.61,2.60,2.60,0.00,0.00,9000,2,23440,0,0,0,0,0,0,0,9000,-9000,-9000
20200528,06533P,上証2X中信9B售01,,,,,0.00,0.00,0,0,0,0,0,0,0,0,0,0,0,0,0
20200528,06534P,聯發科群益98售04,1.28,1.44,1.28,1.44,+0.08,5.88,73000,3,102720,0,0,0,0,0,0,12000,61000,-49000,-49000
20200528,06535P,可成群益99售02,3.19,3.30,3.19,3.30,+0.02,0.61,185000,4,603670,0,0,0,0,0,0,9000,176000,-167000,-167000
20200528,06536P,臺股指群益98售04,,,,,0.00,0.00,0,0,0,0,0,0,0,0,0,0,0,0,0
20200528,06537P,華通凱基98售04,,,,,0.00,0.00,0,0,0,0,0,0,0,0,0,0,0,0,0
20200528,06538P,國巨凱基98售11,0.72,0.74,0.72,0.74,0.00,0.00,60000,6,43600,0,0,0,0,0,0,0,60000,-60000,-60000
20200528,06539P,聯發科凱基98售12,0.71,0.71,0.71,0.71,0.00,0.00,10000,1,7100,0,0,0,0,0,0,0,10000,-10000,-10000
20200528,06540P,聯發科凱基98售13,,,,,0.00,0.00,0,0,0,0,0,0,0,0,0,0,0,0,0
20200528,06541P,元油2X國票9A售02,,,,,0.00,0.00,0,0,0,0,0,0,0,0,0,0,0,0,0
20200528,06542P,台光電國票98售05,0.85,0.90,0.85,0.89,0.00,0.00,199000,6,175640,0,0,0,0,0,0,0,199000,-199000,-199000
20200528,06543P,鴻海元大98售08,3.65,3.65,3.58,3.65,-0.18,-4.7,144000,8,522740,0,0,0,0,0,0,114000,144000,-30000,-30000
20200528,06544P,鴻海元大98售09,4.77,4.77,4.77,4.77,-0.23,-4.6,30000,1,143100,0,0,0,0,0,0,0,30000,-30000,-30000
20200528,06545P,致茂元大98售01,2.49,2.59,2.46,2.59,+0.02,0.78,124000,8,313960,0,0,0,0,0,0,68000,56000,12000,12000
20200528,06546P,聯發科元大98售05,2.01,2.08,2.01,2.03,-0.04,-1.93,36000,3,72840,0,0,0,0,0,0,32000,4000,28000,28000
20200528,06547P,大立光元大98售09,,,,,0.00,0.00,0,0,0,0,0,0,0,0,0,0,0,0,0
20200528,06548P,大立光元大98售10,8.85,8.85,8.85,8.85,0.00,0.00,3000,1,26550,0,0,0,0,0,0,3000,0,3000,3000
20200528,06549P,大立光元大98售11,4.59,4.65,4.59,4.65,0.00,0.00,20000,2,92400,0,0,0,0,0,0,0,20000,-20000,-20000
20200528,06550P,健策元大99售01,,,,,0.00,0.00,0,0,0,0,0,0,0,0,0,0,0,0,0
20200528,06551P,貿聯元大98售05,1.88,1.95,1.86,1.95,-0.07,-3.47,113000,7,216030,0,0,0,0,0,0,35000,78000,-43000,-43000
20200528,06552P,茂林元大99售02,0.90,0.90,0.90,0.90,0.00,0.00,2000,1,1800,0,0,0,0,0,0,2000,0,2000,2000
20200528,06553P,訊芯元大98售05,1.98,2.10,1.98,2.10,-0.01,-0.47,121000,3,248580,0,0,0,0,0,0,21000,100000,-79000,-79000
20200528,06554P,臺股指元大99售06,,,,,0.00,0.00,0,0,0,0,0,0,0,0,0,0,0,0,0
20200528,06555P,臺股指元大99售07,,,,,0.00,0.00,0,0,0,0,0,0,0,0,0,0,0,0,0
20200528,06556P,臺股指元大99售08,,,,,0.00,0.00,0,0,0,0,0,0,0,0,0,0,0,0,0
20200528,06557P,台積電兆豐98售02,,,,,0.00,0.00,0,0,0,0,0,0,0,0,0,0,0,0,0
20200528,06558P,旺宏元富98售02,5.65,5.90,5.65,5.90,+0.10,1.72,40000,5,235000,0,0,0,0,0,0,0,40000,-40000,-40000
20200528,06559P,玉晶光元富98售02,,,,,0.00,0.00,0,0,0,0,0,0,0,0,0,0,0,0,0
20200528,06560P,台積電統一98售07,,,,,0.00,0.00,0,0,0,0,0,0,0,0,0,0,0,0,0
20200528,06561P,台灣50國泰9A售01,,,,,0.00,0.00,0,0,0,0,0,0,0,0,0,0,0,0,0
20200528,06562P,台積電國泰99售02,3.02,3.02,3.02,3.02,0.00,0.00,6000,1,18120,0,0,0,0,0,0,6000,6000,0,0
20200528,06563P,元油2X富邦02售02,,,,,0.00,0.00,0,0,0,0,0,0,0,0,0,0,0,0,0
20200528,06564P,國巨富邦9A售04,0.65,0.69,0.65,0.69,0.00,0.00,163000,7,109030,0,0,0,0,0,0,0,163000,-163000,-163000
20200528,06565P,元油2X永豐9A售01,,,,,0.00,0.00,0,0,0,0,0,0,0,0,0,0,0,0,0
20200528,06566P,華通永豐98售03,0.46,0.46,0.38,0.42,-0.12,-22.22,188000,12,78360,0,0,0,0,0,0,135000,53000,82000,82000
20200528,06567P,鴻海永豐98售02,,,,,0.00,0.00,0,0,0,0,0,0,0,0,0,0,0,0,0
20200528,06568P,國巨永豐98售05,1.63,1.66,1.61,1.66,0.00,0.00,121000,4,200670,0,0,0,0,0,0,0,121000,-121000,-121000
20200528,06569P,可成永豐98售01,0.62,0.67,0.61,0.67,0.00,0.00,145000,6,95500,0,0,0,0,0,0,15000,130000,-115000,-115000
20200528,06570P,大立光永豐98售01,2.92,2.92,2.92,2.92,0.00,0.00,11000,2,32120,0,0,0,0,0,0,0,11000,-11000,-11000
20200528,06571P,欣興永豐98售03,0.34,0.35,0.34,0.35,0.00,0.00,25000,3,8570,0,0,0,0,0,0,0,25000,-25000,-25000
20200528,06572P,台積電永昌99售01,1.58,1.68,1.58,1.68,+0.07,4.35,30000,3,48600,0,0,0,0,0,0,30000,0,30000,30000
20200528,06573P,台積電永昌99售02,,,,,0.00,0.00,0,0,0,0,0,0,0,0,0,0,0,0,0
20200528,06574P,大立光永昌99售01,,,,,0.00,0.00,0,0,0,0,0,0,0,0,0,0,0,0,0
20200528,06575P,大立光永昌99售02,,,,,0.00,0.00,0,0,0,0,0,0,0,0,0,0,0,0,0
20200528,06576P,台光電群益98售03,0.99,1.05,0.99,1.05,+0.05,5.0,153000,4,159940,0,0,0,0,0,0,0,153000,-153000,-153000
20200528,06577P,聯發科日盛9A售02,,,,,0.00,0.00,0,0,0,0,0,0,0,0,0,0,0,0,0
20200528,06578P,華新科國票98售02,5.20,5.20,5.20,5.20,0.00,0.00,6000,1,31200,0,0,0,0,0,0,0,6000,-6000,-6000
20200528,06579P,臺股指麥證98售03,,,,,0.00,0.00,0,0,0,0,0,0,0,0,0,0,0,0,0
20200528,06580P,元油2X凱基9A售06,,,,,0.00,0.00,0,0,0,0,0,0,0,0,0,0,0,0,0
20200528,06581P,南亞科凱基98售04,5.20,5.20,5.20,5.20,0.00,0.00,9000,1,46800,0,0,0,0,0,0,0,9000,-9000,-9000
20200528,06582P,可成凱基98售06,2.35,2.37,2.35,2.37,0.00,0.00,184000,2,434800,0,0,0,0,0,0,0,184000,-184000,-184000
20200528,06583P,可成凱基98售07,3.92,4.07,3.92,4.07,0.00,0.00,153000,8,616230,0,0,0,0,0,0,0,153000,-153000,-153000
20200528,06584P,欣興凱基98售03,1.23,1.23,1.19,1.22,-0.06,-4.69,169000,6,205330,0,0,0,0,0,0,58000,111000,-53000,-53000
20200528,06585P,鴻海元大99售04,,,,,0.00,0.00,0,0,0,0,0,0,0,0,0,0,0,0,0
20200528,06586P,鴻海元大9C售01,4.81,4.81,4.81,4.81,0.00,0.00,30000,1,144300,0,0,0,0,0,0,0,30000,-30000,-30000
20200528,06587P,國巨元大98售13,,,,,0.00,0.00,0,0,0,0,0,0,0,0,0,0,0,0,0
20200528,06588P,台積電元大98售11,,,,,0.00,0.00,0,0,0,0,0,0,0,0,0,0,0,0,0
20200528,06589P,台積電元大98售12,3.80,3.80,3.80,3.80,0.00,0.00,4000,1,15200,0,0,0,0,0,0,0,4000,-4000,-4000
20200528,06590P,大立光元大98售13,4.66,4.66,4.66,4.66,-0.21,-4.31,20000,1,93200,0,0,0,0,0,0,20000,0,20000,20000
20200528,06591P,大立光元大98售14,,,,,0.00,0.00,0,0,0,0,0,0,0,0,0,0,0,0,0
20200528,06592P,欣興元大98售04,2.12,2.17,2.03,2.17,-0.07,-3.13,22000,9,46960,0,0,0,0,0,0,0,22000,-22000,-22000
20200528,06593P,欣興元大98售05,2.09,2.09,1.94,2.06,-0.10,-4.63,575000,24,1181760,0,0,0,0,0,0,312000,263000,49000,49000
20200528,06594P,立積元大98售01,1.48,1.57,1.48,1.57,+0.02,1.29,376000,12,585690,0,0,0,0,0,0,38000,328000,-290000,-290000
20200528,06595P,祥碩元大98售03,0.56,0.67,0.54,0.54,-0.09,-14.29,858000,25,496930,0,0,0,0,0,0,718000,15000,703000,703000
20200528,06596P,元油2X富邦02售03,,,,,0.00,0.00,0,0,0,0,0,0,0,0,0,0,0,0,0
20200528,06597P,國巨富邦9A售05,1.13,1.19,1.13,1.19,+0.02,1.71,110000,9,125700,0,0,0,0,0,0,70000,70000,0,0
20200528,06598P,奇力新永豐98售02,1.74,1.82,1.74,1.82,+0.08,4.6,148000,8,262220,0,0,0,0,0,0,0,148000,-148000,-148000
20200528,06599P,宏達電永豐98售02,1.56,1.76,1.56,1.76,+0.12,7.32,41000,4,67660,0,0,0,0,0,0,16000,25000,-9000,-9000
20200528,06600P,貿聯永豐98售01,0.79,0.83,0.77,0.82,-0.01,-1.2,291000,20,228660,0,0,0,0,0,0,211000,174000,37000,37000
20200528,06601P,臺股指永豐98售04,,,,,0.00,0.00,0,0,0,0,0,0,0,0,0,0,0,0,0
20200528,06602P,國巨統一99售02,,,,,0.00,0.00,0,0,0,0,0,0,0,0,0,0,0,0,0
20200528,06603P,立積統一99售01,1.82,1.82,1.82,1.82,0.00,0.00,4000,1,7280,0,0,0,0,0,0,0,4000,-4000,-4000
20200528,06604P,聯發科元富02售02,0.78,0.85,0.77,0.83,+0.02,2.47,532000,16,424190,0,0,0,0,0,0,272000,260000,12000,12000
20200528,06605P,玉晶光元富98售03,,,,,0.00,0.00,0,0,0,0,0,0,0,0,0,0,0,0,0
20200528,06606P,訊芯元富98售02,,,,,0.00,0.00,0,0,0,0,0,0,0,0,0,0,0,0,0
20200528,06607P,友達台新98售02,,,,,0.00,0.00,0,0,0,0,0,0,0,0,0,0,0,0,0
20200528,06608P,立積群益99售02,0.85,0.88,0.83,0.87,+0.04,4.82,97000,4,81820,0,0,0,0,0,0,62000,35000,27000,27000
20200528,06609P,元油2X凱基9B售06,,,,,0.00,0.00,0,0,0,0,0,0,0,0,0,0,0,0,0
20200528,06610P,台積電凱基9A售03,,,,,0.00,0.00,0,0,0,0,0,0,0,0,0,0,0,0,0
20200528,06611P,祥碩國票98售01,0.40,0.40,0.33,0.35,-0.11,-23.91,100000,6,38900,0,0,0,0,0,0,55000,45000,10000,10000
20200528,06612P,元油2X富邦9B售03,,,,,0.00,0.00,0,0,0,0,0,0,0,0,0,0,0,0,0
20200528,06613P,華新科富邦9A售03,1.70,1.74,1.70,1.74,+0.02,1.16,20000,2,34400,0,0,0,0,0,0,0,20000,-20000,-20000
20200528,06614P,祥碩永豐98售03,,,,,0.00,0.00,0,0,0,0,0,0,0,0,0,0,0,0,0
20200528,06615P,鴻海元大9C售02,2.53,2.59,2.53,2.58,-0.10,-3.73,108000,5,276460,0,0,0,0,0,0,0,108000,-108000,-108000
20200528,06616P,國巨元大98售15,3.40,3.43,3.40,3.43,+0.03,0.88,33000,2,112800,0,0,0,0,0,0,0,33000,-33000,-33000
20200528,06617P,智邦元大98售03,0.20,0.27,0.20,0.26,-0.04,-13.33,551000,8,126210,0,0,0,0,0,0,221000,330000,-109000,-109000
20200528,06618P,智邦元大98售04,,,,,0.00,0.00,0,0,0,0,0,0,0,0,0,0,0,0,0
20200528,06619P,聯發科元大98售06,0.91,1.08,0.90,1.02,+0.03,3.03,1040000,75,1033460,0,0,0,0,0,0,410000,630000,-220000,-220000
20200528,06620P,聯發科元大98售07,1.15,1.15,1.15,1.15,0.00,0.00,10000,1,11500,0,0,0,0,0,0,0,10000,-10000,-10000
20200528,06621P,欣興元大98售06,2.22,2.23,2.17,2.23,-0.08,-3.46,52000,4,114180,0,0,0,0,0,0,10000,42000,-32000,-32000
20200528,06622P,牧德元大98售01,1.51,1.55,1.51,1.54,+0.04,2.67,344000,11,526500,0,0,0,0,0,0,143000,201000,-58000,-58000
20200528,06623P,立積元大98售04,,,,,0.00,0.00,0,0,0,0,0,0,0,0,0,0,0,0,0
20200528,06624P,訊芯元大98售06,1.47,1.55,1.45,1.55,-0.04,-2.52,442000,14,667540,0,0,0,0,0,0,160000,427000,-267000,-267000
20200528,06625P,華新科統一98售03,4.24,4.24,4.24,4.24,+0.14,3.41,7000,1,29680,0,0,0,0,0,0,0,7000,-7000,-7000
20200528,06626P,大立光統一9A售01,2.67,2.69,2.67,2.69,0.00,0.00,318000,3,849260,0,0,0,0,0,0,0,318000,-318000,-318000
20200528,06627P,華新科元富99售01,2.46,2.54,2.46,2.54,+0.04,1.6,20000,2,50000,0,0,0,0,0,0,0,20000,-20000,-20000
20200528,06628P,訊芯元富98售03,,,,,0.00,0.00,0,0,0,0,0,0,0,0,0,0,0,0,0
20200528,06629P,台灣50第一98售01,,,,,0.00,0.00,0,0,0,0,0,0,0,0,0,0,0,0,0
20200528,06630P,國巨群益98售08,4.71,4.71,4.71,4.71,-0.13,-2.69,5000,1,23550,0,0,0,0,0,0,0,5000,-5000,-5000
20200528,06631P,玉晶光群益9A售03,2.03,2.05,2.02,2.05,-0.06,-2.84,16000,3,32580,0,0,0,0,0,0,8000,8000,0,0
20200528,06632P,創意群益98售03,,,,,0.00,0.00,0,0,0,0,0,0,0,0,0,0,0,0,0
20200528,06633P,國巨國票99售01,4.30,4.47,4.30,4.47,+0.02,0.45,24000,4,105340,0,0,0,0,0,0,2000,22000,-20000,-20000
20200528,06634P,欣興國票98售02,2.04,2.04,1.96,1.96,-0.15,-7.11,21000,2,42280,0,0,0,0,0,0,14000,7000,7000,7000
20200528,06635P,聯發科凱基98售15,,,,,0.00,0.00,0,0,0,0,0,0,0,0,0,0,0,0,0
20200528,06636P,可成凱基98售08,0.97,0.98,0.97,0.98,-0.01,-1.01,100000,2,97500,0,0,0,0,0,0,0,100000,-100000,-100000
20200528,06637P,大立光凱基98售15,2.69,2.69,2.69,2.69,-0.25,-8.5,7000,1,18830,0,0,0,0,0,0,7000,0,7000,7000
20200528,06638P,鴻海統一99售02,1.31,1.31,1.31,1.31,-0.02,-1.5,15000,2,19650,0,0,0,0,0,0,5000,10000,-5000,-5000
20200528,06639P,訊芯元富98售04,,,,,0.00,0.00,0,0,0,0,0,0,0,0,0,0,0,0,0
20200528,06640P,國巨兆豐99售02,0.93,0.93,0.93,0.93,0.00,0.00,2000,1,1860,0,0,0,0,0,0,2000,0,2000,2000
20200528,06641P,智邦兆豐99售01,0.21,0.21,0.21,0.21,0.00,0.00,6000,1,1260,0,0,0,0,0,0,6000,0,6000,6000
20200528,06642P,可成兆豐98售01,,,,,0.00,0.00,0,0,0,0,0,0,0,0,0,0,0,0,0
20200528,06643P,大立光兆豐98售01,,,,,0.00,0.00,0,0,0,0,0,0,0,0,0,0,0,0,0
20200528,06644P,亞德客元大98售03,0.93,1.23,0.93,1.22,+0.18,17.31,89000,10,98290,0,0,0,0,0,0,85000,40000,45000,45000
20200528,06645P,上銀元大98售05,1.38,1.53,1.38,1.53,+0.08,5.52,212000,17,313380,0,0,0,0,0,0,68000,144000,-76000,-76000
20200528,06646P,國巨元大98售16,,,,,0.00,0.00,0,0,0,0,0,0,0,0,0,0,0,0,0
20200528,06647P,台積電元大98售13,,,,,0.00,0.00,0,0,0,0,0,0,0,0,0,0,0,0,0
20200528,06648P,華邦電元大98售03,1.44,1.62,1.21,1.62,+0.07,4.52,50000,8,68230,0,0,0,0,0,0,5000,45000,-40000,-40000
20200528,06649P,聯發科元大98售08,,,,,0.00,0.00,0,0,0,0,0,0,0,0,0,0,0,0,0
20200528,06650P,聯發科元大98售09,,,,,0.00,0.00,0,0,0,0,0,0,0,0,0,0,0,0,0
20200528,06651P,華新科元大99售09,,,,,0.00,0.00,0,0,0,0,0,0,0,0,0,0,0,0,0
20200528,06652P,長榮航元大98售01,0.84,0.86,0.77,0.86,-0.04,-4.44,66000,10,55690,0,0,0,0,0,0,0,45000,-45000,-45000
20200528,06653P,美食元大98售02,0.64,0.68,0.64,0.68,+0.05,7.94,204000,3,136560,0,0,0,0,0,0,200000,4000,196000,196000
20200528,06654P,欣興元大98售08,1.47,1.47,1.34,1.44,-0.11,-7.1,311000,7,436030,0,0,0,0,0,0,240000,71000,169000,169000
20200528,06655P,TPK元大98售02,0.90,0.98,0.86,0.98,+0.05,5.38,396000,16,369000,0,0,0,0,0,0,96000,297000,-201000,-201000
20200528,06656P,GIS元大98售02,0.76,0.99,0.76,0.99,+0.10,11.24,476000,22,409200,0,0,0,0,0,0,176000,282000,-106000,-106000
20200528,06657P,寶成元大98售01,2.18,2.45,2.18,2.45,+0.20,8.89,351000,8,788270,0,0,0,0,0,0,351000,0,351000,351000
20200528,06658P,台灣50富邦9C售01,,,,,0.00,0.00,0,0,0,0,0,0,0,0,0,0,0,0,0
20200528,06659P,T50正2富邦9A售01,,,,,0.00,0.00,0,0,0,0,0,0,0,0,0,0,0,0,0
20200528,06660P,大立光富邦9B售03,1.50,1.50,1.50,1.50,0.00,0.00,10000,1,15000,0,0,0,0,0,0,10000,0,10000,10000
20200528,06661P,玉晶光永豐98售05,0.72,0.74,0.68,0.74,-0.03,-3.9,296000,11,205680,0,0,0,0,0,0,242000,48000,194000,194000
20200528,06662P,玉晶光中信9A售01,0.38,0.38,0.34,0.38,-0.01,-2.56,595000,22,216590,0,0,0,0,0,0,146000,424000,-278000,-278000
20200528,06663P,鴻海兆豐98售03,,,,,0.00,0.00,0,0,0,0,0,0,0,0,0,0,0,0,0
20200528,06664P,聯發科兆豐98售02,,,,,0.00,0.00,0,0,0,0,0,0,0,0,0,0,0,0,0
20200528,06665P,欣興兆豐99售01,,,,,0.00,0.00,0,0,0,0,0,0,0,0,0,0,0,0,0
20200528,06666P,台積電日盛9A售02,3.65,3.65,3.65,3.65,0.00,0.00,1000,1,3650,0,0,0,0,0,0,1000,1000,0,0
20200528,06667P,鴻海凱基98售11,1.78,1.84,1.75,1.81,-0.09,-4.74,196000,13,354280,0,0,0,0,0,0,13000,187000,-174000,-174000
20200528,06668P,祥碩凱基98售02,0.22,0.24,0.19,0.21,-0.04,-16.0,941000,24,196950,0,0,0,0,0,0,180000,841000,-661000,-661000
20200528,06669P,緯穎凱基98售05,,,,,0.00,0.00,0,0,0,0,0,0,0,0,0,0,0,0,0
20200528,06670P,鴻海群益98售06,,,,,0.00,0.00,0,0,0,0,0,0,0,0,0,0,0,0,0
20200528,06671P,台積電群益98售04,,,,,0.00,0.00,0,0,0,0,0,0,0,0,0,0,0,0,0
20200528,06672P,聯發科群益98售05,1.23,1.23,1.23,1.23,-0.02,-1.6,3000,1,3690,0,0,0,0,0,0,0,3000,-3000,-3000
20200528,06673P,大立光群益98售01,3.87,4.12,3.87,4.12,+0.06,1.48,18000,2,69910,0,0,0,0,0,0,17000,1000,16000,16000
20200528,06674P,祥碩群益98售02,0.49,0.49,0.34,0.36,-0.07,-16.28,715000,26,258770,0,0,0,0,0,0,165000,545000,-380000,-380000
20200528,06675P,國巨國票99售02,,,,,0.00,0.00,0,0,0,0,0,0,0,0,0,0,0,0,0
20200528,06676P,華新科國票98售03,,,,,0.00,0.00,0,0,0,0,0,0,0,0,0,0,0,0,0
20200528,06677P,牧德國票98售02,3.75,3.94,3.75,3.94,+0.11,2.87,32000,3,123220,0,0,0,0,0,0,11000,21000,-10000,-10000
20200528,06678P,大立光統一99售01,,,,,0.00,0.00,0,0,0,0,0,0,0,0,0,0,0,0,0
20200528,06679P,旺宏元大98售09,,,,,0.00,0.00,0,0,0,0,0,0,0,0,0,0,0,0,0
20200528,06680P,智邦元大98售06,0.35,0.42,0.33,0.40,-0.06,-13.04,217000,12,83900,0,0,0,0,0,0,15000,202000,-187000,-187000
20200528,06681P,致茂元大98售02,2.55,2.67,2.52,2.67,+0.06,2.3,129000,8,335100,0,0,0,0,0,0,84000,62000,22000,22000
20200528,06682P,玉晶光元大99售08,,,,,0.00,0.00,0,0,0,0,0,0,0,0,0,0,0,0,0
20200528,06683P,訊芯元大98售07,1.61,1.67,1.61,1.67,+0.05,3.09,368000,7,600500,0,0,0,0,0,0,0,368000,-368000,-368000
20200528,06684P,緯穎元大98售06,0.42,0.42,0.42,0.42,+0.02,5.0,200000,1,84000,0,0,0,0,0,0,200000,0,200000,200000
20200528,06685P,鴻海國泰9A售01,2.12,2.20,2.12,2.20,-0.05,-2.22,68000,3,144800,0,0,0,0,0,0,0,68000,-68000,-68000
20200528,06686P,麗豐永豐98售02,0.77,0.79,0.77,0.79,-0.03,-3.66,36000,4,27800,0,0,0,0,0,0,36000,0,36000,36000
20200528,06687P,A50正2中信9A售01,1.09,1.09,1.09,1.09,0.00,0.00,3000,1,3270,0,0,0,0,0,0,3000,0,3000,3000
20200528,06688P,鴻海中信02售01,1.31,1.35,1.31,1.35,+0.01,0.75,25000,3,33250,0,0,0,0,0,0,1000,24000,-23000,-23000
20200528,06689P,鴻海中信9C售02,,,,,0.00,0.00,0,0,0,0,0,0,0,0,0,0,0,0,0
20200528,06690P,玉晶光群益9A售05,,,,,0.00,0.00,0,0,0,0,0,0,0,0,0,0,0,0,0
20200528,06691P,臺股指群益9C售05,13.30,13.80,13.20,13.80,+0.30,2.22,23000,5,313300,0,0,0,0,0,0,5000,18000,-13000,-13000
20200528,06692P,瑞昱凱基98售03,0.42,0.42,0.40,0.41,-0.05,-10.87,30000,3,12300,0,0,0,0,0,0,0,30000,-30000,-30000
20200528,06693P,臺股指凱基98售01,3.96,4.23,3.96,4.23,+0.20,4.96,197000,2,827370,0,0,0,0,0,0,22000,175000,-153000,-153000
20200528,06694P,臺股指凱基99售13,,,,,0.00,0.00,0,0,0,0,0,0,0,0,0,0,0,0,0
20200528,06695P,群創兆豐98售04,,,,,0.00,0.00,0,0,0,0,0,0,0,0,0,0,0,0,0
20200528,06696P,台灣50國票99售01,,,,,0.00,0.00,0,0,0,0,0,0,0,0,0,0,0,0,0
20200528,06697P,台積電國票99售05,,,,,0.00,0.00,0,0,0,0,0,0,0,0,0,0,0,0,0
20200528,06698P,玉晶光國票99售05,3.27,3.27,3.16,3.25,0.00,0.00,22000,5,71520,0,0,0,0,0,0,7000,15000,-8000,-8000
20200528,06699P,台積電統一98售11,,,,,0.00,0.00,0,0,0,0,0,0,0,0,0,0,0,0,0
20200528,06700P,臺股指統一99售05,,,,,0.00,0.00,0,0,0,0,0,0,0,0,0,0,0,0,0
20200528,06701P,臺股指統一99售06,2.11,2.41,2.09,2.34,+0.11,4.93,531000,48,1197140,0,0,0,0,0,0,212000,319000,-107000,-107000
20200528,06702P,智邦元富98售01,0.31,0.39,0.31,0.38,0.00,0.00,110000,7,36900,0,0,0,0,0,0,0,110000,-110000,-110000
20200528,06703P,新日興元富98售02,,,,,0.00,0.00,0,0,0,0,0,0,0,0,0,0,0,0,0
20200528,06704P,玉晶光元富98售05,,,,,0.00,0.00,0,0,0,0,0,0,0,0,0,0,0,0,0
20200528,06705P,臻鼎元富98售03,2.23,2.47,2.23,2.47,+0.11,4.66,265000,11,622870,0,0,0,0,0,0,112000,153000,-41000,-41000
20200528,06706P,智原台新98售02,0.96,0.96,0.96,0.96,0.00,0.00,2000,1,1920,0,0,0,0,0,0,2000,0,2000,2000
20200528,06707P,臺股指台新99售04,,,,,0.00,0.00,0,0,0,0,0,0,0,0,0,0,0,0,0
20200528,06708P,臺股指台新99售05,,,,,0.00,0.00,0,0,0,0,0,0,0,0,0,0,0,0,0
20200528,06709P,臺股指台新99售06,7.80,8.50,7.80,8.50,+4.17,96.3,20000,3,163000,0,0,0,0,0,0,20000,10000,10000,10000
20200528,06710P,臺股指台新99售07,,,,,0.00,0.00,0,0,0,0,0,0,0,0,0,0,0,0,0
20200528,06711P,臺股指台新99售08,,,,,0.00,0.00,0,0,0,0,0,0,0,0,0,0,0,0,0
20200528,06712P,臺股指台新99售09,,,,,0.00,0.00,0,0,0,0,0,0,0,0,0,0,0,0,0
20200528,06713P,臺股指富邦99售04,,,,,0.00,0.00,0,0,0,0,0,0,0,0,0,0,0,0,0
20200528,06714P,台積電元大98售15,6.25,6.65,6.20,6.65,+0.30,4.72,58000,8,368650,0,0,0,0,0,0,10000,48000,-38000,-38000
20200528,06715P,台積電元大99售04,,,,,0.00,0.00,0,0,0,0,0,0,0,0,0,0,0,0,0
20200528,06716P,台積電元大9A售02,,,,,0.00,0.00,0,0,0,0,0,0,0,0,0,0,0,0,0
20200528,06717P,可成元大98售09,2.19,2.43,2.19,2.43,+0.09,3.85,37000,5,84730,0,0,0,0,0,0,36000,11000,25000,25000
20200528,06718P,聯詠元大98售01,1.99,2.01,1.99,2.01,+0.13,6.91,137000,3,273630,0,0,0,0,0,0,0,137000,-137000,-137000
20200528,06719P,台灣50群益9A售01,,,,,0.00,0.00,0,0,0,0,0,0,0,0,0,0,0,0,0
20200528,06720P,智邦亞東99售01,0.29,0.29,0.17,0.17,-0.06,-26.09,26000,4,4740,0,0,0,0,0,0,0,25000,-25000,-25000
20200528,06721P,臺股指中信9A售03,1.68,1.77,1.67,1.76,+0.04,2.33,321000,19,557780,0,0,0,0,0,0,122000,199000,-77000,-77000
20200528,06722P,臺股指中信9A售04,2.59,2.59,2.59,2.59,+0.69,36.32,2000,1,5180,0,0,0,0,0,0,0,2000,-2000,-2000
20200528,06723P,台灣50麥證99售01,6.30,6.30,6.30,6.30,0.00,0.00,10000,1,63000,0,10000,-10000,0,0,0,0,10000,-10000,-10000
20200528,06724P,台灣50國票98售01,10.10,10.10,10.10,10.10,+0.10,1.0,5000,1,50500,0,0,0,0,0,0,0,5000,-5000,-5000
20200528,06725P,聯電元富98售01,1.37,1.37,1.30,1.37,-0.03,-2.14,214000,24,286780,0,0,0,0,0,0,212000,2000,210000,210000
20200528,06726P,欣興元富98售04,2.95,2.95,2.86,2.91,-0.12,-3.96,43000,7,126510,0,0,0,0,0,0,38000,5000,33000,33000
20200528,06727P,台光電元大98售05,0.45,0.45,0.45,0.45,+0.05,12.5,5000,1,2250,0,0,0,0,0,0,5000,0,5000,5000
20200528,06728P,全新元大98售03,1.99,1.99,1.99,1.99,+0.01,0.51,20000,1,39800,0,0,0,0,0,0,20000,0,20000,20000
20200528,06729P,聯詠元大98售03,2.35,2.35,2.35,2.35,0.00,0.00,50000,1,117500,0,0,0,0,0,0,0,50000,-50000,-50000
20200528,06730P,祥碩元大98售07,1.44,1.44,0.99,0.99,-0.11,-10.0,37000,4,38420,0,0,0,0,0,0,16000,26000,-10000,-10000
20200528,06731P,聯茂元大98售05,,,,,0.00,0.00,0,0,0,0,0,0,0,0,0,0,0,0,0
20200528,06732P,台灣50日盛9A售01,,,,,0.00,0.00,0,0,0,0,0,0,0,0,0,0,0,0,0
20200528,06733P,鴻海凱基99售02,,,,,0.00,0.00,0,0,0,0,0,0,0,0,0,0,0,0,0
20200528,06734P,智邦凱基98售05,0.49,0.55,0.44,0.52,-0.10,-16.13,350000,17,175900,0,0,0,0,0,0,148000,202000,-54000,-54000
20200528,06735P,奇力新凱基98售07,3.24,3.27,3.24,3.27,+0.16,5.14,29000,2,94260,0,0,0,0,0,0,0,29000,-29000,-29000
20200528,06736P,新日興凱基98售03,0.58,0.58,0.56,0.58,-0.08,-12.12,227000,5,131600,0,0,0,0,0,0,22000,205000,-183000,-183000
20200528,06737P,台郡凱基98售07,1.43,1.44,1.42,1.44,0.00,0.00,214000,3,306540,0,0,0,0,0,0,31000,214000,-183000,-183000
20200528,06738P,瑞昱兆豐98售02,,,,,0.00,0.00,0,0,0,0,0,0,0,0,0,0,0,0,0
20200528,06739P,聯詠兆豐98售02,0.50,0.50,0.50,0.50,0.00,0.00,10000,1,5000,0,0,0,0,0,0,0,10000,-10000,-10000
20200528,06740P,台灣50國泰9A售02,,,,,0.00,0.00,0,0,0,0,0,0,0,0,0,0,0,0,0
20200528,06741P,台積電富邦98售04,,,,,0.00,0.00,0,0,0,0,0,0,0,0,0,0,0,0,0
20200528,06742P,可成富邦99售02,,,,,0.00,0.00,0,0,0,0,0,0,0,0,0,0,0,0,0
20200528,06743P,創意永豐98售03,0.93,0.93,0.91,0.91,-0.02,-2.15,25000,3,22850,0,0,0,0,0,0,10000,15000,-5000,-5000
20200528,06744P,嘉聯益永豐98售03,1.67,1.69,1.57,1.66,-0.12,-6.74,264000,20,430860,0,0,0,0,0,0,166000,98000,68000,68000
20200528,06745P,台積電群益98售05,,,,,0.00,0.00,0,0,0,0,0,0,0,0,0,0,0,0,0
20200528,06746P,聯發科群益99售02,,,,,0.00,0.00,0,0,0,0,0,0,0,0,0,0,0,0,0
20200528,06747P,大立光群益99售04,,,,,0.00,0.00,0,0,0,0,0,0,0,0,0,0,0,0,0
20200528,06748P,智邦台新98售02,0.17,0.22,0.16,0.22,-0.03,-12.0,623000,23,104370,0,0,0,0,0,0,23000,590000,-567000,-567000
20200528,06749P,技嘉元富98售03,2.33,2.33,2.33,2.33,0.00,0.00,1000,1,2330,0,0,0,0,0,0,0,1000,-1000,-1000
20200528,06750P,聯發科元富02售03,1.92,1.96,1.92,1.92,+0.01,0.52,445000,12,871170,0,0,0,0,0,0,0,445000,-445000,-445000
20200528,06751P,旺宏凱基98售10,2.52,2.52,2.52,2.52,+0.03,1.2,18000,1,45360,0,0,0,0,0,0,0,18000,-18000,-18000
20200528,06752P,訊芯凱基98售05,1.79,1.82,1.79,1.82,0.00,0.00,144000,3,260140,0,0,0,0,0,0,0,144000,-144000,-144000
20200528,06753P,智邦富邦98售03,,,,,0.00,0.00,0,0,0,0,0,0,0,0,0,0,0,0,0
20200528,06754P,台積電永豐98售03,,,,,0.00,0.00,0,0,0,0,0,0,0,0,0,0,0,0,0
20200528,06755P,大立光永豐98售03,,,,,0.00,0.00,0,0,0,0,0,0,0,0,0,0,0,0,0
20200528,06756P,臺股指永豐98售05,,,,,0.00,0.00,0,0,0,0,0,0,0,0,0,0,0,0,0
20200528,06757P,台灣50元大9B售01,2.20,2.31,2.20,2.31,+0.06,2.67,12000,3,27150,0,0,0,0,0,0,7000,5000,2000,2000
20200528,06758P,鴻海元大98售10,,,,,0.00,0.00,0,0,0,0,0,0,0,0,0,0,0,0,0
20200528,06759P,台積電元大98售17,,,,,0.00,0.00,0,0,0,0,0,0,0,0,0,0,0,0,0
20200528,06760P,台積電元大98售18,2.18,2.18,2.18,2.18,0.00,0.00,5000,1,10900,0,0,0,0,0,0,5000,0,5000,5000
20200528,06761P,台積電元大99售05,,,,,0.00,0.00,0,0,0,0,0,0,0,0,0,0,0,0,0
20200528,06762P,智邦元大98售11,0.36,0.36,0.30,0.30,0.00,0.00,5000,2,1620,0,0,0,0,0,0,3000,2000,1000,1000
20200528,06763P,技嘉元大98售05,1.64,1.86,1.64,1.85,+0.15,8.82,495000,37,856890,0,0,0,0,0,0,429000,0,429000,429000
20200528,06764P,聯發科元大98售11,,,,,0.00,0.00,0,0,0,0,0,0,0,0,0,0,0,0,0
20200528,06765P,欣興元大98售11,2.42,2.43,2.29,2.41,-0.10,-3.98,92000,13,220960,0,0,0,0,0,0,69000,23000,46000,46000
20200528,06766P,玉晶光元大99售10,1.63,1.66,1.60,1.66,-0.05,-2.92,92000,8,149920,0,0,0,0,0,0,2000,90000,-88000,-88000
20200528,06767P,台積電永昌99售03,2.66,2.66,2.66,2.66,+0.07,2.7,3000,1,7980,0,0,0,0,0,0,0,3000,-3000,-3000
20200528,06768P,臺股指永昌98售02,,,,,0.00,0.00,0,0,0,0,0,0,0,0,0,0,0,0,0
20200528,06769P,臺股指永昌98售03,,,,,0.00,0.00,0,0,0,0,0,0,0,0,0,0,0,0,0
20200528,06770P,台灣50第一9C售01,,,,,0.00,0.00,0,0,0,0,0,0,0,0,0,0,0,0,0
20200528,06771P,台灣50中信02售01,3.48,3.54,3.48,3.54,+0.08,2.31,21000,2,73140,0,0,0,0,0,0,0,21000,-21000,-21000
20200528,06772P,國巨中信99售01,1.03,1.03,1.03,1.03,0.00,0.00,1000,1,1030,0,0,0,0,0,0,1000,0,1000,1000
20200528,06773P,台灣50兆豐9A售01,,,,,0.00,0.00,0,0,0,0,0,0,0,0,0,0,0,0,0
20200528,06774P,臺股指兆豐98售02,,,,,0.00,0.00,0,0,0,0,0,0,0,0,0,0,0,0,0
20200528,06775P,臺股指兆豐98售03,,,,,0.00,0.00,0,0,0,0,0,0,0,0,0,0,0,0,0
20200528,06776P,鴻海元大99售05,,,,,0.00,0.00,0,0,0,0,0,0,0,0,0,0,0,0,0
20200528,06777P,鴻海元大99售06,7.70,7.70,7.70,7.70,-0.35,-4.35,10000,1,77000,0,0,0,0,0,0,10000,0,10000,10000
20200528,06778P,台積電元大99售06,2.81,2.84,2.81,2.84,0.00,0.00,100000,3,282500,0,0,0,0,0,0,0,100000,-100000,-100000
20200528,06779P,智邦元大98售12,0.22,0.26,0.20,0.26,-0.04,-13.33,170000,6,36000,0,0,0,0,0,0,45000,125000,-80000,-80000
20200528,06780P,義隆元大98售02,0.92,0.98,0.91,0.96,-0.08,-7.69,167000,16,157220,0,0,0,0,0,0,70000,97000,-27000,-27000
20200528,06781P,大立光元大98售19,,,,,0.00,0.00,0,0,0,0,0,0,0,0,0,0,0,0,0
20200528,06782P,大立光元大99售07,,,,,0.00,0.00,0,0,0,0,0,0,0,0,0,0,0,0,0
20200528,06783P,亞光元大98售03,3.41,3.64,3.41,3.64,+0.19,5.51,149000,13,530730,0,0,0,0,0,0,9000,140000,-131000,-131000
20200528,06784P,臺股指元大98售01,,,,,0.00,0.00,0,0,0,0,0,0,0,0,0,0,0,0,0
20200528,06785P,臺股指元大98售02,,,,,0.00,0.00,0,0,0,0,0,0,0,0,0,0,0,0,0
20200528,06786P,臺股指元大98售03,,,,,0.00,0.00,0,0,0,0,0,0,0,0,0,0,0,0,0
20200528,06787P,臺股指元大98售04,,,,,0.00,0.00,0,0,0,0,0,0,0,0,0,0,0,0,0
20200528,06788P,臺股指元大98售05,,,,,0.00,0.00,0,0,0,0,0,0,0,0,0,0,0,0,0
20200528,06789P,鴻海凱基98售12,4.13,4.13,4.13,4.13,0.00,0.00,19000,1,78470,0,0,0,0,0,0,0,19000,-19000,-19000
20200528,06790P,台積電凱基9A售04,0.77,0.77,0.77,0.77,0.00,0.00,1000,1,770,0,0,0,0,0,0,0,1000,-1000,-1000
20200528,06791P,聯發科凱基98售16,,,,,0.00,0.00,0,0,0,0,0,0,0,0,0,0,0,0,0
20200528,06792P,臺股指凱基98售02,,,,,0.00,0.00,0,0,0,0,0,0,0,0,0,0,0,0,0
20200528,06793P,臺股指凱基98售03,8.25,8.25,8.25,8.25,0.00,0.00,10000,1,82500,0,0,0,0,0,0,0,10000,-10000,-10000
20200528,06794P,臺股指凱基98售04,6.50,6.50,6.45,6.45,0.00,0.00,3000,2,19400,0,0,0,0,0,0,0,3000,-3000,-3000
20200528,06795P,臺股指凱基98售05,,,,,0.00,0.00,0,0,0,0,0,0,0,0,0,0,0,0,0
20200528,06796P,臺股指凱基98售06,,,,,0.00,0.00,0,0,0,0,0,0,0,0,0,0,0,0,0
20200528,06797P,臺股指凱基98售07,5.85,5.85,5.85,5.85,-0.15,-2.5,20000,2,117000,0,0,0,0,0,0,10000,10000,0,0
20200528,06798P,臺股指凱基98售08,,,,,0.00,0.00,0,0,0,0,0,0,0,0,0,0,0,0,0
20200528,06799P,臺股指凱基98售09,,,,,0.00,0.00,0,0,0,0,0,0,0,0,0,0,0,0,0
20200528,06800P,台灣50群益9A售02,,,,,0.00,0.00,0,0,0,0,0,0,0,0,0,0,0,0,0
20200528,06801P,技嘉群益99售02,1.06,1.15,1.05,1.15,+0.09,8.49,876000,29,960180,0,0,0,0,0,0,182000,621000,-439000,-439000
20200528,06802P,緯穎群益98售03,,,,,0.00,0.00,0,0,0,0,0,0,0,0,0,0,0,0,0
20200528,06803P,臺股指群益98售09,8.00,8.20,8.00,8.20,-0.25,-2.96,9000,4,73000,0,0,0,0,0,0,4000,5000,-1000,-1000
20200528,06804P,臺股指群益98售10,13.60,13.60,13.60,13.60,-0.30,-2.16,1000,1,13600,0,0,0,0,0,0,1000,0,1000,1000
20200528,06805P,臺股指群益98售11,,,,,0.00,0.00,0,0,0,0,0,0,0,0,0,0,0,0,0
20200528,06806P,臺股指群益98售12,8.65,8.65,8.65,8.65,-0.20,-2.26,5000,1,43250,0,0,0,0,0,0,5000,0,5000,5000
20200528,06807P,臺股指群益98售13,,,,,0.00,0.00,0,0,0,0,0,0,0,0,0,0,0,0,0
20200528,06808P,電子類群益98售02,,,,,0.00,0.00,0,0,0,0,0,0,0,0,0,0,0,0,0
20200528,06809P,電子類群益98售03,10.30,10.30,10.30,10.30,0.00,0.00,2000,1,20600,0,0,0,0,0,0,0,2000,-2000,-2000
20200528,06810P,國巨統一99售03,,,,,0.00,0.00,0,0,0,0,0,0,0,0,0,0,0,0,0
20200528,06811P,聯發科統一98售06,0.56,0.61,0.56,0.61,+0.03,5.17,58000,2,33880,0,0,0,0,0,0,28000,30000,-2000,-2000
20200528,06812P,台灣50元富9C售01,,,,,0.00,0.00,0,0,0,0,0,0,0,0,0,0,0,0,0
20200528,06813P,友訊元富98售03,,,,,0.00,0.00,0,0,0,0,0,0,0,0,0,0,0,0,0
20200528,06814P,臺股指元富98售03,,,,,0.00,0.00,0,0,0,0,0,0,0,0,0,0,0,0,0
20200528,06815P,臺股指元富98售04,,,,,0.00,0.00,0,0,0,0,0,0,0,0,0,0,0,0,0
20200528,06816P,臺股指元富98售05,,,,,0.00,0.00,0,0,0,0,0,0,0,0,0,0,0,0,0
20200528,06817P,臺股指元富98售06,,,,,0.00,0.00,0,0,0,0,0,0,0,0,0,0,0,0,0
20200528,06818P,臺股指元富98售07,,,,,0.00,0.00,0,0,0,0,0,0,0,0,0,0,0,0,0
20200528,06819P,臺股指元富98售08,,,,,0.00,0.00,0,0,0,0,0,0,0,0,0,0,0,0,0
20200528,06820P,臺股指元富98售09,,,,,0.00,0.00,0,0,0,0,0,0,0,0,0,0,0,0,0
20200528,06821P,臺股指元富98售10,,,,,0.00,0.00,0,0,0,0,0,0,0,0,0,0,0,0,0
20200528,06822P,上銀富邦99售03,1.02,1.16,1.02,1.15,+0.11,10.58,266000,11,291490,0,0,0,0,0,0,72000,194000,-122000,-122000
20200528,06823P,台灣50永豐98售02,,,,,0.00,0.00,0,0,0,0,0,0,0,0,0,0,0,0,0
20200528,06824P,台灣50國票99售02,7.10,7.10,7.00,7.00,-0.20,-2.78,10000,3,70350,0,0,0,0,0,0,0,10000,-10000,-10000
20200528,06825P,臺股指國票98售01,9.45,10.40,9.40,10.40,+0.45,4.52,29000,7,281100,0,0,0,0,0,0,12000,17000,-5000,-5000
20200528,06826P,臺股指國票98售02,,,,,0.00,0.00,0,0,0,0,0,0,0,0,0,0,0,0,0
20200528,06827P,臺股指國票98售03,7.80,8.40,7.80,8.40,+0.30,3.7,23000,3,191600,0,0,0,0,0,0,21000,2000,19000,19000
20200528,06828P,臺股指國票98售04,8.10,8.10,8.10,8.10,0.00,0.00,15000,1,121500,0,0,0,0,0,0,0,15000,-15000,-15000
20200528,06829P,臺股指國票98售05,,,,,0.00,0.00,0,0,0,0,0,0,0,0,0,0,0,0,0
20200528,06830P,臺股指國票98售06,,,,,0.00,0.00,0,0,0,0,0,0,0,0,0,0,0,0,0
20200528,06831P,臺股指國票98售07,,,,,0.00,0.00,0,0,0,0,0,0,0,0,0,0,0,0,0
20200528,06832P,玉晶光凱基98售03,0.85,0.86,0.85,0.86,-0.07,-7.53,78000,4,66640,0,0,0,0,0,0,73000,68000,5000,5000
20200528,06833P,矽力群益99售01,0.40,0.40,0.34,0.36,-0.04,-10.0,625000,75,221160,0,0,0,0,0,0,0,448000,-448000,-448000
20200528,06834P,訊芯群益99售02,2.31,2.31,2.31,2.31,-0.04,-1.7,50000,1,115500,0,0,0,0,0,0,0,50000,-50000,-50000
20200528,06835P,台灣50國票9A售01,,,,,0.00,0.00,0,0,0,0,0,0,0,0,0,0,0,0,0
20200528,06836P,玉晶光國票99售06,1.90,1.95,1.82,1.94,-0.06,-3.0,250000,24,474700,0,0,0,0,0,0,20000,230000,-210000,-210000
20200528,06837P,上銀統一9A售02,1.08,1.08,0.98,1.06,0.00,0.00,8000,3,8420,0,0,0,0,0,0,2000,5000,-3000,-3000
20200528,06838P,台積電統一99售05,,,,,0.00,0.00,0,0,0,0,0,0,0,0,0,0,0,0,0
20200528,06839P,玉晶光統一9A售05,1.21,1.23,1.16,1.22,-0.06,-4.69,180000,11,216470,0,0,0,0,0,0,150000,75000,75000,75000
20200528,06840P,臺股指統一98售04,,,,,0.00,0.00,0,0,0,0,0,0,0,0,0,0,0,0,0
20200528,06841P,臺股指統一9A售02,2.22,2.34,2.22,2.34,+0.01,0.43,20000,2,45600,0,0,0,0,0,0,10000,10000,0,0
20200528,06842P,臺股指統一9A售03,,,,,0.00,0.00,0,0,0,0,0,0,0,0,0,0,0,0,0
20200528,06843P,鴻海元大98售11,3.72,3.72,3.69,3.72,-0.06,-1.59,95000,5,352680,0,0,0,0,0,0,65000,95000,-30000,-30000
20200528,06844P,智邦元大98售13,0.66,0.66,0.51,0.62,-0.12,-16.22,364000,15,227350,0,0,0,0,0,0,199000,162000,37000,37000
20200528,06845P,億光元大98售02,1.89,1.97,1.89,1.97,-0.02,-1.01,66000,3,128740,0,0,0,0,0,0,16000,50000,-34000,-34000
20200528,06846P,美律元大98售05,2.27,2.31,2.27,2.31,-0.18,-7.23,50000,6,114420,0,0,0,0,0,0,50000,0,50000,50000
20200528,06847P,奇力新元大98售05,1.90,2.03,1.88,2.01,+0.09,4.69,409000,16,811950,0,0,0,0,0,0,22000,387000,-365000,-365000
20200528,06848P,聯詠元大98售04,1.82,1.82,1.82,1.82,+0.08,4.6,100000,2,182000,0,0,0,0,0,0,0,100000,-100000,-100000
20200528,06849P,欣興元大98售12,2.15,2.18,2.15,2.17,-0.03,-1.36,26000,3,56520,0,0,0,0,0,0,2000,24000,-22000,-22000
20200528,06850P,聯茂元大98售06,1.93,1.93,1.93,1.93,0.00,0.00,15000,1,28950,0,0,0,0,0,0,15000,15000,0,0
20200528,06851P,鈺齊元大98售01,1.80,1.80,1.69,1.72,-0.22,-11.34,238000,5,414360,0,0,0,0,0,0,238000,0,238000,238000
20200528,06852P,臺股指元大98售11,0.39,0.44,0.38,0.43,+0.01,2.38,1910000,51,787280,0,0,0,0,0,0,800000,940000,-140000,-140000
20200528,06853P,華擎元富98售03,0.78,0.87,0.77,0.87,+0.02,2.35,609000,35,489600,0,0,0,0,0,0,433000,156000,277000,277000
20200528,06854P,鴻海富邦99售05,,,,,0.00,0.00,0,0,0,0,0,0,0,0,0,0,0,0,0
20200528,06855P,聯發科富邦9A售01,1.25,1.28,1.25,1.28,0.00,0.00,214000,3,270500,0,0,0,0,0,0,0,214000,-214000,-214000
20200528,06856P,台灣50永豐99售03,,,,,0.00,0.00,0,0,0,0,0,0,0,0,0,0,0,0,0
20200528,06857P,超眾永豐98售02,0.53,0.56,0.53,0.55,0.00,0.00,80000,3,43600,0,0,0,0,0,0,30000,50000,-20000,-20000
20200528,06858P,道瓊指中信9B售01,,,,,0.00,0.00,0,0,0,0,0,0,0,0,0,0,0,0,0
20200528,06859P,元金2X中信9C售01,1.43,1.44,1.41,1.41,-0.02,-1.4,6000,4,8550,0,0,0,0,0,0,1000,5000,-4000,-4000
20200528,06860P,台灣50兆豐98售01,,,,,0.00,0.00,0,0,0,0,0,0,0,0,0,0,0,0,0
20200528,06861P,台積電國票99售08,9.55,9.65,9.55,9.55,-0.35,-3.54,36000,4,345300,0,0,0,0,0,0,0,36000,-36000,-36000
20200528,06862P,大立光凱基98售16,2.46,2.51,2.46,2.51,+0.02,0.8,14000,2,34540,0,0,0,0,0,0,14000,0,14000,14000
20200528,06863P,欣興凱基98售05,,,,,0.00,0.00,0,0,0,0,0,0,0,0,0,0,0,0,0
20200528,06864P,健策凱基98售01,0.91,1.04,0.91,1.03,+0.03,3.0,184000,12,183020,0,0,0,0,0,0,120000,61000,59000,59000
20200528,06865P,亞德客元大98售04,2.43,2.63,2.43,2.63,+0.02,0.77,137000,5,344190,0,0,0,0,0,0,0,137000,-137000,-137000
20200528,06866P,聯發科元大98售13,,,,,0.00,0.00,0,0,0,0,0,0,0,0,0,0,0,0,0
20200528,06867P,訊芯元大98售08,2.08,2.19,2.08,2.19,-0.02,-0.9,170000,7,364100,0,0,0,0,0,0,70000,150000,-80000,-80000
20200528,06868P,電子類元大99售01,2.03,2.03,1.99,1.99,-0.01,-0.5,50000,3,101100,0,0,0,0,0,0,50000,0,50000,50000
20200528,06869P,金融類元大99售01,1.44,1.51,1.44,1.51,0.00,0.00,280000,29,421500,0,0,0,0,0,0,0,270000,-270000,-270000
20200528,06870P,台灣50群益9A售03,,,,,0.00,0.00,0,0,0,0,0,0,0,0,0,0,0,0,0
20200528,06871P,元油2X群益98售04,,,,,0.00,0.00,0,0,0,0,0,0,0,0,0,0,0,0,0
20200528,06872P,亞德客元富98售04,,,,,0.00,0.00,0,0,0,0,0,0,0,0,0,0,0,0,0
20200528,06873P,嘉晶元富98售02,,,,,0.00,0.00,0,0,0,0,0,0,0,0,0,0,0,0,0
20200528,06874P,台積電台新98售02,,,,,0.00,0.00,0,0,0,0,0,0,0,0,0,0,0,0,0
20200528,06875P,台灣50永昌9A售02,,,,,0.00,0.00,0,0,0,0,0,0,0,0,0,0,0,0,0
20200528,06876P,台灣50兆豐9B售01,,,,,0.00,0.00,0,0,0,0,0,0,0,0,0,0,0,0,0
20200528,06877P,台積電兆豐98售04,1.85,2.43,1.74,1.74,+0.06,3.57,165000,11,298880,0,0,0,0,0,0,164000,165000,-1000,-1000
20200528,06878P,台灣50日盛9B售01,1.60,1.66,1.60,1.66,+0.03,1.84,75000,4,121720,0,0,0,0,0,0,27000,48000,-21000,-21000
20200528,06879P,長榮航凱基98售02,0.86,0.94,0.86,0.94,+0.04,4.44,101000,8,92730,0,0,0,0,0,0,101000,0,101000,101000
20200528,06880P,鈺齊凱基98售03,,,,,0.00,0.00,0,0,0,0,0,0,0,0,0,0,0,0,0
20200528,06881P,國巨群益98售10,,,,,0.00,0.00,0,0,0,0,0,0,0,0,0,0,0,0,0
20200528,06882P,聯發科群益98售07,,,,,0.00,0.00,0,0,0,0,0,0,0,0,0,0,0,0,0
20200528,06883P,聯茂群益98售03,1.24,1.24,1.24,1.24,-0.08,-6.06,27000,1,33480,0,0,0,0,0,0,0,27000,-27000,-27000
20200528,06884P,台郡群益98售03,2.28,2.28,2.28,2.28,+0.01,0.44,100000,1,228000,0,0,0,0,0,0,0,100000,-100000,-100000
20200528,06885P,國巨國票99售06,9.45,10.00,9.45,10.00,+0.10,1.01,58000,7,562650,0,0,0,0,0,0,35000,23000,12000,12000
20200528,06886P,旺宏元大99售07,4.16,4.38,4.16,4.38,+0.12,2.82,30000,3,127700,0,0,0,0,0,0,20000,10000,10000,10000
20200528,06887P,華新科元大98售04,,,,,0.00,0.00,0,0,0,0,0,0,0,0,0,0,0,0,0
20200528,06888P,日月光元大98售02,6.15,6.20,6.15,6.20,-0.20,-3.12,20000,6,123500,0,0,0,0,0,0,18000,2000,16000,16000
20200528,06889P,臺股指元大98售13,0.72,0.75,0.72,0.75,0.00,0.00,45000,4,33030,0,0,0,0,0,0,21000,24000,-3000,-3000
20200528,06890P,金融類元大98售02,,,,,0.00,0.00,0,0,0,0,0,0,0,0,0,0,0,0,0
20200528,06891P,緯穎富邦99售03,0.22,0.24,0.22,0.24,+0.01,4.35,310000,16,71800,0,0,0,0,0,0,180000,130000,50000,50000
20200528,06892P,聯鈞元富98售01,,,,,0.00,0.00,0,0,0,0,0,0,0,0,0,0,0,0,0
20200528,06893P,致新元富98售02,0.81,0.81,0.76,0.76,-0.12,-13.64,36000,5,28410,0,0,0,0,0,0,1000,35000,-34000,-34000
20200528,06894P,鈺齊元富98售03,,,,,0.00,0.00,0,0,0,0,0,0,0,0,0,0,0,0,0
20200528,06895P,台灣50統一9A售01,,,,,0.00,0.00,0,0,0,0,0,0,0,0,0,0,0,0,0
20200528,06896P,信邦中信98售01,,,,,0.00,0.00,0,0,0,0,0,0,0,0,0,0,0,0,0
20200528,06897P,FBVIX群益01售01,,,,,0.00,0.00,0,0,0,0,0,0,0,0,0,0,0,0,0
20200528,06898P,FBVIX群益9C售03,,,,,0.00,0.00,0,0,0,0,0,0,0,0,0,0,0,0,0
20200528,06899P,嘉澤群益98售01,0.24,0.29,0.24,0.28,+0.02,7.69,672000,26,177780,0,0,0,0,0,0,500000,170000,330000,330000
20200528,06900P,FBVIX國票12售01,0.45,0.45,0.45,0.45,0.00,0.00,3000,1,1350,0,0,0,0,0,0,3000,0,3000,3000
20200528,06901P,亞德客凱基98售02,0.41,0.50,0.41,0.50,+0.04,8.7,23000,4,9980,0,0,0,0,0,0,16000,7000,9000,9000
20200528,06902P,聯電凱基98售02,0.96,0.97,0.93,0.97,-0.04,-3.96,221000,8,207090,0,0,0,0,0,0,200000,21000,179000,179000
20200528,06903P,技嘉凱基98售04,0.75,0.84,0.72,0.83,+0.12,16.9,1493000,34,1162950,0,0,0,0,0,0,157000,1336000,-1179000,-1179000
20200528,06904P,TPK凱基98售03,1.45,1.46,1.44,1.44,-0.05,-3.36,50000,5,72500,0,0,0,0,0,0,50000,0,50000,50000
20200528,06905P,上証2X國泰99售02,1.13,1.15,1.13,1.15,-0.01,-0.86,13000,2,14750,0,0,0,0,0,0,0,13000,-13000,-13000
20200528,06906P,國巨國泰99售01,,,,,0.00,0.00,0,0,0,0,0,0,0,0,0,0,0,0,0
20200528,06907P,華新科國泰99售05,,,,,0.00,0.00,0,0,0,0,0,0,0,0,0,0,0,0,0
20200528,06908P,健策國泰99售02,,,,,0.00,0.00,0,0,0,0,0,0,0,0,0,0,0,0,0
20200528,06909P,元油2X元大98售22,,,,,0.00,0.00,0,0,0,0,0,0,0,0,0,0,0,0,0
20200528,06910P,元油2X元大98售23,,,,,0.00,0.00,0,0,0,0,0,0,0,0,0,0,0,0,0
20200528,06911P,鴻海元大99售09,3.93,3.99,3.93,3.99,-0.16,-3.86,86000,4,340380,0,0,0,0,0,0,56000,85000,-29000,-29000
20200528,06912P,台光電元大99售02,0.93,1.04,0.93,1.04,+0.13,14.29,55000,2,51700,0,0,0,0,0,0,55000,0,55000,55000
20200528,06913P,聯發科元大98售14,,,,,0.00,0.00,0,0,0,0,0,0,0,0,0,0,0,0,0
20200528,06914P,南茂元大98售03,1.44,1.57,1.44,1.56,+0.09,6.12,431000,10,643510,0,0,0,0,0,0,0,431000,-431000,-431000
20200528,06915P,晶技元富98售02,0.14,0.22,0.14,0.22,0.00,0.00,11000,2,1620,0,0,0,0,0,0,10000,0,10000,10000
20200528,06916P,聯鈞元富98售02,,,,,0.00,0.00,0,0,0,0,0,0,0,0,0,0,0,0,0
20200528,06917P,聯電亞東99售01,,,,,0.00,0.00,0,0,0,0,0,0,0,0,0,0,0,0,0
20200528,06918P,嘉聯益亞東99售01,,,,,0.00,0.00,0,0,0,0,0,0,0,0,0,0,0,0,0
20200528,06919P,臺股指日盛98售02,,,,,0.00,0.00,0,0,0,0,0,0,0,0,0,0,0,0,0
20200528,06920P,台灣50凱基9A售01,3.01,3.01,3.00,3.00,0.00,0.00,180000,18,541100,0,0,0,0,0,0,180000,180000,0,0
20200528,06921P,台光電凱基98售06,1.17,1.24,1.17,1.24,+0.06,5.08,238000,9,285690,0,0,0,0,0,0,10000,225000,-215000,-215000
20200528,06922P,元上證群益9C售01,2.96,2.96,2.96,2.96,+0.03,1.02,20000,2,59200,0,0,0,0,0,0,0,20000,-20000,-20000
20200528,06923P,鴻海群益98售09,,,,,0.00,0.00,0,0,0,0,0,0,0,0,0,0,0,0,0
20200528,06924P,台積電群益98售07,4.19,4.19,4.19,4.19,0.00,0.00,5000,1,20950,0,0,0,0,0,0,0,5000,-5000,-5000
20200528,06925P,致茂群益9A售02,2.32,2.38,2.28,2.36,+0.03,1.29,113000,12,263240,0,0,0,0,0,0,88000,25000,63000,63000
20200528,06926P,可成群益9A售04,5.30,5.50,5.30,5.50,+0.05,0.92,120000,4,651850,0,0,0,0,0,0,3000,117000,-114000,-114000
20200528,06927P,台灣50元大9B售03,,,,,0.00,0.00,0,0,0,0,0,0,0,0,0,0,0,0,0
20200528,06928P,鴻海元大99售10,3.78,3.82,3.78,3.82,0.00,0.00,120000,4,455700,0,0,0,0,0,0,30000,120000,-90000,-90000
20200528,06929P,鴻海元大99售11,1.72,1.72,1.72,1.72,0.00,0.00,50000,1,86000,0,0,0,0,0,0,0,50000,-50000,-50000
20200528,06930P,台積電元大98售19,,,,,0.00,0.00,0,0,0,0,0,0,0,0,0,0,0,0,0
20200528,06931P,大立光元大98售20,,,,,0.00,0.00,0,0,0,0,0,0,0,0,0,0,0,0,0
20200528,06932P,大立光元大98售21,,,,,0.00,0.00,0,0,0,0,0,0,0,0,0,0,0,0,0
20200528,06933P,禾伸堂元大98售03,1.14,1.19,1.12,1.19,+0.01,0.85,75000,9,86510,0,0,0,0,0,0,70000,5000,65000,65000
20200528,06934P,聯鈞元大98售03,2.12,2.21,2.11,2.20,-0.14,-5.98,237000,16,508450,0,0,0,0,0,0,129000,108000,21000,21000
20200528,06935P,神達元大98售02,2.16,2.22,2.16,2.22,-0.06,-2.63,160000,11,350930,0,0,0,0,0,0,150000,10000,140000,140000
20200528,06936P,瑞儀元大98售01,2.19,2.19,2.19,2.19,-0.07,-3.1,25000,2,54750,0,0,0,0,0,0,25000,0,25000,25000
20200528,06937P,GIS元大98售03,1.32,1.59,1.30,1.54,+0.07,4.76,582000,35,824420,0,0,0,0,0,0,387000,187000,200000,200000
20200528,06938P,南電元大98售03,3.12,3.12,3.08,3.08,0.00,0.00,89000,2,276120,0,0,0,0,0,0,0,89000,-89000,-89000
20200528,06939P,國巨永豐98售09,2.45,2.52,2.42,2.52,0.00,0.00,356000,11,877350,0,0,0,0,0,0,20000,336000,-316000,-316000
20200528,06940P,旺宏永豐98售05,1.76,1.76,1.76,1.76,0.00,0.00,7000,1,12320,0,0,0,0,0,0,0,7000,-7000,-7000
20200528,06941P,國巨統一98售07,,,,,0.00,0.00,0,0,0,0,0,0,0,0,0,0,0,0,0
20200528,06942P,台灣50台新02售01,,,,,0.00,0.00,0,0,0,0,0,0,0,0,0,0,0,0,0
20200528,06943P,致茂元富98售03,,,,,0.00,0.00,0,0,0,0,0,0,0,0,0,0,0,0,0
20200528,06944P,健鼎元富98售02,,,,,0.00,0.00,0,0,0,0,0,0,0,0,0,0,0,0,0
20200528,06945P,國巨群益99售04,,,,,0.00,0.00,0,0,0,0,0,0,0,0,0,0,0,0,0
20200528,06946P,T50正2元大9C售01,3.78,4.10,3.78,4.10,+0.06,1.49,66000,9,262500,0,0,0,0,0,0,38000,28000,10000,10000
20200528,06947P,FBVIX元大01售01,,,,,0.00,0.00,0,0,0,0,0,0,0,0,0,0,0,0,0
20200528,06948P,FBVIX元大01售02,,,,,0.00,0.00,0,0,0,0,0,0,0,0,0,0,0,0,0
20200528,06949P,台表科元大99售01,1.29,1.39,1.24,1.37,+0.06,4.58,383000,13,495320,0,0,0,0,0,0,175000,208000,-33000,-33000
20200528,06950P,鴻海統一9B售02,,,,,0.00,0.00,0,0,0,0,0,0,0,0,0,0,0,0,0
20200528,06951P,台積電統一9B售02,0.66,0.66,0.66,0.66,0.00,0.00,110000,1,72600,0,0,0,0,0,0,110000,110000,0,0
20200528,06952P,大立光統一9A售03,2.37,2.37,2.37,2.37,0.00,0.00,13000,1,30810,0,0,0,0,0,0,0,13000,-13000,-13000
20200528,06953P,景碩統一9A售01,0.90,0.90,0.90,0.90,0.00,0.00,21000,1,18900,0,0,0,0,0,0,0,21000,-21000,-21000
20200528,06954P,大立光元富99售01,4.07,4.38,4.07,4.35,+0.14,3.33,150000,14,628350,0,0,0,0,0,0,53000,97000,-44000,-44000
20200528,06955P,臻鼎元富99售01,,,,,0.00,0.00,0,0,0,0,0,0,0,0,0,0,0,0,0
20200528,06956P,國巨日盛99售04,,,,,0.00,0.00,0,0,0,0,0,0,0,0,0,0,0,0,0
20200528,06957P,FBVIX凱基01售01,,,,,0.00,0.00,0,0,0,0,0,0,0,0,0,0,0,0,0
20200528,06958P,FBVIX凱基9C售02,,,,,0.00,0.00,0,0,0,0,0,0,0,0,0,0,0,0,0
20200528,06959P,鴻海凱基9A售02,2.66,2.68,2.66,2.66,0.00,0.00,77000,4,204850,0,0,0,0,0,0,2000,75000,-73000,-73000
20200528,06960P,國巨凱基99售08,2.62,2.66,2.62,2.66,-0.01,-0.37,162000,2,430440,0,0,0,0,0,0,0,162000,-162000,-162000
20200528,06961P,台積電凱基99售05,,,,,0.00,0.00,0,0,0,0,0,0,0,0,0,0,0,0,0
20200528,06962P,華新科永豐99售01,1.12,1.15,1.12,1.15,+0.07,6.48,215000,12,246000,0,0,0,0,0,0,6000,209000,-203000,-203000
20200528,06963P,鴻海凱基99售04,,,,,0.00,0.00,0,0,0,0,0,0,0,0,0,0,0,0,0
20200528,06964P,臺股指凱基9B售01,,,,,0.00,0.00,0,0,0,0,0,0,0,0,0,0,0,0,0
20200528,06965P,台積電台新99售02,0.97,1.13,0.97,1.13,+0.08,7.62,129000,13,131030,0,0,0,0,0,0,120000,129000,-9000,-9000
20200528,06966P,健策台新9A售02,,,,,0.00,0.00,0,0,0,0,0,0,0,0,0,0,0,0,0
20200528,06967P,台郡台新99售02,,,,,0.00,0.00,0,0,0,0,0,0,0,0,0,0,0,0,0
20200528,06968P,元油2X元大99售08,,,,,0.00,0.00,0,0,0,0,0,0,0,0,0,0,0,0,0
20200528,06969P,上銀元大99售02,,,,,0.00,0.00,0,0,0,0,0,0,0,0,0,0,0,0,0
20200528,06970P,旺宏元大99售08,0.79,0.79,0.79,0.79,-0.02,-2.47,10000,1,7900,0,0,0,0,0,0,10000,0,10000,10000
20200528,06971P,台光電元大99售03,0.54,0.60,0.54,0.59,+0.04,7.27,89000,9,51550,0,0,0,0,0,0,52000,37000,15000,15000
20200528,06972P,聯發科元大99售04,2.63,2.63,2.63,2.63,+0.04,1.54,17000,1,44710,0,0,0,0,0,0,17000,0,17000,17000
20200528,06973P,臺股指元大9A售11,9.65,9.65,9.65,9.65,0.00,0.00,100000,1,965000,0,0,0,0,0,0,0,100000,-100000,-100000
20200528,06974P,臺股指元大9A售12,,,,,0.00,0.00,0,0,0,0,0,0,0,0,0,0,0,0,0
20200528,06975P,臺股指元大9A售13,,,,,0.00,0.00,0,0,0,0,0,0,0,0,0,0,0,0,0
20200528,06976P,臺股指元大9A售14,,,,,0.00,0.00,0,0,0,0,0,0,0,0,0,0,0,0,0
20200528,06977P,臺股指元大9A售15,,,,,0.00,0.00,0,0,0,0,0,0,0,0,0,0,0,0,0
20200528,06978P,聯發科富邦9B售02,,,,,0.00,0.00,0,0,0,0,0,0,0,0,0,0,0,0,0
20200528,06979P,台灣50永豐9A售02,,,,,0.00,0.00,0,0,0,0,0,0,0,0,0,0,0,0,0
20200528,06980P,緯穎永豐99售02,0.48,0.52,0.48,0.51,+0.02,4.08,41000,3,20110,0,0,0,0,0,0,1000,40000,-39000,-39000
20200528,06981P,台灣50麥證99售02,,,,,0.00,0.00,0,0,0,0,0,0,0,0,0,0,0,0,0
20200528,06982P,義隆凱基99售02,0.46,0.48,0.46,0.48,-0.02,-4.0,179000,10,83480,0,0,0,0,0,0,70000,109000,-39000,-39000
20200528,06983P,台積電國泰9A售02,2.30,2.36,2.30,2.36,+0.08,3.51,68000,3,159400,0,0,0,0,0,0,0,68000,-68000,-68000
20200528,06984P,上銀富邦9B售01,1.48,1.59,1.46,1.59,+0.09,6.0,373000,19,576920,0,0,0,0,0,0,114000,259000,-145000,-145000
20200528,06985P,華新科富邦9C售02,,,,,0.00,0.00,0,0,0,0,0,0,0,0,0,0,0,0,0
20200528,06986P,台積電台新9A售01,,,,,0.00,0.00,0,0,0,0,0,0,0,0,0,0,0,0,0
20200528,06987P,鴻海元富99售08,,,,,0.00,0.00,0,0,0,0,0,0,0,0,0,0,0,0,0
20200528,06988P,鴻海元富99售09,6.40,6.40,6.40,6.40,0.00,0.00,3000,1,19200,0,0,0,0,0,0,0,3000,-3000,-3000
20200528,06989P,鴻海元富99售10,,,,,0.00,0.00,0,0,0,0,0,0,0,0,0,0,0,0,0
20200528,06990P,康友元富99售03,3.57,3.59,3.57,3.59,0.00,0.00,12000,2,43040,0,0,0,0,0,0,12000,0,12000,12000
20200528,06991P,矽創群益99售01,0.86,0.97,0.86,0.97,-0.12,-11.01,1078000,13,1004940,0,0,0,0,0,0,23000,1055000,-1032000,-1032000
20200528,06992P,玉晶光日盛9B售01,,,,,0.00,0.00,0,0,0,0,0,0,0,0,0,0,0,0,0
20200528,06993P,鴻海凱基99售05,1.93,1.93,1.93,1.93,0.00,0.00,2000,1,3860,0,0,0,0,0,0,2000,2000,0,0
20200528,06994P,台光電凱基99售02,0.76,0.76,0.76,0.76,0.00,0.00,10000,1,7600,0,0,0,0,0,0,0,10000,-10000,-10000
20200528,06995P,臺股指凱基99售16,1.28,1.33,1.28,1.33,+0.06,4.72,37000,5,48910,0,0,0,0,0,0,0,37000,-37000,-37000
20200528,06996P,臺股指凱基99售17,0.80,0.80,0.80,0.80,+0.04,5.26,16000,2,12800,0,0,0,0,0,0,1000,0,1000,1000
20200528,06997P,台灣50中信03售01,,,,,0.00,0.00,0,0,0,0,0,0,0,0,0,0,0,0,0
20200528,06998P,S&P正2中信9B售01,,,,,0.00,0.00,0,0,0,0,0,0,0,0,0,0,0,0,0
20200528,06999P,玉晶光國票9B售01,3.61,3.61,3.40,3.59,-0.16,-4.27,115000,8,412300,0,0,0,0,0,0,0,115000,-115000,-115000
20200528,07000P,T50反1元大99售03,,,,,0.00,0.00,0,0,0,0,0,0,0,0,0,0,0,0,0
20200528,07001P,國巨元大99售12,,,,,0.00,0.00,0,0,0,0,0,0,0,0,0,0,0,0,0
20200528,07002P,鴻海兆豐99售04,,,,,0.00,0.00,0,0,0,0,0,0,0,0,0,0,0,0,0
20200528,07003P,聯發科兆豐99售02,,,,,0.00,0.00,0,0,0,0,0,0,0,0,0,0,0,0,0
20200528,07004P,大立光兆豐9A售01,,,,,0.00,0.00,0,0,0,0,0,0,0,0,0,0,0,0,0
20200528,07005P,台積電統一9B售05,1.02,1.02,1.02,1.02,+0.13,14.61,10000,1,10200,0,0,0,0,0,0,10000,10000,0,0
20200528,07006P,旺宏統一9B售03,1.10,1.14,1.10,1.14,+0.04,3.64,10000,4,11090,0,0,0,0,0,0,0,10000,-10000,-10000
20200528,07007P,台灣50台新01售02,,,,,0.00,0.00,0,0,0,0,0,0,0,0,0,0,0,0,0
20200528,07008P,台郡中信99售02,,,,,0.00,0.00,0,0,0,0,0,0,0,0,0,0,0,0,0
20200528,07009P,臺股指中信9B售01,1.44,1.54,1.44,1.52,+0.07,4.83,34000,6,51680,0,0,0,0,0,0,4000,30000,-26000,-26000
20200528,07010P,T50正2凱基9C售01,4.01,4.13,4.01,4.11,0.00,0.00,83000,6,340070,0,0,0,0,0,0,78000,5000,73000,73000
20200528,07011P,宏達電凱基99售02,1.38,1.58,1.38,1.56,+0.13,9.09,94000,7,139440,0,0,0,0,0,0,36000,58000,-22000,-22000
20200528,07012P,智邦群益9A售01,0.28,0.28,0.28,0.28,0.00,0.00,10000,1,2800,0,0,0,0,0,0,0,10000,-10000,-10000
20200528,07013P,玉晶光群益9A售06,,,,,0.00,0.00,0,0,0,0,0,0,0,0,0,0,0,0,0
20200528,07014P,華通元大99售04,1.29,1.30,1.21,1.30,-0.14,-9.72,277000,24,350960,0,0,0,0,0,0,63000,214000,-151000,-151000
20200528,07015P,國巨元大99售13,1.07,1.07,1.07,1.07,+0.02,1.9,10000,1,10700,0,0,0,0,0,0,10000,0,10000,10000
20200528,07016P,聯發科元大99售10,1.95,2.03,1.95,1.97,-0.03,-1.5,55000,7,108300,0,0,0,0,0,0,22000,33000,-11000,-11000
20200528,07017P,台灣50元富9B售02,,,,,0.00,0.00,0,0,0,0,0,0,0,0,0,0,0,0,0
20200528,07018P,台灣50統一9B售01,,,,,0.00,0.00,0,0,0,0,0,0,0,0,0,0,0,0,0
20200528,07019P,鴻海台新99售01,,,,,0.00,0.00,0,0,0,0,0,0,0,0,0,0,0,0,0
20200528,07020P,玉晶光台新99售02,1.38,1.39,1.37,1.38,-0.09,-6.12,596000,11,823270,0,0,0,0,0,0,596000,596000,0,0
20200528,07021P,台積電富邦9C售02,1.90,2.02,1.90,2.02,+0.09,4.66,40000,4,78400,0,0,0,0,0,0,20000,20000,0,0
20200528,07022P,嘉晶永豐99售02,0.42,0.45,0.41,0.44,+0.03,7.32,145000,8,61810,0,0,0,0,0,0,78000,65000,13000,13000
20200528,07023P,南電永豐99售02,1.48,1.53,1.48,1.53,0.00,0.00,197000,7,295280,0,0,0,0,0,0,0,197000,-197000,-197000
20200528,07024P,臺股指永豐99售02,,,,,0.00,0.00,0,0,0,0,0,0,0,0,0,0,0,0,0
20200528,07025P,玉晶光凱基99售01,0.88,0.89,0.83,0.89,-0.04,-4.3,127000,7,112430,0,0,0,0,0,0,26000,101000,-75000,-75000
20200528,07026P,超眾凱基99售03,0.77,0.79,0.75,0.77,-0.01,-1.28,148000,9,112660,0,0,0,0,0,0,51000,97000,-46000,-46000
20200528,07027P,台積電群益99售04,4.19,4.41,4.19,4.41,+0.11,2.56,109000,7,471030,0,0,0,0,0,0,105000,4000,101000,101000
20200528,07028P,大立光群益99售06,,,,,0.00,0.00,0,0,0,0,0,0,0,0,0,0,0,0,0
20200528,07029P,緯穎群益99售02,,,,,0.00,0.00,0,0,0,0,0,0,0,0,0,0,0,0,0
20200528,07030P,鈺齊群益99售01,1.74,1.76,1.74,1.75,-0.14,-7.41,46000,3,80300,0,0,0,0,0,0,26000,20000,6000,6000
20200528,07031P,台灣50中信03售02,1.49,1.49,1.49,1.49,-0.02,-1.32,50000,1,74500,0,0,0,0,0,0,0,50000,-50000,-50000
20200528,07032P,聯發科統一9C售02,0.88,0.93,0.88,0.91,+0.01,1.11,1478000,20,1339720,0,0,0,0,0,0,584000,894000,-310000,-310000
20200528,07033P,大立光統一9B售03,1.79,1.86,1.79,1.86,0.00,0.00,4000,2,7230,0,0,0,0,0,0,0,4000,-4000,-4000
20200528,07034P,大立光元富99售03,2.95,2.95,2.95,2.95,-0.04,-1.34,13000,4,38350,0,0,0,0,0,0,13000,0,13000,13000
20200528,07035P,大立光元富99售04,4.49,4.76,4.49,4.76,0.00,0.00,177000,13,814810,0,0,0,0,0,0,88000,89000,-1000,-1000
20200528,07036P,台灣50台新9C售01,,,,,0.00,0.00,0,0,0,0,0,0,0,0,0,0,0,0,0
20200528,07037P,台積電台新99售03,,,,,0.00,0.00,0,0,0,0,0,0,0,0,0,0,0,0,0
20200528,07038P,華新科台新99售01,,,,,0.00,0.00,0,0,0,0,0,0,0,0,0,0,0,0,0
20200528,07039P,南電台新99售01,,,,,0.00,0.00,0,0,0,0,0,0,0,0,0,0,0,0,0
20200528,07040P,台灣50元大9C售02,,,,,0.00,0.00,0,0,0,0,0,0,0,0,0,0,0,0,0
20200528,07041P,T50反1元大9C售01,,,,,0.00,0.00,0,0,0,0,0,0,0,0,0,0,0,0,0
20200528,07042P,T50反1元大9C售02,,,,,0.00,0.00,0,0,0,0,0,0,0,0,0,0,0,0,0
20200528,07043P,國巨元大99售14,,,,,0.00,0.00,0,0,0,0,0,0,0,0,0,0,0,0,0
20200528,07044P,台積電元大99售13,2.83,2.83,2.83,2.83,0.00,0.00,4000,1,11320,0,0,0,0,0,0,0,4000,-4000,-4000
20200528,07045P,上銀國票9A售01,3.75,3.99,3.68,3.99,0.00,0.00,44000,6,168740,0,0,0,0,0,0,0,44000,-44000,-44000
20200528,07046P,大立光富邦9C售03,1.24,1.24,1.24,1.24,0.00,0.00,1000,1,1240,0,0,0,0,0,0,0,0,0,0
20200528,07047P,S&P500中信9B售02,,,,,0.00,0.00,0,0,0,0,0,0,0,0,0,0,0,0,0
20200528,07048P,台積電中信03售01,1.52,1.61,1.52,1.61,+0.05,3.21,15000,5,23740,0,0,0,0,0,0,14000,1000,13000,13000
20200528,07049P,聯發科中信99售03,0.58,0.58,0.57,0.58,+0.03,5.45,13000,3,7510,0,0,0,0,0,0,8000,5000,3000,3000
20200528,07050P,宏達電中信9B售01,1.11,1.13,1.11,1.13,+0.06,5.61,5000,3,5600,0,0,0,0,0,0,5000,0,5000,5000
20200528,07051P,大立光中信99售02,2.21,2.21,2.21,2.21,-0.08,-3.49,31000,1,68510,0,0,0,0,0,0,31000,0,31000,31000
20200528,07052P,臺股指中信9C售02,,,,,0.00,0.00,0,0,0,0,0,0,0,0,0,0,0,0,0
20200528,07053P,台灣50兆豐01售01,,,,,0.00,0.00,0,0,0,0,0,0,0,0,0,0,0,0,0
20200528,07054P,華新科兆豐99售04,,,,,0.00,0.00,0,0,0,0,0,0,0,0,0,0,0,0,0
20200528,07055P,景碩群益9A售02,2.84,2.87,2.78,2.87,-0.08,-2.71,54000,7,153050,0,0,0,0,0,0,31000,23000,8000,8000
20200528,07056P,臺股指麥證99售02,,,,,0.00,0.00,0,0,0,0,0,0,0,0,0,0,0,0,0
20200528,07057P,大立光康和9B售02,,,,,0.00,0.00,0,0,0,0,0,0,0,0,0,0,0,0,0
20200528,07058P,台積電凱基9A售07,2.59,2.72,2.59,2.72,+0.06,2.26,80000,7,210650,0,0,0,0,0,0,20000,60000,-40000,-40000
20200528,07059P,華通國票9A售02,2.17,2.17,2.09,2.09,0.00,0.00,40000,3,86150,0,0,0,0,0,0,0,40000,-40000,-40000
20200528,07060P,台表科國票9A售01,0.75,0.80,0.72,0.80,+0.02,2.56,275000,10,214980,0,0,0,0,0,0,20000,255000,-235000,-235000
20200528,07061P,台積電元大99售14,,,,,0.00,0.00,0,0,0,0,0,0,0,0,0,0,0,0,0
20200528,07062P,台積電元大99售15,,,,,0.00,0.00,0,0,0,0,0,0,0,0,0,0,0,0,0
20200528,07063P,臺股指元大9A售24,8.35,8.35,8.35,8.35,0.00,0.00,10000,2,83500,0,0,0,0,0,0,0,10000,-10000,-10000
20200528,07064P,臺股指元大9A售25,,,,,0.00,0.00,0,0,0,0,0,0,0,0,0,0,0,0,0
20200528,07065P,臺股指元大9A售26,7.40,7.80,7.40,7.80,+0.35,4.7,13000,3,100600,0,0,0,0,0,0,11000,2000,9000,9000
20200528,07066P,台灣50台新9B售01,,,,,0.00,0.00,0,0,0,0,0,0,0,0,0,0,0,0,0
20200528,07067P,旺宏台新99售02,1.21,1.30,1.20,1.30,+0.09,7.44,351000,16,426200,0,0,0,0,0,0,56000,293000,-237000,-237000
20200528,07068P,欣興台新99售01,1.60,1.60,1.60,1.60,0.00,0.00,10000,1,16000,0,0,0,0,0,0,10000,0,10000,10000
20200528,07069P,欣興元富99售02,4.32,4.32,4.22,4.24,-0.15,-3.42,58000,3,246460,0,0,0,0,0,0,57000,1000,56000,56000
20200528,07070P,晶相光元富99售01,3.44,3.59,3.44,3.59,+0.15,4.36,34000,2,118160,0,0,0,0,0,0,0,34000,-34000,-34000
20200528,07071P,立積元富99售01,1.63,1.71,1.63,1.69,+0.04,2.42,317000,10,532300,0,0,0,0,0,0,37000,280000,-243000,-243000
20200528,07072P,元油2X凱基9C售01,,,,,0.00,0.00,0,0,0,0,0,0,0,0,0,0,0,0,0
20200528,07073P,臺股指中信9B售02,,,,,0.00,0.00,0,0,0,0,0,0,0,0,0,0,0,0,0
20200528,07074P,FBVIX凱基9A售01,,,,,0.00,0.00,0,0,0,0,0,0,0,0,0,0,0,0,0
20200528,07075P,FBVIX凱基9C售04,,,,,0.00,0.00,0,0,0,0,0,0,0,0,0,0,0,0,0
20200528,07076P,鴻海凱基9A售08,2.68,2.77,2.68,2.77,-0.01,-0.36,4000,2,10810,0,0,0,0,0,0,1000,3000,-2000,-2000
20200528,07077P,緯穎凱基99售01,,,,,0.00,0.00,0,0,0,0,0,0,0,0,0,0,0,0,0
20200528,07078P,鴻海群益99售02,,,,,0.00,0.00,0,0,0,0,0,0,0,0,0,0,0,0,0
20200528,07079P,台積電群益99售06,8.45,8.45,8.45,8.45,-0.25,-2.87,5000,1,42250,0,0,0,0,0,0,5000,0,5000,5000
20200528,07080P,健策群益9A售01,0.64,0.74,0.64,0.73,+0.03,4.29,408000,30,279910,0,0,0,0,0,0,183000,225000,-42000,-42000
20200528,07081P,南電群益9A售01,1.64,1.69,1.64,1.69,+0.01,0.6,67000,4,110440,0,0,0,0,0,0,5000,62000,-57000,-57000
20200528,07082P,美律元大99售06,0.95,0.97,0.94,0.96,-0.06,-5.88,937000,48,891830,0,0,0,0,0,0,807000,243000,564000,564000
20200528,07083P,台積電統一9A售06,,,,,0.00,0.00,0,0,0,0,0,0,0,0,0,0,0,0,0
20200528,07084P,S&P正2元富9B售02,0.76,0.78,0.75,0.78,-0.04,-4.88,28000,5,21250,0,0,0,0,0,0,0,11000,-11000,-11000
20200528,07085P,超眾元富9C售01,1.89,1.92,1.84,1.86,-0.05,-2.62,113000,7,214040,0,0,0,0,0,0,44000,69000,-25000,-25000
20200528,07086P,力成元富9C售01,2.30,2.39,2.25,2.39,+0.05,2.14,371000,17,873960,0,0,0,0,0,0,4000,367000,-363000,-363000
20200528,07087P,聯發科台新99售02,,,,,0.00,0.00,0,0,0,0,0,0,0,0,0,0,0,0,0
20200528,07088P,訊芯永豐99售02,0.69,0.76,0.69,0.76,+0.01,1.33,230000,6,165420,0,0,0,0,0,0,42000,188000,-146000,-146000
20200528,07089P,臺指2X中信01售01,1.27,1.35,1.26,1.33,+0.03,2.31,340000,16,444140,0,0,0,0,0,0,108000,232000,-124000,-124000
20200528,07090P,台灣50凱基01售01,3.25,3.38,3.25,3.38,+0.27,8.68,10000,2,33670,0,0,0,0,0,0,1000,9000,-8000,-8000
20200528,07091P,SGBR2X凱基9A售02,,,,,0.00,0.00,0,0,0,0,0,0,0,0,0,0,0,0,0
20200528,07092P,上銀凱基99售03,,,,,0.00,0.00,0,0,0,0,0,0,0,0,0,0,0,0,0
20200528,07093P,台積電凱基99售07,,,,,0.00,0.00,0,0,0,0,0,0,0,0,0,0,0,0,0
20200528,07094P,華通國票9A售03,1.61,1.62,1.50,1.62,-0.12,-6.9,85000,9,133550,0,0,0,0,0,0,30000,55000,-25000,-25000
20200528,07095P,台灣50元大9C售03,,,,,0.00,0.00,0,0,0,0,0,0,0,0,0,0,0,0,0
20200528,07096P,元石油元大9C售05,,,,,0.00,0.00,0,0,0,0,0,0,0,0,0,0,0,0,0
20200528,07097P,元油2X元大9C售09,,,,,0.00,0.00,0,0,0,0,0,0,0,0,0,0,0,0,0
20200528,07098P,台積電元大99售18,0.59,0.62,0.59,0.62,0.00,0.00,28000,2,17060,0,0,0,0,0,0,0,28000,-28000,-28000
20200528,07099P,台積電元大99售19,2.03,2.13,2.03,2.13,0.00,0.00,7000,2,14810,0,0,0,0,0,0,0,7000,-7000,-7000
20200528,07100P,華航元大99售01,0.67,0.72,0.67,0.71,+0.02,2.9,142000,8,99890,0,0,0,0,0,0,90000,0,90000,90000
20200528,07101P,台郡元大99售06,,,,,0.00,0.00,0,0,0,0,0,0,0,0,0,0,0,0,0
20200528,07102P,南電元大99售03,2.40,2.51,2.34,2.51,+0.05,2.03,371000,17,899560,0,0,0,0,0,0,25000,346000,-321000,-321000
20200528,07103P,南電元大99售04,3.11,3.22,3.07,3.22,+0.06,1.9,124000,8,385780,0,0,0,0,0,0,15000,109000,-94000,-94000
20200528,07104P,聯發科元富99售04,1.12,1.14,1.11,1.11,+0.03,2.78,11000,4,12360,0,0,0,0,0,0,3000,8000,-5000,-5000
20200528,07105P,大毅元富99售02,0.59,0.61,0.56,0.60,0.00,0.00,558000,16,322480,0,0,0,0,0,0,438000,100000,338000,338000
20200528,07106P,國巨統一9B售05,1.04,1.08,1.04,1.08,+0.01,0.93,1025000,18,1069050,0,0,0,0,0,0,0,1025000,-1025000,-1025000
20200528,07107P,臺股指統一99售07,,,,,0.00,0.00,0,0,0,0,0,0,0,0,0,0,0,0,0
20200528,07108P,FBVIX台新99售02,,,,,0.00,0.00,0,0,0,0,0,0,0,0,0,0,0,0,0
20200528,07109P,聯發科中信9B售02,,,,,0.00,0.00,0,0,0,0,0,0,0,0,0,0,0,0,0
20200528,07110P,台灣50群益9B售03,,,,,0.00,0.00,0,0,0,0,0,0,0,0,0,0,0,0,0
20200528,07111P,台積電群益99售08,,,,,0.00,0.00,0,0,0,0,0,0,0,0,0,0,0,0,0
20200528,07112P,聯發科群益99售05,,,,,0.00,0.00,0,0,0,0,0,0,0,0,0,0,0,0,0
20200528,07113P,台積電兆豐99售03,,,,,0.00,0.00,0,0,0,0,0,0,0,0,0,0,0,0,0
20200528,07114P,旺宏兆豐9A售01,1.70,1.78,1.70,1.78,+0.10,5.95,52000,2,88560,0,0,0,0,0,0,0,52000,-52000,-52000
20200528,07115P,T50反1日盛9C售02,1.21,1.21,1.21,1.21,0.00,0.00,220000,1,266200,0,0,0,0,0,0,220000,220000,0,0
20200528,07116P,台灣50麥證9A售02,,,,,0.00,0.00,0,0,0,0,0,0,0,0,0,0,0,0,0
20200528,07117P,SGBR2X凱基9C售01,1.88,1.89,1.87,1.87,+0.03,1.63,40000,4,75100,0,0,0,0,0,0,0,40000,-40000,-40000
20200528,07118P,台積電凱基99售09,,,,,0.00,0.00,0,0,0,0,0,0,0,0,0,0,0,0,0
20200528,07119P,台積電凱基9A售08,0.40,0.45,0.37,0.37,-0.05,-11.9,25000,5,9390,0,0,0,0,0,0,0,0,0,0
20200528,07120P,聯發科凱基99售09,1.73,1.73,1.73,1.73,0.00,0.00,6000,1,10380,0,0,0,0,0,0,0,6000,-6000,-6000
20200528,07121P,華新科凱基99售03,1.85,1.91,1.85,1.91,+0.03,1.6,78000,3,147780,0,0,0,0,0,0,0,78000,-78000,-78000
20200528,07122P,欣興凱基99售05,1.33,1.33,1.20,1.29,-0.10,-7.19,42000,3,54160,0,0,0,0,0,0,32000,10000,22000,22000
20200528,07123P,鴻海元大99售23,1.15,1.17,1.15,1.16,-0.03,-2.52,120000,3,138350,0,0,0,0,0,0,0,120000,-120000,-120000
20200528,07124P,台積電元大99售21,1.27,1.28,1.27,1.28,0.00,0.00,200000,3,255000,0,0,0,0,0,0,0,200000,-200000,-200000
20200528,07125P,台積電元大99售22,,,,,0.00,0.00,0,0,0,0,0,0,0,0,0,0,0,0,0
20200528,07126P,台積電元大99售23,1.02,1.03,1.01,1.03,0.00,0.00,23000,4,23580,0,0,0,0,0,0,5000,18000,-13000,-13000
20200528,07127P,精元元大99售01,2.61,2.68,2.48,2.48,-0.25,-9.16,82000,6,205410,0,0,0,0,0,0,63000,19000,44000,44000
20200528,07128P,大毅元大99售04,0.59,0.59,0.59,0.59,0.00,0.00,175000,2,103250,0,0,0,0,0,0,170000,5000,165000,165000
20200528,07129P,華新科元大99售14,3.99,4.21,3.99,4.18,+0.12,2.96,282000,9,1158680,0,0,0,0,0,0,90000,192000,-102000,-102000
20200528,07130P,台郡元大9B售01,0.91,0.92,0.91,0.92,+0.01,1.1,273000,5,249430,0,0,0,0,0,0,20000,253000,-233000,-233000
20200528,07131P,緯穎元大99售06,1.28,1.35,1.28,1.35,+0.03,2.27,193000,3,256910,0,0,0,0,0,0,13000,180000,-167000,-167000
20200528,07132P,臺股指元大99售11,,,,,0.00,0.00,0,0,0,0,0,0,0,0,0,0,0,0,0
20200528,07133P,臺股指元大9A售27,2.25,2.40,2.25,2.40,+0.04,1.69,75000,8,173100,0,0,0,0,0,0,40000,30000,10000,10000
20200528,07134P,臺股指元大9A售28,3.69,3.72,3.69,3.70,+0.07,1.93,77000,6,285240,0,0,0,0,0,0,77000,0,77000,77000
20200528,07135P,臺股指元大9A售29,4.36,4.36,4.35,4.35,0.00,0.00,7000,3,30510,0,0,0,0,0,0,0,7000,-7000,-7000
20200528,07136P,T50反1台新01售01,,,,,0.00,0.00,0,0,0,0,0,0,0,0,0,0,0,0,0
20200528,07137P,大立光中信9B售01,,,,,0.00,0.00,0,0,0,0,0,0,0,0,0,0,0,0,0
20200528,07138P,台灣50群益9B售04,3.77,3.77,3.77,3.77,0.00,0.00,10000,1,37700,0,0,0,0,0,0,10000,0,10000,10000
20200528,07139P,元油2X群益9C售06,,,,,0.00,0.00,0,0,0,0,0,0,0,0,0,0,0,0,0
20200528,07140P,台灣50日盛99售01,2.35,2.50,2.33,2.33,+0.14,6.39,75000,7,181850,0,0,0,0,0,0,75000,10000,65000,65000
20200528,07141P,台灣50國票9A售03,5.00,5.00,5.00,5.00,+0.35,7.53,80000,1,400000,0,0,0,0,0,0,0,80000,-80000,-80000
20200528,07142P,台灣50元大01售01,4.50,4.50,4.50,4.50,+0.05,1.12,1000,1,4500,0,0,0,0,0,0,1000,0,1000,1000
20200528,07143P,FBVIX元大99售02,1.19,1.19,1.19,1.19,-0.01,-0.83,10000,1,11900,0,0,0,0,0,0,10000,0,10000,10000
20200528,07144P,FBVIX元大99售03,,,,,0.00,0.00,0,0,0,0,0,0,0,0,0,0,0,0,0
20200528,07145P,為升元大99售03,1.20,1.27,1.20,1.27,0.00,0.00,80000,3,96350,0,0,0,0,0,0,80000,0,80000,80000
20200528,07146P,瑞昱元大99售02,,,,,0.00,0.00,0,0,0,0,0,0,0,0,0,0,0,0,0
20200528,07147P,高鐵元大99售01,0.30,0.39,0.30,0.39,+0.05,14.71,143000,10,50700,0,0,0,0,0,0,86000,35000,51000,51000
20200528,07148P,富邦金元大99售01,,,,,0.00,0.00,0,0,0,0,0,0,0,0,0,0,0,0,0
20200528,07149P,健鼎元大99售03,1.65,1.65,1.54,1.63,-0.07,-4.12,212000,7,330970,0,0,0,0,0,0,91000,121000,-30000,-30000
20200528,07150P,和碩元大99售01,0.93,0.99,0.93,0.99,+0.02,2.06,19000,2,17850,0,0,0,0,0,0,19000,0,19000,19000
20200528,07151P,台灣50統一9B售04,,,,,0.00,0.00,0,0,0,0,0,0,0,0,0,0,0,0,0
20200528,07152P,臺股指元富99售08,,,,,0.00,0.00,0,0,0,0,0,0,0,0,0,0,0,0,0
20200528,07153P,臺股指元富99售09,,,,,0.00,0.00,0,0,0,0,0,0,0,0,0,0,0,0,0
20200528,07155P,臺股指元富99售10,,,,,0.00,0.00,0,0,0,0,0,0,0,0,0,0,0,0,0
20200528,07156P,臺股指元富99售11,,,,,0.00,0.00,0,0,0,0,0,0,0,0,0,0,0,0,0
20200528,07157P,臺股指元富99售12,,,,,0.00,0.00,0,0,0,0,0,0,0,0,0,0,0,0,0
20200528,07158P,FBVIX國泰9C售01,,,,,0.00,0.00,0,0,0,0,0,0,0,0,0,0,0,0,0
20200528,07159P,台積電永豐99售04,,,,,0.00,0.00,0,0,0,0,0,0,0,0,0,0,0,0,0
20200528,07160P,台灣50中信03售04,,,,,0.00,0.00,0,0,0,0,0,0,0,0,0,0,0,0,0
20200528,07161P,臺股指群益99售12,,,,,0.00,0.00,0,0,0,0,0,0,0,0,0,0,0,0,0
20200528,07162P,臺股指群益99售13,1.80,2.04,1.80,2.00,+0.07,3.63,438000,35,845130,0,0,0,0,0,0,253000,185000,68000,68000
20200528,07163P,臺股指群益99售14,2.15,2.31,2.14,2.31,+0.08,3.59,44000,10,96750,0,0,0,0,0,0,14000,30000,-16000,-16000
20200528,07164P,臺股指群益99售15,2.22,2.43,2.18,2.38,+0.06,2.59,228000,14,527680,0,0,0,0,0,0,86000,142000,-56000,-56000
20200528,07165P,臺股指群益99售16,4.20,4.24,4.20,4.24,+0.12,2.91,10000,4,42170,0,0,0,0,0,0,10000,0,10000,10000
20200528,07166P,台灣50兆豐03售01,0.80,0.80,0.80,0.80,+0.04,5.26,12000,2,9600,0,0,0,0,0,0,0,10000,-10000,-10000
20200528,07167P,臺股指兆豐99售02,,,,,0.00,0.00,0,0,0,0,0,0,0,0,0,0,0,0,0
20200528,07168P,臺股指兆豐99售03,,,,,0.00,0.00,0,0,0,0,0,0,0,0,0,0,0,0,0
20200528,07169P,臺股指國票99售06,,,,,0.00,0.00,0,0,0,0,0,0,0,0,0,0,0,0,0
20200528,07170P,臺股指國票99售07,2.46,2.80,2.45,2.73,+0.13,5.0,1181000,35,3054260,0,0,0,0,0,0,805000,366000,439000,439000
20200528,07171P,臺股指國票99售08,1.90,2.08,1.90,2.08,+0.08,4.0,116000,3,238480,0,0,0,0,0,0,10000,106000,-96000,-96000
20200528,07172P,臺股指國票99售09,1.97,2.17,1.97,2.13,+0.08,3.9,56000,10,114730,0,0,0,0,0,0,51000,5000,46000,46000
20200528,07173P,臺股指國票99售10,1.44,1.66,1.43,1.62,+0.06,3.85,636000,51,970110,0,0,0,0,0,0,353000,273000,80000,80000
20200528,07174P,臺股指國票99售11,2.68,3.02,2.68,2.96,+0.07,2.42,595000,28,1687830,0,0,0,0,0,0,314000,281000,33000,33000
20200528,07175P,聯詠凱基99售02,,,,,0.00,0.00,0,0,0,0,0,0,0,0,0,0,0,0,0
20200528,07176P,臺股指凱基99售18,,,,,0.00,0.00,0,0,0,0,0,0,0,0,0,0,0,0,0
20200528,07177P,臺股指凱基99售19,,,,,0.00,0.00,0,0,0,0,0,0,0,0,0,0,0,0,0
20200528,07178P,臺股指凱基99售20,2.91,2.91,2.91,2.91,-0.13,-4.28,1000,1,2910,0,0,0,0,0,0,1000,0,1000,1000
20200528,07179P,臺股指凱基99售21,,,,,0.00,0.00,0,0,0,0,0,0,0,0,0,0,0,0,0
20200528,07180P,臺股指凱基99售22,3.71,3.71,3.65,3.65,0.00,0.00,25000,2,92450,0,0,0,0,0,0,0,25000,-25000,-25000
20200528,07181P,臺股指凱基99售23,2.91,3.15,2.91,3.11,+0.10,3.32,34000,11,102680,0,0,0,0,0,0,11000,23000,-12000,-12000
20200528,07182P,臺股指凱基99售24,,,,,0.00,0.00,0,0,0,0,0,0,0,0,0,0,0,0,0
20200528,07183P,臺股指凱基99售25,3.60,3.82,3.60,3.82,+0.10,2.69,50000,2,190780,0,0,0,0,0,0,49000,1000,48000,48000
20200528,07184P,台灣50元富01售01,,,,,0.00,0.00,0,0,0,0,0,0,0,0,0,0,0,0,0
20200528,07185P,臺股指統一9C售01,,,,,0.00,0.00,0,0,0,0,0,0,0,0,0,0,0,0,0
20200528,07186P,臺股指統一9C售02,,,,,0.00,0.00,0,0,0,0,0,0,0,0,0,0,0,0,0
20200528,07187P,臺股指台新99售10,1.04,1.13,1.04,1.13,+0.08,7.62,22000,3,23060,0,0,0,0,0,0,2000,20000,-18000,-18000
20200528,07188P,臺股指台新99售11,,,,,0.00,0.00,0,0,0,0,0,0,0,0,0,0,0,0,0
20200528,07189P,聯發科富邦9B售03,0.74,0.75,0.74,0.75,+0.01,1.35,150000,3,111300,0,0,0,0,0,0,100000,50000,50000,50000
20200528,07190P,臺股指富邦9C售02,1.82,1.87,1.82,1.86,+0.01,0.54,18000,3,33110,0,0,0,0,0,0,10000,8000,2000,2000
20200528,07191P,台積電元大99售32,,,,,0.00,0.00,0,0,0,0,0,0,0,0,0,0,0,0,0
20200528,07192P,聯發科元大99售23,1.95,2.17,1.95,2.15,+0.05,2.38,74000,5,158500,0,0,0,0,0,0,14000,60000,-46000,-46000
20200528,07193P,聯發科元大99售24,,,,,0.00,0.00,0,0,0,0,0,0,0,0,0,0,0,0,0
20200528,07194P,聯發科元大99售25,1.92,2.08,1.92,2.08,0.00,0.00,20000,3,39920,0,0,0,0,0,0,10000,10000,0,0
20200528,07195P,大立光元大99售12,4.74,4.81,4.74,4.81,0.00,0.00,18000,2,85950,0,0,0,0,0,0,0,18000,-18000,-18000
20200528,07196P,大立光元大99售13,4.44,4.44,4.44,4.44,0.00,0.00,10000,1,44400,0,0,0,0,0,0,0,10000,-10000,-10000
20200528,07197P,臺股指元大99售13,,,,,0.00,0.00,0,0,0,0,0,0,0,0,0,0,0,0,0
20200528,07198P,臺股指元大99售14,4.11,4.11,4.11,4.11,0.00,0.00,5000,1,20550,0,0,0,0,0,0,5000,0,5000,5000
20200528,07199P,臺股指元大99售15,,,,,0.00,0.00,0,0,0,0,0,0,0,0,0,0,0,0,0
20200528,07200P,臺股指元大99售16,,,,,0.00,0.00,0,0,0,0,0,0,0,0,0,0,0,0,0
20200528,07201P,臺股指元大99售17,3.70,3.75,3.70,3.75,+0.08,2.18,29000,3,107850,0,0,0,0,0,0,11000,18000,-7000,-7000
20200528,07202P,台灣50凱基9C售04,1.67,1.79,1.66,1.77,+0.05,2.91,109000,6,191430,0,0,0,0,0,0,105000,4000,101000,101000
20200528,07203P,T50正2凱基9C售02,,,,,0.00,0.00,0,0,0,0,0,0,0,0,0,0,0,0,0
20200528,07204P,鴻海凱基99售10,,,,,0.00,0.00,0,0,0,0,0,0,0,0,0,0,0,0,0
20200528,07205P,鴻海凱基99售11,,,,,0.00,0.00,0,0,0,0,0,0,0,0,0,0,0,0,0
20200528,07206P,鴻海凱基9A售11,1.08,1.12,1.08,1.12,-0.01,-0.88,13000,2,14160,0,0,0,0,0,0,0,3000,-3000,-3000
20200528,07207P,台積電凱基99售13,,,,,0.00,0.00,0,0,0,0,0,0,0,0,0,0,0,0,0
20200528,07208P,台積電凱基99售14,0.89,0.94,0.89,0.94,+0.03,3.3,121000,9,110640,0,0,0,0,0,0,59000,62000,-3000,-3000
20200528,07209P,台積電凱基9A售10,,,,,0.00,0.00,0,0,0,0,0,0,0,0,0,0,0,0,0
20200528,07210P,智邦凱基99售03,0.20,0.21,0.17,0.20,-0.03,-13.04,666000,39,130420,0,0,0,0,0,0,275000,341000,-66000,-66000
20200528,07211P,南亞科凱基99售05,1.40,1.52,1.40,1.52,-0.08,-5.0,60000,7,88280,0,0,0,0,0,0,1000,59000,-58000,-58000
20200528,07212P,聯發科凱基99售14,0.23,0.25,0.23,0.25,0.00,0.00,41000,2,9550,0,0,0,0,0,0,41000,0,41000,41000
20200528,07213P,聯發科凱基99售15,2.02,2.02,2.02,2.02,0.00,0.00,4000,1,8080,0,0,0,0,0,0,0,4000,-4000,-4000
20200528,07214P,聯發科凱基9A售04,0.26,0.30,0.26,0.28,0.00,0.00,239000,6,69000,0,0,0,0,0,0,189000,50000,139000,139000
20200528,07215P,大立光凱基99售07,1.28,1.36,1.28,1.36,+0.04,3.03,93000,4,122080,0,0,0,0,0,0,93000,0,93000,93000
20200528,07216P,大立光凱基99售08,1.26,1.29,1.26,1.29,-0.04,-3.01,78000,6,98860,0,0,0,0,0,0,78000,0,78000,78000
20200528,07217P,大立光凱基9A售05,1.10,1.17,1.10,1.17,+0.03,2.63,59000,4,65330,0,0,0,0,0,0,59000,0,59000,59000
20200528,07218P,臺股指凱基99售31,1.63,1.78,1.63,1.78,+0.06,3.49,165000,15,279770,0,0,0,0,0,0,98000,67000,31000,31000
20200528,07219P,臺股指凱基99售32,1.89,1.89,1.89,1.89,-0.09,-4.55,3000,1,5670,0,0,0,0,0,0,3000,0,3000,3000
20200528,07220P,台灣50中信03售05,,,,,0.00,0.00,0,0,0,0,0,0,0,0,0,0,0,0,0
20200528,07221P,臺股指中信9B售04,,,,,0.00,0.00,0,0,0,0,0,0,0,0,0,0,0,0,0
20200528,07222P,台灣50元大01售04,,,,,0.00,0.00,0,0,0,0,0,0,0,0,0,0,0,0,0
20200528,07223P,鴻海元大99售29,,,,,0.00,0.00,0,0,0,0,0,0,0,0,0,0,0,0,0
20200528,07224P,鴻海元大9A售02,,,,,0.00,0.00,0,0,0,0,0,0,0,0,0,0,0,0,0
20200528,07225P,台積電元大99售33,2.24,2.34,2.24,2.34,0.00,0.00,150000,3,346000,0,0,0,0,0,0,100000,150000,-50000,-50000
20200528,07226P,貿聯富邦9B售01,,,,,0.00,0.00,0,0,0,0,0,0,0,0,0,0,0,0,0
20200528,07227P,聯發科元富99售05,0.57,0.58,0.55,0.55,+0.01,1.85,301000,5,169370,0,0,0,0,0,0,121000,180000,-59000,-59000
20200528,07228P,台灣50群益9B售06,,,,,0.00,0.00,0,0,0,0,0,0,0,0,0,0,0,0,0
20200528,07229P,T50正2群益9A售01,4.08,4.08,4.08,4.08,0.00,0.00,10000,1,40800,0,0,0,0,0,0,10000,0,10000,10000
20200528,07230P,滬深2X群益01售02,,,,,0.00,0.00,0,0,0,0,0,0,0,0,0,0,0,0,0
20200528,07231P,台灣50元大01售06,,,,,0.00,0.00,0,0,0,0,0,0,0,0,0,0,0,0,0
20200528,07232P,台灣50元大01售07,,,,,0.00,0.00,0,0,0,0,0,0,0,0,0,0,0,0,0
20200528,07233P,台灣50元大99售04,2.50,2.50,2.50,2.50,+0.07,2.88,2000,1,5000,0,0,0,0,0,0,0,2000,-2000,-2000
20200528,07234P,台灣50元大9B售04,4.15,4.21,4.14,4.20,+0.06,1.45,665000,8,2756430,0,0,0,0,0,0,5000,660000,-655000,-655000
20200528,07235P,T50正2元大9C售02,3.31,3.41,3.31,3.40,+0.06,1.8,35000,4,116760,0,0,0,0,0,0,0,35000,-35000,-35000
20200528,07236P,台灣50國票99售05,5.50,5.50,5.50,5.50,0.00,0.00,10000,1,55000,0,0,0,0,0,0,0,10000,-10000,-10000
20200528,07237P,台灣50國票99售06,,,,,0.00,0.00,0,0,0,0,0,0,0,0,0,0,0,0,0
20200528,07238P,台灣50國票99售07,2.68,2.82,2.68,2.82,+0.06,2.17,12000,2,33000,0,0,0,0,0,0,6000,6000,0,0
20200528,07239P,台灣50國票9A售04,,,,,0.00,0.00,0,0,0,0,0,0,0,0,0,0,0,0,0
20200528,07241P,台灣50國票9A售05,4.05,4.05,4.05,4.05,+0.13,3.32,30000,1,121500,0,0,0,0,0,0,30000,0,30000,30000
20200528,07242P,台灣50凱基9A售03,1.72,1.72,1.72,1.72,+0.05,2.99,5000,1,8600,0,0,0,0,0,0,0,5000,-5000,-5000
20200528,07243P,台灣50凱基9A售04,,,,,0.00,0.00,0,0,0,0,0,0,0,0,0,0,0,0,0
20200528,07244P,鴻海凱基9A售13,1.57,1.62,1.57,1.62,0.00,0.00,10000,4,15870,0,0,0,0,0,0,0,10000,-10000,-10000
20200528,07245P,台積電凱基99售16,2.19,2.27,2.19,2.26,+0.02,0.89,52000,5,117470,0,0,0,0,0,0,50000,1000,49000,49000
20200528,07246P,旺宏凱基99售08,1.05,1.10,1.05,1.10,+0.02,1.85,97000,3,105850,0,0,0,0,0,0,0,97000,-97000,-97000
20200528,07247P,聯發科凱基9A售06,0.37,0.40,0.37,0.39,+0.01,2.63,278000,4,107500,0,0,0,0,0,0,178000,100000,78000,78000
20200528,07248P,可成凱基99售06,0.66,0.67,0.66,0.67,0.00,0.00,396000,2,263360,0,0,0,0,0,0,0,396000,-396000,-396000
20200528,07249P,T50正2富邦03售02,,,,,0.00,0.00,0,0,0,0,0,0,0,0,0,0,0,0,0
20200528,07250P,台灣50永豐99售07,,,,,0.00,0.00,0,0,0,0,0,0,0,0,0,0,0,0,0
20200528,07251P,台灣50元富01售04,,,,,0.00,0.00,0,0,0,0,0,0,0,0,0,0,0,0,0
20200528,07252P,台灣50凱基99售01,1.44,1.44,1.44,1.44,0.00,0.00,20000,1,28800,0,0,0,0,0,0,0,20000,-20000,-20000
20200528,07253P,台灣50凱基9A售05,,,,,0.00,0.00,0,0,0,0,0,0,0,0,0,0,0,0,0
20200528,07254P,台灣50凱基9C售06,,,,,0.00,0.00,0,0,0,0,0,0,0,0,0,0,0,0,0
20200528,07255P,國巨凱基99售15,0.58,0.61,0.58,0.61,-0.02,-3.17,4000,4,2400,0,0,0,0,0,0,0,4000,-4000,-4000
20200528,07256P,臺股指凱基99售36,1.87,1.87,1.87,1.87,0.00,0.00,9000,2,16830,0,0,0,0,0,0,9000,0,9000,9000
20200528,07257P,臺股指凱基99售37,1.67,1.73,1.67,1.73,+0.02,1.17,23000,3,38890,0,0,0,0,0,0,23000,0,23000,23000
20200528,07258P,台灣50台新9A售01,0.39,0.42,0.39,0.42,+0.01,2.44,65000,4,26200,0,0,0,0,0,0,10000,55000,-45000,-45000
20200528,07259P,滬深2X國票01售01,0.49,0.51,0.47,0.51,0.00,0.00,105000,5,51850,0,0,0,0,0,0,20000,85000,-65000,-65000
20200528,07260P,台灣50元大9A售01,,,,,0.00,0.00,0,0,0,0,0,0,0,0,0,0,0,0,0
20200528,07261P,台灣50元大9A售04,,,,,0.00,0.00,0,0,0,0,0,0,0,0,0,0,0,0,0
20200528,07262P,台灣50元大9B售05,,,,,0.00,0.00,0,0,0,0,0,0,0,0,0,0,0,0,0
20200528,07263P,台積電元大99售37,1.24,1.32,1.24,1.31,+0.03,2.34,940000,8,1228700,0,0,0,0,0,0,930000,910000,20000,20000
20200528,07264P,台積電元大99售38,2.02,2.17,2.02,2.17,+0.06,2.84,457000,4,990720,0,0,0,0,0,0,454000,453000,1000,1000
20200528,07265P,大立光元大99售16,1.73,1.77,1.73,1.77,-0.04,-2.21,26000,3,45300,0,0,0,0,0,0,26000,0,26000,26000
20200528,07266P,大立光元大99售19,1.96,2.10,1.96,2.10,+0.08,3.96,54000,4,108380,0,0,0,0,0,0,15000,39000,-24000,-24000
20200528,07267P,臺股指元大99售23,2.91,3.01,2.91,3.01,+0.06,2.03,12000,2,35920,0,0,0,0,0,0,10000,2000,8000,8000
20200528,07268P,臺股指元大99售24,,,,,0.00,0.00,0,0,0,0,0,0,0,0,0,0,0,0,0
20200528,07269P,台灣50元大01售08,,,,,0.00,0.00,0,0,0,0,0,0,0,0,0,0,0,0,0
20200528,07270P,台灣50元大01售09,,,,,0.00,0.00,0,0,0,0,0,0,0,0,0,0,0,0,0
20200528,07271P,台灣50元大9C售04,,,,,0.00,0.00,0,0,0,0,0,0,0,0,0,0,0,0,0
20200528,07272P,台灣50元大9C售05,,,,,0.00,0.00,0,0,0,0,0,0,0,0,0,0,0,0,0
20200528,07273P,台灣50群益99售03,,,,,0.00,0.00,0,0,0,0,0,0,0,0,0,0,0,0,0
20200528,07274P,上証2X群益01售01,,,,,0.00,0.00,0,0,0,0,0,0,0,0,0,0,0,0,0
20200528,07275P,FBVIX群益99售02,,,,,0.00,0.00,0,0,0,0,0,0,0,0,0,0,0,0,0
20200528,07276P,臺股指群益99售19,1.31,1.38,1.31,1.38,+0.04,2.99,51000,4,67840,0,0,0,0,0,0,4000,47000,-43000,-43000
20200528,07277P,臺股指群益99售20,,,,,0.00,0.00,0,0,0,0,0,0,0,0,0,0,0,0,0
20200528,07278P,台灣50元富9C售03,,,,,0.00,0.00,0,0,0,0,0,0,0,0,0,0,0,0,0
20200528,07279P,台灣50台新99售02,0.12,0.14,0.12,0.14,+0.01,7.69,315000,9,43200,0,0,0,0,0,0,20000,290000,-270000,-270000
20200528,07280P,FBVIX凱基99售01,,,,,0.00,0.00,0,0,0,0,0,0,0,0,0,0,0,0,0
20200528,07281P,鴻海凱基99售13,1.09,1.10,1.08,1.10,-0.02,-1.79,270000,5,293900,0,0,0,0,0,0,160000,110000,50000,50000
20200528,07282P,聯發科凱基99售17,,,,,0.00,0.00,0,0,0,0,0,0,0,0,0,0,0,0,0
20200528,07283P,華新科凱基99售07,,,,,0.00,0.00,0,0,0,0,0,0,0,0,0,0,0,0,0
20200528,07284P,大立光凱基99售10,1.30,1.35,1.30,1.35,+0.02,1.5,132000,5,171760,0,0,0,0,0,0,132000,0,132000,132000
20200528,07285P,上証2X群益01售02,,,,,0.00,0.00,0,0,0,0,0,0,0,0,0,0,0,0,0
20200528,07286P,元石油群益99售03,1.00,1.00,1.00,1.00,+0.49,96.08,2000,1,2000,0,0,0,0,0,0,0,0,0,0
20200528,07287P,全新群益9B售01,0.29,0.29,0.29,0.29,0.00,0.00,23000,1,6670,0,0,0,0,0,0,0,23000,-23000,-23000
20200528,07288P,台灣50凱基99售06,0.63,0.63,0.63,0.63,0.00,0.00,45000,1,28350,0,0,0,0,0,0,45000,0,45000,45000
20200528,07289P,台灣50凱基99售07,0.58,0.58,0.58,0.58,0.00,0.00,45000,1,26100,0,0,0,0,0,0,45000,0,45000,45000
20200528,07290P,台灣50凱基9A售08,,,,,0.00,0.00,0,0,0,0,0,0,0,0,0,0,0,0,0
20200528,07291P,臺股指凱基99售43,0.68,0.68,0.68,0.68,0.00,0.00,3000,1,2040,0,0,0,0,0,0,3000,0,3000,3000
20200528,07292P,臺股指凱基99售44,0.58,0.62,0.58,0.61,+0.01,1.67,753000,17,439210,0,0,0,0,0,0,561000,76000,485000,485000
20200528,07293P,臺股指凱基99售45,0.87,0.91,0.87,0.91,+0.02,2.25,8000,2,7160,0,0,0,0,0,0,0,8000,-8000,-8000
20200528,07294P,滬深2X元富9C售08,1.83,1.92,1.83,1.92,+0.03,1.59,34000,5,63200,0,0,0,0,0,0,0,34000,-34000,-34000
20200528,07295P,滬深2X元富9C售09,,,,,0.00,0.00,0,0,0,0,0,0,0,0,0,0,0,0,0
20200528,07296P,T50反1台新99售02,,,,,0.00,0.00,0,0,0,0,0,0,0,0,0,0,0,0,0
20200528,07297P,台灣50元大9C售11,,,,,0.00,0.00,0,0,0,0,0,0,0,0,0,0,0,0,0
20200528,07298P,台灣50元大9C售12,,,,,0.00,0.00,0,0,0,0,0,0,0,0,0,0,0,0,0
20200528,07299P,台灣50元大9C售13,,,,,0.00,0.00,0,0,0,0,0,0,0,0,0,0,0,0,0
20200528,07300P,臺股指元大9A售33,0.85,0.86,0.84,0.86,-0.01,-1.15,305000,7,257360,0,0,0,0,0,0,210000,95000,115000,115000
20200528,07301P,臺股指元大9A售34,0.88,0.88,0.88,0.88,+0.01,1.15,11000,1,9680,0,0,0,0,0,0,11000,0,11000,11000
20200528,07302P,臺股指元大9A售35,1.00,1.00,1.00,1.00,0.00,0.00,5000,1,5000,0,0,0,0,0,0,5000,0,5000,5000
20200528,07303P,臺股指元大9A售36,0.98,1.03,0.97,1.01,+0.01,1.0,733000,10,723530,0,0,0,0,0,0,364000,369000,-5000,-5000
20200528,07304P,臺股指元大9A售37,1.09,1.15,1.09,1.14,+0.02,1.79,345000,8,383780,0,0,0,0,0,0,133000,212000,-79000,-79000
20200528,07305P,T50正2群益99售02,0.75,0.79,0.74,0.79,+0.02,2.6,60000,7,45450,0,0,0,0,0,0,40000,20000,20000,20000
20200528,07306P,台灣50凱基9A售09,,,,,0.00,0.00,0,0,0,0,0,0,0,0,0,0,0,0,0
20200528,07307P,上証2X凱基9A售02,,,,,0.00,0.00,0,0,0,0,0,0,0,0,0,0,0,0,0
20200528,07308P,滬深2X凱基9A售01,,,,,0.00,0.00,0,0,0,0,0,0,0,0,0,0,0,0,0
20200528,07309P,聯發科凱基99售18,,,,,0.00,0.00,0,0,0,0,0,0,0,0,0,0,0,0,0
20200528,07310P,大立光凱基99售12,,,,,0.00,0.00,0,0,0,0,0,0,0,0,0,0,0,0,0
20200528,07311P,台灣50元大99售09,1.04,1.04,1.04,1.04,0.00,0.00,20000,2,20800,0,0,0,0,0,0,20000,0,20000,20000
20200528,07312P,台灣50元大99售10,0.89,0.90,0.89,0.90,-0.01,-1.1,13000,2,11680,0,0,0,0,0,0,0,13000,-13000,-13000
20200528,07313P,台灣50元大99售11,,,,,0.00,0.00,0,0,0,0,0,0,0,0,0,0,0,0,0
20200528,07314P,T50正2元大9C售03,,,,,0.00,0.00,0,0,0,0,0,0,0,0,0,0,0,0,0
20200528,07315P,台積電台新99售06,0.23,0.26,0.23,0.26,-0.01,-3.7,424000,8,101210,0,0,0,0,0,0,201000,223000,-22000,-22000
20200528,07316P,長榮航康和99售01,0.46,0.48,0.46,0.48,+0.02,4.35,85000,3,39160,0,0,0,0,0,0,85000,0,85000,85000
20200528,07317P,T50正2凱基9B售02,0.74,0.75,0.74,0.75,-0.02,-2.6,18000,2,13350,0,0,0,0,0,0,18000,0,18000,18000
20200528,07318P,鴻海凱基01售02,,,,,0.00,0.00,0,0,0,0,0,0,0,0,0,0,0,0,0
20200528,07319P,台積電凱基01售02,0.61,0.62,0.61,0.62,0.00,0.00,84000,3,51480,0,0,0,0,0,0,81000,0,81000,81000
20200528,07320P,台灣50元大9C售14,,,,,0.00,0.00,0,0,0,0,0,0,0,0,0,0,0,0,0
20200528,07321P,台灣50元大9C售15,,,,,0.00,0.00,0,0,0,0,0,0,0,0,0,0,0,0,0
20200528,07322P,鴻海元大99售33,2.22,2.25,2.22,2.25,0.00,0.00,100000,2,223500,0,0,0,0,0,0,0,100000,-100000,-100000
20200528,07323P,鴻海元大99售34,,,,,0.00,0.00,0,0,0,0,0,0,0,0,0,0,0,0,0
20200528,07324P,台積電元大99售40,1.98,2.00,1.98,2.00,0.00,0.00,600000,5,1196000,0,0,0,0,0,0,600000,600000,0,0
20200528,07325P,台積電元大99售41,2.09,2.09,2.09,2.09,-0.06,-2.79,50000,1,104500,0,0,0,0,0,0,50000,0,50000,50000
20200528,07326P,大立光元大99售23,2.95,3.11,2.95,3.10,+0.03,0.98,59000,3,177190,0,0,0,0,0,0,39000,20000,19000,19000
20200528,07327P,台灣50群益9A售06,1.60,1.64,1.60,1.64,+0.02,1.23,200000,3,320800,0,0,0,0,0,0,140000,60000,80000,80000
20200528,07328P,FBVIX國泰9B售01,1.84,1.84,1.84,1.84,-0.01,-0.54,40000,2,73600,0,0,0,0,0,0,40000,0,40000,40000
20200528,07329P,台灣50群益9A售07,,,,,0.00,0.00,0,0,0,0,0,0,0,0,0,0,0,0,0
20200528,07330P,台灣50群益9A售08,,,,,0.00,0.00,0,0,0,0,0,0,0,0,0,0,0,0,0
20200528,07331P,臺股指群益99售22,,,,,0.00,0.00,0,0,0,0,0,0,0,0,0,0,0,0,0
20200528,07332P,臺股指群益99售23,,,,,0.00,0.00,0,0,0,0,0,0,0,0,0,0,0,0,0
20200528,07333P,台灣50國票9B售03,,,,,0.00,0.00,0,0,0,0,0,0,0,0,0,0,0,0,0
20200528,07334P,臺股指國票99售19,0.74,0.80,0.72,0.79,+0.02,2.6,456000,19,344140,0,0,0,0,0,0,130000,326000,-196000,-196000
20200528,07335P,臺股指國票99售20,0.72,0.72,0.72,0.72,-0.04,-5.26,1000,1,720,0,0,0,0,0,0,1000,0,1000,1000
20200528,07336P,台灣50台新99售05,,,,,0.00,0.00,0,0,0,0,0,0,0,0,0,0,0,0,0
20200528,07337P,台灣50凱基99售09,0.75,0.75,0.75,0.75,0.00,0.00,10000,1,7500,0,0,0,0,0,0,0,10000,-10000,-10000
20200528,07338P,滬深2X凱基99售02,,,,,0.00,0.00,0,0,0,0,0,0,0,0,0,0,0,0,0
20200528,07339P,滬深2X凱基9A售03,,,,,0.00,0.00,0,0,0,0,0,0,0,0,0,0,0,0,0
20200528,07340P,鴻海凱基99售15,,,,,0.00,0.00,0,0,0,0,0,0,0,0,0,0,0,0,0
20200528,07341P,台積電凱基99售18,0.50,0.51,0.49,0.51,0.00,0.00,52000,9,26060,0,0,0,0,0,0,10000,37000,-27000,-27000
20200528,07342P,大立光凱基99售14,0.81,0.81,0.81,0.81,+0.02,2.53,66000,4,53460,0,0,0,0,0,0,15000,51000,-36000,-36000
20200528,07343P,高鐵康和99售01,0.25,0.25,0.25,0.25,0.00,0.00,60000,1,15000,0,0,0,0,0,0,60000,0,60000,60000
20200528,07344P,鴻海富邦9A售03,1.02,1.02,1.02,1.02,0.00,0.00,17000,1,17340,0,0,0,0,0,0,0,17000,-17000,-17000
20200528,07345P,台灣50永豐99售10,,,,,0.00,0.00,0,0,0,0,0,0,0,0,0,0,0,0,0
20200528,07346P,FBVIX群益99售04,,,,,0.00,0.00,0,0,0,0,0,0,0,0,0,0,0,0,0
20200528,07347P,上証2X凱基99售02,1.00,1.00,1.00,1.00,0.00,0.00,50000,1,50000,0,0,0,0,0,0,0,50000,-50000,-50000
20200528,07348P,滬深2X凱基9A售04,0.91,0.91,0.91,0.91,-0.03,-3.19,5000,2,4550,0,0,0,0,0,0,0,5000,-5000,-5000
20200528,07349P,大立光凱基99售16,,,,,0.00,0.00,0,0,0,0,0,0,0,0,0,0,0,0,0
20200528,07350P,台灣50國票99售11,2.06,2.07,2.06,2.07,0.00,0.00,20000,2,41300,0,0,0,0,0,0,0,20000,-20000,-20000
20200528,07351P,鴻海國票99售08,,,,,0.00,0.00,0,0,0,0,0,0,0,0,0,0,0,0,0
20200528,07352P,台積電國票99售11,1.62,1.70,1.62,1.70,+0.04,2.41,75000,3,123100,0,0,0,0,0,0,55000,20000,35000,35000
20200528,07353P,大立光國票99售02,1.23,1.32,1.23,1.32,+0.02,1.54,91000,3,117230,0,0,0,0,0,0,1000,90000,-89000,-89000
20200528,07354P,臺股指國票99售22,1.08,1.12,1.08,1.12,0.00,0.00,60000,2,66000,0,0,0,0,0,0,60000,0,60000,60000
20200528,07355P,臺股指國票99售23,1.28,1.31,1.28,1.31,+0.01,0.77,20000,2,25630,0,0,0,0,0,0,0,20000,-20000,-20000
20200528,07356P,臺股指國票99售24,0.95,0.95,0.95,0.95,-0.04,-4.04,20000,1,19000,0,0,0,0,0,0,20000,0,20000,20000
20200528,07357P,鴻海元大99售38,,,,,0.00,0.00,0,0,0,0,0,0,0,0,0,0,0,0,0
20200528,07358P,鴻海元大99售39,1.67,1.67,1.67,1.67,-0.02,-1.18,115000,2,192050,0,0,0,0,0,0,0,115000,-115000,-115000
20200528,07359P,台積電元大99售45,1.38,1.43,1.38,1.43,+0.03,2.14,60000,5,83750,0,0,0,0,0,0,30000,30000,0,0
20200528,07360P,台積電元大99售46,,,,,0.00,0.00,0,0,0,0,0,0,0,0,0,0,0,0,0
20200528,07361P,聯發科元大99售34,0.66,0.67,0.66,0.67,+0.02,3.08,50000,2,33200,0,0,0,0,0,0,50000,0,50000,50000
20200528,07362P,聯發科元大99售35,0.74,0.74,0.74,0.74,0.00,0.00,15000,2,11100,0,0,0,0,0,0,5000,10000,-5000,-5000
20200528,07363P,大立光元大99售26,1.41,1.41,1.41,1.41,0.00,0.00,10000,1,14100,0,0,0,0,0,0,0,10000,-10000,-10000
20200528,07364P,大立光元大99售27,,,,,0.00,0.00,0,0,0,0,0,0,0,0,0,0,0,0,0
20200528,07365P,超眾元大99售07,2.00,2.06,1.95,2.03,-0.01,-0.49,103000,5,208940,0,0,0,0,0,0,51000,52000,-1000,-1000
20200528,07366P,國巨康和99售02,0.90,0.96,0.90,0.96,+0.02,2.13,1364000,21,1272750,0,0,0,0,0,0,738000,626000,112000,112000
20200528,07367P,鴻海凱基99售17,,,,,0.00,0.00,0,0,0,0,0,0,0,0,0,0,0,0,0
20200528,07368P,國巨凱基99售19,,,,,0.00,0.00,0,0,0,0,0,0,0,0,0,0,0,0,0
20200528,07369P,台積電凱基99售20,,,,,0.00,0.00,0,0,0,0,0,0,0,0,0,0,0,0,0
20200528,07370P,南亞科凱基99售08,0.57,0.62,0.57,0.62,0.00,0.00,222000,4,135620,0,0,0,0,0,0,20000,202000,-182000,-182000
20200528,07371P,滬深2X元大99售07,,,,,0.00,0.00,0,0,0,0,0,0,0,0,0,0,0,0,0
20200528,07372P,滬深2X元大99售08,,,,,0.00,0.00,0,0,0,0,0,0,0,0,0,0,0,0,0
20200528,07373P,A50正2元大99售01,0.74,0.79,0.74,0.79,+0.01,1.28,62000,4,48810,0,0,0,0,0,0,1000,61000,-60000,-60000
20200528,07374P,鴻海元大99售41,,,,,0.00,0.00,0,0,0,0,0,0,0,0,0,0,0,0,0
20200528,07375P,台積電元大99售48,,,,,0.00,0.00,0,0,0,0,0,0,0,0,0,0,0,0,0
20200528,07376P,聯發科元大99售39,,,,,0.00,0.00,0,0,0,0,0,0,0,0,0,0,0,0,0
20200528,07377P,聯發科元大99售40,0.67,0.67,0.67,0.67,-0.01,-1.47,30000,1,20100,0,0,0,0,0,0,30000,0,30000,30000
20200528,07378P,大立光元大99售29,1.72,1.72,1.72,1.72,0.00,0.00,10000,1,17200,0,0,0,0,0,0,10000,0,10000,10000
20200528,07379P,大立光元大99售30,,,,,0.00,0.00,0,0,0,0,0,0,0,0,0,0,0,0,0
20200528,07380P,台灣50群益9A售11,,,,,0.00,0.00,0,0,0,0,0,0,0,0,0,0,0,0,0
20200528,07381P,鴻海群益99售05,1.76,1.79,1.76,1.77,-0.05,-2.75,60000,3,106400,0,0,0,0,0,0,40000,20000,20000,20000
20200528,07382P,台積電群益9B售01,,,,,0.00,0.00,0,0,0,0,0,0,0,0,0,0,0,0,0
20200528,07383P,聯發科群益99售06,0.39,0.39,0.39,0.39,0.00,0.00,60000,3,23400,0,0,0,0,0,0,60000,0,60000,60000
20200528,07384P,大立光群益9A售01,,,,,0.00,0.00,0,0,0,0,0,0,0,0,0,0,0,0,0
20200528,07385P,緯穎群益99售04,2.10,2.19,2.10,2.15,+0.03,1.42,138000,6,292880,0,0,0,0,0,0,82000,56000,26000,26000
20200528,07386P,臺股指群益99售24,1.51,1.56,1.51,1.56,-0.04,-2.5,35000,2,53100,0,0,0,0,0,0,30000,5000,25000,25000
20200528,07387P,臺股指群益99售25,1.91,1.92,1.91,1.92,+0.04,2.13,20000,2,38300,0,0,0,0,0,0,20000,0,20000,20000
20200528,07388P,臺股指群益9C售07,,,,,0.00,0.00,0,0,0,0,0,0,0,0,0,0,0,0,0
20200528,07389P,臺股指群益9C售08,1.99,2.04,1.99,2.04,+0.02,0.99,31000,4,62240,0,0,0,0,0,0,0,31000,-31000,-31000
20200528,07390P,華新科康和99售02,0.79,0.82,0.79,0.82,+0.01,1.23,85000,3,68950,0,0,0,0,0,0,60000,25000,35000,35000
20200528,07391P,台灣50國泰02售01,0.68,0.70,0.68,0.70,+0.01,1.45,130000,4,89900,0,0,0,0,0,0,0,130000,-130000,-130000
20200528,07392P,台積電國泰02售01,0.72,0.74,0.72,0.73,0.00,0.00,247000,5,178780,0,0,0,0,0,0,140000,105000,35000,35000
20200528,07393P,台灣50富邦9B售02,,,,,0.00,0.00,0,0,0,0,0,0,0,0,0,0,0,0,0
20200528,07394P,國巨群益99售12,1.08,1.08,1.08,1.08,0.00,0.00,199000,1,214920,0,0,0,0,0,0,0,199000,-199000,-199000
20200528,07395P,台積電群益99售13,1.97,1.97,1.97,1.97,+0.08,4.23,20000,1,39400,0,0,0,0,0,0,20000,0,20000,20000
20200528,07396P,聯發科群益9B售01,,,,,0.00,0.00,0,0,0,0,0,0,0,0,0,0,0,0,0
20200528,07397P,大立光群益99售10,,,,,0.00,0.00,0,0,0,0,0,0,0,0,0,0,0,0,0
20200528,07398P,鴻海凱基99售18,,,,,0.00,0.00,0,0,0,0,0,0,0,0,0,0,0,0,0
20200528,07399P,鴻海凱基99售19,,,,,0.00,0.00,0,0,0,0,0,0,0,0,0,0,0,0,0
20200528,07400P,國巨凱基99售20,0.50,0.50,0.50,0.50,-0.01,-1.96,10000,1,5000,0,0,0,0,0,0,10000,0,10000,10000
20200528,07401P,台積電凱基99售21,,,,,0.00,0.00,0,0,0,0,0,0,0,0,0,0,0,0,0
20200528,07402P,瑞昱凱基99售02,0.59,0.59,0.59,0.59,0.00,0.00,200000,1,118000,0,0,0,0,0,0,0,200000,-200000,-200000
20200528,07403P,聯發科凱基99售21,,,,,0.00,0.00,0,0,0,0,0,0,0,0,0,0,0,0,0
20200528,07404P,華新科凱基99售10,0.65,0.65,0.65,0.65,+0.02,3.17,6000,1,3900,0,0,0,0,0,0,6000,0,6000,6000
20200528,07405P,大立光凱基99售17,0.88,0.88,0.88,0.88,0.00,0.00,10000,1,8800,0,0,0,0,0,0,0,10000,-10000,-10000
20200528,07406P,大立光凱基99售18,,,,,0.00,0.00,0,0,0,0,0,0,0,0,0,0,0,0,0
20200528,07407P,欣興凱基99售07,0.47,0.47,0.43,0.46,-0.02,-4.17,537000,17,248460,0,0,0,0,0,0,283000,253000,30000,30000
20200528,07408P,台積電兆豐99售06,0.36,0.36,0.36,0.36,+0.01,2.86,10000,1,3600,0,0,0,0,0,0,0,10000,-10000,-10000
20200528,07409P,台積電台新99售07,0.32,0.32,0.32,0.32,0.00,0.00,20000,1,6400,0,0,0,0,0,0,0,20000,-20000,-20000
20200528,07410P,鴻海元大99售44,1.48,1.52,1.47,1.50,-0.03,-1.96,220000,9,327500,0,0,0,0,0,0,80000,140000,-60000,-60000
20200528,07411P,國巨元大99售31,,,,,0.00,0.00,0,0,0,0,0,0,0,0,0,0,0,0,0
20200528,07412P,國巨元大99售32,,,,,0.00,0.00,0,0,0,0,0,0,0,0,0,0,0,0,0
20200528,07413P,國巨元大99售33,0.92,0.94,0.92,0.94,-0.01,-1.05,25000,3,23100,0,0,0,0,0,0,0,25000,-25000,-25000
20200528,07414P,台積電元大99售51,2.70,2.70,2.70,2.70,-0.08,-2.88,15000,1,40500,0,0,0,0,0,0,15000,0,15000,15000
20200528,07415P,台積電元大99售52,2.40,2.49,2.40,2.49,+0.04,1.63,2000,2,4890,0,0,0,0,0,0,1000,1000,0,0
20200528,07416P,台積電元大99售53,1.87,1.93,1.86,1.93,+0.04,2.12,261000,19,496650,0,0,0,0,0,0,144000,116000,28000,28000
20200528,07417P,聯發科元大99售44,1.07,1.07,1.07,1.07,0.00,0.00,100000,1,107000,0,0,0,0,0,0,0,100000,-100000,-100000
20200528,07418P,聯發科元大99售45,0.90,0.92,0.90,0.91,+0.02,2.25,366000,7,334640,0,0,0,0,0,0,339000,27000,312000,312000
20200528,07419P,聯發科元大99售46,0.69,0.71,0.69,0.71,0.00,0.00,120000,3,85000,0,0,0,0,0,0,10000,100000,-90000,-90000
20200528,07420P,可成元大99售07,1.18,1.25,1.18,1.23,-0.01,-0.81,521000,10,632100,0,0,0,0,0,0,30000,491000,-461000,-461000
20200528,07421P,國泰金元大99售01,0.88,0.96,0.88,0.95,+0.04,4.4,932000,26,857430,0,0,0,0,0,0,220000,712000,-492000,-492000
20200528,07422P,大立光元大99售32,1.88,1.97,1.88,1.97,+0.03,1.55,41000,3,78620,0,0,0,0,0,0,33000,8000,25000,25000
20200528,07423P,大立光元大99售33,3.06,3.15,3.06,3.15,+0.01,0.32,25000,2,77400,0,0,0,0,0,0,15000,10000,5000,5000
20200528,07424P,大立光元大9B售01,2.01,2.01,2.01,2.01,0.00,0.00,8000,1,16080,0,0,0,0,0,0,0,8000,-8000,-8000
20200528,07425P,台灣50國票9A售10,2.13,2.13,2.13,2.13,-0.02,-0.93,30000,1,63900,0,0,0,0,0,0,0,30000,-30000,-30000
20200528,07426P,上証2X國票9B售01,,,,,0.00,0.00,0,0,0,0,0,0,0,0,0,0,0,0,0
20200528,07427P,台積電國票9B售02,,,,,0.00,0.00,0,0,0,0,0,0,0,0,0,0,0,0,0
20200528,07428P,華新科國票9A售01,2.24,2.24,2.24,2.24,0.00,0.00,13000,1,29120,0,0,0,0,0,0,0,13000,-13000,-13000
20200528,07429P,臺股指國票9A售01,1.03,1.03,1.03,1.03,0.00,0.00,2000,1,2060,0,0,0,0,0,0,2000,0,2000,2000
20200528,07430P,臺股指國票9A售02,0.86,0.86,0.86,0.86,-0.05,-5.49,1000,1,860,0,0,0,0,0,0,1000,0,1000,1000
20200528,07431P,臺股指國票9A售03,,,,,0.00,0.00,0,0,0,0,0,0,0,0,0,0,0,0,0
20200528,07432P,臺股指國票9A售04,0.92,0.92,0.92,0.92,-0.05,-5.15,1000,1,920,0,0,0,0,0,0,1000,0,1000,1000
20200528,07433P,臺股指國票9A售05,0.81,0.81,0.78,0.78,-0.05,-6.02,9000,2,7140,0,0,0,0,0,0,5000,4000,1000,1000
20200528,07434P,臺股指國票9A售06,0.78,0.81,0.78,0.81,-0.04,-4.71,180000,18,143200,0,0,0,0,0,0,80000,100000,-20000,-20000
20200528,07435P,台積電富邦9C售07,0.60,0.63,0.60,0.63,0.00,0.00,7000,2,4350,0,0,0,0,0,0,0,7000,-7000,-7000
20200528,07436P,臺股指麥證9A售03,,,,,0.00,0.00,0,0,0,0,0,0,0,0,0,0,0,0,0
20200528,07437P,臺股指麥證9A售04,,,,,0.00,0.00,0,0,0,0,0,0,0,0,0,0,0,0,0
20200528,07438P,臺股指麥證9A售05,,,,,0.00,0.00,0,0,0,0,0,0,0,0,0,0,0,0,0
20200528,07439P,臺股指麥證9B售01,,,,,0.00,0.00,0,0,0,0,0,0,0,0,0,0,0,0,0
20200528,07440P,臺股指麥證9B售02,,,,,0.00,0.00,0,0,0,0,0,0,0,0,0,0,0,0,0
20200528,07441P,臺股指麥證9B售03,,,,,0.00,0.00,0,0,0,0,0,0,0,0,0,0,0,0,0
20200528,07442P,華航康和9A售02,0.34,0.34,0.34,0.34,0.00,0.00,100000,1,34000,0,0,0,0,0,0,0,100000,-100000,-100000
20200528,07443P,鴻海凱基9A售18,0.57,0.57,0.57,0.57,0.00,0.00,10000,1,5700,0,0,0,0,0,0,10000,0,10000,10000
20200528,07444P,聯發科凱基9A售10,0.48,0.48,0.48,0.48,0.00,0.00,1000,1,480,0,0,0,0,0,0,0,1000,-1000,-1000
20200528,07445P,大立光凱基9A售08,,,,,0.00,0.00,0,0,0,0,0,0,0,0,0,0,0,0,0
20200528,07446P,台灣50元大9A售06,1.63,1.63,1.63,1.63,0.00,0.00,50000,1,81500,0,0,0,0,0,0,0,50000,-50000,-50000
20200528,07447P,台灣50元大9A售07,,,,,0.00,0.00,0,0,0,0,0,0,0,0,0,0,0,0,0
20200528,07448P,台灣50元大9A售08,,,,,0.00,0.00,0,0,0,0,0,0,0,0,0,0,0,0,0
20200528,07449P,臺指反元大01售01,,,,,0.00,0.00,0,0,0,0,0,0,0,0,0,0,0,0,0
20200528,07450P,鴻海元大9A售03,,,,,0.00,0.00,0,0,0,0,0,0,0,0,0,0,0,0,0
20200528,07451P,鴻海元大9B售01,1.23,1.25,1.23,1.25,-0.02,-1.57,110000,3,136400,0,0,0,0,0,0,50000,60000,-10000,-10000
20200528,07452P,國巨元大9A售05,0.81,0.83,0.81,0.83,-0.03,-3.49,299000,4,244190,0,0,0,0,0,0,299000,0,299000,299000
20200528,07453P,台積電元大9A售05,,,,,0.00,0.00,0,0,0,0,0,0,0,0,0,0,0,0,0
20200528,07454P,台積電元大9A售06,,,,,0.00,0.00,0,0,0,0,0,0,0,0,0,0,0,0,0
20200528,07455P,聯發科元大9A售01,,,,,0.00,0.00,0,0,0,0,0,0,0,0,0,0,0,0,0
20200528,07456P,華新科元大9A售06,,,,,0.00,0.00,0,0,0,0,0,0,0,0,0,0,0,0,0
20200528,07457P,宏達電元大9A售01,1.24,1.41,1.24,1.40,+0.10,7.69,722000,19,970280,0,0,0,0,0,0,77000,645000,-568000,-568000
20200528,07458P,長榮航元大9A售01,0.50,0.50,0.49,0.49,0.00,0.00,202000,3,99990,0,0,0,0,0,0,101000,101000,0,0
20200528,07459P,緯穎元大9A售01,0.70,0.76,0.69,0.76,+0.03,4.11,768000,17,549730,0,0,0,0,0,0,308000,430000,-122000,-122000
20200528,07460P,臺股指元大9B售03,,,,,0.00,0.00,0,0,0,0,0,0,0,0,0,0,0,0,0
20200528,07461P,臺股指元大9B售04,,,,,0.00,0.00,0,0,0,0,0,0,0,0,0,0,0,0,0
20200528,07462P,臺股指元大9B售05,1.14,1.14,1.14,1.14,+0.03,2.7,3000,1,3420,0,0,0,0,0,0,0,3000,-3000,-3000
20200528,07463P,台積電國票9A售05,0.65,0.65,0.65,0.65,-0.02,-2.99,5000,1,3250,0,0,0,0,0,0,0,5000,-5000,-5000
20200528,07464P,台灣50兆豐9A售02,,,,,0.00,0.00,0,0,0,0,0,0,0,0,0,0,0,0,0
20200528,07465P,台灣50元大9C售24,,,,,0.00,0.00,0,0,0,0,0,0,0,0,0,0,0,0,0
20200528,07466P,亞德客元大9A售02,1.13,1.26,1.12,1.23,+0.06,5.13,368000,10,437940,0,0,0,0,0,0,51000,317000,-266000,-266000
20200528,07467P,上銀元大9A售03,0.65,0.69,0.62,0.69,+0.04,6.15,45000,5,29500,0,0,0,0,0,0,20000,25000,-5000,-5000
20200528,07468P,聯電元大9A售02,0.55,0.55,0.53,0.54,-0.04,-6.9,292000,12,158270,0,0,0,0,0,0,232000,60000,172000,172000
20200528,07469P,台達電元大9A售01,0.78,0.80,0.77,0.80,+0.01,1.27,537000,8,423600,0,0,0,0,0,0,87000,437000,-350000,-350000
20200528,07470P,國巨元大9A售06,1.13,1.14,1.13,1.14,0.00,0.00,2000,2,2270,0,0,0,0,0,0,0,2000,-2000,-2000
20200528,07471P,南亞科元大9A售01,1.60,1.67,1.58,1.66,0.00,0.00,198000,6,324590,0,0,0,0,0,0,1000,198000,-197000,-197000
20200528,07472P,和碩元大9A售03,1.96,2.02,1.96,2.00,+0.02,1.01,502000,24,995710,0,0,0,0,0,0,60000,422000,-362000,-362000
20200528,07473P,祥碩元大9A售01,0.91,0.95,0.87,0.88,-0.07,-7.37,356000,18,323020,0,0,0,0,0,0,186000,170000,16000,16000
20200528,07474P,滬深2X群益9C售03,,,,,0.00,0.00,0,0,0,0,0,0,0,0,0,0,0,0,0
20200528,07475P,A50正2群益9C售02,,,,,0.00,0.00,0,0,0,0,0,0,0,0,0,0,0,0,0
20200528,07476P,鴻海群益9A售04,,,,,0.00,0.00,0,0,0,0,0,0,0,0,0,0,0,0,0
20200528,07477P,國巨群益9A售04,,,,,0.00,0.00,0,0,0,0,0,0,0,0,0,0,0,0,0
20200528,07478P,南電康和9A售02,0.94,0.99,0.94,0.99,+0.01,1.02,124000,7,119480,0,0,0,0,0,0,117000,7000,110000,110000
20200528,07479P,A50正2元富9A售03,,,,,0.00,0.00,0,0,0,0,0,0,0,0,0,0,0,0,0
20200528,07481P,大立光台新9A售01,,,,,0.00,0.00,0,0,0,0,0,0,0,0,0,0,0,0,0
20200528,07482P,南亞科元富9A售04,0.98,1.05,0.98,1.05,-0.01,-0.94,846000,10,868520,0,0,0,0,0,0,28000,818000,-790000,-790000
20200528,07483P,國巨台新9A售01,,,,,0.00,0.00,0,0,0,0,0,0,0,0,0,0,0,0,0
20200528,07484P,台灣50凱基04售02,,,,,0.00,0.00,0,0,0,0,0,0,0,0,0,0,0,0,0
20200528,07485P,台灣50凱基04售03,,,,,0.00,0.00,0,0,0,0,0,0,0,0,0,0,0,0,0
20200528,07486P,上証2X國票9B售02,,,,,0.00,0.00,0,0,0,0,0,0,0,0,0,0,0,0,0
20200528,07487P,鴻海國票9A售01,0.48,0.49,0.48,0.49,-0.02,-3.92,13000,2,6270,0,0,0,0,0,0,10000,3000,7000,7000
20200528,07488P,鴻海國票9A售02,,,,,0.00,0.00,0,0,0,0,0,0,0,0,0,0,0,0,0
20200528,07489P,國巨國票9A售07,1.15,1.19,1.15,1.19,-0.01,-0.83,20000,2,23400,0,0,0,0,0,0,10000,10000,0,0
20200528,07490P,大立光國票9A售03,,,,,0.00,0.00,0,0,0,0,0,0,0,0,0,0,0,0,0
20200528,07491P,臺股指國票9A售09,0.50,0.52,0.50,0.52,-0.02,-3.7,775000,5,389300,0,0,0,0,0,0,635000,140000,495000,495000
20200528,07492P,臺股指國票9A售10,,,,,0.00,0.00,0,0,0,0,0,0,0,0,0,0,0,0,0
20200528,07493P,台灣50元大9A售10,1.55,1.55,1.55,1.55,0.00,0.00,10000,1,15500,0,0,0,0,0,0,0,10000,-10000,-10000
20200528,07494P,葡萄王元大9A售03,1.94,2.03,1.94,2.01,0.00,0.00,273000,10,544390,0,0,0,0,0,0,0,273000,-273000,-273000
20200528,07495P,鴻海元大9A售04,,,,,0.00,0.00,0,0,0,0,0,0,0,0,0,0,0,0,0
20200528,07496P,鴻海元大9A售05,1.74,1.74,1.74,1.74,0.00,0.00,50000,1,87000,0,0,0,0,0,0,0,50000,-50000,-50000
20200528,07497P,鴻海元大9A售06,,,,,0.00,0.00,0,0,0,0,0,0,0,0,0,0,0,0,0
20200528,07498P,台積電元大9A售09,,,,,0.00,0.00,0,0,0,0,0,0,0,0,0,0,0,0,0
20200528,07499P,台積電元大9A售12,,,,,0.00,0.00,0,0,0,0,0,0,0,0,0,0,0,0,0
20200528,07500P,微星元大9A售01,1.31,1.33,1.29,1.31,-0.08,-5.76,249000,13,326510,0,0,0,0,0,0,201000,48000,153000,153000
20200528,07501P,華新科元大9A售07,,,,,0.00,0.00,0,0,0,0,0,0,0,0,0,0,0,0,0
20200528,07502P,美食元大9A售01,0.91,0.94,0.91,0.94,+0.03,3.3,120000,2,109800,0,0,0,0,0,0,20000,100000,-80000,-80000
20200528,07503P,禾伸堂元大9A售01,0.83,0.87,0.81,0.87,+0.01,1.16,345000,5,280470,0,0,0,0,0,0,341000,4000,337000,337000
20200528,07504P,聯詠元大9A售02,,,,,0.00,0.00,0,0,0,0,0,0,0,0,0,0,0,0,0
20200528,07505P,台勝科元大9A售01,1.14,1.21,1.14,1.21,+0.06,5.22,75000,9,89140,0,0,0,0,0,0,21000,17000,4000,4000
20200528,07506P,中租元大9A售01,0.92,0.96,0.92,0.96,0.00,0.00,317000,6,294150,0,0,0,0,0,0,60000,147000,-87000,-87000
20200528,07507P,國巨國票9B售02,,,,,0.00,0.00,0,0,0,0,0,0,0,0,0,0,0,0,0
20200528,07508P,華新科國票9A售03,3.20,3.20,3.20,3.20,+0.02,0.63,9000,1,28800,0,0,0,0,0,0,0,9000,-9000,-9000
20200528,07509P,牧德國票9A售03,0.72,0.75,0.72,0.75,+0.03,4.17,107000,4,77590,0,0,0,0,0,0,0,107000,-107000,-107000
20200528,07510P,台灣50元富04售02,,,,,0.00,0.00,0,0,0,0,0,0,0,0,0,0,0,0,0
20200528,07511P,鴻海元大9B售02,,,,,0.00,0.00,0,0,0,0,0,0,0,0,0,0,0,0,0
20200528,07512P,國巨元大9A售08,,,,,0.00,0.00,0,0,0,0,0,0,0,0,0,0,0,0,0
20200528,07513P,台積電元大9A售13,1.35,1.35,1.35,1.35,0.00,0.00,89000,1,120150,0,0,0,0,0,0,0,89000,-89000,-89000
20200528,07514P,台積電元大9A售14,,,,,0.00,0.00,0,0,0,0,0,0,0,0,0,0,0,0,0
20200528,07515P,台積電元大9A售15,,,,,0.00,0.00,0,0,0,0,0,0,0,0,0,0,0,0,0
20200528,07516P,台積電元大9A售16,,,,,0.00,0.00,0,0,0,0,0,0,0,0,0,0,0,0,0
20200528,07517P,台積電元大9A售17,0.62,0.63,0.62,0.63,+0.02,3.28,2000,2,1250,0,0,0,0,0,0,0,2000,-2000,-2000
20200528,07518P,臺股指元大9B售09,,,,,0.00,0.00,0,0,0,0,0,0,0,0,0,0,0,0,0
20200528,07519P,臺股指元大9B售10,,,,,0.00,0.00,0,0,0,0,0,0,0,0,0,0,0,0,0
20200528,07520P,臺股指元大9B售11,0.91,0.91,0.91,0.91,-0.01,-1.09,2000,1,1820,0,0,0,0,0,0,0,2000,-2000,-2000
20200528,07521P,台積電中信01售05,0.66,0.66,0.66,0.66,0.00,0.00,10000,1,6600,0,0,0,0,0,0,10000,0,10000,10000
20200528,07522P,台積電中信9A售03,0.76,0.76,0.76,0.76,0.00,0.00,1000,1,760,0,0,0,0,0,0,0,1000,-1000,-1000
20200528,07523P,台積電中信9C售05,,,,,0.00,0.00,0,0,0,0,0,0,0,0,0,0,0,0,0
20200528,07524P,臺股指中信9B售06,0.64,0.64,0.64,0.64,0.00,0.00,10000,1,6400,0,0,0,0,0,0,0,10000,-10000,-10000
20200528,07525P,臺股指中信9B售07,,,,,0.00,0.00,0,0,0,0,0,0,0,0,0,0,0,0,0
20200528,07526P,臺股指中信9B售08,,,,,0.00,0.00,0,0,0,0,0,0,0,0,0,0,0,0,0
20200528,07527P,台灣50凱基9B售02,1.07,1.15,1.06,1.14,+0.03,2.7,529000,19,591960,0,0,0,0,0,0,366000,158000,208000,208000
20200528,07528P,鴻海凱基9A售19,,,,,0.00,0.00,0,0,0,0,0,0,0,0,0,0,0,0,0
20200528,07529P,國巨凱基9A售11,,,,,0.00,0.00,0,0,0,0,0,0,0,0,0,0,0,0,0
20200528,07530P,聯發科凱基9A售11,,,,,0.00,0.00,0,0,0,0,0,0,0,0,0,0,0,0,0
20200528,07531P,大立光國泰9B售03,1.76,1.79,1.76,1.79,-0.03,-1.65,84000,3,148640,0,0,0,0,0,0,64000,20000,44000,44000
20200528,07532P,台灣50中信01售02,,,,,0.00,0.00,0,0,0,0,0,0,0,0,0,0,0,0,0
20200528,07533P,臺股指中信9C售04,0.66,0.66,0.66,0.66,-0.02,-2.94,63000,1,41580,0,0,0,0,0,0,63000,0,63000,63000
20200528,07534P,台灣50群益9A售12,,,,,0.00,0.00,0,0,0,0,0,0,0,0,0,0,0,0,0
20200528,07535P,上銀元富9A售03,0.74,0.86,0.73,0.84,+0.04,5.0,683000,35,529510,0,0,0,0,0,0,328000,353000,-25000,-25000
20200528,07536P,華新科元富9A售04,1.32,1.36,1.32,1.36,+0.03,2.26,316000,5,420430,0,0,0,0,0,0,0,316000,-316000,-316000
20200528,07537P,玉晶光元富9A售04,1.54,1.54,1.53,1.53,-0.08,-4.97,18000,2,27620,0,0,0,0,0,0,10000,8000,2000,2000
20200528,07538P,玉晶光元富9A售05,,,,,0.00,0.00,0,0,0,0,0,0,0,0,0,0,0,0,0
20200528,07539P,玉山金台新9A售01,0.72,0.72,0.72,0.72,0.00,0.00,10000,1,7200,0,0,0,0,0,0,10000,0,10000,10000
20200528,07540P,鴻海凱基9A售21,,,,,0.00,0.00,0,0,0,0,0,0,0,0,0,0,0,0,0
20200528,07541P,國巨凱基9A售12,0.66,0.66,0.66,0.66,-0.04,-5.71,200000,1,132000,0,200000,-200000,0,0,0,200000,0,200000,0
20200528,07542P,台積電凱基9A售16,,,,,0.00,0.00,0,0,0,0,0,0,0,0,0,0,0,0,0
20200528,07543P,台積電凱基9A售17,1.04,1.04,1.04,1.04,+0.02,1.96,17000,4,17680,0,0,0,0,0,0,0,17000,-17000,-17000
20200528,07544P,大立光凱基9A售09,,,,,0.00,0.00,0,0,0,0,0,0,0,0,0,0,0,0,0
20200528,07545P,玉晶光凱基9A售07,0.77,0.79,0.77,0.79,-0.02,-2.47,69000,6,53880,0,0,0,0,0,0,60000,9000,51000,51000
20200528,07546P,玉晶光凱基9A售09,0.54,0.54,0.52,0.53,-0.01,-1.85,1832000,9,978850,0,0,0,0,0,0,923000,909000,14000,14000
20200528,07547P,緯穎凱基9A售05,,,,,0.00,0.00,0,0,0,0,0,0,0,0,0,0,0,0,0
20200528,07548P,台灣50元大9A售12,,,,,0.00,0.00,0,0,0,0,0,0,0,0,0,0,0,0,0
20200528,07549P,台灣50元大9A售13,,,,,0.00,0.00,0,0,0,0,0,0,0,0,0,0,0,0,0
20200528,07550P,國巨元大9A售09,,,,,0.00,0.00,0,0,0,0,0,0,0,0,0,0,0,0,0
20200528,07551P,國巨元大9A售10,,,,,0.00,0.00,0,0,0,0,0,0,0,0,0,0,0,0,0
20200528,07552P,技嘉元大9A售03,0.83,0.91,0.83,0.91,+0.05,5.81,349000,13,303580,0,0,0,0,0,0,175000,174000,1000,1000
20200528,07553P,嘉晶元大9A售02,0.73,0.78,0.72,0.77,+0.04,5.48,273000,12,207410,0,0,0,0,0,0,71000,202000,-131000,-131000
20200528,07554P,玉晶光元大9A售06,1.23,1.23,1.23,1.23,0.00,0.00,10000,1,12300,0,0,0,0,0,0,0,10000,-10000,-10000
20200528,07555P,玉晶光元大9A售07,1.20,1.22,1.20,1.22,0.00,0.00,46000,2,55760,0,0,0,0,0,0,0,46000,-46000,-46000
20200528,07556P,玉晶光元大9A售08,,,,,0.00,0.00,0,0,0,0,0,0,0,0,0,0,0,0,0
20200528,07557P,玉晶光元大9A售09,0.99,0.99,0.99,0.99,0.00,0.00,20000,1,19800,0,0,0,0,0,0,20000,0,20000,20000
20200528,07558P,玉晶光元大9A售10,1.38,1.42,1.32,1.39,-0.07,-4.79,328000,14,449170,0,0,0,0,0,0,190000,136000,54000,54000
20200528,07559P,祥碩元大9A售03,0.64,0.65,0.61,0.63,-0.05,-7.35,40000,4,25300,0,0,0,0,0,0,20000,20000,0,0
20200528,07560P,台積電國泰9B售01,2.16,2.25,2.16,2.25,+0.05,2.27,118000,4,260140,0,0,0,0,0,0,0,118000,-118000,-118000
20200528,07561P,玉晶光永豐9A售02,,,,,0.00,0.00,0,0,0,0,0,0,0,0,0,0,0,0,0
20200528,07562P,台灣50第一9A售01,,,,,0.00,0.00,0,0,0,0,0,0,0,0,0,0,0,0,0
20200528,07563P,台灣50中信04售01,,,,,0.00,0.00,0,0,0,0,0,0,0,0,0,0,0,0,0
20200528,07564P,臺股指中信01售01,1.33,1.33,1.33,1.33,-0.01,-0.75,20000,1,26600,0,0,0,0,0,0,0,20000,-20000,-20000
20200528,07565P,台灣50台新9C售02,,,,,0.00,0.00,0,0,0,0,0,0,0,0,0,0,0,0,0
20200528,07566P,台積電台新9B售02,,,,,0.00,0.00,0,0,0,0,0,0,0,0,0,0,0,0,0
20200528,07567P,台灣50凱基01售05,,,,,0.00,0.00,0,0,0,0,0,0,0,0,0,0,0,0,0
20200528,07568P,鴻海凱基9A售22,0.81,0.81,0.81,0.81,0.00,0.00,5000,1,4050,0,0,0,0,0,0,5000,0,5000,5000
20200528,07569P,國巨凱基9A售13,,,,,0.00,0.00,0,0,0,0,0,0,0,0,0,0,0,0,0
20200528,07570P,旺宏凱基9A售04,0.92,0.92,0.92,0.92,0.00,0.00,10000,1,9200,0,0,0,0,0,0,0,10000,-10000,-10000
20200528,07571P,台灣50元大9A售14,,,,,0.00,0.00,0,0,0,0,0,0,0,0,0,0,0,0,0
20200528,07572P,台灣50元大9A售15,,,,,0.00,0.00,0,0,0,0,0,0,0,0,0,0,0,0,0
20200528,07573P,國巨元大9A售11,1.08,1.08,1.08,1.08,0.00,0.00,4000,1,4320,0,0,0,0,0,0,4000,0,4000,4000
20200528,07574P,國巨元大9A售12,1.40,1.42,1.40,1.42,0.00,0.00,202000,2,282840,0,0,0,0,0,0,0,202000,-202000,-202000
20200528,07575P,瑞昱元大9A售02,1.15,1.17,1.15,1.17,-0.01,-0.85,55000,7,64150,0,0,0,0,0,0,20000,35000,-15000,-15000
20200528,07576P,可成元大9A售01,1.48,1.54,1.48,1.54,-0.01,-0.65,395000,8,598100,0,0,0,0,0,0,0,390000,-390000,-390000
20200528,07577P,華新科元大9A售09,1.13,1.13,1.13,1.13,0.00,0.00,200000,1,226000,0,0,0,0,0,0,0,200000,-200000,-200000
20200528,07578P,高鐵元大9A售02,0.67,0.77,0.67,0.77,+0.08,11.59,319000,10,226050,0,0,0,0,0,0,20000,299000,-279000,-279000
20200528,07579P,聯茂元大9A售01,1.71,1.72,1.65,1.68,-0.06,-3.45,246000,13,417200,0,0,0,0,0,0,166000,180000,-14000,-14000
20200528,07580P,緯穎元大9A售03,0.97,1.03,0.97,1.03,+0.02,1.98,236000,4,237100,0,0,0,0,0,0,136000,100000,36000,36000
20200528,07581P,臺股指元大9A售44,,,,,0.00,0.00,0,0,0,0,0,0,0,0,0,0,0,0,0
20200528,07582P,臺股指元大9A售45,,,,,0.00,0.00,0,0,0,0,0,0,0,0,0,0,0,0,0
20200528,07583P,台積電富邦9B售05,,,,,0.00,0.00,0,0,0,0,0,0,0,0,0,0,0,0,0
20200528,07584P,台積電永豐9A售02,,,,,0.00,0.00,0,0,0,0,0,0,0,0,0,0,0,0,0
20200528,07585P,台灣50中信03售06,,,,,0.00,0.00,0,0,0,0,0,0,0,0,0,0,0,0,0
20200528,07586P,FBVIX台新9A售01,,,,,0.00,0.00,0,0,0,0,0,0,0,0,0,0,0,0,0
20200528,07587P,台灣50國票9A售11,1.51,1.51,1.51,1.51,-0.03,-1.95,10000,1,15100,0,0,0,0,0,0,10000,0,10000,10000
20200528,07588P,滬深2X國票9C售01,0.27,0.28,0.26,0.28,0.00,0.00,343000,11,91640,0,0,0,0,0,0,40000,303000,-263000,-263000
20200528,07589P,玉晶光國票9A售02,,,,,0.00,0.00,0,0,0,0,0,0,0,0,0,0,0,0,0
20200528,07590P,玉晶光國票9A售03,,,,,0.00,0.00,0,0,0,0,0,0,0,0,0,0,0,0,0
20200528,07591P,台灣50元大9A售16,1.53,1.57,1.51,1.55,+0.01,0.65,570000,10,881180,0,0,0,0,0,0,299000,271000,28000,28000
20200528,07592P,台灣50元大9A售17,1.49,1.53,1.48,1.51,+0.01,0.67,550000,8,827380,0,0,0,0,0,0,299000,251000,48000,48000
20200528,07593P,臺股指凱基9A售08,1.55,1.57,1.54,1.57,-0.02,-1.26,40000,3,62300,0,0,0,0,0,0,20000,20000,0,0
20200528,07594P,大立光永豐9A售01,,,,,0.00,0.00,0,0,0,0,0,0,0,0,0,0,0,0,0
20200528,07595P,台灣50中信03售07,,,,,0.00,0.00,0,0,0,0,0,0,0,0,0,0,0,0,0
20200528,07596P,上証2X中信01售01,,,,,0.00,0.00,0,0,0,0,0,0,0,0,0,0,0,0,0
20200528,07597P,臺股指中信01售02,0.60,0.68,0.60,0.68,+0.02,3.03,1344000,62,891040,0,0,0,0,0,0,903000,336000,567000,567000
20200528,07598P,臺股指中信01售03,,,,,0.00,0.00,0,0,0,0,0,0,0,0,0,0,0,0,0
20200528,07599P,台灣50凱基04售05,,,,,0.00,0.00,0,0,0,0,0,0,0,0,0,0,0,0,0
20200528,07600P,台灣50凱基04售06,,,,,0.00,0.00,0,0,0,0,0,0,0,0,0,0,0,0,0
20200528,07601P,國巨統一9A售05,0.54,0.54,0.54,0.54,-0.02,-3.57,1000,1,540,0,0,0,0,0,0,1000,0,1000,1000
20200528,07602P,台積電統一9A售07,,,,,0.00,0.00,0,0,0,0,0,0,0,0,0,0,0,0,0
20200528,07603P,台積電統一9B售08,,,,,0.00,0.00,0,0,0,0,0,0,0,0,0,0,0,0,0
20200528,07604P,台灣50元大9B售09,,,,,0.00,0.00,0,0,0,0,0,0,0,0,0,0,0,0,0
20200528,07605P,台灣50元大9B售10,,,,,0.00,0.00,0,0,0,0,0,0,0,0,0,0,0,0,0
20200528,07606P,台灣50國票01售02,,,,,0.00,0.00,0,0,0,0,0,0,0,0,0,0,0,0,0
20200528,07607P,台灣50國票01售03,,,,,0.00,0.00,0,0,0,0,0,0,0,0,0,0,0,0,0
20200528,07608P,台灣50國票9C售03,1.98,2.03,1.97,2.03,+0.06,3.05,182000,3,359850,0,0,0,0,0,0,0,182000,-182000,-182000
20200528,07609P,台灣50國票9C售04,2.32,2.44,2.32,2.44,+0.12,5.17,11000,2,26720,0,0,0,0,0,0,0,11000,-11000,-11000
20200528,07610P,大立光國票9A售04,2.06,2.06,2.06,2.06,+0.04,1.98,10000,1,20600,0,0,0,0,0,0,0,10000,-10000,-10000
20200528,07611P,大立光國票9A售05,,,,,0.00,0.00,0,0,0,0,0,0,0,0,0,0,0,0,0
20200528,07612P,國巨國泰9B售06,0.71,0.73,0.70,0.73,+0.01,1.39,230000,8,166000,0,0,0,0,0,0,160000,65000,95000,95000
20200528,07613P,國巨永豐9A售01,,,,,0.00,0.00,0,0,0,0,0,0,0,0,0,0,0,0,0
20200528,07614P,華新科群益9A售04,1.10,1.10,1.10,1.10,0.00,0.00,100000,1,110000,0,0,0,0,0,0,0,100000,-100000,-100000
20200528,07615P,華通中信02售02,0.58,0.58,0.58,0.58,-0.03,-4.92,30000,1,17400,0,0,0,0,0,0,0,30000,-30000,-30000
20200528,07616P,瑞昱中信02售01,0.57,0.57,0.57,0.57,0.00,0.00,300000,8,171000,0,0,0,0,0,0,300000,0,300000,300000
20200528,07617P,聯發科中信9C售04,0.29,0.29,0.29,0.29,-0.01,-3.33,1000,1,290,0,0,0,0,0,0,0,1000,-1000,-1000
20200528,07618P,大立光中信9A售06,0.44,0.46,0.44,0.46,+0.02,4.55,262000,4,117320,0,0,0,0,0,0,230000,32000,198000,198000
20200528,07619P,鴻海統一9A售03,0.68,0.69,0.68,0.69,0.00,0.00,60000,2,41300,0,0,0,0,0,0,50000,10000,40000,40000
20200528,07620P,國巨統一9B售07,,,,,0.00,0.00,0,0,0,0,0,0,0,0,0,0,0,0,0
20200528,07621P,台積電統一9B售09,,,,,0.00,0.00,0,0,0,0,0,0,0,0,0,0,0,0,0
20200528,07622P,華新科統一9B售02,,,,,0.00,0.00,0,0,0,0,0,0,0,0,0,0,0,0,0
20200528,07623P,大立光統一9B售05,,,,,0.00,0.00,0,0,0,0,0,0,0,0,0,0,0,0,0
20200528,07624P,台灣50台新9B售07,,,,,0.00,0.00,0,0,0,0,0,0,0,0,0,0,0,0,0
20200528,07625P,台灣50凱基01售06,,,,,0.00,0.00,0,0,0,0,0,0,0,0,0,0,0,0,0
20200528,07626P,台灣50凱基04售07,1.93,1.98,1.93,1.97,+0.04,2.07,111000,5,217670,0,0,0,0,0,0,80000,31000,49000,49000
20200528,07627P,超眾凱基9A售02,0.75,0.76,0.73,0.76,-0.01,-1.3,59000,3,44100,0,0,0,0,0,0,45000,14000,31000,31000
20200528,07628P,臺股指凱基9A售09,1.15,1.25,1.15,1.25,0.00,0.00,30000,2,36500,0,0,0,0,0,0,0,30000,-30000,-30000
20200528,07629P,臺股指凱基9A售10,1.92,1.92,1.92,1.92,-0.04,-2.04,50000,1,96000,0,0,0,0,0,0,50000,0,50000,50000
20200528,07630P,臺股指凱基9A售11,1.57,1.68,1.55,1.66,+0.05,3.11,1360000,14,2208550,0,0,0,0,0,0,460000,900000,-440000,-440000
20200528,07631P,臺股指凱基9A售12,,,,,0.00,0.00,0,0,0,0,0,0,0,0,0,0,0,0,0
20200528,07632P,臺股指凱基9A售14,,,,,0.00,0.00,0,0,0,0,0,0,0,0,0,0,0,0,0
20200528,07633P,台灣50元大9A售18,,,,,0.00,0.00,0,0,0,0,0,0,0,0,0,0,0,0,0
20200528,07634P,金像電元大9A售01,0.95,1.03,0.94,0.99,-0.02,-1.98,1285000,62,1259360,0,0,0,0,0,0,1053000,243000,810000,810000
20200528,07635P,世芯永豐9A售05,0.52,0.53,0.50,0.50,-0.01,-1.96,108000,7,55850,0,0,0,0,0,0,7000,101000,-94000,-94000
20200528,07636P,鴻海國票9A售05,2.14,2.14,2.14,2.14,-0.06,-2.73,10000,1,21400,0,0,0,0,0,0,0,10000,-10000,-10000
20200528,07637P,國巨國票9A售08,,,,,0.00,0.00,0,0,0,0,0,0,0,0,0,0,0,0,0
20200528,07638P,長榮航國票9A售01,0.52,0.57,0.52,0.57,+0.02,3.64,81000,6,43530,0,0,0,0,0,0,41000,40000,1000,1000
20200528,07639P,緯穎國票9A售01,0.80,0.87,0.80,0.87,+0.01,1.16,529000,5,432860,0,0,0,0,0,0,271000,258000,13000,13000
20200528,07640P,國巨群益9A售07,1.34,1.34,1.34,1.34,+0.01,0.75,200000,1,268000,0,0,0,0,0,0,0,200000,-200000,-200000
20200528,07641P,上銀凱基9A售05,0.43,0.46,0.43,0.46,+0.01,2.22,23000,2,10190,0,0,0,0,0,0,10000,13000,-3000,-3000
20200528,07642P,華通凱基9A售05,0.70,0.73,0.70,0.73,0.00,0.00,114000,3,80220,0,0,0,0,0,0,100000,14000,86000,86000
20200528,07643P,禾伸堂凱基9A售02,0.61,0.61,0.61,0.61,0.00,0.00,30000,1,18300,0,0,0,0,0,0,0,30000,-30000,-30000
20200528,07644P,南電凱基9A售03,0.97,0.97,0.97,0.97,+0.01,1.04,2000,1,1940,0,0,0,0,0,0,2000,0,2000,2000
20200528,07645P,華通元大9A售06,0.98,0.98,0.96,0.96,-0.07,-6.8,30000,2,29200,0,0,0,0,0,0,0,30000,-30000,-30000
20200528,07646P,世芯元大9A售04,1.08,1.12,1.07,1.07,-0.04,-3.6,855000,34,931940,0,0,0,0,0,0,434000,345000,89000,89000
20200528,07647P,健策國票9A售04,1.34,1.51,1.34,1.51,+0.04,2.72,361000,14,512270,0,0,0,0,0,0,138000,223000,-85000,-85000
20200528,07648P,祥碩國票9B售01,0.87,0.91,0.78,0.84,-0.08,-8.7,2132000,27,1771800,0,0,0,0,0,0,500000,1607000,-1107000,-1107000
20200528,07649P,金像電永豐9A售02,0.43,0.46,0.43,0.45,0.00,0.00,1172000,20,528290,0,0,0,0,0,0,723000,449000,274000,274000
20200528,07650P,台灣50中信9A售01,,,,,0.00,0.00,0,0,0,0,0,0,0,0,0,0,0,0,0
20200528,07651P,道瓊指中信01售01,0.88,0.88,0.87,0.87,-0.02,-2.25,20000,2,17500,0,0,0,0,0,0,0,20000,-20000,-20000
20200528,07652P,臺股指中信9A售07,0.69,0.75,0.69,0.75,+0.03,4.17,706000,21,505440,0,0,0,0,0,0,405000,271000,134000,134000
20200528,07653P,華新科群益9A售05,1.83,1.83,1.83,1.83,-0.04,-2.14,10000,1,18300,0,0,0,0,0,0,0,10000,-10000,-10000
20200528,07654P,台灣50凱基01售08,,,,,0.00,0.00,0,0,0,0,0,0,0,0,0,0,0,0,0
20200528,07655P,台灣50凱基01售09,2.04,2.15,2.04,2.13,+0.06,2.9,49000,13,101660,0,0,0,0,0,0,20000,29000,-9000,-9000
20200528,07656P,國巨凱基9A售15,,,,,0.00,0.00,0,0,0,0,0,0,0,0,0,0,0,0,0
20200528,07657P,技嘉凱基9A售03,0.48,0.51,0.48,0.51,+0.03,6.25,31000,6,15010,0,0,0,0,0,0,30000,1000,29000,29000
20200528,07658P,國泰金凱基9A售01,0.56,0.63,0.56,0.63,+0.03,5.0,1147000,18,684840,0,0,0,0,0,0,160000,987000,-827000,-827000
20200528,07659P,中租凱基9A售02,0.57,0.57,0.56,0.57,0.00,0.00,639000,6,361140,0,0,0,0,0,0,65000,574000,-509000,-509000
20200528,07660P,聯茂凱基9A售03,1.13,1.14,1.12,1.12,-0.02,-1.75,231000,7,260870,0,0,0,0,0,0,0,221000,-221000,-221000
20200528,07661P,台灣50兆豐9A售03,,,,,0.00,0.00,0,0,0,0,0,0,0,0,0,0,0,0,0
20200528,07662P,台積電兆豐9A售03,,,,,0.00,0.00,0,0,0,0,0,0,0,0,0,0,0,0,0
20200528,07663P,台灣50台新01售03,,,,,0.00,0.00,0,0,0,0,0,0,0,0,0,0,0,0,0
20200528,07664P,台灣50元大9C售30,,,,,0.00,0.00,0,0,0,0,0,0,0,0,0,0,0,0,0
20200528,07665P,台灣50元大9C售31,,,,,0.00,0.00,0,0,0,0,0,0,0,0,0,0,0,0,0
20200528,07666P,台灣50元大9C售32,,,,,0.00,0.00,0,0,0,0,0,0,0,0,0,0,0,0,0
20200528,07667P,亞德客元大9A售05,1.12,1.23,1.12,1.23,+0.04,3.36,220000,7,257000,0,0,0,0,0,0,10000,210000,-200000,-200000
20200528,07668P,旺宏元大9A售10,1.81,1.81,1.81,1.81,0.00,0.00,25000,1,45250,0,0,0,0,0,0,0,25000,-25000,-25000
20200528,07669P,華新科元大9A售14,1.25,1.29,1.25,1.29,+0.03,2.38,213000,5,266700,0,0,0,0,0,0,0,213000,-213000,-213000
20200528,07670P,茂林元大9A售02,1.30,1.37,1.30,1.37,0.00,0.00,160000,6,210580,0,0,0,0,0,0,127000,33000,94000,94000
20200528,07671P,超眾元大9A售04,1.91,1.91,1.91,1.91,-0.05,-2.55,50000,1,95500,0,0,0,0,0,0,50000,0,50000,50000
20200528,07672P,南電元大9A售05,1.85,1.89,1.84,1.89,+0.02,1.07,100000,5,184900,0,0,0,0,0,0,30000,70000,-40000,-40000
20200528,07673P,電子類元大9A售01,1.56,1.62,1.56,1.62,+0.03,1.89,8000,3,12720,0,0,0,0,0,0,1000,7000,-6000,-6000
20200528,07674P,金融類元大9A售01,1.28,1.28,1.28,1.28,+0.04,3.23,4000,1,5120,0,0,0,0,0,0,0,4000,-4000,-4000
20200528,07675P,全新永豐9A售02,0.79,0.79,0.79,0.79,-0.01,-1.25,14000,1,11060,0,0,0,0,0,0,14000,0,14000,14000
20200528,07676P,華新科永豐9A售02,0.88,0.88,0.88,0.88,0.00,0.00,100000,1,88000,0,0,0,0,0,0,0,100000,-100000,-100000
20200528,07677P,祥碩永豐9A售01,0.39,0.39,0.34,0.36,-0.03,-7.69,461000,18,164280,0,0,0,0,0,0,82000,379000,-297000,-297000
20200528,07678P,大立光群益9A售03,,,,,0.00,0.00,0,0,0,0,0,0,0,0,0,0,0,0,0
20200528,07679P,台灣50凱基01售10,,,,,0.00,0.00,0,0,0,0,0,0,0,0,0,0,0,0,0
20200528,07680P,鴻海凱基9A售24,,,,,0.00,0.00,0,0,0,0,0,0,0,0,0,0,0,0,0
20200528,07681P,台積電凱基9A售20,,,,,0.00,0.00,0,0,0,0,0,0,0,0,0,0,0,0,0
20200528,07682P,聯發科凱基9A售15,0.70,0.70,0.70,0.70,+0.03,4.48,10000,1,7000,0,0,0,0,0,0,0,10000,-10000,-10000
20200528,07683P,宏達電凱基9A售03,0.97,1.05,0.97,1.05,+0.07,7.14,70000,3,69700,0,0,0,0,0,0,50000,20000,30000,30000
20200528,07684P,大立光凱基9A售11,,,,,0.00,0.00,0,0,0,0,0,0,0,0,0,0,0,0,0
20200528,07685P,玉晶光凱基9B售03,0.66,0.67,0.64,0.67,-0.01,-1.47,181000,9,117570,0,0,0,0,0,0,120000,61000,59000,59000
20200528,07686P,祥碩凱基9A售02,0.53,0.53,0.50,0.52,-0.03,-5.45,25000,4,13160,0,0,0,0,0,0,1000,24000,-23000,-23000
20200528,07687P,上銀元大9A售06,0.97,1.08,0.97,1.08,+0.11,11.34,150000,14,155010,0,0,0,0,0,0,4000,146000,-142000,-142000
20200528,07688P,華通元大9A售07,,,,,0.00,0.00,0,0,0,0,0,0,0,0,0,0,0,0,0
20200528,07689P,旺宏元大9A售13,1.91,1.91,1.91,1.91,+0.07,3.8,24000,1,45840,0,0,0,0,0,0,0,24000,-24000,-24000
20200528,07690P,華新科元大9A售15,2.06,2.13,2.06,2.13,+0.06,2.9,106000,3,222280,0,0,0,0,0,0,0,106000,-106000,-106000
20200528,07691P,宏達電元大9A售05,1.06,1.14,1.06,1.14,+0.07,6.54,25000,3,27300,0,0,0,0,0,0,15000,15000,0,0
20200528,07692P,玉晶光元大9A售11,,,,,0.00,0.00,0,0,0,0,0,0,0,0,0,0,0,0,0
20200528,07693P,群創元大9B售10,0.97,1.01,0.97,1.01,+0.02,2.02,236000,5,231960,0,0,0,0,0,0,236000,80000,156000,156000
20200528,07694P,超眾元大9A售05,1.36,1.40,1.36,1.39,0.00,0.00,240000,5,331480,0,0,0,0,0,0,86000,154000,-68000,-68000
20200528,07695P,台郡元大9A售02,1.15,1.16,1.15,1.16,0.00,0.00,210000,3,242600,0,0,0,0,0,0,10000,200000,-190000,-190000
20200528,07696P,臺股指元大9A售49,,,,,0.00,0.00,0,0,0,0,0,0,0,0,0,0,0,0,0
20200528,07697P,臺股指元大9A售50,,,,,0.00,0.00,0,0,0,0,0,0,0,0,0,0,0,0,0
20200528,07698P,臺股指元大9A售51,,,,,0.00,0.00,0,0,0,0,0,0,0,0,0,0,0,0,0
20200528,07699P,臺股指元大9A售52,,,,,0.00,0.00,0,0,0,0,0,0,0,0,0,0,0,0,0
20200528,07700P,臺股指元大9A售53,1.18,1.18,1.18,1.18,-0.01,-0.84,1000,1,1180,0,0,0,0,0,0,1000,0,1000,1000
20200528,07701P,玉晶光第一9A售02,,,,,0.00,0.00,0,0,0,0,0,0,0,0,0,0,0,0,0
20200528,07702P,台積電中信9A售06,1.04,1.04,1.04,1.04,0.00,0.00,2000,1,2080,0,0,0,0,0,0,2000,0,2000,2000
20200528,07703P,玉晶光中信9B售03,0.54,0.54,0.54,0.54,0.00,0.00,100000,2,54000,0,0,0,0,0,0,0,100000,-100000,-100000
20200528,07704P,台積電元大9A售25,3.02,3.05,3.02,3.05,-0.04,-1.29,49000,2,148280,0,0,0,0,0,0,39000,10000,29000,29000
20200528,07705P,台積電元大9A售26,,,,,0.00,0.00,0,0,0,0,0,0,0,0,0,0,0,0,0
20200528,07706P,長榮航元大9A售03,,,,,0.00,0.00,0,0,0,0,0,0,0,0,0,0,0,0,0
20200528,07707P,玉山金元大9A售03,1.97,2.00,1.97,2.00,0.00,0.00,173000,7,342530,0,0,0,0,0,0,0,173000,-173000,-173000
20200528,07708P,玉晶光元大9A售13,2.43,2.45,2.38,2.45,-0.06,-2.39,14000,3,34030,0,0,0,0,0,0,0,14000,-14000,-14000
20200528,07709P,創意元大9A售01,2.03,2.03,2.03,2.03,-0.01,-0.49,22000,1,44660,0,0,0,0,0,0,0,22000,-22000,-22000
20200528,07710P,華擎元大9A售05,1.02,1.06,1.02,1.06,-0.03,-2.75,109000,3,113580,0,0,0,0,0,0,109000,0,109000,109000
20200528,07711P,世芯元大9A售07,0.60,0.64,0.60,0.63,0.00,0.00,76000,9,47140,0,0,0,0,0,0,55000,21000,34000,34000
20200528,07712P,茂林元大9A售03,0.96,0.97,0.96,0.97,0.00,0.00,55000,7,52900,0,0,0,0,0,0,50000,0,50000,50000
20200528,07713P,台郡元大9A售03,1.84,1.84,1.84,1.84,0.00,0.00,50000,1,92000,0,0,0,0,0,0,0,50000,-50000,-50000
20200528,07714P,世紀鋼元大9A售03,0.99,1.00,0.97,0.97,0.00,0.00,45000,3,44400,0,0,0,0,0,0,0,45000,-45000,-45000
20200528,07715P,台灣50群益9A售14,2.03,2.16,2.02,2.14,+0.06,2.88,557000,13,1161830,0,0,0,0,0,0,261000,296000,-35000,-35000
20200528,07716P,臺股指群益9A售05,,,,,0.00,0.00,0,0,0,0,0,0,0,0,0,0,0,0,0
20200528,07717P,臺股指群益9A售06,2.28,2.41,2.28,2.39,0.00,0.00,38000,4,90730,0,0,0,0,0,0,35000,3000,32000,32000
20200528,07718P,臺股指群益9A售07,,,,,0.00,0.00,0,0,0,0,0,0,0,0,0,0,0,0,0
20200528,07719P,臺股指群益9A售08,1.93,2.11,1.93,2.10,+0.08,3.96,84000,13,173360,0,0,0,0,0,0,13000,71000,-58000,-58000
20200528,07720P,臺股指群益9A售09,2.64,2.70,2.64,2.67,+0.05,1.91,21000,5,56340,0,0,0,0,0,0,1000,20000,-19000,-19000
20200528,07721P,台積電凱基9A售22,,,,,0.00,0.00,0,0,0,0,0,0,0,0,0,0,0,0,0
20200528,07722P,玉晶光凱基9A售10,0.78,0.78,0.78,0.78,-0.02,-2.5,20000,1,15600,0,0,0,0,0,0,0,20000,-20000,-20000
20200528,07723P,臺股指凱基9A售15,,,,,0.00,0.00,0,0,0,0,0,0,0,0,0,0,0,0,0
20200528,07724P,臺股指凱基9A售16,2.01,2.01,2.01,2.01,0.00,0.00,4000,1,8040,0,0,0,0,0,0,0,4000,-4000,-4000
20200528,07725P,臺股指凱基9A售17,,,,,0.00,0.00,0,0,0,0,0,0,0,0,0,0,0,0,0
20200528,07726P,臺股指凱基9A售18,,,,,0.00,0.00,0,0,0,0,0,0,0,0,0,0,0,0,0
20200528,07727P,臺股指凱基9A售19,,,,,0.00,0.00,0,0,0,0,0,0,0,0,0,0,0,0,0
20200528,07728P,臺股指凱基9A售20,2.11,2.24,2.07,2.21,+0.06,2.79,81000,15,174150,0,0,0,0,0,0,30000,51000,-21000,-21000
20200528,07729P,臺股指凱基9A售21,1.91,2.01,1.89,2.00,+0.04,2.04,131000,6,254710,0,0,0,0,0,0,41000,90000,-49000,-49000
20200528,07730P,臺股指凱基9A售22,2.00,2.13,2.00,2.13,+0.05,2.4,139000,9,282630,0,0,0,0,0,0,110000,29000,81000,81000
20200528,07731P,臺股指凱基9A售28,2.23,2.41,2.23,2.40,+0.08,3.45,370000,25,844750,0,0,0,0,0,0,268000,102000,166000,166000
20200528,07732P,台灣50台新9A售05,0.79,0.79,0.79,0.79,0.00,0.00,40000,2,31600,0,0,0,0,0,0,40000,0,40000,40000
20200528,07733P,台積電統一9B售10,,,,,0.00,0.00,0,0,0,0,0,0,0,0,0,0,0,0,0
20200528,07734P,台積電富邦9C售10,0.65,0.65,0.65,0.65,+0.01,1.56,100000,1,65000,0,0,0,0,0,0,100000,0,100000,100000
20200528,07735P,臺股指富邦9A售03,,,,,0.00,0.00,0,0,0,0,0,0,0,0,0,0,0,0,0
20200528,07736P,台灣50永豐9A售03,,,,,0.00,0.00,0,0,0,0,0,0,0,0,0,0,0,0,0
20200528,07737P,華通永豐9A售01,0.63,0.63,0.63,0.63,0.00,0.00,1000,1,630,0,0,0,0,0,0,0,1000,-1000,-1000
20200528,07738P,玉晶光永豐9A售06,,,,,0.00,0.00,0,0,0,0,0,0,0,0,0,0,0,0,0
20200528,07739P,緯穎永豐9A售01,0.39,0.42,0.39,0.42,+0.01,2.44,110000,2,43200,0,0,0,0,0,0,0,110000,-110000,-110000
20200528,07740P,臺股指永豐9A售01,0.52,0.52,0.52,0.52,-0.03,-5.45,2000,1,1040,0,0,0,0,0,0,2000,0,2000,2000
20200528,07741P,滬深2X凱基9B售04,1.34,1.34,1.34,1.34,0.00,0.00,151000,3,202340,0,0,0,0,0,0,141000,10000,131000,131000
20200528,07742P,台積電凱基9A售25,,,,,0.00,0.00,0,0,0,0,0,0,0,0,0,0,0,0,0
20200528,07743P,智邦凱基9A售03,0.37,0.40,0.34,0.39,-0.02,-4.88,1384000,32,500850,0,0,0,0,0,0,147000,1162000,-1015000,-1015000
20200528,07744P,奇力新凱基9A售05,0.95,0.96,0.94,0.96,0.00,0.00,142000,7,135900,0,0,0,0,0,0,0,142000,-142000,-142000
20200528,07745P,華新科凱基9A售10,,,,,0.00,0.00,0,0,0,0,0,0,0,0,0,0,0,0,0
20200528,07746P,華新科凱基9A售11,1.22,1.22,1.22,1.22,-0.02,-1.61,80000,1,97600,0,0,0,0,0,0,0,80000,-80000,-80000
20200528,07747P,晶技凱基9A售04,1.24,1.24,1.23,1.23,0.00,0.00,104000,6,128250,0,0,0,0,0,0,83000,20000,63000,63000
20200528,07748P,茂林凱基9A售04,0.70,0.71,0.70,0.71,0.00,0.00,10000,2,7050,0,0,0,0,0,0,0,5000,-5000,-5000
20200528,07749P,台郡凱基9A售01,0.89,0.89,0.89,0.89,0.00,0.00,200000,1,178000,0,0,0,0,0,0,0,200000,-200000,-200000
20200528,07750P,台表科凱基9A售04,0.58,0.61,0.58,0.61,+0.02,3.39,95000,5,56750,0,0,0,0,0,0,75000,20000,55000,55000
20200528,07751P,世紀鋼凱基9A售02,0.78,0.78,0.71,0.72,-0.07,-8.86,590000,13,441900,100000,300000,-200000,0,0,0,310000,280000,30000,-170000
20200528,07752P,台灣50元大9C售33,1.73,1.73,1.73,1.73,+0.03,1.76,1000,1,1730,0,0,0,0,0,0,0,1000,-1000,-1000
20200528,07753P,台灣50元大9C售34,,,,,0.00,0.00,0,0,0,0,0,0,0,0,0,0,0,0,0
20200528,07754P,日月光元大9A售02,2.01,2.07,2.01,2.07,-0.02,-0.96,286000,11,578900,0,0,0,0,0,0,186000,100000,86000,86000
20200528,07755P,台灣50國票03售01,,,,,0.00,0.00,0,0,0,0,0,0,0,0,0,0,0,0,0
20200528,07756P,台灣50國票04售01,4.02,4.11,4.00,4.11,+0.03,0.74,38000,7,153930,0,0,0,0,0,0,23000,15000,8000,8000
20200528,07757P,國巨國票9B售04,,,,,0.00,0.00,0,0,0,0,0,0,0,0,0,0,0,0,0
20200528,07758P,台積電國票9A售06,,,,,0.00,0.00,0,0,0,0,0,0,0,0,0,0,0,0,0
20200528,07759P,臺股指富邦9A售04,,,,,0.00,0.00,0,0,0,0,0,0,0,0,0,0,0,0,0
20200528,07760P,力山永豐9A售03,0.64,0.64,0.64,0.64,+0.02,3.23,80000,3,51200,0,0,0,0,0,0,0,80000,-80000,-80000
20200528,07761P,智邦永豐9A售03,0.49,0.49,0.49,0.49,0.00,0.00,4000,1,1960,0,0,0,0,0,0,0,4000,-4000,-4000
20200528,07762P,聯發科永豐9A售03,0.33,0.34,0.33,0.34,0.00,0.00,44000,2,14740,0,0,0,0,0,0,0,44000,-44000,-44000
20200528,07763P,嘉澤永豐9A售02,0.41,0.44,0.41,0.44,+0.02,4.76,246000,11,104790,0,0,0,0,0,0,225000,16000,209000,209000
20200528,07764P,世紀鋼永豐9A售04,0.71,0.71,0.63,0.63,-0.07,-10.0,55000,3,38310,0,0,0,0,0,0,0,55000,-55000,-55000
20200528,07765P,台積電群益9A售06,1.65,1.66,1.65,1.66,+0.04,2.47,8000,2,13250,0,0,0,0,0,0,8000,0,8000,8000
20200528,07766P,美律群益9A售03,0.95,0.96,0.94,0.96,-0.06,-5.88,133000,5,126260,0,0,0,0,0,0,133000,33000,100000,100000
20200528,07767P,華新科群益9A售07,,,,,0.00,0.00,0,0,0,0,0,0,0,0,0,0,0,0,0
20200528,07768P,緯穎群益9A售02,1.16,1.24,1.16,1.24,+0.03,2.48,120000,7,142770,0,0,0,0,0,0,51000,69000,-18000,-18000
20200528,07769P,國巨國票9A售10,,,,,0.00,0.00,0,0,0,0,0,0,0,0,0,0,0,0,0
20200528,07770P,台積電國票9A售07,,,,,0.00,0.00,0,0,0,0,0,0,0,0,0,0,0,0,0
20200528,07771P,義隆國票9A售01,1.14,1.19,1.12,1.17,-0.05,-4.1,180000,6,208700,0,0,0,0,0,0,50000,110000,-60000,-60000
20200528,07772P,華新科國票9A售05,2.88,2.88,2.88,2.88,0.00,0.00,67000,3,192960,0,0,0,0,0,0,0,67000,-67000,-67000
20200528,07773P,台灣50群益9A售15,,,,,0.00,0.00,0,0,0,0,0,0,0,0,0,0,0,0,0
20200528,07774P,台灣50群益9A售16,0.96,1.03,0.94,1.02,+0.03,3.03,574000,33,565640,0,0,0,0,0,0,109000,465000,-356000,-356000
20200528,07775P,國巨群益9A售10,1.99,1.99,1.99,1.99,+0.01,0.51,200000,1,398000,0,0,0,0,0,0,0,200000,-200000,-200000
20200528,07776P,國巨群益9B售02,1.34,1.37,1.32,1.37,+0.02,1.48,222000,6,299710,0,0,0,0,0,0,11000,211000,-200000,-200000
20200528,07777P,創意元大9A售03,2.16,2.16,2.16,2.16,-0.01,-0.46,21000,1,45360,0,0,0,0,0,0,0,21000,-21000,-21000
20200528,07778P,台灣50凱基9C售08,1.88,1.88,1.88,1.88,0.00,0.00,10000,1,18800,0,0,0,0,0,0,0,10000,-10000,-10000
20200528,07779P,鴻海凱基9B售04,,,,,0.00,0.00,0,0,0,0,0,0,0,0,0,0,0,0,0
20200528,07780P,美律凱基9A售02,1.01,1.04,1.01,1.04,-0.01,-0.95,43000,2,44420,0,0,0,0,0,0,43000,33000,10000,10000
20200528,07781P,高鐵凱基9A售02,0.34,0.39,0.34,0.39,+0.03,8.33,40000,9,14660,0,0,0,0,0,0,30000,8000,22000,22000
20200528,07782P,寶成凱基9A售02,0.75,0.80,0.75,0.80,+0.03,3.9,366000,25,280490,0,0,0,0,0,0,205000,141000,64000,64000
20200528,07783P,聯發科富邦9C售03,0.46,0.46,0.46,0.46,0.00,0.00,72000,2,33120,0,0,0,0,0,0,0,72000,-72000,-72000
20200528,07784P,華新科富邦9B售04,,,,,0.00,0.00,0,0,0,0,0,0,0,0,0,0,0,0,0
20200528,07785P,鴻海中信04售03,,,,,0.00,0.00,0,0,0,0,0,0,0,0,0,0,0,0,0
20200528,07786P,南電中信9C售01,0.67,0.69,0.67,0.69,+0.01,1.47,174000,9,118780,0,0,0,0,0,0,110000,64000,46000,46000
20200528,07787P,國巨凱基9A售17,0.83,0.84,0.83,0.84,+0.02,2.44,2000,2,1670,0,0,0,0,0,0,0,2000,-2000,-2000
20200528,07788P,華新科群益9A售08,1.51,1.57,1.51,1.57,+0.06,3.97,192000,2,291060,0,0,0,0,0,0,0,192000,-192000,-192000
20200528,07789P,緯穎群益9A售03,1.09,1.16,1.09,1.16,+0.03,2.65,173000,6,193300,0,0,0,0,0,0,50000,123000,-73000,-73000
20200528,07790P,台灣50元大9A售19,,,,,0.00,0.00,0,0,0,0,0,0,0,0,0,0,0,0,0
20200528,07791P,奇鋐元大9A售02,1.32,1.32,1.23,1.27,-0.10,-7.3,357000,9,460890,0,0,0,0,0,0,107000,250000,-143000,-143000
20200528,07792P,牧德元大9A售04,,,,,0.00,0.00,0,0,0,0,0,0,0,0,0,0,0,0,0
20200528,07793P,同欣電元大9A售02,0.97,1.01,0.97,1.00,+0.01,1.01,260000,5,257700,0,0,0,0,0,0,110000,150000,-40000,-40000
20200528,07794P,智邦國票9A售03,1.17,1.32,1.12,1.30,-0.06,-4.41,305000,10,363800,0,0,0,0,0,0,85000,210000,-125000,-125000
20200528,07795P,美律國票9A售03,1.44,1.44,1.44,1.44,0.00,0.00,21000,1,30240,0,0,0,0,0,0,0,21000,-21000,-21000
20200528,07796P,聯發科國票9A售03,0.51,0.55,0.51,0.55,+0.01,1.85,26000,2,13780,0,0,0,0,0,0,13000,13000,0,0
20200528,07797P,大立光國票9A售08,,,,,0.00,0.00,0,0,0,0,0,0,0,0,0,0,0,0,0
20200528,07798P,同欣電國票9A售01,,,,,0.00,0.00,0,0,0,0,0,0,0,0,0,0,0,0,0
20200528,07799P,南電國票9A售04,3.63,3.75,3.58,3.75,+0.03,0.81,57000,4,207100,0,0,0,0,0,0,16000,41000,-25000,-25000
20200528,07800P,華新科國泰9B售04,2.23,2.23,2.22,2.22,-0.02,-0.89,151000,4,336630,0,0,0,0,0,0,10000,151000,-141000,-141000
20200528,07801P,上銀永豐9A售02,0.41,0.41,0.41,0.41,0.00,0.00,40000,2,16400,0,0,0,0,0,0,0,40000,-40000,-40000
20200528,07802P,瑞昱永豐9A售03,0.69,0.69,0.69,0.69,0.00,0.00,10000,1,6900,0,0,0,0,0,0,0,10000,-10000,-10000
20200528,07803P,南亞科永豐9A售02,0.76,0.78,0.75,0.78,-0.05,-6.02,168000,3,127840,0,0,0,0,0,0,110000,58000,52000,52000
20200528,07804P,美律永豐9A售02,0.86,0.86,0.86,0.86,0.00,0.00,394000,4,338840,0,0,0,0,0,0,20000,374000,-354000,-354000
20200528,07805P,義隆永豐9A售02,0.75,0.77,0.73,0.77,-0.03,-3.75,171000,12,129030,0,0,0,0,0,0,62000,94000,-32000,-32000
20200528,07806P,健策永豐9A售02,0.62,0.63,0.62,0.63,+0.03,5.0,21000,2,13120,0,0,0,0,0,0,21000,0,21000,21000
20200528,07807P,聯茂永豐9A售02,0.88,0.88,0.87,0.87,-0.03,-3.33,120000,2,105570,0,0,0,0,0,0,0,120000,-120000,-120000
20200528,07808P,超眾永豐9A售04,,,,,0.00,0.00,0,0,0,0,0,0,0,0,0,0,0,0,0
20200528,07809P,國巨中信9A售06,,,,,0.00,0.00,0,0,0,0,0,0,0,0,0,0,0,0,0
20200528,07810P,台積電統一9A售08,0.88,0.88,0.88,0.88,-0.01,-1.12,101000,1,88880,0,0,0,0,0,0,101000,0,101000,101000
20200528,07811P,華新科統一9A售02,,,,,0.00,0.00,0,0,0,0,0,0,0,0,0,0,0,0,0
20200528,07812P,大立光統一9A售06,0.50,0.50,0.50,0.50,0.00,0.00,16000,1,8000,0,0,0,0,0,0,16000,0,16000,16000
20200528,07813P,台灣50群益9C售03,,,,,0.00,0.00,0,0,0,0,0,0,0,0,0,0,0,0,0
20200528,07814P,華通群益9A售06,1.36,1.36,1.36,1.36,-0.15,-9.93,10000,1,13600,0,0,0,0,0,0,0,10000,-10000,-10000
20200528,07815P,美律群益9A售04,1.46,1.47,1.46,1.46,-0.06,-3.95,161000,3,235470,0,0,0,0,0,0,20000,141000,-121000,-121000
20200528,07816P,聯發科群益9A售02,1.18,1.18,1.18,1.18,0.00,0.00,259000,2,305620,0,0,0,0,0,0,0,259000,-259000,-259000
20200528,07817P,同欣電群益9A售02,0.98,1.02,0.98,1.02,+0.01,0.99,336000,5,339130,0,0,0,0,0,0,118000,218000,-100000,-100000
20200528,07818P,台積電國票9C售01,1.55,1.61,1.55,1.60,+0.02,1.27,522000,5,838450,0,0,0,0,0,0,10000,512000,-502000,-502000
20200528,07819P,旺宏國票9B售01,1.88,2.02,1.87,2.02,+0.08,4.12,681000,18,1325710,0,0,0,0,0,0,221000,460000,-239000,-239000
20200528,07820P,臺股指國票9A售11,1.64,1.79,1.64,1.79,+0.04,2.29,11000,4,18970,0,0,0,0,0,0,0,11000,-11000,-11000
20200528,07821P,臺股指國票9A售12,1.37,1.50,1.35,1.47,+0.03,2.08,413000,30,590970,0,0,0,0,0,0,137000,276000,-139000,-139000
20200528,07822P,滬深2X元大9A售09,,,,,0.00,0.00,0,0,0,0,0,0,0,0,0,0,0,0,0
20200528,07823P,國巨元大9A售23,2.65,2.65,2.65,2.65,+0.02,0.76,1000,1,2650,0,0,0,0,0,0,0,1000,-1000,-1000
20200528,07824P,國巨元大9A售24,,,,,0.00,0.00,0,0,0,0,0,0,0,0,0,0,0,0,0
20200528,07825P,健策國泰9B售04,0.96,1.09,0.96,1.08,+0.09,9.09,380000,16,393180,0,0,0,0,0,0,99000,281000,-182000,-182000
20200528,07826P,台積電富邦9B售07,,,,,0.00,0.00,0,0,0,0,0,0,0,0,0,0,0,0,0
20200528,07827P,台灣50中信9C售01,,,,,0.00,0.00,0,0,0,0,0,0,0,0,0,0,0,0,0
20200528,07828P,SP黃豆凱基01售01,,,,,0.00,0.00,0,0,0,0,0,0,0,0,0,0,0,0,0
20200528,07829P,旺宏凱基9A售07,,,,,0.00,0.00,0,0,0,0,0,0,0,0,0,0,0,0,0
20200528,07830P,牧德凱基9A售03,0.74,0.76,0.74,0.76,+0.01,1.33,84000,3,62640,0,0,0,0,0,0,60000,24000,36000,36000
20200528,07831P,大立光統一9B售07,1.96,1.96,1.96,1.96,0.00,0.00,2000,1,3920,0,0,0,0,0,0,0,2000,-2000,-2000
20200528,07832P,台積電群益9A售08,2.77,2.78,2.77,2.78,-0.05,-1.77,85000,2,235880,0,0,0,0,0,0,42000,43000,-1000,-1000
20200528,07833P,大立光群益9B售02,1.42,1.46,1.42,1.46,+0.02,1.39,37000,2,52940,0,0,0,0,0,0,27000,10000,17000,17000
20200528,07834P,聯詠群益9A售03,0.79,0.81,0.79,0.81,+0.02,2.53,118000,5,93910,0,0,0,0,0,0,0,118000,-118000,-118000
20200528,07835P,台表科群益9A售02,0.72,0.74,0.72,0.74,+0.04,5.71,461000,5,337160,0,0,0,0,0,0,212000,249000,-37000,-37000
20200528,07836P,大成鋼元大9A售01,1.39,1.39,1.34,1.34,-0.09,-6.29,147000,4,204280,0,0,0,0,0,0,117000,30000,87000,87000
20200528,07837P,華邦電元大9A售01,1.35,1.51,1.31,1.51,+0.14,10.22,683000,22,968500,0,0,0,0,0,0,149000,533000,-384000,-384000
20200528,07838P,泰碩元大9A售04,1.70,1.75,1.70,1.75,+0.02,1.16,71000,9,122460,0,0,0,0,0,0,65000,6000,59000,59000
20200528,07839P,嘉澤元大9A售04,1.15,1.20,1.14,1.17,0.00,0.00,403000,11,472220,0,0,0,0,0,0,235000,168000,67000,67000
20200528,07840P,康控元大9A售02,1.45,1.50,1.45,1.50,0.00,0.00,355000,6,525600,0,0,0,0,0,0,130000,235000,-105000,-105000
20200528,07841P,臻鼎元大9A售04,1.19,1.22,1.19,1.22,0.00,0.00,40000,2,47900,0,0,0,0,0,0,40000,0,40000,40000
20200528,07842P,力成元大9A售01,1.37,1.41,1.37,1.41,+0.03,2.17,182000,4,253120,0,0,0,0,0,0,0,182000,-182000,-182000
20200528,07843P,緯穎元大9A售05,0.92,0.96,0.92,0.96,+0.01,1.05,209000,3,196380,0,0,0,0,0,0,99000,110000,-11000,-11000
20200528,07844P,可成國票9A售01,2.21,2.26,2.19,2.26,+0.01,0.44,138000,10,307170,0,0,0,0,0,0,38000,125000,-87000,-87000
20200528,07845P,南亞科元大9A售08,1.76,1.85,1.75,1.85,-0.03,-1.6,161000,10,290660,0,0,0,0,0,0,55000,96000,-41000,-41000
20200528,07846P,台灣50群益9A售17,3.48,3.48,3.48,3.48,-0.08,-2.25,3000,1,10440,0,0,0,0,0,0,0,3000,-3000,-3000
20200528,07847P,國巨群益9A售13,2.26,2.32,2.26,2.32,+0.03,1.31,281000,8,642950,0,0,0,0,0,0,40000,241000,-201000,-201000
20200528,07848P,旺宏群益9B售01,,,,,0.00,0.00,0,0,0,0,0,0,0,0,0,0,0,0,0
20200528,07849P,大立光群益9A售06,2.00,2.09,2.00,2.09,0.00,0.00,7000,2,14180,0,0,0,0,0,0,5000,2000,3000,3000
20200528,07850P,健策群益9A售06,0.92,0.98,0.92,0.98,0.00,0.00,171000,5,165030,0,0,0,0,0,0,0,171000,-171000,-171000
20200528,07851P,聯發科國票9A售05,1.04,1.15,1.04,1.10,+0.02,1.85,136000,6,147220,0,0,0,0,0,0,58000,78000,-20000,-20000
20200528,07852P,臺股指國票9A售13,,,,,0.00,0.00,0,0,0,0,0,0,0,0,0,0,0,0,0
20200528,07853P,國巨凱基9A售19,1.61,1.65,1.61,1.65,+0.02,1.23,840000,9,1374520,0,0,0,0,0,0,0,840000,-840000,-840000
20200528,07854P,台積電凱基9A售28,2.93,2.93,2.93,2.93,+0.02,0.69,10000,1,29300,0,0,0,0,0,0,10000,0,10000,10000
20200528,07855P,旺宏凱基9A售09,1.56,1.62,1.56,1.61,+0.04,2.55,223000,9,357060,0,0,0,0,0,0,5000,218000,-213000,-213000
20200528,07856P,力成凱基9A售02,0.93,0.95,0.93,0.95,+0.03,3.26,462000,7,433730,0,0,0,0,0,0,0,462000,-462000,-462000
20200528,07857P,國巨永豐9A售05,,,,,0.00,0.00,0,0,0,0,0,0,0,0,0,0,0,0,0
20200528,07858P,旺宏永豐9A售03,,,,,0.00,0.00,0,0,0,0,0,0,0,0,0,0,0,0,0
20200528,07859P,台灣50麥證9A售04,1.11,1.15,1.11,1.15,+0.02,1.77,81000,6,91530,40000,41000,-1000,0,0,0,40000,41000,-1000,-1000
20200528,07860P,臺股指麥證9A售06,,,,,0.00,0.00,0,0,0,0,0,0,0,0,0,0,0,0,0
20200528,07861P,台灣50中信03售08,1.54,1.54,1.54,1.54,+0.03,1.99,40000,2,61600,0,0,0,0,0,0,40000,0,40000,40000
20200528,07862P,聯發科凱基9B售05,,,,,0.00,0.00,0,0,0,0,0,0,0,0,0,0,0,0,0
20200528,07863P,華新科凱基9B售07,1.22,1.23,1.22,1.23,+0.01,0.82,45000,2,55050,0,0,0,0,0,0,0,45000,-45000,-45000
20200528,07864P,可成元大9B售01,2.05,2.14,2.05,2.14,+0.01,0.47,355000,12,741250,0,0,0,0,0,0,54000,301000,-247000,-247000
20200528,07865P,可成元大9B售02,2.79,2.90,2.79,2.90,-0.01,-0.34,179000,6,508010,0,0,0,0,0,0,19000,160000,-141000,-141000
20200528,07866P,上証2X國票97售01,,,,,0.00,0.00,0,0,0,0,0,0,0,0,0,0,0,0,0
20200528,07867P,晶技元大9B售01,2.14,2.17,2.10,2.17,+0.04,1.88,216000,7,463080,0,0,0,0,0,0,43000,173000,-130000,-130000
20200528,07868P,健策元大9B售05,,,,,0.00,0.00,0,0,0,0,0,0,0,0,0,0,0,0,0
20200528,07869P,台灣50群益9C售04,,,,,0.00,0.00,0,0,0,0,0,0,0,0,0,0,0,0,0
20200528,07870P,鴻海群益9B售01,,,,,0.00,0.00,0,0,0,0,0,0,0,0,0,0,0,0,0
20200528,07871P,台積電群益9C售02,4.10,4.24,4.09,4.24,+0.09,2.17,81000,4,334750,0,0,0,0,0,0,29000,52000,-23000,-23000
20200528,07872P,聯發科群益9B售03,1.54,1.58,1.54,1.58,+0.07,4.64,91000,2,143180,0,0,0,0,0,0,15000,76000,-61000,-61000
20200528,07873P,華新科群益9B售03,2.66,2.66,2.66,2.66,0.00,0.00,1000,1,2660,0,0,0,0,0,0,0,1000,-1000,-1000
20200528,07874P,長榮航群益9B售01,1.30,1.37,1.30,1.37,+0.06,4.58,53000,2,71210,0,0,0,0,0,0,0,53000,-53000,-53000
20200528,07875P,祥碩群益9B售01,0.63,0.63,0.60,0.62,-0.04,-6.06,135000,8,83800,0,0,0,0,0,0,105000,30000,75000,75000
20200528,07876P,台灣50國泰01售01,1.36,1.36,1.36,1.36,0.00,0.00,22000,2,29920,0,0,0,0,0,0,0,22000,-22000,-22000
20200528,07877P,晶技永豐9B售01,,,,,0.00,0.00,0,0,0,0,0,0,0,0,0,0,0,0,0
20200528,07878P,智邦群益9C售01,1.82,2.03,1.76,1.97,-0.13,-6.19,234000,19,447950,0,0,0,0,0,0,60000,174000,-114000,-114000
20200528,07879P,瑞昱群益9C售01,,,,,0.00,0.00,0,0,0,0,0,0,0,0,0,0,0,0,0
20200528,07880P,可成群益9B售05,2.49,2.56,2.49,2.56,-0.04,-1.54,200000,3,511100,0,0,0,0,0,0,3000,197000,-194000,-194000
20200528,07881P,台灣50凱基01售11,,,,,0.00,0.00,0,0,0,0,0,0,0,0,0,0,0,0,0
20200528,07882P,台灣50凱基01售12,,,,,0.00,0.00,0,0,0,0,0,0,0,0,0,0,0,0,0
20200528,07883P,可成凱基9B售03,1.43,1.49,1.41,1.48,0.00,0.00,675000,15,987570,0,0,0,0,0,0,124000,601000,-477000,-477000
20200528,07884P,華新科凱基9B售08,2.61,2.71,2.61,2.71,+0.08,3.04,51000,3,137210,0,0,0,0,0,0,0,51000,-51000,-51000
20200528,07885P,長榮航凱基9B售01,,,,,0.00,0.00,0,0,0,0,0,0,0,0,0,0,0,0,0
20200528,07886P,國巨國票9B售06,1.99,2.08,1.99,2.08,+0.06,2.97,24000,4,48940,0,0,0,0,0,0,4000,20000,-16000,-16000
20200528,07887P,台積電國票9C售03,,,,,0.00,0.00,0,0,0,0,0,0,0,0,0,0,0,0,0
20200528,07888P,大立光國票9B售01,3.26,3.26,3.26,3.26,-0.01,-0.31,3000,1,9780,0,0,0,0,0,0,3000,0,3000,3000
20200528,07889P,旭富國票9B售01,1.48,1.49,1.45,1.49,+0.01,0.68,514000,10,759340,0,0,0,0,0,0,368000,146000,222000,222000
20200528,07890P,南電國票9B售01,4.53,4.62,4.53,4.62,-0.01,-0.22,100000,8,454700,0,0,0,0,0,0,80000,20000,60000,60000
20200528,07891P,臺股指國票9B售01,3.79,4.05,3.79,4.05,+0.14,3.58,76000,9,293570,0,0,0,0,0,0,15000,61000,-46000,-46000
20200528,07892P,臺股指國票9B售02,,,,,0.00,0.00,0,0,0,0,0,0,0,0,0,0,0,0,0
20200528,07893P,臺股指國票9B售03,,,,,0.00,0.00,0,0,0,0,0,0,0,0,0,0,0,0,0
20200528,07894P,燿華元大9B售01,2.47,2.55,2.47,2.55,-0.01,-0.39,97000,2,243590,0,0,0,0,0,0,47000,50000,-3000,-3000
20200528,07895P,美律元大9B售01,1.90,1.92,1.90,1.92,-0.12,-5.88,72000,5,137240,0,0,0,0,0,0,50000,22000,28000,28000
20200528,07896P,臺股指元大9B售16,,,,,0.00,0.00,0,0,0,0,0,0,0,0,0,0,0,0,0
20200528,07897P,臺股指元大9B售17,,,,,0.00,0.00,0,0,0,0,0,0,0,0,0,0,0,0,0
20200528,07898P,國巨國泰9C售02,1.51,1.58,1.50,1.58,+0.02,1.28,682000,23,1050750,0,0,0,0,0,0,207000,475000,-268000,-268000
20200528,07899P,和大凱基9B售01,0.98,1.04,0.96,1.04,+0.03,2.97,963000,26,939900,0,0,0,0,0,0,829000,134000,695000,695000
20200528,07900P,臺股指凱基9B售03,4.08,4.13,4.06,4.06,+0.03,0.74,18000,8,73650,0,0,0,0,0,0,5000,13000,-8000,-8000
20200528,07901P,臺股指凱基9B售04,,,,,0.00,0.00,0,0,0,0,0,0,0,0,0,0,0,0,0
20200528,07902P,玉晶光國票01售01,2.99,2.99,2.91,2.99,-0.12,-3.86,199000,5,590210,0,0,0,0,0,0,149000,50000,99000,99000
20200528,07903P,台積電群益9B售03,,,,,0.00,0.00,0,0,0,0,0,0,0,0,0,0,0,0,0
20200528,07904P,聯發科群益9B售05,2.41,2.61,2.41,2.53,+0.04,1.61,296000,29,748030,0,0,0,0,0,0,51000,245000,-194000,-194000
20200528,07905P,大立光群益9B售04,2.43,2.52,2.43,2.52,+0.08,3.28,49000,4,119160,0,0,0,0,0,0,48000,1000,47000,47000
20200528,07906P,中租群益9B售02,1.80,1.81,1.80,1.81,0.00,0.00,223000,2,403390,0,0,0,0,0,0,0,199000,-199000,-199000
20200528,07907P,台灣50台新9B售08,,,,,0.00,0.00,0,0,0,0,0,0,0,0,0,0,0,0,0
20200528,07908P,台積電統一9B售11,,,,,0.00,0.00,0,0,0,0,0,0,0,0,0,0,0,0,0
20200528,07909P,台積電統一9B售12,1.55,1.55,1.55,1.55,+0.02,1.31,5000,1,7750,0,0,0,0,0,0,5000,0,5000,5000
20200528,07910P,台積電統一9C售07,1.98,2.00,1.98,2.00,0.00,0.00,51000,2,101000,0,0,0,0,0,0,51000,0,51000,51000
20200528,07911P,大立光統一9B售08,,,,,0.00,0.00,0,0,0,0,0,0,0,0,0,0,0,0,0
20200528,07912P,玉晶光統一9B售02,,,,,0.00,0.00,0,0,0,0,0,0,0,0,0,0,0,0,0
20200528,07913P,友達元大01售01,1.29,1.32,1.29,1.32,+0.01,0.76,108000,3,140340,0,0,0,0,0,0,34000,74000,-40000,-40000
20200528,07914P,臺股指元大9B售20,,,,,0.00,0.00,0,0,0,0,0,0,0,0,0,0,0,0,0
20200528,07915P,臺股指元大9B售21,,,,,0.00,0.00,0,0,0,0,0,0,0,0,0,0,0,0,0
20200528,07916P,臺股指元大9B售22,,,,,0.00,0.00,0,0,0,0,0,0,0,0,0,0,0,0,0
20200528,07917P,可成永豐9B售01,1.13,1.17,1.13,1.17,0.00,0.00,388000,8,451490,0,0,0,0,0,0,22000,366000,-344000,-344000
20200528,07918P,玉晶光永豐9B售04,,,,,0.00,0.00,0,0,0,0,0,0,0,0,0,0,0,0,0
20200528,07919P,創意永豐9B售01,0.96,0.97,0.94,0.94,0.00,0.00,40000,4,38300,0,0,0,0,0,0,0,40000,-40000,-40000
20200528,07920P,大立光中信01售01,0.52,0.52,0.52,0.52,0.00,0.00,110000,2,57200,0,0,0,0,0,0,0,110000,-110000,-110000
20200528,07921P,鴻海群益9B售04,2.66,2.66,2.66,2.66,0.00,0.00,5000,1,13300,0,0,0,0,0,0,0,5000,-5000,-5000
20200528,07922P,大立光群益9B售05,1.76,1.82,1.75,1.82,-0.01,-0.55,132000,3,233840,0,0,0,0,0,0,94000,38000,56000,56000
20200528,07923P,元金2X凱基02售02,1.52,1.52,1.52,1.52,0.00,0.00,3000,1,4560,0,0,0,0,0,0,3000,0,3000,3000
20200528,07924P,台積電凱基9B售04,,,,,0.00,0.00,0,0,0,0,0,0,0,0,0,0,0,0,0
20200528,07925P,台積電凱基9B售05,3.49,3.60,3.49,3.60,+0.07,1.98,39000,2,136660,0,0,0,0,0,0,5000,34000,-29000,-29000
20200528,07926P,上銀統一9B售02,0.62,0.67,0.62,0.66,+0.02,3.12,91000,7,59450,0,0,0,0,0,0,50000,36000,14000,14000
20200528,07927P,國巨統一9B售08,1.13,1.16,1.13,1.16,0.00,0.00,200000,3,230000,0,0,0,0,0,0,50000,150000,-100000,-100000
20200528,07928P,國巨統一9B售09,,,,,0.00,0.00,0,0,0,0,0,0,0,0,0,0,0,0,0
20200528,07929P,旺宏統一9B售07,1.03,1.03,1.03,1.03,0.00,0.00,13000,2,13390,0,0,0,0,0,0,0,13000,-13000,-13000
20200528,07930P,聯發科統一9B售06,0.62,0.62,0.62,0.62,-0.01,-1.59,10000,1,6200,0,0,0,0,0,0,10000,0,10000,10000
20200528,07931P,國巨元大9B售03,2.37,2.38,2.35,2.38,-0.03,-1.24,55000,3,130270,0,0,0,0,0,0,0,55000,-55000,-55000
20200528,07932P,國巨元大9B售04,3.23,3.32,3.23,3.31,0.00,0.00,51000,5,168820,0,0,0,0,0,0,1000,50000,-49000,-49000
20200528,07933P,大立光富邦9C售06,0.68,0.71,0.68,0.71,+0.01,1.43,66000,5,45520,0,0,0,0,0,0,10000,56000,-46000,-46000
20200528,07934P,臺股指國票9B售06,1.92,2.01,1.91,2.01,+0.08,4.15,20000,4,39150,0,0,0,0,0,0,0,20000,-20000,-20000
20200528,07935P,臺股指國票9B售07,2.07,2.07,2.07,2.07,-0.02,-0.96,5000,1,10350,0,0,0,0,0,0,0,5000,-5000,-5000
20200528,07936P,臺股指國票9B售08,,,,,0.00,0.00,0,0,0,0,0,0,0,0,0,0,0,0,0
20200528,07937P,國巨中信9B售03,,,,,0.00,0.00,0,0,0,0,0,0,0,0,0,0,0,0,0
20200528,07938P,國巨統一9B售10,,,,,0.00,0.00,0,0,0,0,0,0,0,0,0,0,0,0,0
20200528,07939P,台積電統一9B售14,0.81,0.84,0.81,0.84,0.00,0.00,10000,2,8250,0,0,0,0,0,0,5000,5000,0,0
20200528,07940P,國巨群益9B售06,2.72,2.77,2.70,2.77,+0.01,0.36,30000,3,81900,0,0,0,0,0,0,0,30000,-30000,-30000
20200528,07941P,國巨凱基9B售07,1.10,1.10,1.10,1.10,+0.01,0.92,10000,1,11000,0,0,0,0,0,0,10000,0,10000,10000
20200528,07942P,健策凱基9B售03,,,,,0.00,0.00,0,0,0,0,0,0,0,0,0,0,0,0,0
20200528,07943P,瑞昱元大9B售02,3.16,3.16,3.10,3.13,-0.10,-3.1,197000,5,617420,0,0,0,0,0,0,37000,160000,-123000,-123000
20200528,07944P,華新科元大9B售08,2.86,2.94,2.86,2.94,+0.07,2.44,108000,4,313520,0,0,0,0,0,0,0,108000,-108000,-108000
20200528,07945P,上銀國票9B售02,1.77,1.93,1.77,1.91,+0.08,4.37,80000,5,148160,0,0,0,0,0,0,20000,60000,-40000,-40000
20200528,07946P,華通統一9B售02,1.02,1.04,1.00,1.04,-0.06,-5.45,79000,7,81530,0,0,0,0,0,0,28000,51000,-23000,-23000
20200528,07947P,國巨統一9B售12,,,,,0.00,0.00,0,0,0,0,0,0,0,0,0,0,0,0,0
20200528,07948P,大成鋼凱基9B售01,,,,,0.00,0.00,0,0,0,0,0,0,0,0,0,0,0,0,0
20200528,07949P,滬深2X元大9B售04,,,,,0.00,0.00,0,0,0,0,0,0,0,0,0,0,0,0,0
20200528,07950P,智邦元大9B售04,2.05,2.13,1.92,2.13,-0.14,-6.17,249000,10,511150,0,0,0,0,0,0,120000,129000,-9000,-9000
20200528,07951P,智邦元大9B售05,1.72,1.72,1.49,1.63,-0.10,-5.78,402000,48,644590,0,0,0,0,0,0,260000,136000,124000,124000
20200528,07952P,富邦金元大9B售02,2.50,2.56,2.50,2.56,0.00,0.00,89000,5,225970,0,0,0,0,0,0,0,89000,-89000,-89000
20200528,07953P,健策元大9B售07,1.73,1.87,1.72,1.87,+0.05,2.75,69000,10,124160,0,0,0,0,0,0,24000,45000,-21000,-21000
20200528,07954P,台表科元大9B售02,1.89,1.98,1.89,1.95,+0.07,3.72,334000,13,651180,0,0,0,0,0,0,5000,324000,-319000,-319000
20200528,07955P,大成鋼群益9B售02,1.69,1.69,1.69,1.69,-0.06,-3.43,26000,1,43940,0,0,0,0,0,0,26000,0,26000,26000
20200528,07956P,鴻海群益9B售06,1.81,1.82,1.81,1.82,-0.05,-2.67,123000,2,222680,0,0,0,0,0,0,0,123000,-123000,-123000
20200528,07957P,晶技群益9B售02,1.74,1.76,1.70,1.76,+0.04,2.33,282000,14,493920,0,0,0,0,0,0,65000,217000,-152000,-152000
20200528,07958P,華擎群益9B售01,0.92,0.95,0.92,0.95,-0.01,-1.04,128000,2,118600,0,0,0,0,0,0,100000,28000,72000,72000
20200528,07959P,健策永豐9B售05,0.72,0.76,0.72,0.76,0.00,0.00,80000,3,59540,0,0,0,0,0,0,0,80000,-80000,-80000
20200528,07960P,台灣50中信9B售02,,,,,0.00,0.00,0,0,0,0,0,0,0,0,0,0,0,0,0
20200528,07961P,滬深2X中信01售02,,,,,0.00,0.00,0,0,0,0,0,0,0,0,0,0,0,0,0
20200528,07962P,聯詠中信05售03,,,,,0.00,0.00,0,0,0,0,0,0,0,0,0,0,0,0,0
20200528,07963P,智邦統一9B售01,0.76,0.81,0.72,0.79,-0.04,-4.82,2067000,71,1617040,0,0,0,0,0,0,284000,1703000,-1419000,-1419000
20200528,07964P,大立光統一9B售12,1.45,1.45,1.45,1.45,-0.02,-1.36,138000,1,200100,0,0,0,0,0,0,138000,0,138000,138000
20200528,07965P,玉晶光群益01售02,2.45,2.46,2.40,2.46,-0.05,-1.99,44000,8,106930,0,0,0,0,0,0,19000,25000,-6000,-6000
20200528,07966P,瑞祺群益9B售02,1.50,1.56,1.50,1.56,+0.01,0.65,98000,7,149310,0,0,0,0,0,0,77000,21000,56000,56000
20200528,07967P,力山元大9B售03,1.85,1.94,1.85,1.94,+0.06,3.19,66000,4,126410,0,0,0,0,0,0,10000,56000,-46000,-46000
20200528,07968P,國巨元大9B售09,3.68,3.68,3.68,3.68,+0.01,0.27,26000,2,95680,0,0,0,0,0,0,0,26000,-26000,-26000
20200528,07969P,臺股指元大9B售27,,,,,0.00,0.00,0,0,0,0,0,0,0,0,0,0,0,0,0
20200528,07970P,臺股指元大9B售28,,,,,0.00,0.00,0,0,0,0,0,0,0,0,0,0,0,0,0
20200528,07971P,臺股指元大9B售29,,,,,0.00,0.00,0,0,0,0,0,0,0,0,0,0,0,0,0
20200528,07972P,大立光統一9C售05,2.34,2.34,2.34,2.34,0.00,0.00,1000,1,2340,0,0,0,0,0,0,0,1000,-1000,-1000
20200528,07973P,大立光台新9B售01,,,,,0.00,0.00,0,0,0,0,0,0,0,0,0,0,0,0,0
20200528,07974P,上証2X元大9B售02,1.62,1.63,1.62,1.63,0.00,0.00,60000,2,97700,0,0,0,0,0,0,0,60000,-60000,-60000
20200528,07975P,國巨元大9B售15,2.30,2.37,2.30,2.37,+0.03,1.28,145000,7,340250,0,0,0,0,0,0,20000,125000,-105000,-105000
20200528,07976P,聯發科群益9C售02,1.18,1.25,1.18,1.22,+0.04,3.39,310000,14,382870,0,0,0,0,0,0,37000,273000,-236000,-236000
20200528,07977P,華新科群益01售01,1.83,1.83,1.83,1.83,+0.05,2.81,16000,1,29280,0,0,0,0,0,0,0,16000,-16000,-16000
20200528,07978P,茂林群益9B售02,1.47,1.50,1.46,1.49,-0.03,-1.97,542000,10,809140,0,0,0,0,0,0,539000,3000,536000,536000
20200528,07979P,大立光凱基9B售05,1.93,1.93,1.93,1.93,-0.05,-2.53,15000,1,28950,0,0,0,0,0,0,15000,0,15000,15000
20200528,07980P,臺股指凱基02售01,,,,,0.00,0.00,0,0,0,0,0,0,0,0,0,0,0,0,0
20200528,07981P,上銀群益9B售04,1.19,1.31,1.17,1.29,+0.08,6.61,270000,14,343310,0,0,0,0,0,0,17000,253000,-236000,-236000
20200528,07982P,全新群益9B售04,1.69,1.69,1.69,1.69,-0.01,-0.59,6000,1,10140,0,0,0,0,0,0,6000,0,6000,6000
20200528,07983P,茂林群益9B售03,1.21,1.27,1.20,1.25,0.00,0.00,308000,15,381260,0,0,0,0,0,0,288000,20000,268000,268000
20200528,07984P,臺指反元大02售08,,,,,0.00,0.00,0,0,0,0,0,0,0,0,0,0,0,0,0
20200528,07985P,臺指反元大02售09,,,,,0.00,0.00,0,0,0,0,0,0,0,0,0,0,0,0,0
20200528,07986P,大成鋼統一9B售02,0.73,0.74,0.73,0.74,-0.01,-1.33,43000,2,31420,0,0,0,0,0,0,40000,3000,37000,37000
20200528,07987P,大立光統一9B售13,,,,,0.00,0.00,0,0,0,0,0,0,0,0,0,0,0,0,0
20200528,07988P,台積電台新9C售03,0.91,0.95,0.91,0.95,+0.03,3.26,13000,2,11950,0,0,0,0,0,0,3000,10000,-7000,-7000
20200528,07989P,玉晶光凱基9B售07,1.41,1.44,1.41,1.44,-0.03,-2.04,22000,3,31340,0,0,0,0,0,0,0,22000,-22000,-22000
20200528,07990P,緯穎凱基9B售02,1.00,1.06,0.99,1.05,+0.02,1.94,443000,16,456930,0,0,0,0,0,0,144000,279000,-135000,-135000
20200528,07991P,鴻海群益9C售02,3.33,3.41,3.33,3.41,+0.01,0.29,49000,3,166320,0,0,0,0,0,0,9000,40000,-31000,-31000
20200528,07992P,玉晶光群益01售04,3.58,3.58,3.58,3.58,0.00,0.00,50000,1,179000,0,0,0,0,0,0,50000,0,50000,50000
20200528,07993P,寶成群益9B售01,1.37,1.46,1.37,1.46,+0.03,2.1,334000,34,470140,0,0,0,0,0,0,183000,151000,32000,32000
20200528,07994P,臺股指群益9B售04,3.30,3.57,3.30,3.55,+0.06,1.72,139000,7,485390,0,0,0,0,0,0,126000,13000,113000,113000
20200528,07995P,臺股指麥證9C售01,3.00,3.20,3.00,3.16,+0.08,2.6,27000,23,84490,21000,6000,15000,0,0,0,21000,6000,15000,15000
20200528,07996P,亞德客凱基9B售03,1.42,1.53,1.42,1.52,+0.04,2.7,579000,20,871910,0,0,0,0,0,0,208000,570000,-362000,-362000
20200528,07997P,上銀凱基9B售04,1.01,1.06,1.00,1.06,+0.07,7.07,6000,5,6130,0,0,0,0,0,0,2000,4000,-2000,-2000
20200528,07998P,聯電凱基9C售01,1.18,1.19,1.14,1.19,-0.01,-0.83,291000,11,338030,0,0,0,0,0,0,250000,41000,209000,209000
20200528,07999P,台達電凱基9B售02,1.16,1.19,1.15,1.19,+0.06,5.31,183000,18,211930,0,0,0,0,0,0,81000,100000,-19000,-19000
20200528,08000P,奇鋐凱基9B售03,1.24,1.24,1.17,1.20,-0.10,-7.69,1117000,12,1347480,0,0,0,0,0,0,102000,1015000,-913000,-913000
20200528,08001P,台灣50元大9B售17,,,,,0.00,0.00,0,0,0,0,0,0,0,0,0,0,0,0,0
20200528,08002P,大毅國票9B售03,2.54,2.63,2.54,2.61,-0.06,-2.25,338000,14,875830,0,0,0,0,0,0,62000,276000,-214000,-214000
20200528,08003P,國巨國泰9B售07,4.22,4.32,4.22,4.32,-0.02,-0.46,196000,9,836480,0,0,0,0,0,0,0,196000,-196000,-196000
20200528,08004P,大毅永豐9B售02,0.92,0.93,0.91,0.92,-0.02,-2.13,81000,6,74820,0,0,0,0,0,0,7000,74000,-67000,-67000
20200528,08005P,台積電群益9C售04,1.60,1.60,1.60,1.60,0.00,0.00,5000,1,8000,0,0,0,0,0,0,0,5000,-5000,-5000
20200528,08006P,長榮航中信03售01,0.61,0.61,0.61,0.61,+0.01,1.67,60000,3,36600,0,0,0,0,0,0,0,60000,-60000,-60000
20200528,08007P,國泰金中信03售02,0.86,0.86,0.86,0.86,0.00,0.00,70000,2,60200,0,0,0,0,0,0,0,70000,-70000,-70000
20200528,08008P,華新科統一9B售05,,,,,0.00,0.00,0,0,0,0,0,0,0,0,0,0,0,0,0
20200528,08009P,華擎統一9B售02,0.86,0.86,0.86,0.86,-0.01,-1.15,5000,1,4300,0,0,0,0,0,0,5000,0,5000,5000
20200528,08010P,大成鋼元大9B售01,1.97,1.98,1.89,1.89,-0.13,-6.44,77000,3,151510,0,0,0,0,0,0,22000,55000,-33000,-33000
20200528,08011P,玉晶光元大9B售05,1.24,1.31,1.24,1.29,-0.03,-2.27,34000,6,43390,0,0,0,0,0,0,12000,22000,-10000,-10000
20200528,08012P,台灣50凱基01售13,,,,,0.00,0.00,0,0,0,0,0,0,0,0,0,0,0,0,0
20200528,08013P,台灣50凱基9C售09,1.64,1.64,1.64,1.64,+0.06,3.8,1000,1,1640,0,0,0,0,0,0,0,1000,-1000,-1000
20200528,08014P,微星凱基9B售02,1.15,1.17,1.14,1.14,-0.05,-4.2,268000,9,308580,0,0,0,0,0,0,252000,16000,236000,236000
20200528,08015P,可成凱基9B售05,2.24,2.28,2.24,2.28,0.00,0.00,245000,3,551000,0,0,0,0,0,0,0,245000,-245000,-245000
20200528,08016P,臺股指凱基02售02,1.02,1.03,1.02,1.03,+0.02,1.98,2000,2,2050,0,0,0,0,0,0,0,2000,-2000,-2000
20200528,08017P,華新科國票9B售01,2.95,2.95,2.95,2.95,+0.09,3.15,20000,1,59000,0,0,0,0,0,0,0,20000,-20000,-20000
20200528,08018P,牧德國票9B售04,4.55,4.65,4.55,4.65,+0.04,0.87,20000,3,92080,0,0,0,0,0,0,11000,9000,2000,2000
20200528,08019P,緯穎國票9B售02,2.11,2.19,2.11,2.19,0.00,0.00,48000,4,102630,0,0,0,0,0,0,10000,38000,-28000,-28000
20200528,08020P,臺股指凱基9B售06,2.30,2.30,2.30,2.30,0.00,0.00,2000,1,4600,0,0,0,0,0,0,0,2000,-2000,-2000
20200528,08021P,臺股指凱基9B售07,,,,,0.00,0.00,0,0,0,0,0,0,0,0,0,0,0,0,0
20200528,08022P,臺股指凱基9B售08,2.37,2.37,2.37,2.37,0.00,0.00,3000,1,7110,0,0,0,0,0,0,0,3000,-3000,-3000
20200528,08023P,臺股指凱基9B售09,,,,,0.00,0.00,0,0,0,0,0,0,0,0,0,0,0,0,0
20200528,08024P,臺股指凱基9B售10,,,,,0.00,0.00,0,0,0,0,0,0,0,0,0,0,0,0,0
20200528,08025P,臺股指凱基9B售11,,,,,0.00,0.00,0,0,0,0,0,0,0,0,0,0,0,0,0
20200528,08026P,臺股指凱基9B售12,2.18,2.34,2.16,2.30,+0.06,2.68,428000,13,980510,0,0,0,0,0,0,269000,159000,110000,110000
20200528,08027P,嘉晶元大9B售03,1.37,1.45,1.37,1.45,+0.08,5.84,655000,17,913800,0,0,0,0,0,0,109000,590000,-481000,-481000
20200528,08028P,臺股指元大9B售30,1.49,1.55,1.49,1.55,+0.04,2.65,20000,2,30400,0,0,0,0,0,0,0,20000,-20000,-20000
20200528,08029P,臺股指元大9B售36,,,,,0.00,0.00,0,0,0,0,0,0,0,0,0,0,0,0,0
20200528,08030P,臺股指元大9B售37,,,,,0.00,0.00,0,0,0,0,0,0,0,0,0,0,0,0,0
20200528,08031P,臺股指元大9B售38,1.38,1.44,1.38,1.44,0.00,0.00,1158000,4,1666920,0,0,0,0,0,0,10000,1148000,-1138000,-1138000
20200528,08032P,台積電統一9B售16,0.90,0.90,0.90,0.90,0.00,0.00,33000,1,29700,0,0,0,0,0,0,0,33000,-33000,-33000
20200528,08033P,台灣50兆豐9C售03,,,,,0.00,0.00,0,0,0,0,0,0,0,0,0,0,0,0,0
20200528,08034P,台積電兆豐9B售02,1.13,1.20,1.13,1.20,+0.05,4.35,45000,3,52000,0,0,0,0,0,0,20000,25000,-5000,-5000
20200528,08035P,國巨群益9C售04,1.91,1.93,1.91,1.93,-0.02,-1.03,206000,3,397460,0,0,0,0,0,0,0,206000,-206000,-206000
20200528,08036P,嘉澤群益9B售03,1.80,1.85,1.80,1.85,+0.07,3.93,260000,9,474930,0,0,0,0,0,0,100000,160000,-60000,-60000
20200528,08037P,台表科群益9B售02,1.35,1.38,1.29,1.37,+0.01,0.74,203000,12,276460,0,0,0,0,0,0,61000,112000,-51000,-51000
20200528,08038P,臺股指群益9B售11,1.92,2.06,1.92,2.02,+0.07,3.59,8000,3,15740,0,0,0,0,0,0,2000,6000,-4000,-4000
20200528,08039P,臺股指群益9B售12,,,,,0.00,0.00,0,0,0,0,0,0,0,0,0,0,0,0,0
20200528,08040P,臺股指群益9B售13,2.66,2.91,2.66,2.84,+0.07,2.53,115000,16,325030,0,0,0,0,0,0,63000,52000,11000,11000
20200528,08041P,臺股指群益9B售14,,,,,0.00,0.00,0,0,0,0,0,0,0,0,0,0,0,0,0
20200528,08042P,臺股指群益9B售15,2.99,3.21,2.99,3.21,+0.13,4.22,60000,7,185150,0,0,0,0,0,0,25000,35000,-10000,-10000
20200528,08043P,電子類群益9B售01,2.45,2.55,2.45,2.55,+1.04,68.87,6000,3,14960,0,0,0,0,0,0,0,6000,-6000,-6000
20200528,08044P,臺股指富邦9B售03,1.41,1.43,1.41,1.43,0.00,0.00,280000,2,397600,0,0,0,0,0,0,140000,140000,0,0
20200528,08045P,健策國票9B售01,0.78,0.88,0.78,0.87,+0.06,7.41,191000,11,160030,0,0,0,0,0,0,145000,46000,99000,99000
20200528,08046P,臺股指國票9B售11,,,,,0.00,0.00,0,0,0,0,0,0,0,0,0,0,0,0,0
20200528,08047P,臺股指國票9B售12,2.85,3.11,2.85,3.11,+0.12,4.01,85000,9,250240,0,0,0,0,0,0,71000,14000,57000,57000
20200528,08048P,臺股指國票9B售13,,,,,0.00,0.00,0,0,0,0,0,0,0,0,0,0,0,0,0
20200528,08049P,臺股指國票9B售14,,,,,0.00,0.00,0,0,0,0,0,0,0,0,0,0,0,0,0
20200528,08050P,臺股指國票9B售15,,,,,0.00,0.00,0,0,0,0,0,0,0,0,0,0,0,0,0
20200528,08051P,臺股指國票9B售16,,,,,0.00,0.00,0,0,0,0,0,0,0,0,0,0,0,0,0
20200528,08052P,臺股指國票9B售17,,,,,0.00,0.00,0,0,0,0,0,0,0,0,0,0,0,0,0
20200528,08053P,臺股指國票9B售18,4.01,4.42,4.01,4.37,+0.16,3.8,130000,18,558540,0,0,0,0,0,0,10000,120000,-110000,-110000
20200528,08054P,臺股指國票9B售19,3.52,3.83,3.52,3.79,+0.11,2.99,81000,14,293150,0,0,0,0,0,0,31000,50000,-19000,-19000
20200528,08055P,臺股指國票9B售20,3.35,3.59,3.34,3.59,+0.14,4.06,79000,6,271430,0,0,0,0,0,0,12000,67000,-55000,-55000
20200528,08056P,華通群益9B售06,,,,,0.00,0.00,0,0,0,0,0,0,0,0,0,0,0,0,0
20200528,08057P,京鼎群益9B售01,1.45,1.45,1.44,1.44,0.00,0.00,61000,2,88150,0,0,0,0,0,0,0,61000,-61000,-61000
20200528,08058P,華新科元大9B售10,3.49,3.60,3.49,3.60,+0.09,2.56,73000,4,259500,0,0,0,0,0,0,0,73000,-73000,-73000
20200528,08059P,京鼎元大9B售02,2.67,2.77,2.67,2.77,+0.07,2.59,156000,4,418120,0,0,0,0,0,0,0,156000,-156000,-156000
20200528,08060P,嘉澤元大9B售01,1.94,2.05,1.94,2.04,+0.06,3.03,175000,16,350100,0,0,0,0,0,0,73000,102000,-29000,-29000
20200528,08061P,大毅國票9B售04,1.18,1.21,1.18,1.21,-0.03,-2.42,97000,5,115970,0,0,0,0,0,0,64000,33000,31000,31000
20200528,08062P,華擎國票9B售03,2.44,2.52,2.44,2.52,-0.02,-0.79,215000,10,529200,0,0,0,0,0,0,91000,124000,-33000,-33000
20200528,08063P,立積國票9B售03,1.34,1.38,1.34,1.38,+0.01,0.73,46000,3,62460,0,0,0,0,0,0,15000,31000,-16000,-16000
20200528,08064P,上証2X凱基9C售02,1.50,1.50,1.50,1.50,0.00,0.00,40000,1,60000,0,0,0,0,0,0,0,40000,-40000,-40000
20200528,08065P,瑞昱凱基9B售03,,,,,0.00,0.00,0,0,0,0,0,0,0,0,0,0,0,0,0
20200528,08066P,南亞科凱基9B售04,1.29,1.37,1.27,1.37,-0.02,-1.44,829000,15,1109210,0,0,0,0,0,0,44000,775000,-731000,-731000
20200528,08067P,大立光凱基9B售08,2.23,2.23,2.23,2.23,-0.09,-3.88,26000,1,57980,0,0,0,0,0,0,26000,0,26000,26000
20200528,08068P,宏達電國泰9C售01,1.11,1.23,1.11,1.23,+0.08,6.96,50000,5,57020,0,0,0,0,0,0,26000,24000,2000,2000
20200528,08069P,大立光國泰01售02,1.51,1.51,1.51,1.51,-0.03,-1.95,26000,1,39260,0,0,0,0,0,0,26000,0,26000,26000
20200528,08070P,晶技國泰9C售02,1.00,1.00,1.00,1.00,0.00,0.00,3000,1,3000,0,0,0,0,0,0,0,3000,-3000,-3000
20200528,08071P,臺股指富邦9B售04,1.21,1.27,1.21,1.27,0.00,0.00,5000,2,6110,0,0,0,0,0,0,0,5000,-5000,-5000
20200528,08072P,祥碩永豐9B售03,0.99,0.99,0.92,0.95,-0.06,-5.94,2136000,53,2040510,0,0,0,0,0,0,1568000,563000,1005000,1005000
20200528,08073P,台灣50麥證9C售01,,,,,0.00,0.00,0,0,0,0,0,0,0,0,0,0,0,0,0
20200528,08074P,緯穎元富9B售02,2.24,2.35,2.24,2.35,+0.06,2.62,115000,8,264660,0,0,0,0,0,0,11000,104000,-93000,-93000
20200528,08075P,聯電群益9C售01,1.15,1.15,1.12,1.14,-0.03,-2.56,243000,7,276090,0,0,0,0,0,0,100000,143000,-43000,-43000
20200528,08076P,國巨群益9C售05,2.08,2.08,2.08,2.08,-0.03,-1.42,10000,1,20800,0,0,0,0,0,0,10000,0,10000,10000
20200528,08077P,亞德客國票9B售02,1.26,1.40,1.24,1.37,+0.08,6.2,285000,11,384980,0,0,0,0,0,0,30000,255000,-225000,-225000
20200528,08078P,聯發科國票9B售04,,,,,0.00,0.00,0,0,0,0,0,0,0,0,0,0,0,0,0
20200528,08079P,宏達電國票9B售03,1.23,1.28,1.23,1.28,+0.14,12.28,119000,6,147540,0,0,0,0,0,0,0,119000,-119000,-119000
20200528,08080P,祥碩國票9B售03,1.00,1.02,0.95,0.98,-0.06,-5.77,481000,12,476390,0,0,0,0,0,0,244000,237000,7000,7000
20200528,08081P,台灣50元大9B售20,,,,,0.00,0.00,0,0,0,0,0,0,0,0,0,0,0,0,0
20200528,08082P,台灣50元大9B售21,,,,,0.00,0.00,0,0,0,0,0,0,0,0,0,0,0,0,0
20200528,08083P,健策元大9C售05,1.19,1.25,1.19,1.25,+0.02,1.63,107000,19,132350,0,0,0,0,0,0,69000,38000,31000,31000
20200528,08084P,台表科元大9B售06,2.02,2.02,2.00,2.00,+0.17,9.29,199000,4,399000,0,0,0,0,0,0,0,199000,-199000,-199000
20200528,08085P,華通凱基9B售04,1.61,1.63,1.61,1.63,0.00,0.00,30000,2,48700,0,0,0,0,0,0,0,30000,-30000,-30000
20200528,08086P,燿華凱基9B售03,1.61,1.65,1.61,1.65,+0.02,1.23,84000,3,135960,0,0,0,0,0,0,66000,18000,48000,48000
20200528,08087P,聯發科凱基9B售12,2.08,2.08,2.08,2.08,+0.04,1.96,10000,1,20800,0,0,0,0,0,0,10000,0,10000,10000
20200528,08088P,義隆凱基9B售03,1.09,1.10,1.09,1.10,-0.04,-3.51,666000,5,732580,0,0,0,0,0,0,0,666000,-666000,-666000
20200528,08089P,嘉澤凱基9B售03,1.12,1.17,1.12,1.17,+0.06,5.41,304000,8,351360,0,0,0,0,0,0,16000,288000,-272000,-272000
20200528,08090P,嘉澤統一9B售01,0.80,0.81,0.80,0.81,0.00,0.00,50000,3,40200,0,0,0,0,0,0,30000,20000,10000,10000
20200528,08091P,A50正2元富9B售02,1.98,1.98,1.98,1.98,0.00,0.00,10000,1,19800,0,0,0,0,0,0,0,10000,-10000,-10000
20200528,08092P,仁寶元富9B售02,2.17,2.26,2.17,2.26,+0.10,4.63,223000,9,490100,0,0,0,0,0,0,28000,195000,-167000,-167000
20200528,08093P,英業達元富9B售02,2.18,2.27,2.18,2.25,+0.02,0.9,134000,19,296750,0,0,0,0,0,0,76000,58000,18000,18000
20200528,08094P,華新科元富9B售05,1.47,1.52,1.47,1.52,+0.03,2.01,202000,3,297940,0,0,0,0,0,0,0,202000,-202000,-202000
20200528,08095P,大立光元富9B售03,2.72,2.92,2.72,2.92,+0.10,3.55,494000,14,1409520,0,0,0,0,0,0,121000,373000,-252000,-252000
20200528,08096P,大立光元富9B售04,3.34,3.53,3.34,3.53,+0.06,1.73,168000,10,582610,0,0,0,0,0,0,77000,91000,-14000,-14000
20200528,08097P,嘉澤永豐9B售03,,,,,0.00,0.00,0,0,0,0,0,0,0,0,0,0,0,0,0
20200528,08098P,大立光凱基9B售09,1.35,1.35,1.34,1.35,-0.03,-2.17,71000,3,95550,0,0,0,0,0,0,71000,0,71000,71000
20200528,08099P,聯發科中信9B售04,0.62,0.64,0.62,0.63,+0.01,1.61,538000,10,339910,0,0,0,0,0,0,503000,35000,468000,468000
20200528,08101P,超眾群益9B售02,2.14,2.14,2.12,2.12,0.00,0.00,30000,2,64160,0,0,0,0,0,0,30000,0,30000,30000
20200528,08102P,台灣50元大9B售22,,,,,0.00,0.00,0,0,0,0,0,0,0,0,0,0,0,0,0
20200528,08103P,台灣50元大9B售23,,,,,0.00,0.00,0,0,0,0,0,0,0,0,0,0,0,0,0
20200528,08104P,晶技元大9B售06,2.38,2.41,2.38,2.41,+0.02,0.84,57000,2,137160,0,0,0,0,0,0,0,57000,-57000,-57000
20200528,08105P,景碩元大9B售01,,,,,0.00,0.00,0,0,0,0,0,0,0,0,0,0,0,0,0
20200528,08106P,聯發科統一9B售09,0.73,0.78,0.73,0.78,0.00,0.00,55000,4,41200,0,0,0,0,0,0,20000,35000,-15000,-15000
20200528,08107P,聯發科統一9B售10,,,,,0.00,0.00,0,0,0,0,0,0,0,0,0,0,0,0,0
20200528,08108P,聯發科元富9B售03,2.24,2.30,2.22,2.22,0.00,0.00,329000,9,754490,0,0,0,0,0,0,0,329000,-329000,-329000
20200528,08109P,台灣50台新9C售04,,,,,0.00,0.00,0,0,0,0,0,0,0,0,0,0,0,0,0
20200528,08110P,臺股指中信01售05,1.38,1.38,1.38,1.38,+0.02,1.47,10000,1,13800,0,0,0,0,0,0,0,10000,-10000,-10000
20200528,08111P,臺股指中信01售06,1.01,1.04,1.01,1.04,+0.02,1.96,364000,10,368450,0,0,0,0,0,0,10000,354000,-344000,-344000
20200528,08112P,臺股指中信01售07,1.99,2.08,1.98,2.08,+0.07,3.48,86000,7,173980,0,0,0,0,0,0,3000,83000,-80000,-80000
20200528,08113P,台灣50凱基02售04,,,,,0.00,0.00,0,0,0,0,0,0,0,0,0,0,0,0,0
20200528,08114P,國巨凱基9B售11,1.58,1.58,1.57,1.57,0.00,0.00,70000,2,110090,0,0,0,0,0,0,0,70000,-70000,-70000
20200528,08115P,聯發科凱基9B售13,3.26,3.27,3.26,3.27,0.00,0.00,44000,3,143840,0,0,0,0,0,0,0,44000,-44000,-44000
20200528,08116P,臺股指凱基9B售17,,,,,0.00,0.00,0,0,0,0,0,0,0,0,0,0,0,0,0
20200528,08117P,聯發科元富9B售04,2.17,2.28,2.17,2.28,+0.05,2.24,107000,5,235330,0,0,0,0,0,0,99000,8000,91000,91000
20200528,08118P,嘉澤元富9B售02,1.81,1.90,1.81,1.90,+0.09,4.97,315000,11,583770,0,0,0,0,0,0,111000,204000,-93000,-93000
20200528,08119P,南亞科統一9C售03,0.91,0.95,0.91,0.95,0.00,0.00,153000,4,139390,0,0,0,0,0,0,0,153000,-153000,-153000
20200528,08120P,南亞科國票9C售01,2.45,2.45,2.45,2.45,0.00,0.00,1000,1,2450,0,0,0,0,0,0,0,1000,-1000,-1000
20200528,08121P,聯發科國票9B售05,,,,,0.00,0.00,0,0,0,0,0,0,0,0,0,0,0,0,0
20200528,08122P,晶技國票9C售01,2.25,2.29,2.25,2.29,0.00,0.00,118000,4,269460,0,0,0,0,0,0,0,118000,-118000,-118000
20200528,08123P,台表科國票9C售01,2.74,2.89,2.74,2.83,+0.07,2.54,420000,14,1180360,0,0,0,0,0,0,174000,246000,-72000,-72000
20200528,08124P,臻鼎群益9B售02,1.76,1.84,1.76,1.84,+0.04,2.22,284000,6,504240,0,0,0,0,0,0,110000,174000,-64000,-64000
20200528,08125P,聯茂群益9B售02,1.46,1.46,1.46,1.46,-0.01,-0.68,35000,2,51100,0,0,0,0,0,0,35000,35000,0,0
20200528,08126P,臺指反元大02售15,,,,,0.00,0.00,0,0,0,0,0,0,0,0,0,0,0,0,0
20200528,08127P,聯發科元大9B售21,1.90,1.90,1.88,1.88,+0.04,2.17,52000,2,98760,0,0,0,0,0,0,0,52000,-52000,-52000
20200528,08128P,聯發科元大9B售22,2.34,2.42,2.34,2.37,+0.05,2.16,62000,5,149540,0,0,0,0,0,0,2000,60000,-58000,-58000
20200528,08129P,聯發科元大9B售23,3.65,3.72,3.64,3.64,+0.08,2.25,82000,5,301340,0,0,0,0,0,0,0,82000,-82000,-82000
20200528,08130P,義隆元大9B售05,2.27,2.30,2.27,2.30,-0.10,-4.17,21000,3,48150,0,0,0,0,0,0,0,21000,-21000,-21000
20200528,08131P,立積元大9B售02,,,,,0.00,0.00,0,0,0,0,0,0,0,0,0,0,0,0,0
20200528,08132P,南六元大9B售05,2.26,2.29,2.19,2.28,+0.02,0.88,521000,40,1173370,0,0,0,0,0,0,369000,111000,258000,258000
20200528,08133P,臺股指元大9B售39,,,,,0.00,0.00,0,0,0,0,0,0,0,0,0,0,0,0,0
20200528,08134P,臺股指元大9B售40,,,,,0.00,0.00,0,0,0,0,0,0,0,0,0,0,0,0,0
20200528,08135P,玉晶光國泰01售02,1.06,1.08,1.04,1.08,-0.01,-0.92,80000,5,84740,0,0,0,0,0,0,63000,80000,-17000,-17000
20200528,08136P,祥碩國泰01售01,1.22,1.25,1.16,1.21,-0.05,-3.97,1815000,34,2192990,0,0,0,0,0,0,1511000,1312000,199000,199000
20200528,08137P,台灣50元大9B售24,,,,,0.00,0.00,0,0,0,0,0,0,0,0,0,0,0,0,0
20200528,08138P,台灣50元大9B售25,,,,,0.00,0.00,0,0,0,0,0,0,0,0,0,0,0,0,0
20200528,08139P,華新科元大9B售12,2.31,2.31,2.31,2.31,0.00,0.00,52000,2,120120,0,0,0,0,0,0,0,52000,-52000,-52000
20200528,08140P,祥碩元大9B售07,2.27,2.32,2.24,2.24,-0.07,-3.03,215000,7,489100,0,0,0,0,0,0,200000,15000,185000,185000
20200528,08141P,鴻海凱基9B售09,1.99,1.99,1.99,1.99,-0.04,-1.97,40000,2,79600,0,0,0,0,0,0,40000,0,40000,40000
20200528,08142P,國巨凱基9B售13,2.33,2.33,2.33,2.33,0.00,0.00,13000,1,30290,0,0,0,0,0,0,0,13000,-13000,-13000
20200528,08143P,聯發科凱基9C售05,,,,,0.00,0.00,0,0,0,0,0,0,0,0,0,0,0,0,0
20200528,08144P,臺股指凱基02售03,,,,,0.00,0.00,0,0,0,0,0,0,0,0,0,0,0,0,0
20200528,08145P,台灣50群益9B售11,3.55,3.55,3.55,3.55,+0.07,2.01,1000,1,3550,0,0,0,0,0,0,0,1000,-1000,-1000
20200528,08146P,台積電群益9B售08,,,,,0.00,0.00,0,0,0,0,0,0,0,0,0,0,0,0,0
20200528,08147P,聯發科群益9B售10,2.47,2.47,2.46,2.46,+0.05,2.07,20000,2,49300,0,0,0,0,0,0,10000,10000,0,0
20200528,08148P,長榮航群益9B售03,,,,,0.00,0.00,0,0,0,0,0,0,0,0,0,0,0,0,0
20200528,08149P,祥碩群益9B售07,1.09,1.09,1.02,1.07,-0.04,-3.6,105000,3,112240,0,0,0,0,0,0,0,105000,-105000,-105000
20200528,08150P,立積國票9C售01,2.94,2.94,2.94,2.94,0.00,0.00,25000,3,73500,0,0,0,0,0,0,0,25000,-25000,-25000
20200528,08151P,聯發科統一9B售11,,,,,0.00,0.00,0,0,0,0,0,0,0,0,0,0,0,0,0
20200528,08152P,祥碩統一9B售02,0.86,0.86,0.84,0.84,-0.04,-4.55,92000,4,78800,0,0,0,0,0,0,71000,21000,50000,50000
20200528,08153P,台表科統一9B售01,0.97,1.04,0.97,1.02,0.00,0.00,130000,14,132900,0,0,0,0,0,0,0,130000,-130000,-130000
20200528,08154P,上銀元富9B售04,1.31,1.41,1.31,1.40,0.00,0.00,146000,4,204600,0,0,0,0,0,0,0,146000,-146000,-146000
20200528,08155P,聯發科元富9B售05,2.53,2.58,2.53,2.58,0.00,0.00,38000,2,97690,0,0,0,0,0,0,0,38000,-38000,-38000
20200528,08156P,大立光元富9B售05,2.50,2.61,2.50,2.61,+0.08,3.16,46000,3,119150,0,0,0,0,0,0,7000,39000,-32000,-32000
20200528,08157P,大立光元富9B售06,2.70,2.87,2.70,2.87,+0.17,6.3,135000,6,380950,0,0,0,0,0,0,66000,69000,-3000,-3000
20200528,08158P,嘉澤元富9B售03,1.52,1.58,1.52,1.58,+0.07,4.64,223000,7,345570,0,0,0,0,0,0,43000,180000,-137000,-137000
20200528,08159P,日月光元富9B售01,2.96,3.02,2.95,3.01,-0.02,-0.66,118000,6,349080,0,0,0,0,0,0,32000,86000,-54000,-54000
20200528,08160P,茂林元富9B售03,2.31,2.41,2.31,2.36,0.00,0.00,301000,11,705000,0,0,0,0,0,0,185000,116000,69000,69000
20200528,08161P,台表科元富9B售02,1.22,1.25,1.17,1.24,0.00,0.00,488000,14,602430,0,0,0,0,0,0,219000,269000,-50000,-50000
20200528,08162P,台灣50台新9C售06,,,,,0.00,0.00,0,0,0,0,0,0,0,0,0,0,0,0,0
20200528,08165P,台表科永豐9B售02,,,,,0.00,0.00,0,0,0,0,0,0,0,0,0,0,0,0,0
20200528,08166P,國巨中信9B售05,,,,,0.00,0.00,0,0,0,0,0,0,0,0,0,0,0,0,0
20200528,08167P,台積電兆豐9B售04,0.95,0.95,0.95,0.95,0.00,0.00,18000,1,17100,0,0,0,0,0,0,0,18000,-18000,-18000
20200528,08168P,金像電群益9B售03,1.51,1.55,1.51,1.54,-0.01,-0.65,22000,4,33760,0,0,0,0,0,0,12000,10000,2000,2000
20200528,08169P,台光電群益9B售04,2.16,2.25,2.13,2.25,+0.14,6.64,184000,6,401380,0,0,0,0,0,0,130000,54000,76000,76000
20200528,08170P,緯穎群益9B售03,2.21,2.25,2.21,2.25,0.00,0.00,54000,3,119860,0,0,0,0,0,0,0,54000,-54000,-54000
20200528,08171P,嘉澤國票9C售01,2.65,2.73,2.63,2.71,+0.07,2.65,37000,6,98900,0,0,0,0,0,0,1000,36000,-35000,-35000
20200528,08172P,台積電凱基03售02,,,,,0.00,0.00,0,0,0,0,0,0,0,0,0,0,0,0,0
20200528,08173P,金像電凱基9B售02,1.00,1.03,1.00,1.03,-0.01,-0.96,14000,3,14120,0,0,0,0,0,0,12000,2000,10000,10000
20200528,08174P,國巨統一9B售17,,,,,0.00,0.00,0,0,0,0,0,0,0,0,0,0,0,0,0
20200528,08175P,金像電統一9B售02,0.95,0.99,0.95,0.98,+0.06,6.52,149000,5,144220,0,0,0,0,0,0,149000,0,149000,149000
20200528,08176P,國巨元大9B售20,2.08,2.08,2.08,2.08,0.00,0.00,1000,1,2080,0,0,0,0,0,0,0,1000,-1000,-1000
20200528,08177P,金像電元大9B售02,2.13,2.25,2.13,2.25,+0.07,3.21,57000,3,123530,0,0,0,0,0,0,6000,51000,-45000,-45000
20200528,08178P,南亞科元大9B售01,1.99,1.99,1.96,1.98,0.00,0.00,75000,5,148190,0,0,0,0,0,0,0,75000,-75000,-75000
20200528,08179P,華新科元大9B售13,,,,,0.00,0.00,0,0,0,0,0,0,0,0,0,0,0,0,0
20200528,08180P,聯發科國泰01售05,1.30,1.30,1.30,1.30,0.00,0.00,13000,1,16900,0,0,0,0,0,0,0,13000,-13000,-13000
20200528,08181P,華新科國泰9C售02,,,,,0.00,0.00,0,0,0,0,0,0,0,0,0,0,0,0,0
20200528,08182P,金像電永豐9B售01,,,,,0.00,0.00,0,0,0,0,0,0,0,0,0,0,0,0,0
20200528,08183P,聯發科永豐9B售04,,,,,0.00,0.00,0,0,0,0,0,0,0,0,0,0,0,0,0
20200528,08184P,可成永豐9B售03,0.86,0.86,0.86,0.86,0.00,0.00,20000,1,17200,0,0,0,0,0,0,0,20000,-20000,-20000
20200528,08185P,華新科永豐9B售01,,,,,0.00,0.00,0,0,0,0,0,0,0,0,0,0,0,0,0
20200528,08186P,泰碩永豐9B售03,,,,,0.00,0.00,0,0,0,0,0,0,0,0,0,0,0,0,0
20200528,08187P,大毅群益9B售04,,,,,0.00,0.00,0,0,0,0,0,0,0,0,0,0,0,0,0
20200528,08188P,群創群益9B售04,,,,,0.00,0.00,0,0,0,0,0,0,0,0,0,0,0,0,0
20200528,08189P,超眾群益9B售04,,,,,0.00,0.00,0,0,0,0,0,0,0,0,0,0,0,0,0
20200528,08190P,宏達電元富9B售04,,,,,0.00,0.00,0,0,0,0,0,0,0,0,0,0,0,0,0
20200528,08191P,鴻海台新9B售03,,,,,0.00,0.00,0,0,0,0,0,0,0,0,0,0,0,0,0
20200528,08192P,大毅國票9B售05,,,,,0.00,0.00,0,0,0,0,0,0,0,0,0,0,0,0,0
20200528,08193P,同欣電國票9C售02,,,,,0.00,0.00,0,0,0,0,0,0,0,0,0,0,0,0,0
20200528,08194P,同欣電國票9C售03,,,,,0.00,0.00,0,0,0,0,0,0,0,0,0,0,0,0,0
20200528,08195P,臺指反元大03售01,,,,,0.00,0.00,0,0,0,0,0,0,0,0,0,0,0,0,0
20200528,08196P,上銀元大9B售07,,,,,0.00,0.00,0,0,0,0,0,0,0,0,0,0,0,0,0
20200528,08197P,聯發科元大9B售24,,,,,0.00,0.00,0,0,0,0,0,0,0,0,0,0,0,0,0
20200528,08198P,聯發科元大9B售25,1.89,1.91,1.89,1.91,-0.14,-6.83,25000,2,47350,0,0,0,0,0,0,0,25000,-25000,-25000
20200528,08199P,大毅元大9B售02,1.48,1.48,1.48,1.48,+0.08,5.71,10000,1,14800,0,0,0,0,0,0,0,10000,-10000,-10000
20200528,08200P,祥碩元大9B售08,,,,,0.00,0.00,0,0,0,0,0,0,0,0,0,0,0,0,0
20200528,08201P,祥碩元大9B售09,1.57,1.57,1.55,1.56,-0.04,-2.5,16000,8,25020,0,0,0,0,0,0,0,16000,-16000,-16000
20200528,08202P,台表科國泰01售04,,,,,0.00,0.00,0,0,0,0,0,0,0,0,0,0,0,0,0
20200528,08203P,同欣電永豐9B售04,,,,,0.00,0.00,0,0,0,0,0,0,0,0,0,0,0,0,0
20200528,08217P,T50反1凱基96售02,,,,,0.00,0.00,0,0,0,0,0,0,0,0,0,0,0,0,0
20200528,08218P,滬深2X凱基96售01,,,,,0.00,0.00,0,0,0,0,0,0,0,0,0,0,0,0,0
20200528,08484P,台灣50中信96售01,,,,,0.00,0.00,0,0,0,0,0,0,0,0,0,0,0,0,0
20200528,08506P,台灣50中信96售02,,,,,0.00,0.00,0,0,0,0,0,0,0,0,0,0,0,0,0
20200528,08525P,台灣50凱基96售02,,,,,0.00,0.00,0,0,0,0,0,0,0,0,0,0,0,0,0
20200528,08539P,元油2X國票99售01,,,,,0.00,0.00,0,0,0,0,0,0,0,0,0,0,0,0,0
20200528,08570P,台灣50凱基96售03,,,,,0.00,0.00,0,0,0,0,0,0,0,0,0,0,0,0,0
20200528,08602P,台灣50凱基96售04,,,,,0.00,0.00,0,0,0,0,0,0,0,0,0,0,0,0,0
20200528,08609P,世紀鋼永豐9C售03,,,,,0.00,0.00,0,0,0,0,0,0,0,0,0,0,0,0,0
20200528,08625P,台灣50凱基96售05,,,,,0.00,0.00,0,0,0,0,0,0,0,0,0,0,0,0,0
20200528,08637P,台灣50中信96售03,0.28,0.45,0.28,0.45,0.00,0.00,124000,6,37330,0,0,0,0,0,0,112000,0,112000,112000
20200528,08653P,台灣50凱基96售07,,,,,0.00,0.00,0,0,0,0,0,0,0,0,0,0,0,0,0
20200528,08663P,台灣50元大96售01,0.20,0.22,0.20,0.22,0.00,0.00,5000,2,1060,0,0,0,0,0,0,0,0,0,0
20200528,08671P,友訊國票01售01,,,,,0.00,0.00,0,0,0,0,0,0,0,0,0,0,0,0,0
20200528,08674P,嘉晶元富07售02,0.25,0.29,0.25,0.29,0.00,0.00,177000,5,50650,0,0,0,0,0,0,167000,167000,0,0
20200528,08679P,台灣50元大01售15,,,,,0.00,0.00,0,0,0,0,0,0,0,0,0,0,0,0,0
20200528,08714P,華碩元富01售03,,,,,0.00,0.00,0,0,0,0,0,0,0,0,0,0,0,0,0
20200528,08801P,聯發科元大01售13,,,,,0.00,0.00,0,0,0,0,0,0,0,0,0,0,0,0,0
20200528,08818P,台灣50元大97售01,0.09,0.16,0.09,0.16,+0.04,33.33,374000,16,45770,0,0,0,0,0,0,124000,0,124000,124000
20200528,08852P,台灣50台新01售01,0.72,0.88,0.72,0.88,+0.13,17.33,62000,6,52510,0,0,0,0,0,0,53000,0,53000,53000
20200528,1101,台泥,42.85,42.90,42.35,42.35,-0.50,-1.17,16239519,7015,691419332,5845906,11176501,-5330595,0,430000,-430000,61000,138000,-77000,-5837595
20200528,1101B,台泥乙特,54.60,54.70,54.60,54.70,+0.10,0.18,7000,7,382300,0,0,0,0,0,0,1000,0,1000,1000
20200528,1102,亞泥,43.80,43.90,43.25,43.25,-0.45,-1.03,6713740,2756,292098386,1572381,6197000,-4624619,97000,0,97000,52000,94000,-42000,-4569619
20200528,1103,嘉泥,16.35,17.15,16.35,16.75,+0.45,2.76,6031673,1984,101995313,629000,783000,-154000,0,0,0,0,0,0,-154000
20200528,1104,環泥,17.85,17.85,17.65,17.70,0.00,0.00,216563,129,3836911,17000,92000,-75000,0,0,0,0,0,0,-75000
20200528,1108,幸福,9.01,9.01,8.93,8.95,-0.05,-0.56,389995,131,3494943,0,71000,-71000,0,0,0,0,0,0,-71000
20200528,1109,信大,17.60,17.75,17.55,17.60,0.00,0.00,173000,86,3053950,26000,27000,-1000,0,0,0,0,0,0,-1000
20200528,1110,東泥,16.20,16.30,15.85,16.30,+0.20,1.24,50000,38,804050,4000,19000,-15000,0,0,0,0,0,0,-15000
20200528,1201,味全,22.20,22.45,22.10,22.15,+0.05,0.23,1425176,560,31703792,217000,156000,61000,0,0,0,56000,0,56000,117000
20200528,1203,味王,28.30,28.35,28.00,28.00,-0.30,-1.06,50932,57,1432896,1000,27000,-26000,0,0,0,0,0,0,-26000
20200528,1210,大成,44.15,44.50,43.75,43.75,-0.40,-0.91,2094126,1207,91985480,386000,570568,-184568,0,223000,-223000,30000,0,30000,-377568
20200528,1213,大飲,,,,,0.00,0.00,335,5,1877,0,0,0,0,0,0,0,0,0,0
20200528,1215,卜蜂,72.50,72.80,71.60,72.00,-0.30,-0.41,1099700,863,79438700,208000,251368,-43368,0,0,0,2000,17000,-15000,-58368
20200528,1216,統一,72.80,72.80,71.50,71.50,-0.90,-1.24,8364435,3069,601343520,5423641,7471346,-2047705,0,25000,-25000,4000,112000,-108000,-2180705
20200528,1217,愛之味,7.09,7.10,7.02,7.03,-0.02,-0.28,1330417,427,9377855,204000,207000,-3000,0,0,0,0,0,0,-3000
20200528,1218,泰山,24.60,24.60,24.00,24.25,-0.20,-0.82,1185479,616,28785912,267000,186000,81000,0,0,0,5000,0,5000,86000
20200528,1219,福壽,19.00,19.05,18.95,19.05,+0.05,0.26,48461,32,919880,0,11000,-11000,0,0,0,0,0,0,-11000
20200528,1220,台榮,10.85,10.90,10.80,10.80,-0.05,-0.46,152163,78,1648282,0,27000,-27000,0,0,0,0,0,0,-27000
20200528,1225,福懋油,37.00,37.50,36.90,37.05,+0.25,0.68,107534,81,4002133,6000,29000,-23000,0,0,0,0,0,0,-23000
20200528,1227,佳格,66.10,66.60,65.10,65.10,-0.90,-1.36,1007763,727,66020669,322139,893653,-571514,0,0,0,20000,0,20000,-551514
20200528,1229,聯華,41.90,41.90,41.55,41.65,-0.15,-0.36,2139568,1286,89266770,170000,869686,-699686,0,0,0,11000,111000,-100000,-799686
20200528,1231,聯華食,42.00,42.00,41.35,41.70,-0.20,-0.48,276952,163,11569346,14000,52000,-38000,0,0,0,0,0,0,-38000
20200528,1232,大統益,118.50,119.00,118.00,119.00,0.00,0.00,27622,38,3274640,2000,6000,-4000,0,0,0,0,0,0,-4000
20200528,1233,天仁,35.80,36.00,35.80,35.85,-0.05,-0.14,20089,19,720754,5000,4000,1000,0,0,0,0,0,0,1000
20200528,1234,黑松,32.10,32.30,31.85,32.00,-0.20,-0.62,76863,59,2467991,0,50000,-50000,0,0,0,0,0,0,-50000
20200528,1235,興泰,25.50,26.30,25.30,25.60,+0.10,0.39,8201,9,210505,0,0,0,0,0,0,0,0,0,0
20200528,1236,宏亞,12.00,12.00,11.80,11.90,-0.05,-0.42,38510,36,459818,0,6000,-6000,0,0,0,0,0,0,-6000
20200528,1256,鮮活果汁-KY,206.00,208.00,205.50,206.00,-1.00,-0.48,54347,102,11217829,2000,12000,-10000,0,0,0,0,0,0,-10000
20200528,1301,台塑,85.30,85.70,83.50,83.80,-1.40,-1.64,12712233,6301,1074039137,5193693,11054844,-5861151,585000,0,585000,81000,168000,-87000,-5363151
20200528,1303,南亞,63.60,63.90,62.00,62.50,-0.60,-0.95,4854829,2056,304828072,2921616,3823537,-901921,0,0,0,2000,82000,-80000,-981921
20200528,1304,台聚,12.05,12.10,11.90,12.00,+0.05,0.42,1291883,489,15502996,239000,369000,-130000,0,0,0,0,0,0,-130000
20200528,1305,華夏,19.55,19.60,19.15,19.20,-0.25,-1.29,2661393,1018,51482977,185000,1054519,-869519,0,0,0,3000,0,3000,-866519
20200528,1307,三芳,23.80,24.15,23.30,23.50,-0.25,-1.05,983331,683,23233807,39000,473000,-434000,0,0,0,0,0,0,-434000
20200528,1308,亞聚,17.60,17.60,17.40,17.40,-0.20,-1.14,1328910,534,23202284,48000,621000,-573000,0,0,0,0,0,0,-573000
20200528,1309,台達化,12.65,13.40,12.60,13.40,+0.85,6.77,11893752,3309,154426833,1328000,721000,607000,0,0,0,0,0,0,607000
20200528,1310,台苯,16.30,16.45,16.25,16.30,0.00,0.00,1159471,537,18922271,45000,538000,-493000,0,0,0,0,0,0,-493000
20200528,1312,國喬,14.50,14.50,14.15,14.15,-0.25,-1.74,5556984,1506,79441507,718983,2715000,-1996017,0,0,0,24000,19000,5000,-1991017
20200528,1312A,國喬特,,,,,0.00,0.00,0,0,0,0,0,0,0,0,0,0,0,0,0
20200528,1313,聯成,9.42,9.50,9.30,9.32,-0.08,-0.85,778074,295,7311185,97000,337000,-240000,0,0,0,0,0,0,-240000
20200528,1314,中石化,8.35,8.36,8.22,8.23,-0.08,-0.96,10981121,2691,90899948,1295000,3076000,-1781000,0,0,0,17000,10900,6100,-1774900
20200528,1315,達新,56.50,57.70,56.00,56.10,0.00,0.00,969850,595,55025615,203000,85000,118000,0,0,0,8000,0,8000,126000
20200528,1316,上曜,10.90,11.00,10.90,10.90,0.00,0.00,321586,123,3521765,29000,44000,-15000,0,0,0,0,0,0,-15000
20200528,1319,東陽,38.15,38.15,37.10,37.20,-0.60,-1.59,1346345,872,50529325,308000,347528,-39528,0,200000,-200000,55000,30000,25000,-214528
20200528,1321,大洋,31.10,31.30,30.80,30.95,0.00,0.00,225522,126,6991158,17000,36000,-19000,0,0,0,0,0,0,-19000
20200528,1323,永裕,33.20,33.40,33.10,33.40,+0.20,0.6,224115,99,7449756,45000,40000,5000,0,0,0,0,0,0,5000
20200528,1324,地球,9.79,9.89,9.70,9.80,+0.05,0.51,96450,34,945199,0,0,0,0,0,0,0,0,0,0
20200528,1325,恆大,163.00,178.00,163.00,170.00,+5.00,3.03,2112801,1170,358669869,12000,278000,-266000,0,340000,-340000,68000,15000,53000,-553000
20200528,1326,台化,72.90,73.20,71.70,72.00,-0.60,-0.83,5010710,2428,362416285,1639041,3655685,-2016644,0,0,0,18000,71000,-53000,-2069644
20200528,1337,再生-KY,5.20,5.30,5.16,5.18,+0.01,0.19,1198020,336,6292533,52000,114000,-62000,0,0,0,0,0,0,-62000
20200528,1338,廣華-KY,51.70,52.20,51.10,51.20,-0.50,-0.97,205002,165,10600104,64000,53000,11000,0,0,0,5000,0,5000,16000
20200528,1339,昭輝,44.20,44.65,43.50,43.50,-0.50,-1.14,625000,458,27561700,51000,74000,-23000,0,0,0,3000,0,3000,-20000
20200528,1340,勝悅-KY,10.35,10.40,10.10,10.10,-0.20,-1.94,238615,167,2443966,16000,86000,-70000,0,0,0,0,0,0,-70000
20200528,1341,富林-KY,61.30,61.30,60.50,61.00,-0.30,-0.49,18024,19,1094977,0,0,0,0,0,0,0,0,0,0
20200528,1402,遠東新,27.45,27.45,27.00,27.10,-0.20,-0.73,9839571,3765,267344500,3125690,6079000,-2953310,1086000,0,1086000,160000,26000,134000,-1733310
20200528,1409,新纖,11.10,11.25,10.95,10.95,-0.15,-1.35,2879377,846,31965850,373000,758000,-385000,0,0,0,0,0,0,-385000
20200528,1410,南染,30.70,30.70,30.45,30.50,+0.10,0.33,24340,14,742516,19000,5000,14000,0,0,0,0,0,0,14000
20200528,1413,宏洲,7.39,7.39,7.12,7.12,+0.02,0.28,168001,56,1214295,0,9000,-9000,0,0,0,0,0,0,-9000
20200528,1414,東和,6.63,6.70,6.57,6.57,0.00,0.00,422142,119,2801809,0,18000,-18000,0,0,0,0,0,0,-18000
20200528,1416,廣豐,11.55,11.55,11.30,11.35,+0.05,0.44,271958,136,3111766,0,12000,-12000,0,0,0,1000,0,1000,-11000
20200528,1417,嘉裕,8.18,8.23,8.10,8.18,+0.03,0.37,634617,231,5178340,85000,99000,-14000,0,0,0,0,0,0,-14000
20200528,1418,東華,5.53,5.75,5.53,5.75,0.00,0.00,3000,2,16810,0,0,0,0,0,0,0,0,0,0
20200528,1419,新紡,40.80,40.85,39.00,39.75,-1.10,-2.69,62033,61,2465403,3000,52000,-49000,0,0,0,0,0,0,-49000
20200528,1423,利華,10.80,10.80,10.75,10.80,-0.05,-0.46,34377,21,370619,0,0,0,0,0,0,0,0,0,0
20200528,1432,大魯閣,5.98,5.98,5.75,5.85,-0.03,-0.51,119038,58,695440,0,6000,-6000,0,0,0,0,0,0,-6000
20200528,1434,福懋,34.80,34.90,34.25,34.60,-0.15,-0.43,2037992,1381,70533018,560900,1168000,-607100,0,0,0,2000,1000,1000,-606100
20200528,1435,中福,8.28,8.32,8.18,8.24,+0.01,0.12,171212,95,1410307,0,17000,-17000,0,0,0,0,0,0,-17000
20200528,1436,華友聯,37.70,37.70,36.85,37.20,-0.10,-0.27,59062,50,2199851,0,20000,-20000,0,0,0,0,0,0,-20000
20200528,1437,勤益控,20.75,20.90,20.65,20.70,0.00,0.00,141070,70,2931492,13000,44000,-31000,0,0,0,0,0,0,-31000
20200528,1438,裕豐,12.25,12.50,11.95,12.40,0.00,0.00,19000,13,235100,2000,0,2000,0,0,0,0,0,0,2000
20200528,1439,中和,36.80,36.95,36.15,36.25,-0.25,-0.68,828454,440,30287194,210000,115000,95000,0,0,0,0,0,0,95000
20200528,1440,南紡,9.20,9.38,9.11,9.15,+0.06,0.66,2061803,775,19081871,384000,504000,-120000,0,0,0,0,0,0,-120000
20200528,1441,大東,7.11,7.18,7.07,7.07,+0.02,0.28,81007,67,578890,0,5000,-5000,0,0,0,0,0,0,-5000
20200528,1442,名軒,17.85,17.90,17.50,17.65,-0.25,-1.4,318125,119,5642761,21000,36000,-15000,0,0,0,3000,0,3000,-12000
20200528,1443,立益,9.15,9.15,9.15,9.15,+0.05,0.55,10544,5,96396,0,0,0,0,0,0,0,0,0,0
20200528,1444,力麗,7.15,7.67,7.12,7.67,+0.69,9.89,10197728,1666,77530724,295000,806000,-511000,0,0,0,0,0,0,-511000
20200528,1445,大宇,8.39,8.39,8.29,8.36,+0.06,0.72,91516,35,762881,0,4000,-4000,0,0,0,0,0,0,-4000
20200528,1446,宏和,29.55,29.65,28.95,28.95,-0.25,-0.86,74604,53,2182145,4000,17000,-13000,0,0,0,0,0,0,-13000
20200528,1447,力鵬,5.87,6.15,5.85,5.95,+0.15,2.59,2432453,937,14725862,114000,517664,-403664,0,0,0,0,0,0,-403664
20200528,1449,佳和,16.10,17.60,16.00,17.20,+1.20,7.5,2613157,1081,43615025,398000,137000,261000,0,0,0,0,0,0,261000
20200528,1451,年興,14.80,15.00,14.70,14.95,+0.05,0.34,318222,148,4724057,5000,46000,-41000,0,0,0,0,0,0,-41000
20200528,1452,宏益,17.00,17.20,17.00,17.00,0.00,0.00,308606,148,5274652,12000,37000,-25000,0,0,0,0,0,0,-25000
20200528,1453,大將,7.12,7.15,7.06,7.06,+0.01,0.14,45101,33,320906,4000,2000,2000,0,0,0,0,0,0,2000
20200528,1454,台富,7.89,7.89,7.75,7.86,+0.01,0.13,100827,50,788734,0,43000,-43000,0,0,0,0,0,0,-43000
20200528,1455,集盛,7.10,7.32,7.02,7.06,+0.01,0.14,1913604,695,13679115,445000,550000,-105000,0,0,0,0,0,0,-105000
20200528,1456,怡華,9.97,10.30,9.77,9.77,-0.15,-1.51,115069,61,1151904,5000,2000,3000,0,0,0,4000,0,4000,7000
20200528,1457,宜進,12.00,12.20,11.95,11.95,0.00,0.00,419513,188,5067350,51000,50000,1000,0,0,0,0,0,0,1000
20200528,1459,聯發,7.48,7.48,7.35,7.37,-0.12,-1.6,150973,60,1116402,0,15000,-15000,0,0,0,0,0,0,-15000
20200528,1460,宏遠,8.40,8.43,8.10,8.14,+0.04,0.49,1278733,493,10598265,139000,162000,-23000,0,0,0,0,0,0,-23000
20200528,1463,強盛,12.15,12.15,11.90,11.95,-0.20,-1.65,343466,113,4110195,1000,31000,-30000,0,0,0,0,0,0,-30000
20200528,1464,得力,21.75,21.85,21.25,21.35,-0.30,-1.39,1514700,768,32572398,117000,177000,-60000,0,0,0,2000,19000,-17000,-77000
20200528,1465,偉全,15.30,15.35,15.20,15.20,-0.10,-0.65,75027,44,1147407,0,15000,-15000,0,0,0,0,0,0,-15000
20200528,1466,聚隆,9.13,9.13,9.13,9.13,+0.83,10.0,238882,49,2180991,0,12000,-12000,0,0,0,0,0,0,-12000
20200528,1467,南緯,12.90,13.10,12.30,12.60,-0.40,-3.08,3907162,1665,49372989,248000,157000,91000,0,0,0,0,0,0,91000
20200528,1468,昶和,9.98,9.98,9.58,9.90,-0.07,-0.7,30000,25,294110,2000,16000,-14000,0,0,0,0,0,0,-14000
20200528,1470,大統新創,18.40,18.70,18.40,18.70,-0.10,-0.53,2000,2,37100,0,1000,-1000,0,0,0,0,0,0,-1000
20200528,1471,首利,2.15,2.23,2.11,2.18,+0.05,2.35,88608,31,193414,0,0,0,0,0,0,0,0,0,0
20200528,1472,三洋紡,11.55,11.75,11.25,11.35,-0.05,-0.44,228676,117,2609905,16000,48000,-32000,0,0,0,0,0,0,-32000
20200528,1473,台南,20.15,21.15,20.00,20.25,+0.30,1.5,837262,563,17233291,82000,158000,-76000,0,0,0,0,0,0,-76000
20200528,1474,弘裕,11.10,11.60,10.55,11.60,+0.40,3.57,9936041,3229,109912518,162000,183000,-21000,0,0,0,0,7000,-7000,-28000
20200528,1475,本盟,,,,,0.00,0.00,1,1,14,0,0,0,0,0,0,0,0,0,0
20200528,1476,儒鴻,324.50,327.50,312.00,312.50,-11.50,-3.55,2219249,1948,706271435,270969,742000,-471031,13000,0,13000,57000,81000,-24000,-482031
20200528,1477,聚陽,150.00,150.00,145.00,145.00,-5.00,-3.33,4728558,3446,696244910,1602000,405000,1197000,88000,29000,59000,62000,94000,-32000,1224000
20200528,1503,士電,45.85,45.85,44.55,45.40,-0.35,-0.77,151100,117,6845968,40000,87000,-47000,0,0,0,0,0,0,-47000
20200528,1504,東元,28.45,29.20,28.35,28.40,0.00,0.00,4151113,1724,118673649,485000,1740356,-1255356,0,0,0,130000,283000,-153000,-1408356
20200528,1506,正道,12.10,12.50,12.05,12.20,+0.15,1.24,273192,103,3346423,29000,38000,-9000,0,0,0,0,1000,-1000,-10000
20200528,1507,永大,56.40,56.70,56.00,56.40,+0.10,0.18,113872,94,6425732,14000,86870,-72870,0,0,0,0,0,0,-72870
20200528,1512,瑞利,5.62,5.85,5.62,5.85,+0.27,4.84,232002,84,1341941,0,0,0,0,0,0,0,0,0,0
20200528,1513,中興電,28.20,29.30,28.20,29.20,+1.20,4.29,8860229,4140,256048512,1208000,333238,874762,0,0,0,278000,280000,-2000,872762
20200528,1514,亞力,20.80,21.65,20.80,20.95,+0.25,1.21,6076408,2326,129084323,970000,355000,615000,0,0,0,0,0,0,615000
20200528,1515,力山,80.30,80.50,77.10,77.60,-1.40,-1.77,5203950,3188,410924122,312000,519000,-207000,0,0,0,29000,230000,-201000,-408000
20200528,1516,川飛,13.40,13.40,12.80,13.00,-0.40,-2.99,466200,167,6069569,2000,6000,-4000,0,0,0,0,0,0,-4000
20200528,1517,利奇,8.08,8.17,8.01,8.01,-0.09,-1.11,270239,119,2184575,9000,16000,-7000,0,0,0,0,0,0,-7000
20200528,1519,華城,25.85,26.60,25.65,25.90,+0.10,0.39,1027349,569,26909739,134000,247000,-113000,0,0,0,0,0,0,-113000
20200528,1521,大億,59.50,59.90,59.40,59.40,-0.30,-0.5,36134,27,2152340,0,7000,-7000,0,0,0,0,0,0,-7000
20200528,1522,堤維西,23.95,24.00,23.45,23.45,-0.30,-1.26,501374,253,11892889,73000,115000,-42000,0,0,0,0,14000,-14000,-56000
20200528,1524,耿鼎,8.87,9.00,8.85,8.88,+0.01,0.11,556115,95,4951826,33000,50000,-17000,0,0,0,0,0,0,-17000
20200528,1525,江申,47.50,47.75,46.75,47.00,-0.35,-0.74,82053,56,3877530,3000,6000,-3000,0,0,0,0,0,0,-3000
20200528,1526,日馳,31.70,32.55,30.60,32.00,+0.75,2.4,2845376,1634,90258482,278000,7000,271000,0,0,0,0,0,0,271000
20200528,1527,鑽全,42.35,42.35,40.85,40.95,-0.70,-1.68,806500,548,33627448,99000,200000,-101000,0,0,0,2000,0,2000,-99000
20200528,1528,恩德,8.19,8.70,7.91,7.91,-0.19,-2.35,3107044,1048,25923481,88000,149000,-61000,0,0,0,0,0,0,-61000
20200528,1529,樂士,14.40,14.40,14.00,14.20,0.00,0.00,38337,24,544001,0,9000,-9000,0,0,0,0,0,0,-9000
20200528,1530,亞崴,32.05,32.25,31.80,32.00,-0.05,-0.16,65055,46,2080110,0,10000,-10000,0,0,0,0,0,0,-10000
20200528,1531,高林股,12.75,12.80,12.50,12.50,-0.25,-1.96,95000,39,1205900,0,24000,-24000,0,0,0,2000,0,2000,-22000
20200528,1532,勤美,28.30,28.30,27.75,27.80,-0.30,-1.07,465754,200,13004056,40000,162600,-122600,0,0,0,0,0,0,-122600
20200528,1533,車王電,27.10,27.10,26.70,26.70,-0.15,-0.56,76002,50,2039952,1000,14000,-13000,0,0,0,0,0,0,-13000
20200528,1535,中宇,32.70,32.90,32.70,32.90,+0.30,0.92,6000,6,196700,0,2000,-2000,0,0,0,0,0,0,-2000
20200528,1536,和大,95.60,97.20,94.00,94.70,-0.30,-0.32,1665343,1296,158767285,268000,266000,2000,120000,0,120000,59000,3000,56000,178000
20200528,1537,廣隆,146.00,146.00,144.00,145.00,-0.50,-0.34,112048,105,16263460,3000,29000,-26000,0,0,0,0,0,0,-26000
20200528,1538,正峰新,2.87,2.94,2.80,2.94,+0.26,9.7,141419,62,411677,0,0,0,0,0,0,0,0,0,0
20200528,1539,巨庭,17.30,18.35,17.30,17.60,+0.20,1.15,453000,263,8097000,10000,11000,-1000,0,0,0,0,2000,-2000,-3000
20200528,1540,喬福,16.45,16.60,16.25,16.30,-0.15,-0.91,340101,172,5599116,3000,37000,-34000,0,0,0,0,0,0,-34000
20200528,1541,錩泰,40.10,40.20,39.60,39.60,-0.45,-1.12,117025,89,4670540,0,26000,-26000,0,0,0,1000,0,1000,-25000
20200528,1558,伸興,134.50,134.50,133.00,134.00,-0.50,-0.37,113387,91,15186825,1000,56000,-55000,0,0,0,0,0,0,-55000
20200528,1560,中砂,61.10,61.90,60.70,60.70,+0.20,0.33,366100,262,22449530,65000,57000,8000,0,0,0,0,0,0,8000
20200528,1568,倉佑,16.30,16.30,15.70,15.75,-0.35,-2.17,165700,96,2639442,4000,6000,-2000,0,0,0,1000,0,1000,-1000
20200528,1582,信錦,82.60,82.70,80.80,81.10,-1.00,-1.22,406191,289,33202143,4000,151000,-147000,0,0,0,12000,11000,1000,-146000
20200528,1583,程泰,61.00,61.80,60.50,60.50,-0.10,-0.17,18245,16,1111846,1000,6000,-5000,0,0,0,0,0,0,-5000
20200528,1587,吉茂,12.75,13.10,12.60,13.05,0.00,0.00,16450,15,210717,0,4000,-4000,0,0,0,0,1000,-1000,-5000
20200528,1589,永冠-KY,62.10,62.10,59.50,60.00,-1.60,-2.6,1261016,643,76534063,131000,885000,-754000,0,0,0,58000,1000,57000,-697000
20200528,1590,亞德客-KY,590.00,600.00,560.00,572.00,-10.00,-1.72,2371091,1844,1373219325,1239646,1151000,88646,0,5000,-5000,42000,81000,-39000,44646
20200528,1592,英瑞-KY,10.95,11.15,10.70,10.80,-0.05,-0.46,807170,294,8803153,57000,89000,-32000,0,0,0,0,3000,-3000,-35000
20200528,1598,岱宇,49.30,50.10,47.00,47.05,-1.55,-3.19,4446987,2379,216549327,374699,403000,-28301,0,0,0,146000,87000,59000,30699
20200528,1603,華電,26.15,27.15,25.90,26.80,+0.45,1.71,103208,68,2754624,2000,32000,-30000,0,0,0,0,0,0,-30000
20200528,1604,聲寶,19.85,20.15,19.80,19.90,+0.10,0.51,1262366,438,25154488,248000,211000,37000,0,0,0,0,0,0,37000
20200528,1605,華新,14.65,15.15,14.20,14.40,0.00,0.00,59102374,17992,870661446,3143000,7862000,-4719000,0,0,0,435000,942000,-507000,-5226000
20200528,1608,華榮,9.32,9.39,9.21,9.22,-0.10,-1.07,509474,216,4741433,77000,156000,-79000,0,0,0,0,0,0,-79000
20200528,1609,大亞,10.70,11.00,10.65,10.75,+0.15,1.42,7394209,2069,80091679,541000,487000,54000,0,0,0,0,1000,-1000,53000
20200528,1611,中電,13.30,13.30,13.00,13.05,-0.15,-1.14,783704,306,10325802,7000,308000,-301000,0,0,0,0,0,0,-301000
20200528,1612,宏泰,10.10,10.10,10.00,10.05,-0.05,-0.5,226002,65,2277520,0,38000,-38000,0,0,0,0,0,0,-38000
20200528,1614,三洋電,31.60,31.60,30.70,30.80,-0.50,-1.6,172093,96,5335118,6000,42000,-36000,0,0,0,0,0,0,-36000
20200528,1615,大山,22.20,22.25,21.95,22.00,-0.10,-0.45,216000,105,4773950,8000,30000,-22000,0,0,0,0,0,0,-22000
20200528,1616,億泰,4.19,4.19,4.04,4.16,-0.01,-0.24,41707,27,172000,0,5000,-5000,0,0,0,0,0,0,-5000
20200528,1617,榮星,11.45,11.45,11.20,11.35,-0.10,-0.87,9000,8,101500,0,2000,-2000,0,0,0,0,0,0,-2000
20200528,1618,合機,8.20,8.20,7.95,7.98,-0.17,-2.09,329150,88,2638607,0,19000,-19000,0,0,0,6000,0,6000,-13000
20200528,1626,艾美特-KY,26.55,26.90,26.10,26.65,-0.35,-1.3,289500,184,7666400,6000,25000,-19000,0,0,0,0,0,0,-19000
20200528,1701,中化,21.85,22.15,21.20,21.35,-0.65,-2.95,3976201,1847,85949717,402000,631000,-229000,0,0,0,3000,11000,-8000,-237000
20200528,1702,南僑,45.10,45.10,44.60,44.65,-0.45,-1.0,207189,166,9279191,33000,65000,-32000,0,0,0,0,0,0,-32000
20200528,1707,葡萄王,193.00,193.00,189.00,189.50,-2.50,-1.3,918600,705,174897300,221300,483000,-261700,0,94000,-94000,2000,63000,-61000,-416700
20200528,1708,東鹼,24.20,24.20,23.85,23.85,-0.20,-0.83,354706,173,8514159,31000,87000,-56000,0,0,0,0,0,0,-56000
20200528,1709,和益,15.75,16.10,13.20,13.35,-1.30,-8.87,18265480,4711,263198347,446000,1463000,-1017000,0,0,0,2000,7000,-5000,-1022000
20200528,1710,東聯,17.10,17.10,16.65,16.75,-0.20,-1.18,1571597,550,26541436,265000,559000,-294000,0,0,0,0,0,0,-294000
20200528,1711,永光,14.95,15.05,14.70,14.75,-0.15,-1.01,844474,375,12568256,223000,210000,13000,0,0,0,0,0,0,13000
20200528,1712,興農,18.25,18.35,18.15,18.15,-0.10,-0.55,1001770,324,18283835,148000,231000,-83000,0,0,0,0,0,0,-83000
20200528,1713,國化,17.95,18.05,17.95,18.00,-0.05,-0.28,40216,25,723654,1000,19000,-18000,0,0,0,0,0,0,-18000
20200528,1714,和桐,7.43,7.43,7.26,7.26,-0.09,-1.22,2571054,671,18923656,332000,368000,-36000,0,0,0,0,0,0,-36000
20200528,1717,長興,33.40,34.30,32.70,33.00,+0.15,0.46,19298136,8163,647761724,1643000,1642000,1000,624000,0,624000,234000,1004000,-770000,-145000
20200528,1718,中纖,6.33,6.40,6.21,6.22,-0.07,-1.11,2697263,804,17024046,903000,1154000,-251000,0,0,0,0,0,0,-251000
20200528,1720,生達,39.25,39.65,38.70,38.75,-0.45,-1.15,1293350,866,50502545,298000,127000,171000,0,0,0,0,2000,-2000,169000
20200528,1721,三晃,9.86,9.86,9.67,9.67,-0.06,-0.62,74311,53,724967,5000,30000,-25000,0,0,0,0,0,0,-25000
20200528,1722,台肥,49.40,49.45,49.00,49.00,-0.25,-0.51,2160322,1022,106367317,525000,742000,-217000,368000,0,368000,0,0,0,151000
20200528,1723,中碳,102.00,102.00,101.00,101.50,0.00,0.00,176776,162,17966538,13000,80000,-67000,0,0,0,0,0,0,-67000
20200528,1724,台硝,12.25,12.30,12.25,12.25,+0.05,0.41,21183,20,260205,1000,1000,0,0,0,0,0,0,0,0
20200528,1725,元禎,14.20,14.50,14.20,14.35,+0.10,0.7,21000,16,302850,2000,5000,-3000,0,0,0,0,0,0,-3000
20200528,1726,永記,68.50,69.10,68.50,68.70,+0.10,0.15,10040,11,690611,0,6000,-6000,0,0,0,0,0,0,-6000
20200528,1727,中華化,9.19,9.28,9.18,9.28,+0.09,0.98,45241,40,418034,2000,14000,-12000,0,0,0,0,0,0,-12000
20200528,1730,花仙子,74.00,74.30,72.30,73.90,-0.80,-1.07,545481,493,40137142,280000,154000,126000,0,0,0,0,0,0,126000
20200528,1731,美吾華,14.05,14.05,13.75,13.80,-0.15,-1.08,674100,329,9365689,28000,61000,-33000,0,0,0,0,0,0,-33000
20200528,1732,毛寶,32.10,32.80,31.00,31.80,-0.35,-1.09,2130736,1288,68207903,219000,78000,141000,0,0,0,0,1000,-1000,140000
20200528,1733,五鼎,24.90,24.95,24.35,24.40,-0.55,-2.2,701698,385,17280481,70000,61000,9000,0,0,0,4000,1000,3000,12000
20200528,1734,杏輝,22.55,22.80,21.85,21.90,-0.65,-2.88,1661596,914,36968986,65000,299000,-234000,0,0,0,0,0,0,-234000
20200528,1735,日勝化,16.80,16.80,16.65,16.65,-0.10,-0.6,6050,7,101490,0,2000,-2000,0,0,0,0,0,0,-2000
20200528,1736,喬山,72.60,74.00,69.10,69.40,-2.60,-3.61,5798548,3820,411428160,591000,734000,-143000,100000,0,100000,9000,191000,-182000,-225000
20200528,1737,臺鹽,31.45,31.45,31.10,31.10,-0.10,-0.32,208132,115,6500952,1000,56000,-55000,0,0,0,4000,0,4000,-51000
20200528,1760,寶齡富錦,146.00,152.00,140.00,146.00,-0.50,-0.34,30014235,20135,4408444810,1803000,1419000,384000,0,61000,-61000,0,84000,-84000,239000
20200528,1762,中化生,58.00,59.90,55.40,57.80,-0.20,-0.34,9951114,6195,576805733,1478000,773000,705000,0,210000,-210000,3000,0,3000,498000
20200528,1773,勝一,97.90,98.50,96.80,97.30,+0.30,0.31,286496,214,28026204,54000,30000,24000,0,0,0,0,0,0,24000
20200528,1776,展宇,17.20,17.20,16.95,16.95,0.00,0.00,4265,5,72501,0,2000,-2000,0,0,0,0,0,0,-2000
20200528,1783,和康生,26.20,26.70,25.50,25.75,-0.45,-1.72,677000,398,17618600,63000,82000,-19000,0,0,0,0,1000,-1000,-20000
20200528,1786,科妍,63.90,64.10,63.00,63.10,-0.50,-0.79,123011,102,7786699,8000,22000,-14000,0,0,0,0,0,0,-14000
20200528,1789,神隆,30.90,31.30,30.25,30.25,-0.65,-2.1,3594725,2114,110422345,484000,570000,-86000,0,0,0,3000,19000,-16000,-102000
20200528,1795,美時,80.50,80.50,78.00,78.10,-1.60,-2.01,1512500,1166,119762600,207000,177000,30000,0,0,0,0,0,0,30000
20200528,1802,台玻,8.95,9.08,8.78,8.80,-0.12,-1.35,1786391,623,16004869,437000,694000,-257000,0,0,0,0,0,0,-257000
20200528,1805,寶徠,7.89,8.29,7.89,7.95,-0.23,-2.81,24111,14,194184,0,1000,-1000,0,0,0,2000,0,2000,1000
20200528,1806,冠軍,4.94,5.02,4.91,4.97,+0.03,0.61,389532,153,1932686,9000,43000,-34000,0,0,0,0,0,0,-34000
20200528,1808,潤隆,60.20,60.80,60.10,60.10,+0.10,0.17,140048,131,8449082,57000,81000,-24000,0,0,0,0,0,0,-24000
20200528,1809,中釉,9.35,9.58,9.24,9.29,+0.11,1.2,1061896,418,10010575,42000,131000,-89000,0,0,0,0,0,0,-89000
20200528,1810,和成,7.25,7.29,7.16,7.24,-0.03,-0.41,293192,76,2118310,28000,87000,-59000,0,0,0,0,0,0,-59000
20200528,1817,凱撒衛,30.10,30.30,30.00,30.00,-0.10,-0.33,54000,35,1630150,0,11000,-11000,0,0,0,0,0,0,-11000
20200528,1903,士紙,45.65,45.65,43.40,44.05,-1.10,-2.44,299489,195,13283481,13000,45000,-32000,0,0,0,0,0,0,-32000
20200528,1904,正隆,24.10,24.45,23.80,23.85,-0.05,-0.21,5087691,2497,122755306,1008000,794872,213128,350000,0,350000,58000,38000,20000,583128
20200528,1905,華紙,8.00,8.13,7.92,8.00,+0.08,1.01,2319247,694,18609686,399000,485000,-86000,0,0,0,0,0,0,-86000
20200528,1906,寶隆,12.10,12.75,12.05,12.20,+0.30,2.52,1062174,543,13181035,80000,83000,-3000,0,0,0,0,0,0,-3000
20200528,1907,永豐餘,13.50,13.90,13.45,13.50,+0.10,0.75,6920021,1853,94403319,775000,1469000,-694000,0,0,0,91000,7000,84000,-610000
20200528,1909,榮成,12.90,13.70,12.85,13.10,+0.50,3.97,31602392,9163,420316569,3439000,4868000,-1429000,650000,0,650000,354000,38000,316000,-463000
20200528,2002,中鋼,19.90,20.00,19.85,19.95,+0.05,0.25,21784768,5939,434041656,10464900,10283078,181822,0,0,0,35000,55000,-20000,161822
20200528,2002A,中鋼特,53.60,53.70,53.60,53.70,+0.10,0.19,11020,12,591278,0,0,0,0,0,0,3000,0,3000,3000
20200528,2006,東和鋼鐵,24.15,24.25,24.00,24.15,0.00,0.00,1272628,551,30669522,135000,307000,-172000,0,0,0,0,0,0,-172000
20200528,2007,燁興,3.87,3.92,3.87,3.87,-0.02,-0.51,67995,30,264869,2000,10000,-8000,0,0,0,0,0,0,-8000
20200528,2008,高興昌,12.55,12.65,12.40,12.65,0.00,0.00,8013,8,100611,1000,2000,-1000,0,0,0,0,0,0,-1000
20200528,2009,第一銅,7.20,7.34,7.18,7.25,+0.07,0.97,327150,115,2380320,14000,44000,-30000,0,0,0,0,0,0,-30000
20200528,2010,春源,9.66,9.69,9.51,9.60,+0.13,1.37,985046,322,9483466,65000,168000,-103000,0,0,0,0,0,0,-103000
20200528,2012,春雨,17.70,17.70,17.40,17.50,0.00,0.00,42326,32,739472,0,20000,-20000,0,0,0,0,0,0,-20000
20200528,2013,中鋼構,24.45,25.10,24.35,24.35,+0.05,0.21,1314086,685,32417207,149000,170000,-21000,0,0,0,0,1000,-1000,-22000
20200528,2014,中鴻,7.88,8.39,7.82,8.14,+0.35,4.49,10337088,3032,84032797,446000,2177000,-1731000,0,0,0,0,1000,-1000,-1732000
20200528,2015,豐興,52.60,53.10,52.60,52.80,+0.40,0.76,215017,133,11362297,37000,63000,-26000,0,0,0,0,0,0,-26000
20200528,2017,官田鋼,7.51,8.04,7.51,8.04,+0.73,9.99,7524981,1898,59885144,230000,200000,30000,0,0,0,0,0,0,30000
20200528,2020,美亞,17.75,18.00,17.70,17.85,+0.20,1.13,2300060,717,41148172,316000,306000,10000,0,0,0,0,0,0,10000
20200528,2022,聚亨,4.09,4.15,4.09,4.11,+0.02,0.49,625498,134,2571663,7000,35000,-28000,0,0,0,0,144000,-144000,-172000
20200528,2023,燁輝,8.40,8.69,8.40,8.62,+0.24,2.86,6933884,2211,59722007,535000,1782660,-1247660,0,0,0,0,0,0,-1247660
20200528,2024,志聯,12.50,12.55,12.35,12.50,+0.15,1.21,34514,27,428774,0,4000,-4000,0,0,0,0,0,0,-4000
20200528,2025,千興,1.60,1.66,1.60,1.64,+0.04,2.5,90001,18,147541,0,0,0,0,0,0,0,0,0,0
20200528,2027,大成鋼,27.30,28.10,27.10,27.45,+0.35,1.29,8286154,3858,229290516,2335000,787000,1548000,0,0,0,902000,278000,624000,2172000
20200528,2028,威致,9.39,9.50,9.36,9.39,+0.09,0.97,114086,38,1077238,0,16000,-16000,0,0,0,0,0,0,-16000
20200528,2029,盛餘,16.30,16.35,16.20,16.25,0.00,0.00,141999,73,2309982,7000,88000,-81000,0,0,0,0,0,0,-81000
20200528,2030,彰源,10.30,10.45,10.25,10.30,+0.05,0.49,462754,190,4788977,38000,72000,-34000,0,0,0,0,0,0,-34000
20200528,2031,新光鋼,24.35,25.70,24.30,25.30,+0.95,3.9,2141901,1054,54066592,374000,216000,158000,100000,0,100000,0,13000,-13000,245000
20200528,2032,新鋼,8.30,8.50,8.28,8.31,+0.01,0.12,120030,58,1000920,1000,7000,-6000,0,0,0,0,0,0,-6000
20200528,2033,佳大,9.03,9.09,9.02,9.04,+0.01,0.11,31364,23,283370,6000,1000,5000,0,0,0,0,0,0,5000
20200528,2034,允強,24.00,24.10,23.85,23.90,0.00,0.00,595278,283,14280922,81000,203000,-122000,0,0,0,0,0,0,-122000
20200528,2038,海光,6.99,6.99,6.76,6.87,-0.06,-0.87,1166000,458,8006500,5000,50000,-45000,0,0,0,0,0,0,-45000
20200528,2049,上銀,331.00,335.00,316.50,317.50,-7.50,-2.31,5028128,4101,1637858076,1904347,1101000,803347,63000,0,63000,144000,255000,-111000,755347
20200528,2059,川湖,336.00,342.00,332.50,333.00,-1.50,-0.45,312420,285,105125400,110000,80000,30000,0,0,0,0,0,0,30000
20200528,2062,橋椿,20.85,20.85,20.00,20.20,-0.35,-1.7,371000,174,7525100,18000,57000,-39000,0,0,0,0,0,0,-39000
20200528,2069,運錩,14.80,14.85,14.80,14.80,0.00,0.00,20000,15,296650,0,7000,-7000,0,0,0,0,0,0,-7000
20200528,2101,南港,41.65,41.80,40.20,40.20,-1.30,-3.13,2291382,1223,94288280,439000,784000,-345000,0,0,0,43000,71000,-28000,-373000
20200528,2102,泰豐,15.75,16.10,15.70,15.75,+0.05,0.32,2313427,819,36731042,778000,401000,377000,0,0,0,0,0,0,377000
20200528,2103,台橡,16.80,16.85,16.60,16.70,0.00,0.00,1812294,718,30304788,202000,273000,-71000,0,0,0,75000,0,75000,4000
20200528,2104,國際中橡,20.40,20.65,20.15,20.25,-0.05,-0.25,3275221,1596,66759364,1282000,878000,404000,0,0,0,0,99000,-99000,305000
20200528,2105,正新,34.30,34.40,33.10,33.55,-0.45,-1.32,3976717,1851,133755045,1759037,2956000,-1196963,0,0,0,5000,87000,-82000,-1278963
20200528,2106,建大,30.00,30.50,29.45,29.45,-0.35,-1.17,1973799,865,59100856,132000,370000,-238000,333000,0,333000,0,0,0,95000
20200528,2107,厚生,17.95,17.95,17.65,17.70,-0.30,-1.67,639878,309,11376093,15000,380000,-365000,0,0,0,0,0,0,-365000
20200528,2108,南帝,35.45,36.20,35.45,35.55,+0.10,0.28,2276718,1374,81458888,281000,314000,-33000,0,0,0,0,0,0,-33000
20200528,2109,華豐,12.95,12.95,12.60,12.90,+0.05,0.39,227372,128,2899859,3000,53000,-50000,0,0,0,0,0,0,-50000
20200528,2114,鑫永銓,81.20,81.20,80.70,80.70,-0.50,-0.62,82100,49,6639410,0,25000,-25000,0,0,0,4000,0,4000,-21000
20200528,2115,六暉-KY,40.20,40.60,40.10,40.10,0.00,0.00,38417,28,1547730,0,13000,-13000,0,0,0,0,0,0,-13000
20200528,2201,裕隆,20.00,20.65,19.75,19.80,-0.10,-0.5,12140219,4244,245284630,2116000,4315000,-2199000,0,0,0,548000,34000,514000,-1685000
20200528,2204,中華,36.15,36.80,35.55,36.00,0.00,0.00,1100139,582,39705594,212000,493800,-281800,0,0,0,119000,0,119000,-162800
20200528,2206,三陽工業,20.95,21.10,20.80,20.80,0.00,0.00,1505155,488,31505566,148000,156000,-8000,0,0,0,0,0,0,-8000
20200528,2207,和泰車,542.00,543.00,522.00,526.00,-7.00,-1.31,462455,392,245309515,210237,304000,-93763,0,0,0,0,0,0,-93763
20200528,2208,台船,25.05,25.10,24.50,24.50,-0.35,-1.41,2891699,1506,71939799,395000,419000,-24000,0,0,0,0,0,0,-24000
20200528,2227,裕日車,262.50,263.50,261.00,261.00,-0.50,-0.19,106101,85,27806563,1000,58000,-57000,0,0,0,15000,0,15000,-42000
20200528,2228,劍麟,89.10,90.50,87.60,87.60,-1.20,-1.35,641245,572,57204250,111000,199000,-88000,0,0,0,14000,49000,-35000,-123000
20200528,2231,為升,153.50,155.00,150.00,150.50,-1.50,-0.99,919456,721,139919538,112000,214000,-102000,0,0,0,2000,4000,-2000,-104000
20200528,2233,宇隆,62.20,63.90,61.70,62.60,+0.90,1.46,852837,617,53725110,110000,77000,33000,92000,0,92000,68000,10000,58000,183000
20200528,2236,百達-KY,16.50,16.55,16.00,16.20,-0.05,-0.31,64758,55,1053529,0,9000,-9000,0,0,0,1000,0,1000,-8000
20200528,2239,英利-KY,59.80,60.40,58.40,58.60,-1.00,-1.68,138050,128,8168355,11000,49000,-38000,0,0,0,0,8000,-8000,-46000
20200528,2243,宏旭-KY,10.00,10.00,9.74,9.80,-0.18,-1.8,19000,11,186080,0,2000,-2000,0,0,0,0,0,0,-2000
20200528,2301,光寶科,48.80,49.00,48.10,48.20,-0.45,-0.92,8354656,4509,404787749,2620580,6135000,-3514420,720000,52000,668000,858000,137000,721000,-2125420
20200528,2302,麗正,7.18,7.18,7.00,7.03,0.00,0.00,280454,41,1970208,0,217000,-217000,0,0,0,0,0,0,-217000
20200528,2303,聯電,15.20,15.40,15.15,15.35,+0.25,1.66,45046009,7951,688499995,29632825,15352000,14280825,0,0,0,600000,1491000,-891000,13389825
20200528,2305,全友,5.26,5.29,5.21,5.25,0.00,0.00,125828,62,659394,0,24000,-24000,0,0,0,0,0,0,-24000
20200528,2308,台達電,141.00,141.00,138.00,139.00,-2.00,-1.42,4313673,2381,599772720,1490615,3898528,-2407913,0,0,0,47000,5000,42000,-2365913
20200528,2312,金寶,11.65,11.90,11.50,11.55,0.00,0.00,19674118,3567,229680006,5712000,1994221,3717779,0,0,0,100000,73000,27000,3744779
20200528,2313,華通,41.70,43.30,41.65,42.10,+1.15,2.81,64183273,28653,2727654230,13879320,6560000,7319320,1151000,100000,1051000,3914000,2016000,1898000,10268320
20200528,2314,台揚,21.70,22.00,21.00,21.00,-0.40,-1.87,3548760,1171,76598960,365000,1027000,-662000,0,0,0,3000,0,3000,-659000
20200528,2316,楠梓電,30.35,30.60,29.60,29.90,-0.30,-0.99,1568701,902,47365585,234000,332000,-98000,0,0,0,30000,8000,22000,-76000
20200528,2317,鴻海,75.70,75.90,74.80,75.30,0.00,0.00,26184820,11142,1974966847,9326604,12655397,-3328793,3493000,0,3493000,372000,1165000,-793000,-628793
20200528,2321,東訊,1.40,1.40,1.40,1.40,0.00,0.00,77841,14,108942,0,0,0,0,0,0,0,0,0,0
20200528,2323,中環,7.46,7.46,7.20,7.20,-0.14,-1.91,12152428,2898,88747430,712000,2158174,-1446174,0,0,0,988000,49000,939000,-507174
20200528,2324,仁寶,18.65,18.70,18.40,18.40,-0.25,-1.34,13253034,4482,245134632,4180452,11906000,-7725548,0,0,0,54000,266000,-212000,-7937548
20200528,2327,國巨,379.00,381.50,370.00,370.00,-6.00,-1.6,13104627,9593,4917209871,874158,2948000,-2073842,38000,239000,-201000,216000,435000,-219000,-2493842
20200528,2328,廣宇,18.30,18.40,18.05,18.05,-0.20,-1.1,1322955,626,24102923,238000,576000,-338000,0,0,0,2000,0,2000,-336000
20200528,2329,華泰,11.95,12.15,11.70,11.75,0.00,0.00,5708808,1589,68118058,503000,1213000,-710000,200000,0,200000,0,0,0,-510000
20200528,2330,台積電,298.50,298.50,293.00,294.00,-2.50,-0.84,32395568,13208,9575118830,23419548,23428455,-8907,389000,828000,-439000,799000,273000,526000,78093
20200528,2331,精英,11.80,11.90,11.50,11.50,-0.20,-1.71,1092283,369,12758036,95000,341000,-246000,0,0,0,20000,12000,8000,-238000
20200528,2332,友訊,12.40,12.50,12.20,12.25,-0.05,-0.41,6515187,1583,80527013,571000,824000,-253000,0,0,0,89000,19000,70000,-183000
20200528,2337,旺宏,33.85,34.10,32.85,32.90,-0.95,-2.81,73228684,29280,2450719812,4428000,12035000,-7607000,0,3146000,-3146000,271000,1993000,-1722000,-12475000
20200528,2338,光罩,26.30,26.45,25.80,25.80,-0.30,-1.15,2430860,1376,63400972,217000,423000,-206000,0,0,0,11000,72000,-61000,-267000
20200528,2340,光磊,21.25,21.45,20.90,21.35,+0.30,1.43,2789134,1249,59058684,382000,372000,10000,0,0,0,35000,19000,16000,26000
20200528,2342,茂矽,30.85,32.00,28.85,29.15,-0.95,-3.16,18209798,9134,555212985,1395000,1517000,-122000,0,0,0,0,150000,-150000,-272000
20200528,2344,華邦電,14.80,15.15,14.00,14.20,-0.10,-0.7,176034938,42618,2581280447,13435993,25407000,-11971007,0,0,0,598000,2876000,-2278000,-14249007
20200528,2345,智邦,235.50,247.00,231.50,236.00,+7.00,3.06,9884078,7381,2362920330,3601883,2391800,1210083,172000,0,172000,333000,422000,-89000,1293083
20200528,2347,聯強,45.20,45.70,44.70,44.75,-0.10,-0.22,6844124,4448,309536171,3544095,2063532,1480563,400000,0,400000,1064000,95000,969000,2849563
20200528,2348,海悅,64.10,65.70,64.10,65.30,+1.50,2.35,792202,467,51454986,165000,56000,109000,0,0,0,0,2000,-2000,107000
20200528,2349,錸德,5.88,5.89,5.61,5.61,-0.19,-3.28,9906535,2278,56204331,40000,1352000,-1312000,0,0,0,0,0,0,-1312000
20200528,2351,順德,45.35,45.85,44.50,44.50,-0.65,-1.44,632005,309,28489475,93000,242000,-149000,0,27000,-27000,0,1000,-1000,-177000
20200528,2352,佳世達,16.60,16.85,16.60,16.65,+0.10,0.6,4868440,1385,81375510,1868000,1839000,29000,0,0,0,6000,0,6000,35000
20200528,2353,宏碁,16.45,16.50,16.25,16.35,-0.05,-0.3,7912975,2237,129569726,4497827,3720398,777429,0,0,0,26000,93000,-67000,710429
20200528,2354,鴻準,54.50,54.80,53.60,53.70,-0.60,-1.1,2165559,1391,117274083,677168,1488439,-811271,0,0,0,10000,21000,-11000,-822271
20200528,2355,敬鵬,24.45,24.90,24.10,24.15,-0.20,-0.82,1026200,551,25109569,192000,271000,-79000,0,0,0,32000,0,32000,-47000
20200528,2356,英業達,24.45,24.50,24.15,24.30,-0.10,-0.41,7475794,2663,181962805,4419707,3789000,630707,0,0,0,177000,320000,-143000,487707
20200528,2357,華碩,209.50,210.00,208.00,209.00,+1.00,0.48,1841450,1319,384977817,1414912,1074000,340912,0,0,0,204000,23000,181000,521912
20200528,2358,廷鑫,13.55,13.55,13.35,13.45,-0.10,-0.74,118974,60,1596450,8000,5000,3000,0,0,0,0,0,0,3000
20200528,2359,所羅門,18.60,18.70,18.25,18.25,-0.10,-0.54,571954,309,10605214,78000,108000,-30000,0,0,0,0,0,0,-30000
20200528,2360,致茂,133.50,135.50,131.50,132.00,-1.00,-0.75,917956,799,122466213,304194,504000,-199806,10000,0,10000,0,7000,-7000,-196806
20200528,2362,藍天,29.65,29.95,29.40,29.50,-0.15,-0.51,190666,142,5644560,67000,96000,-29000,0,0,0,0,0,0,-29000
20200528,2363,矽統,12.45,12.75,12.20,12.20,-0.10,-0.81,16450743,5184,203717065,1918000,3807000,-1889000,0,0,0,0,0,0,-1889000
20200528,2364,倫飛,,,,,0.00,0.00,61,6,115,0,0,0,0,0,0,0,0,0,0
20200528,2365,昆盈,8.69,8.87,8.64,8.73,+0.12,1.39,2361882,571,20624705,250000,190000,60000,0,0,0,0,0,0,60000
20200528,2367,燿華,23.35,23.50,22.85,22.85,-0.25,-1.08,10825961,4816,250280397,1650230,1575000,75230,0,0,0,38000,82000,-44000,31230
20200528,2368,金像電,37.80,38.25,36.20,37.00,+0.10,0.27,53547863,20790,1994393581,5947000,10712343,-4765343,0,356000,-356000,874000,1173000,-299000,-5420343
20200528,2369,菱生,9.50,9.57,9.33,9.33,-0.12,-1.27,1536273,617,14517182,215000,465000,-250000,0,0,0,0,0,0,-250000
20200528,2371,大同,20.25,20.60,19.90,20.20,-0.05,-0.25,6227281,2057,125804088,2551690,3137000,-585310,0,0,0,92000,112000,-20000,-605310
20200528,2373,震旦行,90.00,90.00,89.20,89.80,-0.10,-0.11,12321,16,1104096,0,6000,-6000,0,0,0,0,0,0,-6000
20200528,2374,佳能,12.25,12.30,11.95,12.05,-0.20,-1.63,336756,227,4061199,1000,91000,-90000,0,0,0,0,6000,-6000,-96000
20200528,2375,凱美,37.10,38.20,36.90,37.90,+1.15,3.13,7118510,3994,267674786,983000,464000,519000,0,0,0,226000,8000,218000,737000
20200528,2376,技嘉,61.20,61.50,59.10,59.60,-1.70,-2.77,10777125,6160,648654137,4112000,2217758,1894242,0,1503000,-1503000,144000,322000,-178000,213242
20200528,2377,微星,101.50,102.50,100.50,102.50,+2.00,1.99,5886126,3440,598141852,4105065,2401276,1703789,361000,266000,95000,61000,87000,-26000,1772789
20200528,2379,瑞昱,255.00,256.50,253.00,254.50,+3.50,1.39,4503434,3322,1148877868,1174072,1375832,-201760,122000,0,122000,151000,17000,134000,54240
20200528,2380,虹光,3.53,3.59,3.49,3.52,-0.02,-0.56,128904,67,456969,0,5000,-5000,0,0,0,0,0,0,-5000
20200528,2382,廣達,69.60,69.80,68.90,69.50,+0.50,0.72,13483389,5045,932745143,10285896,7360600,2925296,398000,0,398000,112000,143000,-31000,3292296
20200528,2383,台光電,154.00,154.50,147.50,148.00,-4.00,-2.63,5183056,3179,779870788,1333030,1351000,-17970,0,303000,-303000,157000,469000,-312000,-632970
20200528,2385,群光,84.80,85.00,83.60,83.90,0.00,0.00,3727247,2887,314732666,1582294,1469600,112694,233000,0,233000,49000,142000,-93000,252694
20200528,2387,精元,34.05,35.60,33.70,35.00,+1.55,4.63,10492720,5293,363198600,1037000,956000,81000,0,0,0,279000,162000,117000,198000
20200528,2388,威盛,30.00,30.30,29.25,29.25,-0.75,-2.5,864913,559,25657433,38000,143000,-105000,0,0,0,0,0,0,-105000
20200528,2390,云辰,11.30,11.65,10.95,11.05,-0.45,-3.91,5511513,2307,62284947,689000,407000,282000,0,0,0,0,0,0,282000
20200528,2392,正崴,37.50,37.60,36.50,36.70,-0.65,-1.74,2510073,1457,92814018,277208,726000,-448792,0,0,0,36000,50000,-14000,-462792
20200528,2393,億光,31.60,31.60,30.85,30.95,-0.30,-0.96,2186650,1141,68061528,371000,1628000,-1257000,164000,0,164000,50000,2000,48000,-1045000
20200528,2395,研華,291.00,299.00,288.50,294.00,+5.00,1.73,1392123,1206,408762662,1172962,846390,326572,0,0,0,0,2000,-2000,324572
20200528,2397,友通,75.70,75.90,74.90,75.20,-0.50,-0.66,67036,60,5046118,2000,36000,-34000,0,0,0,0,0,0,-34000
20200528,2399,映泰,9.65,9.77,9.47,9.55,-0.02,-0.21,449100,240,4320464,67000,237000,-170000,0,0,0,0,0,0,-170000
20200528,2401,凌陽,11.55,11.90,11.20,11.25,-0.20,-1.75,12040529,3677,139089300,450000,1859000,-1409000,0,0,0,8000,28000,-20000,-1429000
20200528,2402,毅嘉,13.20,13.85,13.10,13.20,+0.15,1.15,6105587,1695,82046270,282000,948000,-666000,0,0,0,0,0,0,-666000
20200528,2404,漢唐,209.00,209.50,203.00,205.00,-3.00,-1.44,2078086,1527,427725216,458999,301000,157999,0,0,0,30000,142000,-112000,45999
20200528,2405,浩鑫,9.60,9.76,9.43,9.43,-0.14,-1.46,831007,347,7954114,60000,117000,-57000,0,0,0,0,0,0,-57000
20200528,2406,國碩,9.45,9.48,9.23,9.23,-0.16,-1.7,1101146,483,10308720,195000,486000,-291000,0,0,0,0,0,0,-291000
20200528,2408,南亞科,63.00,63.40,60.80,60.90,+0.20,0.33,29491698,15480,1831074378,5980247,9237000,-3256753,64000,545000,-481000,629000,562000,67000,-3670753
20200528,2409,友達,7.78,7.83,7.63,7.70,-0.02,-0.26,47173243,7849,364637232,19818478,17256000,2562478,0,0,0,657000,291000,366000,2928478
20200528,2412,中華電,110.00,111.00,110.00,110.50,+0.50,0.45,6454371,2822,712001471,2861172,3431806,-570634,0,0,0,9000,22000,-13000,-583634
20200528,2413,環科,12.80,13.00,12.70,12.70,-0.10,-0.78,244000,118,3134000,3000,49000,-46000,0,0,0,0,0,0,-46000
20200528,2414,精技,24.05,24.15,24.00,24.00,-0.05,-0.21,347483,189,8368942,8000,36000,-28000,0,0,0,0,0,0,-28000
20200528,2415,錩新,16.60,16.60,16.05,16.05,-0.40,-2.43,246690,136,4032373,5000,46000,-41000,0,0,0,0,0,0,-41000
20200528,2417,圓剛,13.55,13.85,13.40,13.45,+0.05,0.37,1756799,638,23925156,257000,208000,49000,0,0,0,0,0,0,49000
20200528,2419,仲琦,20.40,20.75,20.30,20.35,+0.20,0.99,712338,340,14623875,64000,122000,-58000,0,0,0,0,0,0,-58000
20200528,2420,新巨,34.50,34.50,33.45,33.60,-0.65,-1.9,340273,263,11522138,18000,53000,-35000,0,0,0,0,0,0,-35000
20200528,2421,建準,54.20,57.20,53.60,53.90,+0.30,0.56,8935356,6098,493489881,1649000,2050000,-401000,959000,0,959000,276000,68000,208000,766000
20200528,2423,固緯,24.00,24.15,23.50,23.75,-0.15,-0.63,469000,324,11176050,21000,47000,-26000,0,0,0,0,0,0,-26000
20200528,2424,隴華,17.75,17.75,17.65,17.65,0.00,0.00,5000,4,88650,0,1000,-1000,0,0,0,0,0,0,-1000
20200528,2425,承啟,24.05,24.10,23.80,23.95,-0.05,-0.21,97149,76,2321868,19000,19000,0,0,0,0,0,0,0,0
20200528,2426,鼎元,13.60,13.70,13.30,13.30,-0.10,-0.75,1089866,498,14689396,77000,212000,-135000,0,0,0,0,0,0,-135000
20200528,2427,三商電,10.05,10.10,9.86,9.95,-0.15,-1.49,190050,67,1899310,16000,45000,-29000,0,0,0,0,0,0,-29000
20200528,2428,興勤,88.10,88.50,86.80,87.00,-1.00,-1.14,719000,452,62953000,22000,137000,-115000,0,0,0,0,59000,-59000,-174000
20200528,2429,銘旺科,22.80,23.70,21.70,21.80,+0.20,0.93,880000,527,20042850,22000,41000,-19000,0,0,0,0,0,0,-19000
20200528,2430,燦坤,17.35,17.50,17.10,17.20,-0.15,-0.86,283005,125,4901785,17000,59000,-42000,0,0,0,0,0,0,-42000
20200528,2431,聯昌,8.35,8.80,8.33,8.65,+0.40,4.85,1961028,666,16781107,157000,182000,-25000,0,0,0,0,2000,-2000,-27000
20200528,2433,互盛電,52.80,53.10,52.40,52.40,-0.40,-0.76,104000,67,5481600,3000,33000,-30000,0,0,0,10000,0,10000,-20000
20200528,2434,統懋,6.15,6.15,6.15,6.15,0.00,0.00,23364,18,145125,0,0,0,0,0,0,0,0,0,0
20200528,2436,偉詮電,27.00,27.10,26.20,26.20,-0.75,-2.78,2543260,937,67401709,102000,533000,-431000,0,0,0,0,0,0,-431000
20200528,2438,翔耀,5.33,5.43,5.26,5.40,+0.01,0.19,118999,40,632044,1000,2000,-1000,0,0,0,0,0,0,-1000
20200528,2439,美律,136.00,137.00,134.50,135.00,+0.50,0.37,2834966,2047,384525876,1045000,584000,461000,0,0,0,80000,63000,17000,478000
20200528,2440,太空梭,8.46,8.47,8.45,8.46,0.00,0.00,13754,11,116214,1000,2000,-1000,0,0,0,0,0,0,-1000
20200528,2441,超豐,45.10,45.20,44.80,44.95,+0.10,0.22,553609,341,24892455,56000,192000,-136000,0,0,0,0,1000,-1000,-137000
20200528,2442,新美齊,8.20,8.33,8.04,8.20,+0.05,0.61,1695800,502,13882149,134000,604000,-470000,0,0,0,0,2000,-2000,-472000
20200528,2443,億麗,3.00,3.00,2.88,2.92,-0.04,-1.35,180771,67,531123,1000,8000,-7000,0,0,0,0,0,0,-7000
20200528,2444,兆勁,14.80,14.85,14.65,14.80,-0.10,-0.67,376485,183,5549627,0,136000,-136000,0,0,0,0,0,0,-136000
20200528,2448,晶電,37.00,37.30,35.80,35.95,-0.60,-1.64,20232412,8674,737469213,3892000,4172000,-280000,0,0,0,424000,896000,-472000,-752000
20200528,2449,京元電子,31.00,31.10,30.50,30.50,-0.30,-0.97,27429862,11899,843088206,1574364,14777000,-13202636,0,2646000,-2646000,77000,199000,-122000,-15970636
20200528,2450,神腦,28.10,28.20,28.05,28.15,+0.05,0.18,162491,100,4572692,14000,73000,-59000,0,0,0,0,0,0,-59000
20200528,2451,創見,71.90,71.90,70.50,70.70,-0.70,-0.98,873475,682,62175525,72000,218000,-146000,150000,0,150000,12000,44000,-32000,-28000
20200528,2453,凌群,16.40,16.55,16.20,16.20,-0.15,-0.92,404000,222,6614150,108000,127000,-19000,0,0,0,0,0,0,-19000
20200528,2454,聯發科,468.00,469.00,453.50,460.00,-4.50,-0.97,10968535,7753,5042125065,6414634,6623558,-208924,320000,211000,109000,659000,204000,455000,355076
20200528,2455,全新,86.30,87.20,85.90,86.60,+0.50,0.58,1656114,1178,143174822,585000,380000,205000,0,0,0,17000,151000,-134000,71000
20200528,2456,奇力新,98.90,99.20,95.70,95.90,-2.10,-2.14,5988705,4167,581455250,1002000,2524000,-1522000,0,762000,-762000,26000,88000,-62000,-2346000
20200528,2457,飛宏,7.37,7.86,7.34,7.86,+0.71,9.93,10175162,2310,79117533,417000,383000,34000,0,0,0,0,0,0,34000
20200528,2458,義隆,98.80,99.50,97.20,97.90,+1.40,1.45,10592534,7112,1041590010,2041000,1784000,257000,508000,0,508000,169000,293000,-124000,641000
20200528,2459,敦吉,41.20,41.30,40.80,40.80,-0.25,-0.61,154286,100,6342010,2000,46000,-44000,0,0,0,0,0,0,-44000
20200528,2460,建通,8.05,8.06,7.91,8.00,0.00,0.00,51001,33,404978,2000,13000,-11000,0,0,0,2000,0,2000,-9000
20200528,2461,光群雷,14.80,15.85,14.80,15.00,+0.40,2.74,2862011,1505,44028616,220000,388000,-168000,0,0,0,0,0,0,-168000
20200528,2462,良得電,26.80,26.90,26.45,26.70,-0.10,-0.37,54092,36,1444037,1000,9000,-8000,0,0,0,0,0,0,-8000
20200528,2464,盟立,37.50,37.60,37.10,37.15,-0.15,-0.4,549780,351,20560978,61000,117000,-56000,0,0,0,0,0,0,-56000
20200528,2465,麗臺,9.20,9.37,9.06,9.20,-0.04,-0.43,151305,78,1393174,0,21000,-21000,0,0,0,0,0,0,-21000
20200528,2466,冠西電,29.20,29.30,28.90,29.05,-0.15,-0.51,53000,29,1539100,2000,11000,-9000,0,0,0,0,0,0,-9000
20200528,2467,志聖,30.80,31.80,30.80,31.20,+0.50,1.63,3725421,1838,116089673,611000,484000,127000,0,0,0,0,0,0,127000
20200528,2468,華經,12.80,12.85,12.60,12.70,0.00,0.00,294000,92,3739250,2000,3000,-1000,0,0,0,0,1000,-1000,-2000
20200528,2471,資通,21.50,21.50,21.05,21.10,-0.30,-1.4,383697,226,8136854,15000,97000,-82000,0,0,0,0,0,0,-82000
20200528,2472,立隆電,42.50,42.80,41.50,41.65,-0.60,-1.42,909550,657,38375288,271000,134000,137000,0,0,0,12000,0,12000,149000
20200528,2474,可成,219.00,219.50,215.00,216.00,-0.50,-0.23,4332255,2980,939432845,1383852,933000,450852,62000,0,62000,42000,79000,-37000,475852
20200528,2476,鉅祥,20.15,20.15,20.00,20.05,+0.05,0.25,115737,79,2321553,2000,51000,-49000,0,0,0,0,0,0,-49000
20200528,2477,美隆電,21.50,21.60,21.30,21.40,-0.10,-0.47,85542,56,1840152,8000,26000,-18000,0,0,0,0,0,0,-18000
20200528,2478,大毅,78.50,78.80,77.00,77.40,0.00,0.00,4816736,3227,374786553,994000,515000,479000,0,0,0,38000,73000,-35000,444000
20200528,2480,敦陽科,68.30,68.70,67.20,67.30,-0.90,-1.32,684194,550,46475666,135000,56000,79000,0,0,0,30000,52000,-22000,57000
20200528,2481,強茂,25.00,25.05,24.20,24.50,-0.30,-1.21,3075308,1584,75637370,252000,1139000,-887000,0,0,0,71000,13000,58000,-829000
20200528,2482,連宇,11.50,11.55,11.10,11.30,-0.10,-0.88,189460,93,2144312,3000,19000,-16000,0,0,0,2000,0,2000,-14000
20200528,2483,百容,19.50,19.50,19.40,19.45,+0.05,0.26,111000,38,2160250,3000,26000,-23000,0,0,0,0,0,0,-23000
20200528,2484,希華,21.10,21.35,20.60,20.75,-0.40,-1.89,1205682,600,25342645,175000,135000,40000,0,0,0,8000,0,8000,48000
20200528,2485,兆赫,16.90,16.95,16.35,16.35,-0.35,-2.1,1213328,531,20148419,68000,348000,-280000,0,0,0,5000,2000,3000,-277000
20200528,2486,一詮,7.35,7.39,7.23,7.30,-0.04,-0.54,361103,92,2635860,10000,105000,-95000,0,0,0,0,0,0,-95000
20200528,2488,漢平,28.55,28.55,28.25,28.30,-0.20,-0.7,139003,87,3937684,7000,58000,-51000,0,0,0,0,0,0,-51000
20200528,2489,瑞軒,7.28,7.45,7.26,7.35,+0.10,1.38,2011097,731,14783991,210000,432000,-222000,0,0,0,10000,0,10000,-212000
20200528,2491,吉祥全,8.24,8.24,7.93,7.93,-0.12,-1.49,92148,42,738978,0,2000,-2000,0,0,0,2000,0,2000,0
20200528,2492,華新科,192.50,193.00,187.50,187.50,-3.50,-1.83,7207969,4973,1369495141,1226619,1908000,-681381,0,0,0,60000,161000,-101000,-782381
20200528,2493,揚博,35.20,35.45,33.90,34.10,-0.80,-2.29,2297577,1428,79364480,310000,401000,-91000,0,0,0,35000,0,35000,-56000
20200528,2495,普安,11.85,12.25,11.80,12.00,+0.20,1.69,628372,299,7523175,16000,51000,-35000,0,0,0,0,0,0,-35000
20200528,2496,卓越,71.20,71.70,69.00,71.30,+0.20,0.28,51104,33,3624863,0,25000,-25000,0,0,0,0,0,0,-25000
20200528,2497,怡利電,15.60,15.85,15.60,15.65,+0.05,0.32,36005,29,564228,2000,3000,-1000,0,0,0,0,0,0,-1000
20200528,2498,宏達電,30.90,31.00,29.50,29.60,-1.10,-3.58,9554412,4554,287363010,820000,1585000,-765000,0,0,0,86000,201000,-115000,-880000
20200528,2501,國建,20.55,20.60,20.15,20.20,-0.35,-1.7,1857081,952,37836224,141000,431000,-290000,592000,0,592000,0,0,0,302000
20200528,2504,國產,14.60,14.60,14.10,14.10,-0.50,-3.42,7948549,1926,113981836,871000,822639,48361,0,0,0,625000,0,625000,673361
20200528,2505,國揚,21.70,22.15,21.45,21.75,+0.15,0.69,4537710,1709,98929741,1368000,948814,419186,0,0,0,71000,372000,-301000,118186
20200528,2506,太設,9.00,9.01,8.95,8.97,0.00,0.00,83589,43,751246,0,28000,-28000,0,0,0,0,0,0,-28000
20200528,2509,全坤建,20.85,20.85,20.50,20.50,-0.15,-0.73,36560,20,754580,0,20000,-20000,0,0,0,0,0,0,-20000
20200528,2511,太子,9.85,9.94,9.79,9.81,+0.03,0.31,1154609,421,11409132,222000,221000,1000,0,0,0,0,0,0,1000
20200528,2514,龍邦,14.20,14.30,14.00,14.00,-0.20,-1.41,89710,69,1269608,11000,59000,-48000,0,0,0,0,0,0,-48000
20200528,2515,中工,6.78,6.85,6.73,6.74,-0.02,-0.3,4037443,819,27415321,681000,783000,-102000,0,0,0,32000,37000,-5000,-107000
20200528,2516,新建,4.76,4.90,4.71,4.71,0.00,0.00,109201,51,521605,1000,30000,-29000,0,0,0,0,0,0,-29000
20200528,2520,冠德,29.80,30.35,29.65,30.05,+0.55,1.86,5197554,2327,155971843,2442595,697000,1745595,0,0,0,386000,116000,270000,2015595
20200528,2524,京城,31.90,31.90,30.75,31.00,-0.70,-2.21,192469,119,6037994,15000,82000,-67000,0,0,0,0,0,0,-67000
20200528,2527,宏璟,20.00,20.20,19.95,20.00,+0.05,0.25,454000,192,9118300,71000,44000,27000,0,0,0,0,0,0,27000
20200528,2528,皇普,20.15,20.20,20.00,20.10,0.00,0.00,124995,57,2514399,0,11000,-11000,0,0,0,0,0,0,-11000
20200528,2530,華建,16.45,16.45,16.15,16.35,0.00,0.00,275070,115,4472139,17000,36000,-19000,0,0,0,0,0,0,-19000
20200528,2534,宏盛,17.45,17.50,17.05,17.10,-0.30,-1.72,1057328,495,18225776,150000,402200,-252200,0,0,0,0,0,0,-252200
20200528,2535,達欣工,21.85,21.85,21.60,21.70,0.00,0.00,840054,377,18259475,85000,268000,-183000,0,0,0,87000,0,87000,-96000
20200528,2536,宏普,23.60,23.90,23.35,23.35,-0.15,-0.64,638000,226,15054800,80000,202000,-122000,0,0,0,0,0,0,-122000
20200528,2537,聯上發,10.00,10.05,9.92,9.98,-0.02,-0.2,1012230,402,10103657,88000,382000,-294000,0,0,0,0,0,0,-294000
20200528,2538,基泰,10.40,10.40,10.10,10.10,-0.25,-2.42,793646,237,8077387,3000,200000,-197000,0,0,0,0,0,0,-197000
20200528,2539,櫻花建,34.45,34.45,33.65,33.95,-0.30,-0.88,377084,239,12819822,6000,106000,-100000,0,0,0,0,0,0,-100000
20200528,2540,愛山林,30.50,30.65,30.10,30.30,0.00,0.00,80000,25,2417150,3000,16000,-13000,0,0,0,0,0,0,-13000
20200528,2542,興富發,44.50,45.15,44.40,44.75,+0.30,0.67,3828417,2288,171454643,1786254,1830500,-44246,0,0,0,356000,51000,305000,260754
20200528,2543,皇昌,6.50,6.59,6.50,6.59,+0.04,0.61,9581,8,62426,0,2000,-2000,0,0,0,0,0,0,-2000
20200528,2545,皇翔,34.80,35.40,34.45,34.80,0.00,0.00,438065,241,15277949,54000,113000,-59000,0,0,0,0,0,0,-59000
20200528,2546,根基,39.85,40.20,39.25,39.30,-0.40,-1.01,351545,245,13976614,20000,74000,-54000,0,0,0,0,0,0,-54000
20200528,2547,日勝生,10.00,10.15,9.92,9.93,-0.03,-0.3,1311625,432,13142444,161000,457000,-296000,0,0,0,0,0,0,-296000
20200528,2548,華固,95.20,96.00,94.60,95.70,+0.60,0.63,1710217,1300,163275218,355500,283895,71605,115000,0,115000,1000,0,1000,187605
20200528,2597,潤弘,62.00,62.70,61.80,62.30,+0.60,0.97,98000,78,6105100,5000,9000,-4000,0,0,0,0,0,0,-4000
20200528,2601,益航,9.80,9.80,9.59,9.60,-0.20,-2.04,2836894,953,27470727,134000,1076000,-942000,0,0,0,0,0,0,-942000
20200528,2603,長榮,10.90,11.20,10.85,10.90,+0.05,0.46,28330734,5665,312383435,6471157,7256000,-784843,3176000,0,3176000,2351000,1569000,782000,3173157
20200528,2605,新興,14.35,14.40,14.00,14.10,-0.20,-1.4,1386217,346,19629676,76000,321000,-245000,0,0,0,140000,1000,139000,-106000
20200528,2606,裕民,29.45,29.70,29.20,29.40,0.00,0.00,1292646,659,38110639,729000,404000,325000,0,0,0,0,0,0,325000
20200528,2607,榮運,13.10,13.10,12.90,12.95,-0.10,-0.77,727363,164,9444169,74000,147000,-73000,0,0,0,0,0,0,-73000
20200528,2608,嘉里大榮,40.80,41.00,40.20,40.30,-0.50,-1.23,210350,184,8518561,72000,101000,-29000,0,0,0,0,0,0,-29000
20200528,2609,陽明,6.60,6.67,6.52,6.53,-0.06,-0.91,2271306,564,14977313,39000,406000,-367000,0,0,0,0,0,0,-367000
20200528,2610,華航,8.46,8.47,8.26,8.34,-0.06,-0.71,13045150,3518,109021921,2334147,4816000,-2481853,0,0,0,52000,49000,3000,-2478853
20200528,2611,志信,6.40,6.45,6.29,6.37,-0.03,-0.47,134121,71,850322,0,23000,-23000,0,0,0,0,0,0,-23000
20200528,2612,中航,24.15,24.15,23.55,23.75,-0.15,-0.63,184884,112,4418097,14000,57000,-43000,0,0,0,0,0,0,-43000
20200528,2613,中櫃,13.40,13.50,13.20,13.20,-0.20,-1.49,83414,47,1116245,0,22239,-22239,0,0,0,2000,0,2000,-20239
20200528,2614,東森,15.80,15.85,15.55,15.55,-0.15,-0.96,4663070,1478,73125173,408000,709000,-301000,0,0,0,0,0,0,-301000
20200528,2615,萬海,16.35,16.50,15.95,16.05,-0.30,-1.83,2390148,860,38844168,101000,1769000,-1668000,200000,0,200000,0,0,0,-1468000
20200528,2616,山隆,30.50,30.50,30.40,30.40,-0.05,-0.16,440254,104,13406299,31000,17000,14000,0,0,0,0,0,0,14000
20200528,2617,台航,16.00,16.05,15.70,15.75,-0.15,-0.94,705000,330,11219300,144000,328000,-184000,0,0,0,0,0,0,-184000
20200528,2618,長榮航,11.55,11.60,11.15,11.25,-0.15,-1.32,22799048,5593,258820963,2779525,10871113,-8091588,0,0,0,237000,393000,-156000,-8247588
20200528,2630,亞航,16.25,16.30,15.10,16.00,-0.25,-1.54,149015,87,2349087,1000,3000,-2000,0,0,0,0,0,0,-2000
20200528,2633,台灣高鐵,39.95,39.95,38.10,38.45,-0.85,-2.16,20923002,10772,814847840,5089123,3888000,1201123,440000,0,440000,125000,517000,-392000,1249123
20200528,2634,漢翔,29.05,29.85,29.05,29.10,+0.10,0.34,5426321,2658,160010632,418000,724000,-306000,0,0,0,157000,45000,112000,-194000
20200528,2636,台驊投控,24.35,24.80,24.00,24.10,+0.20,0.84,1182435,600,28876590,161000,81000,80000,0,0,0,33000,6000,27000,107000
20200528,2637,慧洋-KY,23.40,23.45,22.55,22.55,-0.75,-3.22,5345284,1819,122961571,606800,806000,-199200,0,0,0,18000,1180000,-1162000,-1361200
20200528,2642,宅配通,35.95,36.10,34.45,34.75,-0.95,-2.66,1558073,938,54724318,100000,114000,-14000,0,192000,-192000,0,0,0,-206000
20200528,2701,萬企,12.55,12.60,12.00,12.25,-0.20,-1.61,383237,200,4734615,4000,54000,-50000,0,0,0,2000,0,2000,-48000
20200528,2702,華園,22.45,22.50,20.20,20.55,-0.45,-2.14,4921936,2584,105410788,159000,246000,-87000,0,0,0,0,0,0,-87000
20200528,2704,國賓,29.00,29.20,27.50,27.70,-1.10,-3.82,927112,587,26219089,29000,251000,-222000,0,0,0,0,0,0,-222000
20200528,2705,六福,15.30,15.65,14.75,14.90,-0.75,-4.79,1204711,610,18351405,22000,42000,-20000,0,0,0,0,0,0,-20000
20200528,2706,第一店,14.25,15.00,14.05,14.20,+0.15,1.07,1398181,741,20253564,41000,95000,-54000,0,0,0,0,0,0,-54000
20200528,2707,晶華,152.00,153.50,147.50,147.50,-3.50,-2.32,860085,652,129178620,101000,173000,-72000,0,0,0,10000,0,10000,-62000
20200528,2712,遠雄來,55.70,55.70,46.05,54.00,+3.30,6.51,580348,461,31305083,28000,19000,9000,0,0,0,0,0,0,9000
20200528,2722,夏都,34.15,34.15,34.15,34.15,+3.10,9.98,429361,263,14662662,0,0,0,0,0,0,0,0,0,0
20200528,2723,美食-KY,115.50,116.50,110.00,111.50,-2.00,-1.76,1342785,1123,151480705,223000,375000,-152000,0,0,0,4000,15000,-11000,-163000
20200528,2727,王品,73.30,74.70,72.80,73.10,+0.20,0.27,987703,865,72840159,58000,114000,-56000,0,0,0,0,0,0,-56000
20200528,2731,雄獅,80.20,80.80,77.60,77.70,-1.90,-2.39,1198576,953,94938632,111000,155000,-44000,0,0,0,0,2000,-2000,-46000
20200528,2739,寒舍,24.30,24.70,23.80,23.80,-0.45,-1.86,350496,185,8408504,144000,16000,128000,0,0,0,1000,0,1000,129000
20200528,2748,雲品,54.00,55.50,52.60,54.00,+1.60,3.05,1153040,843,62610584,31000,65000,-34000,0,0,0,50000,0,50000,16000
20200528,2801,彰銀,19.15,19.20,18.90,18.95,-0.10,-0.52,8203397,2064,156033792,3180461,6332751,-3152290,0,0,0,0,52000,-52000,-3204290
20200528,2809,京城銀,32.60,32.60,31.65,31.65,0.00,0.00,6747260,2816,216379637,702000,1859000,-1157000,0,0,0,96000,0,96000,-1061000
20200528,2812,台中銀,11.50,11.55,11.45,11.50,+0.05,0.44,4282840,1241,49198085,1047900,1069740,-21840,0,0,0,0,0,0,-21840
20200528,2816,旺旺保,19.35,19.45,19.20,19.20,-0.15,-0.78,91363,60,1763523,7000,48000,-41000,0,0,0,0,0,0,-41000
20200528,2820,華票,14.80,14.85,14.70,14.75,0.00,0.00,1023674,364,15116519,124000,740180,-616180,0,0,0,0,0,0,-616180
20200528,2823,中壽,21.20,21.20,20.55,20.60,-0.45,-2.14,18684378,4293,392187392,1760329,7966000,-6205671,0,0,0,522000,20000,502000,-5703671
20200528,2832,台產,20.15,20.20,20.05,20.15,+0.15,0.75,186522,105,3750740,15000,68000,-53000,0,0,0,0,0,0,-53000
20200528,2834,臺企銀,10.80,10.85,10.60,10.65,-0.15,-1.39,24207622,4763,259118844,4528470,10363000,-5834530,0,0,0,15000,26000,-11000,-5845530
20200528,2836,高雄銀,9.52,9.55,9.45,9.49,-0.05,-0.52,454791,157,4319973,50000,228000,-178000,0,0,0,0,0,0,-178000
20200528,2838,聯邦銀,10.80,10.80,10.75,10.75,-0.05,-0.46,763685,185,8224947,54000,236000,-182000,0,0,0,0,0,0,-182000
20200528,2838A,聯邦銀甲特,54.10,54.20,54.00,54.20,+0.10,0.18,117000,93,6332800,0,0,0,0,0,0,0,0,0,0
20200528,2841,台開,6.61,6.68,6.50,6.51,-0.07,-1.06,3129460,800,20644651,279000,575000,-296000,0,0,0,0,883000,-883000,-1179000
20200528,2845,遠東銀,10.75,10.75,10.65,10.65,-0.05,-0.47,3997669,1008,42755839,403600,1320869,-917269,0,0,0,0,0,0,-917269
20200528,2849,安泰銀,14.35,14.35,14.20,14.20,-0.15,-1.05,90981,47,1297260,2000,77000,-75000,0,0,0,0,0,0,-75000
20200528,2850,新產,35.85,36.00,35.40,35.80,-0.05,-0.14,173187,124,6177350,11000,101000,-90000,0,0,0,44000,0,44000,-46000
20200528,2851,中再保,19.10,19.10,18.95,19.00,-0.05,-0.26,147494,84,2807336,9000,65000,-56000,0,0,0,0,0,0,-56000
20200528,2852,第一保,14.10,14.10,13.95,14.00,-0.20,-1.41,151258,58,2121412,1000,28000,-27000,0,0,0,0,0,0,-27000
20200528,2855,統一證,13.35,13.40,13.25,13.30,0.00,0.00,1164036,417,15496873,105000,588000,-483000,0,0,0,0,0,0,-483000
20200528,2867,三商壽,9.58,9.60,9.32,9.36,-0.17,-1.78,2804045,908,26538906,647000,812794,-165794,0,0,0,0,0,0,-165794
20200528,2880,華南金,19.55,19.65,19.40,19.50,0.00,0.00,11546786,3401,225300375,3087580,6997000,-3909420,0,0,0,0,37000,-37000,-3946420
20200528,2881,富邦金,42.85,42.85,41.75,42.05,-0.60,-1.41,11204676,3653,472730694,3967452,8263803,-4296351,0,0,0,29000,52000,-23000,-4319351
20200528,2881A,富邦特,65.00,65.00,64.80,64.90,-0.10,-0.15,170439,109,11071871,0,0,0,0,0,0,0,0,0,0
20200528,2881B,富邦金乙特,63.80,64.00,63.80,64.00,0.00,0.00,20627,17,1317714,0,0,0,0,0,0,17000,0,17000,17000
20200528,2882,國泰金,40.30,40.30,39.45,39.50,-0.65,-1.62,19969835,6706,794724954,3488153,14883423,-11395270,0,0,0,100000,174000,-74000,-11469270
20200528,2882A,國泰特,63.80,63.90,63.80,63.90,+0.10,0.16,125183,126,7995718,2000,5000,-3000,0,0,0,3000,30000,-27000,-30000
20200528,2882B,國泰金乙特,63.40,63.40,63.00,63.40,-0.10,-0.16,45048,35,2845124,0,0,0,0,0,0,2000,0,2000,2000
20200528,2883,開發金,9.10,9.10,8.96,9.00,-0.07,-0.77,22885927,4560,206607693,7051681,15140000,-8088319,0,0,0,1000,202000,-201000,-8289319
20200528,2884,玉山金,26.95,27.00,26.75,26.80,-0.15,-0.56,40422461,12901,1085341315,8165788,35003613,-26837825,0,0,0,5000,8000,-3000,-26840825
20200528,2885,元大金,16.75,16.80,16.50,16.50,-0.15,-0.9,31213663,6485,518818621,13195993,21743000,-8547007,0,252000,-252000,1000,349058,-348058,-9147065
20200528,2886,兆豐金,30.70,30.75,30.40,30.45,-0.25,-0.81,20054124,5434,612123643,8240758,14709632,-6468874,0,0,0,27000,236000,-209000,-6677874
20200528,2887,台新金,12.75,12.80,12.60,12.70,+0.05,0.4,18493167,3025,234996757,7998506,10637926,-2639420,0,0,0,1000,86000,-85000,-2724420
20200528,2887E,台新戊特,54.50,54.50,54.50,54.50,+0.10,0.18,94273,97,5137795,0,0,0,0,0,0,0,0,0,0
20200528,2887F,台新戊特二,52.50,52.50,52.40,52.50,0.00,0.00,13695,13,718577,0,0,0,0,0,0,0,7000,-7000,-7000
20200528,2888,新光金,8.39,8.39,8.20,8.22,-0.10,-1.2,32562305,5439,269461356,6387566,15643638,-9256072,0,0,0,222000,536000,-314000,-9570072
20200528,2888A,新光金甲特,44.30,44.30,44.10,44.20,-0.10,-0.23,425241,71,18789525,0,0,0,0,0,0,0,0,0,0
20200528,2889,國票金,11.70,11.70,11.55,11.60,-0.05,-0.43,3908390,1234,45412210,297000,993000,-696000,0,0,0,0,0,0,-696000
20200528,2890,永豐金,11.95,12.00,11.70,11.75,-0.05,-0.42,24566305,4741,291268021,8358638,16310000,-7951362,0,0,0,3000,49000,-46000,-7997362
20200528,2891,中信金,20.15,20.15,19.80,19.85,-0.25,-1.24,45782017,8726,911539602,21192070,36161673,-14969603,0,115805,-115805,19000,15000,4000,-15081408
20200528,2891B,中信金乙特,65.70,65.90,65.30,65.90,-0.10,-0.15,52999,31,3470232,0,0,0,0,0,0,1000,0,1000,1000
20200528,2891C,中信金丙特,62.90,63.00,62.90,63.00,0.00,0.00,50094,37,3155444,0,0,0,0,0,0,0,0,0,0
20200528,2892,第一金,22.70,22.75,22.40,22.50,-0.10,-0.44,18741566,5029,422624528,8370888,12519270,-4148382,80000,0,80000,1000,69000,-68000,-4136382
20200528,2897,王道銀行,7.08,7.10,7.00,7.03,-0.05,-0.71,657140,193,4631734,42000,443000,-401000,0,0,0,0,0,0,-401000
20200528,2897A,王道銀甲特,10.25,10.30,10.25,10.30,+0.05,0.49,17000,7,174450,0,0,0,0,0,0,3000,0,3000,3000
20200528,2901,欣欣,22.65,22.70,22.20,22.65,0.00,0.00,24360,25,546630,0,2000,-2000,0,0,0,0,0,0,-2000
20200528,2903,遠百,24.60,25.00,24.10,24.20,-0.30,-1.22,3493100,615,86434805,15000,749000,-734000,0,0,0,0,0,0,-734000
20200528,2904,匯僑,24.10,24.35,24.10,24.30,+0.20,0.83,82992,52,2016039,1000,0,1000,0,0,0,0,0,0,1000
20200528,2905,三商,22.05,22.20,21.85,21.90,-0.05,-0.23,1024718,391,22572207,350090,241000,109090,0,0,0,0,0,0,109090
20200528,2906,高林,12.20,12.70,12.15,12.20,+0.05,0.41,2715118,801,33647129,23000,34000,-11000,0,0,0,0,0,0,-11000
20200528,2908,特力,19.35,19.50,19.00,19.20,-0.05,-0.26,1398300,547,26986132,179000,126000,53000,0,0,0,0,0,0,53000
20200528,2910,統領,31.50,31.55,31.50,31.55,-0.20,-0.63,2000,2,63050,1000,0,1000,0,0,0,0,0,0,1000
20200528,2911,麗嬰房,6.00,6.08,5.91,5.92,-0.04,-0.67,254443,126,1527788,0,1000,-1000,0,0,0,0,0,0,-1000
20200528,2912,統一超,299.00,300.50,296.50,298.00,-1.00,-0.33,1005972,670,299760100,482984,847000,-364016,0,50000,-50000,38000,3000,35000,-379016
20200528,2913,農林,14.80,15.15,14.70,15.00,+0.25,1.69,2037544,710,30500686,364000,272000,92000,0,0,0,0,0,0,92000
20200528,2915,潤泰全,69.30,69.70,67.90,68.00,-1.00,-1.45,3874147,2282,267016596,1427376,2493729,-1066353,0,0,0,43000,137000,-94000,-1160353
20200528,2923,鼎固-KY,24.70,24.70,24.00,24.45,-0.25,-1.01,14005,13,341972,3000,7000,-4000,0,0,0,0,0,0,-4000
20200528,2929,淘帝-KY,59.00,59.70,57.80,57.80,-1.30,-2.2,670998,479,39362484,127000,309059,-182059,0,0,0,2000,1769,231,-181828
20200528,2936,客思達-KY,14.80,14.80,14.45,14.60,-0.25,-1.68,4400,5,64150,1000,3000,-2000,0,0,0,0,0,0,-2000
20200528,2939,凱羿-KY,133.50,137.50,133.00,135.00,+0.50,0.37,74149,69,10001764,19000,6000,13000,0,0,0,0,8000,-8000,5000
20200528,3002,歐格,10.35,10.40,10.25,10.40,+0.10,0.97,177250,85,1830337,0,1000,-1000,0,0,0,0,0,0,-1000
20200528,3003,健和興,45.00,46.40,40.80,41.55,-1.60,-3.71,7786623,4748,340395294,450000,1125000,-675000,0,0,0,24000,31000,-7000,-682000
20200528,3004,豐達科,57.10,62.20,57.10,62.20,+5.60,9.89,1627301,994,98830222,93000,42000,51000,0,0,0,0,0,0,51000
20200528,3005,神基,45.20,45.40,43.95,44.05,-0.60,-1.34,2709100,1629,120908694,133000,1478000,-1345000,0,0,0,300000,89000,211000,-1134000
20200528,3006,晶豪科,41.20,41.70,40.35,40.40,-0.20,-0.49,4661855,2761,191415197,1247000,816000,431000,0,0,0,148000,65000,83000,514000
20200528,3008,大立光,3935.00,3935.00,3820.00,3830.00,-50.00,-1.29,431477,760,1670248605,149149,233279,-84130,7000,5000,2000,0,2000,-2000,-84130
20200528,3010,華立,56.50,56.70,56.00,56.10,-0.40,-0.71,361677,243,20367716,47000,128000,-81000,0,0,0,0,0,0,-81000
20200528,3011,今皓,5.37,5.48,5.25,5.39,+0.03,0.56,115079,61,616638,0,11000,-11000,0,0,0,0,0,0,-11000
20200528,3013,晟銘電,12.60,12.65,12.40,12.50,0.00,0.00,256145,108,3215248,26000,28000,-2000,0,0,0,0,0,0,-2000
20200528,3014,聯陽,59.60,59.80,58.10,58.50,-0.30,-0.51,2531890,1597,149549155,433000,264000,169000,0,0,0,81000,99000,-18000,151000
20200528,3015,全漢,22.85,23.25,22.35,22.60,+0.10,0.44,708924,394,16156533,23000,203000,-180000,0,0,0,0,2000,-2000,-182000
20200528,3016,嘉晶,70.70,70.80,68.30,68.30,-2.60,-3.67,11831806,6958,823088608,1739000,784000,955000,0,0,0,121000,215000,-94000,861000
20200528,3017,奇鋐,38.20,39.60,38.20,38.60,+1.00,2.66,22839407,11731,890440015,2787369,3782000,-994631,0,0,0,890000,136000,754000,-240631
20200528,3018,同開,18.45,19.40,18.30,18.45,+0.05,0.27,403004,231,7533122,82000,83000,-1000,0,0,0,0,1000,-1000,-2000
20200528,3019,亞光,71.00,71.30,68.80,68.80,-1.40,-1.99,2074121,1435,145234071,244000,573000,-329000,0,0,0,37000,120000,-83000,-412000
20200528,3021,鴻名,12.85,12.90,12.65,12.70,-0.20,-1.55,136000,38,1738950,0,0,0,0,0,0,0,0,0,0
20200528,3022,威強電,40.80,41.10,40.10,40.15,-0.55,-1.35,214108,121,8678573,9000,71000,-62000,0,0,0,0,0,0,-62000
20200528,3023,信邦,149.50,151.50,148.50,151.00,+3.00,2.03,898187,745,134692050,387986,221145,166841,200000,0,200000,12000,17000,-5000,361841
20200528,3024,憶聲,8.40,8.44,8.25,8.25,-0.15,-1.79,933064,297,7767052,12000,157000,-145000,0,0,0,0,0,0,-145000
20200528,3025,星通,18.85,19.05,18.75,18.75,-0.05,-0.27,66001,32,1242068,1000,7000,-6000,0,0,0,0,0,0,-6000
20200528,3026,禾伸堂,124.50,125.00,121.50,121.50,-1.50,-1.22,1416400,1124,174574500,255000,305000,-50000,0,0,0,10000,45000,-35000,-85000
20200528,3027,盛達,8.18,8.18,8.11,8.13,-0.05,-0.61,142802,65,1164338,2000,19000,-17000,0,0,0,0,0,0,-17000
20200528,3028,增你強,19.05,19.10,18.90,18.95,-0.10,-0.52,115502,89,2193909,16000,31000,-15000,0,0,0,0,0,0,-15000
20200528,3029,零壹,33.75,33.95,33.30,33.65,+0.20,0.6,2414800,1256,81294113,170000,184000,-14000,0,0,0,0,7000,-7000,-21000
20200528,3030,德律,56.10,56.70,54.90,55.00,-0.60,-1.08,1325460,811,74106000,134000,328000,-194000,0,0,0,5000,0,5000,-189000
20200528,3031,佰鴻,14.60,14.90,14.50,14.50,-0.10,-0.68,307000,162,4522150,79000,68000,11000,0,0,0,0,0,0,11000
20200528,3032,偉訓,29.25,29.30,29.10,29.20,0.00,0.00,198655,114,5802625,5000,50000,-45000,0,0,0,0,0,0,-45000
20200528,3033,威健,14.60,14.75,14.60,14.60,-0.05,-0.34,332309,194,4874699,61000,69000,-8000,0,0,0,0,0,0,-8000
20200528,3034,聯詠,209.00,209.00,205.00,208.00,+1.00,0.48,3002959,2195,622683972,1134529,1330000,-195471,249000,15000,234000,115000,124000,-9000,29529
20200528,3035,智原,44.50,44.85,43.20,43.35,-0.50,-1.14,2722218,1761,119674788,386000,686000,-300000,0,0,0,21000,27000,-6000,-306000
20200528,3036,文曄,39.00,39.15,38.70,38.70,-0.20,-0.51,1332080,755,51867748,134000,545249,-411249,0,0,0,0,71000,-71000,-482249
20200528,3037,欣興,40.35,41.65,40.10,40.40,+0.50,1.25,35601608,16499,1452619454,9444500,7068000,2376500,525000,50000,475000,1988000,717000,1271000,4122500
20200528,3038,全台,20.15,20.20,19.45,19.45,-0.45,-2.26,5683463,1780,112475426,489000,585000,-96000,0,871000,-871000,335000,115000,220000,-747000
20200528,3040,遠見,40.00,40.35,37.90,39.90,+3.20,8.72,5582739,2730,221341160,166000,626000,-460000,0,0,0,0,0,0,-460000
20200528,3041,揚智,17.15,17.45,16.65,16.65,-0.20,-1.19,2225219,1007,37859163,608000,584000,24000,0,0,0,0,0,0,24000
20200528,3042,晶技,59.60,60.00,58.40,58.50,-1.30,-2.17,9848541,6386,583091998,1317000,1934677,-617677,70000,455000,-385000,70000,291000,-221000,-1223677
20200528,3043,科風,1.46,1.46,1.40,1.46,0.00,0.00,57708,10,81115,0,0,0,0,0,0,0,0,0,0
20200528,3044,健鼎,114.50,116.00,113.00,113.50,+0.50,0.44,3439259,2586,394623285,542150,1278690,-736540,87000,0,87000,109000,169000,-60000,-709540
20200528,3045,台灣大,107.50,107.50,107.00,107.50,0.00,0.00,2809452,1469,301337316,1166545,1816100,-649555,0,0,0,0,14000,-14000,-663555
20200528,3046,建碁,11.95,11.95,11.85,11.85,-0.15,-1.25,4170,7,49612,0,0,0,0,0,0,0,0,0,0
20200528,3047,訊舟,8.22,8.29,8.12,8.18,+0.01,0.12,586994,207,4819069,120000,164000,-44000,0,0,0,0,0,0,-44000
20200528,3048,益登,17.90,17.95,17.60,17.70,-0.15,-0.84,674981,384,11991645,62000,110000,-48000,0,0,0,4000,0,4000,-44000
20200528,3049,和鑫,10.55,10.75,10.20,10.25,-0.20,-1.91,8575310,2588,90102022,476000,2289662,-1813662,0,0,0,110000,46000,64000,-1749662
20200528,3050,鈺德,9.38,9.39,9.18,9.20,-0.06,-0.65,423920,160,3923775,25000,63000,-38000,0,0,0,11000,0,11000,-27000
20200528,3051,力特,3.73,4.08,3.68,3.99,+0.26,6.97,1436912,224,5686617,0,0,0,0,0,0,0,0,0,0
20200528,3052,夆典,10.85,10.85,10.70,10.80,-0.05,-0.46,921502,205,9925621,98000,117000,-19000,0,0,0,0,0,0,-19000
20200528,3054,立萬利,23.80,23.90,23.65,23.65,-0.15,-0.63,14000,12,333050,0,4000,-4000,0,0,0,0,0,0,-4000
20200528,3055,蔚華科,28.00,28.00,27.55,27.60,-0.40,-1.43,55617,27,1548804,1000,12000,-11000,0,0,0,0,0,0,-11000
20200528,3056,總太,34.10,34.15,33.30,33.85,-0.15,-0.44,2197548,1120,74224515,132000,268000,-136000,0,0,0,0,0,0,-136000
20200528,3057,喬鼎,4.94,4.99,4.76,4.86,-0.01,-0.21,467261,202,2277252,0,79000,-79000,0,0,0,0,0,0,-79000
20200528,3058,立德,6.51,6.64,6.45,6.64,+0.13,2.0,157727,90,1030767,14000,8000,6000,0,0,0,0,6000,-6000,0
20200528,3059,華晶科,24.10,24.40,23.60,23.60,-0.65,-2.68,2419446,1090,57917120,218000,236000,-18000,0,0,0,0,0,0,-18000
20200528,3060,銘異,13.65,14.20,13.55,13.70,+0.05,0.37,3717663,1056,51666545,228000,399000,-171000,0,0,0,0,0,0,-171000
20200528,3062,建漢,14.70,15.15,14.50,14.55,-0.05,-0.34,2944189,1170,43757043,524000,1083000,-559000,0,0,0,0,0,0,-559000
20200528,3090,日電貿,53.20,53.30,52.20,52.20,-0.50,-0.95,1307500,911,68900495,240000,303000,-63000,0,0,0,27000,96000,-69000,-132000
20200528,3094,聯傑,18.30,18.35,18.00,18.00,-0.05,-0.28,295098,167,5365853,68000,23000,45000,0,0,0,0,0,0,45000
20200528,3130,一零四,158.00,158.00,156.50,156.50,-0.50,-0.32,3210,13,503970,0,0,0,0,0,0,0,0,0,0
20200528,3149,正達,6.99,7.04,6.92,6.99,0.00,0.00,195888,85,1368509,16000,59000,-43000,0,0,0,0,0,0,-43000
20200528,3164,景岳,24.05,24.30,23.95,23.95,-0.05,-0.21,63000,53,1517000,9000,6000,3000,0,0,0,0,0,0,3000
20200528,3167,大量,40.15,40.15,39.30,39.30,-0.15,-0.38,29130,20,1151027,1000,6000,-5000,0,0,0,0,0,0,-5000
20200528,3189,景碩,46.50,47.50,46.35,46.70,+0.40,0.86,5260531,2901,246631972,1128000,1468000,-340000,101000,50000,51000,323000,97000,226000,-63000
20200528,3209,全科,20.35,20.50,20.20,20.20,-0.05,-0.25,655463,287,13353571,119000,67000,52000,0,0,0,0,0,0,52000
20200528,3229,晟鈦,9.06,9.15,9.01,9.14,+0.01,0.11,33000,23,299280,0,0,0,0,0,0,0,0,0,0
20200528,3231,緯創,28.70,28.90,28.35,28.50,-0.10,-0.35,10479501,3968,300444403,6653058,4997000,1656058,0,0,0,51000,171000,-120000,1536058
20200528,3257,虹冠電,70.10,71.90,70.10,70.50,0.00,0.00,670614,462,47562199,158000,37000,121000,0,0,0,0,0,0,121000
20200528,3266,昇陽,14.10,14.10,13.60,13.60,-0.40,-2.86,170001,86,2358563,0,28000,-28000,0,0,0,0,0,0,-28000
20200528,3296,勝德,12.90,12.90,12.75,12.90,0.00,0.00,56350,26,723320,0,0,0,0,0,0,0,0,0,0
20200528,3305,昇貿,19.80,19.90,19.55,19.75,0.00,0.00,126094,67,2488191,1000,5000,-4000,0,0,0,0,0,0,-4000
20200528,3308,聯德,,,,,0.00,0.00,0,0,0,0,0,0,0,0,0,0,0,0,0
20200528,3311,閎暉,29.95,30.65,29.05,29.70,-0.10,-0.34,390296,259,11725627,76000,28000,48000,0,0,0,0,0,0,48000
20200528,3312,弘憶股,15.15,15.15,14.90,14.95,-0.15,-0.99,516604,223,7766773,52000,144000,-92000,0,0,0,0,0,0,-92000
20200528,3321,同泰,10.90,11.70,10.45,11.25,-0.05,-0.44,1843382,902,20422347,78000,68000,10000,0,0,0,0,0,0,10000
20200528,3338,泰碩,91.40,92.20,89.60,89.80,-1.10,-1.21,2619621,1917,237742898,162000,204000,-42000,0,124000,-124000,11000,105000,-94000,-260000
20200528,3346,麗清,26.00,26.00,25.05,25.15,-0.10,-0.4,223146,122,5646421,16000,35000,-19000,0,0,0,0,0,0,-19000
20200528,3356,奇偶,23.75,23.75,22.85,22.95,-0.50,-2.13,318656,207,7424599,22000,54000,-32000,0,0,0,0,0,0,-32000
20200528,3376,新日興,133.50,137.00,132.50,133.50,+2.00,1.52,4149098,2543,558960034,745000,1015388,-270388,709000,0,709000,89000,21000,68000,506612
20200528,3380,明泰,26.70,26.80,26.55,26.60,-0.05,-0.19,3244162,2124,86493539,604000,805000,-201000,0,0,0,30000,164000,-134000,-335000
20200528,3383,新世紀,4.10,4.13,4.05,4.13,+0.02,0.49,179771,37,736699,4000,1000,3000,0,0,0,0,0,0,3000
20200528,3406,玉晶光,483.00,495.00,478.00,481.00,+4.00,0.84,7827217,6266,3803146980,865000,687000,178000,15000,17000,-2000,445000,309000,136000,312000
20200528,3413,京鼎,171.00,171.50,166.00,167.00,-2.00,-1.18,1330129,1065,224600607,269000,126000,143000,0,0,0,12000,6000,6000,149000
20200528,3416,融程電,61.00,62.00,59.60,60.30,+0.20,0.33,578995,386,35453400,6000,19000,-13000,0,0,0,14000,0,14000,1000
20200528,3419,譁裕,14.25,14.30,13.85,13.85,-0.20,-1.42,461000,183,6518150,70000,102000,-32000,0,0,0,0,0,0,-32000
20200528,3432,台端,11.85,11.90,11.55,11.55,-0.35,-2.94,67000,43,784250,0,11000,-11000,0,0,0,2000,0,2000,-9000
20200528,3437,榮創,18.25,18.45,17.60,17.80,-0.25,-1.39,1326300,557,23803464,209000,416000,-207000,0,0,0,0,0,0,-207000
20200528,3443,創意,230.00,234.50,228.50,229.00,+1.00,0.44,2006050,1566,463873950,624000,297000,327000,0,0,0,238000,67000,171000,498000
20200528,3450,聯鈞,65.40,65.90,64.30,64.90,+0.20,0.31,2594954,1816,168905310,777000,496000,281000,0,0,0,9000,23000,-14000,267000
20200528,3454,晶睿,72.10,72.70,71.40,71.50,-0.60,-0.83,183772,145,13209847,19000,69000,-50000,0,0,0,0,0,0,-50000
20200528,3481,群創,6.29,6.30,6.15,6.17,-0.07,-1.12,43310458,7399,269411691,14249581,19080395,-4830814,0,0,0,294000,335000,-41000,-4871814
20200528,3494,誠研,3.33,3.33,3.26,3.31,0.00,0.00,114000,42,374780,1000,7000,-6000,0,0,0,0,0,0,-6000
20200528,3501,維熹,45.30,45.50,45.00,45.00,-0.30,-0.66,82100,66,3714439,7000,19000,-12000,0,0,0,0,0,0,-12000
20200528,3504,揚明光,62.90,63.50,60.30,60.50,-1.60,-2.58,654001,490,40343160,72000,63000,9000,0,0,0,2000,9000,-7000,2000
20200528,3515,華擎,141.00,142.00,136.00,136.00,-3.00,-2.16,3849516,2740,534786916,456000,885816,-429816,140000,36000,104000,127000,115000,12000,-313816
20200528,3518,柏騰,35.90,37.30,35.20,35.45,+0.05,0.14,1019490,646,36855169,252000,273000,-21000,0,0,0,0,1000,-1000,-22000
20200528,3528,安馳,38.30,38.40,38.15,38.15,-0.20,-0.52,36000,25,1377950,0,3000,-3000,0,0,0,0,0,0,-3000
20200528,3530,晶相光,81.90,82.30,79.00,79.10,-2.20,-2.71,692580,555,55689678,74000,193000,-119000,0,0,0,0,40000,-40000,-159000
20200528,3532,台勝科,152.50,153.00,148.00,150.50,-0.50,-0.33,832988,685,125280200,179000,234000,-55000,0,0,0,12000,81000,-69000,-124000
20200528,3533,嘉澤,415.00,415.00,402.00,404.00,-7.00,-1.7,2281817,1929,928715473,1334000,892000,442000,0,170000,-170000,25000,32000,-7000,265000
20200528,3535,晶彩科,15.75,16.10,15.30,15.30,-0.30,-1.92,1174131,608,18379158,307000,293000,14000,0,0,0,0,0,0,14000
20200528,3536,誠創,2.92,2.92,2.85,2.91,0.00,0.00,52513,23,151831,0,0,0,0,0,0,0,0,0,0
20200528,3543,州巧,17.55,17.55,17.15,17.20,-0.35,-1.99,311100,148,5408320,5000,8000,-3000,0,0,0,0,0,0,-3000
20200528,3545,敦泰,31.15,31.30,30.00,30.15,-0.65,-2.11,5532699,2719,169033915,308000,1678759,-1370759,0,0,0,0,0,0,-1370759
20200528,3550,聯穎,12.25,12.30,12.15,12.25,+0.05,0.41,94004,43,1150302,0,0,0,0,0,0,0,0,0,0
20200528,3557,嘉威,76.00,81.00,74.40,75.40,+1.60,2.17,10626501,7143,822534810,1060000,922000,138000,222000,0,222000,0,0,0,360000
20200528,3563,牧德,334.50,336.00,326.00,326.50,-5.00,-1.51,874984,837,288366268,72199,120000,-47801,0,90000,-90000,10000,28000,-18000,-155801
20200528,3576,聯合再生,6.10,6.14,6.00,6.01,-0.04,-0.66,4550683,1016,27483308,203000,469000,-266000,0,0,0,0,0,0,-266000
20200528,3583,辛耘,47.50,48.50,46.60,46.80,-0.40,-0.85,383000,292,18288750,96000,80000,16000,0,0,0,0,0,0,16000
20200528,3588,通嘉,37.00,37.75,34.60,35.00,-3.40,-8.85,4577519,2966,164168755,303000,489000,-186000,0,0,0,0,2000,-2000,-188000
20200528,3591,艾笛森,12.00,12.00,11.65,11.65,-0.15,-1.27,155178,73,1831663,15000,6000,9000,0,0,0,3000,0,3000,12000
20200528,3593,力銘,10.70,11.45,10.70,11.15,+0.30,2.76,138411,101,1535019,1000,1000,0,0,0,0,0,0,0,0
20200528,3596,智易,85.70,87.80,85.00,85.00,+0.50,0.59,5098332,3776,440753020,535000,782648,-247648,133000,0,133000,198000,65000,133000,18352
20200528,3605,宏致,25.05,25.20,24.35,24.70,-0.35,-1.4,1169000,625,29018150,171000,198000,-27000,0,0,0,16000,0,16000,-11000
20200528,3607,谷崧,12.15,12.90,12.00,12.25,+0.15,1.24,2442002,544,30679374,87000,233000,-146000,0,0,0,0,2000,-2000,-148000
20200528,3617,碩天,82.30,83.40,82.20,82.50,-0.10,-0.12,189100,125,15664600,21000,32000,-11000,0,0,0,6000,0,6000,-5000
20200528,3622,洋華,19.20,19.35,19.00,19.00,-0.05,-0.26,117150,69,2248783,6000,25000,-19000,0,0,0,0,0,0,-19000
20200528,3645,達邁,40.10,40.85,39.55,40.05,+0.25,0.63,629611,464,25360616,188000,113000,75000,0,0,0,0,0,0,75000
20200528,3653,健策,250.50,253.00,237.00,239.00,-6.00,-2.45,6802482,5334,1662333198,506000,554000,-48000,60000,191000,-131000,280000,375000,-95000,-274000
20200528,3661,世芯-KY,291.50,293.00,284.00,291.50,+3.50,1.22,4550650,3595,1313692800,1032080,502000,530080,45000,223000,-178000,118000,295000,-177000,175080
20200528,3665,貿聯-KY,195.50,198.00,192.50,193.50,-1.00,-0.51,2682402,1881,524911488,451000,699000,-248000,55000,0,55000,81000,77000,4000,-189000
20200528,3669,圓展,29.60,30.50,29.50,29.55,+0.05,0.17,1048107,690,31436843,158000,206000,-48000,0,0,0,0,1000,-1000,-49000
20200528,3673,TPK-KY,43.30,43.95,42.15,42.15,-0.65,-1.52,4850256,2945,208883451,1105188,478000,627188,0,0,0,232000,384000,-152000,475188
20200528,3679,新至陞,62.50,62.50,61.50,61.80,-0.20,-0.32,54120,51,3356155,9000,18000,-9000,0,0,0,0,0,0,-9000
20200528,3682,亞太電,6.63,6.69,6.50,6.51,-0.09,-1.36,3334713,1011,21958079,338000,1163000,-825000,0,0,0,0,0,0,-825000
20200528,3686,達能,3.83,3.85,3.70,3.70,-0.14,-3.65,659940,188,2479755,50000,3000,47000,0,0,0,0,0,0,47000
20200528,3694,海華,18.10,18.30,17.45,17.45,-0.85,-4.64,191651,133,3410987,5000,10000,-5000,0,0,0,0,4000,-4000,-9000
20200528,3698,隆達,18.95,19.20,18.30,18.30,-0.60,-3.17,4925783,2085,92196034,1189000,859000,330000,0,0,0,10000,60000,-50000,280000
20200528,3701,大眾控,13.05,13.45,13.05,13.45,-0.05,-0.37,7998,19,105618,1000,4000,-3000,0,0,0,0,0,0,-3000
20200528,3702,大聯大,39.45,39.75,39.00,39.20,0.00,0.00,3246229,1641,127587113,1522642,1988000,-465358,0,0,0,64000,186000,-122000,-587358
20200528,3702A,大聯大甲特,49.40,49.55,49.40,49.50,+0.10,0.2,164148,65,8123026,0,0,0,0,0,0,0,46000,-46000,-46000
20200528,3703,欣陸,12.00,12.10,11.90,11.95,0.00,0.00,1153761,197,13840853,131000,217000,-86000,0,0,0,0,0,0,-86000
20200528,3704,合勤控,16.70,16.80,16.20,16.20,-0.55,-3.28,3868707,1694,63662130,149000,730000,-581000,0,0,0,0,194000,-194000,-775000
20200528,3705,永信,48.65,48.80,47.85,48.00,-0.40,-0.83,784141,578,37954018,237000,100000,137000,0,0,0,0,0,0,137000
20200528,3706,神達,32.35,32.40,32.00,32.05,0.00,0.00,8851643,4837,284877480,3649000,1256919,2392081,8000,0,8000,76000,109000,-33000,2367081
20200528,3708,上緯投控,87.50,88.50,83.50,83.80,-2.20,-2.56,3706088,2770,319290814,261000,689000,-428000,0,0,0,29000,59000,-30000,-458000
20200528,3711,日月光投控,61.60,61.90,60.90,61.30,+0.30,0.49,7231552,3209,444086476,4128981,4717565,-588584,223000,0,223000,14000,308000,-294000,-659584
20200528,3712,永崴投控,13.70,14.05,13.50,13.50,-0.10,-0.74,424546,256,5824363,59000,122000,-63000,0,0,0,0,0,0,-63000
20200528,4104,佳醫,56.60,56.80,55.80,56.10,-0.50,-0.88,534714,415,30065090,27000,42000,-15000,0,0,0,0,0,0,-15000
20200528,4106,雃博,37.00,39.10,36.20,36.80,-1.05,-2.77,8540922,5461,321688175,840000,847000,-7000,0,0,0,0,1000,-1000,-8000
20200528,4108,懷特,20.60,20.70,19.70,20.00,-0.60,-2.91,1157478,698,23224350,27000,34000,-7000,0,0,0,2000,0,2000,-5000
20200528,4119,旭富,137.00,138.50,135.00,136.00,-0.50,-0.37,2116575,1506,288775484,154000,543000,-389000,0,192000,-192000,28000,11000,17000,-564000
20200528,4133,亞諾法,65.80,72.00,64.40,64.40,-5.40,-7.74,34733572,20671,2373156408,2163000,1369000,794000,0,0,0,12000,0,12000,806000
20200528,4137,麗豐-KY,204.00,204.50,200.50,200.50,-2.50,-1.23,384350,304,77744050,14000,88000,-74000,0,0,0,6000,24000,-18000,-92000
20200528,4141,龍燈-KY,14.30,14.40,14.05,14.30,0.00,0.00,85100,60,1210460,0,20000,-20000,0,0,0,2000,2000,0,-20000
20200528,4142,國光生,55.10,59.10,55.10,55.10,-6.10,-9.97,22961211,9994,1277708908,586000,182000,404000,0,105000,-105000,820000,136000,684000,983000
20200528,4144,康聯-KY,24.15,24.20,22.70,23.60,-0.10,-0.42,384575,287,8977633,16000,64000,-48000,0,0,0,0,3000,-3000,-51000
20200528,4148,全宇生技-KY,39.00,39.55,37.80,38.50,+0.25,0.65,202000,170,7806050,12000,33000,-21000,0,0,0,0,0,0,-21000
20200528,4155,訊映,30.60,30.85,30.15,30.15,-0.45,-1.47,374000,244,11371700,23000,48000,-25000,0,0,0,0,0,0,-25000
20200528,4164,承業醫,38.55,38.90,38.20,38.30,-0.10,-0.26,184150,125,7083652,15000,48000,-33000,0,0,0,2000,4000,-2000,-35000
20200528,4190,佐登-KY,85.10,86.30,83.60,83.70,-1.00,-1.18,153000,135,12979500,9000,9000,0,0,0,0,0,35000,-35000,-35000
20200528,4306,炎洲,10.75,10.85,10.55,10.60,-0.15,-1.4,685638,259,7329052,42000,161000,-119000,0,0,0,8000,0,8000,-111000
20200528,4414,如興,8.74,8.82,8.61,8.65,+0.01,0.12,1029869,557,8986331,528000,311000,217000,0,0,0,0,0,0,217000
20200528,4426,利勤,35.00,35.50,34.00,34.05,-0.55,-1.59,911306,569,31621042,132000,166000,-34000,0,0,0,16000,7052,8948,-25052
20200528,4438,廣越,127.50,128.00,126.00,126.00,0.00,0.00,131035,94,16674445,17000,12000,5000,0,0,0,0,0,0,5000
20200528,4439,冠星-KY,150.00,150.50,148.00,149.50,-0.50,-0.33,102002,77,15204298,0,4000,-4000,0,0,0,0,0,0,-4000
20200528,4526,東台,13.75,14.15,13.60,13.70,+0.20,1.48,1379558,703,19119812,8000,220000,-212000,0,0,0,0,0,0,-212000
20200528,4532,瑞智,17.20,17.65,17.20,17.25,+0.10,0.58,1309991,600,22810040,210000,284000,-74000,0,0,0,0,0,0,-74000
20200528,4536,拓凱,126.00,127.00,121.00,121.00,-4.00,-3.2,732176,564,90325324,56000,69000,-13000,0,0,0,0,0,0,-13000
20200528,4540,全球傳動,60.70,61.80,57.10,59.00,-0.60,-1.01,2554071,1919,152121802,302000,207000,95000,0,0,0,0,50000,-50000,45000
20200528,4545,銘鈺,27.25,27.65,26.70,26.70,-0.20,-0.74,110000,69,2996650,21000,14000,7000,0,0,0,0,1000,-1000,6000
20200528,4551,智伸科,153.00,153.50,142.00,142.00,-8.00,-5.33,1328350,1107,196405425,142000,438000,-296000,90000,0,90000,11000,52000,-41000,-247000
20200528,4552,力達-KY,34.05,34.20,33.05,33.50,-0.40,-1.18,390317,247,13113202,50000,38000,12000,82000,0,82000,1000,0,1000,95000
20200528,4555,氣立,56.60,57.60,54.80,55.80,-0.30,-0.53,1468004,1004,83233825,56000,195000,-139000,0,0,0,22000,19000,3000,-136000
20200528,4557,永新-KY,69.40,69.40,68.50,68.70,-0.10,-0.15,13000,8,893500,0,1000,-1000,0,0,0,0,0,0,-1000
20200528,4560,強信-KY,48.80,48.80,48.00,48.00,-0.70,-1.44,210000,129,10153400,116000,111000,5000,0,0,0,0,0,0,5000
20200528,4562,穎漢,17.15,17.15,16.55,16.70,-0.10,-0.6,39000,26,651100,1000,10000,-9000,0,0,0,0,0,0,-9000
20200528,4564,元翎,32.60,32.80,31.75,31.80,-0.70,-2.15,811000,516,26092200,72000,265000,-193000,0,0,0,1000,3000,-2000,-195000
20200528,4566,時碩工業,42.00,42.50,40.80,40.80,-0.50,-1.21,254000,188,10550300,22000,68000,-46000,0,0,0,0,0,0,-46000
20200528,4571,鈞興-KY,60.00,60.30,59.10,59.10,-0.60,-1.01,14000,14,833800,0,2000,-2000,0,0,0,0,0,0,-2000
20200528,4572,駐龍,86.00,93.30,86.00,93.30,+8.40,9.89,878758,518,81308020,13000,18000,-5000,0,0,0,0,0,0,-5000
20200528,4576,大銀微系統,89.20,93.00,84.50,86.00,+1.00,1.18,4271950,3135,380369675,162000,318000,-156000,233000,0,233000,0,0,0,77000
20200528,4581,光隆精密-KY,43.40,43.40,41.50,41.50,-1.35,-3.15,170000,129,7173000,0,3000,-3000,0,0,0,0,0,0,-3000
20200528,4720,德淵,14.55,15.10,14.30,14.65,+0.30,2.09,2920586,1417,43219024,105000,63000,42000,0,0,0,0,0,0,42000
20200528,4722,國精化,27.95,27.95,27.75,27.90,+0.15,0.54,324932,179,9044702,28000,19000,9000,0,0,0,0,0,0,9000
20200528,4725,信昌化,6.10,6.41,6.10,6.41,+0.58,9.95,1222635,357,7755350,0,67000,-67000,0,0,0,0,0,0,-67000
20200528,4737,華廣,66.90,67.00,65.70,65.70,-0.70,-1.05,36000,28,2393800,1000,4000,-3000,0,0,0,0,0,0,-3000
20200528,4739,康普,57.90,58.10,56.00,56.00,-1.40,-2.44,341171,234,19414178,28000,148000,-120000,0,0,0,1000,2000,-1000,-121000
20200528,4746,台耀,51.30,52.50,49.80,51.30,0.00,0.00,6277556,4015,321562721,626000,256000,370000,0,0,0,7000,7000,0,370000
20200528,4755,三福化,52.40,52.40,49.00,49.30,-2.20,-4.27,135028,124,6830475,0,10000,-10000,24000,0,24000,2000,0,2000,16000
20200528,4763,材料-KY,128.00,128.50,126.00,126.50,-1.00,-0.78,200344,152,25531516,13000,52000,-39000,0,0,0,1000,1000,0,-39000
20200528,4764,雙鍵,68.90,69.20,67.50,69.00,+0.10,0.15,65600,38,4517780,12000,8000,4000,0,0,0,0,0,0,4000
20200528,4766,南寶,138.00,138.00,132.00,134.00,-3.00,-2.19,422070,348,56510915,55000,75000,-20000,0,0,0,0,1000,-1000,-21000
20200528,4807,日成-KY,29.05,29.10,28.10,28.60,-0.30,-1.04,56001,46,1601879,1000,3000,-2000,0,0,0,1000,0,1000,-1000
20200528,4904,遠傳,65.50,65.80,65.00,65.20,-0.10,-0.15,2893500,1588,188870346,1382623,2610000,-1227377,0,0,0,15000,24000,-9000,-1236377
20200528,4906,正文,21.65,22.00,21.40,21.60,+0.10,0.47,2320440,1019,50367476,407000,364000,43000,0,0,0,39000,25000,14000,57000
20200528,4912,聯德控股-KY,84.90,90.00,84.40,86.10,+2.80,3.36,279100,238,24309309,30000,25000,5000,0,0,0,0,0,0,5000
20200528,4915,致伸,47.30,47.90,47.10,47.35,+0.45,0.96,3759507,2525,178619032,1938000,1432278,505722,0,0,0,69000,0,69000,574722
20200528,4916,事欣科,28.70,28.70,27.20,27.25,-1.05,-3.71,1144610,768,31732030,20000,433000,-413000,0,0,0,4000,0,4000,-409000
20200528,4919,新唐,38.50,39.60,38.30,38.95,+0.80,2.1,5915893,3281,230892851,615000,669000,-54000,0,0,0,71000,7000,64000,10000
20200528,4927,泰鼎-KY,68.40,69.00,67.10,68.10,0.00,0.00,3859014,2441,262727744,585000,1128000,-543000,110000,0,110000,21000,78000,-57000,-490000
20200528,4930,燦星網,10.45,10.50,10.20,10.30,-0.05,-0.48,136432,94,1411294,4000,9000,-5000,0,0,0,0,1000,-1000,-6000
20200528,4934,太極,17.70,18.00,17.30,17.40,-0.90,-4.92,6353310,2500,112198945,109000,1229000,-1120000,0,0,0,0,0,0,-1120000
20200528,4935,茂林-KY,141.50,141.50,136.00,137.00,-2.00,-1.44,3790292,2967,523411004,497000,399376,97624,0,94000,-94000,40000,246000,-206000,-202376
20200528,4938,和碩,62.30,62.50,61.20,61.50,-0.50,-0.81,9555699,4603,589997258,2522745,7590681,-5067936,292000,0,292000,67000,95000,-28000,-4803936
20200528,4942,嘉彰,34.50,34.90,34.00,34.05,0.00,0.00,629000,423,21662200,85000,319000,-234000,0,0,0,0,0,0,-234000
20200528,4943,康控-KY,119.50,120.50,116.00,116.00,-2.00,-1.69,1446427,1102,170188959,167000,416000,-249000,0,0,0,7000,13000,-6000,-255000
20200528,4952,凌通,29.25,29.50,29.00,29.10,-0.10,-0.34,136000,104,3981250,17000,31000,-14000,0,0,0,0,0,0,-14000
20200528,4956,光鋐,20.10,20.30,18.30,18.50,-1.20,-6.09,6108535,2895,117957744,170000,443000,-273000,0,0,0,0,0,0,-273000
20200528,4958,臻鼎-KY,120.00,121.50,117.00,117.50,-1.50,-1.26,4217680,2884,502071960,1229670,2153000,-923330,57000,0,57000,93000,85000,8000,-858330
20200528,4960,誠美材,6.08,6.21,6.08,6.10,+0.06,0.99,2195402,456,13484140,281000,541000,-260000,0,0,0,0,1000,-1000,-261000
20200528,4961,天鈺,27.55,28.05,27.15,27.30,-0.05,-0.18,599135,376,16562922,153000,172000,-19000,0,0,0,0,0,0,-19000
20200528,4967,十銓,43.20,43.20,40.30,40.50,-1.55,-3.69,8300561,4455,347736519,260000,761000,-501000,0,0,0,5000,0,5000,-496000
20200528,4968,立積,147.50,147.50,143.00,143.50,-1.50,-1.03,1921892,1413,278514732,392440,553000,-160560,0,0,0,9000,45000,-36000,-196560
20200528,4976,佳凌,20.50,20.75,19.50,19.50,-0.30,-1.52,2845010,1559,57323952,137000,766000,-629000,0,0,0,4000,0,4000,-625000
20200528,4977,眾達-KY,128.00,134.50,128.00,129.50,+2.50,1.97,5835854,3973,766278666,909000,536000,373000,316000,0,316000,24000,40000,-16000,673000
20200528,4989,榮科,19.80,19.80,19.20,19.20,-0.25,-1.29,129000,76,2509650,9000,17000,-8000,0,0,0,0,0,0,-8000
20200528,4994,傳奇,65.30,68.40,64.30,64.30,-0.30,-0.46,731500,611,48589349,78000,144500,-66500,0,0,0,2000,1000,1000,-65500
20200528,4999,鑫禾,40.40,40.60,40.05,40.45,+0.10,0.25,48250,49,1944634,0,10000,-10000,0,0,0,0,1000,-1000,-11000
20200528,5007,三星,44.50,44.95,44.50,44.60,-0.15,-0.34,65430,43,2933757,5000,23000,-18000,0,0,0,0,0,0,-18000
20200528,5203,訊連,116.50,117.50,112.50,113.00,-3.50,-3.0,680500,570,77861000,95000,383000,-288000,0,0,0,3000,2000,1000,-287000
20200528,5215,科嘉-KY,98.40,98.40,91.70,94.00,0.00,0.00,2542225,1912,241220544,301000,303000,-2000,0,134000,-134000,0,8000,-8000,-144000
20200528,5225,東科-KY,25.75,28.20,25.75,26.45,+0.80,3.12,1580308,1004,42831435,191000,394000,-203000,0,0,0,1000,0,1000,-202000
20200528,5234,達興材料,90.00,90.00,87.70,87.80,-1.50,-1.68,153300,126,13604600,11000,66000,-55000,0,0,0,0,0,0,-55000
20200528,5243,乙盛-KY,31.80,31.95,30.80,31.10,-0.60,-1.89,812100,416,25493575,24000,384000,-360000,0,0,0,1000,0,1000,-359000
20200528,5258,虹堡,24.30,24.30,23.55,23.75,-0.45,-1.86,117415,95,2807302,3000,49000,-46000,0,0,0,0,0,0,-46000
20200528,5264,鎧勝-KY,44.50,44.75,43.75,44.20,+0.10,0.23,1101287,716,48643148,286000,452000,-166000,0,0,0,6000,3000,3000,-163000
20200528,5269,祥碩,1140.00,1175.00,1110.00,1170.00,+55.00,4.93,1347475,1275,1546753625,499000,440051,58949,88000,19000,69000,32000,27000,5000,132949
20200528,5283,禾聯碩,99.00,99.30,98.50,98.80,-0.20,-0.2,81230,72,8028478,5000,22000,-17000,0,0,0,0,0,0,-17000
20200528,5284,jpp-KY,42.85,42.85,41.50,41.50,-0.45,-1.07,230400,157,9748999,9000,31000,-22000,0,0,0,0,0,0,-22000
20200528,5285,界霖,42.95,43.35,42.20,42.30,-0.65,-1.51,129000,90,5498900,10000,45000,-35000,0,0,0,0,0,0,-35000
20200528,5288,豐祥-KY,99.50,99.50,96.60,96.70,-1.80,-1.83,181000,124,17736700,15000,36000,-21000,0,0,0,0,0,0,-21000
20200528,5305,敦南,41.75,41.80,41.60,41.70,+0.05,0.12,468899,281,19555698,310000,95000,215000,0,0,0,0,0,0,215000
20200528,5388,中磊,73.10,73.50,72.00,72.10,-0.70,-0.96,560300,416,40650020,49000,183000,-134000,0,0,0,20000,50000,-30000,-164000
20200528,5434,崇越,106.00,106.50,104.50,105.00,0.00,0.00,843488,537,89072204,160149,125000,35149,0,0,0,0,60000,-60000,-24851
20200528,5469,瀚宇博,37.60,37.80,37.40,37.50,+0.10,0.27,7723126,3900,290406114,399000,1570347,-1171347,0,152203,-152203,150000,281000,-131000,-1454550
20200528,5471,松翰,56.90,58.80,56.30,57.10,+1.20,2.15,15430251,8848,887223926,2258000,1575000,683000,0,400000,-400000,0,0,0,283000
20200528,5484,慧友,8.03,8.16,8.03,8.16,0.00,0.00,15996,17,129632,0,1000,-1000,0,0,0,0,0,0,-1000
20200528,5515,建國,10.30,10.30,10.20,10.20,-0.10,-0.97,269244,97,2758661,11000,142000,-131000,0,0,0,0,0,0,-131000
20200528,5519,隆大,15.20,15.20,14.95,15.00,-0.10,-0.66,864033,392,13029097,119000,88000,31000,0,0,0,0,0,0,31000
20200528,5521,工信,8.72,8.98,8.70,8.80,+0.17,1.97,3780736,1127,33284562,572000,371000,201000,0,0,0,0,0,0,201000
20200528,5522,遠雄,45.90,46.15,44.30,44.35,-1.45,-3.17,3171973,1638,143691998,854000,1432850,-578850,0,0,0,70000,0,70000,-508850
20200528,5525,順天,20.30,20.35,20.20,20.20,-0.10,-0.49,22765,21,460452,0,2000,-2000,0,0,0,0,0,0,-2000
20200528,5531,鄉林,8.98,9.79,8.98,9.77,+0.87,9.78,6213398,1960,59830480,418000,414000,4000,0,0,0,1000,1000,0,4000
20200528,5533,皇鼎,15.50,15.50,15.30,15.30,-0.20,-1.29,69000,19,1067550,0,30000,-30000,0,0,0,0,0,0,-30000
20200528,5534,長虹,84.60,84.60,83.60,83.80,-0.20,-0.24,635969,415,53447987,52000,241000,-189000,0,0,0,13000,0,13000,-176000
20200528,5538,東明-KY,28.55,28.55,28.30,28.30,-0.25,-0.88,9000,8,256200,0,0,0,0,1000,-1000,0,0,0,-1000
20200528,5546,永固-KY,66.00,66.00,62.90,64.00,-1.20,-1.84,635020,368,40997098,58000,15000,43000,0,0,0,0,0,0,43000
20200528,5607,遠雄港,24.35,24.70,23.30,23.60,-0.80,-3.28,4457229,2060,107265303,234000,802000,-568000,0,0,0,0,28000,-28000,-596000
20200528,5608,四維航,5.04,5.10,5.04,5.05,+0.01,0.2,763572,258,3867350,93000,74000,19000,0,0,0,0,0,0,19000
20200528,5706,鳳凰,37.50,38.50,35.95,36.10,-0.65,-1.77,1172602,820,43382627,57000,91000,-34000,0,0,0,0,0,0,-34000
20200528,5871,中租-KY,118.00,118.00,115.50,116.50,+0.50,0.43,4323100,2114,505254741,2888381,1684050,1204331,0,0,0,3000,82000,-79000,1125331
20200528,5876,上海商銀,42.80,42.95,41.95,42.20,-0.30,-0.71,5895160,2586,249030144,2587930,2967000,-379070,0,0,0,0,8000,-8000,-387070
20200528,5880,合庫金,20.30,20.35,20.10,20.25,0.00,0.00,13897841,3947,281299300,5992185,8118000,-2125815,0,0,0,0,88000,-88000,-2213815
20200528,5906,台南-KY,17.15,17.15,16.95,16.95,+0.10,0.59,6000,5,102400,0,0,0,0,0,0,0,0,0,0
20200528,5907,大洋-KY,24.80,24.85,24.20,24.35,-0.25,-1.02,320000,185,7863200,22000,64000,-42000,0,0,0,0,0,0,-42000
20200528,6005,群益證,9.96,9.99,9.90,9.94,0.00,0.00,1541107,1569,15337657,193000,775000,-582000,0,0,0,0,0,0,-582000
20200528,6024,群益期,39.00,39.15,38.55,38.65,-0.25,-0.64,389936,241,15175668,83000,126000,-43000,0,0,0,0,50000,-50000,-93000
20200528,6108,競國,21.05,21.30,20.95,21.00,-0.05,-0.24,335041,189,7067368,35000,148000,-113000,0,0,0,0,1000,-1000,-114000
20200528,6112,聚碩,40.90,41.10,40.00,40.00,-0.65,-1.6,1566372,945,63345530,96000,369000,-273000,0,0,0,0,0,0,-273000
20200528,6115,鎰勝,43.80,44.00,43.50,43.60,-0.20,-0.46,61000,48,2672250,0,25000,-25000,0,0,0,0,0,0,-25000
20200528,6116,彩晶,6.05,6.09,5.94,5.94,-0.04,-0.67,14060256,2715,84684306,2841000,3547000,-706000,0,0,0,466000,312000,154000,-552000
20200528,6117,迎廣,16.05,16.05,15.60,16.00,-0.05,-0.31,18547,13,295637,0,4000,-4000,0,0,0,0,0,0,-4000
20200528,6120,達運,10.45,10.70,10.25,10.30,-0.05,-0.48,1207281,464,12602616,190000,423000,-233000,0,0,0,0,0,0,-233000
20200528,6128,上福,29.25,29.50,28.90,29.00,-0.40,-1.36,79154,62,2310504,8000,13000,-5000,0,0,0,0,0,0,-5000
20200528,6131,鈞泰,2.77,2.77,2.70,2.70,-0.21,-7.22,215003,35,580647,0,0,0,0,0,0,0,0,0,0
20200528,6133,金橋,7.05,7.22,6.95,7.13,+0.09,1.28,29001,15,206867,0,3000,-3000,0,0,0,0,0,0,-3000
20200528,6136,富爾特,18.85,18.85,18.70,18.80,-0.05,-0.27,93100,67,1747888,3000,3000,0,0,0,0,0,0,0,0
20200528,6139,亞翔,26.15,26.15,25.65,25.80,-0.35,-1.34,362000,194,9384350,33000,103000,-70000,0,0,0,0,0,0,-70000
20200528,6141,柏承,17.60,17.85,17.40,17.45,-0.05,-0.29,692000,352,12183000,155000,117000,38000,0,0,0,0,0,0,38000
20200528,6142,友勁,7.00,7.10,6.99,7.10,0.00,0.00,272768,76,1925022,42000,11000,31000,0,0,0,143000,0,143000,174000
20200528,6152,百一,6.17,6.17,6.07,6.12,+0.02,0.33,122831,53,749237,0,17000,-17000,0,0,0,0,0,0,-17000
20200528,6153,嘉聯益,26.50,27.55,26.00,26.80,+0.45,1.71,9312767,4726,250874909,1339000,2035000,-696000,0,0,0,1214000,183000,1031000,335000
20200528,6155,鈞寶,24.25,24.25,23.25,23.30,-0.55,-2.31,344000,218,8145250,42000,97000,-55000,0,0,0,2000,0,2000,-53000
20200528,6164,華興,5.71,5.82,5.68,5.76,+0.05,0.88,160130,68,919857,1000,5000,-4000,0,0,0,0,0,0,-4000
20200528,6165,捷泰,31.50,32.00,30.10,30.25,-2.25,-6.92,1564112,625,48120737,43000,341000,-298000,0,0,0,0,0,0,-298000
20200528,6166,凌華,69.00,70.70,69.00,70.70,+1.80,2.61,874442,629,61231067,410000,136547,273453,0,0,0,10000,0,10000,283453
20200528,6168,宏齊,13.55,13.55,13.20,13.25,-0.15,-1.12,766880,316,10240813,22000,193000,-171000,0,0,0,0,0,0,-171000
20200528,6172,互億,23.05,23.40,22.85,22.90,-0.30,-1.29,120000,60,2776900,3000,8000,-5000,0,0,0,0,0,0,-5000
20200528,6176,瑞儀,105.50,106.00,104.00,104.00,+0.50,0.48,5219837,3230,547466048,750600,317650,432950,175000,50000,125000,326000,143000,183000,740950
20200528,6177,達麗,29.20,29.30,28.85,28.90,-0.05,-0.17,1210613,426,35192762,115000,195000,-80000,0,0,0,0,0,0,-80000
20200528,6183,關貿,42.00,42.20,41.90,42.00,0.00,0.00,74322,70,3126005,4000,31000,-27000,0,0,0,0,0,0,-27000
20200528,6184,大豐電,42.15,42.20,41.80,41.90,-0.20,-0.48,216775,118,9091878,7000,23000,-16000,0,0,0,0,0,0,-16000
20200528,6189,豐藝,34.50,34.75,34.50,34.50,+0.05,0.15,300916,151,10418659,30000,30000,0,0,0,0,33000,0,33000,33000
20200528,6191,精成科,14.70,15.10,14.55,14.60,+0.10,0.69,22896618,6963,339013768,450000,1881000,-1431000,0,0,0,0,0,0,-1431000
20200528,6192,巨路,67.40,68.00,66.70,66.80,-0.60,-0.89,151211,107,10195220,9000,35000,-26000,0,0,0,26000,0,26000,0
20200528,6196,帆宣,83.10,84.10,80.20,80.50,+1.30,1.64,8813161,6276,721634341,478000,867000,-389000,0,0,0,20000,88000,-68000,-457000
20200528,6197,佳必琪,32.95,33.10,32.55,32.70,-0.10,-0.3,496537,312,16317229,54000,63000,-9000,0,0,0,0,0,0,-9000
20200528,6201,亞弘電,33.50,33.50,33.40,33.50,+0.10,0.3,23000,18,769200,0,10000,-10000,0,0,0,0,0,0,-10000
20200528,6202,盛群,66.10,66.20,65.10,65.10,-0.70,-1.06,776277,535,50947140,106000,329000,-223000,0,0,0,0,1000,-1000,-224000
20200528,6205,詮欣,26.10,26.10,25.70,25.75,-0.25,-0.96,23000,21,593450,0,4000,-4000,0,0,0,0,0,0,-4000
20200528,6206,飛捷,69.00,69.20,68.00,68.00,-0.60,-0.87,171188,130,11723996,1000,59000,-58000,0,0,0,2000,0,2000,-56000
20200528,6209,今國光,22.80,22.95,22.20,22.20,-0.40,-1.77,716540,406,16207744,142000,179000,-37000,0,0,0,0,0,0,-37000
20200528,6213,聯茂,134.00,137.00,133.00,135.00,+2.50,1.89,4738550,3387,639829016,1536311,506000,1030311,472000,20000,452000,106000,54000,52000,1534311
20200528,6214,精誠,78.90,79.20,78.20,78.60,-0.20,-0.25,608345,468,47900878,198000,358398,-160398,0,0,0,17000,0,17000,-143398
20200528,6215,和椿,15.95,16.10,15.00,15.05,-0.95,-5.94,1030050,522,15958114,12000,22000,-10000,0,0,0,7000,0,7000,-3000
20200528,6216,居易,27.40,27.50,27.30,27.30,-0.10,-0.36,71105,53,1946436,0,10000,-10000,0,0,0,0,0,0,-10000
20200528,6224,聚鼎,63.90,64.30,63.00,63.00,-1.20,-1.87,420050,317,26790864,20000,54000,-34000,0,0,0,0,0,0,-34000
20200528,6225,天瀚,2.40,2.40,2.40,2.40,+0.06,2.56,12107,10,28739,0,0,0,0,0,0,0,0,0,0
20200528,6226,光鼎,8.55,8.58,8.01,8.01,-0.44,-5.21,3126790,1025,25819367,75000,255000,-180000,0,0,0,46000,1000,45000,-135000
20200528,6230,超眾,243.00,245.50,239.00,241.00,+1.00,0.42,1013355,850,245584006,156355,104000,52355,22000,0,22000,53000,83000,-30000,44355
20200528,6235,華孚,10.95,12.00,10.95,12.00,+1.05,9.59,4157051,1102,49306353,130000,101000,29000,0,0,0,0,0,0,29000
20200528,6239,力成,100.00,101.00,97.70,98.10,-0.90,-0.91,5050591,3445,501029301,1577686,2985442,-1407756,458000,62000,396000,182000,38000,144000,-867756
20200528,6243,迅杰,9.07,9.16,8.98,8.98,-0.07,-0.77,185692,87,1679551,0,3000,-3000,0,0,0,0,0,0,-3000
20200528,6251,定穎,19.55,19.70,18.75,18.75,0.00,0.00,10622921,4302,202768765,899000,1229000,-330000,0,143000,-143000,0,450000,-450000,-923000
20200528,6257,矽格,38.05,38.15,37.30,37.30,-0.40,-1.06,3802524,2052,143138627,357334,659000,-301666,300000,0,300000,111000,80350,30650,28984
20200528,6269,台郡,108.00,108.50,106.50,106.50,-1.00,-0.93,3200682,1936,344335974,906000,554000,352000,273000,1000,272000,103000,142000,-39000,585000
20200528,6271,同欣電,139.50,140.00,136.00,136.50,-0.50,-0.36,2991250,2181,412248000,435000,597000,-162000,3000,0,3000,44000,85000,-41000,-200000
20200528,6277,宏正,91.30,91.60,89.10,89.80,-1.00,-1.1,354491,299,32091285,77000,46000,31000,0,0,0,0,0,0,31000
20200528,6278,台表科,117.50,119.50,113.00,114.00,-2.50,-2.15,12961401,7940,1501686714,2261196,1472829,788367,0,274000,-274000,202000,518000,-316000,198367
20200528,6281,全國電,69.00,69.10,68.60,68.70,-0.20,-0.29,71815,62,4950587,1000,18000,-17000,0,0,0,0,0,0,-17000
20200528,6282,康舒,20.50,20.70,20.40,20.40,0.00,0.00,2210600,827,45434669,736000,644000,92000,0,0,0,5000,1000,4000,96000
20200528,6283,淳安,21.80,21.80,21.45,21.55,+0.10,0.47,170102,117,3674681,44000,29000,15000,0,0,0,0,0,0,15000
20200528,6285,啟碁,64.40,65.00,63.70,63.90,-0.10,-0.16,2074402,1478,133654828,405000,500000,-95000,50000,0,50000,6000,130000,-124000,-169000
20200528,6288,聯嘉,21.00,22.15,20.75,21.40,+0.20,0.94,6538000,2320,140813100,473000,914000,-441000,0,0,0,4000,4000,0,-441000
20200528,6289,華上,1.85,1.85,1.81,1.81,-0.08,-4.23,30550,16,56172,0,0,0,0,0,0,0,0,0,0
20200528,6405,悅城,14.80,14.80,14.60,14.60,-0.20,-1.35,46000,16,675850,0,0,0,0,0,0,3000,0,3000,3000
20200528,6409,旭隼,773.00,779.00,762.00,766.00,0.00,0.00,147271,128,113570946,125200,124129,1071,0,0,0,0,0,0,1071
20200528,6412,群電,66.00,66.70,64.20,64.80,-0.70,-1.07,1631595,1319,107149516,971000,354076,616924,0,0,0,0,34000,-34000,582924
20200528,6414,樺漢,191.50,193.50,189.50,192.00,+1.50,0.79,844809,717,162378828,124000,94000,30000,0,0,0,21000,10000,11000,41000
20200528,6415,矽力-KY,1520.00,1595.00,1515.00,1545.00,+40.00,2.66,1561897,1394,2433634150,934300,856047,78253,6000,0,6000,41000,3000,38000,122253
20200528,6416,瑞祺電通,140.00,143.50,136.50,137.00,-1.50,-1.08,3151845,2229,440606686,544000,283000,261000,147000,76000,71000,167000,121000,46000,378000
20200528,6431,光麗-KY,22.90,23.10,22.60,22.90,0.00,0.00,39000,21,891200,0,1000,-1000,0,0,0,0,0,0,-1000
20200528,6442,光聖,35.70,36.00,35.40,35.60,0.00,0.00,53300,32,1901680,0,3000,-3000,0,0,0,0,0,0,-3000
20200528,6443,元晶,6.30,6.32,6.18,6.18,-0.05,-0.8,1631388,388,10194232,106000,162000,-56000,0,0,0,0,0,0,-56000
20200528,6449,鈺邦,30.55,30.90,30.10,30.15,-0.40,-1.31,74001,60,2253482,6000,29000,-23000,0,0,0,3000,2000,1000,-22000
20200528,6451,訊芯-KY,108.50,109.50,104.50,105.50,-1.50,-1.4,843100,709,90216200,247000,139000,108000,0,0,0,6000,16000,-10000,98000
20200528,6452,康友-KY,151.50,152.50,148.00,149.00,-2.00,-1.32,683195,515,102583150,69000,215000,-146000,0,0,0,1000,11000,-10000,-156000
20200528,6456,GIS-KY,114.50,116.00,107.50,109.00,-3.00,-2.68,10603750,6711,1186486500,1781000,1597000,184000,35000,0,35000,27000,244000,-217000,2000
20200528,6464,台數科,116.00,116.00,114.00,114.50,-0.50,-0.43,20203,15,2331446,1000,3000,-2000,0,0,0,0,0,0,-2000
20200528,6477,安集,21.40,21.55,21.10,21.20,-0.10,-0.47,126000,78,2681300,5000,26000,-21000,0,0,0,0,0,0,-21000
20200528,6491,晶碩,127.50,129.00,126.50,127.50,+1.50,1.19,221000,169,28244000,48000,24000,24000,0,0,0,0,0,0,24000
20200528,6504,南六,227.00,229.50,222.00,222.00,-5.00,-2.2,2486280,2075,558940440,97000,439500,-342500,60000,351000,-291000,100000,32000,68000,-565500
20200528,6505,台塑化,89.00,89.40,87.70,87.90,-1.10,-1.24,4994318,2854,440771002,1966132,3868511,-1902379,38000,0,38000,25000,30000,-5000,-1869379
20200528,6525,捷敏-KY,60.60,60.70,59.50,59.50,-1.00,-1.65,171410,148,10271933,7000,61000,-54000,0,0,0,0,0,0,-54000
20200528,6531,愛普,208.00,215.00,203.50,215.00,+9.50,4.62,2499960,2067,521536480,376000,207691,168309,0,0,0,3000,0,3000,171309
20200528,6533,晶心科,127.50,131.50,123.50,123.50,-3.00,-2.37,2415347,1868,308864852,120000,234000,-114000,0,0,0,0,0,0,-114000
20200528,6541,泰福-KY,45.40,45.95,44.05,44.05,-1.25,-2.76,590002,400,26405939,70000,40000,30000,0,0,0,0,0,0,30000
20200528,6552,易華電,58.90,58.90,56.90,56.90,-1.30,-2.23,639022,460,36871782,41000,207000,-166000,0,0,0,0,4000,-4000,-170000
20200528,6558,興能高,44.95,45.20,43.65,43.70,-0.80,-1.8,788100,564,35026100,99000,143000,-44000,0,0,0,0,0,0,-44000
20200528,6573,虹揚-KY,17.95,17.95,17.45,17.50,-0.15,-0.85,43523,34,767704,1000,2000,-1000,0,0,0,0,0,0,-1000
20200528,6579,研揚,64.10,64.60,64.10,64.20,+0.20,0.31,12110,13,779140,1000,2000,-1000,0,0,0,0,0,0,-1000
20200528,6581,鋼聯,60.60,60.80,59.70,60.50,-0.10,-0.17,49008,50,2953604,5000,20000,-15000,0,0,0,0,0,0,-15000
20200528,6582,申豐,103.50,107.00,101.00,102.50,+1.00,0.99,1151095,967,119072475,143000,114000,29000,0,0,0,0,8000,-8000,21000
20200528,6591,動力-KY,48.50,49.35,47.65,47.75,-0.50,-1.04,529271,395,25631188,50000,53000,-3000,0,0,0,2000,0,2000,-1000
20200528,6592,和潤企業,80.10,80.50,79.50,79.70,0.00,0.00,1325298,773,105903906,307000,267000,40000,0,0,0,10000,1000,9000,49000
20200528,6605,帝寶,49.90,50.00,48.80,48.80,-0.65,-1.31,202200,163,9989256,29000,58000,-29000,0,0,0,0,0,0,-29000
20200528,6625,必應,38.85,38.85,38.85,38.85,0.00,0.00,1500,3,58100,0,0,0,0,0,0,0,0,0,0
20200528,6641,基士德-KY,67.80,68.30,67.80,68.10,+0.10,0.15,25014,23,1702759,2000,0,2000,0,0,0,0,0,0,2000
20200528,6655,科定,41.80,41.80,40.90,40.90,-0.10,-0.24,31101,26,1281470,0,11000,-11000,0,0,0,0,0,0,-11000
20200528,6666,羅麗芬-KY,122.00,123.00,120.50,121.00,0.00,0.00,22502,26,2741493,1000,0,1000,0,0,0,0,0,0,1000
20200528,6668,中揚光,59.10,59.20,57.20,57.20,-1.30,-2.22,241000,193,13985400,30000,55000,-25000,0,0,0,0,0,0,-25000
20200528,6669,緯穎,874.00,883.00,845.00,845.00,-21.00,-2.42,1341926,1266,1158920730,354836,531500,-176664,5000,15000,-10000,72000,36000,36000,-150664
20200528,6670,復盛應用,177.00,180.00,176.00,176.00,-1.00,-0.56,599426,449,106554976,228000,61000,167000,0,0,0,23000,46000,-23000,144000
20200528,6671,三能-KY,38.10,39.50,37.80,39.50,+1.30,3.4,23000,19,877900,2000,2000,0,0,0,0,0,0,0,0
20200528,6672,騰輝電子-KY,90.60,91.00,89.20,89.30,-0.70,-0.78,654150,444,58891245,70000,119000,-49000,0,0,0,0,0,0,-49000
20200528,6674,鋐寶科技,25.00,25.00,24.10,24.70,+0.20,0.82,38000,28,926550,0,1000,-1000,0,0,0,1000,0,1000,0
20200528,6698,旭暉應材,52.00,52.50,51.20,51.20,-0.80,-1.54,66000,54,3419400,6000,6000,0,0,0,0,0,0,0,0
20200528,6706,惠特,153.50,158.00,148.50,154.00,+4.00,2.67,2067655,1589,317431196,117000,90000,27000,90000,30000,60000,93000,1000,92000,179000
20200528,6715,嘉基,122.00,122.00,110.50,113.50,-8.50,-6.97,1156867,903,134307770,155000,40000,115000,0,0,0,0,14000,-14000,101000
20200528,8011,台通,17.10,17.30,16.70,16.75,-0.35,-2.05,1420020,713,24078232,110000,265000,-155000,0,0,0,0,0,0,-155000
20200528,8016,矽創,153.50,161.00,153.50,155.50,+5.50,3.67,13334130,9425,2097635280,1337400,1450000,-112600,8000,0,8000,252000,16000,236000,131400
20200528,8021,尖點,20.45,20.55,20.05,20.10,-0.20,-0.99,507284,240,10305890,102000,173000,-71000,0,0,0,0,0,0,-71000
20200528,8028,昇陽半導體,50.80,51.80,50.40,50.60,+0.10,0.2,1754745,1187,89555594,236000,234000,2000,100000,0,100000,3000,0,3000,105000
20200528,8033,雷虎,8.12,8.12,7.96,8.02,-0.08,-0.99,258232,141,2075270,0,10000,-10000,0,0,0,0,0,0,-10000
20200528,8039,台虹,48.05,48.25,46.80,46.90,-0.85,-1.78,1392081,991,66074135,79000,612000,-533000,0,0,0,11000,111000,-100000,-633000
20200528,8046,南電,56.40,56.80,55.00,55.00,-1.00,-1.79,15447300,7373,862712250,1914000,2677000,-763000,566000,683000,-117000,162000,171000,-9000,-889000
20200528,8070,長華,158.50,159.50,158.50,159.00,0.00,0.00,71040,52,11320900,1000,14000,-13000,0,0,0,0,0,0,-13000
20200528,8072,陞泰,22.05,22.25,21.60,21.60,-0.45,-2.04,60119,53,1311778,0,13000,-13000,0,0,0,0,0,0,-13000
20200528,8081,致新,149.50,155.00,149.00,155.00,+8.00,5.44,5166371,3481,788578134,1526000,732593,793407,263000,0,263000,196000,95000,101000,1157407
20200528,8101,華冠,4.41,4.41,3.76,3.90,-0.11,-2.74,1157651,316,4710127,0,0,0,0,0,0,0,0,0,0
20200528,8103,瀚荃,25.80,25.90,25.70,25.70,+0.05,0.19,166500,93,4298974,5000,19000,-14000,0,0,0,0,0,0,-14000
20200528,8104,錸寶,41.10,41.60,39.70,39.95,-1.15,-2.8,396933,289,16078703,26000,48000,-22000,0,0,0,0,0,0,-22000
20200528,8105,凌巨,9.12,9.23,8.91,8.93,-0.19,-2.08,919302,377,8339097,191000,449000,-258000,0,0,0,0,0,0,-258000
20200528,8110,華東,10.30,10.40,9.91,9.96,-0.44,-4.23,3330500,1405,33723063,65000,1103000,-1038000,0,0,0,47000,0,47000,-991000
20200528,8112,至上,30.00,30.10,29.70,29.70,-0.15,-0.5,3654695,2159,109267810,323000,2357000,-2034000,0,0,0,0,1000,-1000,-2035000
20200528,8114,振樺電,86.50,86.50,84.50,84.50,-1.00,-1.17,37105,38,3152891,0,7000,-7000,0,0,0,0,0,0,-7000
20200528,8131,福懋科,37.65,37.70,37.15,37.15,-0.30,-0.8,551560,274,20668741,94000,115000,-21000,0,0,0,1000,8000,-7000,-28000
20200528,8150,南茂,31.75,31.75,30.85,30.90,-0.65,-2.06,5652647,2791,176864726,524650,2798790,-2274140,500000,0,500000,40000,124000,-84000,-1858140
20200528,8163,達方,36.25,36.50,36.00,36.15,0.00,0.00,1658501,1097,60076385,165000,522000,-357000,0,0,0,4000,30000,-26000,-383000
20200528,8201,無敵,8.34,8.53,8.25,8.37,+0.04,0.48,106735,59,896830,0,14000,-14000,0,0,0,0,0,0,-14000
20200528,8210,勤誠,95.40,95.60,93.00,93.00,-1.40,-1.48,1341065,1018,126314850,81000,247000,-166000,0,0,0,40000,50000,-10000,-176000
20200528,8213,志超,36.30,36.95,36.20,36.80,+1.05,2.94,7213727,3419,264346497,831000,748803,82197,0,0,0,158000,19000,139000,221197
20200528,8215,明基材,16.80,16.85,16.50,16.50,-0.20,-1.2,852784,378,14205568,228000,189000,39000,0,0,0,0,0,0,39000
20200528,8222,寶一,13.40,14.60,13.30,14.60,+1.30,9.77,1155239,421,16789538,21000,12000,9000,0,0,0,0,0,0,9000
20200528,8249,菱光,18.60,18.60,18.40,18.40,-0.15,-0.81,79051,60,1461394,4000,14000,-10000,0,0,0,0,0,0,-10000
20200528,8261,富鼎,25.30,25.35,24.50,24.55,-0.45,-1.8,265090,198,6612505,24000,100000,-76000,0,0,0,1000,0,1000,-75000
20200528,8271,宇瞻,53.40,54.40,49.20,49.50,-2.50,-4.81,13001553,8444,673332482,3620023,3607000,13023,0,0,0,79000,0,79000,92023
20200528,8341,日友,266.00,267.50,264.50,264.50,-0.50,-0.19,78817,90,20955322,41000,34000,7000,0,0,0,1000,0,1000,8000
20200528,8367,建新國際,25.40,25.40,25.15,25.40,+0.15,0.59,130000,73,3288150,3000,5000,-2000,0,0,0,0,0,0,-2000
20200528,8374,羅昇,20.90,20.90,20.30,20.85,-0.20,-0.95,186000,107,3841650,3000,23000,-20000,0,0,0,1000,1000,0,-20000
20200528,8404,百和興業-KY,30.80,30.80,29.90,29.90,-0.60,-1.97,342917,278,10352360,63000,168000,-105000,0,0,0,0,0,0,-105000
20200528,8411,福貞-KY,10.60,10.60,10.40,10.55,-0.05,-0.47,113100,57,1185620,0,9000,-9000,0,0,0,0,0,0,-9000
20200528,8422,可寧衛,157.00,157.50,156.00,156.00,-0.50,-0.32,202781,177,31800117,21000,121000,-100000,0,0,0,0,0,0,-100000
20200528,8427,基勝-KY,,,,,0.00,0.00,0,0,0,0,0,0,0,0,0,0,0,0,0
20200528,8429,金麗-KY,7.47,7.47,7.25,7.25,-0.15,-2.03,494268,211,3646509,12000,52000,-40000,0,0,0,0,0,0,-40000
20200528,8442,威宏-KY,40.25,40.65,39.85,40.30,+0.05,0.12,35000,30,1408400,0,7000,-7000,0,0,0,0,2000,-2000,-9000
20200528,8443,阿瘦,8.72,8.78,8.65,8.72,+0.09,1.04,60894,44,530025,1000,0,1000,0,0,0,0,0,0,1000
20200528,8454,富邦媒,569.00,569.00,548.00,548.00,-16.00,-2.84,218623,240,121220650,85021,91000,-5979,0,30000,-30000,1000,11000,-10000,-45979
20200528,8462,柏文,199.00,199.00,194.00,195.50,-0.50,-0.26,159959,195,31388437,39000,49000,-10000,0,0,0,0,11000,-11000,-21000
20200528,8463,潤泰材,39.30,40.40,38.80,38.80,+0.20,0.52,593417,448,23515124,74000,97000,-23000,0,0,0,0,0,0,-23000
20200528,8464,億豐,257.00,257.50,251.00,252.00,-3.00,-1.18,358648,319,91277563,227591,163000,64591,22000,0,22000,0,1000,-1000,85591
20200528,8466,美吉吉-KY,66.00,66.70,65.50,66.70,+0.10,0.15,13000,12,859100,0,2000,-2000,0,0,0,0,0,0,-2000
20200528,8467,波力-KY,,,,,0.00,0.00,0,0,0,0,0,0,0,0,0,0,0,0,0
20200528,8473,山林水,43.50,43.50,42.90,43.20,-0.20,-0.46,77319,58,3333693,3000,10000,-7000,0,0,0,0,0,0,-7000
20200528,8478,東哥遊艇,35.30,37.50,35.30,35.75,+0.75,2.14,147000,126,5323700,9000,15000,-6000,0,0,0,0,0,0,-6000
20200528,8480,泰昇-KY,138.50,138.50,136.00,137.50,-1.00,-0.72,18007,19,2468459,8000,9000,-1000,0,0,0,0,0,0,-1000
20200528,8481,政伸,60.50,60.80,60.00,60.00,-0.20,-0.33,3000,3,181300,0,1000,-1000,0,0,0,0,0,0,-1000
20200528,8482,商億-KY,107.50,108.50,106.00,106.00,-1.00,-0.93,98000,53,10519500,3000,36000,-33000,0,0,0,0,0,0,-33000
20200528,8488,吉源-KY,13.55,13.55,13.50,13.55,0.00,0.00,8000,6,108250,0,1000,-1000,0,0,0,0,0,0,-1000
20200528,8497,格威傳媒,,,,,0.00,0.00,0,0,0,0,0,0,0,0,0,0,0,0,0
20200528,8499,鼎炫-KY,106.00,107.50,104.00,104.00,-1.50,-1.42,114050,102,12038325,14000,17000,-3000,0,0,0,0,0,0,-3000
20200528,8926,台汽電,37.75,37.75,37.00,37.00,-0.55,-1.46,2264819,1146,84259178,322000,343005,-21005,0,0,0,0,8000,-8000,-29005
20200528,8940,新天地,13.50,13.80,12.05,12.40,-0.70,-5.34,2627313,1305,34327575,10000,69000,-59000,0,0,0,0,0,0,-59000
20200528,8996,高力,73.50,74.40,71.20,72.20,-0.80,-1.1,2632857,1817,191280656,565000,258000,307000,0,0,0,0,145000,-145000,162000
20200528,9103,美德醫療-DR,8.36,8.36,8.36,8.36,+0.76,10.0,6777809,1624,56662481,1000,0,1000,0,0,0,0,0,0,1000
20200528,910322,康師傅-DR,26.80,26.80,25.05,25.05,-0.95,-3.65,26000,19,659750,0,22000,-22000,0,0,0,0,0,0,-22000
20200528,910482,聖馬丁-DR,0.23,0.24,0.23,0.24,0.00,0.00,1197211,103,286237,0,0,0,0,0,0,0,0,0,0
20200528,9105,泰金寶-DR,2.47,2.47,2.45,2.47,+0.01,0.41,382382,86,942046,55000,19000,36000,0,0,0,0,0,0,36000
20200528,910861,神州-DR,8.22,8.36,8.11,8.20,-0.37,-4.32,174000,55,1429860,0,166000,-166000,0,0,0,0,0,0,-166000
20200528,9110,越南控-DR,,,,,0.00,0.00,0,0,0,0,0,0,0,0,0,0,0,0,0
20200528,911608,明輝-DR,1.21,1.21,1.17,1.18,-0.02,-1.67,13000,9,15570,0,0,0,0,0,0,0,0,0,0
20200528,911616,杜康-DR,0.90,0.90,0.83,0.84,-0.08,-8.7,1778000,141,1501630,0,0,0,0,0,0,0,0,0,0
20200528,911622,泰聚亨-DR,,,,,0.00,0.00,0,0,0,0,0,0,0,0,0,0,0,0,0
20200528,911868,同方友友-DR,0.92,0.95,0.91,0.95,-0.01,-1.04,6000,5,5510,0,0,0,0,0,0,0,0,0,0
20200528,912000,晨訊科-DR,1.90,1.90,1.90,1.90,0.00,0.00,1000,1,1900,0,0,0,0,0,0,0,0,0,0
20200528,912398,友佳-DR,2.19,2.19,2.15,2.18,-0.01,-0.46,157000,15,339610,0,0,0,0,0,0,0,0,0,0
20200528,9136,巨騰-DR,9.12,9.20,9.01,9.08,-0.03,-0.33,520000,86,4722840,14000,37000,-23000,0,0,0,0,0,0,-23000
20200528,9188,精熙-DR,2.51,2.52,2.49,2.52,+0.01,0.4,103001,28,257722,0,3000,-3000,0,0,0,0,0,0,-3000
20200528,9802,鈺齊-KY,99.80,103.50,99.20,99.50,+1.60,1.63,7934450,5573,801906908,914000,1893000,-979000,584000,0,584000,237000,91000,146000,-249000
20200528,9902,台火,9.18,9.18,8.93,9.04,-0.06,-0.66,349714,125,3153104,1000,20000,-19000,0,0,0,0,0,0,-19000
20200528,9904,寶成,29.75,29.85,28.85,29.00,-0.65,-2.19,34383019,9632,1002047137,19372762,20685000,-1312238,618000,0,618000,65000,117000,-52000,-746238
20200528,9905,大華,21.35,21.60,21.35,21.50,+0.20,0.94,227000,101,4880950,8000,36000,-28000,0,0,0,0,0,0,-28000
20200528,9906,欣巴巴,21.90,21.90,21.70,21.90,0.00,0.00,38012,19,830907,0,2000,-2000,0,0,0,0,0,0,-2000
20200528,9907,統一實,8.83,8.88,8.75,8.79,-0.02,-0.23,1690848,516,14933576,89000,343000,-254000,0,0,0,0,0,0,-254000
20200528,9908,大台北,30.05,30.10,29.90,29.95,-0.20,-0.66,91293,70,2737998,2000,67000,-65000,0,0,0,0,0,0,-65000
20200528,9910,豐泰,191.50,191.50,184.50,185.50,-5.50,-2.88,1423998,1132,266353128,691277,824700,-133423,0,0,0,4000,20000,-16000,-149423
20200528,9911,櫻花,47.40,47.60,46.65,46.85,-0.40,-0.85,147666,139,6965746,13000,63000,-50000,0,0,0,1000,0,1000,-49000
20200528,9912,偉聯,6.66,6.67,6.45,6.50,-0.09,-1.37,56629,37,368921,0,2000,-2000,0,0,0,0,0,0,-2000
20200528,9914,美利達,172.50,179.00,171.50,178.00,+7.50,4.4,3295242,2512,581140334,1096000,712000,384000,278000,30000,248000,16000,18000,-2000,630000
20200528,9917,中保科,86.40,86.50,85.80,85.80,-0.70,-0.81,412437,365,35495409,61000,379000,-318000,0,0,0,26000,0,26000,-292000
20200528,9918,欣天然,34.65,34.65,34.10,34.10,-0.55,-1.59,6319,13,216955,0,2000,-2000,0,0,0,0,0,0,-2000
20200528,9919,康那香,38.95,43.25,38.95,41.30,-1.95,-4.51,11675856,4733,473231982,524000,21000,503000,0,10000,-10000,548000,143000,405000,898000
20200528,9921,巨大,243.50,243.50,236.50,238.00,-4.00,-1.65,1784693,1528,427537084,1211237,991000,220237,0,103000,-103000,17000,5000,12000,129237
20200528,9924,福興,40.90,40.90,40.30,40.40,-0.40,-0.98,107114,95,4346101,2000,74000,-72000,0,0,0,0,0,0,-72000
20200528,9925,新保,36.25,36.30,36.15,36.30,+0.05,0.14,139685,83,5063913,2000,48000,-46000,0,0,0,0,0,0,-46000
20200528,9926,新海,42.35,42.35,42.15,42.15,-0.20,-0.47,5006,7,211502,0,1000,-1000,0,0,0,0,0,0,-1000
20200528,9927,泰銘,29.80,29.95,29.70,29.70,-0.20,-0.67,107129,76,3191192,8000,27000,-19000,0,0,0,0,0,0,-19000
20200528,9928,中視,,,,,0.00,0.00,0,0,0,0,0,0,0,0,0,0,0,0,0
20200528,9929,秋雨,11.60,11.60,11.20,11.45,-0.15,-1.29,56000,20,639800,0,1000,-1000,0,0,0,1000,0,1000,0
20200528,9930,中聯資源,44.30,44.40,43.70,43.80,-0.30,-0.68,111980,82,4937209,3000,27000,-24000,0,0,0,0,0,0,-24000
20200528,9931,欣高,40.25,40.50,40.25,40.50,0.00,0.00,2000,2,80750,0,1000,-1000,0,0,0,0,0,0,-1000
20200528,9933,中鼎,34.75,34.95,34.20,34.25,-0.45,-1.3,1972555,1256,68334866,200000,816000,-616000,0,0,0,10000,0,10000,-606000
20200528,9934,成霖,12.55,12.65,12.45,12.55,+0.05,0.4,674232,262,8464673,157000,178000,-21000,0,0,0,0,0,0,-21000
20200528,9935,慶豐富,28.65,30.70,28.65,29.45,+0.85,2.97,3909478,1867,116411099,674000,657000,17000,0,0,0,0,0,0,17000
20200528,9937,全國,44.10,44.10,43.60,44.10,-0.05,-0.11,10009,9,438394,1000,9000,-8000,0,0,0,0,0,0,-8000
20200528,9938,百和,70.90,71.70,69.30,69.30,-0.40,-0.57,3673031,2481,258206148,419000,774000,-355000,0,0,0,49000,119000,-70000,-425000
20200528,9939,宏全,55.10,55.40,54.50,54.50,-0.30,-0.55,703135,444,38583369,191000,231637,-40637,0,0,0,33000,36000,-3000,-43637
20200528,9940,信義,27.00,27.05,26.60,26.60,-0.30,-1.12,284175,190,7630618,6000,98000,-92000,0,0,0,1000,0,1000,-91000
20200528,9941,裕融,102.00,102.00,101.00,101.50,0.00,0.00,199078,180,20202410,6000,29000,-23000,0,0,0,0,0,0,-23000
20200528,9941A,裕融甲特,52.90,53.00,52.80,53.00,0.00,0.00,20100,14,1062450,0,0,0,0,0,0,3000,0,3000,3000
20200528,9942,茂順,63.50,64.10,63.50,63.60,0.00,0.00,62261,59,3970434,14000,31000,-17000,0,0,0,0,0,0,-17000
20200528,9943,好樂迪,66.80,67.10,65.70,65.70,-1.10,-1.65,275710,240,18269144,11000,67000,-56000,0,0,0,0,0,0,-56000
20200528,9944,新麗,22.70,23.80,22.00,22.75,+0.05,0.22,3564238,1791,82043175,244000,469000,-225000,0,0,0,0,1000,-1000,-226000
20200528,9945,潤泰新,46.25,46.35,45.55,45.75,-0.35,-0.76,4416747,2157,203360778,932248,1443000,-510752,0,0,0,18000,4000,14000,-496752
20200528,9946,三發地產,15.60,15.60,15.15,15.35,+0.05,0.33,198510,87,3048905,5000,59000,-54000,0,0,0,0,0,0,-54000
20200528,9955,佳龍,16.10,16.40,16.10,16.15,+0.10,0.62,292942,170,4763345,49000,46000,3000,0,0,0,0,0,0,3000
20200528,9958,世紀鋼,87.90,93.80,87.50,91.80,+4.30,4.91,24477280,15779,2235226807,7314000,909123,6404877,1178000,0,1178000,1422000,405000,1017000,8599877
20200528,00679B,元大美債20年,49.80,49.89,49.61,49.69,-0.15,-0.3,873000,206,43407390,0,132000,-132000,0,0,0,631000,616000,15000,-117000
20200528,00687B,國泰20年美債,52.10,52.25,52.00,52.10,-0.15,-0.29,194000,32,10122300,0,52000,-52000,0,0,0,100000,126000,-26000,-78000
20200528,00694B,富邦美債1-3,40.66,40.73,40.66,40.73,+0.04,0.1,358000,8,14580680,53000,0,53000,0,0,0,300000,350000,-50000,3000
20200528,00695B,富邦美債7-10,42.36,42.43,42.35,42.43,+0.05,0.12,307000,7,13025610,0,0,0,0,0,0,303000,300000,3000,3000
20200528,00696B,富邦美債20年,52.10,52.15,51.90,52.05,-0.15,-0.29,415000,16,21640500,0,2000,-2000,0,0,0,401000,411000,-10000,-12000
20200528,00697B,元大美債7-10,44.96,44.98,44.90,44.98,+0.04,0.09,162000,12,7286340,0,2000,-2000,0,0,0,105000,103000,2000,0
20200528,00718B,富邦中國政策債,19.45,19.46,19.43,19.46,-0.02,-0.1,485000,53,9436960,0,0,0,0,0,0,400000,441000,-41000,-41000
20200528,00719B,元大美債1-3,32.44,32.44,32.40,32.42,+0.03,0.09,177000,13,5739690,59000,0,59000,0,0,0,102000,169000,-67000,-8000
20200528,00720B,元大投資級公司債,45.33,45.39,45.30,45.35,+0.12,0.27,220000,44,9978280,0,0,0,0,0,0,204000,107000,97000,97000
20200528,00721B,元大中國債3-5,44.80,44.84,44.74,44.84,-0.06,-0.13,191000,10,8557640,0,0,0,0,0,0,132000,141000,-9000,-9000
20200528,00722B,群益15年IG電信債,49.62,49.67,49.49,49.67,+0.20,0.4,114000,18,5654320,0,0,0,0,0,0,110000,109000,1000,1000
20200528,00723B,群益15年IG科技債,46.67,46.70,46.67,46.70,+0.10,0.21,102000,6,4763340,0,0,0,0,0,0,100000,100000,0,0
20200528,00724B,群益10年IG金融債,43.73,43.84,43.70,43.84,+0.18,0.41,116000,13,5083480,0,0,0,0,0,0,112000,100000,12000,12000
20200528,00725B,國泰投資級公司債,43.55,43.61,43.51,43.58,+0.13,0.3,113000,9,4924500,0,0,0,0,0,0,102000,107000,-5000,-5000
20200528,00726B,國泰5Y+新興債,43.40,43.40,43.38,43.38,+0.14,0.32,104000,4,4513540,0,0,0,0,0,0,103000,100000,3000,3000
20200528,00727B,國泰1-5Y高收債,38.92,38.95,38.92,38.93,+0.12,0.31,104000,5,4048720,0,0,0,0,0,0,103000,100000,3000,3000
20200528,00734B,台新JPM新興債,21.24,21.24,21.15,21.19,0.00,0.0,1014000,25,21477060,0,0,0,0,0,0,965000,985000,-20000,-20000
20200528,00740B,富邦全球投等債,47.93,47.95,47.92,47.93,+0.06,0.13,324000,9,15529340,0,0,0,0,0,0,320000,320000,0,0
20200528,00741B,富邦全球高收債,37.97,37.97,37.88,37.90,+0.02,0.05,332000,21,12587450,0,0,0,0,0,0,331000,211000,120000,120000
20200528,00744B,國泰中國政金債5+,41.36,41.36,41.30,41.30,+0.07,0.17,124000,4,5121920,0,0,0,0,0,0,124000,124000,0,0
20200528,00745B,富邦中政債0-1,38.51,38.64,38.51,38.64,-0.01,-0.03,110000,5,4249100,0,0,0,0,0,0,110000,110000,0,0
20200528,00746B,富邦A級公司債,47.55,47.65,47.55,47.55,0.00,0.0,103000,5,4902650,0,0,0,0,0,0,103000,100000,3000,3000
20200528,00747B,FH中國政策債,50.30,50.30,50.30,50.30,-0.20,-0.4,100000,2,5030000,0,0,0,0,0,0,100000,100000,0,0
20200528,00748B,凱基中國債3-10,40.92,40.92,40.92,40.92,-0.13,-0.32,100000,2,4092000,0,0,0,0,0,0,100000,100000,0,0
20200528,00749B,凱基新興債10+,46.34,46.56,46.34,46.56,+0.19,0.41,116000,13,5378390,0,13000,-13000,0,0,0,100000,100000,0,-13000
20200528,00750B,凱基科技債10+,47.69,47.69,47.69,47.69,+0.14,0.29,100000,2,4769000,0,0,0,0,0,0,100000,100000,0,0
20200528,00751B,元大AAA至A公司債,48.59,48.69,48.58,48.67,+0.08,0.16,196000,44,9538200,0,0,0,0,0,0,163000,143000,20000,20000
20200528,00754B,群益AAA-AA公司債,50.30,50.40,50.30,50.40,+0.25,0.5,101000,3,5080400,0,0,0,0,0,0,100000,101000,-1000,-1000
20200528,00755B,群益15年IG公用債,46.79,46.79,46.72,46.74,+0.14,0.3,108000,11,5048010,0,0,0,0,0,0,103000,102000,1000,1000
20200528,00756B,群益15年EM主權債,48.62,48.70,48.62,48.70,+0.08,0.16,121000,9,5883100,0,0,0,0,0,0,120000,121000,-1000,-1000
20200528,00758B,FH能源債,61.20,61.20,61.10,61.10,+0.55,0.91,101000,3,6171200,0,0,0,0,0,0,101000,100000,1000,1000
20200528,00759B,FH製藥債,76.10,76.10,76.00,76.00,-0.10,-0.13,101000,3,7686000,0,0,0,0,0,0,101000,100000,1000,1000
20200528,00760B,FH新興企業債,65.45,65.60,65.45,65.50,-0.15,-0.23,102000,6,6690950,0,0,0,0,0,0,102000,100000,2000,2000
20200528,00761B,國泰A級公司債,49.62,49.76,49.62,49.76,+0.03,0.06,104000,6,5171900,0,0,0,0,0,0,104000,100000,4000,4000
20200528,00764B,群益25年美債,52.75,52.75,52.65,52.65,-0.15,-0.28,108000,8,5691700,0,0,0,0,0,0,100000,108000,-8000,-8000
20200528,00765B,群益中國政金債,39.36,39.39,39.36,39.39,-0.02,-0.05,101000,3,3975390,0,0,0,0,0,0,100000,101000,-1000,-1000
20200528,00768B,FH20年美債,82.30,82.30,82.30,82.30,0.00,0.0,100000,2,8230000,0,0,0,0,0,0,100000,100000,0,0
20200528,00772B,中信高評級公司債,48.05,48.19,48.05,48.19,+0.18,0.37,733000,39,35287190,0,0,0,0,0,0,701000,708000,-7000,-7000
20200528,00773B,中信優先金融債,47.50,47.54,47.50,47.52,+0.05,0.11,670000,22,31827630,0,0,0,0,0,0,649000,646000,3000,3000
20200528,00777B,凱基AAA至A公司債,47.77,47.77,47.77,47.77,+0.14,0.29,100000,2,4777000,0,0,0,0,0,0,100000,100000,0,0
20200528,00778B,凱基金融債20+,47.12,47.12,47.12,47.12,+0.22,0.47,120000,4,5654400,0,0,0,0,0,0,120000,120000,0,0
20200528,00779B,凱基美債25+,53.50,53.50,53.50,53.50,+0.05,0.09,100000,2,5350000,0,0,0,0,0,0,100000,100000,0,0
20200528,00780B,國泰A級金融債,43.10,43.20,43.10,43.20,+0.14,0.33,101000,3,4363100,0,0,0,0,0,0,101000,100000,1000,1000
20200528,00781B,國泰A級科技債,47.77,47.80,47.75,47.75,-0.10,-0.21,136000,6,6499550,0,0,0,0,0,0,102000,134000,-32000,-32000
20200528,00782B,國泰A級公用債,45.74,45.83,45.74,45.83,+0.06,0.13,116000,6,5314900,0,0,0,0,0,0,116000,113000,3000,3000
20200528,00784B,富邦中國投等債,40.80,40.81,40.80,40.81,0.00,0.0,200000,4,8161000,0,0,0,0,0,0,200000,200000,0,0
20200528,00785B,富邦金融投等債,44.81,44.83,44.79,44.83,+0.08,0.18,222000,8,9951570,0,0,0,0,0,0,222000,200000,22000,22000
20200528,00786B,元大10年IG銀行債,43.88,43.98,43.88,43.98,+0.25,0.57,5000,5,219560,0,0,0,0,0,0,5000,3000,2000,2000
20200528,00787B,元大10年IG醫療債,46.41,46.50,46.41,46.48,+0.15,0.32,23000,4,1068990,0,0,0,0,0,0,2000,1000,1000,1000
20200528,00788B,元大10年IG電能債,44.20,44.37,44.20,44.37,+0.26,0.59,2000,2,88570,0,0,0,0,0,0,2000,2000,0,0
20200528,00789B,FH公司債A3,71.10,71.10,71.10,71.10,+0.05,0.07,100000,6,7110000,0,0,0,0,0,0,100000,100000,0,0
20200528,00790B,FH次順位IG金融債,66.35,66.35,66.35,66.35,+0.20,0.3,100000,2,6635000,0,0,0,0,0,0,100000,100000,0,0
20200528,00791B,FH美元信用債1-5Y,59.75,59.75,59.75,59.75,-0.10,-0.17,100000,2,5975000,0,0,0,0,0,0,100000,100000,0,0
20200528,00792B,群益A級公司債,46.22,46.22,46.22,46.22,+0.02,0.04,100000,2,4622000,0,0,0,0,0,0,100000,100000,0,0
20200528,00793B,群益AAA-A醫療債,47.08,47.08,47.08,47.08,+0.09,0.19,100000,2,4708000,0,0,0,0,0,0,100000,100000,0,0
20200528,00794B,群益7+中國政金債,39.34,39.34,39.15,39.19,-0.11,-0.28,118000,6,4625020,0,0,0,0,0,0,111000,106000,5000,5000
20200528,00795B,中信美國公債20年,50.10,50.10,49.97,50.00,-0.05,-0.1,225000,16,11259880,0,0,0,0,0,0,216000,216000,0,0
20200528,00796B,中信中國債7-10,39.04,39.07,39.04,39.07,-0.07,-0.18,210000,6,8200500,0,0,0,0,0,0,210000,210000,0,0
20200528,00798B,國泰中企A級債7+,42.70,42.70,42.70,42.70,0.00,0.0,100000,2,4270000,0,0,0,0,0,0,100000,100000,0,0
20200528,00799B,國泰A級醫療債,45.45,45.56,45.45,45.56,0.00,0.0,113000,6,5146960,0,0,0,0,0,0,112000,110000,2000,2000
20200528,00831B,新光美債1-3,40.00,40.00,40.00,40.00,0.00,0.0,50000,2,2000000,0,0,0,0,0,0,50000,50000,0,0
20200528,00832B,新光美債20+,51.20,51.20,51.20,51.20,-0.30,-0.58,50000,2,2560000,0,0,0,0,0,0,50000,50000,0,0
20200528,00833B,第一金美債20+,49.09,49.09,48.95,49.06,-0.03,-0.06,122000,15,5980180,0,0,0,0,0,0,100000,100000,0,0
20200528,00834B,第一金金融債10+,44.29,44.32,44.20,44.32,+0.03,0.07,127000,18,5623030,0,0,0,0,0,0,100000,100000,0,0
20200528,00835B,第一金科技債10+,44.71,44.71,44.71,44.71,+0.01,0.02,2000,2,89420,0,0,0,0,0,0,2000,2000,0,0
20200528,00836B,永豐10年A公司債,43.55,43.66,43.55,43.64,+0.06,0.14,121000,6,5280720,0,0,0,0,0,0,101000,120000,-19000,-19000
20200528,00837B,永豐15年金融債,35.46,36.18,35.46,36.18,+0.26,0.72,127000,14,4589360,21000,0,21000,0,0,0,103000,119000,-16000,5000
20200528,00838B,永豐7-10年中國債,38.80,38.80,38.80,38.80,-0.05,-0.13,100000,2,3880000,0,0,0,0,0,0,100000,100000,0,0
20200528,00839B,凱基醫療保健債,44.60,44.78,44.60,44.78,+0.01,0.02,101000,3,4522600,0,0,0,0,0,0,101000,100000,1000,1000
20200528,00840B,凱基IG精選15+,43.12,43.31,43.12,43.31,+0.12,0.28,101000,3,4374120,0,0,0,0,0,0,101000,100000,1000,1000
20200528,00841B,凱基AAA-AA公司債,43.91,44.13,43.91,44.13,+0.17,0.39,101000,3,4456910,0,0,0,0,0,0,101000,100000,1000,1000
20200528,00842B,台新美元銀行債,42.02,42.02,42.02,42.02,-0.04,-0.1,52000,4,2185040,0,0,0,0,0,0,51000,51000,0,0
20200528,00843B,台新中國政策債,38.85,38.85,38.85,38.85,-0.13,-0.33,50000,2,1942500,0,0,0,0,0,0,50000,50000,0,0
20200528,00844B,新光15年IG金融債,41.70,41.70,41.70,41.70,0.00,0.0,2000,2,83400,0,0,0,0,0,0,2000,2000,0,0
20200528,00845B,富邦新興投等債,37.45,37.45,37.40,37.40,+0.13,0.35,205000,5,7677000,0,0,0,0,0,0,205000,205000,0,0
20200528,00846B,富邦歐洲銀行債,39.73,39.73,39.73,39.73,+0.26,0.66,200000,2,7946000,0,0,0,0,0,0,200000,200000,0,0
20200528,00847B,中信美國市政債,37.94,37.94,37.85,37.89,+0.01,0.03,292000,27,11062960,0,0,0,0,0,0,271000,248000,23000,23000
20200528,00848B,中信新興亞洲債,39.46,39.52,39.46,39.52,+0.10,0.25,210000,6,8295000,0,0,0,0,0,0,210000,210000,0,0
20200528,00849B,中信EM主權債0-5,39.11,39.20,39.07,39.20,+0.03,0.08,211000,7,8264770,0,0,0,0,0,0,211000,210000,1000,1000
20200528,00853B,統一美債10年Aa-A,,,,,,0.00,0,0,0,0,0,0,0,0,0,0,0,0,0
20200528,00854B,富邦全球保險債,41.06,41.06,41.06,41.06,+0.15,0.37,100000,2,4106000,0,0,0,0,0,0,100000,100000,0,0
20200528,00855B,富邦全球能源債,37.37,37.60,37.37,37.60,+0.34,0.91,104000,4,3909480,0,0,0,0,0,0,104000,100000,4000,4000
20200528,00856B,永豐1-3年美公債,39.69,39.69,39.69,39.69,+0.04,0.1,100000,2,3969000,0,0,0,0,0,0,100000,100000,0,0
20200528,00857B,永豐20年美公債,44.41,44.41,44.41,44.41,-0.04,-0.09,100000,2,4441000,0,0,0,0,0,0,100000,100000,0,0
20200528,00858,永豐美國500大,20.77,20.77,20.66,20.66,+0.16,0.78,103000,4,2128200,0,0,0,0,0,0,101000,102000,-1000,-1000
20200528,00859B,群益0-1年美債,39.28,39.28,39.20,39.20,-0.07,-0.18,188000,15,7380110,0,0,0,0,0,0,187000,187000,0,0
20200528,00860B,群益1-5年IG債,39.66,39.66,39.66,39.66,+0.04,0.1,100000,2,3966000,0,0,0,0,0,0,100000,100000,0,0
20200528,00862B,中信投資級公司債,40.75,40.76,40.75,40.76,+0.06,0.15,216000,9,8802700,0,0,0,0,0,0,215000,210000,5000,5000
20200528,00863B,中信全球電信債,42.30,42.32,42.30,42.30,+0.06,0.14,211000,7,8925320,0,0,0,0,0,0,210000,211000,-1000,-1000
20200528,00864B,中信美國公債0-1,39.57,39.60,39.57,39.60,+0.03,0.08,210000,6,8311800,0,0,0,0,0,0,210000,210000,0,0
20200528,00867B,新光A-BBB電信債,41.97,41.97,41.97,41.97,+0.07,0.17,2000,2,83940,0,0,0,0,0,0,2000,2000,0,0
20200528,00868B,FT1-3年美公債,40.48,40.48,40.48,40.48,+0.03,0.07,100000,2,4048000,0,0,0,0,0,0,100000,100000,0,0
20200528,00869B,FT10-25年公司債,40.05,40.05,40.05,40.05,+0.11,0.28,100000,2,4005000,0,0,0,0,0,0,100000,100000,0,0
20200528,00870B,元大15年EM主權債,40.48,40.56,40.48,40.56,+0.10,0.25,247000,16,10014290,0,0,0,0,0,0,247000,220000,27000,27000
20200528,00871B,元大中國政金債,39.13,39.13,39.13,39.13,-0.11,-0.28,200000,4,7826000,0,0,0,0,0,0,200000,200000,0,0
20200528,00872B,凱基美債1-3,40.90,40.90,40.90,40.90,+0.04,0.1,100000,2,4090000,0,0,0,0,0,0,100000,100000,0,0
20200528,00873B,凱基新興債1-5,39.23,39.24,39.21,39.21,+0.02,0.05,107000,5,4195660,0,0,0,0,0,0,107000,100000,7000,7000
20200528,00874B,凱基BBB公司債15+,39.09,39.09,39.09,39.09,+0.26,0.67,100000,2,3909000,0,0,0,0,0,0,100000,100000,0,0
20200528,1240,茂生農經,52.50,52.50,51.70,52.20,-0.30,-0.57,34000,22,1776400,1000,0,1000,0,0,0,0,0,0,1000
20200528,1258,其祥-KY,10.10,10.85,10.10,10.85,+0.98,9.93,68000,39,735100,0,0,0,0,0,0,0,0,0,0
20200528,1259,安心,70.50,70.50,70.00,70.00,-0.60,-0.85,8000,5,561100,0,1000,-1000,0,0,0,0,0,0,-1000
20200528,1264,德麥,220.00,221.00,219.00,219.00,0.00,0.0,18000,18,3960500,0,4000,-4000,0,0,0,0,0,0,-4000
20200528,1268,漢來美食,134.00,135.00,132.00,132.50,-1.50,-1.12,27000,27,3602500,0,0,0,0,0,0,0,0,0,0
20200528,1336,台翰,15.70,15.70,15.55,15.60,-0.05,-0.32,361000,119,5640250,0,18000,-18000,0,0,0,0,0,0,-18000
20200528,1565,精華,360.00,364.00,358.00,359.50,+1.00,0.28,120000,112,43231500,9000,7000,2000,0,0,0,0,3000,-3000,-1000
20200528,1569,濱川,25.85,26.20,25.05,25.10,-0.50,-1.95,2074000,1157,53092400,12000,144000,-132000,0,0,0,0,10000,-10000,-142000
20200528,1570,力肯,13.70,13.80,13.65,13.70,+0.10,0.74,97000,38,1331700,2000,0,2000,0,0,0,0,0,0,2000
20200528,1580,新麥,91.00,91.10,90.20,90.40,-0.50,-0.55,88000,86,7997000,5000,47000,-42000,0,0,0,0,0,0,-42000
20200528,1584,精剛,7.08,7.08,6.96,7.05,+0.02,0.28,176000,40,1231260,0,0,0,0,0,0,0,0,0,0
20200528,1586,和勤,37.80,39.00,37.45,38.50,+0.80,2.12,1197000,370,45464650,94000,36000,58000,0,0,0,500000,15000,485000,543000
20200528,1591,駿吉-KY,20.50,22.40,20.10,22.40,+2.00,9.8,181000,78,3846050,1000,15000,-14000,0,0,0,0,0,0,-14000
20200528,1593,祺驊,49.00,49.35,48.70,49.10,+0.60,1.24,78000,48,3828550,0,2000,-2000,0,0,0,0,0,0,-2000
20200528,1595,川寶,34.70,35.00,34.60,34.95,-0.05,-0.14,19000,17,661050,0,0,0,0,0,0,0,0,0,0
20200528,1597,直得,102.50,104.00,91.60,93.10,-6.90,-6.9,8451000,6134,841678100,367950,447000,-79050,105000,0,105000,187000,40000,147000,172950
20200528,1599,宏佳騰,29.70,29.70,29.35,29.60,+0.15,0.51,24000,18,707600,0,0,0,0,0,0,0,0,0,0
20200528,1742,台蠟,23.05,23.45,22.90,23.05,0.00,0.0,379000,167,8748050,0,6000,-6000,0,0,0,0,0,0,-6000
20200528,1752,南光,43.20,43.50,42.55,42.65,-0.55,-1.27,664000,446,28470750,51000,168000,-117000,0,0,0,0,17000,-17000,-134000
20200528,1777,生泰,86.30,87.50,85.50,86.40,0.00,0.0,287000,218,24779500,41000,18000,23000,0,0,0,0,0,0,23000
20200528,1781,合世,17.30,18.80,16.65,18.00,-0.35,-1.91,1303000,807,22990450,45000,3000,42000,0,0,0,0,0,0,42000
20200528,1784,訊聯,39.15,39.80,38.80,38.90,-0.10,-0.26,722000,523,28318650,18000,112000,-94000,0,0,0,0,0,0,-94000
20200528,1785,光洋科,19.95,20.00,19.80,19.90,+0.05,0.25,729000,297,14509400,29000,94000,-65000,0,0,0,0,0,0,-65000
20200528,1788,杏昌,109.50,109.50,109.50,109.50,0.00,0.0,20000,18,2190000,0,3000,-3000,0,0,0,0,0,0,-3000
20200528,1796,金穎生技,23.00,23.20,23.00,23.00,0.00,0.0,22000,16,506500,0,0,0,0,0,0,0,0,0,0
20200528,1799,易威,17.80,20.95,17.55,18.50,-0.95,-4.88,4239000,2300,78374800,100000,10000,90000,0,0,0,0,4000,-4000,86000
20200528,1813,寶利徠,21.40,21.45,21.10,21.20,-0.25,-1.17,64000,57,1359050,0,9000,-9000,0,0,0,0,0,0,-9000
20200528,1815,富喬,9.57,9.97,9.57,9.75,+0.23,2.42,4027000,1369,39562880,381000,264000,117000,0,0,0,0,10000,-10000,107000
20200528,2035,唐榮,39.00,39.05,39.00,39.05,-0.05,-0.13,8000,6,312150,0,0,0,0,0,0,0,0,0,0
20200528,2061,風青,7.70,7.75,7.61,7.69,0.00,0.0,34000,23,261640,0,1000,-1000,0,0,0,0,0,0,-1000
20200528,2063,世鎧,34.60,34.60,33.95,34.00,-0.50,-1.45,101000,71,3460950,0,4000,-4000,0,0,0,0,0,0,-4000
20200528,2064,晉椿,11.20,11.20,11.20,11.20,0.00,0.0,2000,2,22400,0,0,0,0,0,0,0,0,0,0
20200528,2065,世豐,58.20,58.30,57.70,57.70,-0.30,-0.52,219000,141,12706900,33000,4000,29000,0,0,0,7000,0,7000,36000
20200528,2066,世德,53.90,54.20,53.50,53.90,+0.10,0.19,66000,31,3561500,0,0,0,0,0,0,0,0,0,0
20200528,2067,嘉鋼,8.75,8.75,8.75,8.75,+0.02,0.23,10000,3,87500,0,0,0,0,0,0,0,0,0,0
20200528,2070,精湛,32.00,32.00,31.40,31.60,-0.40,-1.25,25000,18,795000,0,0,0,0,0,0,0,0,0,0
20200528,2221,大甲,25.15,25.30,25.05,25.10,+0.40,1.62,127000,99,3196300,0,2000,-2000,0,0,0,0,0,0,-2000
20200528,2230,泰茂,9.79,10.00,9.72,9.93,+0.19,1.95,18000,15,177030,0,0,0,0,0,0,0,0,0,0
20200528,2235,謚源,47.50,48.20,47.00,47.65,+0.30,0.63,15000,14,716500,0,0,0,0,0,0,0,0,0,0
20200528,2596,綠意,19.35,19.40,19.30,19.40,+0.10,0.52,30000,19,580550,3000,0,3000,0,0,0,0,0,0,3000
20200528,2640,大車隊,78.50,78.80,78.50,78.70,+0.20,0.25,40000,17,3143800,4000,0,4000,0,0,0,0,0,0,4000
20200528,2641,正德,6.28,6.28,6.19,6.24,0.00,0.0,376000,81,2340910,0,0,0,0,0,0,0,0,0,0
20200528,2643,捷迅,43.00,43.65,43.00,43.20,+0.35,0.82,186000,106,8077950,31000,16000,15000,0,0,0,0,0,0,15000
20200528,2718,晶悅,17.15,17.20,16.50,16.50,-0.70,-4.07,5000,5,84500,0,0,0,0,0,0,0,0,0,0
20200528,2719,燦星旅,11.55,11.55,11.55,11.55,+1.05,10.0,104000,63,1201200,0,0,0,0,0,0,0,0,0,0
20200528,2724,富驛-KY,3.23,3.28,3.23,3.28,+0.08,2.5,27000,12,88230,0,0,0,0,0,0,0,0,0,0
20200528,2726,雅茗-KY,62.00,62.50,61.30,61.50,-0.50,-0.81,76000,57,4698900,5000,6000,-1000,0,0,0,0,0,0,-1000
20200528,2729,瓦城,258.50,264.00,250.00,251.00,-7.00,-2.71,224000,205,57082000,0,20000,-20000,0,0,0,1000,14000,-13000,-33000
20200528,2732,六角,151.00,152.50,146.50,146.50,-3.50,-2.33,618000,553,92191500,10000,42000,-32000,0,0,0,12000,45000,-33000,-65000
20200528,2734,易飛網,14.60,14.60,14.60,14.60,+1.30,9.77,350000,178,5110000,0,0,0,0,0,0,0,0,0,0
20200528,2736,高野,17.80,17.80,16.10,16.75,-0.70,-4.01,763000,362,12869500,2000,20000,-18000,0,0,0,3000,0,3000,-15000
20200528,2740,天蔥,16.00,17.10,16.00,17.10,+1.55,9.97,148000,87,2484200,3000,0,3000,0,0,0,0,0,0,3000
20200528,2743,山富,18.90,19.00,17.95,18.10,-0.95,-4.99,457000,304,8350650,0,21000,-21000,0,0,0,0,0,0,-21000
20200528,2745,五福,22.65,22.85,22.00,22.85,+2.05,9.86,1408000,632,32040650,15000,8000,7000,0,0,0,0,0,0,7000
20200528,2752,豆府,119.00,119.00,116.00,118.00,-1.00,-0.84,29000,29,3406500,0,0,0,0,0,0,0,0,0,0
20200528,2916,滿心,16.40,16.45,16.40,16.45,+0.05,0.3,26000,10,427650,0,0,0,0,0,0,0,0,0,0
20200528,2924,東凌-KY,20.05,20.05,19.15,19.30,-1.20,-5.85,15000,12,291650,0,0,0,0,0,0,0,0,0,0
20200528,2926,誠品生活,87.90,89.00,86.90,89.00,+2.20,2.53,39000,35,3441100,1000,0,1000,0,0,0,0,0,0,1000
20200528,2928,紅馬-KY,49.75,52.60,49.75,50.30,+2.40,5.01,3893000,2703,199672150,148000,179000,-31000,0,0,0,17000,0,17000,-14000
20200528,2937,集雅社,28.00,29.85,28.00,28.80,+1.10,3.97,111000,84,3216200,2000,2000,0,0,0,0,0,0,0,0
20200528,3064,泰偉,13.55,13.55,13.50,13.50,-0.05,-0.37,63000,28,850550,0,0,0,0,0,0,0,0,0,0
20200528,3066,李洲,6.20,6.35,5.83,5.86,-0.44,-6.98,14000,7,84430,0,0,0,0,0,0,0,0,0,0
20200528,3067,全域,26.20,26.65,26.20,26.35,+0.40,1.54,13000,11,343300,0,1000,-1000,0,0,0,0,0,0,-1000
20200528,3071,協禧,20.75,20.80,20.10,20.20,-0.70,-3.35,1142000,572,23307150,9000,83000,-74000,0,0,0,0,0,0,-74000
20200528,3073,凱柏實業,7.50,8.25,7.50,8.25,+0.75,10.0,19000,10,155250,0,0,0,0,0,0,0,0,0,0
20200528,3078,僑威,28.20,28.30,26.75,27.00,-0.80,-2.88,6452000,2850,178984150,79000,508000,-429000,0,0,0,0,0,0,-429000
20200528,3081,聯亞,268.50,271.00,265.50,268.50,+2.00,0.75,352000,295,94480000,27000,48000,-21000,0,1000,-1000,18000,13000,5000,-17000
20200528,3083,網龍,87.40,90.30,86.00,86.00,-0.30,-0.35,3888000,2897,343932700,244000,260500,-16500,70000,0,70000,164000,44000,120000,173500
20200528,3085,新零售,2.20,2.20,2.20,2.20,-0.02,-0.9,4000,3,8800,0,0,0,0,0,0,0,0,0,0
20200528,3086,華義,,,,,,0.00,0,0,0,0,0,0,0,0,0,0,0,0,0
20200528,3088,艾訊,55.60,55.60,54.60,54.70,-0.70,-1.26,309000,202,17021500,0,97000,-97000,0,0,0,0,0,0,-97000
20200528,3089,元炬,20.20,20.85,20.20,20.80,-0.05,-0.24,23000,19,469800,0,0,0,0,0,0,0,0,0,0
20200528,3092,鴻碩,42.50,42.50,42.10,42.10,-0.10,-0.24,128000,72,5407550,1000,6000,-5000,0,0,0,0,0,0,-5000
20200528,3093,港建,29.65,29.95,29.25,29.40,-0.20,-0.68,43000,20,1267000,0,0,0,0,0,0,1000,0,1000,1000
20200528,3095,及成,1.95,1.99,1.95,1.98,+0.12,6.45,21000,12,41590,0,0,0,0,0,0,0,0,0,0
20200528,3105,穩懋,249.00,250.00,245.00,247.00,0.00,0.0,4873000,3433,1204478000,2787615,2608152,179463,91000,0,91000,27000,76000,-49000,221463
20200528,3114,好德,22.20,22.30,21.65,21.90,-0.05,-0.23,242000,104,5323500,0,47000,-47000,0,0,0,0,0,0,-47000
20200528,3115,寶島極,18.95,18.95,15.65,17.00,-0.30,-1.73,205000,122,3526800,0,0,0,0,0,0,2000,0,2000,2000
20200528,3118,進階,32.80,33.75,32.10,32.20,-0.80,-2.42,249000,198,8187250,10000,14000,-4000,0,0,0,0,0,0,-4000
20200528,3122,笙泉,11.50,12.40,11.20,11.20,-0.10,-0.88,694000,364,8348450,20000,21000,-1000,0,0,0,5000,0,5000,4000
20200528,3128,昇銳,12.85,12.85,12.70,12.70,-0.10,-0.78,22000,16,280700,0,0,0,0,0,0,0,0,0,0
20200528,3131,弘塑,228.50,228.50,220.00,221.00,-5.50,-2.43,759000,658,169560500,14000,31000,-17000,0,195000,-195000,0,61000,-61000,-273000
20200528,3141,晶宏,23.80,23.80,22.95,23.00,-0.45,-1.92,424000,269,9861150,0,77000,-77000,0,0,0,0,0,0,-77000
20200528,3144,新揚科,26.20,26.20,25.20,25.20,-0.60,-2.33,359000,228,9182250,4000,56000,-52000,0,0,0,0,65000,-65000,-117000
20200528,3147,大綜,34.30,34.30,32.80,32.90,-1.10,-3.24,105000,78,3502500,2000,22000,-20000,0,0,0,0,0,0,-20000
20200528,3152,璟德,316.00,317.50,308.00,308.50,-4.50,-1.44,270000,231,84080000,24000,12000,12000,0,0,0,9000,3000,6000,18000
20200528,3162,精確,8.78,8.78,8.78,8.78,-0.04,-0.45,5000,2,43900,0,0,0,0,0,0,0,0,0,0
20200528,3163,波若威,45.00,45.30,43.25,43.70,-1.20,-2.67,1966000,1165,87216600,22000,140000,-118000,0,0,0,18000,134000,-116000,-234000
20200528,3169,亞信,35.20,35.20,34.95,35.10,-0.10,-0.28,96000,74,3369400,4000,3000,1000,0,0,0,0,0,0,1000
20200528,3171,新洲,21.00,21.30,20.70,20.85,-0.05,-0.24,502000,206,10513200,0,4000,-4000,0,0,0,0,0,0,-4000
20200528,3176,基亞,62.90,65.20,62.20,62.90,-0.50,-0.79,1645000,1186,104482100,91000,63000,28000,0,0,0,10000,3000,7000,35000
20200528,3178,公準,57.60,61.00,53.80,54.40,-1.40,-2.51,6432000,4467,371028100,424000,269000,155000,0,0,0,5000,0,5000,160000
20200528,3188,鑫龍騰,14.00,14.00,13.70,13.75,-0.30,-2.14,52000,36,717000,0,0,0,0,0,0,0,0,0,0
20200528,3191,和進,42.40,43.10,42.25,42.25,0.00,0.0,125000,91,5333600,9000,6000,3000,0,0,0,0,0,0,3000
20200528,3202,樺晟,18.20,18.30,17.70,17.70,-0.30,-1.67,2365000,732,42584250,138000,274000,-136000,0,0,0,0,0,0,-136000
20200528,3205,佰研,44.60,45.05,43.00,43.40,-1.25,-2.8,402000,311,17706300,11000,23000,-12000,0,0,0,3000,0,3000,-9000
20200528,3206,志豐,28.30,28.65,28.25,28.40,+0.15,0.53,205000,119,5827750,17000,17000,0,0,0,0,0,0,0,0
20200528,3207,耀勝,11.30,11.30,11.30,11.30,0.00,0.0,1000,1,11300,0,0,0,0,0,0,0,0,0,0
20200528,3211,順達,84.10,84.70,80.80,81.20,-2.90,-3.45,2421000,1716,199923400,365000,419000,-54000,0,0,0,6000,77000,-71000,-125000
20200528,3213,茂訊,50.20,50.30,49.65,49.90,-0.20,-0.4,199000,135,9953950,7000,3000,4000,0,0,0,0,0,0,4000
20200528,3217,優群,108.00,110.50,103.00,106.00,+1.50,1.44,11811000,7730,1260676000,630000,855000,-225000,577000,0,577000,66000,65000,1000,353000
20200528,3218,大學光,147.00,149.50,137.00,137.00,-5.50,-3.86,12959000,9077,1871197000,833000,2238000,-1405000,465000,20000,445000,18000,190000,-172000,-1132000
20200528,3221,台嘉碩,22.70,22.90,22.40,22.40,-0.15,-0.67,930000,375,21043650,240000,47000,193000,0,0,0,0,0,0,193000
20200528,3224,三顧,53.10,53.30,51.20,51.20,-1.90,-3.58,330000,186,17326800,11000,12000,-1000,0,0,0,0,0,0,-1000
20200528,3226,至寶電,53.00,53.50,53.00,53.50,+0.50,0.94,6000,5,320000,0,0,0,0,0,0,0,0,0,0
20200528,3227,原相,174.00,176.00,165.00,165.00,-7.00,-4.07,12051000,8760,2051718000,125000,1311600,-1186600,79000,20000,59000,132000,345000,-213000,-1340600
20200528,3228,金麗科,31.70,32.00,31.50,31.90,+0.40,1.27,665000,130,21186700,479000,511000,-32000,0,0,0,0,0,0,-32000
20200528,3230,錦明,5.39,5.39,5.20,5.36,+0.07,1.32,41000,19,215500,0,1000,-1000,0,0,0,0,0,0,-1000
20200528,3232,昱捷,20.50,20.60,19.65,19.65,-0.45,-2.24,628000,441,12621400,32000,30000,2000,0,0,0,0,0,0,2000
20200528,3234,光環,36.80,37.30,36.00,36.00,-0.60,-1.64,1961000,1143,71749700,308000,191000,117000,0,0,0,0,0,0,117000
20200528,3236,千如,16.25,16.35,16.10,16.20,+0.10,0.62,160000,98,2594950,17000,3000,14000,0,0,0,0,0,0,14000
20200528,3252,海灣,16.95,17.50,16.25,16.35,-0.45,-2.68,436000,261,7370250,0,22000,-22000,0,0,0,4000,0,4000,-18000
20200528,3259,鑫創,14.10,14.15,13.95,13.95,-0.15,-1.06,64000,30,898800,0,5000,-5000,0,0,0,0,0,0,-5000
20200528,3260,威剛,57.40,57.60,55.40,55.50,-0.90,-1.6,5412000,3290,306331000,84000,301000,-217000,90000,0,90000,86000,139000,-53000,-180000
20200528,3264,欣銓,29.15,29.15,28.20,28.30,-0.50,-1.74,2543000,1459,72834550,258000,237000,21000,0,0,0,0,42000,-42000,-21000
20200528,3265,台星科,23.90,24.10,23.70,23.75,-0.15,-0.63,184000,111,4384750,5000,59000,-54000,0,0,0,0,0,0,-54000
20200528,3268,海德威,9.75,9.77,9.65,9.77,-0.10,-1.01,43000,18,417220,5000,0,5000,0,0,0,0,0,0,5000
20200528,3272,東碩,21.40,21.50,21.20,21.40,+0.10,0.47,83000,48,1776050,7000,1000,6000,0,0,0,0,0,0,6000
20200528,3276,宇環,7.07,7.41,7.07,7.41,-0.06,-0.8,11000,6,78110,2000,0,2000,0,0,0,0,0,0,2000
20200528,3284,太普高,12.10,12.25,12.00,12.00,-0.10,-0.83,29000,22,350250,0,0,0,0,0,0,0,0,0,0
20200528,3285,微端,14.60,14.60,14.50,14.50,-0.15,-1.02,14000,11,203450,0,0,0,0,0,0,0,0,0,0
20200528,3287,廣寰科,8.68,8.68,8.34,8.36,-0.14,-1.65,29000,19,244080,0,0,0,0,0,0,1000,0,1000,1000
20200528,3288,點晶,8.60,8.62,8.60,8.61,-0.30,-3.37,3000,3,25830,0,0,0,0,0,0,0,0,0,0
20200528,3289,宜特,56.50,57.80,55.50,57.40,+1.60,2.87,5067000,3301,286671300,254000,520000,-266000,0,0,0,17000,96000,-79000,-345000
20200528,3290,東浦,13.45,13.50,13.30,13.30,-0.10,-0.75,223000,82,2986150,29000,27000,2000,0,0,0,0,0,0,2000
20200528,3293,鈊象,532.00,578.00,532.00,578.00,+52.00,9.89,6530000,5174,3693495000,315550,381069,-65519,281000,0,281000,332000,70000,262000,477481
20200528,3294,英濟,13.45,13.45,13.40,13.45,0.00,0.0,25000,19,335400,0,0,0,0,0,0,0,0,0,0
20200528,3297,杭特,11.85,11.85,11.70,11.70,+0.05,0.43,11000,10,129600,0,0,0,0,0,0,0,0,0,0
20200528,3303,岱稜,24.15,24.15,23.90,23.90,-0.15,-0.62,310000,159,7449600,7000,15000,-8000,0,0,0,0,0,0,-8000
20200528,3306,鼎天,17.30,17.30,16.80,17.15,-0.25,-1.44,31000,21,529650,1000,0,1000,0,0,0,0,0,0,1000
20200528,3310,佳穎,29.40,29.80,29.30,29.80,+0.45,1.53,31000,25,913250,0,0,0,0,0,0,0,0,0,0
20200528,3313,斐成,14.00,14.05,13.95,14.00,0.00,0.0,70000,34,979250,6000,2000,4000,0,0,0,0,0,0,4000
20200528,3317,尼克森,41.00,41.45,40.20,40.55,-0.05,-0.12,1465000,968,59631950,46000,88000,-42000,0,0,0,7000,3000,4000,-38000
20200528,3322,建舜電,6.76,6.84,6.60,6.74,-0.03,-0.44,75000,29,501680,0,15000,-15000,0,0,0,0,0,0,-15000
20200528,3323,加百裕,30.50,30.50,29.05,29.15,-1.00,-3.32,265000,196,7869300,0,77000,-77000,0,0,0,0,0,0,-77000
20200528,3324,雙鴻,164.00,166.50,163.00,163.50,+0.50,0.31,2386000,1609,393335500,182000,108000,74000,498000,0,498000,94000,46000,48000,620000
20200528,3325,旭品,16.60,17.30,16.50,17.20,+0.15,0.88,960000,358,16373600,36000,5000,31000,0,0,0,0,0,0,31000
20200528,3332,幸康,28.50,28.50,28.40,28.40,-0.10,-0.35,3000,2,85400,0,0,0,0,0,0,0,0,0,0
20200528,3339,泰谷,2.70,2.70,2.70,2.70,0.00,0.0,5000,3,13500,0,0,0,0,0,0,0,0,0,0
20200528,3354,律勝,12.20,12.35,12.10,12.35,+0.20,1.65,167000,66,2050250,7000,0,7000,0,0,0,0,0,0,7000
20200528,3360,尚立,17.05,17.10,16.05,16.15,-0.85,-5.0,796000,477,13066050,20000,16000,4000,0,0,0,10000,0,10000,14000
20200528,3362,先進光,41.55,41.80,38.20,38.70,-1.35,-3.37,2278000,1490,91467100,31000,204000,-173000,0,0,0,5000,4000,1000,-172000
20200528,3363,上詮,24.50,24.60,24.05,24.10,-0.15,-0.62,556000,308,13523850,0,121000,-121000,0,0,0,0,10000,-10000,-131000
20200528,3372,典範,8.82,8.96,8.80,8.96,0.00,0.0,21000,11,186040,0,0,0,0,0,0,0,1000,-1000,-1000
20200528,3373,熱映,130.50,130.50,130.50,130.50,+11.50,9.66,1107000,662,144463500,0,1000,-1000,0,0,0,4000,36000,-32000,-33000
20200528,3374,精材,84.60,84.80,81.40,81.50,-2.50,-2.98,6080000,3779,504451800,247000,238000,9000,0,0,0,0,0,0,9000
20200528,3379,彬台,8.62,8.64,8.52,8.52,-0.05,-0.58,42000,22,361490,0,0,0,0,0,0,0,0,0,0
20200528,3388,崇越電,67.50,67.50,66.50,66.70,-0.30,-0.45,107000,91,7149700,0,9000,-9000,0,0,0,0,0,0,-9000
20200528,3390,旭軟,14.35,14.60,14.15,14.15,0.00,0.0,147000,89,2106450,5000,5000,0,0,0,0,0,0,0,0
20200528,3402,漢科,27.20,27.25,26.80,26.80,-0.35,-1.29,134000,89,3624500,9000,41000,-32000,0,0,0,0,0,0,-32000
20200528,3426,台興,,,,,,0.00,0,0,0,0,0,0,0,0,0,0,0,0,0
20200528,3434,哲固,11.15,11.15,11.00,11.10,0.00,0.0,3000,3,33250,0,0,0,0,0,0,0,0,0,0
20200528,3438,類比科,35.10,35.60,34.05,34.35,-0.55,-1.58,1253000,841,43849900,61000,137000,-76000,0,0,0,0,0,0,-76000
20200528,3441,聯一光,26.50,26.85,25.60,25.65,-0.25,-0.97,321000,229,8436250,1000,31000,-30000,0,0,0,1000,0,1000,-29000
20200528,3444,利機,46.00,47.35,41.00,42.00,-3.45,-7.59,6168000,4191,271734400,257000,284000,-27000,0,0,0,0,18000,-18000,-45000
20200528,3455,由田,46.65,48.00,46.35,46.80,+0.60,1.3,677000,456,32057750,27000,77000,-50000,0,0,0,2000,0,2000,-48000
20200528,3465,進泰電子,50.60,53.90,50.60,53.90,+4.90,10.0,45000,32,2397300,0,0,0,0,0,0,0,0,0,0
20200528,3466,致振,14.90,15.10,14.60,15.10,+0.40,2.72,9000,8,132950,0,0,0,0,0,0,0,0,0,0
20200528,3479,安勤,68.00,68.00,66.20,66.50,-1.00,-1.48,412000,334,27654900,9000,162000,-153000,0,0,0,0,6000,-6000,-159000
20200528,3483,力致,69.00,69.90,66.50,66.60,-1.00,-1.48,6510000,4119,442966600,238000,325000,-87000,50000,338000,-288000,126000,94000,32000,-343000
20200528,3484,崧騰,25.00,25.00,24.60,24.90,0.00,0.0,75000,47,1861600,0,15000,-15000,0,0,0,0,0,0,-15000
20200528,3489,森寶,10.20,10.30,10.10,10.10,0.00,0.0,137000,51,1397550,3000,3000,0,0,0,0,0,0,0,0
20200528,3490,單井,21.05,22.10,20.65,20.75,0.00,0.0,610000,408,13078800,2000,41000,-39000,0,0,0,0,0,0,-39000
20200528,3491,昇達科,76.00,76.40,75.40,75.60,+1.00,1.34,603000,501,45719800,44000,59000,-15000,0,0,0,6000,0,6000,-9000
20200528,3492,長盛,15.70,15.70,15.65,15.65,-0.10,-0.63,34000,19,532200,0,0,0,0,0,0,0,0,0,0
20200528,3498,陽程,23.85,24.05,23.05,23.05,-0.80,-3.35,227000,114,5360750,3000,15000,-12000,0,0,0,0,0,0,-12000
20200528,3499,環天科,11.70,11.70,11.50,11.60,-0.05,-0.43,21000,19,244050,0,0,0,0,0,0,0,0,0,0
20200528,3508,位速,19.45,20.00,19.00,19.05,-0.35,-1.8,275000,159,5356500,45000,54000,-9000,0,0,0,0,0,0,-9000
20200528,3511,矽瑪,27.50,27.60,26.65,26.90,-0.60,-2.18,646000,468,17544100,43000,14000,29000,0,0,0,0,0,0,29000
20200528,3512,皇龍,28.90,29.00,28.80,28.90,0.00,0.0,44000,8,1270800,0,0,0,0,0,0,0,0,0,0
20200528,3516,亞帝歐,10.35,10.50,10.25,10.25,0.00,0.0,39000,17,406600,1000,4000,-3000,0,0,0,0,0,0,-3000
20200528,3520,振維,13.05,13.30,13.05,13.30,0.00,0.0,87000,51,1151200,0,0,0,0,0,0,0,0,0,0
20200528,3521,鴻翊,12.40,12.45,12.05,12.10,-0.15,-1.22,121000,54,1479650,0,0,0,0,0,0,0,0,0,0
20200528,3522,御頂,11.20,11.75,11.05,11.75,+1.05,9.81,934000,323,10851550,17000,3000,14000,0,0,0,0,0,0,14000
20200528,3523,迎輝,10.90,10.95,10.40,10.70,-0.10,-0.93,139000,63,1492950,3000,10000,-7000,0,0,0,4000,0,4000,-3000
20200528,3526,凡甲,98.50,98.80,95.80,96.70,-0.40,-0.41,2415000,1765,234867600,214000,164000,50000,0,0,0,76000,137000,-61000,-11000
20200528,3527,聚積,88.80,89.30,87.30,87.30,-0.90,-1.02,230000,201,20294600,18000,38000,-20000,0,17000,-17000,0,0,0,-37000
20200528,3529,力旺,369.00,374.00,355.50,365.50,+4.50,1.25,1759000,1569,642789000,495000,475000,20000,2000,40000,-38000,40000,55000,-15000,-33000
20200528,3531,先益,23.40,23.45,23.25,23.45,+0.05,0.21,23000,8,536950,0,0,0,0,0,0,0,0,0,0
20200528,3537,堡達,40.05,40.50,39.40,39.55,-0.30,-0.75,850000,549,33986950,67000,82000,-15000,0,0,0,0,0,0,-15000
20200528,3540,曜越,22.80,22.95,22.15,22.50,-0.20,-0.88,632000,323,14208500,5000,82000,-77000,0,0,0,0,0,0,-77000
20200528,3541,西柏,76.20,76.30,75.80,76.00,-0.20,-0.26,89000,71,6774900,6000,8000,-2000,0,0,0,0,0,0,-2000
20200528,3546,宇峻,87.50,90.70,87.20,88.00,+1.10,1.27,2037000,1554,181516600,155000,206000,-51000,0,0,0,91000,8000,83000,32000
20200528,3548,兆利,63.90,64.20,62.80,62.90,-0.60,-0.94,386000,269,24484000,10000,168000,-158000,0,0,0,4000,3000,1000,-157000
20200528,3551,世禾,50.30,51.00,46.80,47.20,-1.75,-3.58,3913000,2410,191365900,177000,192000,-15000,0,0,0,22000,150000,-128000,-143000
20200528,3552,同致,61.70,62.90,61.40,61.80,+0.80,1.31,541000,325,33498300,0,27000,-27000,0,0,0,55000,1000,54000,27000
20200528,3555,重鵬,28.00,28.50,28.00,28.50,-0.30,-1.04,2000,2,56500,0,0,0,0,0,0,0,0,0,0
20200528,3556,禾瑞亞,69.00,69.50,64.60,65.50,-2.70,-3.96,2852000,1815,190978900,753000,23000,730000,0,15000,-15000,0,0,0,715000
20200528,3558,神準,110.00,112.00,107.50,108.00,-1.00,-0.92,218000,181,23886500,9000,14000,-5000,0,0,0,0,2000,-2000,-7000
20200528,3564,其陽,27.95,27.95,27.60,27.60,-0.35,-1.25,27000,22,749600,0,0,0,0,0,0,0,0,0,0
20200528,3567,逸昌,25.30,25.35,24.80,24.80,-0.25,-1.0,59000,39,1475100,0,16000,-16000,0,0,0,0,0,0,-16000
20200528,3570,大塚,98.60,98.90,96.90,97.60,-1.00,-1.01,35000,29,3423000,3000,0,3000,0,0,0,0,0,0,3000
20200528,3577,泓格,29.50,29.60,29.20,29.55,+0.15,0.51,15000,14,440950,0,0,0,0,0,0,0,0,0,0
20200528,3580,友威科,23.20,23.40,23.05,23.10,+0.20,0.87,228000,126,5281900,2000,12000,-10000,0,0,0,0,0,0,-10000
20200528,3581,博磊,14.30,14.30,14.20,14.25,-0.05,-0.35,20000,19,284750,0,1000,-1000,0,0,0,0,0,0,-1000
20200528,3587,閎康,78.20,79.40,77.50,77.50,-0.90,-1.15,724000,526,56735700,42000,81000,-39000,0,0,0,6000,42000,-36000,-75000
20200528,3594,磐儀,19.70,19.85,19.50,19.80,+0.20,1.02,71000,47,1398900,0,7000,-7000,0,0,0,0,0,0,-7000
20200528,3597,映興,16.10,16.30,16.05,16.10,0.00,0.0,42000,24,676550,1000,2000,-1000,0,0,0,0,0,0,-1000
20200528,3609,東林,24.30,25.00,24.25,24.55,+0.25,1.03,404000,220,9880300,37000,9000,28000,0,0,0,0,3000,-3000,25000
20200528,3611,鼎翰,199.00,199.50,197.00,197.00,0.00,0.0,60000,60,11863000,32000,4000,28000,0,0,0,0,0,0,28000
20200528,3615,安可,13.70,14.50,13.70,14.10,+0.30,2.17,476000,165,6692550,7000,0,7000,0,0,0,0,0,0,7000
20200528,3623,富晶通,15.25,15.40,15.20,15.20,-0.05,-0.33,18000,15,274350,1000,0,1000,0,0,0,0,0,0,1000
20200528,3624,光頡,27.50,27.80,27.00,27.00,-0.20,-0.74,857000,442,23512150,74000,103000,-29000,0,0,0,78000,2000,76000,47000
20200528,3625,西勝,15.90,15.90,15.45,15.45,-0.20,-1.28,239000,132,3748050,18000,41000,-23000,0,0,0,0,0,0,-23000
20200528,3628,盈正,33.15,33.70,33.00,33.55,+0.30,0.9,166000,86,5507750,0,1000,-1000,0,0,0,0,0,0,-1000
20200528,3629,地心引力,48.65,48.65,48.60,48.60,-4.50,-8.47,3000,2,145850,0,0,0,0,0,0,0,0,0,0
20200528,3630,新鉅科,52.00,52.80,50.20,50.30,-0.80,-1.57,2494000,1549,128319000,153000,257000,-104000,0,0,0,8000,56000,-48000,-152000
20200528,3631,晟楠,48.50,48.90,47.70,47.80,-0.75,-1.54,87000,57,4202950,4000,4000,0,0,0,0,0,0,0,0
20200528,3632,研勤,9.58,9.79,9.58,9.64,+0.06,0.63,48000,36,464840,0,0,0,0,0,0,0,0,0,0
20200528,3642,駿熠電,16.25,16.40,16.05,16.40,0.00,0.0,39000,17,631500,0,0,0,0,0,0,4000,0,4000,4000
20200528,3646,艾恩特,15.35,15.45,15.20,15.45,-0.10,-0.64,19000,16,290500,0,0,0,0,0,0,0,0,0,0
20200528,3652,精聯,15.75,15.75,15.30,15.70,+0.20,1.29,48000,33,746650,0,0,0,0,0,0,0,0,0,0
20200528,3663,鑫科,18.70,18.70,18.50,18.70,0.00,0.0,14000,11,260600,0,1000,-1000,0,0,0,0,0,0,-1000
20200528,3664,安瑞-KY,12.05,12.05,11.85,11.85,-0.50,-4.05,15000,11,178500,0,0,0,0,0,0,0,0,0,0
20200528,3666,光耀,15.30,15.30,15.10,15.30,0.00,0.0,40000,21,609150,0,0,0,0,0,0,0,0,0,0
20200528,3672,康聯訊,12.25,12.25,11.55,12.00,-0.70,-5.51,146000,95,1739100,0,5000,-5000,0,0,0,0,0,0,-5000
20200528,3675,德微,54.20,54.40,51.90,51.90,-0.10,-0.19,577000,371,30699600,0,17000,-17000,0,0,0,7000,0,7000,-10000
20200528,3680,家登,221.00,225.50,209.50,213.50,-15.00,-6.56,3593000,2433,780833500,149000,17000,132000,10000,0,10000,2000,22000,-20000,122000
20200528,3684,榮昌,35.05,35.20,34.50,34.95,-0.05,-0.14,33000,22,1154150,0,1000,-1000,0,0,0,0,1000,-1000,-2000
20200528,3685,元創精密,18.35,19.80,18.35,19.80,+1.80,10.0,86000,53,1685950,0,0,0,0,0,0,0,0,0,0
20200528,3687,歐買尬,59.00,59.50,52.40,55.00,-3.10,-5.34,3276000,2377,185195800,262000,121000,141000,0,0,0,5000,8000,-3000,138000
20200528,3689,湧德,23.80,24.00,23.40,23.80,0.00,0.0,67000,43,1583900,0,0,0,0,0,0,0,0,0,0
20200528,3691,碩禾,86.30,86.50,85.20,85.60,0.00,0.0,320000,224,27448400,6000,18000,-12000,0,0,0,0,0,0,-12000
20200528,3693,營邦,57.60,57.60,57.60,57.60,-6.40,-10.0,446000,225,25689600,0,0,0,0,0,0,0,0,0,0
20200528,3707,漢磊,28.35,29.05,28.05,28.20,0.00,0.0,11330000,5443,323410400,860000,428000,432000,0,0,0,4000,5000,-1000,431000
20200528,3709,鑫聯大投控,20.80,20.95,20.75,20.75,+0.10,0.48,20000,7,417450,0,0,0,0,0,0,0,0,0,0
20200528,3710,連展投控,7.15,7.24,7.12,7.20,0.00,0.0,249000,78,1791040,16000,10000,6000,0,0,0,20000,0,20000,26000
20200528,3713,新晶投控,16.50,17.60,16.25,17.60,+1.60,10.0,1564000,526,26792100,31000,44000,-13000,0,0,0,0,0,0,-13000
20200528,4102,永日,21.70,22.25,21.55,21.60,-0.20,-0.92,603000,318,13171100,9000,44000,-35000,0,0,0,0,0,0,-35000
20200528,4105,東洋,75.60,75.80,74.10,74.40,-1.20,-1.59,554000,368,41474200,16000,50000,-34000,0,0,0,1000,5000,-4000,-38000
20200528,4107,邦特,130.50,130.50,127.50,128.00,-1.50,-1.16,531000,359,68414500,38000,190000,-152000,0,0,0,5000,14000,-9000,-161000
20200528,4109,加捷生醫,16.25,16.50,16.10,16.10,-0.15,-0.92,280000,140,4558050,4000,4000,0,0,0,0,0,0,0,0
20200528,4111,濟生,27.85,27.90,27.55,27.70,-0.10,-0.36,196000,112,5431850,19000,16000,3000,0,0,0,0,0,0,3000
20200528,4113,聯上,12.40,12.40,12.20,12.20,-0.20,-1.61,276000,121,3388300,1000,38000,-37000,0,0,0,0,0,0,-37000
20200528,4114,健喬,24.40,24.55,24.00,24.20,-0.15,-0.62,1217000,672,29465400,58000,179000,-121000,0,0,0,0,0,0,-121000
20200528,4116,明基醫,36.85,36.85,34.15,34.60,-0.90,-2.54,380000,286,13431450,9000,9000,0,0,0,0,0,0,0,0
20200528,4120,友華,49.50,49.50,48.60,48.70,-0.45,-0.92,152000,120,7446550,17000,16000,1000,0,0,0,0,0,0,1000
20200528,4121,優盛,20.00,20.20,19.25,19.25,-0.45,-2.28,3047000,1487,60171650,371000,392000,-21000,0,0,0,0,0,0,-21000
20200528,4123,晟德,58.00,58.70,56.10,56.40,-1.60,-2.76,3946000,2435,226063700,141000,141000,0,0,0,0,37000,242000,-205000,-205000
20200528,4126,太醫,79.00,79.50,78.30,78.30,-0.70,-0.89,468000,288,36928400,80000,154000,-74000,0,0,0,1000,5000,-4000,-78000
20200528,4127,天良,10.50,10.80,10.40,10.40,-0.10,-0.95,102000,65,1076900,3000,0,3000,0,0,0,0,0,0,3000
20200528,4128,中天,28.60,28.95,28.30,28.80,+0.80,2.86,1899000,846,54517350,296000,0,296000,0,0,0,140000,10000,130000,426000
20200528,4129,聯合,36.10,36.30,35.20,35.20,-0.80,-2.22,205000,112,7330850,2000,13000,-11000,0,0,0,0,0,0,-11000
20200528,4129A,聯合甲特,48.30,48.80,48.30,48.80,+0.70,1.46,5000,5,243250,0,0,0,0,0,0,0,0,0,0
20200528,4130,健亞,27.20,27.60,26.90,27.05,-0.20,-0.73,593000,391,16123350,36000,93000,-57000,0,0,0,0,0,0,-57000
20200528,4131,晶宇,4.43,4.43,4.43,4.43,-0.22,-4.73,1000,1,4430,0,0,0,0,0,0,0,0,0,0
20200528,4138,曜亞,50.50,50.50,49.70,49.80,-0.40,-0.8,163000,97,8135850,0,3000,-3000,0,0,0,0,0,0,-3000
20200528,4139,馬光-KY,53.00,54.60,51.20,53.00,+0.90,1.73,1282000,912,67659200,5000,24000,-19000,0,0,0,0,0,0,-19000
20200528,4147,中裕,96.00,96.30,93.00,93.50,-2.20,-2.3,1248000,919,117900900,36000,148000,-112000,0,0,0,0,0,0,-112000
20200528,4152,台微體,70.30,70.30,68.00,69.60,-0.90,-1.28,24000,24,1648900,0,2000,-2000,0,0,0,0,0,0,-2000
20200528,4153,鈺緯,27.50,27.50,26.70,26.70,-1.30,-4.64,27000,23,733050,0,0,0,0,0,0,0,0,0,0
20200528,4154,康樂-KY,34.30,36.30,34.30,35.85,+0.75,2.14,52000,42,1840600,1000,0,1000,0,0,0,0,5000,-5000,-4000
20200528,4157,太景*-KY,19.45,19.45,18.60,18.75,+0.15,0.81,3817000,1581,72500250,239000,191000,48000,0,0,0,22000,65000,-43000,5000
20200528,4160,創源,31.00,32.15,31.00,31.05,-0.65,-2.05,281000,196,8838650,3000,8000,-5000,0,0,0,0,0,0,-5000
20200528,4161,聿新科,31.40,31.40,30.35,30.70,-0.15,-0.49,58000,47,1788250,0,6000,-6000,0,0,0,0,0,0,-6000
20200528,4162,智擎,69.00,70.90,65.60,66.90,-0.50,-0.74,5784000,4026,397801600,240000,272000,-32000,0,0,0,12000,87000,-75000,-107000
20200528,4163,鐿鈦,131.00,131.00,127.50,128.50,-0.50,-0.39,119000,100,15335000,2000,9000,-7000,0,0,0,0,0,0,-7000
20200528,4167,展旺,26.90,28.00,26.55,26.60,-0.30,-1.12,4990000,2518,135004300,104000,513000,-409000,0,0,0,215000,306000,-91000,-500000
20200528,4168,醣聯,28.60,32.00,28.45,29.20,-0.80,-2.67,2635000,1783,79945550,270000,232000,38000,0,0,0,18000,19000,-1000,37000
20200528,4171,瑞基,299.00,310.00,299.00,301.00,0.00,0.0,194000,151,58932000,2000,13000,-11000,6000,0,6000,0,1000,-1000,-6000
20200528,4173,久裕,20.60,20.65,20.05,20.05,-0.20,-0.99,917000,548,18583750,11000,35000,-24000,0,0,0,0,0,0,-24000
20200528,4174,浩鼎,126.00,126.00,121.00,121.50,-5.50,-4.33,1525000,1081,188292500,15000,116000,-101000,0,0,0,14000,0,14000,-87000
20200528,4175,杏一,74.80,75.40,74.70,74.80,-0.10,-0.13,26000,23,1948200,1000,2000,-1000,0,0,0,0,0,0,-1000
20200528,4183,福永生技,19.00,19.00,18.00,18.45,-0.75,-3.91,35000,29,644600,0,0,0,0,0,0,0,0,0,0
20200528,4188,安克,21.80,21.80,20.00,20.75,-1.05,-4.82,445000,247,9140550,0,0,0,0,0,0,0,0,0,0
20200528,4192,杏國,37.00,37.30,35.55,36.25,+0.10,0.28,228000,146,8321550,0,7000,-7000,0,0,0,0,0,0,-7000
20200528,4198,環瑞醫,4.50,4.50,4.40,4.40,-0.20,-4.35,52000,17,232880,0,0,0,0,0,0,0,0,0,0
20200528,4205,中華食,89.90,90.00,89.80,89.80,-0.10,-0.11,11000,11,988400,0,0,0,0,0,0,0,0,0,0
20200528,4207,環泰,10.90,10.90,10.75,10.85,0.00,0.0,142000,44,1533850,0,4000,-4000,0,0,0,0,0,0,-4000
20200528,4303,信立,18.95,19.05,18.95,19.05,0.00,0.0,7000,4,133250,0,0,0,0,0,0,0,0,0,0
20200528,4304,勝昱,4.78,4.92,4.34,4.78,0.00,0.0,11000,7,52320,0,0,0,0,0,0,0,0,0,0
20200528,4305,世坤,34.00,34.00,34.00,34.00,0.00,0.0,5000,3,170000,0,0,0,0,0,0,0,0,0,0
20200528,4401,東隆興,27.95,27.95,26.85,27.05,-0.40,-1.46,490000,280,13470550,9000,14000,-5000,0,0,0,0,0,0,-5000
20200528,4402,福大,5.12,5.12,5.12,5.12,0.00,0.0,31000,11,158720,0,0,0,0,0,0,0,0,0,0
20200528,4406,新昕纖,8.76,8.76,8.74,8.75,-0.07,-0.79,11000,4,96220,0,0,0,0,0,0,0,0,0,0
20200528,4413,飛寶企業,13.15,13.15,13.15,13.15,+0.40,3.14,1000,1,13150,0,0,0,0,0,0,0,0,0,0
20200528,4416,三圓,81.80,81.80,79.60,79.60,0.00,0.0,2000,2,161400,0,0,0,0,0,0,0,0,0,0
20200528,4417,金洲,30.80,30.80,30.50,30.60,-0.10,-0.33,86000,47,2631900,1000,0,1000,0,0,0,0,0,0,1000
20200528,4419,元勝,,,,,,0.00,0,0,0,0,0,0,0,0,0,0,0,0,0
20200528,4420,光明,25.35,25.35,24.90,24.90,-0.05,-0.2,23000,20,577800,5000,3000,2000,0,0,0,0,0,0,2000
20200528,4429,聚紡,,,,,,0.00,0,0,0,0,0,0,0,0,0,0,0,0,0
20200528,4430,耀億,24.00,24.10,23.85,23.95,0.00,0.0,49000,25,1171900,0,2000,-2000,0,0,0,0,0,0,-2000
20200528,4432,銘旺實,12.15,12.20,11.95,12.00,-0.05,-0.41,33000,20,397950,0,0,0,0,0,0,0,0,0,0
20200528,4433,興采,33.90,34.00,32.70,33.20,-0.65,-1.92,140000,90,4671550,0,0,0,0,0,0,0,0,0,0
20200528,4502,健信,54.50,54.50,52.50,53.00,-1.50,-2.75,23000,21,1229600,0,2000,-2000,0,0,0,0,0,0,-2000
20200528,4503,金雨,15.95,16.45,15.95,16.15,+0.20,1.25,39000,23,631150,2000,0,2000,0,0,0,0,0,0,2000
20200528,4506,崇友,57.80,58.30,57.80,58.20,+0.20,0.34,18000,9,1048800,0,3000,-3000,0,0,0,0,10000,-10000,-13000
20200528,4510,高鋒,9.80,9.98,9.80,9.87,+0.07,0.71,169000,46,1663400,0,0,0,0,0,0,0,0,0,0
20200528,4513,福裕,7.28,7.28,7.00,7.17,-0.11,-1.51,193000,82,1379010,8000,0,8000,0,0,0,0,0,0,8000
20200528,4523,永彰,21.10,21.15,20.85,20.85,-0.10,-0.48,32000,17,672000,1000,1000,0,0,0,0,0,0,0,0
20200528,4527,方土霖,25.45,25.55,25.30,25.30,-0.10,-0.39,40000,25,1015600,0,0,0,0,0,0,0,0,0,0
20200528,4528,江興鍛,40.35,40.95,40.00,40.00,-0.35,-0.87,49000,39,1977550,0,3000,-3000,0,0,0,0,0,0,-3000
20200528,4529,淳紳,8.56,8.80,8.52,8.76,+0.11,1.27,52000,31,450820,1000,2000,-1000,0,0,0,2000,0,2000,1000
20200528,4530,宏易,11.15,11.15,10.85,11.05,-0.10,-0.9,7000,5,76750,0,0,0,0,0,0,0,0,0,0
20200528,4533,協易機,11.00,11.05,10.85,10.85,-0.05,-0.46,27000,16,295700,0,0,0,0,0,0,0,0,0,0
20200528,4534,慶騰,7.68,7.68,7.24,7.50,+0.34,4.75,62000,37,464140,0,1000,-1000,0,0,0,0,3000,-3000,-4000
20200528,4535,至興,24.30,24.75,24.15,24.40,+0.10,0.41,22000,13,538300,0,0,0,0,0,0,0,0,0,0
20200528,4538,大詠城,15.10,15.10,14.95,15.00,0.00,0.0,6000,5,90050,0,1000,-1000,0,0,0,0,0,0,-1000
20200528,4541,晟田,18.40,19.45,18.40,19.45,+1.75,9.89,1009000,318,19587100,32000,30000,2000,0,0,0,0,0,0,2000
20200528,4542,科嶠,24.35,24.35,24.35,24.35,+0.45,1.88,1000,1,24350,0,0,0,0,0,0,0,0,0,0
20200528,4543,萬在,15.15,15.20,14.85,14.85,-0.05,-0.34,34000,14,511050,0,0,0,0,0,0,0,1000,-1000,-1000
20200528,4549,桓達,72.10,72.90,71.20,71.90,0.00,0.0,39000,36,2808500,0,4000,-4000,0,0,0,0,0,0,-4000
20200528,4550,長佳,25.70,26.35,25.60,26.00,+0.40,1.56,99000,79,2569400,0,10000,-10000,0,0,0,0,0,0,-10000
20200528,4554,橙的,18.75,19.00,18.60,18.95,0.00,0.0,11000,11,207000,0,0,0,0,0,0,0,0,0,0
20200528,4556,旭然,33.90,34.40,33.90,34.30,-0.10,-0.29,31000,18,1056450,0,0,0,0,0,0,0,0,0,0
20200528,4561,健椿,26.00,26.00,25.70,25.85,+0.05,0.19,28000,19,724350,0,0,0,0,0,0,0,0,0,0
20200528,4563,百德,35.40,35.75,35.40,35.75,+0.40,1.13,46000,36,1635650,5000,0,5000,0,0,0,0,10000,-10000,-5000
20200528,4568,科際精密,57.70,57.70,57.10,57.10,-0.70,-1.21,2000,2,114800,0,0,0,0,0,0,0,0,0,0
20200528,4580,捷流閥業,109.50,113.00,106.50,107.00,+2.50,2.39,880000,669,96149500,4000,13000,-9000,0,0,0,4000,13000,-9000,-18000
20200528,4609,唐鋒,,,,,,0.00,0,0,0,0,0,0,0,0,0,0,0,0,0
20200528,4702,中美實,10.00,10.00,9.71,9.95,-0.02,-0.2,30000,17,296940,0,0,0,0,0,0,0,0,0,0
20200528,4706,大恭,16.40,16.45,16.35,16.35,+0.05,0.31,10000,9,164150,0,0,0,0,0,0,0,0,0,0
20200528,4707,磐亞,11.50,11.55,11.35,11.35,-0.10,-0.87,1448000,464,16556300,0,60000,-60000,0,0,0,0,35000,-35000,-95000
20200528,4711,永純,14.65,14.80,14.50,14.55,0.00,0.0,78000,44,1139050,0,0,0,0,0,0,0,0,0,0
20200528,4712,南璋,9.55,9.55,8.76,8.80,+0.10,1.15,102000,29,964240,0,0,0,0,0,0,0,0,0,0
20200528,4714,永捷,14.30,14.30,14.15,14.25,+0.10,0.71,440000,172,6261600,52000,1000,51000,0,0,0,2000,4000,-2000,49000
20200528,4716,大立,14.05,14.05,13.95,13.95,-0.10,-0.71,95000,12,1334150,0,0,0,0,0,0,0,0,0,0
20200528,4721,美琪瑪,51.10,51.20,50.10,50.10,-0.40,-0.79,215000,173,10883500,24000,21000,3000,0,0,0,2000,0,2000,5000
20200528,4726,永昕,28.90,30.20,28.85,29.00,-0.50,-1.69,708000,385,20747100,65000,15000,50000,0,0,0,0,5000,-5000,45000
20200528,4728,雙美,77.60,79.50,77.30,78.30,+0.70,0.9,418000,378,32765600,76000,24000,52000,0,0,0,38000,89000,-51000,1000
20200528,4729,熒茂,16.60,17.80,16.50,17.40,-0.90,-4.92,826000,423,13848600,0,1000,-1000,0,0,0,0,8000,-8000,-9000
20200528,4735,豪展,68.50,70.00,67.80,68.10,+1.60,2.41,2019000,1336,139067100,433000,124000,309000,0,0,0,5000,123000,-118000,191000
20200528,4736,泰博,268.00,284.50,265.00,282.00,+20.00,7.63,2106000,1592,578250500,167000,224000,-57000,86000,13000,73000,22000,39000,-17000,-1000
20200528,4741,泓瀚,25.45,25.45,25.00,25.05,-0.40,-1.57,42000,30,1055650,0,0,0,0,0,0,0,0,0,0
20200528,4743,合一,127.00,134.00,126.50,134.00,+8.00,6.35,2713000,1481,353141000,519000,13000,506000,0,0,0,0,6000,-6000,500000
20200528,4744,皇將,36.75,37.15,36.45,36.70,-0.05,-0.14,87000,56,3202450,21000,9000,12000,0,0,0,2000,4000,-2000,10000
20200528,4745,合富-KY,33.80,34.10,33.40,33.40,-0.60,-1.76,77000,53,2599650,4000,4000,0,0,0,0,0,0,0,0
20200528,4747,強生,42.20,42.60,42.20,42.25,0.00,0.0,61000,44,2584750,3000,2000,1000,0,0,0,0,0,0,1000
20200528,4754,國碳科,55.90,56.00,55.30,55.30,0.00,0.0,26000,13,1447800,0,2000,-2000,0,0,0,0,0,0,-2000
20200528,4760,勤凱,74.10,76.00,73.50,74.70,+1.10,1.49,258000,224,19240300,18000,9000,9000,0,0,0,0,0,0,9000
20200528,4767,誠泰科技,23.20,23.20,23.00,23.00,-0.20,-0.86,17000,9,391700,0,0,0,0,0,0,0,0,0,0
20200528,4803,VHQ-KY,74.90,75.50,72.30,72.70,-0.90,-1.22,292000,233,21615100,4000,19000,-15000,0,0,0,0,9000,-9000,-24000
20200528,4804,大略-KY,11.50,11.75,10.55,10.65,-0.55,-4.91,337000,195,3780600,1000,12000,-11000,0,0,0,0,0,0,-11000
20200528,4806,昇華,8.94,8.94,7.96,8.20,-0.03,-0.36,11000,11,90680,0,0,0,0,0,0,0,0,0,0
20200528,4903,聯光通,12.95,13.15,12.80,13.15,+0.45,3.54,40000,28,515450,0,6000,-6000,0,0,0,0,0,0,-6000
20200528,4905,台聯電,,,,,,0.00,0,0,0,0,0,0,0,0,0,0,0,0,0
20200528,4907,富宇,24.85,25.00,24.80,25.00,+0.10,0.4,20000,17,498350,4000,0,4000,0,0,0,0,0,0,4000
20200528,4908,前鼎,37.80,38.70,37.30,37.45,0.00,0.0,1088000,737,41286050,93000,127000,-34000,0,0,0,0,6000,-6000,-40000
20200528,4909,新復興,15.15,15.50,14.75,15.50,+0.45,2.99,483000,235,7345500,27000,39000,-12000,0,0,0,0,4000,-4000,-16000
20200528,4911,德英,44.20,46.95,39.75,43.25,-0.90,-2.04,392000,295,16943250,5000,10000,-5000,0,0,0,0,0,0,-5000
20200528,4924,欣厚-KY,7.16,7.16,6.71,6.73,-0.20,-2.89,22000,14,153230,0,0,0,0,0,0,0,0,0,0
20200528,4931,新盛力,29.80,30.05,29.45,29.45,-0.35,-1.17,308000,178,9170500,22000,40000,-18000,0,0,0,0,0,0,-18000
20200528,4933,友輝,21.15,21.60,21.10,21.25,+0.10,0.47,137000,62,2914400,2000,29000,-27000,0,0,0,0,0,0,-27000
20200528,4939,亞電,14.35,14.45,13.85,13.85,-0.50,-3.48,2100000,442,30020200,19000,143000,-124000,0,0,0,0,0,0,-124000
20200528,4944,兆遠,8.34,8.76,8.34,8.65,+0.35,4.22,78000,35,663480,0,0,0,0,0,0,0,0,0,0
20200528,4946,辣椒,11.70,12.20,11.70,11.70,-1.30,-10.0,562000,244,6597550,0,0,0,0,0,0,0,0,0,0
20200528,4950,牧東,5.50,5.80,5.26,5.60,+0.15,2.75,53000,18,290810,0,0,0,0,0,0,0,0,0,0
20200528,4953,緯軟,77.80,78.10,75.00,76.00,0.00,0.0,1206000,904,92730400,62000,134000,-72000,0,0,0,38000,21000,17000,-55000
20200528,4966,譜瑞-KY,919.00,921.00,880.00,880.00,-36.00,-3.93,1607000,1499,1448559000,289013,758407,-469394,24000,16000,8000,26000,36000,-10000,-471394
20200528,4971,IET-KY,61.00,61.00,58.60,59.60,-0.20,-0.33,174000,142,10355300,23000,28000,-5000,0,0,0,0,0,0,-5000
20200528,4972,湯石照明,30.25,30.40,30.25,30.40,+0.15,0.5,23000,18,697650,2000,0,2000,0,0,0,0,0,0,2000
20200528,4973,廣穎,25.95,26.10,25.05,25.05,-0.20,-0.79,3983000,1978,102521200,123000,513000,-390000,0,0,0,0,0,0,-390000
20200528,4974,亞泰,54.70,54.80,53.70,53.70,-0.70,-1.29,458000,317,24880500,28000,33000,-5000,0,0,0,26000,67000,-41000,-46000
20200528,4979,華星光,24.60,24.70,23.15,23.25,-1.20,-4.91,2723000,1491,64884250,212000,75000,137000,0,0,0,0,0,0,137000
20200528,4987,科誠,49.25,49.25,49.00,49.00,-0.25,-0.51,18000,15,884200,0,0,0,0,0,0,0,0,0,0
20200528,4991,環宇-KY,53.30,53.30,52.10,52.20,-0.50,-0.95,367000,235,19343400,40000,61000,-21000,0,0,0,19000,1000,18000,-3000
20200528,4995,晶達,45.25,45.30,44.65,45.30,+0.30,0.67,58000,26,2614650,0,0,0,0,0,0,0,0,0,0
20200528,5009,榮剛,16.15,16.35,16.15,16.15,-0.05,-0.31,250000,106,4055900,50000,0,50000,0,0,0,0,0,0,50000
20200528,5011,久陽,14.95,14.95,14.90,14.90,-0.05,-0.33,7000,5,104350,0,0,0,0,0,0,0,0,0,0
20200528,5013,強新,23.05,23.05,23.00,23.00,-0.05,-0.22,3000,2,69100,0,0,0,0,0,0,0,0,0,0
20200528,5014,建錩,7.90,7.91,7.86,7.88,+0.02,0.25,109000,48,860080,13000,3000,10000,0,0,0,0,0,0,10000
20200528,5015,華祺,36.30,36.30,35.60,36.20,+0.05,0.14,62000,34,2236600,0,0,0,0,0,0,0,0,0,0
20200528,5016,松和,28.50,28.50,28.20,28.20,-0.60,-2.08,12000,8,339400,0,0,0,0,0,0,0,0,0,0
20200528,5102,富強,15.50,15.55,15.50,15.50,0.00,0.0,25000,13,388000,0,0,0,0,0,0,0,0,0,0
20200528,5201,凱衛,32.50,32.50,31.50,31.80,-0.10,-0.31,18000,16,572250,3000,0,3000,0,0,0,0,0,0,3000
20200528,5202,力新,,,,,,0.00,0,0,0,0,0,0,0,0,0,0,0,0,0
20200528,5205,中茂,6.20,6.20,6.20,6.20,+0.41,7.08,2000,2,12400,0,0,0,0,0,0,0,0,0,0
20200528,5206,坤悅,15.30,15.45,15.25,15.30,+0.20,1.32,165000,82,2534600,13000,0,13000,0,0,0,0,0,0,13000
20200528,5209,新鼎,63.70,63.80,63.00,63.40,-0.20,-0.31,54000,43,3418000,5000,2000,3000,0,0,0,0,0,0,3000
20200528,5210,寶碩,6.50,6.68,6.35,6.50,0.00,0.0,62000,39,402460,0,0,0,0,0,0,0,0,0,0
20200528,5211,蒙恬,14.05,14.05,13.85,13.85,-0.10,-0.72,14000,13,194700,0,2000,-2000,0,0,0,0,0,0,-2000
20200528,5212,凌網,49.40,49.60,47.65,47.65,-1.65,-3.35,113000,95,5490650,6000,15000,-9000,0,0,0,0,0,0,-9000
20200528,5213,亞昕,14.90,14.95,14.80,14.85,+0.10,0.68,195000,74,2902900,6000,1000,5000,0,0,0,0,0,0,5000
20200528,5220,萬達光電,34.80,34.80,34.05,34.25,+0.05,0.15,518000,323,17773700,34000,16000,18000,80000,0,80000,0,0,0,98000
20200528,5223,安力-KY,35.00,36.50,35.00,35.05,+0.05,0.14,314000,181,11176350,16000,10000,6000,0,0,0,0,0,0,6000
20200528,5227,立凱-KY,10.90,10.90,10.90,10.90,+0.97,9.77,1232000,371,13428800,0,0,0,0,0,0,0,0,0,0
20200528,5230,雷笛克光學,22.40,22.50,22.25,22.50,0.00,0.0,54000,44,1208850,2000,0,2000,0,0,0,0,0,0,2000
20200528,5245,智晶,38.30,38.70,36.15,36.90,-1.60,-4.16,1230000,789,45956200,82000,54000,28000,0,0,0,8000,0,8000,36000
20200528,5251,天鉞電,13.75,13.75,13.65,13.70,-0.05,-0.36,63000,32,863350,0,0,0,0,0,0,0,0,0,0
20200528,5263,智崴,120.00,120.00,116.00,119.00,+1.00,0.85,233000,194,27536000,5000,32000,-27000,0,0,0,0,0,0,-27000
20200528,5272,笙科,18.80,18.85,18.30,18.60,-0.20,-1.06,81000,62,1504400,0,19000,-19000,0,0,0,0,0,0,-19000
20200528,5274,信驊,1470.00,1510.00,1440.00,1440.00,+5.00,0.35,629000,595,924385000,124400,265487,-141087,4000,11000,-7000,27000,5000,22000,-126087
20200528,5276,達輝-KY,8.00,8.01,8.00,8.00,0.00,0.0,13000,7,104030,0,0,0,0,0,0,0,0,0,0
20200528,5278,尚凡,128.00,129.50,128.00,128.00,-1.00,-0.78,34000,33,4364000,1000,1000,0,0,0,0,0,0,0,0
20200528,5281,大峽谷-KY,22.50,22.50,22.50,22.50,+0.20,0.9,5000,5,112500,0,0,0,0,0,0,0,0,0,0
20200528,5287,數字,226.00,226.00,224.00,224.00,-1.50,-0.67,31000,31,6976000,5000,2000,3000,0,0,0,0,0,0,3000
20200528,5289,宜鼎,188.00,191.00,186.50,186.50,0.00,0.0,1195000,926,225064500,224000,142000,82000,70000,0,70000,69000,36000,33000,185000
20200528,5291,邑昇,22.20,22.25,21.75,21.80,-0.35,-1.58,192000,103,4216050,16000,22000,-6000,0,0,0,0,0,0,-6000
20200528,5299,杰力,117.00,118.50,114.50,118.00,+2.00,1.72,1187000,881,138865500,68000,72000,-4000,0,0,0,9000,7000,2000,-2000
20200528,5301,寶得利,10.85,10.85,10.85,10.85,+0.95,9.6,462000,175,5012700,0,0,0,0,0,0,0,0,0,0
20200528,5302,太欣,5.50,5.54,5.42,5.46,-0.04,-0.73,126000,54,690830,0,12000,-12000,0,0,0,0,0,0,-12000
20200528,5304,鼎創達,2.12,2.12,2.03,2.12,+0.06,2.91,41000,11,86790,0,0,0,0,0,0,0,0,0,0
20200528,5306,桂盟,122.00,122.50,117.50,118.50,-3.00,-2.47,1036000,802,124366500,328000,149000,179000,8102,0,8102,24000,39000,-15000,172102
20200528,5309,系統電,26.00,26.40,25.30,25.35,-0.60,-2.31,3183000,1463,81843350,142000,132000,10000,0,0,0,0,0,0,10000
20200528,5310,天剛,13.00,13.50,12.60,13.50,+0.50,3.85,26000,20,338900,0,0,0,0,0,0,0,0,0,0
20200528,5312,寶島科,65.20,65.50,64.60,65.50,+0.20,0.31,22000,17,1429300,0,0,0,0,0,0,0,0,0,0
20200528,5314,世紀,3.86,3.98,3.79,3.79,-0.07,-1.81,19000,7,74720,0,0,0,0,0,0,0,0,0,0
20200528,5315,光聯,13.85,13.95,13.65,13.75,-0.05,-0.36,275000,106,3793950,1000,44000,-43000,0,0,0,0,0,0,-43000
20200528,5321,友銓,22.35,22.80,21.90,22.80,+0.10,0.44,26000,24,579000,0,1000,-1000,0,0,0,1000,0,1000,0
20200528,5324,士開,8.23,8.30,8.16,8.16,0.00,0.0,59000,32,482920,0,6000,-6000,0,0,0,0,0,0,-6000
20200528,5328,華容,8.35,8.48,8.25,8.25,-0.08,-0.96,315000,171,2626910,15000,71000,-56000,0,0,0,0,0,0,-56000
20200528,5340,建榮,42.70,43.40,41.25,41.65,-1.00,-2.34,365000,253,15443550,21000,21000,0,0,0,0,13000,37000,-24000,-24000
20200528,5344,立衛,10.00,10.05,10.00,10.00,0.00,0.0,108000,40,1080500,0,0,0,0,0,0,0,0,0,0
20200528,5345,天揚,5.50,5.50,5.50,5.50,+0.31,5.97,2000,2,11000,0,0,0,0,0,0,0,0,0,0
20200528,5347,世界,71.70,72.60,71.30,71.60,+0.20,0.28,3026000,2216,217448500,1171955,1030000,141955,317000,0,317000,27000,64000,-37000,421955
20200528,5348,系通,6.35,6.49,6.27,6.36,-0.01,-0.16,12000,9,76370,0,0,0,0,0,0,0,0,0,0
20200528,5349,先豐,22.25,22.55,21.60,21.80,-0.35,-1.58,869000,448,19179700,53000,37000,16000,0,0,0,0,0,0,16000
20200528,5351,鈺創,6.10,6.29,6.10,6.15,+0.07,1.15,1221000,421,7577420,149000,39000,110000,0,0,0,0,0,0,110000
20200528,5353,台林,17.45,17.50,17.30,17.50,0.00,0.0,165000,54,2878600,9000,0,9000,0,0,0,0,0,0,9000
20200528,5355,佳總,4.32,4.32,4.25,4.25,-0.02,-0.47,13000,9,55770,0,0,0,0,0,0,0,0,0,0
20200528,5356,協益,29.20,29.35,28.80,28.80,-0.40,-1.37,103000,57,2994400,9000,23000,-14000,0,0,0,0,0,0,-14000
20200528,5364,力麗店,,,,,,0.00,0,0,0,0,0,0,0,0,0,0,0,0,0
20200528,5371,中光電,31.55,31.75,31.40,31.45,0.00,0.0,626000,391,19744000,105000,175000,-70000,0,0,0,1000,0,1000,-69000
20200528,5381,合正,2.90,2.97,2.90,2.97,0.00,0.0,55000,7,163140,0,0,0,0,0,0,0,0,0,0
20200528,5383,金利,23.80,24.00,22.95,23.00,-0.60,-2.54,252000,126,5907350,13000,4000,9000,0,0,0,0,0,0,9000
20200528,5386,青雲,28.60,29.10,28.25,28.35,-0.05,-0.18,86000,63,2461350,20000,17000,3000,0,0,0,0,0,0,3000
20200528,5392,應華,24.25,24.80,24.05,24.70,+0.55,2.28,871000,308,21358050,72000,78000,-6000,0,0,0,0,0,0,-6000
20200528,5398,慕康生醫,,,,,,0.00,0,0,0,0,0,0,0,0,0,0,0,0,0
20200528,5403,中菲,47.70,48.10,47.70,48.10,+0.50,1.05,258000,171,12376800,21000,0,21000,0,0,0,2000,0,2000,23000
20200528,5410,國眾,20.80,20.80,20.55,20.55,-0.10,-0.48,314000,139,6491050,17000,15000,2000,0,0,0,0,0,0,2000
20200528,5425,台半,37.45,37.65,36.75,36.80,-0.25,-0.67,1080000,690,40239700,229000,101000,128000,0,0,0,44000,28000,16000,144000
20200528,5426,振發,10.15,10.15,9.86,9.95,+0.01,0.1,24000,14,238350,0,6000,-6000,0,0,0,0,0,0,-6000
20200528,5432,達威,15.80,15.90,15.55,15.65,-0.05,-0.32,59000,30,928800,0,0,0,0,0,0,0,0,0,0
20200528,5438,東友,12.10,12.10,11.95,11.95,-0.05,-0.42,69000,37,827200,0,0,0,0,0,0,0,0,0,0
20200528,5439,高技,49.80,50.20,49.60,49.85,+0.65,1.32,1228000,788,61303750,235000,4000,231000,0,0,0,0,3000,-3000,228000
20200528,5443,均豪,19.10,19.10,18.85,18.85,-0.25,-1.31,308000,167,5833350,3000,32000,-29000,0,0,0,0,0,0,-29000
20200528,5450,寶聯通,14.50,14.50,14.25,14.30,-0.40,-2.72,47000,27,675300,0,0,0,0,0,0,0,0,0,0
20200528,5452,佶優,6.48,6.48,6.37,6.39,-0.05,-0.78,158000,51,1013440,0,2000,-2000,0,0,0,0,0,0,-2000
20200528,5455,昇益,,,,,,0.00,0,0,0,0,0,0,0,0,0,0,0,0,0
20200528,5457,宣德,80.50,83.30,80.50,82.70,+2.80,3.5,4555000,3087,374031300,410000,253000,157000,582000,0,582000,173000,96000,77000,816000
20200528,5460,同協,10.90,10.95,10.80,10.85,-0.10,-0.91,67000,24,727500,0,0,0,0,0,0,0,0,0,0
20200528,5464,霖宏,10.95,11.00,10.90,11.00,+0.10,0.92,41000,19,450050,1000,0,1000,0,0,0,0,0,0,1000
20200528,5465,富驊,16.10,16.10,15.65,15.80,0.00,0.0,133000,69,2096750,0,0,0,0,0,0,0,0,0,0
20200528,5468,凱鈺,,,,,,0.00,0,0,0,0,0,0,0,0,0,0,0,0,0
20200528,5474,聰泰,100.00,101.00,95.10,95.10,-4.60,-4.61,595000,471,57669900,6000,109000,-103000,0,0,0,6000,0,6000,-97000
20200528,5475,德宏,2.14,2.18,2.14,2.17,+0.03,1.4,82000,20,178360,0,0,0,0,0,0,0,0,0,0
20200528,5478,智冠,110.50,113.00,109.00,109.50,+0.50,0.46,1180000,948,130689000,187000,315000,-128000,0,0,0,0,0,0,-128000
20200528,5481,新華,12.20,12.30,11.70,11.75,-0.45,-3.69,184000,87,2222900,0,15000,-15000,0,0,0,0,0,0,-15000
20200528,5483,中美晶,89.20,89.70,88.20,89.10,+0.40,0.45,4826000,3133,429453700,1070000,873000,197000,0,0,0,43000,104000,-61000,136000
20200528,5487,通泰,30.35,30.35,29.10,29.95,+0.10,0.34,19000,19,564700,0,0,0,0,0,0,0,0,0,0
20200528,5488,松普,5.31,5.43,5.27,5.41,+0.10,1.88,360000,94,1934470,21000,0,21000,0,0,0,0,0,0,21000
20200528,5489,彩富,32.70,32.70,32.60,32.60,-0.10,-0.31,26000,17,849750,0,15000,-15000,0,0,0,0,0,0,-15000
20200528,5490,同亨,25.75,25.85,25.50,25.55,-0.10,-0.39,184000,115,4722750,15000,28000,-13000,0,0,0,0,2000,-2000,-15000
20200528,5493,三聯,39.55,39.55,38.70,38.90,-0.50,-1.27,136000,93,5317550,1000,5000,-4000,0,0,0,0,0,0,-4000
20200528,5498,凱崴,11.45,11.50,11.15,11.25,-0.05,-0.44,715000,256,8097050,67000,38000,29000,0,0,0,0,0,0,29000
20200528,5508,永信建,32.40,32.60,32.40,32.60,+0.40,1.24,100000,65,3251400,0,4000,-4000,0,0,0,0,0,0,-4000
20200528,5511,德昌,29.60,30.10,29.55,29.80,+0.30,1.02,152000,90,4537450,0,28000,-28000,0,0,0,0,0,0,-28000
20200528,5512,力麒,9.49,9.56,9.42,9.49,+0.04,0.42,1111000,351,10551640,82000,81000,1000,0,0,0,0,0,0,1000
20200528,5514,三豐,19.95,20.00,19.60,19.95,0.00,0.0,60000,14,1196700,0,0,0,0,0,0,0,0,0,0
20200528,5516,雙喜,14.50,15.80,14.50,14.90,+0.50,3.47,80000,44,1188800,0,0,0,0,0,0,0,0,0,0
20200528,5520,力泰,,,,,,0.00,0,0,0,0,0,0,0,0,0,0,0,0,0
20200528,5523,豐謙,10.40,10.40,10.40,10.40,0.00,0.0,27000,7,280800,0,0,0,0,0,0,0,0,0,0
20200528,5529,志嘉,6.50,6.59,6.10,6.18,-0.41,-6.22,814000,179,5126680,8000,11000,-3000,0,0,0,0,0,0,-3000
20200528,5530,龍巖,57.30,57.60,57.00,57.10,-0.10,-0.17,110000,82,6288600,5000,46000,-41000,0,0,0,0,0,0,-41000
20200528,5536,聖暉,212.00,212.00,206.50,207.00,-2.50,-1.19,765000,564,160140000,32000,208000,-176000,0,0,0,2000,14000,-12000,-188000
20200528,5543,崇佑-KY,20.00,20.30,20.00,20.20,+0.20,1.0,29000,16,586600,0,0,0,0,0,0,0,0,0,0
20200528,5601,台聯櫃,,,,,,0.00,0,0,0,0,0,0,0,0,0,0,0,0,0
20200528,5603,陸海,9.72,9.72,9.46,9.70,+0.22,2.32,76000,42,725220,0,0,0,0,0,0,0,2000,-2000,-2000
20200528,5604,中連貨,57.90,58.00,57.50,57.60,-0.30,-0.52,109000,82,6290400,5000,14000,-9000,0,0,0,0,0,0,-9000
20200528,5609,中菲行,30.35,30.65,29.90,29.90,0.00,0.0,1532000,734,46305900,129000,34000,95000,0,0,0,44000,148000,-104000,-9000
20200528,5701,劍湖山,1.79,1.79,1.79,1.79,+0.16,9.82,1347000,159,2411130,0,0,0,0,0,0,0,0,0,0
20200528,5703,亞都,22.35,22.35,22.35,22.35,-0.95,-4.08,1000,1,22350,0,0,0,0,0,0,0,0,0,0
20200528,5704,老爺知,29.70,30.05,28.50,30.05,+2.70,9.87,723000,395,21553400,7000,3000,4000,0,0,0,0,0,0,4000
20200528,5820,日盛金,9.30,9.33,9.28,9.33,+0.03,0.32,1224000,455,11380830,76000,473000,-397000,0,0,0,0,0,0,-397000
20200528,5864,致和證,8.03,8.24,8.01,8.01,-0.02,-0.25,174000,65,1405180,1000,1000,0,0,0,0,0,0,0,0
20200528,5878,台名,47.00,47.50,47.00,47.00,+0.10,0.21,22000,15,1038300,0,0,0,0,0,0,0,0,0,0
20200528,5902,德記,11.95,12.00,11.80,11.80,-0.15,-1.26,26000,14,310200,0,0,0,0,0,0,0,0,0,0
20200528,5903,全家,242.00,242.00,239.50,240.00,-2.00,-0.83,33000,33,7936000,14000,15000,-1000,0,0,0,0,0,0,-1000
20200528,5904,寶雅,580.00,581.00,565.00,574.00,-8.00,-1.37,188000,185,107368000,132021,154000,-21979,30000,0,30000,5000,15000,-10000,-1979
20200528,5905,南仁湖,11.50,12.20,10.90,11.20,-0.15,-1.32,11498000,4203,133757800,121000,696000,-575000,0,0,0,0,0,0,-575000
20200528,6015,宏遠證,6.12,6.12,6.06,6.07,-0.05,-0.82,277000,59,1688220,0,13000,-13000,0,0,0,0,0,0,-13000
20200528,6016,康和證,7.06,7.06,7.02,7.03,-0.02,-0.28,172000,75,1211530,2000,52825,-50825,0,0,0,0,0,0,-50825
20200528,6020,大展證,12.30,12.30,12.20,12.20,0.00,0.0,12000,5,146900,0,0,0,0,0,0,0,0,0,0
20200528,6021,大慶證,12.90,12.90,12.75,12.85,-0.05,-0.39,29000,16,372750,0,0,0,0,0,0,0,0,0,0
20200528,6023,元大期,56.20,56.20,55.80,55.80,0.00,0.0,396000,241,22180300,0,22000,-22000,0,0,0,0,50000,-50000,-72000
20200528,6026,福邦證,8.78,8.78,8.60,8.63,-0.08,-0.92,321000,118,2783310,0,95000,-95000,0,0,0,0,0,0,-95000
20200528,6101,寬魚國際,29.30,29.50,28.80,29.50,+0.05,0.17,34000,28,993250,0,3000,-3000,0,0,0,0,0,0,-3000
20200528,6103,合邦,5.72,6.00,5.72,5.72,+0.19,3.44,11000,7,64320,0,0,0,0,0,0,0,0,0,0
20200528,6104,創惟,45.10,45.30,43.75,43.95,-0.70,-1.57,2801000,1791,124220300,381000,200000,181000,0,0,0,0,18000,-18000,163000
20200528,6109,亞元,10.05,10.10,9.88,10.10,+0.12,1.2,111000,42,1107890,0,0,0,0,0,0,0,0,0,0
20200528,6111,大宇資,72.20,78.60,72.00,78.60,+7.10,9.93,3047000,1928,235821000,107000,100000,7000,0,0,0,8000,1000,7000,14000
20200528,6113,亞矽,5.66,5.88,5.62,5.73,+0.10,1.78,65000,29,370960,0,0,0,0,0,0,0,0,0,0
20200528,6114,久威,24.90,25.00,24.55,24.75,-0.10,-0.4,81000,41,2003900,0,11000,-11000,0,0,0,0,0,0,-11000
20200528,6118,建達,9.32,10.20,9.29,9.61,+0.16,1.69,948000,467,9210950,42000,42000,0,0,0,0,0,17000,-17000,-17000
20200528,6121,新普,321.00,327.50,318.00,327.00,+10.50,3.32,2080000,1781,673685000,1058000,266000,792000,166000,0,166000,174000,37000,137000,1095000
20200528,6122,擎邦,13.90,13.90,13.75,13.75,-0.05,-0.36,198000,85,2737450,3000,16000,-13000,0,0,0,0,0,0,-13000
20200528,6123,上奇,42.00,42.35,41.90,42.00,0.00,0.0,162000,111,6819800,21000,3000,18000,0,0,0,0,0,0,18000
20200528,6124,業強,30.20,30.20,29.25,29.30,-0.20,-0.68,34000,34,1010350,2000,7000,-5000,0,0,0,0,0,0,-5000
20200528,6125,廣運,17.15,17.25,16.90,16.90,-0.25,-1.46,1925000,834,32790100,36000,57000,-21000,0,0,0,0,0,0,-21000
20200528,6126,信音,16.25,16.65,15.85,16.05,+0.05,0.31,1983000,735,32265500,170000,100000,70000,0,0,0,0,0,0,70000
20200528,6127,九豪,17.50,17.75,16.90,16.90,-0.50,-2.87,2968000,1215,51726150,66000,262000,-196000,0,0,0,0,0,0,-196000
20200528,6129,普誠,5.99,6.03,5.92,5.98,+0.08,1.36,191000,80,1140260,0,22000,-22000,0,0,0,0,0,0,-22000
20200528,6130,星寶國際,27.35,27.50,27.25,27.50,+0.20,0.73,15000,15,409600,0,0,0,0,0,0,0,0,0,0
20200528,6134,萬旭,6.92,6.92,6.82,6.91,-0.01,-0.14,28000,11,192590,0,0,0,0,0,0,0,0,0,0
20200528,6138,茂達,78.50,80.90,77.20,77.60,+0.70,0.91,4312000,2931,341172600,283000,391130,-108130,400000,0,400000,68000,27000,41000,332870
20200528,6140,訊達,10.50,10.80,10.45,10.50,-0.15,-1.41,10000,9,105750,0,0,0,0,0,0,0,0,0,0
20200528,6143,振曜,37.95,37.95,37.10,37.30,-0.50,-1.32,184000,120,6926200,0,14000,-14000,0,0,0,0,0,0,-14000
20200528,6144,得利影,6.58,6.58,6.30,6.50,+0.11,1.72,4000,4,25910,0,0,0,0,0,0,0,0,0,0
20200528,6146,耕興,198.00,200.50,197.50,198.50,+0.50,0.25,155000,114,30828000,114000,87000,27000,0,0,0,0,0,0,27000
20200528,6147,頎邦,61.90,62.10,60.80,60.90,-0.50,-0.81,8218000,4762,504978500,535000,553000,-18000,0,0,0,7000,32000,-25000,-43000
20200528,6148,驊宏資,10.30,10.30,10.15,10.30,+0.05,0.49,29000,16,296800,0,0,0,0,0,0,0,0,0,0
20200528,6150,撼訊,50.00,50.00,48.10,48.30,-0.25,-0.51,611000,436,30080950,9000,62000,-53000,0,0,0,0,0,0,-53000
20200528,6151,晉倫,20.50,20.50,20.20,20.35,-0.10,-0.49,82000,32,1671500,0,2000,-2000,0,0,0,0,0,0,-2000
20200528,6154,順發,12.35,12.35,12.20,12.30,-0.05,-0.4,30000,22,368650,0,0,0,0,0,0,0,0,0,0
20200528,6156,松上,11.35,11.50,11.30,11.45,+0.15,1.33,528000,101,5996350,8000,79000,-71000,0,0,0,0,0,0,-71000
20200528,6158,禾昌,22.65,22.65,22.40,22.40,-0.20,-0.88,71000,31,1596500,0,2000,-2000,0,0,0,0,0,0,-2000
20200528,6160,欣技,12.25,12.30,12.15,12.15,-0.15,-1.22,38000,25,463350,1000,1000,0,0,0,0,0,0,0,0
20200528,6161,捷波,20.00,20.40,19.00,19.00,-1.00,-5.0,3467000,1563,68717350,33000,41000,-8000,0,0,0,0,0,0,-8000
20200528,6163,華電網,17.20,17.35,16.05,16.15,-0.60,-3.58,3866000,1624,64437800,64000,175000,-111000,0,0,0,0,0,0,-111000
20200528,6167,久正,6.66,6.72,6.62,6.62,-0.05,-0.75,103000,39,685030,0,0,0,0,0,0,0,0,0,0
20200528,6169,昱泉,31.70,34.50,31.70,34.50,+3.10,9.87,269000,159,9167800,8000,4000,4000,0,0,0,0,4000,-4000,0
20200528,6170,統振,17.30,17.85,17.00,17.10,+0.05,0.29,5633000,1579,98466750,126000,280000,-154000,0,0,0,0,0,0,-154000
20200528,6171,亞銳士,21.90,21.95,21.70,21.75,-0.05,-0.23,35000,23,762100,0,5000,-5000,0,0,0,0,0,0,-5000
20200528,6173,信昌電,56.00,56.10,54.30,54.30,-1.20,-2.16,1112000,796,61297400,54000,82000,-28000,0,0,0,9000,27000,-18000,-46000
20200528,6174,安碁,10.40,10.40,10.25,10.30,-0.05,-0.48,45000,24,464500,0,0,0,0,0,0,0,0,0,0
20200528,6175,立敦,18.25,18.30,17.80,17.85,-0.20,-1.11,137000,91,2469300,2000,18000,-16000,0,0,0,0,0,0,-16000
20200528,6179,亞通,33.50,35.65,33.45,34.10,+0.95,2.87,925000,599,31941050,18000,19000,-1000,0,0,0,0,0,0,-1000
20200528,6180,橘子,62.00,65.00,61.70,61.80,+0.30,0.49,9015000,6282,570700200,403000,418500,-15500,0,0,0,65000,61000,4000,-11500
20200528,6182,合晶,33.50,33.85,33.10,33.10,-0.10,-0.3,3750000,2067,125302550,385000,94097,290903,0,0,0,20000,200000,-180000,110903
20200528,6185,幃翔,16.80,17.00,16.35,16.35,-0.35,-2.1,920000,380,15348550,8000,68000,-60000,0,0,0,2000,9000,-7000,-67000
20200528,6186,新潤,30.15,30.15,29.75,29.80,-0.35,-1.16,593000,327,17756700,14000,127000,-113000,0,0,0,0,0,0,-113000
20200528,6187,萬潤,44.00,45.60,43.30,43.40,-0.25,-0.57,1199000,696,53341500,88000,145000,-57000,0,106,-106,0,10000,-10000,-67106
20200528,6188,廣明,35.15,35.45,34.50,34.50,-0.55,-1.57,1966000,1144,68594500,147000,187000,-40000,0,0,0,6000,3000,3000,-37000
20200528,6190,萬泰科,15.80,15.85,15.65,15.70,0.00,0.0,791000,228,12424950,76000,23000,53000,0,0,0,0,0,0,53000
20200528,6194,育富,23.85,23.85,23.50,23.70,-0.05,-0.21,151000,44,3560400,0,4000,-4000,0,0,0,0,0,0,-4000
20200528,6195,詩肯,34.00,34.05,33.85,34.00,+0.15,0.44,28000,20,950500,0,0,0,0,0,0,0,0,0,0
20200528,6198,凌泰,11.10,11.45,11.10,11.45,-0.20,-1.72,3000,3,33650,0,0,0,0,0,0,0,0,0,0
20200528,6199,天品,,,,,,0.00,0,0,0,0,0,0,0,0,0,0,0,0,0
20200528,006201,元大富櫃50,13.54,13.62,13.43,13.43,-0.06,-0.44,115000,40,1555610,0,0,0,0,15000,-15000,78000,0,78000,63000
20200528,6203,海韻電,59.80,60.30,56.80,57.90,-1.60,-2.69,2266000,1536,132378300,76000,236000,-160000,0,0,0,16000,3000,13000,-147000
20200528,6204,艾華,26.20,26.25,25.30,25.30,-0.15,-0.59,127000,43,3250150,22000,42000,-20000,0,0,0,0,0,0,-20000
20200528,6207,雷科,23.20,23.65,23.20,23.65,+0.45,1.94,218000,138,5126700,6000,4000,2000,0,0,0,0,0,0,2000
20200528,6208,日揚,25.95,26.05,25.65,25.70,-0.15,-0.58,244000,151,6294800,5000,10000,-5000,0,0,0,0,0,0,-5000
20200528,6210,慶生,45.30,45.30,44.65,44.90,-0.25,-0.55,272000,173,12243800,19000,28000,-9000,0,0,0,0,0,0,-9000
20200528,6212,理銘,,,,,,0.00,0,0,0,0,0,0,0,0,0,0,0,0,0
20200528,6217,中探針,32.45,32.50,31.70,31.70,-0.35,-1.09,288000,193,9232700,22000,21000,1000,0,0,0,0,0,0,1000
20200528,6218,豪勉,19.90,20.00,19.75,19.95,+0.10,0.5,35000,20,697250,0,0,0,0,0,0,0,0,0,0
20200528,6219,富旺,13.05,13.20,12.90,13.10,+0.10,0.77,1324000,289,17233600,8000,142000,-134000,0,0,0,0,0,0,-134000
20200528,6220,岳豐,18.80,18.85,18.65,18.70,+0.10,0.54,119000,85,2227500,1000,13000,-12000,0,0,0,0,4000,-4000,-16000
20200528,6221,晉泰,61.00,61.70,60.50,60.50,-0.20,-0.33,134000,93,8177200,35000,0,35000,0,5000,-5000,0,0,0,30000
20200528,6222,上揚,11.80,11.85,11.50,11.50,-0.65,-5.35,11000,5,128650,0,0,0,0,0,0,0,0,0,0
20200528,6223,旺矽,80.30,81.30,78.40,78.90,-0.90,-1.13,1858000,1267,148242300,578000,144000,434000,0,0,0,49000,70000,-21000,413000
20200528,6227,茂綸,21.25,21.55,20.85,20.85,-0.25,-1.18,193000,130,4087800,7000,10000,-3000,0,0,0,0,0,0,-3000
20200528,6228,全譜,5.81,6.06,5.80,5.82,+0.01,0.17,18000,13,105450,0,0,0,0,0,0,0,0,0,0
20200528,6229,研通,12.95,12.95,12.85,12.95,+0.10,0.78,18000,10,232450,0,0,0,0,0,0,0,0,0,0
20200528,6231,系微,71.60,77.10,71.50,77.10,+7.00,9.99,5756000,3941,430941400,682000,150000,532000,0,0,0,0,19000,-19000,513000
20200528,6233,旺玖,11.05,11.15,10.35,10.40,-0.50,-4.59,898000,384,9652350,68000,106000,-38000,0,0,0,0,0,0,-38000
20200528,6234,高僑,26.95,26.95,26.40,26.40,-0.25,-0.94,263000,181,6999150,1000,28000,-27000,0,0,0,0,0,0,-27000
20200528,6236,康呈,,,,,,0.00,0,0,0,0,0,0,0,0,0,0,0,0,0
20200528,6237,驊訊,23.50,23.75,22.25,23.40,+0.55,2.41,1612000,926,37333150,421000,37000,384000,0,0,0,0,14000,-14000,370000
20200528,6238,勝麗,170.50,171.00,166.50,166.50,-2.50,-1.48,250000,208,42066000,5000,40000,-35000,0,0,0,1000,10000,-9000,-44000
20200528,6240,松崗,12.50,12.50,12.30,12.30,-0.20,-1.6,4000,4,49450,0,0,0,0,0,0,0,0,0,0
20200528,6241,易通展,10.15,10.20,10.05,10.05,+0.17,1.72,11000,11,111750,0,0,0,0,0,0,0,0,0,0
20200528,6242,立康,35.00,35.00,34.60,34.60,-1.20,-3.35,9000,9,312650,0,0,0,0,0,0,0,0,0,0
20200528,6244,茂迪,7.10,7.13,6.91,6.91,0.00,0.0,1692000,521,11811900,52000,87000,-35000,0,0,0,0,0,0,-35000
20200528,6245,立端,57.50,57.70,56.10,56.80,-0.10,-0.18,298000,229,16947000,30000,45000,-15000,0,0,0,0,4000,-4000,-19000
20200528,6246,臺龍,7.25,7.36,7.25,7.30,0.00,0.0,12000,9,87290,0,0,0,0,0,0,0,0,0,0
20200528,6247,淇譽電,9.50,9.50,9.21,9.21,-0.29,-3.05,7000,7,65410,0,0,0,0,0,0,0,0,0,0
20200528,6248,沛波,27.70,27.85,27.45,27.45,-0.30,-1.08,25000,17,693700,0,0,0,0,0,0,0,0,0,0
20200528,6259,百徽,1.90,1.90,1.90,1.90,-0.03,-1.55,33000,9,62700,0,0,0,0,0,0,0,0,0,0
20200528,6261,久元,63.90,68.30,62.70,63.00,+0.20,0.32,10961000,7494,712871700,755000,704000,51000,0,0,0,127000,110000,17000,68000
20200528,6263,普萊德,65.00,65.10,64.60,64.60,-0.20,-0.31,61000,48,3948600,0,4000,-4000,0,0,0,0,0,0,-4000
20200528,6264,富裔,5.74,5.80,5.59,5.60,-0.32,-5.41,34000,18,192430,0,0,0,0,0,0,0,0,0,0
20200528,6265,方土昶,5.84,5.89,5.75,5.80,-0.01,-0.17,122000,52,707670,0,1000,-1000,0,0,0,0,0,0,-1000
20200528,6266,泰詠,21.10,21.10,20.80,20.80,-0.10,-0.48,324000,179,6782700,17000,16000,1000,0,0,0,0,0,0,1000
20200528,6270,倍微,18.25,18.65,18.05,18.30,-0.05,-0.27,805000,359,14743950,1000,34000,-33000,0,0,0,0,0,0,-33000
20200528,6274,台燿,139.00,140.50,137.50,140.50,+2.50,1.81,2702000,1706,377113000,1334000,669000,665000,216000,30000,186000,17000,38000,-21000,830000
20200528,6275,元山,17.15,17.15,16.65,17.00,-0.15,-0.87,402000,185,6788300,11000,25000,-14000,0,0,0,0,8000,-8000,-22000
20200528,6276,安鈦克,23.60,23.60,20.50,20.50,-2.25,-9.89,2852000,1660,62465550,66000,127000,-61000,0,0,0,53000,0,53000,-8000
20200528,6279,胡連,84.80,85.60,83.00,83.10,-1.10,-1.31,758000,584,63805400,73000,73000,0,0,40000,-40000,10000,10000,0,-40000
20200528,6284,佳邦,31.00,31.00,30.45,30.60,-0.05,-0.16,395000,212,12125200,10000,61000,-51000,0,0,0,0,6000,-6000,-57000
20200528,6287,元隆,2.00,2.00,2.00,2.00,0.00,0.0,50000,3,100000,0,0,0,0,0,0,0,0,0,0
20200528,6290,良維,62.50,62.50,60.10,60.10,-1.30,-2.12,1491000,931,91332700,166000,154000,12000,0,0,0,9000,27000,-18000,-6000
20200528,6291,沛亨,,,,,,0.00,0,0,0,0,0,0,0,0,0,0,0,0,0
20200528,6292,迅德,36.10,36.35,36.10,36.20,0.00,0.0,76000,59,2749250,1000,9000,-8000,0,0,0,0,0,0,-8000
20200528,6294,智基,109.50,109.50,108.50,108.50,-0.50,-0.46,21000,16,2285500,0,0,0,0,0,0,0,0,0,0
20200528,6404,通訊-KY,3.50,3.50,3.07,3.30,-0.10,-2.94,45000,12,141480,0,0,0,0,0,0,0,0,0,0
20200528,6411,晶焱,84.50,84.70,83.10,83.70,-0.40,-0.48,519000,411,43596100,36000,65000,-29000,0,50000,-50000,2000,1000,1000,-78000
20200528,6417,韋僑,53.80,54.40,53.00,54.40,0.00,0.0,7000,7,376900,0,0,0,0,0,0,0,0,0,0
20200528,6418,詠昇,13.60,13.60,13.50,13.55,-0.15,-1.09,15000,6,203500,0,0,0,0,0,0,0,0,0,0
20200528,6419,京晨科,13.05,13.20,12.60,13.00,+0.35,2.77,4000,4,51850,0,0,0,0,0,0,0,0,0,0
20200528,6425,易發,25.80,25.95,25.50,25.80,-0.10,-0.39,74000,27,1902600,0,0,0,0,0,0,0,0,0,0
20200528,6426,統新,131.50,133.00,128.50,129.00,-0.50,-0.39,1183000,978,154346000,132000,58000,74000,0,10000,-10000,47000,10000,37000,101000
20200528,6432,今展科,29.50,29.50,28.85,29.00,-0.10,-0.34,116000,78,3378650,2000,22000,-20000,0,0,0,0,0,0,-20000
20200528,6435,大中,93.20,93.50,91.50,91.50,-0.90,-0.97,146000,141,13499400,9000,6000,3000,0,0,0,0,2000,-2000,1000
20200528,6438,迅得,63.20,64.10,59.90,60.70,-2.30,-3.65,1485000,1007,92067100,84000,124000,-40000,0,0,0,13000,100195,-87195,-127195
20200528,6441,廣錠,85.40,85.50,81.30,81.30,-2.80,-3.33,1224000,946,102050800,35000,16000,19000,0,0,0,0,0,0,19000
20200528,6446,藥華藥,111.00,113.00,109.50,112.00,+2.00,1.82,378000,287,42048500,51000,25000,26000,0,0,0,0,0,0,26000
20200528,6457,紘康,67.60,72.80,67.20,72.80,+6.60,9.97,3225000,2188,228071900,88000,349000,-261000,0,0,0,0,6000,-6000,-267000
20200528,6461,益得,19.15,19.55,18.60,18.70,-0.35,-1.84,300000,161,5702600,12000,5000,7000,0,0,0,0,0,0,7000
20200528,6462,神盾,193.00,193.00,185.00,186.00,-4.00,-2.11,2824000,2274,532645000,273000,337000,-64000,0,0,0,8000,43000,-35000,-99000
20200528,6465,威潤,37.60,37.80,37.10,37.10,-0.90,-2.37,37000,34,1386850,0,0,0,0,0,0,0,0,0,0
20200528,6469,大樹,85.00,85.00,83.50,83.90,-0.60,-0.71,90000,63,7563500,1000,27000,-26000,0,0,0,0,0,0,-26000
20200528,6470,宇智,41.00,41.00,40.50,40.70,-0.20,-0.49,122000,86,4968700,0,7000,-7000,0,0,0,0,0,0,-7000
20200528,6472,保瑞,147.00,148.50,147.00,147.50,-1.00,-0.67,180000,146,26585000,29000,48000,-19000,0,0,0,0,3000,-3000,-22000
20200528,6482,弘煜科,28.70,28.70,28.05,28.60,0.00,0.0,8000,6,227350,0,0,0,0,0,0,0,0,0,0
20200528,6485,點序,25.55,25.60,24.95,25.15,-0.30,-1.18,80000,53,2020500,2000,7000,-5000,0,0,0,0,0,0,-5000
20200528,6486,互動,75.00,75.40,74.50,74.60,-0.20,-0.27,201000,163,15072500,25000,14000,11000,0,0,0,0,0,0,11000
20200528,6488,環球晶,364.50,370.00,363.00,367.00,+5.50,1.52,2851000,2308,1045260000,689698,478700,210998,62000,151000,-89000,76000,29000,47000,168998
20200528,6492,生華科,123.00,133.50,121.50,133.50,+12.00,9.88,1708000,1036,221737500,38000,60000,-22000,0,0,0,0,3000,-3000,-25000
20200528,6494,九齊,33.25,33.35,33.10,33.10,0.00,0.0,125000,85,4149400,11000,10999,1,0,0,0,0,0,0,1
20200528,6496,科懋,30.95,30.95,30.25,30.25,-0.70,-2.26,61000,50,1867850,1000,5000,-4000,0,0,0,0,0,0,-4000
20200528,6497,亞獅康-KY,4.32,4.40,4.32,4.40,+0.08,1.85,24000,10,104280,0,0,0,0,0,0,0,0,0,0
20200528,6499,益安,53.00,53.60,53.00,53.50,-0.50,-0.93,86000,50,4593900,0,3000,-3000,0,0,0,0,0,0,-3000
20200528,6506,雙邦,18.10,18.10,17.85,17.85,-0.25,-1.38,68000,35,1218800,0,10000,-10000,0,0,0,0,0,0,-10000
20200528,6508,惠光,32.95,33.80,32.95,33.25,+0.30,0.91,356000,193,11910750,7000,4000,3000,0,0,0,26000,0,26000,29000
20200528,6509,聚和,20.70,20.95,20.05,20.10,-0.30,-1.47,2734000,1107,55629450,272000,109000,163000,0,0,0,0,12000,-12000,151000
20200528,6510,精測,620.00,623.00,602.00,602.00,-13.00,-2.11,804000,769,491226000,23000,131000,-108000,0,35000,-35000,5000,10000,-5000,-148000
20200528,6512,啟發電,13.80,13.80,13.65,13.70,-0.10,-0.72,52000,38,713650,0,0,0,0,0,0,0,0,0,0
20200528,6514,芮特-KY,63.90,64.90,62.10,63.00,-0.60,-0.94,141000,118,8946700,8000,16000,-8000,0,0,0,0,0,0,-8000
20200528,6516,勤崴國際,81.50,83.30,81.50,82.40,+0.90,1.1,8000,8,660500,0,0,0,0,0,0,0,0,0,0
20200528,6523,達爾膚,63.80,64.40,63.10,63.10,-0.70,-1.1,186000,165,11847700,29000,11000,18000,0,0,0,0,0,0,18000
20200528,6527,明達醫,55.60,56.20,55.00,55.30,-1.00,-1.78,124000,111,6864200,3000,17000,-14000,0,0,0,0,0,0,-14000
20200528,6530,創威,17.55,17.70,17.10,17.50,+0.10,0.57,53000,36,922200,0,0,0,0,0,0,0,0,0,0
20200528,6532,瑞耘,88.00,89.60,77.60,79.00,-6.50,-7.6,6846000,5017,561834000,630000,275000,355000,10000,0,10000,77000,2000,75000,440000
20200528,6535,順藥,33.00,33.75,31.30,31.85,-1.05,-3.19,318000,237,10247650,11000,10000,1000,0,0,0,0,0,0,1000
20200528,6538,倉和,294.00,296.50,281.00,281.50,-8.50,-2.93,3007000,2486,867120500,65000,99000,-34000,0,69000,-69000,1000,0,1000,-102000
20200528,6542,隆中,59.10,59.10,59.00,59.00,0.00,0.0,11000,8,649300,0,1000,-1000,0,0,0,0,0,0,-1000
20200528,6547,高端疫苗,93.00,101.50,91.20,98.00,0.00,0.0,9177000,6406,887481600,681000,477000,204000,0,0,0,10000,0,10000,214000
20200528,6548,長科*,31.30,31.60,30.50,30.90,-0.30,-0.96,810000,446,24899050,13000,79000,-66000,0,0,0,0,0,0,-66000
20200528,6556,勝品,45.50,45.50,45.50,45.50,-0.20,-0.44,7000,4,318500,0,0,0,0,0,0,0,0,0,0
20200528,6560,欣普羅,31.80,31.80,30.60,30.60,-0.80,-2.55,14000,13,434450,0,0,0,0,0,0,0,0,0,0
20200528,6561,是方,382.00,386.00,370.50,383.50,+4.50,1.19,507000,456,190829500,85000,81000,4000,0,5000,-5000,24000,23000,1000,0
20200528,6568,宏觀,124.00,128.50,122.50,128.00,+6.50,5.35,262000,202,33011000,16000,10000,6000,58000,67000,-9000,0,0,0,-3000
20200528,6569,醫揚,170.00,171.00,170.00,170.00,0.00,0.0,11000,10,1874000,0,2000,-2000,0,0,0,0,0,0,-2000
20200528,6570,維田,37.50,38.30,37.00,37.00,+0.45,1.23,8000,8,298000,0,0,0,0,0,0,0,0,0,0
20200528,6574,霈方,57.30,57.40,55.50,56.90,+0.60,1.07,8000,8,450800,0,0,0,0,0,0,0,0,0,0
20200528,6576,逸達,55.50,57.40,55.30,56.50,+1.20,2.17,333000,232,18760000,27000,41000,-14000,0,0,0,0,0,0,-14000
20200528,6577,勁豐,73.90,74.20,73.60,74.00,+0.60,0.82,61000,47,4513300,5000,0,5000,0,0,0,0,0,0,5000
20200528,6578,達邦蛋白,20.65,20.80,20.55,20.65,0.00,0.0,23000,19,476300,0,0,0,0,0,0,0,0,0,0
20200528,6589,台康生技,57.00,60.90,54.80,57.70,-1.40,-2.37,7872000,4791,455449400,1043000,632000,411000,0,0,0,0,18000,-18000,393000
20200528,6590,普鴻,45.00,49.80,43.30,47.55,+2.25,4.97,360000,278,16792650,8000,0,8000,0,0,0,6000,0,6000,14000
20200528,6593,台灣銘板,,,,,,0.00,0,0,0,0,0,0,0,0,0,0,0,0,0
20200528,6594,展匯科,26.20,27.40,25.60,26.05,-2.30,-8.11,210000,147,5521650,2000,0,2000,0,0,0,0,0,0,2000
20200528,6596,寬宏藝術,59.00,59.00,57.50,57.70,-1.80,-3.03,144000,134,8346600,0,18000,-18000,0,0,0,0,0,0,-18000
20200528,6603,富強鑫,9.19,9.19,9.10,9.17,+0.04,0.44,18000,11,164550,0,0,0,0,0,0,0,0,0,0
20200528,6609,瀧澤科,26.45,26.65,26.10,26.30,+0.15,0.57,103000,70,2720650,0,8000,-8000,0,0,0,0,0,0,-8000
20200528,6612,奈米醫材,77.30,78.20,76.30,76.80,-0.50,-0.65,81000,74,6259800,9000,8000,1000,0,0,0,0,0,0,1000
20200528,6613,朋億,152.00,152.00,151.00,151.00,-1.00,-0.66,54000,48,8196500,1000,1000,0,0,0,0,0,0,0,0
20200528,6615,慧智,71.50,71.50,68.00,70.00,0.00,0.0,65000,62,4555500,0,1000,-1000,0,0,0,0,1000,-1000,-2000
20200528,6616,特昇-KY,26.25,26.55,25.30,25.85,-0.50,-1.9,31000,29,803600,2000,0,2000,0,0,0,0,0,0,2000
20200528,6624,萬年清,39.00,39.60,39.00,39.60,+0.20,0.51,3000,3,118100,0,0,0,0,0,0,0,0,0,0
20200528,6629,泰金-KY,51.20,51.80,50.20,51.30,0.00,0.0,29000,26,1477300,5000,0,5000,0,0,0,0,0,0,5000
20200528,6640,均華,47.30,48.00,47.00,47.95,+0.05,0.1,39000,26,1842650,0,0,0,0,0,0,0,0,0,0
20200528,6642,富致,36.30,38.30,36.30,36.75,+1.80,5.15,158000,136,5862800,4000,0,4000,0,0,0,0,0,0,4000
20200528,6643,M31,316.50,318.00,298.50,303.00,-12.00,-3.81,1307000,1183,402802500,51000,162000,-111000,28000,0,28000,4000,64000,-60000,-143000
20200528,6649,台生材,30.60,31.10,30.00,30.50,-1.30,-4.09,44000,40,1348950,3000,0,3000,0,0,0,0,0,0,3000
20200528,6654,天正國際,50.90,50.90,50.20,50.20,-0.70,-1.38,37000,29,1863100,0,0,0,0,0,0,0,0,0,0
20200528,6662,樂斯科,46.90,46.90,45.00,45.20,-0.80,-1.74,79000,67,3618200,0,2000,-2000,0,0,0,0,0,0,-2000
20200528,6664,群翊,67.50,67.50,63.30,63.30,-2.60,-3.95,682000,514,44355500,1000,92000,-91000,0,0,0,0,0,0,-91000
20200528,6667,信紘科,68.30,69.60,67.50,67.50,-0.80,-1.17,220000,187,14989500,2000,24000,-22000,0,0,0,0,0,0,-22000
20200528,6679,鈺太,158.50,159.00,149.00,149.00,-7.50,-4.79,1685000,1410,256943000,86000,631736,-545736,0,0,0,9000,71000,-62000,-607736
20200528,6680,鑫創電子,63.50,63.50,63.10,63.10,-0.70,-1.1,7000,3,442100,0,0,0,0,0,0,0,0,0,0
20200528,6683,雍智科技,241.50,243.00,230.00,230.50,-9.00,-3.76,1174000,1077,276385000,81000,27000,54000,12000,0,12000,14000,22000,-8000,58000
20200528,6690,安碁資訊,129.50,130.00,128.00,129.00,+0.50,0.39,57000,45,7336000,23000,4000,19000,0,5000,-5000,0,0,0,14000
20200528,6697,東捷資訊,46.00,47.80,44.30,45.60,-0.40,-0.87,203000,171,9340100,12000,10000,2000,0,0,0,0,0,0,2000
20200528,6716,應廣,76.80,76.90,72.40,73.20,-4.30,-5.55,322000,278,24150400,2000,13000,-11000,0,0,0,0,0,0,-11000
20200528,6803,崑鼎,214.50,214.50,213.00,213.50,-1.50,-0.7,44000,33,9398000,0,1000,-1000,0,0,0,0,0,0,-1000
20200528,7402,邑錡,36.40,36.90,35.30,36.90,-0.10,-0.27,7000,5,250000,0,0,0,0,0,0,0,0,0,0
20200528,8024,佑華,9.14,9.34,8.96,9.11,+0.08,0.89,202000,66,1830650,0,0,0,0,0,0,0,0,0,0
20200528,8027,鈦昇,32.60,33.45,32.60,32.80,-0.25,-0.76,178000,80,5872450,4000,14000,-10000,0,0,0,0,0,0,-10000
20200528,8032,光菱,23.40,23.60,22.50,22.80,-0.05,-0.22,25000,21,571500,0,0,0,0,0,0,0,0,0,0
20200528,8034,榮群,32.10,32.10,32.10,32.10,-3.55,-9.96,1580000,533,50718000,0,1000,-1000,0,0,0,0,0,0,-1000
20200528,8038,長園科,32.40,32.60,31.80,31.80,-0.55,-1.7,139000,97,4492100,7000,14000,-7000,0,0,0,0,0,0,-7000
20200528,8040,九暘,16.45,16.80,16.35,16.40,+0.05,0.31,815000,368,13495050,198000,71000,127000,0,0,0,0,0,0,127000
20200528,8042,金山電,33.15,33.50,33.05,33.20,+0.10,0.3,172000,99,5733650,2000,2000,0,0,0,0,0,0,0,0
20200528,8043,蜜望實,26.40,26.40,25.65,25.65,-0.40,-1.54,143000,123,3714300,6000,34000,-28000,0,0,0,0,0,0,-28000
20200528,8044,網家,117.50,118.50,111.50,111.50,-4.50,-3.88,1712000,1249,197458500,98000,107000,-9000,0,0,0,20000,80000,-60000,-69000
20200528,8047,星雲,,,,,,0.00,0,0,0,0,0,0,0,0,0,0,0,0,0
20200528,8048,德勝,32.00,32.00,31.70,31.90,-0.10,-0.31,50000,35,1595250,0,5000,-5000,0,0,0,0,0,0,-5000
20200528,8049,晶采,22.10,22.10,21.90,21.90,-0.15,-0.68,461000,219,10124800,16000,21000,-5000,0,0,0,0,0,0,-5000
20200528,8050,廣積,39.30,40.00,39.30,39.45,+0.40,1.02,259000,199,10260900,12000,27000,-15000,0,0,0,0,0,0,-15000
20200528,8054,安國,12.85,12.85,12.50,12.55,-0.20,-1.57,153000,48,1929850,0,19000,-19000,0,0,0,0,0,0,-19000
20200528,8059,凱碩,13.95,14.20,13.35,13.65,-0.40,-2.85,498000,210,6850550,0,73000,-73000,0,0,0,9000,0,9000,-64000
20200528,8064,東捷,14.40,14.45,14.25,14.25,-0.10,-0.7,402000,171,5775800,13000,19000,-6000,0,0,0,0,0,0,-6000
20200528,8066,來思達,64.80,65.20,63.60,63.80,-0.50,-0.78,148000,69,9568900,19000,13000,6000,0,0,0,0,0,0,6000
20200528,8067,志旭,7.19,7.28,7.19,7.28,+0.08,1.11,2000,2,14470,0,0,0,0,0,0,0,0,0,0
20200528,8068,全達,23.45,23.85,23.00,23.25,+0.55,2.42,28000,23,654600,0,0,0,0,0,0,0,0,0,0
20200528,8069,元太,41.60,42.30,40.50,40.55,-1.05,-2.52,23868000,10092,987141950,4388000,3018000,1370000,351000,0,351000,585000,450000,135000,1856000
20200528,8071,能率網通,12.60,12.65,12.20,12.25,-0.05,-0.41,102000,61,1267000,0,11000,-11000,0,0,0,0,0,0,-11000
20200528,8074,鉅橡,16.90,16.90,16.80,16.80,-0.10,-0.59,189000,49,3178200,0,0,0,0,0,0,0,0,0,0
20200528,8076,伍豐,31.15,31.40,29.15,30.00,-0.70,-2.28,5065000,2851,153190850,47000,410000,-363000,0,0,0,13000,9000,4000,-359000
20200528,8077,洛碁,11.25,11.40,10.70,10.70,-0.55,-4.89,88000,61,979000,0,4000,-4000,0,0,0,0,0,0,-4000
20200528,8080,永利聯合,2.78,2.99,2.78,2.99,+0.14,4.91,26000,10,76200,0,0,0,0,0,0,0,0,0,0
20200528,8083,瑞穎,167.50,168.00,163.00,164.00,-2.50,-1.5,164000,125,26973000,2000,10000,-8000,0,0,0,2000,0,2000,-6000
20200528,8084,巨虹,42.00,42.00,41.00,41.00,-1.15,-2.73,72000,38,2961550,0,0,0,0,0,0,0,0,0,0
20200528,8085,福華,3.84,3.84,3.70,3.70,-0.05,-1.33,124000,42,464430,0,1000,-1000,0,0,0,0,0,0,-1000
20200528,8086,宏捷科,89.50,90.00,87.80,87.80,-1.00,-1.13,3295000,2212,292620600,136000,395559,-259559,0,0,0,4000,114000,-110000,-369559
20200528,8087,華鎂鑫,6.13,6.13,6.05,6.05,-0.23,-3.66,13000,7,79130,0,0,0,0,0,0,0,0,0,0
20200528,8088,品安,30.10,30.30,29.10,29.10,-0.70,-2.35,1984000,1063,59129650,244000,133000,111000,0,0,0,4000,0,4000,115000
20200528,8091,翔名,58.40,58.90,57.60,58.20,-0.30,-0.51,113000,95,6575100,0,11000,-11000,0,0,0,0,0,0,-11000
20200528,8092,建暐,7.85,7.85,7.51,7.65,+0.15,2.0,26000,10,199660,0,0,0,0,0,0,0,0,0,0
20200528,8093,保銳,5.40,5.40,5.00,5.14,-0.16,-3.02,313000,98,1609990,0,14000,-14000,0,0,0,0,0,0,-14000
20200528,8096,擎亞,12.45,12.60,12.30,12.60,+0.35,2.86,3514000,1147,43851450,267000,105000,162000,0,0,0,0,0,0,162000
20200528,8097,常珵,12.15,12.20,12.10,12.20,+0.05,0.41,56000,36,680900,0,1000,-1000,0,0,0,0,0,0,-1000
20200528,8099,大世科,17.50,17.50,17.35,17.40,-0.05,-0.29,99000,36,1723750,0,0,0,0,0,0,0,0,0,0
20200528,8107,大億金茂,16.05,16.20,16.05,16.05,0.00,0.0,32000,21,516100,0,0,0,0,0,0,0,0,0,0
20200528,8109,博大,67.90,69.30,67.90,68.60,-0.20,-0.29,31000,29,2123900,0,1000,-1000,0,0,0,0,0,0,-1000
20200528,8111,立碁,10.10,10.10,9.65,9.80,-0.19,-1.9,763000,315,7513410,5000,48000,-43000,0,0,0,0,0,0,-43000
20200528,8121,越峰,11.05,11.05,10.65,10.65,-0.35,-3.18,159000,104,1715800,0,8000,-8000,0,0,0,0,0,0,-8000
20200528,8147,正淩,36.00,36.40,35.65,36.40,+0.75,2.1,144000,103,5172750,8000,2000,6000,0,0,0,0,2000,-2000,4000
20200528,8155,博智,149.00,149.00,144.00,144.00,-2.00,-1.37,1794000,1392,262931500,71000,57000,14000,0,13000,-13000,39000,38000,1000,2000
20200528,8171,天宇,14.90,15.05,14.50,14.50,-0.40,-2.68,1050000,410,15462100,131000,57000,74000,0,0,0,0,0,0,74000
20200528,8176,智捷,8.71,8.73,8.56,8.69,+0.08,0.93,148000,68,1277790,21000,16000,5000,0,0,0,0,0,0,5000
20200528,8182,加高,29.45,29.60,28.85,28.85,-0.25,-0.86,833000,534,24357650,71000,145000,-74000,0,0,0,0,0,0,-74000
20200528,8183,精星,17.70,17.75,17.15,17.15,-0.35,-2.0,617000,345,10715150,9000,129000,-120000,0,0,0,0,0,0,-120000
20200528,8234,新漢,22.60,22.60,22.30,22.40,+0.15,0.67,41000,28,916550,0,7000,-7000,0,0,0,0,0,0,-7000
20200528,8240,華宏,24.55,24.60,24.10,24.30,-0.15,-0.61,108000,56,2644400,0,2000,-2000,0,0,0,0,0,0,-2000
20200528,8255,朋程,84.40,84.80,83.90,84.00,-0.40,-0.47,140000,99,11802300,8000,4000,4000,0,0,0,0,0,0,4000
20200528,8277,商丞,6.25,6.27,6.20,6.20,0.00,0.0,64000,33,398820,0,0,0,0,0,0,0,0,0,0
20200528,8279,生展,107.50,109.50,107.50,109.00,-0.50,-0.46,36000,34,3902500,2000,2000,0,0,0,0,0,0,0,0
20200528,8284,三竹,64.50,64.50,63.50,63.50,-0.80,-1.24,250000,202,15946600,9000,5000,4000,0,0,0,0,0,0,4000
20200528,8289,泰藝,11.55,11.70,11.20,11.25,-0.30,-2.6,268000,122,3058500,6000,25000,-19000,0,0,0,0,0,0,-19000
20200528,8291,尚茂,3.08,3.08,3.00,3.00,0.00,0.0,13000,2,39480,0,0,0,0,0,0,0,0,0,0
20200528,8299,群聯,282.00,283.50,276.50,277.00,-3.00,-1.07,2094000,1641,585866000,471213,631000,-159787,0,20000,-20000,28000,41000,-13000,-192787
20200528,8342,益張,53.60,54.30,53.10,53.60,0.00,0.0,52000,41,2793200,0,0,0,0,0,0,0,0,0,0
20200528,8349,恒耀,43.30,45.70,43.30,44.15,+1.00,2.32,293000,217,13115000,12000,34000,-22000,0,0,0,0,0,0,-22000
20200528,8349A,恒耀甲特,42.00,42.70,41.90,42.65,+0.75,1.79,14000,10,590200,0,0,0,0,0,0,0,0,0,0
20200528,8354,冠好,17.00,17.05,16.95,16.95,-0.10,-0.59,22000,16,373750,0,0,0,0,0,0,0,0,0,0
20200528,8358,金居,41.90,42.10,40.60,40.60,-1.25,-2.99,7109000,4132,293585050,315000,262000,53000,0,0,0,34000,200000,-166000,-113000
20200528,8383,千附,36.70,37.45,36.65,37.10,+0.60,1.64,1275000,760,47302050,0,24000,-24000,0,0,0,0,0,0,-24000
20200528,8390,金益鼎,18.10,18.20,18.00,18.05,+0.05,0.28,162000,90,2934350,14000,6000,8000,0,0,0,0,0,0,8000
20200528,8401,白紗科,11.90,12.00,11.85,11.85,+0.05,0.42,86000,17,1027450,0,0,0,0,0,0,0,0,0,0
20200528,8403,盛弘,42.25,44.75,40.80,42.80,+1.00,2.39,17036000,10236,736287700,500000,1368000,-868000,0,0,0,29000,115000,-86000,-954000
20200528,8406,金可-KY,153.50,156.50,151.00,152.50,+0.50,0.33,313000,250,48160500,12000,89000,-77000,20000,0,20000,21000,38000,-17000,-74000
20200528,8409,商之器,18.60,18.60,17.25,17.50,-0.95,-5.15,90000,65,1604250,2000,0,2000,0,0,0,4000,0,4000,6000
20200528,8410,森田,40.00,41.00,38.60,40.50,+0.70,1.76,1279000,738,51189950,32000,33000,-1000,0,0,0,0,0,0,-1000
20200528,8415,大國鋼,26.45,26.65,26.35,26.40,0.00,0.0,229000,125,6062600,47000,70000,-23000,0,0,0,0,0,0,-23000
20200528,8416,實威,120.00,120.00,118.50,119.50,-0.50,-0.42,11000,10,1311000,0,0,0,0,0,0,0,0,0,0
20200528,8418,捷必勝-KY,13.30,13.90,13.30,13.90,0.00,0.0,28000,14,382400,0,5000,-5000,0,0,0,0,0,0,-5000
20200528,8420,明揚,22.90,22.90,22.75,22.75,-0.15,-0.66,4000,4,91450,0,0,0,0,0,0,0,0,0,0
20200528,8421,旭源,10.45,10.45,10.15,10.15,-0.30,-2.87,117000,60,1200750,0,4000,-4000,0,0,0,0,0,0,-4000
20200528,8423,保綠-KY,,,,,,0.00,0,0,0,0,0,0,0,0,0,0,0,0,0
20200528,8424,惠普,53.00,53.40,53.00,53.30,+0.30,0.57,51000,30,2717200,0,2000,-2000,0,0,0,0,0,0,-2000
20200528,8426,紅木-KY,13.20,13.20,13.00,13.20,+0.20,1.54,11000,9,144250,0,0,0,0,0,0,0,0,0,0
20200528,8431,匯鑽科,51.10,51.60,49.90,50.40,-0.10,-0.2,148000,119,7516050,6000,32000,-26000,0,0,0,0,0,0,-26000
20200528,8432,東生華,68.40,68.90,68.10,68.30,+0.20,0.29,14000,14,958200,0,0,0,0,0,0,0,0,0,0
20200528,8433,弘帆,44.90,44.90,43.50,44.00,-0.45,-1.01,40000,33,1760300,0,6000,-6000,0,0,0,0,0,0,-6000
20200528,8435,鉅邁,50.60,50.60,50.10,50.20,-0.20,-0.4,142000,104,7139900,0,110000,-110000,0,0,0,2000,0,2000,-108000
20200528,8436,大江,255.00,259.00,253.00,257.00,+3.00,1.18,1001000,839,255729000,413200,120346,292854,0,100000,-100000,14000,21000,-7000,185854
20200528,8437,大地-KY,191.50,193.00,189.00,189.50,-1.00,-0.52,74000,59,14090500,0,3000,-3000,0,0,0,0,0,0,-3000
20200528,8440,綠電,12.50,12.70,12.50,12.60,+0.10,0.8,25000,20,316150,1000,0,1000,0,0,0,0,0,0,1000
20200528,8444,綠河-KY,49.00,50.00,49.00,50.00,-0.50,-0.99,13000,12,646000,0,0,0,0,0,0,0,0,0,0
20200528,8446,華研,114.50,115.50,113.00,113.00,-1.00,-0.88,76000,72,8649000,2000,18000,-16000,0,0,0,1000,0,1000,-15000
20200528,8450,霹靂,25.15,26.60,25.10,25.20,+0.05,0.2,101000,73,2591650,0,0,0,0,0,0,0,0,0,0
20200528,8455,大拓-KY,19.60,21.45,19.60,21.45,+1.95,10.0,64000,46,1354950,1000,3000,-2000,0,0,0,0,0,0,-2000
20200528,8472,夠麻吉,30.00,30.50,30.00,30.00,0.00,0.0,13000,13,391600,0,0,0,0,0,0,0,0,0,0
20200528,8476,台境,23.25,23.75,23.10,23.45,+0.20,0.86,63000,41,1470850,0,10000,-10000,0,0,0,0,0,0,-10000
20200528,8477,創業家,49.00,49.30,46.90,48.00,-0.65,-1.34,206000,158,9934050,26000,1000,25000,0,0,0,0,0,0,25000
20200528,8489,三貝德,64.20,68.90,63.90,66.70,+4.00,6.38,1311000,1033,88184000,78000,101000,-23000,0,0,0,13000,28000,-15000,-38000
20200528,8906,花王,14.50,14.50,14.50,14.50,-0.20,-1.36,3000,3,43500,0,0,0,0,0,0,0,0,0,0
20200528,8908,欣雄,46.95,47.00,46.45,46.50,+0.10,0.22,36000,35,1675200,0,0,0,0,0,0,0,0,0,0
20200528,8916,光隆,41.50,42.30,41.50,41.70,+0.30,0.72,264000,205,11031550,21000,5000,16000,0,0,0,0,0,0,16000
20200528,8916A,光隆甲特,52.80,52.80,52.80,52.80,0.00,0.0,2000,2,105600,0,0,0,0,0,0,0,0,0,0
20200528,8917,欣泰,60.00,60.00,60.00,60.00,+0.10,0.17,2000,2,120000,0,0,0,0,0,0,0,0,0,0
20200528,8921,沈氏,,,,,,0.00,0,0,0,0,0,0,0,0,0,0,0,0,0
20200528,8923,時報,15.10,15.10,15.10,15.10,-0.20,-1.31,1000,1,15100,0,0,0,0,0,0,0,0,0,0
20200528,8924,大田,42.00,42.55,41.15,41.30,-0.65,-1.55,703000,521,29484550,60000,59000,1000,0,0,0,0,50000,-50000,-49000
20200528,8927,北基,15.15,15.45,15.15,15.25,0.00,0.0,31000,10,476600,0,0,0,0,0,0,0,0,0,0
20200528,8928,鉅明,27.50,28.20,27.50,27.75,+0.40,1.46,407000,224,11345450,77000,23000,54000,0,0,0,0,0,0,54000
20200528,8929,富堡,28.60,31.20,27.70,28.70,+0.30,1.06,1419000,860,41891950,22000,24000,-2000,0,0,0,0,0,0,-2000
20200528,8930,青鋼,12.00,12.00,11.90,11.90,0.00,0.0,7000,7,83450,0,3000,-3000,0,0,0,0,0,0,-3000
20200528,8931,大汽電,29.95,30.80,29.60,30.05,+0.25,0.84,140000,76,4183100,0,1000,-1000,0,0,0,0,0,0,-1000
20200528,8932,宏大,11.40,11.45,11.15,11.25,-0.40,-3.43,78000,37,878800,0,0,0,0,0,0,0,0,0,0
20200528,8933,愛地雅,9.30,9.34,8.59,8.78,-0.50,-5.39,1995000,796,17676040,43000,57000,-14000,0,0,0,0,4000,-4000,-18000
20200528,8934,衡平,,,,,,0.00,0,0,0,0,0,0,0,0,0,0,0,0,0
20200528,8935,邦泰,8.55,8.60,8.47,8.55,-0.02,-0.23,102000,45,869770,0,0,0,0,0,0,2000,0,2000,2000
20200528,8936,國統,16.80,16.80,16.50,16.60,0.00,0.0,239000,125,3968250,34000,24000,10000,0,0,0,0,0,0,10000
20200528,8937,合騏,14.40,14.65,14.35,14.35,-0.05,-0.35,36000,13,521250,0,1000,-1000,0,0,0,0,0,0,-1000
20200528,8938,明安,33.50,33.90,33.35,33.35,-0.15,-0.45,202000,133,6786000,11000,14000,-3000,0,0,0,0,0,0,-3000
20200528,8941,關中,39.80,39.80,38.45,39.25,-0.05,-0.13,31000,25,1213550,0,0,0,0,0,0,0,0,0,0
20200528,8942,森鉅,54.30,54.40,53.80,53.90,-0.20,-0.37,246000,178,13305600,0,53000,-53000,0,0,0,0,2000,-2000,-55000
20200528,9949,琉園,11.80,11.95,11.80,11.95,-0.05,-0.42,10000,6,118300,0,0,0,0,0,0,0,0,0,0
20200528,9950,萬國通,9.70,9.70,9.30,9.35,-0.42,-4.3,141000,53,1328640,0,10000,-10000,0,0,0,0,0,0,-10000
20200528,9951,皇田,71.80,73.50,71.70,71.90,+1.00,1.41,707000,581,51265100,145000,73000,72000,62000,0,62000,4000,5000,-1000,133000
20200528,9960,邁達康,27.20,27.20,27.20,27.20,+0.05,0.18,1000,1,27200,0,0,0,0,0,0,0,0,0,0
20200528,9962,有益,8.15,8.15,8.14,8.14,+0.04,0.49,2000,2,16290,0,0,0,0,0,0,0,0,0,0
20200528,020001,富邦存股雙十N,4.99,5.01,4.93,4.93,-0.02,-0.4,136000,19,677500,0,0,0,0,0,0,113000,17000,96000,96000
20200528,020003,統一漲升股利150N,,,,,,0.00,0,0,0,0,0,0,0,0,0,0,0,0,0
20200528,020009,群益A50綠碳N,,,,,,0.00,0,0,0,0,0,0,0,0,0,0,0,0,0
20200528,020010,永昌富櫃200N,10.72,10.72,10.62,10.62,-0.13,-1.21,5000,4,53360,0,0,0,0,0,0,2000,3000,-1000,-1000
20200528,020013,元富亞洲高股息N,,,,,,0.00,0,0,0,0,0,0,0,0,0,0,0,0,0
20200528,020014,元大富櫃200N,4.96,4.97,4.91,4.91,-0.01,-0.2,100000,15,492780,0,0,0,0,0,0,42000,58000,-16000,-16000
20200528,72510P,原相群益96售02,,,,,,0.00,0,0,0,0,0,0,0,0,0,0,0,0,0
20200528,72548P,大江統一96售01,,,,,,0.00,0,0,0,0,0,0,0,0,0,0,0,0,0
20200528,72568P,新普群益96售01,,,,,,0.00,0,0,0,0,0,0,0,0,0,0,0,0,0
20200528,72572P,網家元富96售02,,,,,,0.00,0,0,0,0,0,0,0,0,0,0,0,0,0
20200528,72594P,雙鴻國泰96售03,,,,,,0.00,0,0,0,0,0,0,0,0,0,0,0,0,0
20200528,72595P,大江富邦96售01,,,,,,0.00,0,0,0,0,0,0,0,0,0,0,0,0,0
20200528,72611P,雙鴻凱基96售02,,,,,,0.00,0,0,0,0,0,0,0,0,0,0,0,0,0
20200528,72623P,穩懋富邦96售02,,,,,,0.00,0,0,0,0,0,0,0,0,0,0,0,0,0
20200528,72624P,櫃200第一96售02,,,,,,0.00,0,0,0,0,0,0,0,0,0,0,0,0,0
20200528,72655P,穩懋統一96售03,,,,,,0.00,0,0,0,0,0,0,0,0,0,0,0,0,0
20200528,72661P,穩懋中信96售01,0.87,0.87,0.87,0.87,+0.02,2.35,27000,3,23490,0,0,0,0,0,0,0,27000,-27000,-27000
20200528,72662P,穩懋中信98售01,0.80,0.80,0.80,0.80,0.00,0.0,10000,2,8000,0,0,0,0,0,0,7000,3000,4000,4000
20200528,72663P,神盾元富96售01,2.52,2.52,2.52,2.52,-0.01,-0.4,1000,1,2520,0,0,0,0,0,0,1000,0,1000,1000
20200528,72672P,穩懋國票96售01,,,,,,0.00,0,0,0,0,0,0,0,0,0,0,0,0,0
20200528,72673P,穩懋國泰96售01,,,,,,0.00,0,0,0,0,0,0,0,0,0,0,0,0,0
20200528,72674P,環球晶富邦97售02,0.26,0.26,0.26,0.26,-0.02,-7.14,10000,1,2600,0,0,0,0,0,0,10000,0,10000,10000
20200528,72684P,大江國票96售02,,,,,,0.00,0,0,0,0,0,0,0,0,0,0,0,0,0
20200528,72686P,新普群益97售03,,,,,,0.00,0,0,0,0,0,0,0,0,0,0,0,0,0
20200528,72689P,環宇國票96售01,1.71,1.71,1.71,1.71,+0.05,3.01,9000,1,15390,0,0,0,0,0,0,9000,0,9000,9000
20200528,72697P,穩懋亞東96售01,,,,,,0.00,0,0,0,0,0,0,0,0,0,0,0,0,0
20200528,72703P,聯亞群益96售01,,,,,,0.00,0,0,0,0,0,0,0,0,0,0,0,0,0
20200528,72704P,大江國票96售03,,,,,,0.00,0,0,0,0,0,0,0,0,0,0,0,0,0
20200528,72706P,環球晶國泰96售02,,,,,,0.00,0,0,0,0,0,0,0,0,0,0,0,0,0
20200528,72707P,中美晶國票96售02,,,,,,0.00,0,0,0,0,0,0,0,0,0,0,0,0,0
20200528,72711P,櫃200永昌96售05,,,,,,0.00,0,0,0,0,0,0,0,0,0,0,0,0,0
20200528,72713P,櫃200元大96售01,,,,,,0.00,0,0,0,0,0,0,0,0,0,0,0,0,0
20200528,72714P,櫃200元大96售02,,,,,,0.00,0,0,0,0,0,0,0,0,0,0,0,0,0
20200528,72716P,穩懋統一96售04,,,,,,0.00,0,0,0,0,0,0,0,0,0,0,0,0,0
20200528,72719P,原相亞東96售02,,,,,,0.00,0,0,0,0,0,0,0,0,0,0,0,0,0
20200528,72732P,櫃200T永昌96售05,,,,,,0.00,0,0,0,0,0,0,0,0,0,0,0,0,0
20200528,72733P,櫃200凱基96售01,,,,,,0.00,0,0,0,0,0,0,0,0,0,0,0,0,0
20200528,72734P,櫃200凱基96售02,,,,,,0.00,0,0,0,0,0,0,0,0,0,0,0,0,0
20200528,72737P,櫃200富邦9A售03,,,,,,0.00,0,0,0,0,0,0,0,0,0,0,0,0,0
20200528,72738P,櫃200富邦9A售04,,,,,,0.00,0,0,0,0,0,0,0,0,0,0,0,0,0
20200528,72745P,威剛國票96售01,,,,,,0.00,0,0,0,0,0,0,0,0,0,0,0,0,0
20200528,72746P,大江富邦97售02,0.84,0.84,0.81,0.81,-0.04,-4.71,255000,3,209200,0,0,0,0,0,0,245000,10000,235000,235000
20200528,72747P,櫃200T永昌9C售05,,,,,,0.00,0,0,0,0,0,0,0,0,0,0,0,0,0
20200528,72752P,環球晶凱基96售02,,,,,,0.00,0,0,0,0,0,0,0,0,0,0,0,0,0
20200528,72761P,中美晶富邦96售01,,,,,,0.00,0,0,0,0,0,0,0,0,0,0,0,0,0
20200528,72762P,穩懋富邦97售02,0.70,0.70,0.67,0.67,0.00,0.0,70000,3,47850,0,0,0,0,0,0,45000,25000,20000,20000
20200528,72763P,精測中信96售01,,,,,,0.00,0,0,0,0,0,0,0,0,0,0,0,0,0
20200528,72764P,中美晶凱基96售02,,,,,,0.00,0,0,0,0,0,0,0,0,0,0,0,0,0
20200528,72765P,精測國泰97售01,,,,,,0.00,0,0,0,0,0,0,0,0,0,0,0,0,0
20200528,72766P,中美晶富邦97售01,0.22,0.22,0.22,0.22,-0.01,-4.35,20000,1,4400,0,0,0,0,0,0,0,20000,-20000,-20000
20200528,72767P,精測康和96售01,,,,,,0.00,0,0,0,0,0,0,0,0,0,0,0,0,0
20200528,72768P,精測凱基96售02,,,,,,0.00,0,0,0,0,0,0,0,0,0,0,0,0,0
20200528,72769P,雙鴻兆豐97售01,0.45,0.45,0.45,0.45,-0.02,-4.26,10000,1,4500,0,0,0,0,0,0,0,10000,-10000,-10000
20200528,72770P,精測永豐96售03,,,,,,0.00,0,0,0,0,0,0,0,0,0,0,0,0,0
20200528,72771P,鈊象元大96售01,,,,,,0.00,0,0,0,0,0,0,0,0,0,0,0,0,0
20200528,72772P,同致國票97售01,,,,,,0.00,0,0,0,0,0,0,0,0,0,0,0,0,0
20200528,72773P,鈊象國票96售01,0.01,0.01,0.01,0.01,0.00,0.0,124000,5,1240,0,0,0,0,0,0,124000,0,124000,124000
20200528,72774P,精測群益96售02,,,,,,0.00,0,0,0,0,0,0,0,0,0,0,0,0,0
20200528,72775P,精測統一96售02,,,,,,0.00,0,0,0,0,0,0,0,0,0,0,0,0,0
20200528,72776P,精測凱基96售05,,,,,,0.00,0,0,0,0,0,0,0,0,0,0,0,0,0
20200528,72777P,櫃200凱基96售04,,,,,,0.00,0,0,0,0,0,0,0,0,0,0,0,0,0
20200528,72778P,櫃200凱基96售05,,,,,,0.00,0,0,0,0,0,0,0,0,0,0,0,0,0
20200528,72779P,鈊象凱基96售02,,,,,,0.00,0,0,0,0,0,0,0,0,0,0,0,0,0
20200528,72780P,鈊象台新96售01,,,,,,0.00,0,0,0,0,0,0,0,0,0,0,0,0,0
20200528,72781P,鈊象永豐96售02,,,,,,0.00,0,0,0,0,0,0,0,0,0,0,0,0,0
20200528,72782P,鈊象康和96售01,,,,,,0.00,0,0,0,0,0,0,0,0,0,0,0,0,0
20200528,72783P,鈊象群益96售01,,,,,,0.00,0,0,0,0,0,0,0,0,0,0,0,0,0
20200528,72784P,精測統一96售03,,,,,,0.00,0,0,0,0,0,0,0,0,0,0,0,0,0
20200528,72785P,鈊象元富96售02,,,,,,0.00,0,0,0,0,0,0,0,0,0,0,0,0,0
20200528,72786P,聯亞國票97售02,0.44,0.44,0.44,0.44,-0.02,-4.35,8000,1,3520,0,0,0,0,0,0,0,8000,-8000,-8000
20200528,72787P,精測永豐96售05,,,,,,0.00,0,0,0,0,0,0,0,0,0,0,0,0,0
20200528,72788P,群聯群益96售03,,,,,,0.00,0,0,0,0,0,0,0,0,0,0,0,0,0
20200528,72789P,精測群益96售03,,,,,,0.00,0,0,0,0,0,0,0,0,0,0,0,0,0
20200528,72790P,精華群益96售01,,,,,,0.00,0,0,0,0,0,0,0,0,0,0,0,0,0
20200528,72791P,精測凱基96售06,,,,,,0.00,0,0,0,0,0,0,0,0,0,0,0,0,0
20200528,72792P,穩懋國票96售04,,,,,,0.00,0,0,0,0,0,0,0,0,0,0,0,0,0
20200528,72793P,穩懋兆豐96售03,,,,,,0.00,0,0,0,0,0,0,0,0,0,0,0,0,0
20200528,72794P,穩懋兆豐97售01,,,,,,0.00,0,0,0,0,0,0,0,0,0,0,0,0,0
20200528,72795P,鈊象元大96售02,,,,,,0.00,0,0,0,0,0,0,0,0,0,0,0,0,0
20200528,72796P,穩懋統一97售02,,,,,,0.00,0,0,0,0,0,0,0,0,0,0,0,0,0
20200528,72797P,鈊象統一97售01,,,,,,0.00,0,0,0,0,0,0,0,0,0,0,0,0,0
20200528,72798P,穩懋凱基96售08,,,,,,0.00,0,0,0,0,0,0,0,0,0,0,0,0,0
20200528,72799P,世界永豐96售01,,,,,,0.00,0,0,0,0,0,0,0,0,0,0,0,0,0
20200528,72800P,鈊象元富96售03,,,,,,0.00,0,0,0,0,0,0,0,0,0,0,0,0,0
20200528,72801P,中美晶元大96售01,,,,,,0.00,0,0,0,0,0,0,0,0,0,0,0,0,0
20200528,72802P,世界元大96售04,,,,,,0.00,0,0,0,0,0,0,0,0,0,0,0,0,0
20200528,72803P,中美晶中信98售01,0.82,0.82,0.82,0.82,-0.03,-3.53,103000,5,84460,0,0,0,0,0,0,103000,0,103000,103000
20200528,72804P,世界中信96售02,,,,,,0.00,0,0,0,0,0,0,0,0,0,0,0,0,0
20200528,72805P,鈊象元富96售04,,,,,,0.00,0,0,0,0,0,0,0,0,0,0,0,0,0
20200528,72806P,世界康和96售02,,,,,,0.00,0,0,0,0,0,0,0,0,0,0,0,0,0
20200528,72807P,網龍群益98售02,,,,,,0.00,0,0,0,0,0,0,0,0,0,0,0,0,0
20200528,72808P,力旺康和96售01,,,,,,0.00,0,0,0,0,0,0,0,0,0,0,0,0,0
20200528,72809P,聯亞元富96售01,0.58,0.58,0.58,0.58,-0.05,-7.94,29000,1,16820,0,0,0,0,0,0,0,29000,-29000,-29000
20200528,72810P,雙鴻元富96售02,,,,,,0.00,0,0,0,0,0,0,0,0,0,0,0,0,0
20200528,72811P,鈊象元富96售05,,,,,,0.00,0,0,0,0,0,0,0,0,0,0,0,0,0
20200528,72812P,世界統一96售01,0.77,0.77,0.77,0.77,-0.05,-6.1,33000,1,25410,0,0,0,0,0,0,0,33000,-33000,-33000
20200528,72813P,宣德統一97售01,,,,,,0.00,0,0,0,0,0,0,0,0,0,0,0,0,0
20200528,72814P,世界群益98售03,1.23,1.28,1.23,1.28,0.00,0.0,235000,18,290430,0,0,0,0,0,0,15000,220000,-205000,-205000
20200528,72815P,宣德元大96售05,0.56,0.56,0.52,0.52,-0.02,-3.7,40000,4,21400,0,0,0,0,0,0,30000,30000,0,0
20200528,72816P,信昌電國票97售02,0.95,0.95,0.95,0.95,-0.01,-1.04,2000,1,1900,0,0,0,0,0,0,0,2000,-2000,-2000
20200528,72817P,網龍國票97售03,,,,,,0.00,0,0,0,0,0,0,0,0,0,0,0,0,0
20200528,72818P,櫃200第一96售05,,,,,,0.00,0,0,0,0,0,0,0,0,0,0,0,0,0
20200528,72819P,櫃200第一96售06,,,,,,0.00,0,0,0,0,0,0,0,0,0,0,0,0,0
20200528,72820P,中美晶兆豐97售01,,,,,,0.00,0,0,0,0,0,0,0,0,0,0,0,0,0
20200528,72821P,櫃200永昌97售02,,,,,,0.00,0,0,0,0,0,0,0,0,0,0,0,0,0
20200528,72822P,櫃200永昌97售03,,,,,,0.00,0,0,0,0,0,0,0,0,0,0,0,0,0
20200528,72823P,櫃200永昌99售04,,,,,,0.00,0,0,0,0,0,0,0,0,0,0,0,0,0
20200528,72824P,櫃200永昌99售05,,,,,,0.00,0,0,0,0,0,0,0,0,0,0,0,0,0
20200528,72825P,緯軟永豐96售01,1.49,1.59,1.49,1.59,-0.06,-3.64,124000,4,187160,0,0,0,0,0,0,100000,124000,-24000,-24000
20200528,72826P,穩懋統一96售11,1.76,1.76,1.76,1.76,-0.04,-2.22,3000,1,5280,0,0,0,0,0,0,0,3000,-3000,-3000
20200528,72827P,穩懋統一96售12,1.46,1.46,1.46,1.46,+0.07,5.04,3000,1,4380,0,0,0,0,0,0,0,3000,-3000,-3000
20200528,72828P,新普凱基96售01,,,,,,0.00,0,0,0,0,0,0,0,0,0,0,0,0,0
20200528,72829P,神盾群益98售02,,,,,,0.00,0,0,0,0,0,0,0,0,0,0,0,0,0
20200528,72830P,櫃200永昌9B售02,,,,,,0.00,0,0,0,0,0,0,0,0,0,0,0,0,0
20200528,72831P,櫃200永昌9B售03,,,,,,0.00,0,0,0,0,0,0,0,0,0,0,0,0,0
20200528,72832P,櫃200永昌9C售04,0.77,0.77,0.76,0.76,-0.02,-2.56,17000,3,12970,0,0,0,0,0,0,0,17000,-17000,-17000
20200528,72833P,櫃200永昌9C售05,,,,,,0.00,0,0,0,0,0,0,0,0,0,0,0,0,0
20200528,72834P,威剛元富99售01,,,,,,0.00,0,0,0,0,0,0,0,0,0,0,0,0,0
20200528,72835P,環球晶中信9A售01,0.72,0.73,0.69,0.73,-0.02,-2.67,797000,17,559940,20000,0,20000,0,0,0,642000,155000,487000,507000
20200528,72836P,聯亞永豐96售02,,,,,,0.00,0,0,0,0,0,0,0,0,0,0,0,0,0
20200528,72837P,雙鴻永豐96售01,,,,,,0.00,0,0,0,0,0,0,0,0,0,0,0,0,0
20200528,72838P,M31元大96售03,0.36,0.36,0.36,0.36,+0.02,5.88,10000,1,3600,0,0,0,0,0,0,0,10000,-10000,-10000
20200528,72839P,世界元富96售03,,,,,,0.00,0,0,0,0,0,0,0,0,0,0,0,0,0
20200528,72840P,聖暉統一97售01,,,,,,0.00,0,0,0,0,0,0,0,0,0,0,0,0,0
20200528,72841P,環球晶凱基96售09,,,,,,0.00,0,0,0,0,0,0,0,0,0,0,0,0,0
20200528,72842P,宣德永豐96售02,0.31,0.31,0.28,0.28,-0.08,-22.22,74000,3,21830,0,0,0,0,0,0,0,74000,-74000,-74000
20200528,72843P,精測永豐96售11,,,,,,0.00,0,0,0,0,0,0,0,0,0,0,0,0,0
20200528,72844P,精測國泰97售03,,,,,,0.00,0,0,0,0,0,0,0,0,0,0,0,0,0
20200528,72845P,精測元大96售05,,,,,,0.00,0,0,0,0,0,0,0,0,0,0,0,0,0
20200528,72846P,穩懋元大96售08,,,,,,0.00,0,0,0,0,0,0,0,0,0,0,0,0,0
20200528,72847P,鈊象元大96售05,,,,,,0.00,0,0,0,0,0,0,0,0,0,0,0,0,0
20200528,72848P,信驊康和96售01,,,,,,0.00,0,0,0,0,0,0,0,0,0,0,0,0,0
20200528,72849P,櫃200永昌98售03,,,,,,0.00,0,0,0,0,0,0,0,0,0,0,0,0,0
20200528,72850P,櫃200永昌98售04,,,,,,0.00,0,0,0,0,0,0,0,0,0,0,0,0,0
20200528,72851P,佳邦永豐96售02,,,,,,0.00,0,0,0,0,0,0,0,0,0,0,0,0,0
20200528,72852P,信昌電永豐96售01,0.79,0.79,0.79,0.79,-0.01,-1.25,50000,1,39500,0,0,0,0,0,0,0,50000,-50000,-50000
20200528,72853P,穩懋元大96售09,,,,,,0.00,0,0,0,0,0,0,0,0,0,0,0,0,0
20200528,72854P,勝麗國票97售02,,,,,,0.00,0,0,0,0,0,0,0,0,0,0,0,0,0
20200528,72855P,精測元大96售06,,,,,,0.00,0,0,0,0,0,0,0,0,0,0,0,0,0
20200528,72856P,閎康統一96售01,,,,,,0.00,0,0,0,0,0,0,0,0,0,0,0,0,0
20200528,72857P,聯亞凱基96售02,,,,,,0.00,0,0,0,0,0,0,0,0,0,0,0,0,0
20200528,72858P,直得永豐96售02,0.17,0.18,0.17,0.18,+0.02,12.5,40000,2,7100,0,0,0,0,0,0,30000,10000,20000,20000
20200528,72859P,原相永豐96售02,,,,,,0.00,0,0,0,0,0,0,0,0,0,0,0,0,0
20200528,72860P,環球晶永豐96售01,0.36,0.36,0.36,0.36,-0.08,-18.18,9000,1,3240,0,0,0,0,0,0,0,9000,-9000,-9000
20200528,72861P,精測群益96售07,,,,,,0.00,0,0,0,0,0,0,0,0,0,0,0,0,0
20200528,72862P,力旺國票96售01,0.57,0.59,0.57,0.59,-0.08,-11.94,65000,2,37290,0,0,0,0,0,0,0,65000,-65000,-65000
20200528,72863P,群聯元大96售05,1.20,1.20,1.20,1.20,-0.07,-5.51,10000,1,12000,0,0,0,0,0,0,0,0,0,0
20200528,72864P,良維永豐96售04,1.20,1.30,1.20,1.30,+0.03,2.36,21000,3,26290,0,0,0,0,0,0,10000,11000,-1000,-1000
20200528,72865P,聯亞國票97售03,0.87,0.90,0.87,0.90,+0.01,1.12,103000,3,91800,0,0,0,0,0,0,10000,93000,-83000,-83000
20200528,72866P,原相台新96售01,,,,,,0.00,0,0,0,0,0,0,0,0,0,0,0,0,0
20200528,72867P,頎邦元富96售03,,,,,,0.00,0,0,0,0,0,0,0,0,0,0,0,0,0
20200528,72868P,頎邦永豐96售01,,,,,,0.00,0,0,0,0,0,0,0,0,0,0,0,0,0
20200528,72869P,頎邦元大96售01,,,,,,0.00,0,0,0,0,0,0,0,0,0,0,0,0,0
20200528,72870P,頎邦群益97售03,0.79,0.83,0.79,0.83,-0.02,-2.35,419000,5,333610,0,0,0,0,0,0,18000,401000,-383000,-383000
20200528,72871P,鈊象國票97售02,0.03,0.04,0.03,0.04,-0.04,-50.0,524000,5,15920,0,0,0,0,0,0,449000,0,449000,449000
20200528,72872P,大江永豐96售04,0.61,0.61,0.61,0.61,0.00,0.0,69000,1,42090,0,0,0,0,0,0,69000,0,69000,69000
20200528,72873P,穩懋凱基96售14,1.23,1.23,1.23,1.23,-0.10,-7.52,100000,1,123000,0,0,0,0,0,0,100000,0,100000,100000
20200528,72874P,台燿元富96售01,,,,,,0.00,0,0,0,0,0,0,0,0,0,0,0,0,0
20200528,72875P,碩禾台新97售02,,,,,,0.00,0,0,0,0,0,0,0,0,0,0,0,0,0
20200528,72876P,頎邦康和96售02,,,,,,0.00,0,0,0,0,0,0,0,0,0,0,0,0,0
20200528,72877P,環球晶統一96售03,1.11,1.11,1.11,1.11,-0.10,-8.26,9000,1,9990,0,0,0,0,0,0,0,9000,-9000,-9000
20200528,72878P,穩懋統一96售13,1.80,1.80,1.76,1.77,-0.03,-1.67,143000,23,255860,0,0,0,0,0,0,140000,3000,137000,137000
20200528,72879P,環球晶中信96售03,0.69,0.69,0.67,0.67,-0.11,-14.1,18000,2,12240,0,0,0,0,0,0,0,18000,-18000,-18000
20200528,72880P,台燿凱基96售04,,,,,,0.00,0,0,0,0,0,0,0,0,0,0,0,0,0
20200528,72881P,穩懋凱基96售15,0.30,0.30,0.30,0.30,-0.02,-6.25,60000,6,18000,0,0,0,0,0,0,0,60000,-60000,-60000
20200528,72882P,威剛國票96售02,,,,,,0.00,0,0,0,0,0,0,0,0,0,0,0,0,0
20200528,72883P,雍智國泰97售01,0.47,0.49,0.47,0.48,+0.07,17.07,388000,6,185760,0,0,0,0,0,0,160000,228000,-68000,-68000
20200528,72884P,中美晶元富97售01,1.40,1.46,1.38,1.46,-0.01,-0.68,184000,5,256950,0,0,0,0,0,0,158000,26000,132000,132000
20200528,72885P,晶焱永豐97售02,0.80,0.85,0.79,0.85,+0.02,2.41,59000,5,48050,0,0,0,0,0,0,23000,36000,-13000,-13000
20200528,72886P,旺矽康和97售01,,,,,,0.00,0,0,0,0,0,0,0,0,0,0,0,0,0
20200528,72887P,威剛康和97售01,0.41,0.47,0.41,0.47,+0.02,4.44,76000,8,33300,0,0,0,0,0,0,31000,45000,-14000,-14000
20200528,72888P,中美晶中信99售01,0.53,0.53,0.53,0.53,0.00,0.0,10000,1,5300,0,0,0,0,0,0,0,10000,-10000,-10000
20200528,72889P,合晶永豐97售02,1.00,1.00,0.99,0.99,-0.09,-8.33,86000,2,85710,0,0,0,0,0,0,86000,0,86000,86000
20200528,72890P,金居永豐97售01,1.14,1.32,1.14,1.31,+0.15,12.93,174000,10,219930,0,0,0,0,0,0,26000,148000,-122000,-122000
20200528,72891P,優群永豐97售02,,,,,,0.00,0,0,0,0,0,0,0,0,0,0,0,0,0
20200528,72892P,精測康和97售01,,,,,,0.00,0,0,0,0,0,0,0,0,0,0,0,0,0
20200528,72893P,櫃200群益97售03,,,,,,0.00,0,0,0,0,0,0,0,0,0,0,0,0,0
20200528,72894P,中美晶凱基97售03,,,,,,0.00,0,0,0,0,0,0,0,0,0,0,0,0,0
20200528,72895P,穩懋日盛97售03,2.23,2.23,2.23,2.23,0.00,0.0,10000,10,22300,0,0,0,0,0,0,10000,0,10000,10000
20200528,72896P,廣明永豐97售02,1.09,1.12,1.09,1.12,+0.03,2.75,62000,3,68450,0,0,0,0,0,0,0,62000,-62000,-62000
20200528,72897P,璟德永豐97售01,0.48,0.51,0.48,0.51,+0.01,2.0,55000,3,27150,0,0,0,0,0,0,0,55000,-55000,-55000
20200528,72898P,雙鴻國票98售01,,,,,,0.00,0,0,0,0,0,0,0,0,0,0,0,0,0
20200528,72899P,中美晶群益97售02,0.96,0.96,0.96,0.96,-0.03,-3.03,9000,1,8640,0,0,0,0,0,0,0,9000,-9000,-9000
20200528,72900P,聯亞群益97售01,,,,,,0.00,0,0,0,0,0,0,0,0,0,0,0,0,0
20200528,72901P,穩懋統一97售04,,,,,,0.00,0,0,0,0,0,0,0,0,0,0,0,0,0
20200528,72902P,精測元富97售01,,,,,,0.00,0,0,0,0,0,0,0,0,0,0,0,0,0
20200528,72903P,中美晶國票97售03,2.09,2.19,2.05,2.19,-0.05,-2.23,89000,8,187630,0,0,0,0,0,0,44000,45000,-1000,-1000
20200528,72904P,大江群益97售03,,,,,,0.00,0,0,0,0,0,0,0,0,0,0,0,0,0
20200528,72905P,穩懋國泰98售01,1.62,1.64,1.62,1.64,+0.05,3.14,12000,3,19530,0,0,0,0,0,0,12000,0,12000,12000
20200528,72906P,穩懋國泰99售01,,,,,,0.00,0,0,0,0,0,0,0,0,0,0,0,0,0
20200528,72907P,穩懋兆豐98售01,,,,,,0.00,0,0,0,0,0,0,0,0,0,0,0,0,0
20200528,72908P,原相永豐97售01,0.13,0.13,0.13,0.13,+0.02,18.18,10000,1,1300,0,0,0,0,0,0,10000,0,10000,10000
20200528,72909P,穩懋永豐97售01,0.94,0.94,0.94,0.94,+0.04,4.44,5000,1,4700,0,0,0,0,0,0,0,5000,-5000,-5000
20200528,72910P,穩懋統一99售02,2.61,2.66,2.61,2.66,+0.01,0.38,78000,2,204080,0,0,0,0,0,0,78000,0,78000,78000
20200528,72911P,穩懋元大97售05,1.37,1.37,1.18,1.20,-0.06,-4.76,47000,6,56570,0,0,0,0,0,0,34000,1000,33000,33000
20200528,72912P,原相中信99售02,0.46,0.55,0.46,0.55,+0.06,12.24,227000,14,117720,0,0,0,0,0,0,133000,94000,39000,39000
20200528,72913P,旺矽統一97售02,,,,,,0.00,0,0,0,0,0,0,0,0,0,0,0,0,0
20200528,72914P,穩懋元大97售06,,,,,,0.00,0,0,0,0,0,0,0,0,0,0,0,0,0
20200528,72915P,中美晶凱基97售06,0.71,0.74,0.71,0.74,0.00,0.0,101000,3,73540,0,0,0,0,0,0,0,101000,-101000,-101000
20200528,72916P,穩懋凱基97售04,,,,,,0.00,0,0,0,0,0,0,0,0,0,0,0,0,0
20200528,72917P,網龍國票98售01,0.78,0.80,0.72,0.80,-0.02,-2.44,228000,14,173700,0,0,0,0,0,0,78000,85000,-7000,-7000
20200528,72918P,環球晶元富97售02,,,,,,0.00,0,0,0,0,0,0,0,0,0,0,0,0,0
20200528,72919P,聯亞元富97售02,1.58,1.61,1.58,1.60,-0.04,-2.44,98000,6,155410,0,0,0,0,0,0,89000,9000,80000,80000
20200528,72920P,雙鴻元富97售02,,,,,,0.00,0,0,0,0,0,0,0,0,0,0,0,0,0
20200528,72921P,雙鴻元大98售01,,,,,,0.00,0,0,0,0,0,0,0,0,0,0,0,0,0
20200528,72922P,原相亞東99售01,,,,,,0.00,0,0,0,0,0,0,0,0,0,0,0,0,0
20200528,72923P,台燿永豐97售01,0.17,0.18,0.17,0.18,-0.01,-5.26,48000,2,8560,0,0,0,0,0,0,8000,40000,-32000,-32000
20200528,72924P,精測凱基97售05,,,,,,0.00,0,0,0,0,0,0,0,0,0,0,0,0,0
20200528,72925P,鈊象凱基97售02,,,,,,0.00,0,0,0,0,0,0,0,0,0,0,0,0,0
20200528,72926P,精華元大97售02,2.26,2.32,2.16,2.32,0.00,0.0,95000,10,216520,0,0,0,0,0,0,50000,45000,5000,5000
20200528,72927P,大江元富97售02,,,,,,0.00,0,0,0,0,0,0,0,0,0,0,0,0,0
20200528,72928P,宜鼎元富97售02,,,,,,0.00,0,0,0,0,0,0,0,0,0,0,0,0,0
20200528,72929P,信驊元富97售02,0.13,0.17,0.13,0.17,+0.03,21.43,15000,3,2060,0,0,0,0,0,0,0,12000,-12000,-12000
20200528,72930P,威剛元富97售03,,,,,,0.00,0,0,0,0,0,0,0,0,0,0,0,0,0
20200528,72931P,新普元富97售02,0.42,0.42,0.42,0.42,-0.04,-8.7,98000,1,41160,0,0,0,0,0,0,98000,0,98000,98000
20200528,72932P,網家元富97售02,0.08,0.10,0.08,0.10,+0.01,11.11,120000,2,10000,0,0,0,0,0,0,120000,0,120000,120000
20200528,72933P,碩禾永豐97售01,,,,,,0.00,0,0,0,0,0,0,0,0,0,0,0,0,0
20200528,72934P,晟德永豐97售01,1.26,1.42,1.26,1.42,+0.08,5.97,106000,7,141690,0,0,0,0,0,0,70000,36000,34000,34000
20200528,72935P,鈊象永豐97售03,0.22,0.25,0.19,0.25,-0.08,-24.24,770000,12,160950,0,0,0,0,0,0,375000,355000,20000,20000
20200528,72936P,鈊象元富97售03,0.08,0.10,0.07,0.10,-0.04,-28.57,39000,3,3250,0,0,0,0,0,0,29000,0,29000,29000
20200528,72937P,櫃200元大99售01,,,,,,0.00,0,0,0,0,0,0,0,0,0,0,0,0,0
20200528,72938P,櫃200元大99售02,,,,,,0.00,0,0,0,0,0,0,0,0,0,0,0,0,0
20200528,72939P,網龍元大97售02,1.46,1.55,1.42,1.55,-0.14,-8.28,29000,3,44510,0,0,0,0,0,0,2000,27000,-25000,-25000
20200528,72940P,環球晶群益97售04,,,,,,0.00,0,0,0,0,0,0,0,0,0,0,0,0,0
20200528,72941P,環球晶統一97售03,2.03,2.03,2.03,2.03,-0.07,-3.33,14000,1,28420,0,0,0,0,0,0,14000,0,14000,14000
20200528,72942P,群聯元富97售01,4.75,4.97,4.75,4.97,+0.11,2.26,43000,7,211630,0,0,0,0,0,0,21000,22000,-1000,-1000
20200528,72943P,雙鴻元富97售03,,,,,,0.00,0,0,0,0,0,0,0,0,0,0,0,0,0
20200528,72944P,信昌電元富97售01,,,,,,0.00,0,0,0,0,0,0,0,0,0,0,0,0,0
20200528,72945P,大江永豐97售04,1.50,1.51,1.50,1.51,-0.02,-1.31,150000,2,225120,0,0,0,0,0,0,150000,0,150000,150000
20200528,72946P,穩懋富邦99售02,1.25,1.28,1.24,1.24,-0.01,-0.8,95000,20,119530,0,0,0,0,0,0,61000,34000,27000,27000
20200528,72947P,環球晶凱基97售08,2.07,2.16,2.06,2.16,-0.05,-2.26,117000,3,250220,0,0,0,0,0,0,20000,97000,-77000,-77000
20200528,72948P,大江元大97售06,,,,,,0.00,0,0,0,0,0,0,0,0,0,0,0,0,0
20200528,72949P,環球晶永豐97售02,1.29,1.33,1.27,1.33,-0.04,-2.92,27000,3,35690,0,0,0,0,0,0,0,27000,-27000,-27000
20200528,72950P,中美晶元富97售02,2.40,2.44,2.38,2.44,-0.01,-0.41,81000,8,196610,0,0,0,0,0,0,9000,72000,-63000,-63000
20200528,72951P,宣德元富97售02,,,,,,0.00,0,0,0,0,0,0,0,0,0,0,0,0,0
20200528,72952P,群聯元富97售02,6.75,6.75,6.75,6.75,+0.20,3.05,9000,1,60750,0,0,0,0,0,0,0,9000,-9000,-9000
20200528,72953P,環球晶元富97售05,,,,,,0.00,0,0,0,0,0,0,0,0,0,0,0,0,0
20200528,72954P,穩懋元富97售05,4.50,4.50,4.50,4.50,+0.07,1.58,30000,3,135000,0,0,0,0,0,0,0,30000,-30000,-30000
20200528,72955P,中美晶元大98售02,,,,,,0.00,0,0,0,0,0,0,0,0,0,0,0,0,0
20200528,72956P,信驊元大98售01,0.19,0.22,0.18,0.22,-0.01,-4.35,910000,20,184270,0,0,0,0,0,0,132000,580000,-448000,-448000
20200528,72957P,精測元富98售01,,,,,,0.00,0,0,0,0,0,0,0,0,0,0,0,0,0
20200528,72958P,威剛元大98售03,1.38,1.44,1.38,1.44,+0.04,2.86,179000,3,253020,0,0,0,0,0,0,0,179000,-179000,-179000
20200528,72959P,大江永豐98售02,0.50,0.50,0.50,0.50,+0.03,6.38,1000,1,500,0,0,0,0,0,0,0,0,0,0
20200528,72960P,中美晶永豐98售01,,,,,,0.00,0,0,0,0,0,0,0,0,0,0,0,0,0
20200528,72961P,環球晶國泰99售01,,,,,,0.00,0,0,0,0,0,0,0,0,0,0,0,0,0
20200528,72962P,鈊象元富98售01,0.42,0.42,0.33,0.33,-0.19,-36.54,162000,21,60350,0,0,0,0,0,0,0,120000,-120000,-120000
20200528,72963P,環球晶凱基98售03,1.58,1.63,1.58,1.61,-0.13,-7.47,42000,3,66920,0,0,0,0,0,0,32000,10000,22000,22000
20200528,72964P,環球晶元大98售05,2.25,2.25,2.22,2.22,-0.15,-6.33,55000,2,123600,0,0,0,0,0,0,55000,0,55000,55000
20200528,72965P,環球晶元大98售06,2.30,2.30,2.19,2.19,-0.22,-9.13,55000,2,125950,0,0,0,0,0,0,55000,0,55000,55000
20200528,72966P,環球晶元大98售07,2.20,2.22,2.20,2.22,-0.09,-3.9,57000,2,125540,0,0,0,0,0,0,50000,7000,43000,43000
20200528,72967P,精測國泰9A售02,,,,,,0.00,0,0,0,0,0,0,0,0,0,0,0,0,0
20200528,72968P,大江元富98售03,,,,,,0.00,0,0,0,0,0,0,0,0,0,0,0,0,0
20200528,72969P,精測元大98售03,,,,,,0.00,0,0,0,0,0,0,0,0,0,0,0,0,0
20200528,72970P,原相永豐98售01,0.59,0.74,0.59,0.74,+0.08,12.12,214000,21,136490,0,0,0,0,0,0,69000,195000,-126000,-126000
20200528,72971P,穩懋凱基98售05,,,,,,0.00,0,0,0,0,0,0,0,0,0,0,0,0,0
20200528,72972P,大江元富98售04,,,,,,0.00,0,0,0,0,0,0,0,0,0,0,0,0,0
20200528,72973P,大江富邦9A售03,,,,,,0.00,0,0,0,0,0,0,0,0,0,0,0,0,0
20200528,72974P,精測元大98售04,,,,,,0.00,0,0,0,0,0,0,0,0,0,0,0,0,0
20200528,72975P,緯軟元大9A售01,0.84,0.84,0.84,0.84,-0.04,-4.55,140000,1,117600,0,0,0,0,0,0,140000,0,140000,140000
20200528,72976P,環球晶元大98售08,,,,,,0.00,0,0,0,0,0,0,0,0,0,0,0,0,0
20200528,72977P,晶焱永豐98售02,0.82,0.86,0.82,0.86,0.00,0.0,58000,5,48700,0,0,0,0,0,0,12000,46000,-34000,-34000
20200528,72978P,新鉅科元大98售02,3.36,3.36,3.36,3.36,-0.06,-1.75,15000,2,50400,0,0,0,0,0,0,15000,0,15000,15000
20200528,72979P,聯亞元大98售02,2.29,2.29,2.29,2.29,-0.02,-0.87,20000,1,45800,0,0,0,0,0,0,0,20000,-20000,-20000
20200528,72980P,穩懋元大98售03,,,,,,0.00,0,0,0,0,0,0,0,0,0,0,0,0,0
20200528,72981P,聯亞凱基98售03,,,,,,0.00,0,0,0,0,0,0,0,0,0,0,0,0,0
20200528,72982P,精測元大98售05,,,,,,0.00,0,0,0,0,0,0,0,0,0,0,0,0,0
20200528,72983P,穩懋元大98售04,,,,,,0.00,0,0,0,0,0,0,0,0,0,0,0,0,0
20200528,72984P,威剛永豐98售02,1.29,1.42,1.29,1.42,+0.06,4.41,120000,3,156300,0,0,0,0,0,0,100000,20000,80000,80000
20200528,72985P,群聯元富98售03,4.01,4.21,4.01,4.21,+0.06,1.45,112000,12,462930,0,0,0,0,0,0,24000,88000,-64000,-64000
20200528,72986P,環球晶元大98售11,2.37,2.37,2.37,2.37,-0.11,-4.44,48000,1,113760,0,0,0,0,0,0,48000,0,48000,48000
20200528,72987P,環球晶元大98售12,3.72,3.86,3.72,3.86,-0.06,-1.53,42000,2,157920,0,0,0,0,0,0,30000,12000,18000,18000
20200528,72988P,聯亞元大98售03,1.04,1.04,1.04,1.04,-0.04,-3.7,160000,2,166400,0,0,0,0,0,0,160000,0,160000,160000
20200528,72989P,信昌電永豐98售02,1.21,1.21,1.21,1.21,-0.01,-0.82,60000,1,72600,0,0,0,0,0,0,0,60000,-60000,-60000
20200528,72990P,環球晶凱基98售06,1.06,1.06,1.06,1.06,-0.12,-10.17,25000,1,26500,0,0,0,0,0,0,0,25000,-25000,-25000
20200528,72991P,穩懋凱基98售08,3.56,3.56,3.56,3.56,+0.05,1.42,5000,1,17800,0,0,0,0,0,0,0,5000,-5000,-5000
20200528,72992P,穩懋永豐98售02,2.65,2.65,2.65,2.65,+0.03,1.15,10000,1,26500,0,0,0,0,0,0,10000,0,10000,10000
20200528,72993P,穩懋元富98售01,2.78,2.78,2.70,2.72,-0.01,-0.37,14000,13,38140,0,0,0,0,0,0,12000,2000,10000,10000
20200528,72994P,穩懋元富98售02,,,,,,0.00,0,0,0,0,0,0,0,0,0,0,0,0,0
20200528,72995P,雙鴻兆豐99售02,0.51,0.51,0.51,0.51,0.00,0.0,10000,1,5100,0,0,0,0,0,0,0,10000,-10000,-10000
20200528,72996P,力旺元富98售02,1.05,1.13,0.97,1.13,+0.04,3.67,364000,22,376450,0,0,0,0,0,0,140000,224000,-84000,-84000
20200528,72997P,精測台新98售02,,,,,,0.00,0,0,0,0,0,0,0,0,0,0,0,0,0
20200528,72998P,穩懋台新98售01,1.70,1.70,1.70,1.70,+0.04,2.41,10000,1,17000,0,0,0,0,0,0,10000,0,10000,10000
20200528,72999P,環球晶群益98售03,3.87,3.92,3.87,3.92,-0.07,-1.75,50000,5,195100,0,0,0,0,0,0,10000,50000,-40000,-40000
20200528,73000P,穩懋富邦99售03,,,,,,0.00,0,0,0,0,0,0,0,0,0,0,0,0,0
20200528,73001P,譜瑞元大98售05,1.67,1.84,1.67,1.84,+0.13,7.6,321000,23,562390,0,0,0,0,0,0,169000,150000,19000,19000
20200528,73002P,精測元富98售03,3.33,3.48,3.32,3.48,+0.06,1.75,175000,15,592250,0,0,0,0,0,0,161000,14000,147000,147000
20200528,73003P,神盾群益9A售04,1.31,1.38,1.31,1.38,+0.06,4.55,273000,6,362830,0,0,0,0,0,0,13000,260000,-247000,-247000
20200528,73004P,譜瑞台新99售01,0.33,0.33,0.33,0.33,+0.01,3.12,70000,2,23100,0,0,0,0,0,0,0,70000,-70000,-70000
20200528,73005P,中美晶元大98售07,2.37,2.42,2.37,2.42,+0.03,1.26,164000,6,393260,0,0,0,0,0,0,14000,164000,-150000,-150000
20200528,73006P,聯亞元大98售04,,,,,,0.00,0,0,0,0,0,0,0,0,0,0,0,0,0
20200528,73007P,中美晶元富98售01,,,,,,0.00,0,0,0,0,0,0,0,0,0,0,0,0,0
20200528,73008P,合晶元富98售02,,,,,,0.00,0,0,0,0,0,0,0,0,0,0,0,0,0
20200528,73009P,原相元富98售02,1.18,1.36,1.18,1.36,+0.16,13.33,281000,31,357610,0,0,0,0,0,0,22000,259000,-237000,-237000
20200528,73010P,勝麗元富98售01,,,,,,0.00,0,0,0,0,0,0,0,0,0,0,0,0,0
20200528,73011P,原相台新98售01,0.93,0.93,0.93,0.93,+0.13,16.25,30000,3,27900,0,0,0,0,0,0,0,30000,-30000,-30000
20200528,73012P,威剛統一98售02,1.64,1.64,1.64,1.64,+0.05,3.14,5000,1,8200,0,0,0,0,0,0,0,5000,-5000,-5000
20200528,73013P,中美晶群益98售05,,,,,,0.00,0,0,0,0,0,0,0,0,0,0,0,0,0
20200528,73014P,環球晶國泰9A售02,,,,,,0.00,0,0,0,0,0,0,0,0,0,0,0,0,0
20200528,73015P,碩禾元大99售04,,,,,,0.00,0,0,0,0,0,0,0,0,0,0,0,0,0
20200528,73016P,精測元大98售06,5.95,5.95,5.90,5.90,+0.15,2.61,13000,2,77100,0,0,0,0,0,0,5000,8000,-3000,-3000
20200528,73017P,環球晶統一99售05,,,,,,0.00,0,0,0,0,0,0,0,0,0,0,0,0,0
20200528,73018P,威剛國票99售02,1.96,2.05,1.96,2.05,+0.05,2.5,121000,5,247570,0,0,0,0,0,0,0,121000,-121000,-121000
20200528,73019P,穩懋國泰99售02,,,,,,0.00,0,0,0,0,0,0,0,0,0,0,0,0,0
20200528,73020P,穩懋亞東98售02,2.24,2.24,2.24,2.24,-0.03,-1.32,100000,1,224000,0,0,0,0,0,0,100000,100000,0,0
20200528,73021P,原相元大99售02,,,,,,0.00,0,0,0,0,0,0,0,0,0,0,0,0,0
20200528,73022P,台燿中信9A售02,,,,,,0.00,0,0,0,0,0,0,0,0,0,0,0,0,0
20200528,73023P,新普中信9C售01,0.62,0.62,0.60,0.60,-0.04,-6.25,69000,4,42440,0,0,0,0,0,0,47000,22000,25000,25000
20200528,73024P,譜瑞中信9C售01,0.29,0.30,0.26,0.30,+0.03,11.11,1137000,23,310940,0,0,0,0,0,0,884000,243000,641000,641000
20200528,73025P,譜瑞凱基98售03,0.33,0.36,0.32,0.36,+0.02,5.88,185000,15,62460,0,0,0,0,0,0,100000,50000,50000,50000
20200528,73026P,泰博永豐98售02,0.32,0.39,0.32,0.39,0.00,0.0,66000,9,21590,0,0,0,0,0,0,0,0,0,0
20200528,73027P,雙鴻元大9A售02,0.92,0.95,0.90,0.92,-0.03,-3.16,300000,9,277570,0,0,0,0,0,0,193000,295000,-102000,-102000
20200528,73028P,中美晶統一9B售01,1.27,1.28,1.27,1.28,+0.01,0.79,12000,3,15320,0,0,0,0,0,0,0,12000,-12000,-12000
20200528,73029P,中美晶凱基99售06,1.91,1.99,1.91,1.97,-0.01,-0.51,229000,8,447580,0,0,0,0,0,0,64000,165000,-101000,-101000
20200528,73030P,大江群益99售01,0.98,0.98,0.97,0.97,-0.02,-2.02,88000,3,85430,0,0,0,0,0,0,88000,0,88000,88000
20200528,73031P,宏捷科康和99售02,2.06,2.06,2.06,2.06,0.00,0.0,10000,1,20600,0,0,0,0,0,0,0,10000,-10000,-10000
20200528,73032P,雙鴻群益9B售01,0.85,0.86,0.85,0.86,-0.01,-1.15,250000,5,213600,0,0,0,0,0,0,250000,240000,10000,10000
20200528,73033P,宏捷科國票99售01,,,,,,0.00,0,0,0,0,0,0,0,0,0,0,0,0,0
20200528,73034P,大江富邦9B售01,0.55,0.55,0.55,0.55,0.00,0.0,10000,1,5500,0,0,0,0,0,0,10000,0,10000,10000
20200528,73035P,中美晶台新99售01,,,,,,0.00,0,0,0,0,0,0,0,0,0,0,0,0,0
20200528,73036P,鈊象永豐99售02,0.89,0.89,0.73,0.75,-0.24,-24.24,219000,25,170260,0,0,0,0,0,0,79000,140000,-61000,-61000
20200528,73037P,海韻電元富99售02,,,,,,0.00,0,0,0,0,0,0,0,0,0,0,0,0,0
20200528,73038P,中美晶台新99售02,,,,,,0.00,0,0,0,0,0,0,0,0,0,0,0,0,0
20200528,73039P,原相台新99售01,1.34,1.49,1.34,1.49,+0.13,9.56,121000,4,174590,0,0,0,0,0,0,0,121000,-121000,-121000
20200528,73040P,穩懋凱基99售04,1.31,1.32,1.30,1.31,-0.01,-0.76,123000,7,160310,0,0,0,0,0,0,88000,35000,53000,53000
20200528,73041P,穩懋統一9B售02,,,,,,0.00,0,0,0,0,0,0,0,0,0,0,0,0,0
20200528,73042P,原相元大99售04,2.27,2.27,2.27,2.27,+0.30,15.23,10000,1,22700,0,0,0,0,0,0,0,10000,-10000,-10000
20200528,73043P,穩懋元大99售04,2.75,2.75,2.63,2.63,-0.04,-1.5,40000,3,107600,0,0,0,0,0,0,20000,20000,0,0
20200528,73044P,原相國票9A售01,1.66,1.90,1.66,1.90,+0.16,9.2,221000,19,404390,0,0,0,0,0,0,34000,187000,-153000,-153000
20200528,73045P,雙鴻國票9A售02,1.15,1.15,1.15,1.15,0.00,0.0,129000,2,148350,0,0,0,0,0,0,0,129000,-129000,-129000
20200528,73046P,神盾群益9A售05,1.38,1.47,1.38,1.46,+0.05,3.55,355000,15,507550,0,0,0,0,0,0,122000,215000,-93000,-93000
20200528,73047P,宏捷科元富9C售03,1.67,1.71,1.67,1.71,+0.03,1.79,189000,11,320800,0,0,0,0,0,0,10000,179000,-169000,-169000
20200528,73048P,中美晶中信9B售01,,,,,,0.00,0,0,0,0,0,0,0,0,0,0,0,0,0
20200528,73049P,宏捷科元大99售05,,,,,,0.00,0,0,0,0,0,0,0,0,0,0,0,0,0
20200528,73050P,雍智元大99售02,0.45,0.50,0.45,0.50,+0.05,11.11,320000,7,150000,0,0,0,0,0,0,250000,70000,180000,180000
20200528,73051P,台燿元富9C售02,2.32,2.36,2.32,2.33,-0.05,-2.1,80000,5,187010,0,0,0,0,0,0,9000,71000,-62000,-62000
20200528,73052P,原相統一99售03,1.07,1.14,1.07,1.14,+0.04,3.64,92000,6,102120,0,0,0,0,0,0,42000,50000,-8000,-8000
20200528,73053P,原相統一9A售02,0.91,0.97,0.91,0.97,+0.03,3.19,38000,5,35430,0,0,0,0,0,0,0,38000,-38000,-38000
20200528,73054P,穩懋元大99售08,,,,,,0.00,0,0,0,0,0,0,0,0,0,0,0,0,0
20200528,73055P,信驊永豐99售03,0.35,0.37,0.33,0.37,-0.02,-5.13,123000,4,42850,0,0,0,0,0,0,0,123000,-123000,-123000
20200528,73056P,原相永豐99售02,0.73,0.85,0.73,0.85,+0.07,8.97,567000,15,459010,0,0,0,0,0,0,90000,471000,-381000,-381000
20200528,73057P,環球晶兆豐99售02,1.91,1.94,1.91,1.94,-0.02,-1.02,20000,2,38500,0,0,0,0,0,0,10000,10000,0,0
20200528,73058P,原相統一9B售02,1.03,1.08,1.03,1.08,+0.05,4.85,51000,6,53350,0,0,0,0,0,0,0,51000,-51000,-51000
20200528,73059P,鈊象元大99售05,1.50,1.50,1.12,1.22,-0.34,-21.79,1244000,56,1620430,0,10000,-10000,0,0,0,493000,738000,-245000,-255000
20200528,73060P,環球晶凱基99售06,,,,,,0.00,0,0,0,0,0,0,0,0,0,0,0,0,0
20200528,73061P,群聯元大9A售01,0.95,1.09,0.95,1.00,+0.01,1.01,59000,4,58550,0,0,0,0,0,0,54000,0,54000,54000
20200528,73062P,群聯凱基99售02,5.10,5.15,5.10,5.15,+0.15,3.0,17000,2,87250,0,0,0,0,0,0,0,17000,-17000,-17000
20200528,73063P,環球晶凱基99售10,1.13,1.13,1.13,1.13,-0.06,-5.04,35000,2,39550,0,0,0,0,0,0,25000,10000,15000,15000
20200528,73064P,中美晶富邦9B售02,0.77,0.80,0.77,0.79,0.00,0.0,402000,3,315580,0,0,0,0,0,0,202000,200000,2000,2000
20200528,73065P,鈊象元富99售01,2.41,2.43,2.39,2.43,-0.23,-8.65,67000,8,161330,0,0,0,0,0,0,67000,0,67000,67000
20200528,73066P,環球晶元大99售07,,,,,,0.00,0,0,0,0,0,0,0,0,0,0,0,0,0
20200528,73067P,環球晶元大99售08,,,,,,0.00,0,0,0,0,0,0,0,0,0,0,0,0,0
20200528,73068P,穩懋元大99售12,1.98,1.98,1.98,1.98,+0.03,1.54,50000,1,99000,0,0,0,0,0,0,50000,0,50000,50000
20200528,73069P,聯亞富邦9B售01,0.51,0.52,0.51,0.52,0.00,0.0,76000,2,39360,0,0,0,0,0,0,0,76000,-76000,-76000
20200528,73070P,元太亞東99售02,0.15,0.15,0.10,0.10,-0.06,-37.5,5000,2,700,0,0,0,0,0,0,0,4000,-4000,-4000
20200528,73071P,雙鴻元富99售02,0.67,0.67,0.67,0.67,0.00,0.0,10000,1,6700,0,0,0,0,0,0,0,10000,-10000,-10000
20200528,73072P,環球晶元大99售12,2.12,2.18,2.12,2.18,-0.05,-2.24,31000,3,66990,0,0,0,0,0,0,0,31000,-31000,-31000
20200528,73073P,穩懋元大99售19,,,,,,0.00,0,0,0,0,0,0,0,0,0,0,0,0,0
20200528,73074P,聯亞國票99售04,1.83,1.83,1.83,1.83,-0.02,-1.08,41000,1,75030,0,0,0,0,0,0,0,41000,-41000,-41000
20200528,73075P,中美晶元大99售06,1.18,1.19,1.18,1.19,0.00,0.0,144000,2,170920,0,0,0,0,0,0,0,144000,-144000,-144000
20200528,73076P,中美晶元大99售07,1.12,1.13,1.12,1.13,+0.01,0.89,147000,2,165640,0,0,0,0,0,0,0,147000,-147000,-147000
20200528,73077P,環球晶元大99售16,1.87,1.94,1.87,1.94,0.00,0.0,54000,5,103090,0,0,0,0,0,0,20000,34000,-14000,-14000
20200528,73078P,環球晶元大99售17,1.62,1.64,1.62,1.64,-0.06,-3.53,34000,2,55720,0,0,0,0,0,0,0,34000,-34000,-34000
20200528,73079P,環球晶凱基99售14,0.67,0.67,0.67,0.67,-0.01,-1.47,5000,1,3350,0,0,0,0,0,0,0,5000,-5000,-5000
20200528,73080P,穩懋凱基99售11,,,,,,0.00,0,0,0,0,0,0,0,0,0,0,0,0,0
20200528,73081P,環球晶國泰9A售04,1.21,1.21,1.20,1.21,-0.03,-2.42,206000,5,249250,0,0,0,0,0,0,145000,61000,84000,84000
20200528,73082P,精測元富9A售01,1.47,1.53,1.47,1.53,+0.02,1.32,182000,9,274080,0,0,0,0,0,0,60000,122000,-62000,-62000
20200528,73083P,環球晶凱基9A售03,,,,,,0.00,0,0,0,0,0,0,0,0,0,0,0,0,0
20200528,73084P,穩懋凱基9A售03,,,,,,0.00,0,0,0,0,0,0,0,0,0,0,0,0,0
20200528,73085P,群聯國票9A售02,1.13,1.23,1.13,1.23,+0.03,2.5,78000,7,93080,0,0,0,0,0,0,40000,38000,2000,2000
20200528,73086P,鈊象國票9A售01,2.24,2.24,2.07,2.13,-0.32,-13.06,100000,4,222000,0,0,0,0,0,0,90000,10000,80000,80000
20200528,73087P,穩懋元大9A售03,2.06,2.06,2.03,2.04,-0.03,-1.45,116000,14,237140,0,0,0,0,0,0,34000,80000,-46000,-46000
20200528,73088P,穩懋元大9A售04,,,,,,0.00,0,0,0,0,0,0,0,0,0,0,0,0,0
20200528,73089P,群聯凱基9A售03,0.50,0.50,0.50,0.50,+0.01,2.04,9000,1,4500,0,0,0,0,0,0,0,9000,-9000,-9000
20200528,73090P,環球晶國票9A售01,,,,,,0.00,0,0,0,0,0,0,0,0,0,0,0,0,0
20200528,73091P,穩懋康和9A售01,,,,,,0.00,0,0,0,0,0,0,0,0,0,0,0,0,0
20200528,73092P,新普元大9A售01,,,,,,0.00,0,0,0,0,0,0,0,0,0,0,0,0,0
20200528,73093P,精測凱基9A售03,0.61,0.85,0.61,0.85,+0.01,1.19,58000,7,44170,0,0,0,0,0,0,11000,27000,-16000,-16000
20200528,73094P,中美晶國票9A售03,1.05,1.05,1.05,1.05,-0.03,-2.78,1000,1,1050,0,0,0,0,0,0,0,1000,-1000,-1000
20200528,73095P,穩懋元大9A售05,1.60,1.61,1.60,1.61,0.00,0.0,21000,3,33750,0,0,0,0,0,0,6000,15000,-9000,-9000
20200528,73096P,世界元大9A售02,0.97,1.02,0.97,1.02,-0.01,-0.97,171000,7,169720,0,0,0,0,0,0,70000,170000,-100000,-100000
20200528,73097P,群聯元大9A售04,2.35,2.43,2.35,2.43,+0.05,2.1,130000,7,313530,0,0,0,0,0,0,5000,125000,-120000,-120000
20200528,73098P,信驊凱基9A售02,0.60,0.60,0.59,0.60,-0.03,-4.76,263000,9,157580,0,0,0,0,0,0,155000,108000,47000,47000
20200528,73099P,穩懋國泰9B售02,2.14,2.15,2.12,2.12,-0.02,-0.93,87000,7,185190,0,0,0,0,0,0,24000,63000,-39000,-39000
20200528,73100P,神盾元富9A售02,0.94,1.00,0.94,0.99,+0.05,5.32,905000,18,872920,0,0,0,0,0,0,166000,739000,-573000,-573000
20200528,73101P,中美晶凱基9A售05,,,,,,0.00,0,0,0,0,0,0,0,0,0,0,0,0,0
20200528,73102P,原相元大9A售06,1.09,1.16,1.09,1.16,+0.06,5.45,141000,6,158390,0,0,0,0,0,0,40000,91000,-51000,-51000
20200528,73103P,穩懋富邦9C售01,1.06,1.06,1.06,1.06,+0.01,0.95,2000,1,2120,0,0,0,0,0,0,2000,0,2000,2000
20200528,73104P,原相元大9A售07,1.10,1.11,1.10,1.11,-0.01,-0.89,332000,4,367610,0,0,0,0,0,0,250000,82000,168000,168000
20200528,73105P,穩懋國票9A售03,,,,,,0.00,0,0,0,0,0,0,0,0,0,0,0,0,0
20200528,73106P,原相永豐9A售03,0.82,0.83,0.82,0.83,+0.02,2.47,12000,2,9860,0,0,0,0,0,0,0,12000,-12000,-12000
20200528,73107P,原相國票9B售02,0.92,0.92,0.92,0.92,+0.03,3.37,20000,1,18400,0,0,0,0,0,0,0,20000,-20000,-20000
20200528,73108P,鈊象國票9A售03,3.11,3.11,2.72,2.72,-0.56,-17.07,75000,10,213030,0,0,0,0,0,0,17000,58000,-41000,-41000
20200528,73109P,神盾永豐9A售04,0.64,0.67,0.64,0.67,0.00,0.0,187000,6,122970,0,0,0,0,0,0,171000,16000,155000,155000
20200528,73110P,環球晶統一9A售01,,,,,,0.00,0,0,0,0,0,0,0,0,0,0,0,0,0
20200528,73111P,穩懋統一9A售03,0.79,0.79,0.79,0.79,+0.02,2.6,40000,2,31600,0,0,0,0,0,0,0,40000,-40000,-40000
20200528,73112P,信驊國票9A售03,0.80,0.83,0.76,0.82,-0.07,-7.87,453000,18,366760,0,0,0,0,0,0,176000,277000,-101000,-101000
20200528,73113P,穩懋國票9A售04,2.41,2.41,2.41,2.41,-0.03,-1.23,99000,2,238590,0,0,0,0,0,0,99000,0,99000,99000
20200528,73114P,穩懋元大9A售06,2.68,2.68,2.68,2.68,-0.07,-2.55,50000,1,134000,0,0,0,0,0,0,50000,0,50000,50000
20200528,73115P,鈊象元大9A售03,3.21,3.21,2.86,2.88,-0.44,-13.25,205000,16,611500,0,35000,-35000,0,0,0,99000,106000,-7000,-42000
20200528,73116P,原相凱基9A售04,0.91,0.91,0.91,0.91,-0.01,-1.09,10000,1,9100,0,0,0,0,0,0,10000,0,10000,10000
20200528,73117P,鈊象永豐9A售04,0.84,0.84,0.79,0.80,-0.12,-13.04,172000,9,139360,0,0,0,0,0,0,168000,4000,164000,164000
20200528,73118P,精測群益9A售01,1.45,1.45,1.45,1.45,+0.04,2.84,4000,1,5800,0,0,0,0,0,0,4000,0,4000,4000
20200528,73119P,原相凱基9A售05,0.89,0.93,0.89,0.93,+0.03,3.33,194000,6,176130,0,0,0,0,0,0,58000,136000,-78000,-78000
20200528,73120P,群聯凱基9A售05,0.67,0.69,0.67,0.69,+0.01,1.47,24000,3,16380,0,0,0,0,0,0,0,24000,-24000,-24000
20200528,73121P,中美晶元大9A售03,2.01,2.02,2.01,2.02,0.00,0.0,76000,2,153260,0,0,0,0,0,0,0,76000,-76000,-76000
20200528,73122P,宏捷科元大9B售03,,,,,,0.00,0,0,0,0,0,0,0,0,0,0,0,0,0
20200528,73123P,信驊元大9A售04,1.14,1.17,1.13,1.17,-0.08,-6.4,272000,8,313400,0,0,0,0,0,0,168000,102000,66000,66000
20200528,73124P,穩懋元大9A售07,2.74,2.74,2.74,2.74,+0.04,1.48,5000,1,13700,0,0,0,0,0,0,0,5000,-5000,-5000
20200528,73125P,精測元大9A售06,1.91,1.97,1.91,1.97,+0.04,2.07,60000,2,117600,0,0,0,0,0,0,10000,50000,-40000,-40000
20200528,73126P,聯亞元大9A售02,1.43,1.46,1.43,1.46,0.00,0.0,62000,3,89590,0,0,0,0,0,0,31000,31000,0,0
20200528,73127P,鈊象元大9B售05,1.22,1.22,1.09,1.11,-0.14,-11.2,210000,12,244290,0,0,0,0,0,0,147000,63000,84000,84000
20200528,73128P,鈊象群益9A售04,1.82,1.82,1.71,1.77,-0.32,-15.31,300000,6,534910,0,0,0,0,0,0,85000,215000,-130000,-130000
20200528,73129P,中美晶永豐9A售02,0.80,0.80,0.80,0.80,0.00,0.0,7000,1,5600,0,0,0,0,0,0,0,7000,-7000,-7000
20200528,73130P,碩禾永豐9A售02,0.84,0.86,0.84,0.86,+0.01,1.18,34000,4,29160,0,0,0,0,0,0,4000,30000,-26000,-26000
20200528,73131P,聯亞凱基9A售03,,,,,,0.00,0,0,0,0,0,0,0,0,0,0,0,0,0
20200528,73132P,大江國票9A售07,1.43,1.43,1.38,1.38,-0.07,-4.83,544000,6,774270,0,0,0,0,0,0,447000,97000,350000,350000
20200528,73133P,神盾國票9B售02,1.08,1.08,1.08,1.08,+0.05,4.85,10000,1,10800,0,0,0,0,0,0,0,10000,-10000,-10000
20200528,73134P,神盾國票9B售03,0.96,1.00,0.96,1.00,+0.03,3.09,74000,2,72240,0,0,0,0,0,0,0,74000,-74000,-74000
20200528,73135P,雙鴻國票9A售04,2.32,2.34,2.32,2.34,-0.06,-2.5,16000,2,37380,0,0,0,0,0,0,16000,0,16000,16000
20200528,73136P,宏捷科永豐9A售02,,,,,,0.00,0,0,0,0,0,0,0,0,0,0,0,0,0
20200528,73137P,頎邦永豐9A售03,,,,,,0.00,0,0,0,0,0,0,0,0,0,0,0,0,0
20200528,73138P,宏捷科凱基9A售04,1.12,1.12,1.12,1.12,0.00,0.0,80000,2,89600,0,0,0,0,0,0,0,80000,-80000,-80000
20200528,73139P,精測凱基9A售06,,,,,,0.00,0,0,0,0,0,0,0,0,0,0,0,0,0
20200528,73140P,穩懋凱基9A售06,1.59,1.59,1.57,1.57,0.00,0.0,58000,3,92160,0,0,0,0,0,0,53000,5000,48000,48000
20200528,73141P,神盾元大9A售07,0.84,0.90,0.84,0.90,+0.02,2.27,450000,7,393000,0,0,0,0,0,0,100000,350000,-250000,-250000
20200528,73142P,精測群益9A售03,1.53,1.61,1.53,1.60,+0.02,1.27,114000,8,178580,0,0,0,0,0,0,43000,71000,-28000,-28000
20200528,73143P,環球晶富邦9B售04,,,,,,0.00,0,0,0,0,0,0,0,0,0,0,0,0,0
20200528,73144P,大江元大9A售06,1.10,1.10,1.10,1.10,+0.01,0.92,100000,1,110000,0,0,0,0,0,0,100000,0,100000,100000
20200528,73145P,宏捷科元大9A售04,1.54,1.56,1.54,1.56,+0.06,4.0,132000,3,205280,0,0,0,0,0,0,0,132000,-132000,-132000
20200528,73146P,頎邦元大9A售02,0.69,0.69,0.69,0.69,-0.05,-6.76,24000,1,16560,0,0,0,0,0,0,24000,0,24000,24000
20200528,73147P,信驊群益9A售03,,,,,,0.00,0,0,0,0,0,0,0,0,0,0,0,0,0
20200528,73148P,宏捷科國票9A售05,2.25,2.25,2.25,2.25,-0.03,-1.32,1000,1,2250,0,0,0,0,0,0,0,1000,-1000,-1000
20200528,73149P,穩懋中信9C售02,,,,,,0.00,0,0,0,0,0,0,0,0,0,0,0,0,0
20200528,73150P,威剛永豐9A售02,0.72,0.75,0.72,0.75,+0.03,4.17,204000,4,149880,0,0,0,0,0,0,0,204000,-204000,-204000
20200528,73151P,精測永豐9A售04,0.96,1.00,0.96,1.00,+0.01,1.01,131000,2,126160,0,0,0,0,0,0,131000,0,131000,131000
20200528,73152P,穩懋永豐9A售03,,,,,,0.00,0,0,0,0,0,0,0,0,0,0,0,0,0
20200528,73153P,威剛元大9A售07,1.02,1.08,1.02,1.08,+0.03,2.86,8000,3,8220,0,0,0,0,0,0,7000,1000,6000,6000
20200528,73154P,神盾元大9B售03,,,,,,0.00,0,0,0,0,0,0,0,0,0,0,0,0,0
20200528,73155P,群聯元大9A售12,1.24,1.30,1.24,1.29,+0.02,1.57,250000,11,316800,0,0,0,0,0,0,132000,118000,14000,14000
20200528,73156P,聯亞群益9A售01,1.85,1.85,1.85,1.85,-0.01,-0.54,16000,2,29600,0,0,0,0,0,0,1000,15000,-14000,-14000
20200528,73157P,宏捷科凱基9A售05,2.10,2.13,2.10,2.13,+0.03,1.43,113000,5,239360,0,0,0,0,0,0,0,113000,-113000,-113000
20200528,73158P,環球晶凱基9A售04,1.17,1.19,1.17,1.19,-0.03,-2.46,97000,4,113610,0,0,0,0,0,0,91000,6000,85000,85000
20200528,73159P,聯亞國票9A售02,2.19,2.22,2.19,2.22,+0.02,0.91,56000,2,123060,0,0,0,0,0,0,0,56000,-56000,-56000
20200528,73160P,精測元大9A售07,1.62,1.69,1.62,1.69,+0.05,3.05,384000,12,639200,0,0,0,0,0,0,30000,354000,-324000,-324000
20200528,73161P,鈊象群益9A售05,3.43,3.43,3.10,3.10,-0.49,-13.65,278000,7,896230,0,0,0,0,0,0,95000,183000,-88000,-88000
20200528,73162P,穩懋統一9B售04,1.06,1.06,1.06,1.06,0.00,0.0,3000,1,3180,0,0,0,0,0,0,0,3000,-3000,-3000
20200528,73163P,大江國票9A售08,1.86,1.86,1.86,1.86,-0.07,-3.63,60000,2,111600,0,0,0,0,0,0,60000,0,60000,60000
20200528,73164P,台燿元大9A售01,,,,,,0.00,0,0,0,0,0,0,0,0,0,0,0,0,0
20200528,73165P,緯軟元大9A售02,1.49,1.49,1.49,1.49,-0.04,-2.61,100000,2,149000,0,0,0,0,0,0,0,100000,-100000,-100000
20200528,73166P,聯亞元大9A售03,1.33,1.35,1.33,1.35,0.00,0.0,122000,2,162920,0,0,0,0,0,0,89000,33000,56000,56000
20200528,73167P,櫃200元大9A售01,0.73,0.77,0.73,0.76,-0.01,-1.3,41000,7,30630,0,0,0,0,0,0,23000,18000,5000,5000
20200528,73168P,信驊群益9A售04,0.92,0.92,0.92,0.92,+0.05,5.75,1000,1,920,0,0,0,0,0,0,0,1000,-1000,-1000
20200528,73169P,信驊國票9A售05,1.34,1.34,1.32,1.34,-0.08,-5.63,331000,4,441440,0,0,0,0,0,0,238000,93000,145000,145000
20200528,73170P,穩懋國票9A售05,2.11,2.15,2.11,2.15,+0.01,0.47,134000,3,283620,0,0,0,0,0,0,134000,0,134000,134000
20200528,73171P,神盾凱基9A售03,0.65,0.69,0.65,0.69,+0.01,1.47,24000,2,15960,0,0,0,0,0,0,24000,0,24000,24000
20200528,73172P,群聯永豐9B售01,0.91,0.94,0.91,0.94,+0.04,4.44,54000,6,50010,0,0,0,0,0,0,5000,34000,-29000,-29000
20200528,73173P,台燿群益9B售01,0.59,0.59,0.58,0.58,-0.03,-4.92,75000,2,43600,0,0,0,0,0,0,10000,65000,-55000,-55000
20200528,73174P,環球晶群益9B售03,1.98,2.00,1.98,2.00,-0.02,-0.99,524000,5,1042910,0,0,0,0,0,0,499000,25000,474000,474000
20200528,73175P,鈊象永豐9B售01,,,,,,0.00,0,0,0,0,0,0,0,0,0,0,0,0,0
20200528,73176P,威剛國票9B售03,2.88,3.02,2.88,3.02,+0.05,1.68,100000,4,294440,0,0,0,0,0,0,0,100000,-100000,-100000
20200528,73177P,聯亞國票9B售02,2.53,2.53,2.53,2.53,-0.02,-0.78,18000,1,45540,0,0,0,0,0,0,0,18000,-18000,-18000
20200528,73178P,環球晶中信9C售03,0.61,0.63,0.61,0.63,-0.01,-1.56,66000,2,40860,0,0,0,0,0,0,66000,0,66000,66000
20200528,73179P,鈊象群益9B售02,1.44,1.44,1.28,1.29,-0.26,-16.77,480000,16,651730,0,0,0,0,0,0,199000,281000,-82000,-82000
20200528,73180P,穩懋元大9B售02,,,,,,0.00,0,0,0,0,0,0,0,0,0,0,0,0,0
20200528,73181P,穩懋統一9B售07,,,,,,0.00,0,0,0,0,0,0,0,0,0,0,0,0,0
20200528,73182P,神盾元大9C售01,2.18,2.23,2.18,2.23,+0.02,0.9,70000,2,153600,0,0,0,0,0,0,0,70000,-70000,-70000
20200528,73183P,環球晶群益9B售06,2.54,2.54,2.51,2.51,-0.10,-3.83,34000,2,85670,0,0,0,0,0,0,34000,0,34000,34000
20200528,73184P,精華元大9B售01,2.11,2.15,2.06,2.15,-0.01,-0.46,171000,7,360650,0,0,0,0,0,0,50000,121000,-71000,-71000
20200528,73185P,原相群益9B售06,0.63,0.63,0.63,0.63,+0.03,5.0,100000,1,63000,0,0,0,0,0,0,0,100000,-100000,-100000
20200528,73186P,群聯群益9B售03,2.20,2.23,2.20,2.23,+0.06,2.76,110000,3,244340,0,0,0,0,0,0,0,110000,-110000,-110000
20200528,73187P,鈊象群益9B售03,3.15,3.15,3.04,3.04,-0.48,-13.64,249000,2,766310,0,0,0,0,0,0,85000,164000,-79000,-79000
20200528,73188P,環球晶統一9B售03,0.90,0.91,0.90,0.91,-0.02,-2.15,31000,3,28100,0,0,0,0,0,0,10000,21000,-11000,-11000
20200528,73189P,穩懋統一9B售09,1.51,1.51,1.51,1.51,+0.02,1.34,3000,1,4530,0,0,0,0,0,0,0,3000,-3000,-3000
20200528,73190P,原相群益9B售07,,,,,,0.00,0,0,0,0,0,0,0,0,0,0,0,0,0
20200528,73191P,群聯群益9B售04,2.35,2.44,2.35,2.44,+0.05,2.09,82000,5,198990,0,0,0,0,0,0,40000,42000,-2000,-2000
20200528,73192P,穩懋凱基9B售02,2.00,2.01,2.00,2.01,+0.04,2.03,20000,2,40040,0,0,0,0,0,0,0,20000,-20000,-20000
20200528,73193P,神盾元大9B售04,1.61,1.66,1.61,1.66,+0.03,1.84,154000,3,249290,0,0,0,0,0,0,0,154000,-154000,-154000
20200528,73194P,環球晶統一9B售04,1.15,1.16,1.14,1.14,-0.05,-4.2,144000,6,165830,0,0,0,0,0,0,55000,89000,-34000,-34000
20200528,73195P,鈊象統一9B售01,0.73,0.73,0.70,0.70,-0.11,-13.58,36000,6,25520,0,0,0,0,0,0,19000,17000,2000,2000
20200528,73196P,威剛元大9B售05,1.14,1.19,1.14,1.19,+0.03,2.59,138000,2,159220,0,0,0,0,0,0,0,138000,-138000,-138000
20200528,73197P,緯軟群益9B售01,1.40,1.40,1.40,1.40,-0.04,-2.78,237000,2,331800,0,0,0,0,0,0,0,237000,-237000,-237000
20200528,73198P,頎邦群益9C售02,1.63,1.67,1.63,1.67,-0.01,-0.6,230000,4,375700,0,0,0,0,0,0,0,230000,-230000,-230000
20200528,73199P,雙鴻國票9B售04,0.95,0.95,0.95,0.95,+0.02,2.15,2000,1,1900,0,0,0,0,0,0,0,2000,-2000,-2000
20200528,73200P,神盾永豐9B售01,0.98,1.01,0.98,1.01,+0.02,2.02,430000,4,424300,0,0,0,0,0,0,0,430000,-430000,-430000
20200528,73201P,台燿凱基9B售02,1.16,1.16,1.16,1.16,-0.01,-0.85,55000,1,63800,0,0,0,0,0,0,0,55000,-55000,-55000
20200528,73202P,穩懋凱基9B售04,2.24,2.24,2.24,2.24,-0.01,-0.44,3000,1,6720,0,0,0,0,0,0,0,3000,-3000,-3000
20200528,73203P,泰博國票9B售01,1.85,1.86,1.73,1.73,-0.18,-9.42,451000,56,818200,0,0,0,0,0,0,182000,286000,-104000,-104000
20200528,73204P,大江群益9B售02,,,,,,0.00,0,0,0,0,0,0,0,0,0,0,0,0,0
20200528,73205P,大學光國票9C售02,1.11,1.20,1.08,1.20,+0.05,4.35,507000,40,565750,0,0,0,0,0,0,278000,229000,49000,49000
20200528,73206P,群聯國票9C售01,2.18,2.28,2.18,2.27,+0.05,2.25,82000,16,184550,0,0,0,0,0,0,9000,73000,-64000,-64000
20200528,73207P,環球晶國票9B售03,2.10,2.15,2.04,2.13,-0.04,-1.84,190000,9,392060,0,0,0,0,0,0,180000,39000,141000,141000
20200528,73208P,世界凱基9B售02,1.23,1.23,1.23,1.23,-0.04,-3.15,200000,1,246000,0,0,0,0,0,0,0,200000,-200000,-200000
20200528,73209P,信驊元大9B售03,1.67,1.73,1.66,1.73,-0.08,-4.42,142000,9,238990,0,0,0,0,0,0,113000,29000,84000,84000
20200528,73210P,群聯元大9B售08,3.50,3.62,3.50,3.62,+0.08,2.26,43000,5,153190,0,0,0,0,0,0,0,43000,-43000,-43000
20200528,73211P,環球晶元富9B售05,1.80,1.80,1.79,1.79,-0.05,-2.72,54000,3,97190,0,0,0,0,0,0,53000,1000,52000,52000
20200528,73212P,精測國泰9C售03,1.35,1.40,1.35,1.40,+0.01,0.72,130000,5,180700,0,0,0,0,0,0,30000,100000,-70000,-70000
20200528,73213P,宇峻國票9C售01,1.44,1.44,1.39,1.39,-0.08,-5.44,30000,2,42700,0,0,0,0,0,0,20000,10000,10000,10000
20200528,73214P,鈊象國票9C售01,,,,,,0.00,0,0,0,0,0,0,0,0,0,0,0,0,0
20200528,73215P,群聯凱基9B售08,1.88,1.90,1.88,1.90,+0.05,2.7,98000,3,184900,0,0,0,0,0,0,0,98000,-98000,-98000
20200528,73216P,環球晶凱基9B售06,1.54,1.54,1.54,1.54,-0.08,-4.94,38000,1,58520,0,0,0,0,0,0,38000,0,38000,38000
20200528,73217P,中美晶元富9B售04,1.51,1.54,1.50,1.53,-0.01,-0.65,180000,9,274450,0,0,0,0,0,0,31000,149000,-118000,-118000
20200528,73218P,信驊元富9B售02,1.46,1.52,1.43,1.51,-0.08,-5.03,673000,29,984640,0,0,0,0,0,0,500000,144000,356000,356000
20200528,73219P,鈊象元大9B售07,,,,,,0.00,0,0,0,0,0,0,0,0,0,0,0,0,0
20200528,73220P,雙鴻永豐9B售02,1.05,1.05,1.05,1.05,-0.01,-0.94,10000,1,10500,0,0,0,0,0,0,0,10000,-10000,-10000
20200528,73221P,網家國票9B售03,0.91,0.91,0.90,0.91,+0.02,2.25,53000,4,47930,0,0,0,0,0,0,3000,50000,-47000,-47000
20200528,73222P,雙美國票9C售01,,,,,,0.00,0,0,0,0,0,0,0,0,0,0,0,0,0
20200528,73223P,穩懋元富9B售01,1.75,1.75,1.75,1.75,+0.03,1.74,6000,1,10500,0,0,0,0,0,0,6000,0,6000,6000
20200528,73224P,碩禾台新9B售01,0.87,0.87,0.87,0.87,+0.02,2.35,20000,1,17400,0,0,0,0,0,0,0,20000,-20000,-20000
20200528,73225P,原相國泰9C售02,1.41,1.56,1.39,1.56,+0.02,1.3,1111000,28,1676640,0,0,0,0,0,0,193000,1111000,-918000,-918000
20200528,73226P,群聯元大9B售11,3.21,3.28,3.21,3.27,0.00,0.0,101000,4,329800,0,0,0,0,0,0,0,101000,-101000,-101000
20200528,73227P,穩懋統一9B售10,0.82,0.82,0.82,0.82,0.00,0.0,10000,1,8200,0,0,0,0,0,0,0,10000,-10000,-10000
20200528,73228P,新普元富9B售02,1.15,1.15,1.15,1.15,-0.02,-1.71,38000,1,43700,0,0,0,0,0,0,38000,0,38000,38000
20200528,73229P,穩懋元富9B售02,1.56,1.56,1.56,1.56,-0.01,-0.64,20000,2,31200,0,0,0,0,0,0,0,20000,-20000,-20000
20200528,73230P,信驊永豐9B售02,,,,,,0.00,0,0,0,0,0,0,0,0,0,0,0,0,0
20200528,73231P,元太元富9B售03,1.18,1.22,1.16,1.22,+0.03,2.52,239000,12,288390,0,0,0,0,0,0,10000,229000,-219000,-219000
20200528,73232P,新普群益9C售02,,,,,,0.00,0,0,0,0,0,0,0,0,0,0,0,0,0
20200528,73233P,聯亞國票9C售01,,,,,,0.00,0,0,0,0,0,0,0,0,0,0,0,0,0
20200528,73234P,鈊象國票9C售02,,,,,,0.00,0,0,0,0,0,0,0,0,0,0,0,0,0
20200528,702038,中光電台新97購01,0.47,0.47,0.47,0.47,-0.01,-2.08,10000,1,4700,0,0,0,0,0,0,0,10000,-10000,-10000
20200528,702039,群聯台新97購01,3.58,3.68,3.50,3.50,-0.90,-20.45,84000,10,302970,0,0,0,0,0,0,18000,26000,-8000,-8000
20200528,705503,保瑞國泰98購01,0.29,0.31,0.29,0.31,+0.01,3.33,2000,2,600,0,0,0,0,0,0,1000,0,1000,1000
20200528,705684,建榮統一96購01,,,,,,0.00,0,0,0,0,0,0,0,0,0,0,0,0,0
20200528,705685,建榮統一96購02,,,,,,0.00,0,0,0,0,0,0,0,0,0,0,0,0,0
20200528,705730,群聯元富96購01,,,,,,0.00,0,0,0,0,0,0,0,0,0,0,0,0,0
20200528,705741,富喬統一96購01,0.01,0.01,0.01,0.01,0.00,0.0,24000,1,240,0,0,0,0,0,0,0,0,0,0
20200528,705775,宜鼎群益96購01,,,,,,0.00,0,0,0,0,0,0,0,0,0,0,0,0,0
20200528,705776,原相群益96購01,,,,,,0.00,0,0,0,0,0,0,0,0,0,0,0,0,0
20200528,705788,緯軟元大96購01,,,,,,0.00,0,0,0,0,0,0,0,0,0,0,0,0,0
20200528,705803,原相富邦97購01,3.27,3.34,3.21,3.21,+0.15,4.9,71000,29,235050,0,0,0,0,0,0,61000,10000,51000,51000
20200528,705805,環球晶富邦97購01,0.52,0.53,0.52,0.53,-0.03,-5.36,21000,3,11120,0,0,0,0,0,0,20000,1000,19000,19000
20200528,705847,環球晶統一99購01,2.07,2.12,2.00,2.00,+0.06,3.09,54000,5,113280,0,0,0,0,0,0,0,54000,-54000,-54000
20200528,705848,禾昌元富96購01,,,,,,0.00,0,0,0,0,0,0,0,0,0,0,0,0,0
20200528,705869,穩懋元大96購01,0.01,0.01,0.01,0.01,-0.02,-66.67,23000,2,230,0,0,0,0,0,0,23000,0,23000,23000
20200528,705904,六角富邦97購01,,,,,,0.00,0,0,0,0,0,0,0,0,0,0,0,0,0
20200528,705905,昇達科富邦97購01,,,,,,0.00,0,0,0,0,0,0,0,0,0,0,0,0,0
20200528,705924,大江元富96購01,,,,,,0.00,0,0,0,0,0,0,0,0,0,0,0,0,0
20200528,706108,威剛富邦97購01,0.67,0.67,0.53,0.53,-0.02,-3.64,173000,14,99420,0,0,0,0,0,0,62000,87000,-25000,-25000
20200528,706109,雙鴻富邦97購01,0.10,0.12,0.09,0.12,+0.02,20.0,61000,3,5720,0,0,0,0,0,0,0,21000,-21000,-21000
20200528,706194,博智國票95購01,,,,,,0.00,0,0,0,0,0,0,0,0,0,0,0,0,0
20200528,706199,昇達科國泰95購01,,,,,,0.00,0,0,0,0,0,0,0,0,0,0,0,0,0
20200528,706200,保瑞國泰95購02,,,,,,0.00,0,0,0,0,0,0,0,0,0,0,0,0,0
20200528,706256,神盾富邦96購01,,,,,,0.00,0,0,0,0,0,0,0,0,0,0,0,0,0
20200528,706267,合晶元大96購01,,,,,,0.00,0,0,0,0,0,0,0,0,0,0,0,0,0
20200528,706296,穩懋統一96購01,,,,,,0.00,0,0,0,0,0,0,0,0,0,0,0,0,0
20200528,706302,三貝德國票96購01,,,,,,0.00,0,0,0,0,0,0,0,0,0,0,0,0,0
20200528,706357,網家元富96購01,,,,,,0.00,0,0,0,0,0,0,0,0,0,0,0,0,0
20200528,706373,雙鴻國泰96購01,,,,,,0.00,0,0,0,0,0,0,0,0,0,0,0,0,0
20200528,706383,群聯群益96購01,,,,,,0.00,0,0,0,0,0,0,0,0,0,0,0,0,0
20200528,706393,昇達科元大96購01,,,,,,0.00,0,0,0,0,0,0,0,0,0,0,0,0,0
20200528,706410,信昌電元大96購01,,,,,,0.00,0,0,0,0,0,0,0,0,0,0,0,0,0
20200528,706415,緯軟元大96購02,,,,,,0.00,0,0,0,0,0,0,0,0,0,0,0,0,0
20200528,706417,雙鴻元大97購01,0.05,0.05,0.05,0.05,-0.01,-16.67,65000,2,3250,0,0,0,0,0,0,65000,0,65000,65000
20200528,706419,鈺太元大96購01,,,,,,0.00,0,0,0,0,0,0,0,0,0,0,0,0,0
20200528,706423,宏觀群益96購01,,,,,,0.00,0,0,0,0,0,0,0,0,0,0,0,0,0
20200528,706427,雙鴻群益96購01,,,,,,0.00,0,0,0,0,0,0,0,0,0,0,0,0,0
20200528,706430,建榮國票96購01,,,,,,0.00,0,0,0,0,0,0,0,0,0,0,0,0,0
20200528,706436,穩懋富邦96購01,0.35,0.35,0.35,0.35,0.00,0.0,1000,1,350,0,0,0,0,0,0,0,1000,-1000,-1000
20200528,706446,雙鴻麥證96購01,,,,,,0.00,0,0,0,0,0,0,0,0,0,0,0,0,0
20200528,706448,威剛元富97購01,,,,,,0.00,0,0,0,0,0,0,0,0,0,0,0,0,0
20200528,706461,元太富邦96購01,,,,,,0.00,0,0,0,0,0,0,0,0,0,0,0,0,0
20200528,706481,雙鴻群益96購02,,,,,,0.00,0,0,0,0,0,0,0,0,0,0,0,0,0
20200528,706513,金居群益96購01,,,,,,0.00,0,0,0,0,0,0,0,0,0,0,0,0,0
20200528,706516,大田元大96購01,0.12,0.12,0.09,0.09,-0.03,-25.0,270000,2,30900,0,0,0,0,0,0,220000,50000,170000,170000
20200528,706518,杰力元大96購01,,,,,,0.00,0,0,0,0,0,0,0,0,0,0,0,0,0
20200528,706529,M31國泰96購01,,,,,,0.00,0,0,0,0,0,0,0,0,0,0,0,0,0
20200528,706530,群聯國泰96購01,,,,,,0.00,0,0,0,0,0,0,0,0,0,0,0,0,0
20200528,706531,雙鴻國泰96購02,,,,,,0.00,0,0,0,0,0,0,0,0,0,0,0,0,0
20200528,706554,神盾群益96購01,,,,,,0.00,0,0,0,0,0,0,0,0,0,0,0,0,0
20200528,706556,由田富邦96購01,,,,,,0.00,0,0,0,0,0,0,0,0,0,0,0,0,0
20200528,706574,建榮元大97購01,,,,,,0.00,0,0,0,0,0,0,0,0,0,0,0,0,0
20200528,706596,建榮永豐96購01,,,,,,0.00,0,0,0,0,0,0,0,0,0,0,0,0,0
20200528,706602,大江元大96購01,,,,,,0.00,0,0,0,0,0,0,0,0,0,0,0,0,0
20200528,706612,原相群益97購01,3.71,3.71,3.05,3.05,-0.27,-8.13,33000,9,109130,0,0,0,0,0,0,33000,0,33000,33000
20200528,706614,櫃200永昌96購01,,,,,,0.00,0,0,0,0,0,0,0,0,0,0,0,0,0
20200528,706615,櫃200永昌96購02,,,,,,0.00,0,0,0,0,0,0,0,0,0,0,0,0,0
20200528,706616,櫃200永昌96購03,,,,,,0.00,0,0,0,0,0,0,0,0,0,0,0,0,0
20200528,706618,原相國泰96購01,,,,,,0.00,0,0,0,0,0,0,0,0,0,0,0,0,0
20200528,706624,雙鴻凱基96購01,,,,,,0.00,0,0,0,0,0,0,0,0,0,0,0,0,0
20200528,706631,櫃200第一96購01,,,,,,0.00,0,0,0,0,0,0,0,0,0,0,0,0,0
20200528,706646,昇達科元大96購02,,,,,,0.00,0,0,0,0,0,0,0,0,0,0,0,0,0
20200528,706651,雙美元大96購01,,,,,,0.00,0,0,0,0,0,0,0,0,0,0,0,0,0
20200528,706690,環球晶富邦98購01,,,,,,0.00,0,0,0,0,0,0,0,0,0,0,0,0,0
20200528,706726,M31元大96購01,,,,,,0.00,0,0,0,0,0,0,0,0,0,0,0,0,0
20200528,706731,良維元大97購01,,,,,,0.00,0,0,0,0,0,0,0,0,0,0,0,0,0
20200528,706733,神盾元大96購01,,,,,,0.00,0,0,0,0,0,0,0,0,0,0,0,0,0
20200528,706754,碩禾台新96購01,,,,,,0.00,0,0,0,0,0,0,0,0,0,0,0,0,0
20200528,706758,六角國泰96購01,,,,,,0.00,0,0,0,0,0,0,0,0,0,0,0,0,0
20200528,706761,鐿鈦國泰96購01,,,,,,0.00,0,0,0,0,0,0,0,0,0,0,0,0,0
20200528,706765,六角元大96購01,,,,,,0.00,0,0,0,0,0,0,0,0,0,0,0,0,0
20200528,706774,雙美群益96購01,,,,,,0.00,0,0,0,0,0,0,0,0,0,0,0,0,0
20200528,706788,大學光國泰96購01,,,,,,0.00,0,0,0,0,0,0,0,0,0,0,0,0,0
20200528,706792,威剛元大96購01,0.94,1.01,0.94,1.01,+0.01,1.0,64000,2,60860,0,0,0,0,0,0,54000,64000,-10000,-10000
20200528,706796,鈺太元大96購02,,,,,,0.00,0,0,0,0,0,0,0,0,0,0,0,0,0
20200528,706800,原相元大96購01,,,,,,0.00,0,0,0,0,0,0,0,0,0,0,0,0,0
20200528,706803,環球晶中信97購01,0.06,0.06,0.05,0.06,0.00,0.0,175000,21,10400,0,0,0,0,0,0,5000,160000,-155000,-155000
20200528,706804,由田國泰96購01,,,,,,0.00,0,0,0,0,0,0,0,0,0,0,0,0,0
20200528,706825,穩懋統一96購02,,,,,,0.00,0,0,0,0,0,0,0,0,0,0,0,0,0
20200528,706833,鈺太元大96購03,,,,,,0.00,0,0,0,0,0,0,0,0,0,0,0,0,0
20200528,706844,新鉅科富邦98購01,0.01,0.08,0.01,0.08,0.00,0.0,3000,3,100,0,0,0,0,0,0,0,0,0,0
20200528,706858,由田群益96購01,,,,,,0.00,0,0,0,0,0,0,0,0,0,0,0,0,0
20200528,706868,神盾國票96購01,,,,,,0.00,0,0,0,0,0,0,0,0,0,0,0,0,0
20200528,706870,原相群益97購02,,,,,,0.00,0,0,0,0,0,0,0,0,0,0,0,0,0
20200528,706876,大宇資元大96購01,,,,,,0.00,0,0,0,0,0,0,0,0,0,0,0,0,0
20200528,706882,緯軟元大96購03,,,,,,0.00,0,0,0,0,0,0,0,0,0,0,0,0,0
20200528,706889,雙鴻元富96購01,,,,,,0.00,0,0,0,0,0,0,0,0,0,0,0,0,0
20200528,706906,大學光國票96購01,,,,,,0.00,0,0,0,0,0,0,0,0,0,0,0,0,0
20200528,706912,鐿鈦國票96購01,0.56,0.56,0.50,0.50,-0.10,-16.67,165000,3,88500,0,0,0,0,0,0,5000,160000,-155000,-155000
20200528,706916,M31元大96購02,,,,,,0.00,0,0,0,0,0,0,0,0,0,0,0,0,0
20200528,706918,大學光元大96購01,,,,,,0.00,0,0,0,0,0,0,0,0,0,0,0,0,0
20200528,706919,良維元大96購01,,,,,,0.00,0,0,0,0,0,0,0,0,0,0,0,0,0
20200528,706920,宣德元大96購01,0.06,0.06,0.06,0.06,-0.10,-62.5,1000,1,60,0,0,0,0,0,0,1000,0,1000,1000
20200528,706923,聚積元大96購01,,,,,,0.00,0,0,0,0,0,0,0,0,0,0,0,0,0
20200528,706928,大學光永豐96購01,,,,,,0.00,0,0,0,0,0,0,0,0,0,0,0,0,0
20200528,706933,神盾中信97購01,0.01,0.01,0.01,0.01,0.00,0.0,70000,2,700,0,0,0,0,0,0,70000,0,70000,70000
20200528,706934,環宇中信97購01,0.01,0.02,0.01,0.02,0.00,0.0,11000,2,210,0,0,0,0,0,0,1000,10000,-9000,-9000
20200528,706935,VHQ凱基96購01,,,,,,0.00,0,0,0,0,0,0,0,0,0,0,0,0,0
20200528,706936,台燿凱基96購01,,,,,,0.00,0,0,0,0,0,0,0,0,0,0,0,0,0
20200528,706937,宜鼎凱基96購01,,,,,,0.00,0,0,0,0,0,0,0,0,0,0,0,0,0
20200528,706940,穩懋凱基96購01,,,,,,0.00,0,0,0,0,0,0,0,0,0,0,0,0,0
20200528,706941,譜瑞凱基96購01,,,,,,0.00,0,0,0,0,0,0,0,0,0,0,0,0,0
20200528,706942,大中國票96購01,,,,,,0.00,0,0,0,0,0,0,0,0,0,0,0,0,0
20200528,706945,碩禾國票96購01,,,,,,0.00,0,0,0,0,0,0,0,0,0,0,0,0,0
20200528,706946,環球晶國票96購01,,,,,,0.00,0,0,0,0,0,0,0,0,0,0,0,0,0
20200528,706947,大田國泰96購01,,,,,,0.00,0,0,0,0,0,0,0,0,0,0,0,0,0
20200528,706950,雙鴻富邦96購01,,,,,,0.00,0,0,0,0,0,0,0,0,0,0,0,0,0
20200528,706952,新鉅科元富96購01,,,,,,0.00,0,0,0,0,0,0,0,0,0,0,0,0,0
20200528,706956,原相群益96購03,,,,,,0.00,0,0,0,0,0,0,0,0,0,0,0,0,0
20200528,706960,雙鴻元大96購01,,,,,,0.00,0,0,0,0,0,0,0,0,0,0,0,0,0
20200528,706961,金可中信96購01,,,,,,0.00,0,0,0,0,0,0,0,0,0,0,0,0,0
20200528,706962,勝麗中信97購01,0.52,0.52,0.51,0.51,-0.09,-15.0,26000,7,13460,0,0,0,0,0,0,26000,0,26000,26000
20200528,706963,群聯中信97購01,,,,,,0.00,0,0,0,0,0,0,0,0,0,0,0,0,0
20200528,706965,群聯統一96購01,,,,,,0.00,0,0,0,0,0,0,0,0,0,0,0,0,0
20200528,706966,三貝德凱基96購01,,,,,,0.00,0,0,0,0,0,0,0,0,0,0,0,0,0
20200528,706969,信驊凱基96購01,3.36,3.36,3.36,3.36,-0.30,-8.2,12000,1,40320,0,0,0,0,0,0,12000,12000,0,0
20200528,706970,茂達凱基96購01,0.13,0.13,0.13,0.13,+0.02,18.18,2000,1,260,0,0,0,0,0,0,2000,0,2000,2000
20200528,706973,穩懋凱基96購02,,,,,,0.00,0,0,0,0,0,0,0,0,0,0,0,0,0
20200528,706974,穩懋富邦96購03,,,,,,0.00,0,0,0,0,0,0,0,0,0,0,0,0,0
20200528,706975,穩懋富邦96購04,,,,,,0.00,0,0,0,0,0,0,0,0,0,0,0,0,0
20200528,706976,大江國泰96購01,,,,,,0.00,0,0,0,0,0,0,0,0,0,0,0,0,0
20200528,706977,神盾國泰96購01,,,,,,0.00,0,0,0,0,0,0,0,0,0,0,0,0,0
20200528,706984,合晶國票96購01,,,,,,0.00,0,0,0,0,0,0,0,0,0,0,0,0,0
20200528,706985,建榮國票96購02,,,,,,0.00,0,0,0,0,0,0,0,0,0,0,0,0,0
20200528,706986,網家國票96購01,0.01,0.01,0.01,0.01,0.00,0.0,5000,1,50,0,0,0,0,0,0,5000,0,5000,5000
20200528,706990,中美晶中信97購01,0.33,0.33,0.29,0.31,-0.02,-6.06,170000,6,51320,0,0,0,0,0,0,104000,66000,38000,38000
20200528,706991,弘塑中信97購01,0.44,0.44,0.38,0.38,-0.09,-19.15,150000,6,62700,0,0,0,0,0,0,110000,40000,70000,70000
20200528,706992,神盾中信96購01,,,,,,0.00,0,0,0,0,0,0,0,0,0,0,0,0,0
20200528,706993,環球晶中信96購01,,,,,,0.00,0,0,0,0,0,0,0,0,0,0,0,0,0
20200528,706995,弘塑統一96購01,,,,,,0.00,0,0,0,0,0,0,0,0,0,0,0,0,0
20200528,706996,群聯統一96購02,,,,,,0.00,0,0,0,0,0,0,0,0,0,0,0,0,0
20200528,707000,台燿凱基96購02,,,,,,0.00,0,0,0,0,0,0,0,0,0,0,0,0,0
20200528,707003,神盾凱基96購01,,,,,,0.00,0,0,0,0,0,0,0,0,0,0,0,0,0
20200528,707013,良維兆豐96購01,,,,,,0.00,0,0,0,0,0,0,0,0,0,0,0,0,0
20200528,707018,合晶元大96購02,,,,,,0.00,0,0,0,0,0,0,0,0,0,0,0,0,0
20200528,707019,金居元大96購01,,,,,,0.00,0,0,0,0,0,0,0,0,0,0,0,0,0
20200528,707020,信昌電元大96購02,,,,,,0.00,0,0,0,0,0,0,0,0,0,0,0,0,0
20200528,707024,由田國票96購01,,,,,,0.00,0,0,0,0,0,0,0,0,0,0,0,0,0
20200528,707025,杰力國票96購01,,,,,,0.00,0,0,0,0,0,0,0,0,0,0,0,0,0
20200528,707026,晶焱國票96購01,,,,,,0.00,0,0,0,0,0,0,0,0,0,0,0,0,0
20200528,707027,網龍國票96購01,,,,,,0.00,0,0,0,0,0,0,0,0,0,0,0,0,0
20200528,707029,大宇資國泰97購01,,,,,,0.00,0,0,0,0,0,0,0,0,0,0,0,0,0
20200528,707030,建榮國泰97購01,,,,,,0.00,0,0,0,0,0,0,0,0,0,0,0,0,0
20200528,707038,譜瑞富邦97購01,,,,,,0.00,0,0,0,0,0,0,0,0,0,0,0,0,0
20200528,707046,大宇資元大97購01,,,,,,0.00,0,0,0,0,0,0,0,0,0,0,0,0,0
20200528,707048,昇達科元大96購03,,,,,,0.00,0,0,0,0,0,0,0,0,0,0,0,0,0
20200528,707049,杰力元大96購02,,,,,,0.00,0,0,0,0,0,0,0,0,0,0,0,0,0
20200528,707050,信昌電元大96購03,,,,,,0.00,0,0,0,0,0,0,0,0,0,0,0,0,0
20200528,707051,神盾元大97購01,,,,,,0.00,0,0,0,0,0,0,0,0,0,0,0,0,0
20200528,707053,群聯元大96購01,,,,,,0.00,0,0,0,0,0,0,0,0,0,0,0,0,0
20200528,707054,合晶國泰97購01,,,,,,0.00,0,0,0,0,0,0,0,0,0,0,0,0,0
20200528,707055,大江國票96購01,,,,,,0.00,0,0,0,0,0,0,0,0,0,0,0,0,0
20200528,707056,台半國票96購01,,,,,,0.00,0,0,0,0,0,0,0,0,0,0,0,0,0
20200528,707061,聯亞國票96購01,,,,,,0.00,0,0,0,0,0,0,0,0,0,0,0,0,0
20200528,707063,中美晶兆豐96購01,,,,,,0.00,0,0,0,0,0,0,0,0,0,0,0,0,0
20200528,707065,新普群益97購01,1.46,1.66,1.39,1.63,+0.26,18.98,353000,20,532450,0,0,0,0,0,0,110000,270000,-160000,-160000
20200528,707075,廣明永豐96購01,,,,,,0.00,0,0,0,0,0,0,0,0,0,0,0,0,0
20200528,707077,精華中信97購01,,,,,,0.00,0,0,0,0,0,0,0,0,0,0,0,0,0
20200528,707078,環宇中信97購02,,,,,,0.00,0,0,0,0,0,0,0,0,0,0,0,0,0
20200528,707079,晟德中信97購01,,,,,,0.00,0,0,0,0,0,0,0,0,0,0,0,0,0
20200528,707080,弘塑統一98購01,,,,,,0.00,0,0,0,0,0,0,0,0,0,0,0,0,0
20200528,707083,大江元大96購02,,,,,,0.00,0,0,0,0,0,0,0,0,0,0,0,0,0
20200528,707084,原相元大97購01,5.05,5.05,4.36,4.36,-0.74,-14.51,3000,2,14460,0,0,0,0,0,0,2000,1000,1000,1000
20200528,707085,群聯元大96購02,,,,,,0.00,0,0,0,0,0,0,0,0,0,0,0,0,0
20200528,707093,廣明國泰96購01,,,,,,0.00,0,0,0,0,0,0,0,0,0,0,0,0,0
20200528,707094,中美晶國票96購01,,,,,,0.00,0,0,0,0,0,0,0,0,0,0,0,0,0
20200528,707095,宜鼎國票96購01,,,,,,0.00,0,0,0,0,0,0,0,0,0,0,0,0,0
20200528,707097,穩懋國票96購02,,,,,,0.00,0,0,0,0,0,0,0,0,0,0,0,0,0
20200528,707098,台燿兆豐96購01,0.54,0.59,0.54,0.59,+0.02,3.51,30000,3,17000,0,0,0,0,0,0,30000,0,30000,30000
20200528,707099,穩懋兆豐96購01,,,,,,0.00,0,0,0,0,0,0,0,0,0,0,0,0,0
20200528,707102,原相群益96購04,,,,,,0.00,0,0,0,0,0,0,0,0,0,0,0,0,0
20200528,707104,六角兆豐96購01,0.05,0.05,0.05,0.05,-0.03,-37.5,40000,1,2000,0,0,0,0,0,0,40000,0,40000,40000
20200528,707106,原相台新97購01,,,,,,0.00,0,0,0,0,0,0,0,0,0,0,0,0,0
20200528,707108,新普群益97購02,1.14,1.20,1.05,1.20,+0.07,6.19,257000,11,298910,0,0,0,0,0,0,59000,201000,-142000,-142000
20200528,707109,環宇群益97購01,,,,,,0.00,0,0,0,0,0,0,0,0,0,0,0,0,0
20200528,707113,金居元大96購02,,,,,,0.00,0,0,0,0,0,0,0,0,0,0,0,0,0
20200528,707114,建榮元大96購01,,,,,,0.00,0,0,0,0,0,0,0,0,0,0,0,0,0
20200528,707117,聯亞元大96購01,0.13,0.13,0.13,0.13,-0.05,-27.78,50000,1,6500,0,0,0,0,0,0,50000,0,50000,50000
20200528,707121,大江國票97購01,,,,,,0.00,0,0,0,0,0,0,0,0,0,0,0,0,0
20200528,707123,保瑞國票96購01,,,,,,0.00,0,0,0,0,0,0,0,0,0,0,0,0,0
20200528,707124,環宇國泰96購01,,,,,,0.00,0,0,0,0,0,0,0,0,0,0,0,0,0
20200528,707125,環球晶國泰96購01,,,,,,0.00,0,0,0,0,0,0,0,0,0,0,0,0,0
20200528,707132,晟德國泰96購01,,,,,,0.00,0,0,0,0,0,0,0,0,0,0,0,0,0
20200528,707133,中光電群益96購01,,,,,,0.00,0,0,0,0,0,0,0,0,0,0,0,0,0
20200528,707134,元太群益96購01,1.93,1.93,1.82,1.82,-0.73,-28.63,8000,3,15220,0,0,0,0,0,0,8000,0,8000,8000
20200528,707135,原相群益97購03,,,,,,0.00,0,0,0,0,0,0,0,0,0,0,0,0,0
20200528,707136,群聯群益97購01,,,,,,0.00,0,0,0,0,0,0,0,0,0,0,0,0,0
20200528,707147,大江元大96購03,,,,,,0.00,0,0,0,0,0,0,0,0,0,0,0,0,0
20200528,707149,群聯元大96購03,0.01,0.01,0.01,0.01,-0.01,-50.0,41000,1,410,0,0,0,0,0,0,41000,41000,0,0
20200528,707154,雙鴻元大97購02,,,,,,0.00,0,0,0,0,0,0,0,0,0,0,0,0,0
20200528,707157,同致兆豐96購01,,,,,,0.00,0,0,0,0,0,0,0,0,0,0,0,0,0
20200528,707158,威剛兆豐96購01,0.27,0.27,0.27,0.27,0.00,0.0,90000,1,24300,0,0,0,0,0,0,90000,90000,0,0
20200528,707159,網龍兆豐96購01,,,,,,0.00,0,0,0,0,0,0,0,0,0,0,0,0,0
20200528,707161,元太國票96購01,0.77,0.79,0.68,0.68,-0.13,-16.05,188000,3,139750,0,0,0,0,0,0,69000,119000,-50000,-50000
20200528,707162,旺矽國票96購01,,,,,,0.00,0,0,0,0,0,0,0,0,0,0,0,0,0
20200528,707163,信昌電國票96購01,,,,,,0.00,0,0,0,0,0,0,0,0,0,0,0,0,0
20200528,707164,宣德國票96購01,,,,,,0.00,0,0,0,0,0,0,0,0,0,0,0,0,0
20200528,707165,聚積國票96購01,,,,,,0.00,0,0,0,0,0,0,0,0,0,0,0,0,0
20200528,707166,譜瑞國票96購01,3.96,3.96,3.96,3.96,-2.09,-34.55,2000,2,7920,0,0,0,0,0,0,0,2000,-2000,-2000
20200528,707167,中美晶國泰96購01,0.26,0.26,0.26,0.26,-0.10,-27.78,100000,1,26000,0,0,0,0,0,0,100000,0,100000,100000
20200528,707168,群聯國泰97購01,,,,,,0.00,0,0,0,0,0,0,0,0,0,0,0,0,0
20200528,707169,群聯富邦96購01,,,,,,0.00,0,0,0,0,0,0,0,0,0,0,0,0,0
20200528,707170,環宇富邦97購01,0.01,0.01,0.01,0.01,0.00,0.0,1000,1,10,0,0,0,0,0,0,0,0,0,0
20200528,707171,弘塑中信99購01,0.33,0.33,0.29,0.29,-0.05,-14.71,319000,9,101770,0,0,0,0,0,0,5000,314000,-309000,-309000
20200528,707172,環球晶中信99購01,0.09,0.09,0.09,0.09,-0.01,-10.0,91000,12,8190,0,0,0,0,0,0,0,90000,-90000,-90000
20200528,707173,鈺太中信96購01,0.01,0.01,0.01,0.01,-0.02,-66.67,30000,1,300,0,0,0,0,0,0,30000,0,30000,30000
20200528,707174,凡甲凱基96購01,,,,,,0.00,0,0,0,0,0,0,0,0,0,0,0,0,0
20200528,707175,大江凱基96購01,,,,,,0.00,0,0,0,0,0,0,0,0,0,0,0,0,0
20200528,707178,威剛凱基97購01,0.10,0.10,0.10,0.10,-0.05,-33.33,12000,1,1200,0,0,0,0,0,0,12000,12000,0,0
20200528,707189,美琪瑪元大96購01,,,,,,0.00,0,0,0,0,0,0,0,0,0,0,0,0,0
20200528,707190,神盾元大96購02,,,,,,0.00,0,0,0,0,0,0,0,0,0,0,0,0,0
20200528,707196,閎康群益96購01,,,,,,0.00,0,0,0,0,0,0,0,0,0,0,0,0,0
20200528,707197,順達群益96購01,,,,,,0.00,0,0,0,0,0,0,0,0,0,0,0,0,0
20200528,707198,VHQ國票96購01,,,,,,0.00,0,0,0,0,0,0,0,0,0,0,0,0,0
20200528,707200,網龍國票97購01,0.89,1.14,0.89,1.09,+0.16,17.2,141000,10,147170,0,0,0,0,0,0,13000,131000,-118000,-118000
20200528,707201,環球晶國票96購02,,,,,,0.00,0,0,0,0,0,0,0,0,0,0,0,0,0
20200528,707202,聯亞國票96購02,,,,,,0.00,0,0,0,0,0,0,0,0,0,0,0,0,0
20200528,707207,宇峻元大97購01,,,,,,0.00,0,0,0,0,0,0,0,0,0,0,0,0,0
20200528,707213,順達統一97購01,,,,,,0.00,0,0,0,0,0,0,0,0,0,0,0,0,0
20200528,707233,迅得群益97購01,0.51,0.51,0.51,0.51,-0.14,-21.54,46000,1,23460,0,0,0,0,0,0,46000,0,46000,46000
20200528,707235,群聯群益96購02,,,,,,0.00,0,0,0,0,0,0,0,0,0,0,0,0,0
20200528,707236,聚積群益97購01,,,,,,0.00,0,0,0,0,0,0,0,0,0,0,0,0,0
20200528,707241,昇達科國票96購01,,,,,,0.00,0,0,0,0,0,0,0,0,0,0,0,0,0
20200528,707242,信驊國票96購01,,,,,,0.00,0,0,0,0,0,0,0,0,0,0,0,0,0
20200528,707243,新普國票96購01,,,,,,0.00,0,0,0,0,0,0,0,0,0,0,0,0,0
20200528,707244,精華國票96購01,,,,,,0.00,0,0,0,0,0,0,0,0,0,0,0,0,0
20200528,707246,弘塑元大96購01,0.20,0.20,0.20,0.20,-0.14,-41.18,30000,1,6000,0,0,0,0,0,0,30000,0,30000,30000
20200528,707248,建榮元大96購02,,,,,,0.00,0,0,0,0,0,0,0,0,0,0,0,0,0
20200528,707252,鐿鈦元大96購01,,,,,,0.00,0,0,0,0,0,0,0,0,0,0,0,0,0
20200528,707253,穩懋亞東96購02,,,,,,0.00,0,0,0,0,0,0,0,0,0,0,0,0,0
20200528,707254,同致中信97購01,,,,,,0.00,0,0,0,0,0,0,0,0,0,0,0,0,0
20200528,707262,大宇資凱基97購01,,,,,,0.00,0,0,0,0,0,0,0,0,0,0,0,0,0
20200528,707263,神盾凱基96購02,,,,,,0.00,0,0,0,0,0,0,0,0,0,0,0,0,0
20200528,707275,元太元大96購01,3.60,3.92,3.14,3.14,-0.53,-14.44,152000,9,561500,0,0,0,0,0,0,30000,123000,-93000,-93000
20200528,707277,神盾元大97購02,,,,,,0.00,0,0,0,0,0,0,0,0,0,0,0,0,0
20200528,707278,勝麗元大96購01,,,,,,0.00,0,0,0,0,0,0,0,0,0,0,0,0,0
20200528,707280,碩禾元大96購01,,,,,,0.00,0,0,0,0,0,0,0,0,0,0,0,0,0
20200528,707285,弘塑國泰97購01,0.60,0.60,0.60,0.60,-0.19,-24.05,30000,2,18000,0,0,0,0,0,0,0,0,0,0
20200528,707287,同致國票96購01,,,,,,0.00,0,0,0,0,0,0,0,0,0,0,0,0,0
20200528,707288,良維國票97購01,,,,,,0.00,0,0,0,0,0,0,0,0,0,0,0,0,0
20200528,707289,緯軟國票97購01,0.03,0.03,0.03,0.03,0.00,0.0,100000,1,3000,0,0,0,0,0,0,0,100000,-100000,-100000
20200528,707290,優群國票96購01,,,,,,0.00,0,0,0,0,0,0,0,0,0,0,0,0,0
20200528,707293,泰博兆豐96購01,7.20,7.85,7.20,7.85,+1.05,15.44,40000,4,302000,0,0,0,0,0,0,0,40000,-40000,-40000
20200528,707294,VHQ群益96購01,,,,,,0.00,0,0,0,0,0,0,0,0,0,0,0,0,0
20200528,707297,台燿凱基96購03,0.54,0.54,0.54,0.54,+0.06,12.5,10000,1,5400,0,0,0,0,0,0,10000,0,10000,10000
20200528,707302,原相亞東96購01,2.58,2.58,2.58,2.58,-0.40,-13.42,100000,1,258000,0,0,0,0,0,0,100000,100000,0,0
20200528,707309,合晶國票96購02,,,,,,0.00,0,0,0,0,0,0,0,0,0,0,0,0,0
20200528,707310,原相國票96購01,,,,,,0.00,0,0,0,0,0,0,0,0,0,0,0,0,0
20200528,707315,大江元大96購04,,,,,,0.00,0,0,0,0,0,0,0,0,0,0,0,0,0
20200528,707316,同致元大96購01,,,,,,0.00,0,0,0,0,0,0,0,0,0,0,0,0,0
20200528,707323,環宇元大96購01,0.02,0.02,0.02,0.02,-0.01,-33.33,69000,1,1380,0,0,0,0,0,0,69000,0,69000,69000
20200528,707324,櫃200永昌96購04,,,,,,0.00,0,0,0,0,0,0,0,0,0,0,0,0,0
20200528,707325,M31中信96購01,,,,,,0.00,0,0,0,0,0,0,0,0,0,0,0,0,0
20200528,707326,穩懋中信97購01,,,,,,0.00,0,0,0,0,0,0,0,0,0,0,0,0,0
20200528,707328,中美晶凱基96購01,,,,,,0.00,0,0,0,0,0,0,0,0,0,0,0,0,0
20200528,707333,大江國票96購04,,,,,,0.00,0,0,0,0,0,0,0,0,0,0,0,0,0
20200528,707334,合晶國票97購01,,,,,,0.00,0,0,0,0,0,0,0,0,0,0,0,0,0
20200528,707335,勝麗國票97購01,1.19,1.19,1.15,1.15,-0.17,-12.88,200000,17,232780,0,0,0,0,0,0,200000,0,200000,200000
20200528,707336,群聯國票96購01,,,,,,0.00,0,0,0,0,0,0,0,0,0,0,0,0,0
20200528,707337,網龍國票97購02,1.59,1.83,1.45,1.45,0.00,0.0,537000,17,847870,0,0,0,0,0,0,4000,533000,-529000,-529000
20200528,707338,環球晶國票96購03,0.97,0.97,0.97,0.97,+0.12,14.12,1000,1,970,0,0,0,0,0,0,1000,0,1000,1000
20200528,707339,晟德國票97購01,1.23,1.25,1.02,1.02,-0.44,-30.14,114000,13,134070,0,0,0,0,0,0,74000,40000,34000,34000
20200528,707340,神盾國泰97購01,,,,,,0.00,0,0,0,0,0,0,0,0,0,0,0,0,0
20200528,707341,博智國泰97購01,,,,,,0.00,0,0,0,0,0,0,0,0,0,0,0,0,0
20200528,707342,原相富邦99購01,2.43,2.46,2.05,2.12,-0.27,-11.3,70000,20,152780,0,0,0,0,0,0,56000,40000,16000,16000
20200528,707343,聯亞兆豐96購01,0.58,0.62,0.58,0.61,+0.03,5.17,86000,3,53250,0,0,0,0,0,0,3000,83000,-80000,-80000
20200528,707345,宣德群益96購01,,,,,,0.00,0,0,0,0,0,0,0,0,0,0,0,0,0
20200528,707346,皇田群益97購01,,,,,,0.00,0,0,0,0,0,0,0,0,0,0,0,0,0
20200528,707347,金居元大96購03,,,,,,0.00,0,0,0,0,0,0,0,0,0,0,0,0,0
20200528,707348,保瑞元大96購01,,,,,,0.00,0,0,0,0,0,0,0,0,0,0,0,0,0
20200528,707349,茂達元大96購01,,,,,,0.00,0,0,0,0,0,0,0,0,0,0,0,0,0
20200528,707350,優群元大96購01,,,,,,0.00,0,0,0,0,0,0,0,0,0,0,0,0,0
20200528,707351,環球晶元大96購01,,,,,,0.00,0,0,0,0,0,0,0,0,0,0,0,0,0
20200528,707352,櫃200元大96購03,,,,,,0.00,0,0,0,0,0,0,0,0,0,0,0,0,0
20200528,707353,櫃200元大96購04,,,,,,0.00,0,0,0,0,0,0,0,0,0,0,0,0,0
20200528,707354,昇達科中信97購01,,,,,,0.00,0,0,0,0,0,0,0,0,0,0,0,0,0
20200528,707357,大江國票97購02,0.34,0.34,0.34,0.34,0.00,0.0,10000,1,3400,0,0,0,0,0,0,0,10000,-10000,-10000
20200528,707361,元太元大96購02,,,,,,0.00,0,0,0,0,0,0,0,0,0,0,0,0,0
20200528,707363,合晶元大96購03,0.53,0.53,0.53,0.53,-0.03,-5.36,53000,1,28090,0,0,0,0,0,0,53000,0,53000,53000
20200528,707365,群聯元大97購01,,,,,,0.00,0,0,0,0,0,0,0,0,0,0,0,0,0
20200528,707366,廣明元大96購01,0.14,0.14,0.14,0.14,-0.06,-30.0,10000,1,1400,0,0,0,0,0,0,10000,0,10000,10000
20200528,707368,茂達永豐96購01,,,,,,0.00,0,0,0,0,0,0,0,0,0,0,0,0,0
20200528,707370,杰力國票96購02,0.76,0.76,0.76,0.76,-0.02,-2.56,80000,1,60800,0,0,0,0,0,0,0,80000,-80000,-80000
20200528,707371,大江富邦97購01,,,,,,0.00,0,0,0,0,0,0,0,0,0,0,0,0,0
20200528,707372,原相凱基96購01,,,,,,0.00,0,0,0,0,0,0,0,0,0,0,0,0,0
20200528,707376,雙鴻凱基96購03,,,,,,0.00,0,0,0,0,0,0,0,0,0,0,0,0,0
20200528,707385,晶焱元大96購01,,,,,,0.00,0,0,0,0,0,0,0,0,0,0,0,0,0
20200528,707395,大宇資群益97購01,,,,,,0.00,0,0,0,0,0,0,0,0,0,0,0,0,0
20200528,707400,威剛元大96購02,,,,,,0.00,0,0,0,0,0,0,0,0,0,0,0,0,0
20200528,707402,大宇資永豐96購01,,,,,,0.00,0,0,0,0,0,0,0,0,0,0,0,0,0
20200528,707403,旺矽永豐96購01,,,,,,0.00,0,0,0,0,0,0,0,0,0,0,0,0,0
20200528,707405,優群永豐96購01,,,,,,0.00,0,0,0,0,0,0,0,0,0,0,0,0,0
20200528,707406,M31國票96購01,,,,,,0.00,0,0,0,0,0,0,0,0,0,0,0,0,0
20200528,707407,中美晶國票96購03,,,,,,0.00,0,0,0,0,0,0,0,0,0,0,0,0,0
20200528,707408,兆利國票96購01,,,,,,0.00,0,0,0,0,0,0,0,0,0,0,0,0,0
20200528,707410,雙美國票96購01,,,,,,0.00,0,0,0,0,0,0,0,0,0,0,0,0,0
20200528,707415,櫃200T永昌96購01,,,,,,0.00,0,0,0,0,0,0,0,0,0,0,0,0,0
20200528,707416,櫃200T永昌96購02,,,,,,0.00,0,0,0,0,0,0,0,0,0,0,0,0,0
20200528,707417,櫃200T永昌96購03,,,,,,0.00,0,0,0,0,0,0,0,0,0,0,0,0,0
20200528,707418,櫃200T永昌96購04,,,,,,0.00,0,0,0,0,0,0,0,0,0,0,0,0,0
20200528,707421,緯軟凱基96購01,,,,,,0.00,0,0,0,0,0,0,0,0,0,0,0,0,0
20200528,707422,櫃200凱基99購01,,,,,,0.00,0,0,0,0,0,0,0,0,0,0,0,0,0
20200528,707423,三貝德國票96購02,,,,,,0.00,0,0,0,0,0,0,0,0,0,0,0,0,0
20200528,707424,大學光國票96購02,,,,,,0.00,0,0,0,0,0,0,0,0,0,0,0,0,0
20200528,707425,台燿國票96購01,0.45,0.49,0.45,0.49,-0.05,-9.26,40000,2,19520,0,0,0,0,0,0,38000,2000,36000,36000
20200528,707426,穩懋國票96購03,,,,,,0.00,0,0,0,0,0,0,0,0,0,0,0,0,0
20200528,707427,新普國泰96購01,,,,,,0.00,0,0,0,0,0,0,0,0,0,0,0,0,0
20200528,707428,譜瑞國泰97購01,,,,,,0.00,0,0,0,0,0,0,0,0,0,0,0,0,0
20200528,707432,雙鴻台新96購01,,,,,,0.00,0,0,0,0,0,0,0,0,0,0,0,0,0
20200528,707434,環球晶元大96購02,1.83,1.94,1.83,1.94,+0.03,1.57,128000,7,238330,0,0,0,0,0,0,50000,78000,-28000,-28000
20200528,707437,群聯兆豐96購01,,,,,,0.00,0,0,0,0,0,0,0,0,0,0,0,0,0
20200528,707440,昇達科群益97購01,,,,,,0.00,0,0,0,0,0,0,0,0,0,0,0,0,0
20200528,707441,晶焱群益96購01,,,,,,0.00,0,0,0,0,0,0,0,0,0,0,0,0,0
20200528,707442,櫃200富邦9A購01,,,,,,0.00,0,0,0,0,0,0,0,0,0,0,0,0,0
20200528,707443,櫃200富邦9A購02,,,,,,0.00,0,0,0,0,0,0,0,0,0,0,0,0,0
20200528,707444,雙鴻富邦96購02,0.01,0.01,0.01,0.01,-0.01,-50.0,1000,1,10,0,0,0,0,0,0,1000,0,1000,1000
20200528,707450,大江中信96購01,,,,,,0.00,0,0,0,0,0,0,0,0,0,0,0,0,0
20200528,707452,兆利元大96購01,,,,,,0.00,0,0,0,0,0,0,0,0,0,0,0,0,0
20200528,707457,緯軟群益96購01,,,,,,0.00,0,0,0,0,0,0,0,0,0,0,0,0,0
20200528,707459,迅得凱基98購01,,,,,,0.00,0,0,0,0,0,0,0,0,0,0,0,0,0
20200528,707461,信昌電凱基97購01,0.46,0.46,0.45,0.45,-0.03,-6.25,60000,3,27270,0,0,0,0,0,0,60000,0,60000,60000
20200528,707462,茂達凱基9B購01,0.77,0.89,0.76,0.84,+0.07,9.09,553000,17,452780,0,0,0,0,0,0,260000,260000,0,0
20200528,707463,神盾凱基9B購01,0.49,0.50,0.44,0.45,-0.05,-10.0,35000,4,16650,0,0,0,0,0,0,30000,25000,5000,5000
20200528,707464,勝麗凱基97購01,0.85,0.85,0.85,0.85,-0.03,-3.41,24000,2,20400,0,0,0,0,0,0,24000,0,24000,24000
20200528,707465,閎康凱基97購01,,,,,,0.00,0,0,0,0,0,0,0,0,0,0,0,0,0
20200528,707466,環宇凱基97購01,,,,,,0.00,0,0,0,0,0,0,0,0,0,0,0,0,0
20200528,707467,環球晶凱基96購01,,,,,,0.00,0,0,0,0,0,0,0,0,0,0,0,0,0
20200528,707468,穩懋凱基96購03,,,,,,0.00,0,0,0,0,0,0,0,0,0,0,0,0,0
20200528,707469,鈺太凱基97購01,,,,,,0.00,0,0,0,0,0,0,0,0,0,0,0,0,0
20200528,707470,鐿鈦凱基96購01,,,,,,0.00,0,0,0,0,0,0,0,0,0,0,0,0,0
20200528,707471,信昌電國票96購02,0.47,0.47,0.47,0.47,-0.10,-17.54,135000,1,63450,0,0,0,0,0,0,135000,0,135000,135000
20200528,707472,晶焱國票96購02,,,,,,0.00,0,0,0,0,0,0,0,0,0,0,0,0,0
20200528,707473,群聯國票96購02,,,,,,0.00,0,0,0,0,0,0,0,0,0,0,0,0,0
20200528,707474,穩懋富邦97購01,0.09,0.10,0.09,0.10,0.00,0.0,185000,7,17180,0,0,0,0,0,0,0,0,0,0
20200528,707479,晶焱凱基96購01,,,,,,0.00,0,0,0,0,0,0,0,0,0,0,0,0,0
20200528,707480,環球晶凱基97購01,0.32,0.32,0.32,0.32,+0.01,3.23,15000,2,4800,0,0,0,0,0,0,15000,0,15000,15000
20200528,707484,大江元大96購05,,,,,,0.00,0,0,0,0,0,0,0,0,0,0,0,0,0
20200528,707485,同致元大97購01,,,,,,0.00,0,0,0,0,0,0,0,0,0,0,0,0,0
20200528,707487,迅得國票96購01,,,,,,0.00,0,0,0,0,0,0,0,0,0,0,0,0,0
20200528,707488,宜鼎國票96購02,,,,,,0.00,0,0,0,0,0,0,0,0,0,0,0,0,0
20200528,707489,美琪瑪國票96購01,,,,,,0.00,0,0,0,0,0,0,0,0,0,0,0,0,0
20200528,707490,智崴國泰96購01,,,,,,0.00,0,0,0,0,0,0,0,0,0,0,0,0,0
20200528,707491,櫃200T永昌9C購01,,,,,,0.00,0,0,0,0,0,0,0,0,0,0,0,0,0
20200528,707492,櫃200T永昌9C購02,,,,,,0.00,0,0,0,0,0,0,0,0,0,0,0,0,0
20200528,707493,櫃200T永昌9C購03,,,,,,0.00,0,0,0,0,0,0,0,0,0,0,0,0,0
20200528,707494,櫃200T永昌9C購04,,,,,,0.00,0,0,0,0,0,0,0,0,0,0,0,0,0
20200528,707498,旺矽元大96購01,,,,,,0.00,0,0,0,0,0,0,0,0,0,0,0,0,0
20200528,707500,智崴國票96購01,,,,,,0.00,0,0,0,0,0,0,0,0,0,0,0,0,0
20200528,707501,閎康國票97購01,0.84,0.85,0.79,0.79,-0.08,-9.2,268000,6,220350,0,0,0,0,0,0,197000,71000,126000,126000
20200528,707502,金可國泰97購01,,,,,,0.00,0,0,0,0,0,0,0,0,0,0,0,0,0
20200528,707503,精華國泰97購01,,,,,,0.00,0,0,0,0,0,0,0,0,0,0,0,0,0
20200528,707504,環球晶國泰96購03,,,,,,0.00,0,0,0,0,0,0,0,0,0,0,0,0,0
20200528,707505,穩懋國泰96購02,,,,,,0.00,0,0,0,0,0,0,0,0,0,0,0,0,0
20200528,707506,穩懋統一96購05,,,,,,0.00,0,0,0,0,0,0,0,0,0,0,0,0,0
20200528,707507,三貝德凱基96購02,,,,,,0.00,0,0,0,0,0,0,0,0,0,0,0,0,0
20200528,707509,元太凱基96購01,0.56,0.56,0.56,0.56,0.00,0.0,3000,1,1680,0,0,0,0,0,0,0,0,0,0
20200528,707511,建榮凱基97購01,,,,,,0.00,0,0,0,0,0,0,0,0,0,0,0,0,0
20200528,707512,穩懋凱基96購04,,,,,,0.00,0,0,0,0,0,0,0,0,0,0,0,0,0
20200528,707517,穩懋兆豐96購02,,,,,,0.00,0,0,0,0,0,0,0,0,0,0,0,0,0
20200528,707520,優群群益97購01,,,,,,0.00,0,0,0,0,0,0,0,0,0,0,0,0,0
20200528,707525,泰博中信97購01,,,,,,0.00,0,0,0,0,0,0,0,0,0,0,0,0,0
20200528,707526,建榮凱基96購01,,,,,,0.00,0,0,0,0,0,0,0,0,0,0,0,0,0
20200528,707528,精華凱基96購01,,,,,,0.00,0,0,0,0,0,0,0,0,0,0,0,0,0
20200528,707529,精華統一97購01,,,,,,0.00,0,0,0,0,0,0,0,0,0,0,0,0,0
20200528,707530,精華統一97購02,,,,,,0.00,0,0,0,0,0,0,0,0,0,0,0,0,0
20200528,707531,神盾國票97購01,0.17,0.17,0.14,0.14,-0.03,-17.65,1149000,7,176130,0,0,0,0,0,0,640000,509000,131000,131000
20200528,707532,群聯國票96購03,0.12,0.12,0.12,0.12,-0.11,-47.83,10000,2,1200,0,0,0,0,0,0,10000,10000,0,0
20200528,707533,緯軟國票97購02,0.10,0.10,0.10,0.10,0.00,0.0,100000,1,10000,0,0,0,0,0,0,100000,0,100000,100000
20200528,707534,碩禾元大98購01,,,,,,0.00,0,0,0,0,0,0,0,0,0,0,0,0,0
20200528,707535,精華元大96購01,,,,,,0.00,0,0,0,0,0,0,0,0,0,0,0,0,0
20200528,707546,台半亞東96購01,,,,,,0.00,0,0,0,0,0,0,0,0,0,0,0,0,0
20200528,707547,世界中信96購01,,,,,,0.00,0,0,0,0,0,0,0,0,0,0,0,0,0
20200528,707549,精測凱基96購01,,,,,,0.00,0,0,0,0,0,0,0,0,0,0,0,0,0
20200528,707552,精測統一96購01,,,,,,0.00,0,0,0,0,0,0,0,0,0,0,0,0,0
20200528,707556,精測永豐96購01,,,,,,0.00,0,0,0,0,0,0,0,0,0,0,0,0,0
20200528,707561,M31國票96購02,,,,,,0.00,0,0,0,0,0,0,0,0,0,0,0,0,0
20200528,707562,由田國票97購01,0.14,0.14,0.14,0.14,+0.02,16.67,40000,2,5600,0,0,0,0,0,0,0,40000,-40000,-40000
20200528,707563,宇峻國票96購01,,,,,,0.00,0,0,0,0,0,0,0,0,0,0,0,0,0
20200528,707564,環球晶國票96購04,,,,,,0.00,0,0,0,0,0,0,0,0,0,0,0,0,0
20200528,707566,大江元大96購06,,,,,,0.00,0,0,0,0,0,0,0,0,0,0,0,0,0
20200528,707567,合晶元大96購04,,,,,,0.00,0,0,0,0,0,0,0,0,0,0,0,0,0
20200528,707571,優群元大97購01,,,,,,0.00,0,0,0,0,0,0,0,0,0,0,0,0,0
20200528,707573,穩懋元大96購02,0.01,0.01,0.01,0.01,-0.01,-50.0,10000,2,100,0,0,0,0,0,0,10000,0,10000,10000
20200528,707574,大江富邦97購03,0.24,0.26,0.24,0.25,-0.01,-3.85,561000,11,142640,0,0,0,0,0,0,311000,250000,61000,61000
20200528,707577,神盾群益97購01,,,,,,0.00,0,0,0,0,0,0,0,0,0,0,0,0,0
20200528,707580,雙鴻群益96購03,,,,,,0.00,0,0,0,0,0,0,0,0,0,0,0,0,0
20200528,707581,世界元大96購01,,,,,,0.00,0,0,0,0,0,0,0,0,0,0,0,0,0
20200528,707582,金可元大96購01,,,,,,0.00,0,0,0,0,0,0,0,0,0,0,0,0,0
20200528,707583,順達元大96購01,2.62,2.62,2.62,2.62,-0.57,-17.87,18000,1,47160,0,0,0,0,0,0,18000,18000,0,0
20200528,707584,精測元大97購01,,,,,,0.00,0,0,0,0,0,0,0,0,0,0,0,0,0
20200528,707585,精華元大96購02,,,,,,0.00,0,0,0,0,0,0,0,0,0,0,0,0,0
20200528,707586,新鉅科元富96購02,,,,,,0.00,0,0,0,0,0,0,0,0,0,0,0,0,0
20200528,707587,精測元富96購01,,,,,,0.00,0,0,0,0,0,0,0,0,0,0,0,0,0
20200528,707588,廣明元富96購01,,,,,,0.00,0,0,0,0,0,0,0,0,0,0,0,0,0
20200528,707589,宣德統一96購01,,,,,,0.00,0,0,0,0,0,0,0,0,0,0,0,0,0
20200528,707590,群聯統一96購03,,,,,,0.00,0,0,0,0,0,0,0,0,0,0,0,0,0
20200528,707591,精測統一97購01,,,,,,0.00,0,0,0,0,0,0,0,0,0,0,0,0,0
20200528,707592,穩懋統一97購01,,,,,,0.00,0,0,0,0,0,0,0,0,0,0,0,0,0
20200528,707593,穩懋統一98購01,,,,,,0.00,0,0,0,0,0,0,0,0,0,0,0,0,0
20200528,707595,精測凱基97購01,,,,,,0.00,0,0,0,0,0,0,0,0,0,0,0,0,0
20200528,707596,精測凱基97購02,,,,,,0.00,0,0,0,0,0,0,0,0,0,0,0,0,0
20200528,707597,雙鴻凱基96購04,,,,,,0.00,0,0,0,0,0,0,0,0,0,0,0,0,0
20200528,707598,穩懋凱基96購05,,,,,,0.00,0,0,0,0,0,0,0,0,0,0,0,0,0
20200528,707599,大江永豐96購01,,,,,,0.00,0,0,0,0,0,0,0,0,0,0,0,0,0
20200528,707600,中美晶永豐96購01,,,,,,0.00,0,0,0,0,0,0,0,0,0,0,0,0,0
20200528,707601,精測永豐96購02,,,,,,0.00,0,0,0,0,0,0,0,0,0,0,0,0,0
20200528,707602,精測永豐97購01,,,,,,0.00,0,0,0,0,0,0,0,0,0,0,0,0,0
20200528,707603,邦特國票97購01,,,,,,0.00,0,0,0,0,0,0,0,0,0,0,0,0,0
20200528,707604,金可國票97購01,,,,,,0.00,0,0,0,0,0,0,0,0,0,0,0,0,0
20200528,707605,群聯富邦97購01,0.01,0.01,0.01,0.01,-0.07,-87.5,420000,2,4200,0,0,0,0,0,0,420000,420000,0,0
20200528,707606,精測富邦96購01,,,,,,0.00,0,0,0,0,0,0,0,0,0,0,0,0,0
20200528,707607,精測兆豐97購01,,,,,,0.00,0,0,0,0,0,0,0,0,0,0,0,0,0
20200528,707608,東洋群益96購01,,,,,,0.00,0,0,0,0,0,0,0,0,0,0,0,0,0
20200528,707609,金居群益98購01,0.52,0.52,0.47,0.47,-0.09,-16.07,117000,4,60490,0,0,0,0,0,0,117000,0,117000,117000
20200528,707610,保瑞群益98購01,,,,,,0.00,0,0,0,0,0,0,0,0,0,0,0,0,0
20200528,707611,新鉅科群益96購01,,,,,,0.00,0,0,0,0,0,0,0,0,0,0,0,0,0
20200528,707612,精測群益96購01,,,,,,0.00,0,0,0,0,0,0,0,0,0,0,0,0,0
20200528,707613,鈊象台新97購01,5.65,5.65,5.65,5.65,+1.57,38.48,2000,1,11300,0,0,0,0,0,0,2000,0,2000,2000
20200528,707614,精測中信96購02,,,,,,0.00,0,0,0,0,0,0,0,0,0,0,0,0,0
20200528,707615,鈊象中信96購01,1.57,2.12,1.57,2.12,+0.88,70.97,111000,5,185540,0,0,0,0,0,0,93000,18000,75000,75000
20200528,707616,M31凱基97購01,,,,,,0.00,0,0,0,0,0,0,0,0,0,0,0,0,0
20200528,707617,宣德凱基96購01,,,,,,0.00,0,0,0,0,0,0,0,0,0,0,0,0,0
20200528,707618,精測凱基97購03,,,,,,0.00,0,0,0,0,0,0,0,0,0,0,0,0,0
20200528,707619,璟德凱基96購01,,,,,,0.00,0,0,0,0,0,0,0,0,0,0,0,0,0
20200528,707620,鐿鈦凱基96購02,,,,,,0.00,0,0,0,0,0,0,0,0,0,0,0,0,0
20200528,707621,精測統一97購02,0.08,0.08,0.08,0.08,-0.01,-11.11,51000,1,4080,0,0,0,0,0,0,51000,0,51000,51000
20200528,707622,鈊象統一96購01,,,,,,0.00,0,0,0,0,0,0,0,0,0,0,0,0,0
20200528,707623,勝麗兆豐96購01,,,,,,0.00,0,0,0,0,0,0,0,0,0,0,0,0,0
20200528,707624,精測康和96購02,,,,,,0.00,0,0,0,0,0,0,0,0,0,0,0,0,0
20200528,707625,鈊象康和96購01,1.14,1.14,1.14,1.14,+0.48,72.73,10000,1,11400,0,0,0,0,0,0,0,10000,-10000,-10000
20200528,707626,環球晶永昌99購01,1.53,1.60,1.53,1.60,+0.08,5.26,20000,2,31300,0,0,0,0,0,0,20000,0,20000,20000
20200528,707627,迅得永豐97購01,,,,,,0.00,0,0,0,0,0,0,0,0,0,0,0,0,0
20200528,707628,旺矽永豐97購01,,,,,,0.00,0,0,0,0,0,0,0,0,0,0,0,0,0
20200528,707629,昇達科永豐97購01,,,,,,0.00,0,0,0,0,0,0,0,0,0,0,0,0,0
20200528,707630,僑威永豐96購01,,,,,,0.00,0,0,0,0,0,0,0,0,0,0,0,0,0
20200528,707631,璟德永豐96購01,,,,,,0.00,0,0,0,0,0,0,0,0,0,0,0,0,0
20200528,707632,鈊象永豐96購01,,,,,,0.00,0,0,0,0,0,0,0,0,0,0,0,0,0
20200528,707633,鈊象永豐97購01,4.54,4.93,4.54,4.93,+1.00,25.45,9000,3,42030,0,0,0,0,0,0,3000,7000,-4000,-4000
20200528,707634,元太元大96購03,,,,,,0.00,0,0,0,0,0,0,0,0,0,0,0,0,0
20200528,707635,宣德元大96購02,,,,,,0.00,0,0,0,0,0,0,0,0,0,0,0,0,0
20200528,707636,新普元大96購01,,,,,,0.00,0,0,0,0,0,0,0,0,0,0,0,0,0
20200528,707637,群聯元大97購02,,,,,,0.00,0,0,0,0,0,0,0,0,0,0,0,0,0
20200528,707638,精測元大96購01,,,,,,0.00,0,0,0,0,0,0,0,0,0,0,0,0,0
20200528,707639,鈊象元大97購01,4.25,4.25,4.25,4.25,+0.10,2.41,1000,1,4250,0,0,0,0,0,0,1000,0,1000,1000
20200528,707640,波若威國票97購01,0.10,0.10,0.10,0.10,-0.08,-44.44,499000,1,49900,0,0,0,0,0,0,499000,0,499000,499000
20200528,707641,聯亞國票97購01,,,,,,0.00,0,0,0,0,0,0,0,0,0,0,0,0,0
20200528,707642,宣德國泰97購01,0.50,0.60,0.50,0.57,+0.07,14.0,68000,5,38840,0,0,0,0,0,0,68000,0,68000,68000
20200528,707643,原相國泰98購01,,,,,,0.00,0,0,0,0,0,0,0,0,0,0,0,0,0
20200528,707644,精測國泰98購01,,,,,,0.00,0,0,0,0,0,0,0,0,0,0,0,0,0
20200528,707645,鈊象國泰98購01,,,,,,0.00,0,0,0,0,0,0,0,0,0,0,0,0,0
20200528,707646,鈊象群益99購01,,,,,,0.00,0,0,0,0,0,0,0,0,0,0,0,0,0
20200528,707647,鈺太中信96購02,,,,,,0.00,0,0,0,0,0,0,0,0,0,0,0,0,0
20200528,707648,雙鴻統一96購01,,,,,,0.00,0,0,0,0,0,0,0,0,0,0,0,0,0
20200528,707649,鈊象統一96購02,,,,,,0.00,0,0,0,0,0,0,0,0,0,0,0,0,0
20200528,707650,宇峻凱基98購01,,,,,,0.00,0,0,0,0,0,0,0,0,0,0,0,0,0
20200528,707651,精測凱基96購03,,,,,,0.00,0,0,0,0,0,0,0,0,0,0,0,0,0
20200528,707652,環球晶凱基96購03,,,,,,0.00,0,0,0,0,0,0,0,0,0,0,0,0,0
20200528,707653,櫃200凱基96購03,,,,,,0.00,0,0,0,0,0,0,0,0,0,0,0,0,0
20200528,707654,雙美凱基97購01,,,,,,0.00,0,0,0,0,0,0,0,0,0,0,0,0,0
20200528,707655,穩懋凱基96購06,,,,,,0.00,0,0,0,0,0,0,0,0,0,0,0,0,0
20200528,707656,鈊象凱基96購01,,,,,,0.00,0,0,0,0,0,0,0,0,0,0,0,0,0
20200528,707657,鈊象凱基97購01,3.99,4.74,3.99,4.74,+1.16,32.4,89000,12,394920,0,0,0,0,0,0,8000,82000,-74000,-74000
20200528,707658,信昌電元富96購01,,,,,,0.00,0,0,0,0,0,0,0,0,0,0,0,0,0
20200528,707659,精測元富96購02,,,,,,0.00,0,0,0,0,0,0,0,0,0,0,0,0,0
20200528,707660,鈊象元富96購01,,,,,,0.00,0,0,0,0,0,0,0,0,0,0,0,0,0
20200528,707661,宣德台新96購01,,,,,,0.00,0,0,0,0,0,0,0,0,0,0,0,0,0
20200528,707662,凡甲國票97購01,1.97,1.97,1.97,1.97,-0.10,-4.83,30000,3,59100,0,0,0,0,0,0,0,30000,-30000,-30000
20200528,707663,世界國票97購01,,,,,,0.00,0,0,0,0,0,0,0,0,0,0,0,0,0
20200528,707664,杰力國票97購01,0.83,0.87,0.77,0.77,-0.06,-7.23,239000,8,200370,0,0,0,0,0,0,5000,234000,-229000,-229000
20200528,707665,原相國票98購01,,,,,,0.00,0,0,0,0,0,0,0,0,0,0,0,0,0
20200528,707666,鈊象國票96購02,,,,,,0.00,0,0,0,0,0,0,0,0,0,0,0,0,0
20200528,707667,精測國泰98購02,0.16,0.16,0.16,0.16,-0.01,-5.88,20000,2,3200,0,0,0,0,0,0,0,20000,-20000,-20000
20200528,707668,合晶富邦96購01,,,,,,0.00,0,0,0,0,0,0,0,0,0,0,0,0,0
20200528,707669,安勤永豐97購01,,,,,,0.00,0,0,0,0,0,0,0,0,0,0,0,0,0
20200528,707670,閎康永豐96購01,,,,,,0.00,0,0,0,0,0,0,0,0,0,0,0,0,0
20200528,707671,精測永豐96購04,,,,,,0.00,0,0,0,0,0,0,0,0,0,0,0,0,0
20200528,707672,晶焱兆豐97購01,,,,,,0.00,0,0,0,0,0,0,0,0,0,0,0,0,0
20200528,707673,雙鴻兆豐97購02,0.13,0.13,0.13,0.13,0.00,0.0,100000,10,13000,0,0,0,0,0,0,0,100000,-100000,-100000
20200528,707674,合晶元大97購01,,,,,,0.00,0,0,0,0,0,0,0,0,0,0,0,0,0
20200528,707675,茂達元大97購01,,,,,,0.00,0,0,0,0,0,0,0,0,0,0,0,0,0
20200528,707676,原相元大97購02,,,,,,0.00,0,0,0,0,0,0,0,0,0,0,0,0,0
20200528,707677,勝麗元大96購02,,,,,,0.00,0,0,0,0,0,0,0,0,0,0,0,0,0
20200528,707678,精測元大98購01,0.02,0.02,0.02,0.02,-0.09,-81.82,40000,1,800,0,0,0,0,0,0,40000,0,40000,40000
20200528,707679,璟德元大96購01,,,,,,0.00,0,0,0,0,0,0,0,0,0,0,0,0,0
20200528,707680,鈊象元大98購01,9.15,10.30,9.15,10.00,+1.75,21.21,24000,6,223800,0,0,0,0,0,0,4000,23000,-19000,-19000
20200528,707681,力麒康和96購01,,,,,,0.00,0,0,0,0,0,0,0,0,0,0,0,0,0
20200528,707682,精測康和96購03,,,,,,0.00,0,0,0,0,0,0,0,0,0,0,0,0,0
20200528,707683,東隆興群益96購01,,,,,,0.00,0,0,0,0,0,0,0,0,0,0,0,0,0
20200528,707684,金居群益98購02,,,,,,0.00,0,0,0,0,0,0,0,0,0,0,0,0,0
20200528,707685,保瑞群益98購02,,,,,,0.00,0,0,0,0,0,0,0,0,0,0,0,0,0
20200528,707686,神盾群益98購01,,,,,,0.00,0,0,0,0,0,0,0,0,0,0,0,0,0
20200528,707687,順達群益96購02,,,,,,0.00,0,0,0,0,0,0,0,0,0,0,0,0,0
20200528,707688,緯軟統一96購01,,,,,,0.00,0,0,0,0,0,0,0,0,0,0,0,0,0
20200528,707689,穩懋統一96購06,,,,,,0.00,0,0,0,0,0,0,0,0,0,0,0,0,0
20200528,707690,鈊象統一96購03,,,,,,0.00,0,0,0,0,0,0,0,0,0,0,0,0,0
20200528,707691,同致元大97購02,,,,,,0.00,0,0,0,0,0,0,0,0,0,0,0,0,0
20200528,707692,迅得元大97購01,,,,,,0.00,0,0,0,0,0,0,0,0,0,0,0,0,0
20200528,707693,晶焱元大97購01,0.62,0.62,0.62,0.62,+0.01,1.64,10000,1,6200,0,0,0,0,0,0,0,10000,-10000,-10000
20200528,707694,群聯元大97購03,,,,,,0.00,0,0,0,0,0,0,0,0,0,0,0,0,0
20200528,707695,優群元大97購02,5.15,5.15,5.15,5.15,+0.54,11.71,1000,1,5150,0,0,0,0,0,0,0,0,0,0
20200528,707696,聯亞元大97購01,,,,,,0.00,0,0,0,0,0,0,0,0,0,0,0,0,0
20200528,707697,穩懋元大96購03,,,,,,0.00,0,0,0,0,0,0,0,0,0,0,0,0,0
20200528,707698,鈊象元大97購02,,,,,,0.00,0,0,0,0,0,0,0,0,0,0,0,0,0
20200528,707699,原相元富96購01,,,,,,0.00,0,0,0,0,0,0,0,0,0,0,0,0,0
20200528,707700,精華元富96購01,,,,,,0.00,0,0,0,0,0,0,0,0,0,0,0,0,0
20200528,707701,環球晶元富96購01,,,,,,0.00,0,0,0,0,0,0,0,0,0,0,0,0,0
20200528,707702,鈊象台新98購01,,,,,,0.00,0,0,0,0,0,0,0,0,0,0,0,0,0
20200528,707703,M31凱基96購01,,,,,,0.00,0,0,0,0,0,0,0,0,0,0,0,0,0
20200528,707704,金可凱基97購01,,,,,,0.00,0,0,0,0,0,0,0,0,0,0,0,0,0
20200528,707705,金居凱基96購01,,,,,,0.00,0,0,0,0,0,0,0,0,0,0,0,0,0
20200528,707706,精華凱基96購02,,,,,,0.00,0,0,0,0,0,0,0,0,0,0,0,0,0
20200528,707707,環球晶凱基96購04,,,,,,0.00,0,0,0,0,0,0,0,0,0,0,0,0,0
20200528,707708,聯亞凱基96購01,,,,,,0.00,0,0,0,0,0,0,0,0,0,0,0,0,0
20200528,707709,鐿鈦凱基97購01,,,,,,0.00,0,0,0,0,0,0,0,0,0,0,0,0,0
20200528,707710,大田國票97購01,0.45,0.45,0.45,0.45,-0.06,-11.76,20000,1,9000,0,0,0,0,0,0,20000,0,20000,20000
20200528,707711,六角國票98購01,0.65,0.65,0.55,0.55,-0.13,-19.12,40000,2,24000,0,0,0,0,0,0,0,40000,-40000,-40000
20200528,707713,晶焱國票97購01,,,,,,0.00,0,0,0,0,0,0,0,0,0,0,0,0,0
20200528,707714,群聯國票97購01,,,,,,0.00,0,0,0,0,0,0,0,0,0,0,0,0,0
20200528,707715,大江國泰98購01,0.15,0.15,0.15,0.15,0.00,0.0,20000,2,3000,0,0,0,0,0,0,0,20000,-20000,-20000
20200528,707716,晶焱國泰98購01,0.35,0.35,0.35,0.35,-0.03,-7.89,40000,1,14000,0,0,0,0,0,0,0,40000,-40000,-40000
20200528,707717,穩懋國泰97購01,,,,,,0.00,0,0,0,0,0,0,0,0,0,0,0,0,0
20200528,707718,良維永豐96購01,,,,,,0.00,0,0,0,0,0,0,0,0,0,0,0,0,0
20200528,707719,威剛永豐96購01,,,,,,0.00,0,0,0,0,0,0,0,0,0,0,0,0,0
20200528,707720,宣德永豐97購01,0.17,0.17,0.17,0.17,+0.02,13.33,1000,1,170,0,0,0,0,0,0,0,1000,-1000,-1000
20200528,707721,鈊象永豐96購03,2.26,2.26,2.26,2.26,+0.44,24.18,10000,1,22600,0,0,0,0,0,0,0,10000,-10000,-10000
20200528,707722,三貝德群益96購01,,,,,,0.00,0,0,0,0,0,0,0,0,0,0,0,0,0
20200528,707723,宜鼎群益96購02,,,,,,0.00,0,0,0,0,0,0,0,0,0,0,0,0,0
20200528,707724,長科*群益96購01,,,,,,0.00,0,0,0,0,0,0,0,0,0,0,0,0,0
20200528,707725,閎康群益97購01,0.32,0.32,0.31,0.31,-0.04,-11.43,363000,4,113530,0,0,0,0,0,0,353000,10000,343000,343000
20200528,707726,晟德群益96購01,,,,,,0.00,0,0,0,0,0,0,0,0,0,0,0,0,0
20200528,707727,鈊象群益99購02,,,,,,0.00,0,0,0,0,0,0,0,0,0,0,0,0,0
20200528,707728,鈊象康和96購03,,,,,,0.00,0,0,0,0,0,0,0,0,0,0,0,0,0
20200528,707729,鈊象凱基98購01,5.75,6.60,5.70,6.50,+1.35,26.21,47000,11,284300,0,0,0,0,0,0,6000,46000,-40000,-40000
20200528,707730,穩懋元富96購01,,,,,,0.00,0,0,0,0,0,0,0,0,0,0,0,0,0
20200528,707731,環球晶亞東97購01,,,,,,0.00,0,0,0,0,0,0,0,0,0,0,0,0,0
20200528,707732,凡甲永豐97購01,0.79,0.79,0.69,0.69,-0.08,-10.39,208000,13,158490,0,0,0,0,0,0,198000,10000,188000,188000
20200528,707733,大宇資永豐96購02,,,,,,0.00,0,0,0,0,0,0,0,0,0,0,0,0,0
20200528,707734,元太國票97購01,4.84,5.20,4.42,4.42,-0.58,-11.6,23000,4,114140,0,0,0,0,0,0,10000,13000,-3000,-3000
20200528,707735,台燿國票97購01,,,,,,0.00,0,0,0,0,0,0,0,0,0,0,0,0,0
20200528,707736,信驊國票97購01,,,,,,0.00,0,0,0,0,0,0,0,0,0,0,0,0,0
20200528,707737,新普國票97購01,,,,,,0.00,0,0,0,0,0,0,0,0,0,0,0,0,0
20200528,707738,聖暉國泰96購01,,,,,,0.00,0,0,0,0,0,0,0,0,0,0,0,0,0
20200528,707739,網家國泰97購01,0.69,0.69,0.69,0.69,+0.06,9.52,5000,1,3450,0,0,0,0,0,0,0,0,0,0
20200528,707740,金可兆豐96購01,,,,,,0.00,0,0,0,0,0,0,0,0,0,0,0,0,0
20200528,707741,胡連康和96購01,,,,,,0.00,0,0,0,0,0,0,0,0,0,0,0,0,0
20200528,707742,佳邦群益96購01,,,,,,0.00,0,0,0,0,0,0,0,0,0,0,0,0,0
20200528,707743,旺矽群益97購01,,,,,,0.00,0,0,0,0,0,0,0,0,0,0,0,0,0
20200528,707744,新普群益98購01,1.44,1.53,1.36,1.53,+0.16,11.68,431000,40,631230,0,0,0,0,0,0,131000,337000,-206000,-206000
20200528,707745,網龍群益98購01,1.09,1.27,1.09,1.27,+0.14,12.39,73000,5,85320,0,0,0,0,0,0,11000,63000,-52000,-52000
20200528,707746,由田元大96購01,,,,,,0.00,0,0,0,0,0,0,0,0,0,0,0,0,0
20200528,707747,信昌電元大97購01,,,,,,0.00,0,0,0,0,0,0,0,0,0,0,0,0,0
20200528,707748,神盾元大99購01,0.31,0.31,0.31,0.31,-0.06,-16.22,1000,1,310,0,0,0,0,0,0,1000,0,1000,1000
20200528,707749,精華元大97購01,,,,,,0.00,0,0,0,0,0,0,0,0,0,0,0,0,0
20200528,707750,穩懋元大97購01,,,,,,0.00,0,0,0,0,0,0,0,0,0,0,0,0,0
20200528,707751,鈺太元大97購01,,,,,,0.00,0,0,0,0,0,0,0,0,0,0,0,0,0
20200528,707752,世界中信98購01,,,,,,0.00,0,0,0,0,0,0,0,0,0,0,0,0,0
20200528,707753,環球晶中信99購02,0.40,0.43,0.37,0.39,0.00,0.0,2108000,65,844930,0,0,0,0,0,0,960000,998000,-38000,-38000
20200528,707754,環球晶統一96購01,,,,,,0.00,0,0,0,0,0,0,0,0,0,0,0,0,0
20200528,707755,穩懋統一96購07,,,,,,0.00,0,0,0,0,0,0,0,0,0,0,0,0,0
20200528,707756,世界凱基96購01,,,,,,0.00,0,0,0,0,0,0,0,0,0,0,0,0,0
20200528,707757,網龍凱基97購01,,,,,,0.00,0,0,0,0,0,0,0,0,0,0,0,0,0
20200528,707758,穩懋凱基96購07,,,,,,0.00,0,0,0,0,0,0,0,0,0,0,0,0,0
20200528,707759,大江元大97購01,,,,,,0.00,0,0,0,0,0,0,0,0,0,0,0,0,0
20200528,707760,世界元大96購02,,,,,,0.00,0,0,0,0,0,0,0,0,0,0,0,0,0
20200528,707761,迅得元大98購01,,,,,,0.00,0,0,0,0,0,0,0,0,0,0,0,0,0
20200528,707762,宣德元大96購03,,,,,,0.00,0,0,0,0,0,0,0,0,0,0,0,0,0
20200528,707763,群聯元大96購04,,,,,,0.00,0,0,0,0,0,0,0,0,0,0,0,0,0
20200528,707764,鈊象元大96購03,,,,,,0.00,0,0,0,0,0,0,0,0,0,0,0,0,0
20200528,707765,原相永昌99購01,2.97,2.97,2.42,2.52,-0.31,-10.95,106000,32,297550,0,0,0,0,0,0,72000,21000,51000,51000
20200528,707766,大田永豐96購01,,,,,,0.00,0,0,0,0,0,0,0,0,0,0,0,0,0
20200528,707767,中美晶永豐96購02,,,,,,0.00,0,0,0,0,0,0,0,0,0,0,0,0,0
20200528,707768,世界永豐96購02,,,,,,0.00,0,0,0,0,0,0,0,0,0,0,0,0,0
20200528,707769,光頡永豐96購01,,,,,,0.00,0,0,0,0,0,0,0,0,0,0,0,0,0
20200528,707770,合晶永豐97購01,,,,,,0.00,0,0,0,0,0,0,0,0,0,0,0,0,0
20200528,707771,精測永豐96購06,,,,,,0.00,0,0,0,0,0,0,0,0,0,0,0,0,0
20200528,707772,精測永豐96購07,,,,,,0.00,0,0,0,0,0,0,0,0,0,0,0,0,0
20200528,707773,穩懋永豐96購01,,,,,,0.00,0,0,0,0,0,0,0,0,0,0,0,0,0
20200528,707774,大宇資國票97購01,0.20,0.20,0.20,0.20,+0.08,66.67,10000,1,2000,0,0,0,0,0,0,10000,0,10000,10000
20200528,707775,良維國票97購02,,,,,,0.00,0,0,0,0,0,0,0,0,0,0,0,0,0
20200528,707776,宜鼎國票97購01,4.05,4.09,4.05,4.09,+0.06,1.49,84000,3,341400,0,0,0,0,0,0,84000,0,84000,84000
20200528,707777,金居國票97購01,,,,,,0.00,0,0,0,0,0,0,0,0,0,0,0,0,0
20200528,707778,信昌電國票97購01,0.58,0.58,0.50,0.50,-0.08,-13.79,298000,2,160920,0,0,0,0,0,0,149000,149000,0,0
20200528,707779,保瑞國票97購01,,,,,,0.00,0,0,0,0,0,0,0,0,0,0,0,0,0
20200528,707780,昇達科富邦98購01,0.24,0.24,0.24,0.24,+0.01,4.35,3000,2,720,0,0,0,0,0,0,3000,0,3000,3000
20200528,707781,宣德麥證96購01,,,,,,0.00,0,0,0,0,0,0,0,0,0,0,0,0,0
20200528,707782,世界台新97購01,,,,,,0.00,0,0,0,0,0,0,0,0,0,0,0,0,0
20200528,707783,泰博兆豐96購02,,,,,,0.00,0,0,0,0,0,0,0,0,0,0,0,0,0
20200528,707784,聚積康和96購01,,,,,,0.00,0,0,0,0,0,0,0,0,0,0,0,0,0
20200528,707785,凡甲群益98購01,1.78,1.78,1.78,1.78,-0.03,-1.66,5000,1,8900,0,0,0,0,0,0,5000,0,5000,5000
20200528,707786,中美晶群益96購01,,,,,,0.00,0,0,0,0,0,0,0,0,0,0,0,0,0
20200528,707787,合晶群益96購01,,,,,,0.00,0,0,0,0,0,0,0,0,0,0,0,0,0
20200528,707788,晶焱群益98購01,,,,,,0.00,0,0,0,0,0,0,0,0,0,0,0,0,0
20200528,707789,精測群益96購04,,,,,,0.00,0,0,0,0,0,0,0,0,0,0,0,0,0
20200528,707790,廣明群益96購01,,,,,,0.00,0,0,0,0,0,0,0,0,0,0,0,0,0
20200528,707791,聯亞群益96購02,,,,,,0.00,0,0,0,0,0,0,0,0,0,0,0,0,0
20200528,707792,鐿鈦群益97購01,0.35,0.35,0.35,0.35,0.00,0.0,10000,1,3500,0,0,0,0,0,0,0,10000,-10000,-10000
20200528,707793,中美晶元大96購02,,,,,,0.00,0,0,0,0,0,0,0,0,0,0,0,0,0
20200528,707794,世界元大96購03,,,,,,0.00,0,0,0,0,0,0,0,0,0,0,0,0,0
20200528,707795,精測元大96購02,,,,,,0.00,0,0,0,0,0,0,0,0,0,0,0,0,0
20200528,707796,聯亞元大96購02,,,,,,0.00,0,0,0,0,0,0,0,0,0,0,0,0,0
20200528,707797,鈊象元大96購04,,,,,,0.00,0,0,0,0,0,0,0,0,0,0,0,0,0
20200528,707798,世界統一97購01,0.50,0.50,0.47,0.47,-0.02,-4.08,80000,2,39700,0,0,0,0,0,0,0,80000,-80000,-80000
20200528,707799,神盾統一98購01,0.36,0.36,0.36,0.36,+0.01,2.86,86000,2,30960,0,0,0,0,0,0,86000,0,86000,86000
20200528,707800,穩懋統一98購02,0.19,0.19,0.19,0.19,-0.01,-5.0,1000,1,190,0,0,0,0,0,0,0,1000,-1000,-1000
20200528,707801,鈊象統一97購02,,,,,,0.00,0,0,0,0,0,0,0,0,0,0,0,0,0
20200528,707802,宣德中信9A購01,0.41,0.43,0.40,0.42,+0.04,10.53,1142000,29,469170,0,0,0,0,0,0,467000,733000,-266000,-266000
20200528,707803,中光電凱基96購01,,,,,,0.00,0,0,0,0,0,0,0,0,0,0,0,0,0
20200528,707804,世界凱基96購02,,,,,,0.00,0,0,0,0,0,0,0,0,0,0,0,0,0
20200528,707805,旺矽凱基96購01,,,,,,0.00,0,0,0,0,0,0,0,0,0,0,0,0,0
20200528,707806,信昌電凱基97購02,,,,,,0.00,0,0,0,0,0,0,0,0,0,0,0,0,0
20200528,707807,佳邦國票97購01,,,,,,0.00,0,0,0,0,0,0,0,0,0,0,0,0,0
20200528,707808,優群國票98購01,,,,,,0.00,0,0,0,0,0,0,0,0,0,0,0,0,0
20200528,707809,中美晶國泰97購01,0.34,0.34,0.34,0.34,-0.02,-5.56,3000,1,1020,0,0,0,0,0,0,0,3000,-3000,-3000
20200528,707810,穩懋麥證96購01,,,,,,0.00,0,0,0,0,0,0,0,0,0,0,0,0,0
20200528,707811,世界元富96購01,,,,,,0.00,0,0,0,0,0,0,0,0,0,0,0,0,0
20200528,707812,茂達元富96購01,,,,,,0.00,0,0,0,0,0,0,0,0,0,0,0,0,0
20200528,707813,群聯元富96購02,,,,,,0.00,0,0,0,0,0,0,0,0,0,0,0,0,0
20200528,707814,穩懋富邦98購01,0.10,0.15,0.10,0.15,-0.01,-6.25,181000,12,19150,0,0,0,0,0,0,0,110000,-110000,-110000
20200528,707815,中美晶台新97購01,0.25,0.25,0.25,0.25,+0.06,31.58,1000,1,250,0,0,0,0,0,0,0,0,0,0
20200528,707816,良維台新97購01,,,,,,0.00,0,0,0,0,0,0,0,0,0,0,0,0,0
20200528,707817,閎康台新96購01,,,,,,0.00,0,0,0,0,0,0,0,0,0,0,0,0,0
20200528,707818,群聯台新97購02,,,,,,0.00,0,0,0,0,0,0,0,0,0,0,0,0,0
20200528,707819,碩禾台新97購01,,,,,,0.00,0,0,0,0,0,0,0,0,0,0,0,0,0
20200528,707820,世界康和96購01,,,,,,0.00,0,0,0,0,0,0,0,0,0,0,0,0,0
20200528,707821,凡甲群益96購01,,,,,,0.00,0,0,0,0,0,0,0,0,0,0,0,0,0
20200528,707822,中美晶群益96購02,,,,,,0.00,0,0,0,0,0,0,0,0,0,0,0,0,0
20200528,707823,宜鼎群益97購01,1.03,1.03,1.03,1.03,-0.06,-5.5,2000,1,2060,0,0,0,0,0,0,2000,0,2000,2000
20200528,707824,環球晶群益96購01,,,,,,0.00,0,0,0,0,0,0,0,0,0,0,0,0,0
20200528,707825,鈊象群益99購03,,,,,,0.00,0,0,0,0,0,0,0,0,0,0,0,0,0
20200528,707826,大江永豐96購02,,,,,,0.00,0,0,0,0,0,0,0,0,0,0,0,0,0
20200528,707827,世界永豐96購03,,,,,,0.00,0,0,0,0,0,0,0,0,0,0,0,0,0
20200528,707828,合晶永豐96購01,,,,,,0.00,0,0,0,0,0,0,0,0,0,0,0,0,0
20200528,707829,博智永豐96購01,,,,,,0.00,0,0,0,0,0,0,0,0,0,0,0,0,0
20200528,707830,網龍永豐96購01,,,,,,0.00,0,0,0,0,0,0,0,0,0,0,0,0,0
20200528,707831,雙美永豐97購01,,,,,,0.00,0,0,0,0,0,0,0,0,0,0,0,0,0
20200528,707832,精測兆豐97購02,,,,,,0.00,0,0,0,0,0,0,0,0,0,0,0,0,0
20200528,707833,網龍兆豐97購01,,,,,,0.00,0,0,0,0,0,0,0,0,0,0,0,0,0
20200528,707834,晟德兆豐97購01,0.67,0.67,0.57,0.57,-0.14,-19.72,345000,15,221080,0,0,0,0,0,0,285000,60000,225000,225000
20200528,707835,原相康和96購01,,,,,,0.00,0,0,0,0,0,0,0,0,0,0,0,0,0
20200528,707836,力旺永豐96購01,,,,,,0.00,0,0,0,0,0,0,0,0,0,0,0,0,0
20200528,707837,良維永豐96購02,,,,,,0.00,0,0,0,0,0,0,0,0,0,0,0,0,0
20200528,707838,佳邦永豐96購01,,,,,,0.00,0,0,0,0,0,0,0,0,0,0,0,0,0
20200528,707839,建榮永豐97購01,,,,,,0.00,0,0,0,0,0,0,0,0,0,0,0,0,0
20200528,707840,晶焱永豐97購01,,,,,,0.00,0,0,0,0,0,0,0,0,0,0,0,0,0
20200528,707841,智崴永豐96購01,,,,,,0.00,0,0,0,0,0,0,0,0,0,0,0,0,0
20200528,707842,精測永豐96購08,,,,,,0.00,0,0,0,0,0,0,0,0,0,0,0,0,0
20200528,707843,鈊象永豐96購04,,,,,,0.00,0,0,0,0,0,0,0,0,0,0,0,0,0
20200528,707844,中美晶元大97購01,,,,,,0.00,0,0,0,0,0,0,0,0,0,0,0,0,0
20200528,707845,台半元大96購01,,,,,,0.00,0,0,0,0,0,0,0,0,0,0,0,0,0
20200528,707846,杰力元大96購03,,,,,,0.00,0,0,0,0,0,0,0,0,0,0,0,0,0
20200528,707847,宣德元大96購04,0.31,0.32,0.31,0.32,-0.09,-21.95,99000,2,30720,0,0,0,0,0,0,0,99000,-99000,-99000
20200528,707848,精測元大96購03,,,,,,0.00,0,0,0,0,0,0,0,0,0,0,0,0,0
20200528,707849,雙鴻元大99購01,,,,,,0.00,0,0,0,0,0,0,0,0,0,0,0,0,0
20200528,707850,鈊象元大97購03,6.20,6.20,6.20,6.20,+2.26,57.36,1000,1,6200,0,0,0,0,0,0,0,1000,-1000,-1000
20200528,707851,群聯麥證96購01,,,,,,0.00,0,0,0,0,0,0,0,0,0,0,0,0,0
20200528,707852,環球晶麥證96購01,,,,,,0.00,0,0,0,0,0,0,0,0,0,0,0,0,0
20200528,707853,雙鴻麥證97購01,,,,,,0.00,0,0,0,0,0,0,0,0,0,0,0,0,0
20200528,707854,合晶台新96購01,,,,,,0.00,0,0,0,0,0,0,0,0,0,0,0,0,0
20200528,707855,良維台新97購02,,,,,,0.00,0,0,0,0,0,0,0,0,0,0,0,0,0
20200528,707856,神盾台新97購01,,,,,,0.00,0,0,0,0,0,0,0,0,0,0,0,0,0
20200528,707857,新普台新97購01,,,,,,0.00,0,0,0,0,0,0,0,0,0,0,0,0,0
20200528,707858,穩懋台新97購01,,,,,,0.00,0,0,0,0,0,0,0,0,0,0,0,0,0
20200528,707859,中美晶國票97購01,,,,,,0.00,0,0,0,0,0,0,0,0,0,0,0,0,0
20200528,707860,同致國票97購02,1.13,1.18,1.10,1.10,+0.14,14.58,89000,11,101420,0,0,0,0,0,0,0,89000,-89000,-89000
20200528,707861,東隆興國票96購01,,,,,,0.00,0,0,0,0,0,0,0,0,0,0,0,0,0
20200528,707862,茂達國票97購01,0.63,0.71,0.63,0.71,+0.10,16.39,99000,2,65730,0,0,0,0,0,0,57000,42000,15000,15000
20200528,707863,穩懋國票97購01,,,,,,0.00,0,0,0,0,0,0,0,0,0,0,0,0,0
20200528,707864,M31凱基98購01,,,,,,0.00,0,0,0,0,0,0,0,0,0,0,0,0,0
20200528,707865,中美晶凱基96購03,,,,,,0.00,0,0,0,0,0,0,0,0,0,0,0,0,0
20200528,707866,合晶凱基96購01,0.06,0.06,0.06,0.06,-0.10,-62.5,11000,1,660,0,0,0,0,0,0,11000,0,11000,11000
20200528,707867,宣德凱基96購02,,,,,,0.00,0,0,0,0,0,0,0,0,0,0,0,0,0
20200528,707868,碩禾凱基97購01,,,,,,0.00,0,0,0,0,0,0,0,0,0,0,0,0,0
20200528,707869,精測凱基96購07,,,,,,0.00,0,0,0,0,0,0,0,0,0,0,0,0,0
20200528,707870,聯亞凱基97購01,,,,,,0.00,0,0,0,0,0,0,0,0,0,0,0,0,0
20200528,707871,精測國泰97購02,,,,,,0.00,0,0,0,0,0,0,0,0,0,0,0,0,0
20200528,707872,精測國泰98購03,,,,,,0.00,0,0,0,0,0,0,0,0,0,0,0,0,0
20200528,707873,鈺太國泰98購01,0.32,0.33,0.28,0.28,-0.13,-31.71,22000,3,7060,0,0,0,0,0,0,12000,10000,2000,2000
20200528,707874,世界富邦98購01,,,,,,0.00,0,0,0,0,0,0,0,0,0,0,0,0,0
20200528,707875,世界群益98購01,0.47,0.47,0.44,0.44,-0.01,-2.22,111000,2,51120,0,0,0,0,0,0,76000,35000,41000,41000
20200528,707876,世界群益98購02,0.31,0.31,0.31,0.31,+0.02,6.9,65000,1,20150,0,0,0,0,0,0,65000,0,65000,65000
20200528,707877,迅得群益97購02,,,,,,0.00,0,0,0,0,0,0,0,0,0,0,0,0,0
20200528,707878,信昌電群益96購01,,,,,,0.00,0,0,0,0,0,0,0,0,0,0,0,0,0
20200528,707879,宣德群益96購02,,,,,,0.00,0,0,0,0,0,0,0,0,0,0,0,0,0
20200528,707880,建榮群益97購01,,,,,,0.00,0,0,0,0,0,0,0,0,0,0,0,0,0
20200528,707881,璟德群益97購01,,,,,,0.00,0,0,0,0,0,0,0,0,0,0,0,0,0
20200528,707882,環球晶群益97購01,,,,,,0.00,0,0,0,0,0,0,0,0,0,0,0,0,0
20200528,707883,力旺元大97購01,1.57,1.70,1.45,1.45,-0.08,-5.23,234000,17,364530,0,0,0,0,0,0,234000,0,234000,234000
20200528,707884,中美晶元大97購02,,,,,,0.00,0,0,0,0,0,0,0,0,0,0,0,0,0
20200528,707885,台燿元大96購01,,,,,,0.00,0,0,0,0,0,0,0,0,0,0,0,0,0
20200528,707886,旺矽元大99購01,0.85,0.85,0.85,0.85,+0.02,2.41,5000,1,4250,0,0,0,0,0,0,0,5000,-5000,-5000
20200528,707887,晶焱元大97購02,,,,,,0.00,0,0,0,0,0,0,0,0,0,0,0,0,0
20200528,707888,精測元大97購02,,,,,,0.00,0,0,0,0,0,0,0,0,0,0,0,0,0
20200528,707889,璟德元大96購02,,,,,,0.00,0,0,0,0,0,0,0,0,0,0,0,0,0
20200528,707890,穩懋元大96購04,,,,,,0.00,0,0,0,0,0,0,0,0,0,0,0,0,0
20200528,707891,力旺凱基96購01,,,,,,0.00,0,0,0,0,0,0,0,0,0,0,0,0,0
20200528,707892,大江凱基96購02,,,,,,0.00,0,0,0,0,0,0,0,0,0,0,0,0,0
20200528,707893,保瑞凱基96購01,,,,,,0.00,0,0,0,0,0,0,0,0,0,0,0,0,0
20200528,707894,璟德凱基96購02,,,,,,0.00,0,0,0,0,0,0,0,0,0,0,0,0,0
20200528,707895,穩懋凱基96購09,,,,,,0.00,0,0,0,0,0,0,0,0,0,0,0,0,0
20200528,707896,中美晶統一96購01,,,,,,0.00,0,0,0,0,0,0,0,0,0,0,0,0,0
20200528,707898,台燿兆豐97購01,,,,,,0.00,0,0,0,0,0,0,0,0,0,0,0,0,0
20200528,707899,威剛群益96購01,0.44,0.44,0.44,0.44,-0.06,-12.0,3000,2,1320,0,0,0,0,0,0,0,3000,-3000,-3000
20200528,707900,宣德群益96購03,,,,,,0.00,0,0,0,0,0,0,0,0,0,0,0,0,0
20200528,707901,精測群益96購05,,,,,,0.00,0,0,0,0,0,0,0,0,0,0,0,0,0
20200528,707902,鈊象群益98購01,5.75,7.00,5.75,6.95,+1.90,37.62,162000,26,1076950,0,0,0,0,0,0,58000,161000,-103000,-103000
20200528,707903,M31永豐96購01,,,,,,0.00,0,0,0,0,0,0,0,0,0,0,0,0,0
20200528,707904,金居永豐96購01,,,,,,0.00,0,0,0,0,0,0,0,0,0,0,0,0,0
20200528,707905,宣德永豐96購01,,,,,,0.00,0,0,0,0,0,0,0,0,0,0,0,0,0
20200528,707906,精測永豐96購09,,,,,,0.00,0,0,0,0,0,0,0,0,0,0,0,0,0
20200528,707907,璟德永豐96購02,,,,,,0.00,0,0,0,0,0,0,0,0,0,0,0,0,0
20200528,707908,優群永豐96購02,2.90,2.90,2.53,2.53,+0.54,27.14,20000,2,54300,0,0,0,0,0,0,20000,0,20000,20000
20200528,707909,凡甲台新96購01,,,,,,0.00,0,0,0,0,0,0,0,0,0,0,0,0,0
20200528,707910,力旺國票97購01,1.03,1.17,0.96,0.96,-0.37,-27.82,1137000,19,1291050,0,0,0,0,0,0,146000,986000,-840000,-840000
20200528,707911,杰力國票97購02,,,,,,0.00,0,0,0,0,0,0,0,0,0,0,0,0,0
20200528,707912,聚積國票97購01,,,,,,0.00,0,0,0,0,0,0,0,0,0,0,0,0,0
20200528,707913,鈊象國票97購01,12.90,15.80,12.90,14.60,+3.60,32.73,17000,6,244700,0,0,0,0,0,0,9000,11000,-2000,-2000
20200528,707914,環球晶國泰97購01,,,,,,0.00,0,0,0,0,0,0,0,0,0,0,0,0,0
20200528,707915,中美晶富邦97購02,0.04,0.04,0.04,0.04,-0.06,-60.0,1000,1,40,0,0,0,0,0,0,1000,0,1000,1000
20200528,707916,聯亞富邦98購01,0.49,0.53,0.48,0.51,+0.03,6.25,343000,7,176950,0,0,0,0,0,0,31000,312000,-281000,-281000
20200528,707917,中美晶麥證96購01,,,,,,0.00,0,0,0,0,0,0,0,0,0,0,0,0,0
20200528,707918,合晶麥證96購01,,,,,,0.00,0,0,0,0,0,0,0,0,0,0,0,0,0
20200528,707919,櫃200第一96購03,,,,,,0.00,0,0,0,0,0,0,0,0,0,0,0,0,0
20200528,707920,櫃200第一96購04,,,,,,0.00,0,0,0,0,0,0,0,0,0,0,0,0,0
20200528,707921,譜瑞兆豐96購01,,,,,,0.00,0,0,0,0,0,0,0,0,0,0,0,0,0
20200528,707922,雍智康和96購01,0.54,0.54,0.54,0.54,-0.09,-14.29,15000,1,8100,0,0,0,0,0,0,15000,0,15000,15000
20200528,707923,力旺群益97購01,,,,,,0.00,0,0,0,0,0,0,0,0,0,0,0,0,0
20200528,707924,中美晶群益97購01,,,,,,0.00,0,0,0,0,0,0,0,0,0,0,0,0,0
20200528,707925,信驊群益96購01,,,,,,0.00,0,0,0,0,0,0,0,0,0,0,0,0,0
20200528,707926,雍智群益96購01,,,,,,0.00,0,0,0,0,0,0,0,0,0,0,0,0,0
20200528,707927,碩禾群益97購01,,,,,,0.00,0,0,0,0,0,0,0,0,0,0,0,0,0
20200528,707928,環球晶群益97購02,2.15,2.15,2.11,2.11,+0.13,6.57,77000,3,164670,0,0,0,0,0,0,57000,22000,35000,35000
20200528,707929,凡甲元大98購01,1.71,1.71,1.69,1.69,-0.10,-5.59,20000,2,34000,0,0,0,0,0,0,0,20000,-20000,-20000
20200528,707930,雍智元大97購01,2.14,2.14,1.72,1.72,-0.35,-16.91,21000,5,40960,0,0,0,0,0,0,16000,4000,12000,12000
20200528,707931,力旺統一96購01,0.57,0.57,0.57,0.57,+0.05,9.62,20000,1,11400,0,0,0,0,0,0,20000,0,20000,20000
20200528,707932,雍智統一97購01,,,,,,0.00,0,0,0,0,0,0,0,0,0,0,0,0,0
20200528,707933,新普中信96購01,,,,,,0.00,0,0,0,0,0,0,0,0,0,0,0,0,0
20200528,707934,雍智中信96購01,,,,,,0.00,0,0,0,0,0,0,0,0,0,0,0,0,0
20200528,707935,大江國票97購03,,,,,,0.00,0,0,0,0,0,0,0,0,0,0,0,0,0
20200528,707936,世界國票97購02,0.15,0.15,0.15,0.15,-0.01,-6.25,5000,1,750,0,0,0,0,0,0,5000,0,5000,5000
20200528,707937,雍智國票96購01,0.58,0.58,0.36,0.36,-0.45,-55.56,204000,6,92450,0,0,0,0,0,0,61000,143000,-82000,-82000
20200528,707938,雙鴻國票97購01,,,,,,0.00,0,0,0,0,0,0,0,0,0,0,0,0,0
20200528,707939,鈺太國票97購01,0.29,0.29,0.29,0.29,-0.14,-32.56,30000,1,8700,0,0,0,0,0,0,30000,0,30000,30000
20200528,707940,弘塑凱基97購01,,,,,,0.00,0,0,0,0,0,0,0,0,0,0,0,0,0
20200528,707941,同致凱基97購01,0.48,0.52,0.48,0.50,+0.04,8.7,170000,6,84900,0,0,0,0,0,0,20000,160000,-140000,-140000
20200528,707942,神盾凱基98購01,,,,,,0.00,0,0,0,0,0,0,0,0,0,0,0,0,0
20200528,707943,雍智凱基96購01,,,,,,0.00,0,0,0,0,0,0,0,0,0,0,0,0,0
20200528,707944,廣明凱基96購01,,,,,,0.00,0,0,0,0,0,0,0,0,0,0,0,0,0
20200528,707945,環球晶凱基96購05,,,,,,0.00,0,0,0,0,0,0,0,0,0,0,0,0,0
20200528,707946,鈊象凱基96購03,,,,,,0.00,0,0,0,0,0,0,0,0,0,0,0,0,0
20200528,707947,力旺麥證96購01,,,,,,0.00,0,0,0,0,0,0,0,0,0,0,0,0,0
20200528,707948,威剛國泰97購01,,,,,,0.00,0,0,0,0,0,0,0,0,0,0,0,0,0
20200528,707949,群聯國泰98購01,,,,,,0.00,0,0,0,0,0,0,0,0,0,0,0,0,0
20200528,707950,雍智國泰98購01,2.04,2.04,2.04,2.04,-0.31,-13.19,20000,1,40800,0,0,0,0,0,0,20000,0,20000,20000
20200528,707951,精測元富99購01,0.06,0.06,0.06,0.06,0.00,0.0,30000,3,1800,0,0,0,0,0,0,0,30000,-30000,-30000
20200528,707952,聯亞元富96購02,,,,,,0.00,0,0,0,0,0,0,0,0,0,0,0,0,0
20200528,707953,力旺台新97購01,0.44,0.44,0.44,0.44,-0.82,-65.08,20000,1,8800,0,0,0,0,0,0,20000,0,20000,20000
20200528,707954,世界台新97購02,,,,,,0.00,0,0,0,0,0,0,0,0,0,0,0,0,0
20200528,707955,櫃200永昌97購01,2.85,2.85,2.77,2.77,-0.25,-8.28,34000,4,95820,0,0,0,0,0,0,24000,10000,14000,14000
20200528,707956,櫃200永昌99購01,,,,,,0.00,0,0,0,0,0,0,0,0,0,0,0,0,0
20200528,707957,櫃200永昌99購02,,,,,,0.00,0,0,0,0,0,0,0,0,0,0,0,0,0
20200528,707958,櫃200永昌99購03,,,,,,0.00,0,0,0,0,0,0,0,0,0,0,0,0,0
20200528,707959,久元永豐96購01,,,,,,0.00,0,0,0,0,0,0,0,0,0,0,0,0,0
20200528,707960,立端永豐96購01,0.12,0.13,0.12,0.12,-0.02,-14.29,113000,3,13660,0,0,0,0,0,0,113000,0,113000,113000
20200528,707961,良維永豐96購03,,,,,,0.00,0,0,0,0,0,0,0,0,0,0,0,0,0
20200528,707962,宜鼎永豐96購01,,,,,,0.00,0,0,0,0,0,0,0,0,0,0,0,0,0
20200528,707963,皇田永豐96購01,0.10,0.10,0.10,0.10,-0.02,-16.67,25000,2,2500,0,0,0,0,0,0,25000,0,25000,25000
20200528,707964,美琪瑪永豐96購01,,,,,,0.00,0,0,0,0,0,0,0,0,0,0,0,0,0
20200528,707965,雍智永豐96購01,0.27,0.27,0.27,0.27,-0.10,-27.03,10000,1,2700,0,0,0,0,0,0,10000,0,10000,10000
20200528,707966,穩懋統一96購08,,,,,,0.00,0,0,0,0,0,0,0,0,0,0,0,0,0
20200528,707967,穩懋統一96購09,,,,,,0.00,0,0,0,0,0,0,0,0,0,0,0,0,0
20200528,707968,穩懋統一96購10,,,,,,0.00,0,0,0,0,0,0,0,0,0,0,0,0,0
20200528,707969,穩懋統一97購03,0.29,0.29,0.29,0.29,-0.01,-3.33,5000,1,1450,0,0,0,0,0,0,5000,0,5000,5000
20200528,707970,鈊象統一97購03,,,,,,0.00,0,0,0,0,0,0,0,0,0,0,0,0,0
20200528,707971,中美晶中信96購01,,,,,,0.00,0,0,0,0,0,0,0,0,0,0,0,0,0
20200528,707972,同致中信98購01,,,,,,0.00,0,0,0,0,0,0,0,0,0,0,0,0,0
20200528,707973,環球晶中信9C購01,0.51,0.52,0.50,0.50,+0.01,2.04,102000,3,52390,0,0,0,0,0,0,30000,72000,-42000,-42000
20200528,707974,世界凱基96購03,,,,,,0.00,0,0,0,0,0,0,0,0,0,0,0,0,0
20200528,707975,金居凱基96購02,,,,,,0.00,0,0,0,0,0,0,0,0,0,0,0,0,0
20200528,707976,環球晶凱基96購06,,,,,,0.00,0,0,0,0,0,0,0,0,0,0,0,0,0
20200528,707977,穩懋凱基96購10,,,,,,0.00,0,0,0,0,0,0,0,0,0,0,0,0,0
20200528,707978,大江群益97購01,,,,,,0.00,0,0,0,0,0,0,0,0,0,0,0,0,0
20200528,707979,原相群益98購01,,,,,,0.00,0,0,0,0,0,0,0,0,0,0,0,0,0
20200528,707980,弘塑國票97購01,,,,,,0.00,0,0,0,0,0,0,0,0,0,0,0,0,0
20200528,707981,宜鼎國票97購02,3.27,3.43,3.27,3.30,+0.10,3.13,35000,4,119110,0,0,0,0,0,0,28000,7000,21000,21000
20200528,707983,環球晶國票97購01,1.46,1.46,1.46,1.46,+0.16,12.31,2000,1,2920,0,0,0,0,0,0,2000,0,2000,2000
20200528,707984,緯軟國泰97購01,,,,,,0.00,0,0,0,0,0,0,0,0,0,0,0,0,0
20200528,707985,櫃200永昌9B購01,,,,,,0.00,0,0,0,0,0,0,0,0,0,0,0,0,0
20200528,707986,櫃200永昌9C購01,,,,,,0.00,0,0,0,0,0,0,0,0,0,0,0,0,0
20200528,707987,櫃200永昌9C購02,,,,,,0.00,0,0,0,0,0,0,0,0,0,0,0,0,0
20200528,707988,櫃200永昌9C購03,,,,,,0.00,0,0,0,0,0,0,0,0,0,0,0,0,0
20200528,707989,大宇資第一96購01,,,,,,0.00,0,0,0,0,0,0,0,0,0,0,0,0,0
20200528,707990,凡甲永豐96購01,,,,,,0.00,0,0,0,0,0,0,0,0,0,0,0,0,0
20200528,707991,弘塑永豐96購01,,,,,,0.00,0,0,0,0,0,0,0,0,0,0,0,0,0
20200528,707992,昇達科永豐96購01,,,,,,0.00,0,0,0,0,0,0,0,0,0,0,0,0,0
20200528,707993,波若威永豐97購01,0.08,0.08,0.07,0.07,-0.07,-50.0,30000,3,2300,0,0,0,0,0,0,0,30000,-30000,-30000
20200528,707994,威剛永豐96購02,,,,,,0.00,0,0,0,0,0,0,0,0,0,0,0,0,0
20200528,707995,原相永豐96購01,,,,,,0.00,0,0,0,0,0,0,0,0,0,0,0,0,0
20200528,707996,神盾永豐96購01,,,,,,0.00,0,0,0,0,0,0,0,0,0,0,0,0,0
20200528,707997,網龍永豐96購02,0.93,0.93,0.93,0.93,+0.18,24.0,3000,1,2790,0,0,0,0,0,0,3000,0,3000,3000
20200528,707998,廣明永豐96購02,,,,,,0.00,0,0,0,0,0,0,0,0,0,0,0,0,0
20200528,707999,聯亞永豐96購01,,,,,,0.00,0,0,0,0,0,0,0,0,0,0,0,0,0
20200528,708000,雙鴻永豐97購01,,,,,,0.00,0,0,0,0,0,0,0,0,0,0,0,0,0
20200528,708001,世界元大96購05,0.22,0.22,0.18,0.18,-0.04,-18.18,14000,2,2880,0,0,0,0,0,0,14000,0,14000,14000
20200528,708002,合晶元大97購02,,,,,,0.00,0,0,0,0,0,0,0,0,0,0,0,0,0
20200528,708003,宜鼎元大96購01,,,,,,0.00,0,0,0,0,0,0,0,0,0,0,0,0,0
20200528,708004,雍智元大97購02,,,,,,0.00,0,0,0,0,0,0,0,0,0,0,0,0,0
20200528,708005,精測元大97購03,,,,,,0.00,0,0,0,0,0,0,0,0,0,0,0,0,0
20200528,708006,精華元大96購03,,,,,,0.00,0,0,0,0,0,0,0,0,0,0,0,0,0
20200528,708007,雍智元富96購01,0.66,0.66,0.45,0.45,-0.22,-32.84,134000,4,84350,0,0,0,0,0,0,111000,23000,88000,88000
20200528,708008,精測元富96購03,,,,,,0.00,0,0,0,0,0,0,0,0,0,0,0,0,0
20200528,708009,精測台新96購01,,,,,,0.00,0,0,0,0,0,0,0,0,0,0,0,0,0
20200528,708010,璟德台新96購01,,,,,,0.00,0,0,0,0,0,0,0,0,0,0,0,0,0
20200528,708011,良維兆豐97購01,0.95,0.95,0.89,0.89,-0.04,-4.3,140000,5,131000,0,0,0,0,0,0,120000,20000,100000,100000
20200528,708012,聚積兆豐97購01,,,,,,0.00,0,0,0,0,0,0,0,0,0,0,0,0,0
20200528,708013,廣明兆豐96購01,,,,,,0.00,0,0,0,0,0,0,0,0,0,0,0,0,0
20200528,708014,聯亞兆豐97購01,2.07,2.17,2.07,2.17,+0.01,0.46,130000,3,278070,0,0,0,0,0,0,7000,123000,-116000,-116000
20200528,708015,鈺太康和96購01,,,,,,0.00,0,0,0,0,0,0,0,0,0,0,0,0,0
20200528,708016,新普群益98購02,1.30,1.39,1.21,1.39,+0.17,13.93,634000,24,851720,0,0,0,0,0,0,419000,239000,180000,180000
20200528,708017,精測群益96購06,,,,,,0.00,0,0,0,0,0,0,0,0,0,0,0,0,0
20200528,708018,雙鴻群益98購01,,,,,,0.00,0,0,0,0,0,0,0,0,0,0,0,0,0
20200528,708019,世界麥證96購01,,,,,,0.00,0,0,0,0,0,0,0,0,0,0,0,0,0
20200528,708020,世界元富96購02,,,,,,0.00,0,0,0,0,0,0,0,0,0,0,0,0,0
20200528,708021,勝麗元富96購01,,,,,,0.00,0,0,0,0,0,0,0,0,0,0,0,0,0
20200528,708022,璟德元富96購01,,,,,,0.00,0,0,0,0,0,0,0,0,0,0,0,0,0
20200528,708023,鈺太元富96購01,,,,,,0.00,0,0,0,0,0,0,0,0,0,0,0,0,0
20200528,708024,金居中信9C購01,0.29,0.31,0.26,0.26,-0.05,-16.13,606000,30,171660,0,0,0,0,0,0,235000,329000,-94000,-94000
20200528,708025,勝麗中信9A購01,0.29,0.29,0.26,0.26,-0.03,-10.34,515000,12,136250,0,0,0,0,0,0,15000,500000,-485000,-485000
20200528,708026,群聯永豐96購01,,,,,,0.00,0,0,0,0,0,0,0,0,0,0,0,0,0
20200528,708027,精測永豐96購10,,,,,,0.00,0,0,0,0,0,0,0,0,0,0,0,0,0
20200528,708028,鈺太永豐96購01,,,,,,0.00,0,0,0,0,0,0,0,0,0,0,0,0,0
20200528,708029,旺矽國票97購01,0.38,0.40,0.32,0.32,-0.06,-15.79,455000,45,161450,0,0,0,0,0,0,15000,440000,-425000,-425000
20200528,708030,精華國票97購01,,,,,,0.00,0,0,0,0,0,0,0,0,0,0,0,0,0
20200528,708031,中美晶凱基96購04,,,,,,0.00,0,0,0,0,0,0,0,0,0,0,0,0,0
20200528,708032,六角凱基97購01,0.37,0.37,0.37,0.37,-0.05,-11.9,10000,1,3700,0,0,0,0,0,0,10000,0,10000,10000
20200528,708034,勝麗凱基96購01,,,,,,0.00,0,0,0,0,0,0,0,0,0,0,0,0,0
20200528,708035,博智凱基96購01,,,,,,0.00,0,0,0,0,0,0,0,0,0,0,0,0,0
20200528,708036,優群凱基98購01,2.79,2.89,2.61,2.89,+0.54,22.98,36000,4,99540,0,0,0,0,0,0,10000,26000,-16000,-16000
20200528,708037,環球晶凱基96購07,,,,,,0.00,0,0,0,0,0,0,0,0,0,0,0,0,0
20200528,708038,穩懋凱基96購11,,,,,,0.00,0,0,0,0,0,0,0,0,0,0,0,0,0
20200528,708039,宣德國泰98購01,,,,,,0.00,0,0,0,0,0,0,0,0,0,0,0,0,0
20200528,708040,雍智國泰98購02,3.43,3.43,3.43,3.43,-0.22,-6.03,10000,1,34300,0,0,0,0,0,0,10000,0,10000,10000
20200528,708041,精測國泰98購04,,,,,,0.00,0,0,0,0,0,0,0,0,0,0,0,0,0
20200528,708042,精測國泰99購01,,,,,,0.00,0,0,0,0,0,0,0,0,0,0,0,0,0
20200528,708043,精測國泰9A購01,,,,,,0.00,0,0,0,0,0,0,0,0,0,0,0,0,0
20200528,708044,雙鴻富邦97購02,,,,,,0.00,0,0,0,0,0,0,0,0,0,0,0,0,0
20200528,708045,大江元大97購02,,,,,,0.00,0,0,0,0,0,0,0,0,0,0,0,0,0
20200528,708046,中美晶元大96購03,,,,,,0.00,0,0,0,0,0,0,0,0,0,0,0,0,0
20200528,708047,世界元大96購06,,,,,,0.00,0,0,0,0,0,0,0,0,0,0,0,0,0
20200528,708048,合晶元大96購05,,,,,,0.00,0,0,0,0,0,0,0,0,0,0,0,0,0
20200528,708049,信驊元大96購01,,,,,,0.00,0,0,0,0,0,0,0,0,0,0,0,0,0
20200528,708050,雍智元大96購01,,,,,,0.00,0,0,0,0,0,0,0,0,0,0,0,0,0
20200528,708051,精測元大96購04,,,,,,0.00,0,0,0,0,0,0,0,0,0,0,0,0,0
20200528,708052,穩懋元大96購05,,,,,,0.00,0,0,0,0,0,0,0,0,0,0,0,0,0
20200528,708053,鈺太元大97購02,,,,,,0.00,0,0,0,0,0,0,0,0,0,0,0,0,0
20200528,708054,力旺元富96購01,,,,,,0.00,0,0,0,0,0,0,0,0,0,0,0,0,0
20200528,708055,金可中信9A購01,0.05,0.06,0.05,0.05,0.00,0.0,270000,6,14800,0,0,0,0,0,0,40000,210000,-170000,-170000
20200528,708056,聖暉統一99購01,,,,,,0.00,0,0,0,0,0,0,0,0,0,0,0,0,0
20200528,708057,大江凱基98購01,0.06,0.10,0.06,0.10,0.00,0.0,11000,2,700,0,0,0,0,0,0,0,0,0,0
20200528,708058,良維凱基98購01,0.32,0.32,0.32,0.32,0.00,0.0,40000,1,12800,0,0,0,0,0,0,40000,0,40000,40000
20200528,708059,旺矽凱基98購01,,,,,,0.00,0,0,0,0,0,0,0,0,0,0,0,0,0
20200528,708060,信驊凱基96購02,3.52,3.52,3.52,3.52,+0.58,19.73,20000,1,70400,0,0,0,0,0,0,20000,0,20000,20000
20200528,708061,雍智凱基98購01,0.70,0.70,0.60,0.60,-0.11,-15.49,106000,6,68400,0,0,0,0,0,0,66000,40000,26000,26000
20200528,708062,精測凱基99購01,,,,,,0.00,0,0,0,0,0,0,0,0,0,0,0,0,0
20200528,708063,緯軟凱基98購01,0.05,0.05,0.05,0.05,0.00,0.0,14000,1,700,0,0,0,0,0,0,14000,0,14000,14000
20200528,708064,環球晶凱基96購08,,,,,,0.00,0,0,0,0,0,0,0,0,0,0,0,0,0
20200528,708065,力旺永豐96購02,0.41,0.41,0.33,0.33,-0.17,-34.0,24000,3,9580,0,0,0,0,0,0,22000,2000,20000,20000
20200528,708066,同致永豐96購01,,,,,,0.00,0,0,0,0,0,0,0,0,0,0,0,0,0
20200528,708067,迅得永豐97購02,,,,,,0.00,0,0,0,0,0,0,0,0,0,0,0,0,0
20200528,708068,欣銓永豐96購01,,,,,,0.00,0,0,0,0,0,0,0,0,0,0,0,0,0
20200528,708069,弘塑康和9C購01,0.41,0.41,0.41,0.41,-0.01,-2.38,2000,1,820,0,0,0,0,0,0,2000,0,2000,2000
20200528,708070,大田群益96購01,0.35,0.35,0.34,0.34,-0.01,-2.86,60000,11,20800,0,0,0,0,0,0,60000,0,60000,60000
20200528,708071,合晶群益96購02,0.45,0.45,0.45,0.45,-0.03,-6.25,20000,1,9000,0,0,0,0,0,0,20000,0,20000,20000
20200528,708072,信昌電群益96購02,,,,,,0.00,0,0,0,0,0,0,0,0,0,0,0,0,0
20200528,708073,茂達群益98購01,0.54,0.62,0.51,0.51,0.00,0.0,504000,18,284970,0,0,0,0,0,0,334000,144000,190000,190000
20200528,708074,大宇資國票97購02,,,,,,0.00,0,0,0,0,0,0,0,0,0,0,0,0,0
20200528,708075,雙鴻國票97購02,,,,,,0.00,0,0,0,0,0,0,0,0,0,0,0,0,0
20200528,708076,力旺國泰98購01,0.81,0.81,0.81,0.81,-0.18,-18.18,10000,1,8100,0,0,0,0,0,0,10000,0,10000,10000
20200528,708077,威剛富邦98購01,0.11,0.11,0.10,0.10,-0.01,-9.09,40000,3,4200,0,0,0,0,0,0,20000,20000,0,0
20200528,708078,勝麗富邦97購01,,,,,,0.00,0,0,0,0,0,0,0,0,0,0,0,0,0
20200528,708079,群聯富邦98購01,0.14,0.14,0.14,0.14,+0.02,16.67,2000,1,280,0,0,0,0,0,0,0,0,0,0
20200528,708080,精測富邦97購01,,,,,,0.00,0,0,0,0,0,0,0,0,0,0,0,0,0
20200528,708081,信驊元大96購02,6.60,6.60,6.60,6.60,+0.85,14.78,10000,1,66000,0,0,0,0,0,0,0,10000,-10000,-10000
20200528,708082,新普元大97購01,1.43,1.43,1.43,1.43,+0.17,13.49,1000,1,1430,0,0,0,0,0,0,0,1000,-1000,-1000
20200528,708083,環球晶元大96購03,0.36,0.36,0.33,0.33,-0.07,-17.5,136000,3,46920,0,0,0,0,0,0,68000,68000,0,0
20200528,708084,環球晶元大97購01,1.66,1.71,1.64,1.67,-0.03,-1.76,58000,5,98360,0,0,0,0,0,0,2000,56000,-54000,-54000
20200528,708085,穩懋元大96購06,,,,,,0.00,0,0,0,0,0,0,0,0,0,0,0,0,0
20200528,708086,穩懋元大96購07,,,,,,0.00,0,0,0,0,0,0,0,0,0,0,0,0,0
20200528,708087,群聯元富96購03,,,,,,0.00,0,0,0,0,0,0,0,0,0,0,0,0,0
20200528,708088,群聯兆豐97購01,,,,,,0.00,0,0,0,0,0,0,0,0,0,0,0,0,0
20200528,708089,精測兆豐97購03,,,,,,0.00,0,0,0,0,0,0,0,0,0,0,0,0,0
20200528,708090,穩懋兆豐96購04,,,,,,0.00,0,0,0,0,0,0,0,0,0,0,0,0,0
20200528,708091,久元康和96購01,1.07,1.14,1.07,1.14,+0.26,29.55,43000,3,46710,0,0,0,0,0,0,0,43000,-43000,-43000
20200528,708092,櫃200永昌98購01,,,,,,0.00,0,0,0,0,0,0,0,0,0,0,0,0,0
20200528,708093,櫃200永昌98購02,,,,,,0.00,0,0,0,0,0,0,0,0,0,0,0,0,0
20200528,708094,大學光群益98購01,,,,,,0.00,0,0,0,0,0,0,0,0,0,0,0,0,0
20200528,708095,VHQ中信96購01,,,,,,0.00,0,0,0,0,0,0,0,0,0,0,0,0,0
20200528,708096,合晶中信9A購01,0.26,0.26,0.26,0.26,+0.02,8.33,130000,4,33800,0,0,0,0,0,0,0,130000,-130000,-130000
20200528,708097,宣德中信9A購02,0.19,0.21,0.18,0.20,+0.02,11.11,1215000,24,241980,0,0,0,0,0,0,1147000,68000,1079000,1079000
20200528,708098,群聯中信9A購01,0.08,0.10,0.08,0.10,+0.03,42.86,30000,3,2600,0,0,0,0,0,0,0,20000,-20000,-20000
20200528,708099,M31凱基97購02,,,,,,0.00,0,0,0,0,0,0,0,0,0,0,0,0,0
20200528,708100,大江凱基96購03,,,,,,0.00,0,0,0,0,0,0,0,0,0,0,0,0,0
20200528,708101,合晶凱基97購01,,,,,,0.00,0,0,0,0,0,0,0,0,0,0,0,0,0
20200528,708102,良維凱基97購01,,,,,,0.00,0,0,0,0,0,0,0,0,0,0,0,0,0
20200528,708103,宜鼎凱基96購02,2.05,2.15,2.05,2.15,+0.08,3.86,40000,4,84300,0,0,0,0,0,0,10000,30000,-20000,-20000
20200528,708104,晶焱凱基98購01,0.05,0.05,0.05,0.05,-0.05,-50.0,200000,1,10000,0,0,0,0,0,0,200000,0,200000,200000
20200528,708105,旺矽統一97購01,,,,,,0.00,0,0,0,0,0,0,0,0,0,0,0,0,0
20200528,708106,宣德統一97購02,0.32,0.32,0.32,0.32,-0.01,-3.03,1000,1,320,0,0,0,0,0,0,0,1000,-1000,-1000
20200528,708107,大江永豐96購03,,,,,,0.00,0,0,0,0,0,0,0,0,0,0,0,0,0
20200528,708109,昇達科永豐96購02,,,,,,0.00,0,0,0,0,0,0,0,0,0,0,0,0,0
20200528,708110,博智永豐96購02,0.71,0.71,0.67,0.67,-0.12,-15.19,40000,2,27880,0,0,0,0,0,0,27000,13000,14000,14000
20200528,708111,新鉅科永豐96購01,,,,,,0.00,0,0,0,0,0,0,0,0,0,0,0,0,0
20200528,708112,晟德永豐96購01,0.60,0.66,0.54,0.54,-0.15,-21.74,89000,7,51290,0,0,0,0,0,0,66000,23000,43000,43000
20200528,708113,世界元大96購07,,,,,,0.00,0,0,0,0,0,0,0,0,0,0,0,0,0
20200528,708114,良維元大97購02,0.39,0.39,0.39,0.39,-0.03,-7.14,50000,1,19500,0,0,0,0,0,0,50000,0,50000,50000
20200528,708115,佳邦元大96購01,,,,,,0.00,0,0,0,0,0,0,0,0,0,0,0,0,0
20200528,708117,廣明元大97購01,,,,,,0.00,0,0,0,0,0,0,0,0,0,0,0,0,0
20200528,708118,環球晶元大96購04,,,,,,0.00,0,0,0,0,0,0,0,0,0,0,0,0,0
20200528,708119,環球晶元大97購02,,,,,,0.00,0,0,0,0,0,0,0,0,0,0,0,0,0
20200528,708120,穩懋元大96購10,,,,,,0.00,0,0,0,0,0,0,0,0,0,0,0,0,0
20200528,708121,M31國票97購01,0.50,0.50,0.50,0.50,+0.07,16.28,1000,1,500,0,0,0,0,0,0,0,0,0,0
20200528,708122,六角國票98購02,0.83,0.83,0.74,0.74,-0.11,-12.94,318000,6,252220,0,0,0,0,0,0,308000,10000,298000,298000
20200528,708123,原相國票97購01,1.59,1.59,1.31,1.31,-0.29,-18.12,167000,11,243180,0,0,0,0,0,0,158000,9000,149000,149000
20200528,708124,神盾國票97購02,0.22,0.22,0.22,0.22,-0.03,-12.0,40000,1,8800,0,0,0,0,0,0,40000,0,40000,40000
20200528,708125,碩禾國票97購01,0.09,0.09,0.08,0.08,-0.01,-11.11,185000,4,15700,0,0,0,0,0,0,45000,140000,-95000,-95000
20200528,708126,環宇國票97購01,,,,,,0.00,0,0,0,0,0,0,0,0,0,0,0,0,0
20200528,708128,環球晶國泰97購02,0.48,0.48,0.48,0.48,-0.07,-12.73,10000,1,4800,0,0,0,0,0,0,10000,0,10000,10000
20200528,708129,力旺元大96購01,0.97,0.97,0.83,0.83,-0.07,-7.78,235000,4,221250,0,0,0,0,0,0,100000,135000,-35000,-35000
20200528,708130,台燿元大96購02,0.45,0.45,0.42,0.45,-0.04,-8.16,514000,8,223390,0,0,0,0,0,0,267000,247000,20000,20000
20200528,708131,泰博元大96購01,,,,,,0.00,0,0,0,0,0,0,0,0,0,0,0,0,0
20200528,708132,博智元大97購01,,,,,,0.00,0,0,0,0,0,0,0,0,0,0,0,0,0
20200528,708133,網家元大96購01,,,,,,0.00,0,0,0,0,0,0,0,0,0,0,0,0,0
20200528,708134,穩懋元大96購11,,,,,,0.00,0,0,0,0,0,0,0,0,0,0,0,0,0
20200528,708135,群聯群益96購04,,,,,,0.00,0,0,0,0,0,0,0,0,0,0,0,0,0
20200528,708136,宇峻凱基98購02,,,,,,0.00,0,0,0,0,0,0,0,0,0,0,0,0,0
20200528,708137,旺矽凱基97購01,0.34,0.34,0.28,0.28,-0.04,-12.5,200000,3,62800,0,0,0,0,0,0,70000,130000,-60000,-60000
20200528,708138,原相凱基98購01,,,,,,0.00,0,0,0,0,0,0,0,0,0,0,0,0,0
20200528,708139,精華凱基97購01,,,,,,0.00,0,0,0,0,0,0,0,0,0,0,0,0,0
20200528,708140,優群凱基98購02,,,,,,0.00,0,0,0,0,0,0,0,0,0,0,0,0,0
20200528,708141,鈊象凱基98購02,5.20,5.90,5.15,5.90,+1.27,27.43,55000,11,319950,0,0,0,0,0,0,43000,43000,0,0
20200528,708142,宣德台新96購02,,,,,,0.00,0,0,0,0,0,0,0,0,0,0,0,0,0
20200528,708143,大江永豐97購01,0.22,0.22,0.22,0.22,-0.02,-8.33,410000,2,90200,0,0,0,0,0,0,410000,0,410000,410000
20200528,708144,杰力永豐96購01,,,,,,0.00,0,0,0,0,0,0,0,0,0,0,0,0,0
20200528,708145,直得永豐96購01,0.44,0.44,0.17,0.17,-0.38,-69.09,345000,5,66750,0,0,0,0,0,0,245000,0,245000,245000
20200528,708146,信昌電永豐96購02,0.61,0.62,0.54,0.54,-0.10,-15.62,140000,5,84860,0,0,0,0,0,0,90000,50000,40000,40000
20200528,708147,保瑞永豐96購01,0.19,0.19,0.19,0.19,-0.03,-13.64,5000,1,950,0,0,0,0,0,0,5000,0,5000,5000
20200528,708148,胡連永豐96購01,,,,,,0.00,0,0,0,0,0,0,0,0,0,0,0,0,0
20200528,708149,精測永豐96購12,,,,,,0.00,0,0,0,0,0,0,0,0,0,0,0,0,0
20200528,708150,聚積永豐96購01,,,,,,0.00,0,0,0,0,0,0,0,0,0,0,0,0,0
20200528,708151,雙鴻永豐97購02,,,,,,0.00,0,0,0,0,0,0,0,0,0,0,0,0,0
20200528,708152,力旺中信96購01,,,,,,0.00,0,0,0,0,0,0,0,0,0,0,0,0,0
20200528,708153,建榮統一98購01,,,,,,0.00,0,0,0,0,0,0,0,0,0,0,0,0,0
20200528,708154,大江凱基98購02,0.06,0.11,0.06,0.11,-0.01,-8.33,17000,2,1070,0,0,0,0,0,0,0,0,0,0
20200528,708155,宇峻凱基98購03,,,,,,0.00,0,0,0,0,0,0,0,0,0,0,0,0,0
20200528,708157,金居凱基97購01,,,,,,0.00,0,0,0,0,0,0,0,0,0,0,0,0,0
20200528,708158,鐿鈦凱基96購03,,,,,,0.00,0,0,0,0,0,0,0,0,0,0,0,0,0
20200528,708159,大江元大97購03,,,,,,0.00,0,0,0,0,0,0,0,0,0,0,0,0,0
20200528,708160,合晶元大98購01,,,,,,0.00,0,0,0,0,0,0,0,0,0,0,0,0,0
20200528,708162,欣銓元大96購01,,,,,,0.00,0,0,0,0,0,0,0,0,0,0,0,0,0
20200528,708163,威剛元大98購01,,,,,,0.00,0,0,0,0,0,0,0,0,0,0,0,0,0
20200528,708164,環球晶元大96購05,0.08,0.08,0.08,0.08,-0.01,-11.11,10000,1,800,0,0,0,0,0,0,10000,0,10000,10000
20200528,708165,環球晶元大97購03,,,,,,0.00,0,0,0,0,0,0,0,0,0,0,0,0,0
20200528,708166,凡甲永豐96購02,,,,,,0.00,0,0,0,0,0,0,0,0,0,0,0,0,0
20200528,708167,台燿永豐96購01,0.06,0.06,0.06,0.06,0.00,0.0,450000,2,27000,0,0,0,0,0,0,450000,0,450000,450000
20200528,708168,波若威永豐97購02,0.54,0.54,0.54,0.54,-0.02,-3.57,50000,2,27000,0,0,0,0,0,0,50000,0,50000,50000
20200528,708169,網家永豐96購01,,,,,,0.00,0,0,0,0,0,0,0,0,0,0,0,0,0
20200528,708170,網龍永豐96購03,1.48,1.63,1.41,1.44,+0.16,12.5,71000,13,108790,0,0,0,0,0,0,21000,50000,-29000,-29000
20200528,708171,優群永豐96購03,,,,,,0.00,0,0,0,0,0,0,0,0,0,0,0,0,0
20200528,708172,緯軟兆豐97購01,,,,,,0.00,0,0,0,0,0,0,0,0,0,0,0,0,0
20200528,708173,鈺太兆豐97購01,0.11,0.11,0.11,0.11,0.00,0.0,10000,1,1100,0,0,0,0,0,0,0,0,0,0
20200528,708174,胡連康和96購02,0.23,0.23,0.23,0.23,-0.06,-20.69,5000,1,1150,0,0,0,0,0,0,5000,0,5000,5000
20200528,708175,精華群益96購02,,,,,,0.00,0,0,0,0,0,0,0,0,0,0,0,0,0
20200528,708176,中美晶國票97購02,,,,,,0.00,0,0,0,0,0,0,0,0,0,0,0,0,0
20200528,708177,欣銓富邦97購01,,,,,,0.00,0,0,0,0,0,0,0,0,0,0,0,0,0
20200528,708178,鈊象富邦97購01,,,,,,0.00,0,0,0,0,0,0,0,0,0,0,0,0,0
20200528,708179,神盾元富98購01,,,,,,0.00,0,0,0,0,0,0,0,0,0,0,0,0,0
20200528,708180,群聯元富96購04,,,,,,0.00,0,0,0,0,0,0,0,0,0,0,0,0,0
20200528,708181,VHQ統一96購01,,,,,,0.00,0,0,0,0,0,0,0,0,0,0,0,0,0
20200528,708182,凡甲統一96購01,,,,,,0.00,0,0,0,0,0,0,0,0,0,0,0,0,0
20200528,708183,中美晶凱基96購05,,,,,,0.00,0,0,0,0,0,0,0,0,0,0,0,0,0
20200528,708184,建榮凱基96購02,,,,,,0.00,0,0,0,0,0,0,0,0,0,0,0,0,0
20200528,708185,原相凱基97購01,0.79,0.79,0.79,0.79,-0.05,-5.95,5000,1,3950,0,0,0,0,0,0,0,5000,-5000,-5000
20200528,708186,神盾凱基96購03,,,,,,0.00,0,0,0,0,0,0,0,0,0,0,0,0,0
20200528,708187,金居兆豐97購01,1.12,1.12,1.06,1.06,-0.16,-13.11,200000,3,218000,0,0,0,0,0,0,100000,100000,0,0
20200528,708188,威剛兆豐97購01,0.51,0.52,0.48,0.48,0.00,0.0,252000,5,121030,0,0,0,0,0,0,251000,251000,0,0
20200528,708189,茂達群益98購02,1.16,1.23,1.12,1.15,+0.06,5.5,378000,17,450020,0,0,0,0,0,0,336000,42000,294000,294000
20200528,708190,六角元大96購02,,,,,,0.00,0,0,0,0,0,0,0,0,0,0,0,0,0
20200528,708191,同致元大96購02,0.49,0.51,0.49,0.49,0.00,0.0,49000,5,24310,0,0,0,0,0,0,39000,49000,-10000,-10000
20200528,708192,旺矽元大97購01,1.42,1.42,1.21,1.21,-0.22,-15.38,188000,7,255220,0,0,0,0,0,0,149000,39000,110000,110000
20200528,708193,直得元大96購01,,,,,,0.00,0,0,0,0,0,0,0,0,0,0,0,0,0
20200528,708194,宣德元大97購01,1.59,1.75,1.56,1.70,-0.01,-0.58,268000,12,441370,0,0,0,0,0,0,50000,218000,-168000,-168000
20200528,708195,精測元大96購07,,,,,,0.00,0,0,0,0,0,0,0,0,0,0,0,0,0
20200528,708196,環宇元大96購02,,,,,,0.00,0,0,0,0,0,0,0,0,0,0,0,0,0
20200528,708197,合晶亞東97購01,,,,,,0.00,0,0,0,0,0,0,0,0,0,0,0,0,0
20200528,708198,三貝德永豐96購01,,,,,,0.00,0,0,0,0,0,0,0,0,0,0,0,0,0
20200528,708199,大田永豐96購02,0.34,0.34,0.34,0.34,-0.04,-10.53,10000,1,3400,0,0,0,0,0,0,10000,0,10000,10000
20200528,708200,中美晶永豐96購03,,,,,,0.00,0,0,0,0,0,0,0,0,0,0,0,0,0
20200528,708201,金居永豐96購02,0.43,0.43,0.43,0.43,-0.06,-12.24,20000,1,8600,0,0,0,0,0,0,20000,0,20000,20000
20200528,708202,碩禾永豐96購01,,,,,,0.00,0,0,0,0,0,0,0,0,0,0,0,0,0
20200528,708203,雙鴻永豐96購02,,,,,,0.00,0,0,0,0,0,0,0,0,0,0,0,0,0
20200528,708205,力旺台新97購02,,,,,,0.00,0,0,0,0,0,0,0,0,0,0,0,0,0
20200528,708206,大江國票97購04,,,,,,0.00,0,0,0,0,0,0,0,0,0,0,0,0,0
20200528,708207,大學光國票98購01,,,,,,0.00,0,0,0,0,0,0,0,0,0,0,0,0,0
20200528,708208,勝麗國票97購03,0.44,0.44,0.40,0.40,-0.13,-24.53,130000,8,55680,0,0,0,0,0,0,130000,0,130000,130000
20200528,708209,博智國票97購01,,,,,,0.00,0,0,0,0,0,0,0,0,0,0,0,0,0
20200528,708210,閎康國票97購02,0.93,0.94,0.93,0.94,-0.10,-9.62,50000,2,46810,0,0,0,0,0,0,50000,0,50000,50000
20200528,708211,精華國票97購02,,,,,,0.00,0,0,0,0,0,0,0,0,0,0,0,0,0
20200528,708212,鈺太國泰96購01,,,,,,0.00,0,0,0,0,0,0,0,0,0,0,0,0,0
20200528,708213,群聯富邦97購02,,,,,,0.00,0,0,0,0,0,0,0,0,0,0,0,0,0
20200528,708214,鈺太統一99購01,,,,,,0.00,0,0,0,0,0,0,0,0,0,0,0,0,0
20200528,708215,久元凱基96購01,2.12,2.19,1.50,1.50,+0.07,4.9,169000,15,325220,0,0,0,0,0,0,51000,116000,-65000,-65000
20200528,708216,勝麗凱基98購01,0.88,0.88,0.86,0.86,-0.08,-8.51,77000,4,66750,0,0,0,0,0,0,74000,3000,71000,71000
20200528,708217,碩禾凱基98購01,,,,,,0.00,0,0,0,0,0,0,0,0,0,0,0,0,0
20200528,708218,中美晶元富96購01,,,,,,0.00,0,0,0,0,0,0,0,0,0,0,0,0,0
20200528,708219,新普元富96購01,2.67,2.88,2.55,2.88,+0.25,9.51,231000,14,613790,0,0,0,0,0,0,111000,120000,-9000,-9000
20200528,708220,雙鴻台新97購01,,,,,,0.00,0,0,0,0,0,0,0,0,0,0,0,0,0
20200528,708221,VHQ康和96購01,,,,,,0.00,0,0,0,0,0,0,0,0,0,0,0,0,0
20200528,708222,網家康和96購01,0.91,0.91,0.86,0.86,-0.02,-2.27,60000,6,52600,0,0,0,0,0,0,0,60000,-60000,-60000
20200528,708223,台半群益96購01,,,,,,0.00,0,0,0,0,0,0,0,0,0,0,0,0,0
20200528,708224,良維群益96購01,,,,,,0.00,0,0,0,0,0,0,0,0,0,0,0,0,0
20200528,708226,信昌電群益96購03,,,,,,0.00,0,0,0,0,0,0,0,0,0,0,0,0,0
20200528,708227,鈊象群益99購04,,,,,,0.00,0,0,0,0,0,0,0,0,0,0,0,0,0
20200528,708228,波若威永豐96購01,0.18,0.18,0.18,0.18,-0.04,-18.18,10000,1,1800,0,0,0,0,0,0,0,10000,-10000,-10000
20200528,708229,中美晶亞東96購01,,,,,,0.00,0,0,0,0,0,0,0,0,0,0,0,0,0
20200528,708230,群聯亞東96購01,,,,,,0.00,0,0,0,0,0,0,0,0,0,0,0,0,0
20200528,708231,六角國票98購03,,,,,,0.00,0,0,0,0,0,0,0,0,0,0,0,0,0
20200528,708232,宜鼎國票97購03,,,,,,0.00,0,0,0,0,0,0,0,0,0,0,0,0,0
20200528,708233,宣德國票97購01,1.18,1.23,1.18,1.22,-0.05,-3.94,106000,7,128080,0,0,0,0,0,0,2000,105000,-103000,-103000
20200528,708234,神盾國票98購01,,,,,,0.00,0,0,0,0,0,0,0,0,0,0,0,0,0
20200528,708235,璟德國票97購01,0.82,0.82,0.82,0.82,-0.24,-22.64,38000,1,31160,0,0,0,0,0,0,0,38000,-38000,-38000
20200528,708236,優群國票97購01,,,,,,0.00,0,0,0,0,0,0,0,0,0,0,0,0,0
20200528,708237,環宇國票97購02,,,,,,0.00,0,0,0,0,0,0,0,0,0,0,0,0,0
20200528,708238,三貝德元大97購01,,,,,,0.00,0,0,0,0,0,0,0,0,0,0,0,0,0
20200528,708239,中美晶元大96購04,,,,,,0.00,0,0,0,0,0,0,0,0,0,0,0,0,0
20200528,708240,宇峻元大97購02,0.99,1.11,0.99,1.11,+0.15,15.62,366000,14,372400,0,0,0,0,0,0,10000,356000,-346000,-346000
20200528,708241,聯亞元大97購02,,,,,,0.00,0,0,0,0,0,0,0,0,0,0,0,0,0
20200528,708242,穩懋元大97購02,,,,,,0.00,0,0,0,0,0,0,0,0,0,0,0,0,0
20200528,708243,譜瑞元大97購01,5.80,5.80,5.60,5.60,-1.40,-20.0,10000,2,57800,0,0,0,0,0,0,9000,1000,8000,8000
20200528,708244,原相國泰98購02,1.72,1.72,1.59,1.59,-0.13,-7.56,4000,3,6490,0,0,0,0,0,0,2000,2000,0,0
20200528,708245,勝麗國泰98購01,1.28,1.28,1.16,1.16,-0.24,-17.14,11000,7,13840,0,0,0,0,0,0,11000,0,11000,11000
20200528,708246,網家國泰97購02,2.24,2.24,2.24,2.24,-0.11,-4.68,10000,1,22400,0,0,0,0,0,0,0,10000,-10000,-10000
20200528,708247,原相第一96購01,0.79,0.79,0.73,0.73,-0.07,-8.75,170000,7,131150,0,0,0,0,0,0,165000,5000,160000,160000
20200528,708248,波若威凱基98購01,0.29,0.29,0.23,0.23,-0.06,-20.69,192000,6,52960,0,0,0,0,0,0,0,192000,-192000,-192000
20200528,708249,雙鴻凱基98購01,,,,,,0.00,0,0,0,0,0,0,0,0,0,0,0,0,0
20200528,708250,穩懋凱基96購12,,,,,,0.00,0,0,0,0,0,0,0,0,0,0,0,0,0
20200528,708251,頎邦凱基97購01,0.32,0.32,0.32,0.32,-0.03,-8.57,100000,1,32000,0,0,0,0,0,0,100000,0,100000,100000
20200528,708252,頎邦凱基97購02,,,,,,0.00,0,0,0,0,0,0,0,0,0,0,0,0,0
20200528,708253,大江元富96購02,0.35,0.35,0.35,0.35,-0.05,-12.5,17000,1,5950,0,0,0,0,0,0,17000,0,17000,17000
20200528,708254,頎邦元富96購01,,,,,,0.00,0,0,0,0,0,0,0,0,0,0,0,0,0
20200528,708255,頎邦元富96購02,,,,,,0.00,0,0,0,0,0,0,0,0,0,0,0,0,0
20200528,708256,信昌電永豐96購03,,,,,,0.00,0,0,0,0,0,0,0,0,0,0,0,0,0
20200528,708257,頎邦永豐96購02,,,,,,0.00,0,0,0,0,0,0,0,0,0,0,0,0,0
20200528,708258,頎邦永豐96購03,,,,,,0.00,0,0,0,0,0,0,0,0,0,0,0,0,0
20200528,708259,神盾統一96購01,0.05,0.05,0.05,0.05,-0.03,-37.5,10000,1,500,0,0,0,0,0,0,10000,0,10000,10000
20200528,708260,群聯統一98購01,1.80,1.80,1.80,1.80,+0.01,0.56,28000,1,50400,0,0,0,0,0,0,28000,0,28000,28000
20200528,708261,頎邦統一96購01,,,,,,0.00,0,0,0,0,0,0,0,0,0,0,0,0,0
20200528,708262,合晶國票97購02,0.65,0.65,0.65,0.65,-0.07,-9.72,20000,1,13000,0,0,0,0,0,0,20000,0,20000,20000
20200528,708263,威剛國票97購01,0.11,0.11,0.11,0.11,-0.01,-8.33,7000,1,770,0,0,0,0,0,0,0,7000,-7000,-7000
20200528,708264,宣德國票97購02,0.81,0.82,0.81,0.82,-0.06,-6.82,80000,2,65010,0,0,0,0,0,0,0,80000,-80000,-80000
20200528,708265,聚積國票97購02,,,,,,0.00,0,0,0,0,0,0,0,0,0,0,0,0,0
20200528,708266,頎邦國票97購01,,,,,,0.00,0,0,0,0,0,0,0,0,0,0,0,0,0
20200528,708267,M31國泰98購01,,,,,,0.00,0,0,0,0,0,0,0,0,0,0,0,0,0
20200528,708268,聯亞國泰98購01,0.55,0.55,0.55,0.55,-0.09,-14.06,10000,1,5500,0,0,0,0,0,0,10000,0,10000,10000
20200528,708269,頎邦國泰97購01,,,,,,0.00,0,0,0,0,0,0,0,0,0,0,0,0,0
20200528,708271,原相富邦98購01,1.08,1.11,0.87,0.87,-0.15,-14.71,222000,39,233210,0,0,0,0,0,0,175000,37000,138000,138000
20200528,708272,頎邦富邦98購01,0.29,0.29,0.29,0.29,-0.03,-9.38,20000,1,5800,0,0,0,0,0,0,20000,0,20000,20000
20200528,708273,力旺元大96購02,1.98,2.10,1.76,1.76,-0.28,-13.73,201000,10,380410,0,0,0,0,0,0,201000,0,201000,201000
20200528,708274,中美晶元大96購05,0.42,0.42,0.42,0.42,-0.02,-4.55,68000,1,28560,0,0,0,0,0,0,0,68000,-68000,-68000
20200528,708275,六角元大98購01,,,,,,0.00,0,0,0,0,0,0,0,0,0,0,0,0,0
20200528,708276,台半元大96購02,,,,,,0.00,0,0,0,0,0,0,0,0,0,0,0,0,0
20200528,708277,金居元大97購01,0.45,0.45,0.43,0.43,-0.09,-17.31,311000,3,137730,0,0,0,0,0,0,311000,311000,0,0
20200528,708278,勝麗元大96購03,0.82,0.82,0.71,0.71,-0.15,-17.44,115000,4,84350,0,0,0,0,0,0,115000,0,115000,115000
20200528,708279,頎邦元大96購02,,,,,,0.00,0,0,0,0,0,0,0,0,0,0,0,0,0
20200528,708280,頎邦元大96購03,,,,,,0.00,0,0,0,0,0,0,0,0,0,0,0,0,0
20200528,708281,頎邦元大97購01,0.44,0.44,0.39,0.39,-0.04,-9.3,672000,11,285680,0,0,0,0,0,0,532000,0,532000,532000
20200528,708282,兆利群益98購01,,,,,,0.00,0,0,0,0,0,0,0,0,0,0,0,0,0
20200528,708283,頎邦群益97購01,0.65,0.65,0.59,0.59,-0.05,-7.81,16000,3,9890,0,0,0,0,0,0,5000,11000,-6000,-6000
20200528,708284,頎邦群益97購02,,,,,,0.00,0,0,0,0,0,0,0,0,0,0,0,0,0
20200528,708285,頎邦群益98購01,0.50,0.50,0.45,0.45,-0.01,-2.17,276000,7,133360,0,0,0,0,0,0,0,276000,-276000,-276000
20200528,708286,三貝德康和96購01,,,,,,0.00,0,0,0,0,0,0,0,0,0,0,0,0,0
20200528,708287,兆利康和9C購01,0.35,0.35,0.35,0.35,-0.01,-2.78,2000,1,700,0,0,0,0,0,0,0,2000,-2000,-2000
20200528,708288,富喬康和96購01,,,,,,0.00,0,0,0,0,0,0,0,0,0,0,0,0,0
20200528,708289,杰力群益96購01,,,,,,0.00,0,0,0,0,0,0,0,0,0,0,0,0,0
20200528,708290,威剛群益97購01,,,,,,0.00,0,0,0,0,0,0,0,0,0,0,0,0,0
20200528,708291,環宇群益98購01,,,,,,0.00,0,0,0,0,0,0,0,0,0,0,0,0,0
20200528,708292,M31國票97購02,,,,,,0.00,0,0,0,0,0,0,0,0,0,0,0,0,0
20200528,708293,合晶國票98購01,1.15,1.15,1.11,1.11,-0.07,-5.93,2000,2,2260,0,0,0,0,0,0,2000,2000,0,0
20200528,708294,良維國票97購03,,,,,,0.00,0,0,0,0,0,0,0,0,0,0,0,0,0
20200528,708296,威剛國票97購02,,,,,,0.00,0,0,0,0,0,0,0,0,0,0,0,0,0
20200528,708297,茂達國票97購02,1.25,1.42,1.17,1.19,+0.01,0.85,1138000,38,1473100,0,0,0,0,0,0,610000,556000,54000,54000
20200528,708298,原相國票98購02,,,,,,0.00,0,0,0,0,0,0,0,0,0,0,0,0,0
20200528,708299,穩懋國票97購02,,,,,,0.00,0,0,0,0,0,0,0,0,0,0,0,0,0
20200528,708300,群聯日盛96購01,,,,,,0.00,0,0,0,0,0,0,0,0,0,0,0,0,0
20200528,708301,優群永豐97購01,4.51,4.51,3.96,4.35,+0.85,24.29,46000,8,197840,0,0,0,0,0,0,30000,16000,14000,14000
20200528,708302,穩懋永豐96購02,,,,,,0.00,0,0,0,0,0,0,0,0,0,0,0,0,0
20200528,708303,伍豐中信9A購01,0.11,0.11,0.09,0.10,-0.06,-37.5,183000,21,18460,0,0,0,0,0,0,31000,111000,-80000,-80000
20200528,708304,同致中信98購02,,,,,,0.00,0,0,0,0,0,0,0,0,0,0,0,0,0
20200528,708305,宜鼎中信9A購01,0.62,0.69,0.61,0.61,+0.02,3.39,624000,29,394780,0,0,0,0,0,0,119000,475000,-356000,-356000
20200528,708306,閎康統一99購01,,,,,,0.00,0,0,0,0,0,0,0,0,0,0,0,0,0
20200528,708307,頎邦統一96購02,,,,,,0.00,0,0,0,0,0,0,0,0,0,0,0,0,0
20200528,708308,大中凱基98購01,,,,,,0.00,0,0,0,0,0,0,0,0,0,0,0,0,0
20200528,708309,大江凱基97購01,,,,,,0.00,0,0,0,0,0,0,0,0,0,0,0,0,0
20200528,708310,兆利凱基98購01,,,,,,0.00,0,0,0,0,0,0,0,0,0,0,0,0,0
20200528,708311,迅得凱基97購01,0.11,0.11,0.11,0.11,0.00,0.0,200000,1,22000,0,0,0,0,0,0,200000,0,200000,200000
20200528,708312,佳邦凱基98購01,,,,,,0.00,0,0,0,0,0,0,0,0,0,0,0,0,0
20200528,708313,金居凱基98購01,0.90,0.90,0.82,0.82,-0.17,-17.17,52000,3,45840,0,0,0,0,0,0,30000,22000,8000,8000
20200528,708314,聚積凱基98購01,,,,,,0.00,0,0,0,0,0,0,0,0,0,0,0,0,0
20200528,708315,廣明凱基98購01,,,,,,0.00,0,0,0,0,0,0,0,0,0,0,0,0,0
20200528,708316,緯軟凱基98購02,,,,,,0.00,0,0,0,0,0,0,0,0,0,0,0,0,0
20200528,708317,環宇凱基98購01,0.26,0.26,0.26,0.26,-0.02,-7.14,50000,1,13000,0,0,0,0,0,0,0,50000,-50000,-50000
20200528,708318,聯亞凱基98購01,1.62,1.69,1.62,1.69,+0.01,0.6,88000,2,147460,0,0,0,0,0,0,0,88000,-88000,-88000
20200528,708319,穩懋凱基96購13,,,,,,0.00,0,0,0,0,0,0,0,0,0,0,0,0,0
20200528,708320,頎邦凱基96購01,,,,,,0.00,0,0,0,0,0,0,0,0,0,0,0,0,0
20200528,708321,大學光元大97購01,,,,,,0.00,0,0,0,0,0,0,0,0,0,0,0,0,0
20200528,708322,群聯元大97購04,,,,,,0.00,0,0,0,0,0,0,0,0,0,0,0,0,0
20200528,708323,聯亞元大97購03,,,,,,0.00,0,0,0,0,0,0,0,0,0,0,0,0,0
20200528,708324,新普兆豐97購01,1.90,2.12,1.90,2.12,+0.26,13.98,222000,15,446750,0,0,0,0,0,0,0,222000,-222000,-222000
20200528,708325,穩懋兆豐97購02,0.83,0.83,0.83,0.83,-0.04,-4.6,6000,1,4980,0,0,0,0,0,0,0,6000,-6000,-6000
20200528,708326,大江日盛96購01,,,,,,0.00,0,0,0,0,0,0,0,0,0,0,0,0,0
20200528,708327,鈊象第一96購01,1.65,1.75,1.65,1.75,+0.43,32.58,165000,6,285900,0,0,0,0,0,0,0,165000,-165000,-165000
20200528,708328,晶焱元大97購03,,,,,,0.00,0,0,0,0,0,0,0,0,0,0,0,0,0
20200528,708329,頎邦康和96購01,,,,,,0.00,0,0,0,0,0,0,0,0,0,0,0,0,0
20200528,708330,M31群益98購01,,,,,,0.00,0,0,0,0,0,0,0,0,0,0,0,0,0
20200528,708331,中美晶群益96購03,,,,,,0.00,0,0,0,0,0,0,0,0,0,0,0,0,0
20200528,708332,六角群益98購01,0.34,0.34,0.34,0.34,-0.02,-5.56,100000,2,34000,0,0,0,0,0,0,100000,0,100000,100000
20200528,708333,宇峻群益98購01,,,,,,0.00,0,0,0,0,0,0,0,0,0,0,0,0,0
20200528,708334,佳邦群益98購01,,,,,,0.00,0,0,0,0,0,0,0,0,0,0,0,0,0
20200528,708335,網龍群益96購01,0.53,0.66,0.53,0.66,+0.13,24.53,15000,2,8600,0,0,0,0,0,0,0,15000,-15000,-15000
20200528,708336,大宇資永豐97購01,,,,,,0.00,0,0,0,0,0,0,0,0,0,0,0,0,0
20200528,708337,大學光永豐96購02,,,,,,0.00,0,0,0,0,0,0,0,0,0,0,0,0,0
20200528,708338,伍豐永豐96購01,,,,,,0.00,0,0,0,0,0,0,0,0,0,0,0,0,0
20200528,708339,旺矽永豐97購02,,,,,,0.00,0,0,0,0,0,0,0,0,0,0,0,0,0
20200528,708341,美琪瑪永豐96購02,,,,,,0.00,0,0,0,0,0,0,0,0,0,0,0,0,0
20200528,708342,群聯永豐96購02,,,,,,0.00,0,0,0,0,0,0,0,0,0,0,0,0,0
20200528,708343,網龍永豐96購04,0.11,0.11,0.08,0.08,0.00,0.0,50000,5,4800,0,0,0,0,0,0,0,50000,-50000,-50000
20200528,708344,聯亞永豐96購03,,,,,,0.00,0,0,0,0,0,0,0,0,0,0,0,0,0
20200528,708345,鈊象永豐96購05,1.37,2.10,1.37,1.98,+1.09,122.47,173000,30,310500,0,0,0,0,0,0,46000,127000,-81000,-81000
20200528,708346,M31統一97購01,0.87,0.87,0.68,0.74,-0.15,-16.85,1427000,18,1050510,0,0,0,0,0,0,1316000,104000,1212000,1212000
20200528,708347,環球晶統一96購02,,,,,,0.00,0,0,0,0,0,0,0,0,0,0,0,0,0
20200528,708348,環球晶中信96購02,,,,,,0.00,0,0,0,0,0,0,0,0,0,0,0,0,0
20200528,708349,鈺太中信97購01,,,,,,0.00,0,0,0,0,0,0,0,0,0,0,0,0,0
20200528,708350,中美晶台新97購02,,,,,,0.00,0,0,0,0,0,0,0,0,0,0,0,0,0
20200528,708351,穩懋台新97購02,,,,,,0.00,0,0,0,0,0,0,0,0,0,0,0,0,0
20200528,708352,杰力凱基98購01,0.55,0.58,0.50,0.50,-0.03,-5.66,597000,26,324710,0,0,0,0,0,0,287000,222000,65000,65000
20200528,708353,中美晶富邦97購03,,,,,,0.00,0,0,0,0,0,0,0,0,0,0,0,0,0
20200528,708354,合晶國票99購01,,,,,,0.00,0,0,0,0,0,0,0,0,0,0,0,0,0
20200528,708355,昇達科國票97購01,,,,,,0.00,0,0,0,0,0,0,0,0,0,0,0,0,0
20200528,708356,信昌電國票97購03,0.30,0.30,0.27,0.27,-0.04,-12.9,200000,2,57000,0,0,0,0,0,0,0,200000,-200000,-200000
20200528,708357,神盾國票97購03,0.72,0.72,0.72,0.72,-0.02,-2.7,20000,1,14400,0,0,0,0,0,0,0,20000,-20000,-20000
20200528,708358,群聯國票97購02,,,,,,0.00,0,0,0,0,0,0,0,0,0,0,0,0,0
20200528,708359,中美晶國泰97購02,,,,,,0.00,0,0,0,0,0,0,0,0,0,0,0,0,0
20200528,708360,宇峻國泰97購01,0.30,0.30,0.30,0.30,-0.15,-33.33,10000,1,3000,0,0,0,0,0,0,0,10000,-10000,-10000
20200528,708361,鈊象國泰98購02,4.12,4.55,4.12,4.50,+1.06,30.81,12000,3,50250,0,0,0,0,0,0,12000,0,12000,12000
20200528,708362,環球晶統一96購04,,,,,,0.00,0,0,0,0,0,0,0,0,0,0,0,0,0
20200528,708363,台燿中信98購01,0.63,0.67,0.62,0.64,+0.02,3.23,185000,30,119000,0,0,0,0,0,0,135000,75000,60000,60000
20200528,708364,新普中信98購01,0.65,0.71,0.65,0.70,+0.09,14.75,381000,21,258480,0,0,0,0,0,0,10000,371000,-361000,-361000
20200528,708365,凡甲凱基97購01,1.53,1.53,1.34,1.35,-0.21,-13.46,211000,11,307500,0,0,0,0,0,0,81000,130000,-49000,-49000
20200528,708366,中美晶凱基97購01,,,,,,0.00,0,0,0,0,0,0,0,0,0,0,0,0,0
20200528,708367,良維凱基97購02,,,,,,0.00,0,0,0,0,0,0,0,0,0,0,0,0,0
20200528,708368,宣德凱基97購01,,,,,,0.00,0,0,0,0,0,0,0,0,0,0,0,0,0
20200528,708369,雙美凱基98購01,0.33,0.33,0.32,0.33,-0.16,-32.65,2999000,7,974700,0,0,0,0,0,0,2999000,0,2999000,2999000
20200528,708370,中美晶元大96購06,0.38,0.38,0.38,0.38,+0.01,2.7,68000,1,25840,0,0,0,0,0,0,0,68000,-68000,-68000
20200528,708371,信昌電元大96購04,,,,,,0.00,0,0,0,0,0,0,0,0,0,0,0,0,0
20200528,708372,優群元大97購03,,,,,,0.00,0,0,0,0,0,0,0,0,0,0,0,0,0
20200528,708373,中美晶元富96購02,0.01,0.01,0.01,0.01,0.00,0.0,7000,1,70,0,0,0,0,0,0,7000,7000,0,0
20200528,708374,久元台新96購01,1.44,1.44,1.44,1.44,0.00,0.0,20000,1,28800,0,0,0,0,0,0,0,0,0,0
20200528,708375,久元台新96購02,,,,,,0.00,0,0,0,0,0,0,0,0,0,0,0,0,0
20200528,708376,台半台新96購01,,,,,,0.00,0,0,0,0,0,0,0,0,0,0,0,0,0
20200528,708377,鈊象台新96購02,,,,,,0.00,0,0,0,0,0,0,0,0,0,0,0,0,0
20200528,708378,頎邦台新97購01,,,,,,0.00,0,0,0,0,0,0,0,0,0,0,0,0,0
20200528,708379,穩懋亞東98購01,,,,,,0.00,0,0,0,0,0,0,0,0,0,0,0,0,0
20200528,708380,台半永豐96購01,,,,,,0.00,0,0,0,0,0,0,0,0,0,0,0,0,0
20200528,708381,亞泰永豐96購01,,,,,,0.00,0,0,0,0,0,0,0,0,0,0,0,0,0
20200528,708382,宜鼎永豐96購02,,,,,,0.00,0,0,0,0,0,0,0,0,0,0,0,0,0
20200528,708383,信昌電永豐96購04,,,,,,0.00,0,0,0,0,0,0,0,0,0,0,0,0,0
20200528,708384,雍智永豐97購01,0.37,0.37,0.31,0.31,-0.08,-20.51,63000,3,23070,0,0,0,0,0,0,61000,2000,59000,59000
20200528,708385,碩禾永豐96購02,,,,,,0.00,0,0,0,0,0,0,0,0,0,0,0,0,0
20200528,708386,雙鴻永豐97購03,,,,,,0.00,0,0,0,0,0,0,0,0,0,0,0,0,0
20200528,708387,瓦城康和96購01,,,,,,0.00,0,0,0,0,0,0,0,0,0,0,0,0,0
20200528,708388,三貝德群益96購02,,,,,,0.00,0,0,0,0,0,0,0,0,0,0,0,0,0
20200528,708389,台半群益96購02,,,,,,0.00,0,0,0,0,0,0,0,0,0,0,0,0,0
20200528,708390,美琪瑪群益96購01,,,,,,0.00,0,0,0,0,0,0,0,0,0,0,0,0,0
20200528,708391,原相群益98購02,0.98,0.98,0.98,0.98,-0.12,-10.91,599000,6,587020,0,0,0,0,0,0,599000,599000,0,0
20200528,708392,大江國票97購05,,,,,,0.00,0,0,0,0,0,0,0,0,0,0,0,0,0
20200528,708393,信昌電國泰98購01,0.30,0.30,0.30,0.30,+0.02,7.14,1000,1,300,0,0,0,0,0,0,0,1000,-1000,-1000
20200528,708394,威剛國泰98購01,,,,,,0.00,0,0,0,0,0,0,0,0,0,0,0,0,0
20200528,708395,環球晶國泰97購03,,,,,,0.00,0,0,0,0,0,0,0,0,0,0,0,0,0
20200528,708396,信昌電富邦98購01,0.11,0.20,0.11,0.20,+0.09,81.82,2000,2,310,0,0,0,0,0,0,1000,0,1000,1000
20200528,708397,群聯富邦97購03,,,,,,0.00,0,0,0,0,0,0,0,0,0,0,0,0,0
20200528,708398,環球晶富邦99購01,0.63,0.63,0.60,0.60,+0.02,3.45,31000,4,19300,0,0,0,0,0,0,21000,10000,11000,11000
20200528,708399,穩懋富邦97購03,,,,,,0.00,0,0,0,0,0,0,0,0,0,0,0,0,0
20200528,708400,建榮國票98購01,,,,,,0.00,0,0,0,0,0,0,0,0,0,0,0,0,0
20200528,708401,威剛國泰98購02,,,,,,0.00,0,0,0,0,0,0,0,0,0,0,0,0,0
20200528,708402,優群國泰99購01,,,,,,0.00,0,0,0,0,0,0,0,0,0,0,0,0,0
20200528,708403,合晶元大98購02,1.53,1.53,1.45,1.45,-0.06,-3.97,136000,2,202640,0,0,0,0,0,0,68000,68000,0,0
20200528,708404,聖暉元大97購01,1.26,1.33,1.18,1.18,-0.13,-9.92,771000,3,952430,0,0,0,0,0,0,700000,71000,629000,629000
20200528,708405,頎邦元大97購02,0.35,0.35,0.28,0.28,-0.03,-9.68,69000,3,20020,0,0,0,0,0,0,68000,1000,67000,67000
20200528,708407,環球晶元富97購01,0.46,0.50,0.46,0.50,+0.06,13.64,44000,4,20840,0,0,0,0,0,0,20000,24000,-4000,-4000
20200528,708408,雙鴻統一97購01,,,,,,0.00,0,0,0,0,0,0,0,0,0,0,0,0,0
20200528,708409,精測中信97購01,,,,,,0.00,0,0,0,0,0,0,0,0,0,0,0,0,0
20200528,708410,頎邦中信9B購01,0.13,0.13,0.11,0.11,-0.01,-8.33,55000,2,7050,0,0,0,0,0,0,55000,0,55000,55000
20200528,708411,宜鼎凱基99購01,,,,,,0.00,0,0,0,0,0,0,0,0,0,0,0,0,0
20200528,708412,直得凱基98購01,0.15,0.15,0.15,0.15,-0.16,-51.61,1000,1,150,0,0,0,0,0,0,1000,0,1000,1000
20200528,708413,信昌電凱基98購01,,,,,,0.00,0,0,0,0,0,0,0,0,0,0,0,0,0
20200528,708414,群聯凱基98購01,,,,,,0.00,0,0,0,0,0,0,0,0,0,0,0,0,0
20200528,708415,VHQ永豐97購01,,,,,,0.00,0,0,0,0,0,0,0,0,0,0,0,0,0
20200528,708416,大宇資永豐99購01,,,,,,0.00,0,0,0,0,0,0,0,0,0,0,0,0,0
20200528,708417,長科*永豐97購01,0.13,0.13,0.12,0.12,-0.05,-29.41,100000,3,12900,0,0,0,0,0,0,60000,40000,20000,20000
20200528,708418,廣明永豐97購01,,,,,,0.00,0,0,0,0,0,0,0,0,0,0,0,0,0
20200528,708419,環宇永豐98購01,,,,,,0.00,0,0,0,0,0,0,0,0,0,0,0,0,0
20200528,708420,宜鼎群益98購01,,,,,,0.00,0,0,0,0,0,0,0,0,0,0,0,0,0
20200528,708421,群聯群益98購01,,,,,,0.00,0,0,0,0,0,0,0,0,0,0,0,0,0
20200528,708422,群聯群益99購01,,,,,,0.00,0,0,0,0,0,0,0,0,0,0,0,0,0
20200528,708423,世界麥證97購01,,,,,,0.00,0,0,0,0,0,0,0,0,0,0,0,0,0
20200528,708424,原相台新97購02,0.66,0.66,0.66,0.66,-0.22,-25.0,15000,1,9900,0,0,0,0,0,0,15000,0,15000,15000
20200528,708425,新鉅科台新98購01,,,,,,0.00,0,0,0,0,0,0,0,0,0,0,0,0,0
20200528,708426,群聯台新97購03,,,,,,0.00,0,0,0,0,0,0,0,0,0,0,0,0,0
20200528,708427,聯亞台新97購01,,,,,,0.00,0,0,0,0,0,0,0,0,0,0,0,0,0
20200528,708428,鈺太台新97購01,,,,,,0.00,0,0,0,0,0,0,0,0,0,0,0,0,0
20200528,708429,群聯統一97購01,0.62,0.62,0.62,0.62,-0.09,-12.68,1000,1,620,0,0,0,0,0,0,0,1000,-1000,-1000
20200528,708430,兆利中信9A購01,,,,,,0.00,0,0,0,0,0,0,0,0,0,0,0,0,0
20200528,708431,原相中信99購01,1.02,1.02,0.79,0.79,-0.17,-17.71,459000,52,418780,0,0,0,0,0,0,306000,153000,153000,153000
20200528,708432,廣明中信9B購01,0.08,0.09,0.08,0.09,0.00,0.0,113000,7,9240,0,0,0,0,0,0,0,20000,-20000,-20000
20200528,708433,穩懋中信99購01,0.12,0.12,0.11,0.12,+0.01,9.09,425000,17,47690,0,0,0,0,0,0,358000,31000,327000,327000
20200528,708434,合晶凱基98購01,0.44,0.44,0.44,0.44,+0.05,12.82,5000,1,2200,0,0,0,0,0,0,5000,0,5000,5000
20200528,708435,勝麗凱基97購02,,,,,,0.00,0,0,0,0,0,0,0,0,0,0,0,0,0
20200528,708436,博智凱基97購01,,,,,,0.00,0,0,0,0,0,0,0,0,0,0,0,0,0
20200528,708437,穩懋日盛97購01,,,,,,0.00,0,0,0,0,0,0,0,0,0,0,0,0,0
20200528,708438,中美晶亞東97購01,,,,,,0.00,0,0,0,0,0,0,0,0,0,0,0,0,0
20200528,708439,合晶亞東97購02,,,,,,0.00,0,0,0,0,0,0,0,0,0,0,0,0,0
20200528,708440,大田元富97購01,0.61,0.61,0.60,0.60,-0.04,-6.25,60000,3,36400,0,0,0,0,0,0,60000,0,60000,60000
20200528,708441,榮剛元富97購01,,,,,,0.00,0,0,0,0,0,0,0,0,0,0,0,0,0
20200528,708442,聯亞台新99購01,,,,,,0.00,0,0,0,0,0,0,0,0,0,0,0,0,0
20200528,708444,威剛元大99購01,0.14,0.14,0.14,0.14,-0.01,-6.67,60000,1,8400,0,0,0,0,0,0,60000,60000,0,0
20200528,708445,神盾元大99購02,,,,,,0.00,0,0,0,0,0,0,0,0,0,0,0,0,0
20200528,708446,聯亞元大97購04,,,,,,0.00,0,0,0,0,0,0,0,0,0,0,0,0,0
20200528,708447,鈺太元大99購01,0.73,0.73,0.69,0.69,-0.04,-5.48,308000,8,220090,0,0,0,0,0,0,27000,308000,-281000,-281000
20200528,708448,大中永豐97購01,,,,,,0.00,0,0,0,0,0,0,0,0,0,0,0,0,0
20200528,708449,大江永豐97購02,,,,,,0.00,0,0,0,0,0,0,0,0,0,0,0,0,0
20200528,708450,六角永豐97購01,,,,,,0.00,0,0,0,0,0,0,0,0,0,0,0,0,0
20200528,708451,兆利永豐97購01,,,,,,0.00,0,0,0,0,0,0,0,0,0,0,0,0,0
20200528,708452,波若威永豐98購01,0.10,0.10,0.09,0.09,-0.03,-25.0,19000,2,1810,0,0,0,0,0,0,0,19000,-19000,-19000
20200528,708453,宣德永豐97購02,,,,,,0.00,0,0,0,0,0,0,0,0,0,0,0,0,0
20200528,708454,建榮永豐99購01,,,,,,0.00,0,0,0,0,0,0,0,0,0,0,0,0,0
20200528,708455,森鉅永豐97購01,,,,,,0.00,0,0,0,0,0,0,0,0,0,0,0,0,0
20200528,708456,榮剛永豐97購01,,,,,,0.00,0,0,0,0,0,0,0,0,0,0,0,0,0
20200528,708457,廣積永豐97購01,,,,,,0.00,0,0,0,0,0,0,0,0,0,0,0,0,0
20200528,708458,旺矽群益9A購01,,,,,,0.00,0,0,0,0,0,0,0,0,0,0,0,0,0
20200528,708459,昇達科群益98購01,,,,,,0.00,0,0,0,0,0,0,0,0,0,0,0,0,0
20200528,708460,櫃200群益97購01,,,,,,0.00,0,0,0,0,0,0,0,0,0,0,0,0,0
20200528,708461,櫃200群益97購02,0.08,0.08,0.08,0.08,-0.02,-20.0,30000,3,2400,0,0,0,0,0,0,0,30000,-30000,-30000
20200528,708462,中美晶元大97購03,0.96,0.96,0.92,0.92,-0.09,-8.91,198000,2,186120,0,0,0,0,0,0,99000,99000,0,0
20200528,708463,宜鼎元大97購01,1.46,1.53,1.39,1.39,-0.08,-5.44,245000,5,362410,0,0,0,0,0,0,0,245000,-245000,-245000
20200528,708465,璟德元大97購01,1.00,1.00,0.88,0.91,-0.12,-11.65,140000,5,128200,0,0,0,0,0,0,40000,100000,-60000,-60000
20200528,708466,璟德元大97購02,0.59,0.59,0.51,0.51,-0.14,-21.54,68000,2,38680,0,0,0,0,0,0,0,68000,-68000,-68000
20200528,708467,優群元大97購04,6.15,6.15,6.15,6.15,0.00,0.0,6000,1,36900,0,0,0,0,0,0,6000,0,6000,6000
20200528,708468,兆利康和97購01,,,,,,0.00,0,0,0,0,0,0,0,0,0,0,0,0,0
20200528,708469,璟德康和97購01,,,,,,0.00,0,0,0,0,0,0,0,0,0,0,0,0,0
20200528,708470,璟德元富97購01,,,,,,0.00,0,0,0,0,0,0,0,0,0,0,0,0,0
20200528,708471,璟德台新97購01,,,,,,0.00,0,0,0,0,0,0,0,0,0,0,0,0,0
20200528,708472,三貝德凱基99購01,0.04,0.04,0.04,0.04,0.00,0.0,80000,4,3200,0,0,0,0,0,0,0,0,0,0
20200528,708473,大田凱基98購01,0.12,0.12,0.12,0.12,-0.03,-20.0,20000,1,2400,0,0,0,0,0,0,20000,0,20000,20000
20200528,708474,中美晶凱基97購02,,,,,,0.00,0,0,0,0,0,0,0,0,0,0,0,0,0
20200528,708475,宇峻凱基9A購01,,,,,,0.00,0,0,0,0,0,0,0,0,0,0,0,0,0
20200528,708476,網龍凱基98購01,1.31,1.32,1.29,1.32,+0.17,14.78,94000,4,123760,0,0,0,0,0,0,0,94000,-94000,-94000
20200528,708477,鈊象凱基99購01,2.40,3.02,2.28,2.87,+0.88,44.22,29000,12,73780,0,0,0,0,0,0,22000,5000,17000,17000
20200528,708478,穩懋日盛97購02,,,,,,0.00,0,0,0,0,0,0,0,0,0,0,0,0,0
20200528,708479,立端永豐97購01,,,,,,0.00,0,0,0,0,0,0,0,0,0,0,0,0,0
20200528,708480,宇峻永豐97購01,0.03,0.04,0.03,0.04,+0.01,33.33,11000,2,340,0,0,0,0,0,0,0,11000,-11000,-11000
20200528,708481,迅得永豐97購03,,,,,,0.00,0,0,0,0,0,0,0,0,0,0,0,0,0
20200528,708482,神盾永豐97購01,,,,,,0.00,0,0,0,0,0,0,0,0,0,0,0,0,0
20200528,708483,璟德永豐97購02,,,,,,0.00,0,0,0,0,0,0,0,0,0,0,0,0,0
20200528,708484,璟德國泰98購01,,,,,,0.00,0,0,0,0,0,0,0,0,0,0,0,0,0
20200528,708485,六角國票97購01,0.20,0.20,0.18,0.18,-0.05,-21.74,11000,2,2000,0,0,0,0,0,0,1000,10000,-9000,-9000
20200528,708487,信昌電國票98購01,,,,,,0.00,0,0,0,0,0,0,0,0,0,0,0,0,0
20200528,708488,威剛國票98購01,,,,,,0.00,0,0,0,0,0,0,0,0,0,0,0,0,0
20200528,708489,群聯國票98購01,,,,,,0.00,0,0,0,0,0,0,0,0,0,0,0,0,0
20200528,708490,雍智國票98購01,0.80,0.80,0.64,0.64,-0.14,-17.95,634000,26,455580,0,0,0,0,0,0,318000,316000,2000,2000
20200528,708491,雙美國票99購01,,,,,,0.00,0,0,0,0,0,0,0,0,0,0,0,0,0
20200528,708492,雙鴻國票98購02,0.21,0.21,0.21,0.21,+0.01,5.0,1000,1,210,0,0,0,0,0,0,0,1000,-1000,-1000
20200528,708493,鈊象國票98購01,,,,,,0.00,0,0,0,0,0,0,0,0,0,0,0,0,0
20200528,708494,大江群益97購02,,,,,,0.00,0,0,0,0,0,0,0,0,0,0,0,0,0
20200528,708495,信昌電群益97購01,,,,,,0.00,0,0,0,0,0,0,0,0,0,0,0,0,0
20200528,708496,建榮群益99購01,,,,,,0.00,0,0,0,0,0,0,0,0,0,0,0,0,0
20200528,708497,原相群益99購01,,,,,,0.00,0,0,0,0,0,0,0,0,0,0,0,0,0
20200528,708498,勝麗群益98購01,1.00,1.00,0.97,0.97,-0.16,-14.16,55000,2,53890,0,0,0,0,0,0,55000,0,55000,55000
20200528,708499,璟德群益98購01,0.29,0.29,0.26,0.26,-0.07,-21.21,8000,2,2230,0,0,0,0,0,0,5000,3000,2000,2000
20200528,708500,鈊象群益99購05,7.45,8.90,7.45,8.75,+2.00,29.63,201000,34,1685650,0,0,0,0,0,0,66000,194000,-128000,-128000
20200528,708501,力致元大97購01,,,,,,0.00,0,0,0,0,0,0,0,0,0,0,0,0,0
20200528,708502,中美晶元大97購04,0.45,0.45,0.41,0.41,-0.10,-19.61,78000,2,34700,0,0,0,0,0,0,10000,68000,-58000,-58000
20200528,708503,世禾元大97購01,0.45,0.45,0.28,0.28,-0.12,-30.0,20000,2,7300,0,0,0,0,0,0,20000,10000,10000,10000
20200528,708504,尼克森元大97購01,,,,,,0.00,0,0,0,0,0,0,0,0,0,0,0,0,0
20200528,708505,宇峻元大97購03,0.28,0.28,0.28,0.28,+0.05,21.74,40000,4,11200,0,0,0,0,0,0,0,40000,-40000,-40000
20200528,708506,信昌電元大98購01,,,,,,0.00,0,0,0,0,0,0,0,0,0,0,0,0,0
20200528,708507,碩禾元大98購02,,,,,,0.00,0,0,0,0,0,0,0,0,0,0,0,0,0
20200528,708508,雙鴻元大99購02,,,,,,0.00,0,0,0,0,0,0,0,0,0,0,0,0,0
20200528,708509,尼克森統一99購01,,,,,,0.00,0,0,0,0,0,0,0,0,0,0,0,0,0
20200528,708510,尼克森統一99購02,,,,,,0.00,0,0,0,0,0,0,0,0,0,0,0,0,0
20200528,708511,迅得統一99購01,,,,,,0.00,0,0,0,0,0,0,0,0,0,0,0,0,0
20200528,708512,頎邦統一97購01,,,,,,0.00,0,0,0,0,0,0,0,0,0,0,0,0,0
20200528,708513,M31中信98購01,0.16,0.17,0.11,0.12,-0.07,-36.84,520000,8,69950,0,0,0,0,0,0,300000,220000,80000,80000
20200528,708514,大中中信97購01,,,,,,0.00,0,0,0,0,0,0,0,0,0,0,0,0,0
20200528,708515,宇峻中信97購01,0.05,0.06,0.05,0.06,+0.02,50.0,110000,3,5600,0,0,0,0,0,0,0,0,0,0
20200528,708516,博智中信97購01,,,,,,0.00,0,0,0,0,0,0,0,0,0,0,0,0,0
20200528,708517,大中凱基98購02,,,,,,0.00,0,0,0,0,0,0,0,0,0,0,0,0,0
20200528,708518,同致凱基98購01,0.33,0.40,0.31,0.32,+0.01,3.23,97000,28,33910,0,0,0,0,0,0,19000,41000,-22000,-22000
20200528,708519,合晶凱基97購02,,,,,,0.00,0,0,0,0,0,0,0,0,0,0,0,0,0
20200528,708520,朋億凱基97購01,,,,,,0.00,0,0,0,0,0,0,0,0,0,0,0,0,0
20200528,708521,南光凱基97購01,,,,,,0.00,0,0,0,0,0,0,0,0,0,0,0,0,0
20200528,708522,緯軟凱基98購03,,,,,,0.00,0,0,0,0,0,0,0,0,0,0,0,0,0
20200528,708523,大江兆豐97購01,,,,,,0.00,0,0,0,0,0,0,0,0,0,0,0,0,0
20200528,708524,中美晶兆豐98購01,0.06,0.10,0.06,0.06,-0.01,-14.29,107000,4,6460,0,0,0,0,0,0,101000,106000,-5000,-5000
20200528,708525,台燿兆豐97購02,0.55,0.59,0.53,0.59,0.00,0.0,45000,8,24860,0,0,0,0,0,0,25000,20000,5000,5000
20200528,708526,精華兆豐98購01,,,,,,0.00,0,0,0,0,0,0,0,0,0,0,0,0,0
20200528,708527,中美晶群益97購03,,,,,,0.00,0,0,0,0,0,0,0,0,0,0,0,0,0
20200528,708528,太景*群益98購01,0.57,0.57,0.35,0.44,-0.01,-2.22,191000,7,68040,0,0,0,0,0,0,179000,1000,178000,178000
20200528,708529,立端群益97購01,,,,,,0.00,0,0,0,0,0,0,0,0,0,0,0,0,0
20200528,708530,朋億群益98購01,,,,,,0.00,0,0,0,0,0,0,0,0,0,0,0,0,0
20200528,708531,欣銓群益98購01,0.19,0.19,0.19,0.19,-0.03,-13.64,100000,1,19000,0,0,0,0,0,0,0,100000,-100000,-100000
20200528,708532,群聯群益97購02,,,,,,0.00,0,0,0,0,0,0,0,0,0,0,0,0,0
20200528,708533,緯軟群益98購01,,,,,,0.00,0,0,0,0,0,0,0,0,0,0,0,0,0
20200528,708534,環球晶群益97購03,,,,,,0.00,0,0,0,0,0,0,0,0,0,0,0,0,0
20200528,708535,譜瑞群益97購01,,,,,,0.00,0,0,0,0,0,0,0,0,0,0,0,0,0
20200528,708536,建榮國票98購02,,,,,,0.00,0,0,0,0,0,0,0,0,0,0,0,0,0
20200528,708537,力致國泰99購01,1.36,1.46,1.21,1.21,-0.34,-21.94,82000,14,113650,0,0,0,0,0,0,30000,43000,-13000,-13000
20200528,708538,凡甲國泰99購01,1.81,1.82,1.65,1.65,-0.15,-8.33,685000,44,1209250,0,0,0,0,0,0,74000,593000,-519000,-519000
20200528,708539,中菲行國泰98購01,1.58,1.62,1.49,1.51,+0.11,7.86,83000,12,127570,0,0,0,0,0,0,36000,47000,-11000,-11000
20200528,708540,世禾國泰98購01,1.17,1.17,0.80,0.82,-0.11,-11.83,928000,49,906140,0,0,0,0,0,0,857000,60000,797000,797000
20200528,708541,尼克森國泰99購01,0.36,0.36,0.33,0.33,0.00,0.0,251000,19,89130,0,0,0,0,0,0,60000,170000,-110000,-110000
20200528,708542,幃翔國泰98購01,0.14,0.14,0.12,0.12,-0.03,-20.0,88000,3,10720,0,0,0,0,0,0,88000,0,88000,88000
20200528,708543,幃翔國泰98購02,0.39,0.39,0.39,0.39,-0.02,-4.88,88000,2,34320,0,0,0,0,0,0,50000,38000,12000,12000
20200528,708544,群聯國泰99購01,0.14,0.14,0.13,0.13,-0.01,-7.14,50000,2,6550,0,0,0,0,0,0,45000,0,45000,45000
20200528,708545,雙鴻國泰99購01,,,,,,0.00,0,0,0,0,0,0,0,0,0,0,0,0,0
20200528,708546,力致永豐97購01,0.55,0.55,0.55,0.55,-0.02,-3.51,86000,1,47300,0,0,0,0,0,0,86000,0,86000,86000
20200528,708547,世禾永豐97購01,,,,,,0.00,0,0,0,0,0,0,0,0,0,0,0,0,0
20200528,708548,尼克森永豐97購01,,,,,,0.00,0,0,0,0,0,0,0,0,0,0,0,0,0
20200528,708549,立敦永豐97購01,,,,,,0.00,0,0,0,0,0,0,0,0,0,0,0,0,0
20200528,708550,同亨永豐97購01,,,,,,0.00,0,0,0,0,0,0,0,0,0,0,0,0,0
20200528,708551,直得永豐97購01,0.12,0.14,0.05,0.05,-0.10,-66.67,336000,23,26560,0,0,0,0,0,0,136000,200000,-64000,-64000
20200528,708552,南光永豐97購01,,,,,,0.00,0,0,0,0,0,0,0,0,0,0,0,0,0
20200528,708553,威剛永豐98購01,,,,,,0.00,0,0,0,0,0,0,0,0,0,0,0,0,0
20200528,708554,幃翔永豐97購01,,,,,,0.00,0,0,0,0,0,0,0,0,0,0,0,0,0
20200528,708555,新潤永豐97購01,,,,,,0.00,0,0,0,0,0,0,0,0,0,0,0,0,0
20200528,708556,網龍永豐97購01,0.12,0.12,0.12,0.12,+0.02,20.0,10000,1,1200,0,0,0,0,0,0,0,0,0,0
20200528,708557,緯軟永豐97購01,,,,,,0.00,0,0,0,0,0,0,0,0,0,0,0,0,0
20200528,708558,環球晶永豐97購01,0.08,0.08,0.08,0.08,-0.01,-11.11,200000,1,16000,0,0,0,0,0,0,200000,0,200000,200000
20200528,708559,聯上永豐97購01,,,,,,0.00,0,0,0,0,0,0,0,0,0,0,0,0,0
20200528,708560,大中康和97購01,,,,,,0.00,0,0,0,0,0,0,0,0,0,0,0,0,0
20200528,708561,亞泰康和97購01,,,,,,0.00,0,0,0,0,0,0,0,0,0,0,0,0,0
20200528,708562,博智康和97購01,,,,,,0.00,0,0,0,0,0,0,0,0,0,0,0,0,0
20200528,708563,力致元富97購01,0.65,0.65,0.51,0.51,-0.09,-15.0,301000,7,181200,0,0,0,0,0,0,279000,22000,257000,257000
20200528,708564,中菲行元富97購01,,,,,,0.00,0,0,0,0,0,0,0,0,0,0,0,0,0
20200528,708565,太景*元富97購01,,,,,,0.00,0,0,0,0,0,0,0,0,0,0,0,0,0
20200528,708566,世禾元富97購01,0.26,0.26,0.26,0.26,-0.03,-10.34,3000,1,780,0,0,0,0,0,0,3000,0,3000,3000
20200528,708567,尼克森元富97購01,,,,,,0.00,0,0,0,0,0,0,0,0,0,0,0,0,0
20200528,708568,幃翔元富97購01,,,,,,0.00,0,0,0,0,0,0,0,0,0,0,0,0,0
20200528,708569,力致統一97購01,0.81,0.87,0.72,0.72,-0.06,-7.69,726000,20,578910,0,0,0,0,0,0,520000,204000,316000,316000
20200528,708570,力致統一97購02,1.20,1.35,1.00,1.02,-0.19,-15.7,1021000,104,1149540,0,0,0,0,0,0,20000,946000,-926000,-926000
20200528,708571,環球晶統一97購01,,,,,,0.00,0,0,0,0,0,0,0,0,0,0,0,0,0
20200528,708572,兆利凱基98購02,,,,,,0.00,0,0,0,0,0,0,0,0,0,0,0,0,0
20200528,708574,威剛凱基99購01,,,,,,0.00,0,0,0,0,0,0,0,0,0,0,0,0,0
20200528,708575,精測凱基98購01,,,,,,0.00,0,0,0,0,0,0,0,0,0,0,0,0,0
20200528,708576,聯亞凱基99購01,0.09,0.09,0.09,0.09,-0.02,-18.18,1000,1,90,0,0,0,0,0,0,1000,0,1000,1000
20200528,708577,頎邦凱基97購03,,,,,,0.00,0,0,0,0,0,0,0,0,0,0,0,0,0
20200528,708578,中美晶麥證97購01,,,,,,0.00,0,0,0,0,0,0,0,0,0,0,0,0,0
20200528,708579,原相麥證97購01,,,,,,0.00,0,0,0,0,0,0,0,0,0,0,0,0,0
20200528,708580,神盾元富97購01,0.19,0.19,0.19,0.19,-0.02,-9.52,60000,1,11400,0,0,0,0,0,0,60000,0,60000,60000
20200528,708581,神盾元富97購02,,,,,,0.00,0,0,0,0,0,0,0,0,0,0,0,0,0
20200528,708582,宇峻元大97購04,,,,,,0.00,0,0,0,0,0,0,0,0,0,0,0,0,0
20200528,708583,亞泰元大97購01,,,,,,0.00,0,0,0,0,0,0,0,0,0,0,0,0,0
20200528,708584,威剛元大98購02,0.07,0.07,0.06,0.06,0.00,0.0,110000,3,6700,0,0,0,0,0,0,110000,0,110000,110000
20200528,708585,建榮元大97購02,,,,,,0.00,0,0,0,0,0,0,0,0,0,0,0,0,0
20200528,708586,原相元大98購01,1.29,1.29,1.09,1.09,-0.22,-16.79,81000,7,90250,0,0,0,0,0,0,66000,81000,-15000,-15000
20200528,708587,原相元大99購01,,,,,,0.00,0,0,0,0,0,0,0,0,0,0,0,0,0
20200528,708588,群聯元大98購01,,,,,,0.00,0,0,0,0,0,0,0,0,0,0,0,0,0
20200528,708589,聯亞元大98購01,,,,,,0.00,0,0,0,0,0,0,0,0,0,0,0,0,0
20200528,708590,雙美元大99購01,0.92,1.01,0.92,0.97,+0.03,3.19,104000,10,100180,0,0,0,0,0,0,64000,74000,-10000,-10000
20200528,708591,雙鴻元大99購03,,,,,,0.00,0,0,0,0,0,0,0,0,0,0,0,0,0
20200528,708592,穩懋元大97購03,,,,,,0.00,0,0,0,0,0,0,0,0,0,0,0,0,0
20200528,708593,穩懋元大97購04,,,,,,0.00,0,0,0,0,0,0,0,0,0,0,0,0,0
20200528,708594,鈊象元大99購01,,,,,,0.00,0,0,0,0,0,0,0,0,0,0,0,0,0
20200528,708595,大江兆豐97購02,0.15,0.15,0.15,0.15,-0.01,-6.25,60000,1,9000,0,0,0,0,0,0,60000,0,60000,60000
20200528,708596,群聯兆豐98購01,0.08,0.08,0.08,0.08,-0.01,-11.11,111000,2,8880,0,0,0,0,0,0,111000,81000,30000,30000
20200528,708597,迅得康和97購01,0.50,0.50,0.50,0.50,0.00,0.0,50000,1,25000,0,0,0,0,0,0,50000,0,50000,50000
20200528,708598,六角群益98購02,0.25,0.25,0.20,0.20,-0.05,-20.0,40000,2,9000,0,0,0,0,0,0,40000,0,40000,40000
20200528,708599,亞泰群益97購01,,,,,,0.00,0,0,0,0,0,0,0,0,0,0,0,0,0
20200528,708600,台燿亞東97購01,,,,,,0.00,0,0,0,0,0,0,0,0,0,0,0,0,0
20200528,708601,光頡永豐97購01,,,,,,0.00,0,0,0,0,0,0,0,0,0,0,0,0,0
20200528,708602,亞泰永豐97購01,,,,,,0.00,0,0,0,0,0,0,0,0,0,0,0,0,0
20200528,708603,力致元富97購02,0.76,0.83,0.66,0.74,+0.02,2.78,729000,25,535690,0,0,0,0,0,0,459000,270000,189000,189000
20200528,708604,鈺太元富97購01,0.28,0.28,0.28,0.28,-0.01,-3.45,50000,1,14000,0,0,0,0,0,0,50000,0,50000,50000
20200528,708605,久元台新97購01,,,,,,0.00,0,0,0,0,0,0,0,0,0,0,0,0,0
20200528,708606,大中台新97購01,,,,,,0.00,0,0,0,0,0,0,0,0,0,0,0,0,0
20200528,708607,晶焱台新97購01,,,,,,0.00,0,0,0,0,0,0,0,0,0,0,0,0,0
20200528,708608,光頡統一97購01,0.48,0.48,0.48,0.48,-0.02,-4.0,18000,1,8640,0,0,0,0,0,0,0,18000,-18000,-18000
20200528,708609,光頡統一99購01,0.14,0.15,0.14,0.15,0.00,0.0,8000,2,1190,0,0,0,0,0,0,1000,7000,-6000,-6000
20200528,708610,合晶統一97購01,0.76,0.76,0.72,0.72,-0.08,-10.0,307000,5,227840,0,0,0,0,0,0,108000,199000,-91000,-91000
20200528,708611,大中中信99購01,0.08,0.08,0.08,0.08,0.00,0.0,650000,4,52000,0,0,0,0,0,0,450000,200000,250000,250000
20200528,708612,亞泰中信97購01,,,,,,0.00,0,0,0,0,0,0,0,0,0,0,0,0,0
20200528,708613,博智中信99購01,,,,,,0.00,0,0,0,0,0,0,0,0,0,0,0,0,0
20200528,708614,緯軟中信97購01,,,,,,0.00,0,0,0,0,0,0,0,0,0,0,0,0,0
20200528,708615,台半凱基98購01,,,,,,0.00,0,0,0,0,0,0,0,0,0,0,0,0,0
20200528,708616,兆利凱基98購03,,,,,,0.00,0,0,0,0,0,0,0,0,0,0,0,0,0
20200528,708617,宇峻凱基99購01,,,,,,0.00,0,0,0,0,0,0,0,0,0,0,0,0,0
20200528,708618,新普凱基98購01,3.49,3.74,3.33,3.57,-0.12,-3.25,87000,23,308390,0,0,0,0,0,0,55000,82000,-27000,-27000
20200528,708619,璟德凱基98購01,,,,,,0.00,0,0,0,0,0,0,0,0,0,0,0,0,0
20200528,708620,環球晶凱基97購02,,,,,,0.00,0,0,0,0,0,0,0,0,0,0,0,0,0
20200528,708621,頎邦第一97購01,,,,,,0.00,0,0,0,0,0,0,0,0,0,0,0,0,0
20200528,708622,光頡永豐97購02,,,,,,0.00,0,0,0,0,0,0,0,0,0,0,0,0,0
20200528,708623,建榮永豐98購01,,,,,,0.00,0,0,0,0,0,0,0,0,0,0,0,0,0
20200528,708624,雙美永豐98購01,,,,,,0.00,0,0,0,0,0,0,0,0,0,0,0,0,0
20200528,708625,雙鴻永豐98購01,0.28,0.28,0.28,0.28,+0.01,3.7,40000,1,11200,0,0,0,0,0,0,40000,0,40000,40000
20200528,708626,亞泰國票97購01,,,,,,0.00,0,0,0,0,0,0,0,0,0,0,0,0,0
20200528,708627,新普國票98購01,1.93,1.95,1.85,1.95,+0.45,30.0,21000,3,39750,0,0,0,0,0,0,0,21000,-21000,-21000
20200528,708628,廣明國票98購01,1.17,1.17,1.12,1.12,-0.08,-6.67,91000,2,106170,0,0,0,0,0,0,85000,6000,79000,79000
20200528,708629,璟德國票98購01,,,,,,0.00,0,0,0,0,0,0,0,0,0,0,0,0,0
20200528,708630,環宇國票98購01,,,,,,0.00,0,0,0,0,0,0,0,0,0,0,0,0,0
20200528,708631,頎邦國票98購01,1.12,1.12,1.02,1.02,-0.05,-4.67,205000,8,217700,0,0,0,0,0,0,85000,120000,-35000,-35000
20200528,708632,M31元大98購01,,,,,,0.00,0,0,0,0,0,0,0,0,0,0,0,0,0
20200528,708634,信昌電元大98購02,0.39,0.39,0.34,0.34,-0.04,-10.53,120000,2,43800,0,0,0,0,0,0,60000,60000,0,0
20200528,708635,建榮元大97購03,,,,,,0.00,0,0,0,0,0,0,0,0,0,0,0,0,0
20200528,708636,原相元大98購02,,,,,,0.00,0,0,0,0,0,0,0,0,0,0,0,0,0
20200528,708637,群聯元大98購02,,,,,,0.00,0,0,0,0,0,0,0,0,0,0,0,0,0
20200528,708638,精測元大97購04,,,,,,0.00,0,0,0,0,0,0,0,0,0,0,0,0,0
20200528,708639,網龍元大97購01,,,,,,0.00,0,0,0,0,0,0,0,0,0,0,0,0,0
20200528,708640,璟德元大97購03,,,,,,0.00,0,0,0,0,0,0,0,0,0,0,0,0,0
20200528,708641,鈊象元大98購02,3.56,3.56,3.36,3.36,+0.91,37.14,26000,5,88560,0,0,0,0,0,0,26000,20000,6000,6000
20200528,708642,頎邦元大97購03,,,,,,0.00,0,0,0,0,0,0,0,0,0,0,0,0,0
20200528,708643,頎邦元大97購04,,,,,,0.00,0,0,0,0,0,0,0,0,0,0,0,0,0
20200528,708644,雙美國泰99購01,,,,,,0.00,0,0,0,0,0,0,0,0,0,0,0,0,0
20200528,708645,聯亞兆豐98購01,,,,,,0.00,0,0,0,0,0,0,0,0,0,0,0,0,0
20200528,708646,櫃200兆豐97購01,,,,,,0.00,0,0,0,0,0,0,0,0,0,0,0,0,0
20200528,708647,泰博群益97購01,,,,,,0.00,0,0,0,0,0,0,0,0,0,0,0,0,0
20200528,708648,VHQ中信97購01,,,,,,0.00,0,0,0,0,0,0,0,0,0,0,0,0,0
20200528,708649,鈊象中信97購01,2.10,2.10,2.10,2.10,+0.43,25.75,5000,1,10500,0,0,0,0,0,0,5000,0,5000,5000
20200528,708650,迅得麥證98購01,0.12,0.12,0.12,0.12,-0.01,-7.69,1000,1,120,1000,0,1000,0,0,0,1000,0,1000,1000
20200528,708651,大學光元富99購01,,,,,,0.00,0,0,0,0,0,0,0,0,0,0,0,0,0
20200528,708652,光頡元富97購01,,,,,,0.00,0,0,0,0,0,0,0,0,0,0,0,0,0
20200528,708653,神盾元富97購03,,,,,,0.00,0,0,0,0,0,0,0,0,0,0,0,0,0
20200528,708654,力致統一97購03,0.43,0.43,0.35,0.35,-0.13,-27.08,261000,19,109150,0,0,0,0,0,0,256000,5000,251000,251000
20200528,708655,波若威統一99購01,,,,,,0.00,0,0,0,0,0,0,0,0,0,0,0,0,0
20200528,708656,信昌電統一98購01,0.76,0.77,0.76,0.77,-0.02,-2.53,60000,2,45880,0,0,0,0,0,0,32000,28000,4000,4000
20200528,708657,兆利台新97購01,,,,,,0.00,0,0,0,0,0,0,0,0,0,0,0,0,0
20200528,708658,神盾台新98購01,,,,,,0.00,0,0,0,0,0,0,0,0,0,0,0,0,0
20200528,708659,合晶凱基97購03,1.13,1.18,1.10,1.10,-0.03,-2.65,86000,4,99100,0,0,0,0,0,0,45000,41000,4000,4000
20200528,708660,宇峻凱基99購02,,,,,,0.00,0,0,0,0,0,0,0,0,0,0,0,0,0
20200528,708661,良維凱基97購03,,,,,,0.00,0,0,0,0,0,0,0,0,0,0,0,0,0
20200528,708662,信昌電凱基98購02,,,,,,0.00,0,0,0,0,0,0,0,0,0,0,0,0,0
20200528,708663,茂達凱基97購01,0.88,1.06,0.82,0.82,0.00,0.0,477000,26,453350,0,0,0,0,0,0,331000,146000,185000,185000
20200528,708664,群聯凱基98購02,,,,,,0.00,0,0,0,0,0,0,0,0,0,0,0,0,0
20200528,708665,網家凱基97購01,2.86,2.86,2.51,2.51,-0.38,-13.15,9000,3,24500,0,0,0,0,0,0,0,9000,-9000,-9000
20200528,708666,聚積凱基97購01,,,,,,0.00,0,0,0,0,0,0,0,0,0,0,0,0,0
20200528,708667,廣明凱基98購02,0.57,0.57,0.57,0.57,0.00,0.0,10000,1,5700,0,0,0,0,0,0,0,10000,-10000,-10000
20200528,708668,優群凱基98購03,3.61,3.62,3.51,3.62,+0.61,20.27,55000,6,196100,0,0,0,0,0,0,10000,45000,-35000,-35000
20200528,708669,聯亞凱基99購02,,,,,,0.00,0,0,0,0,0,0,0,0,0,0,0,0,0
20200528,708670,鈺太凱基98購01,,,,,,0.00,0,0,0,0,0,0,0,0,0,0,0,0,0
20200528,708671,頎邦凱基97購04,0.57,0.57,0.57,0.57,-0.01,-1.72,40000,3,22800,0,0,0,0,0,0,20000,20000,0,0
20200528,708672,M31元大99購01,0.58,0.58,0.58,0.58,-0.02,-3.33,57000,3,33060,0,0,0,0,0,0,50000,7000,43000,43000
20200528,708673,凡甲元大98購02,2.00,2.00,1.85,1.85,-0.07,-3.65,93000,10,181710,0,0,0,0,0,0,93000,0,93000,93000
20200528,708674,大宇資元大98購01,0.26,0.26,0.26,0.26,+0.05,23.81,154000,2,40040,0,0,0,0,0,0,154000,0,154000,154000
20200528,708675,六角元大98購02,,,,,,0.00,0,0,0,0,0,0,0,0,0,0,0,0,0
20200528,708677,晶焱元大98購01,,,,,,0.00,0,0,0,0,0,0,0,0,0,0,0,0,0
20200528,708678,鈊象元大97購04,5.55,5.55,5.55,5.55,+0.62,12.58,20000,3,111000,0,0,0,0,0,0,1000,20000,-19000,-19000
20200528,708679,光頡國票98購01,0.71,0.71,0.71,0.71,-0.02,-2.74,112000,2,79520,0,0,0,0,0,0,0,112000,-112000,-112000
20200528,708680,金居國票98購01,,,,,,0.00,0,0,0,0,0,0,0,0,0,0,0,0,0
20200528,708681,建榮國票99購01,,,,,,0.00,0,0,0,0,0,0,0,0,0,0,0,0,0
20200528,708682,穩懋國票98購01,,,,,,0.00,0,0,0,0,0,0,0,0,0,0,0,0,0
20200528,708683,鈊象國票97購03,,,,,,0.00,0,0,0,0,0,0,0,0,0,0,0,0,0
20200528,708684,光頡國泰98購01,0.59,0.63,0.59,0.59,-0.03,-4.84,40000,3,24400,0,0,0,0,0,0,20000,20000,0,0
20200528,708685,亞泰國泰98購01,,,,,,0.00,0,0,0,0,0,0,0,0,0,0,0,0,0
20200528,708686,世界兆豐97購01,,,,,,0.00,0,0,0,0,0,0,0,0,0,0,0,0,0
20200528,708687,同致兆豐98購01,0.67,0.68,0.54,0.54,+0.01,1.89,163000,23,92940,0,0,0,0,0,0,120000,3000,117000,117000
20200528,708688,宜鼎兆豐98購01,2.34,2.44,2.28,2.28,-0.03,-1.3,187000,10,446940,0,0,0,0,0,0,6000,181000,-175000,-175000
20200528,708689,勝麗群益98購02,1.43,1.43,1.40,1.40,-0.05,-3.45,30000,7,42760,0,0,0,0,0,0,30000,0,30000,30000
20200528,708690,晟德群益97購01,,,,,,0.00,0,0,0,0,0,0,0,0,0,0,0,0,0
20200528,708691,穩懋永豐97購02,,,,,,0.00,0,0,0,0,0,0,0,0,0,0,0,0,0
20200528,708692,元太亞東97購01,2.74,2.74,2.74,2.74,-0.11,-3.86,1000,1,2740,0,0,0,0,0,0,1000,0,1000,1000
20200528,708693,台半中信99購01,0.09,0.09,0.09,0.09,-0.01,-10.0,1000,1,90,0,0,0,0,0,0,1000,0,1000,1000
20200528,708694,M31統一98購01,0.80,0.80,0.66,0.66,-0.18,-21.43,70000,6,50120,0,0,0,0,0,0,0,60000,-60000,-60000
20200528,708695,波若威統一97購01,0.48,0.48,0.43,0.43,-0.11,-20.37,495000,11,226450,0,0,0,0,0,0,231000,264000,-33000,-33000
20200528,708696,建榮統一9A購01,,,,,,0.00,0,0,0,0,0,0,0,0,0,0,0,0,0
20200528,708697,建榮統一9A購02,0.33,0.33,0.33,0.33,-0.01,-2.94,40000,1,13200,0,0,0,0,0,0,40000,0,40000,40000
20200528,708698,雙鴻統一97購02,0.43,0.45,0.43,0.45,+0.01,2.27,165000,3,71450,0,0,0,0,0,0,0,165000,-165000,-165000
20200528,708699,雙鴻統一99購01,,,,,,0.00,0,0,0,0,0,0,0,0,0,0,0,0,0
20200528,708700,穩懋統一99購01,,,,,,0.00,0,0,0,0,0,0,0,0,0,0,0,0,0
20200528,708701,建榮凱基97購02,,,,,,0.00,0,0,0,0,0,0,0,0,0,0,0,0,0
20200528,708702,原相凱基98購02,1.60,1.60,1.06,1.06,-0.45,-29.8,277000,11,314160,0,0,0,0,0,0,217000,260000,-43000,-43000
20200528,708703,精測凱基97購04,,,,,,0.00,0,0,0,0,0,0,0,0,0,0,0,0,0
20200528,708704,環球晶凱基97購03,,,,,,0.00,0,0,0,0,0,0,0,0,0,0,0,0,0
20200528,708705,穩懋凱基97購01,,,,,,0.00,0,0,0,0,0,0,0,0,0,0,0,0,0
20200528,708706,鈺太凱基98購02,0.76,0.76,0.76,0.76,-0.02,-2.56,10000,1,7600,0,0,0,0,0,0,10000,0,10000,10000
20200528,708707,大江元大97購04,,,,,,0.00,0,0,0,0,0,0,0,0,0,0,0,0,0
20200528,708708,光頡元大98購01,,,,,,0.00,0,0,0,0,0,0,0,0,0,0,0,0,0
20200528,708709,新普元大97購02,1.84,2.18,1.84,2.16,+0.30,16.13,296000,25,596510,0,0,0,0,0,0,71000,263000,-192000,-192000
20200528,708710,新普元大97購03,2.75,2.75,2.51,2.51,+0.06,2.45,6000,6,15570,0,0,0,0,0,0,0,6000,-6000,-6000
20200528,708711,群聯元大97購05,,,,,,0.00,0,0,0,0,0,0,0,0,0,0,0,0,0
20200528,708712,聯亞元大97購05,,,,,,0.00,0,0,0,0,0,0,0,0,0,0,0,0,0
20200528,708713,雙鴻元大99購04,0.47,0.47,0.47,0.47,-0.01,-2.08,10000,1,4700,0,0,0,0,0,0,10000,0,10000,10000
20200528,708714,聯亞元富97購01,0.48,0.48,0.48,0.48,+0.01,2.13,50000,1,24000,0,0,0,0,0,0,0,50000,-50000,-50000
20200528,708715,台燿日盛97購01,,,,,,0.00,0,0,0,0,0,0,0,0,0,0,0,0,0
20200528,708716,建榮永豐97購02,,,,,,0.00,0,0,0,0,0,0,0,0,0,0,0,0,0
20200528,708717,閎康永豐97購01,0.91,0.96,0.90,0.90,-0.12,-11.76,289000,8,268850,0,0,0,0,0,0,206000,83000,123000,123000
20200528,708718,譜瑞永豐97購01,,,,,,0.00,0,0,0,0,0,0,0,0,0,0,0,0,0
20200528,708719,鈊象永豐98購01,4.27,4.27,4.27,4.27,+1.02,31.38,5000,1,21350,0,0,0,0,0,0,0,5000,-5000,-5000
20200528,708720,力致國票97購01,0.35,0.35,0.35,0.35,-0.12,-25.53,2000,1,700,0,0,0,0,0,0,0,2000,-2000,-2000
20200528,708721,光頡國票98購02,,,,,,0.00,0,0,0,0,0,0,0,0,0,0,0,0,0
20200528,708722,金居國票98購02,,,,,,0.00,0,0,0,0,0,0,0,0,0,0,0,0,0
20200528,708723,威剛國票98購02,,,,,,0.00,0,0,0,0,0,0,0,0,0,0,0,0,0
20200528,708724,晶焱國票98購01,0.72,0.72,0.72,0.72,-0.02,-2.7,41000,1,29520,0,0,0,0,0,0,41000,0,41000,41000
20200528,708725,群聯國票98購02,,,,,,0.00,0,0,0,0,0,0,0,0,0,0,0,0,0
20200528,708726,廣明國票98購02,2.31,2.31,2.31,2.31,+0.01,0.43,38000,1,87780,0,0,0,0,0,0,0,38000,-38000,-38000
20200528,708727,光頡國泰99購01,0.34,0.34,0.33,0.33,-0.03,-8.33,8000,2,2670,0,0,0,0,0,0,5000,3000,2000,2000
20200528,708728,原相國泰98購03,,,,,,0.00,0,0,0,0,0,0,0,0,0,0,0,0,0
20200528,708729,大江富邦99購01,0.12,0.12,0.12,0.12,-0.03,-20.0,1000,1,120,0,0,0,0,0,0,0,0,0,0
20200528,708730,久元群益97購01,3.57,3.60,2.68,2.68,+0.47,21.27,17000,3,51970,0,0,0,0,0,0,0,17000,-17000,-17000
20200528,708731,聚積群益97購02,,,,,,0.00,0,0,0,0,0,0,0,0,0,0,0,0,0
20200528,708732,頎邦群益98購02,,,,,,0.00,0,0,0,0,0,0,0,0,0,0,0,0,0
20200528,708733,M31凱基99購01,,,,,,0.00,0,0,0,0,0,0,0,0,0,0,0,0,0
20200528,708734,中美晶凱基97購04,,,,,,0.00,0,0,0,0,0,0,0,0,0,0,0,0,0
20200528,708735,昇達科凱基97購01,0.72,0.72,0.72,0.72,+0.04,5.88,50000,4,36000,0,0,0,0,0,0,50000,50000,0,0
20200528,708736,聯亞凱基97購02,,,,,,0.00,0,0,0,0,0,0,0,0,0,0,0,0,0
20200528,708737,雙美凱基99購01,,,,,,0.00,0,0,0,0,0,0,0,0,0,0,0,0,0
20200528,708738,穩懋凱基97購02,0.96,0.99,0.96,0.99,-0.06,-5.71,35000,2,33900,0,0,0,0,0,0,25000,10000,15000,15000
20200528,708739,穩懋凱基97購03,0.38,0.38,0.38,0.38,-0.03,-7.32,100000,1,38000,0,0,0,0,0,0,100000,0,100000,100000
20200528,708740,譜瑞凱基97購01,,,,,,0.00,0,0,0,0,0,0,0,0,0,0,0,0,0
20200528,708741,鈊象凱基98購03,4.15,5.30,4.15,5.10,+1.47,40.5,136000,24,663450,0,0,0,0,0,0,48000,134000,-86000,-86000
20200528,708742,新普麥證97購01,1.06,1.19,1.02,1.15,+0.14,13.86,162000,6,180090,57000,105000,-48000,0,0,0,57000,105000,-48000,-48000
20200528,708743,同致元富97購01,,,,,,0.00,0,0,0,0,0,0,0,0,0,0,0,0,0
20200528,708744,金居元富97購01,,,,,,0.00,0,0,0,0,0,0,0,0,0,0,0,0,0
20200528,708745,原相元富97購01,0.31,0.32,0.31,0.32,-0.04,-11.11,34000,2,10780,0,0,0,0,0,0,34000,0,34000,34000
20200528,708746,穩懋元富97購01,,,,,,0.00,0,0,0,0,0,0,0,0,0,0,0,0,0
20200528,708747,立端亞東98購01,,,,,,0.00,0,0,0,0,0,0,0,0,0,0,0,0,0
20200528,708748,合晶永豐97購03,,,,,,0.00,0,0,0,0,0,0,0,0,0,0,0,0,0
20200528,708749,旺矽永豐97購03,,,,,,0.00,0,0,0,0,0,0,0,0,0,0,0,0,0
20200528,708750,信驊永豐97購01,2.04,2.18,1.81,1.85,+0.06,3.35,366000,48,739380,0,0,0,0,0,0,98000,268000,-170000,-170000
20200528,708751,聯亞永豐97購01,,,,,,0.00,0,0,0,0,0,0,0,0,0,0,0,0,0
20200528,708752,原相統一97購01,1.19,1.19,0.95,0.95,-0.20,-17.39,472000,23,513190,0,0,0,0,0,0,466000,5000,461000,461000
20200528,708753,廣明統一9A購01,1.15,1.16,1.15,1.16,-0.04,-3.33,12000,2,13860,0,0,0,0,0,0,6000,12000,-6000,-6000
20200528,708754,聯亞統一98購01,,,,,,0.00,0,0,0,0,0,0,0,0,0,0,0,0,0
20200528,708755,鈊象統一99購01,,,,,,0.00,0,0,0,0,0,0,0,0,0,0,0,0,0
20200528,708756,大中國票98購01,,,,,,0.00,0,0,0,0,0,0,0,0,0,0,0,0,0
20200528,708757,大江國票97購06,,,,,,0.00,0,0,0,0,0,0,0,0,0,0,0,0,0
20200528,708758,佳邦國票98購01,,,,,,0.00,0,0,0,0,0,0,0,0,0,0,0,0,0
20200528,708759,宜鼎國票97購04,,,,,,0.00,0,0,0,0,0,0,0,0,0,0,0,0,0
20200528,708760,信昌電國票98購02,0.76,0.76,0.76,0.76,-0.03,-3.8,10000,1,7600,0,0,0,0,0,0,10000,0,10000,10000
20200528,708761,宣德國票98購01,0.75,0.85,0.75,0.82,+0.11,15.49,560000,29,449370,0,0,0,0,0,0,65000,535000,-470000,-470000
20200528,708762,神盾國票98購02,0.21,0.21,0.18,0.19,-0.06,-24.0,160000,8,32600,0,0,0,0,0,0,5000,155000,-150000,-150000
20200528,708763,群聯國票98購03,,,,,,0.00,0,0,0,0,0,0,0,0,0,0,0,0,0
20200528,708764,緯軟國票98購01,,,,,,0.00,0,0,0,0,0,0,0,0,0,0,0,0,0
20200528,708765,威剛國泰98購03,,,,,,0.00,0,0,0,0,0,0,0,0,0,0,0,0,0
20200528,708766,廣明國泰98購01,,,,,,0.00,0,0,0,0,0,0,0,0,0,0,0,0,0
20200528,708767,穩懋富邦99購01,0.42,0.42,0.40,0.40,-0.01,-2.44,64000,3,25800,0,0,0,0,0,0,14000,50000,-36000,-36000
20200528,708768,六角元大97購01,,,,,,0.00,0,0,0,0,0,0,0,0,0,0,0,0,0
20200528,708769,合晶元大98購03,1.68,1.74,1.63,1.63,-0.01,-0.61,76000,3,127940,0,0,0,0,0,0,2000,74000,-72000,-72000
20200528,708770,泰博元大97購01,,,,,,0.00,0,0,0,0,0,0,0,0,0,0,0,0,0
20200528,708771,精測元大97購05,,,,,,0.00,0,0,0,0,0,0,0,0,0,0,0,0,0
20200528,708772,聚積元大98購01,,,,,,0.00,0,0,0,0,0,0,0,0,0,0,0,0,0
20200528,708773,廣明元大97購02,0.92,0.92,0.89,0.92,-0.02,-2.13,132000,4,120140,0,0,0,0,0,0,50000,82000,-32000,-32000
20200528,708774,璟德元大97購04,0.47,0.47,0.47,0.47,-0.11,-18.97,10000,1,4700,0,0,0,0,0,0,10000,0,10000,10000
20200528,708775,穩懋元大97購07,,,,,,0.00,0,0,0,0,0,0,0,0,0,0,0,0,0
20200528,708776,穩懋元大98購01,,,,,,0.00,0,0,0,0,0,0,0,0,0,0,0,0,0
20200528,708777,旺矽兆豐98購01,,,,,,0.00,0,0,0,0,0,0,0,0,0,0,0,0,0
20200528,708778,環球晶兆豐98購01,,,,,,0.00,0,0,0,0,0,0,0,0,0,0,0,0,0
20200528,708779,雙鴻兆豐98購01,0.63,0.63,0.62,0.62,-0.04,-6.06,90000,2,56320,0,0,0,0,0,0,52000,38000,14000,14000
20200528,708780,穩懋兆豐97購03,,,,,,0.00,0,0,0,0,0,0,0,0,0,0,0,0,0
20200528,708781,信驊群益97購01,,,,,,0.00,0,0,0,0,0,0,0,0,0,0,0,0,0
20200528,708782,建榮群益98購01,,,,,,0.00,0,0,0,0,0,0,0,0,0,0,0,0,0
20200528,708783,優群群益99購01,,,,,,0.00,0,0,0,0,0,0,0,0,0,0,0,0,0
20200528,708784,環宇群益97購02,,,,,,0.00,0,0,0,0,0,0,0,0,0,0,0,0,0
20200528,708785,信驊中信9B購01,1.62,1.72,1.50,1.50,+0.02,1.35,101000,21,164290,0,0,0,0,0,0,24000,77000,-53000,-53000
20200528,708786,中美晶凱基97購05,1.65,1.65,1.53,1.53,-0.19,-11.05,90000,3,142600,0,0,0,0,0,0,45000,45000,0,0
20200528,708787,同致凱基98購02,,,,,,0.00,0,0,0,0,0,0,0,0,0,0,0,0,0
20200528,708788,泰博凱基99購01,,,,,,0.00,0,0,0,0,0,0,0,0,0,0,0,0,0
20200528,708789,群聯凱基97購01,,,,,,0.00,0,0,0,0,0,0,0,0,0,0,0,0,0
20200528,708790,優群凱基98購04,5.95,5.95,5.95,5.95,+1.06,21.68,2000,1,11900,0,0,0,0,0,0,2000,0,2000,2000
20200528,708791,雙美凱基99購02,,,,,,0.00,0,0,0,0,0,0,0,0,0,0,0,0,0
20200528,708792,凡甲國票98購01,1.58,1.58,1.40,1.40,-0.12,-7.89,145000,11,222400,0,0,0,0,0,0,110000,30000,80000,80000
20200528,708793,迅得國票98購01,,,,,,0.00,0,0,0,0,0,0,0,0,0,0,0,0,0
20200528,708794,旺矽國票98購01,,,,,,0.00,0,0,0,0,0,0,0,0,0,0,0,0,0
20200528,708795,原相國票98購03,2.40,2.40,2.26,2.26,-0.13,-5.44,69000,2,164200,0,0,0,0,0,0,59000,10000,49000,49000
20200528,708796,兆利群益97購01,,,,,,0.00,0,0,0,0,0,0,0,0,0,0,0,0,0
20200528,708797,金居群益99購01,1.04,1.09,0.96,0.97,-0.12,-11.01,197000,9,200420,0,0,0,0,0,0,140000,57000,83000,83000
20200528,708798,晶焱群益99購01,,,,,,0.00,0,0,0,0,0,0,0,0,0,0,0,0,0
20200528,708799,閎康群益97購02,0.76,0.78,0.76,0.78,-0.04,-4.88,182000,5,141420,0,0,0,0,0,0,72000,110000,-38000,-38000
20200528,708800,凡甲元富99購01,1.33,1.33,1.20,1.22,-0.06,-4.69,320000,16,409140,0,0,0,0,0,0,248000,72000,176000,176000
20200528,708801,六角元富97購01,0.53,0.56,0.52,0.52,-0.04,-7.14,80000,4,43600,0,0,0,0,0,0,60000,20000,40000,40000
20200528,708802,欣銓元富97購01,,,,,,0.00,0,0,0,0,0,0,0,0,0,0,0,0,0
20200528,708803,晶焱元富99購01,,,,,,0.00,0,0,0,0,0,0,0,0,0,0,0,0,0
20200528,708804,廣明元富99購01,1.26,1.34,1.26,1.34,-0.04,-2.9,95000,3,122250,0,0,0,0,0,0,21000,74000,-53000,-53000
20200528,708805,環球晶元富98購01,,,,,,0.00,0,0,0,0,0,0,0,0,0,0,0,0,0
20200528,708806,環球晶元富99購01,0.55,0.55,0.43,0.43,0.00,0.0,10000,2,4900,0,0,0,0,0,0,5000,5000,0,0
20200528,708807,雙美元富97購01,0.33,0.33,0.33,0.33,+0.03,10.0,40000,2,13200,0,0,0,0,0,0,0,40000,-40000,-40000
20200528,708808,雙鴻元富97購01,0.51,0.52,0.51,0.52,+0.01,1.96,30000,2,15400,0,0,0,0,0,0,20000,10000,10000,10000
20200528,708809,穩懋元富97購02,,,,,,0.00,0,0,0,0,0,0,0,0,0,0,0,0,0
20200528,708810,鈊象元富97購01,,,,,,0.00,0,0,0,0,0,0,0,0,0,0,0,0,0
20200528,708811,雙鴻國泰98購01,,,,,,0.00,0,0,0,0,0,0,0,0,0,0,0,0,0
20200528,708812,精測台新98購01,,,,,,0.00,0,0,0,0,0,0,0,0,0,0,0,0,0
20200528,708813,宇峻元大98購01,,,,,,0.00,0,0,0,0,0,0,0,0,0,0,0,0,0
20200528,708814,建榮元大97購04,,,,,,0.00,0,0,0,0,0,0,0,0,0,0,0,0,0
20200528,708815,泰博元大97購02,,,,,,0.00,0,0,0,0,0,0,0,0,0,0,0,0,0
20200528,708816,聯亞元大97購06,0.67,0.70,0.67,0.70,-0.01,-1.41,44000,2,30740,0,0,0,0,0,0,42000,2000,40000,40000
20200528,708817,譜瑞元大98購01,,,,,,0.00,0,0,0,0,0,0,0,0,0,0,0,0,0
20200528,708818,鈊象元大98購03,1.50,1.96,1.50,1.96,+0.82,71.93,22000,7,40570,0,0,0,0,0,0,11000,21000,-10000,-10000
20200528,708819,合晶永豐97購04,0.46,0.46,0.43,0.43,-0.05,-10.42,30000,3,13200,0,0,0,0,0,0,10000,20000,-10000,-10000
20200528,708820,威剛永豐99購01,,,,,,0.00,0,0,0,0,0,0,0,0,0,0,0,0,0
20200528,708821,原相永豐97購02,0.10,0.10,0.09,0.09,-0.04,-30.77,24000,3,2360,0,0,0,0,0,0,24000,0,24000,24000
20200528,708822,泰博永豐97購01,,,,,,0.00,0,0,0,0,0,0,0,0,0,0,0,0,0
20200528,708823,勝麗永豐97購01,,,,,,0.00,0,0,0,0,0,0,0,0,0,0,0,0,0
20200528,708824,廣明永豐97購03,,,,,,0.00,0,0,0,0,0,0,0,0,0,0,0,0,0
20200528,708825,碩禾中信9A購01,0.02,0.03,0.02,0.02,0.00,0.0,540000,53,11000,0,0,0,0,0,0,0,520000,-520000,-520000
20200528,708826,威剛統一9A購01,,,,,,0.00,0,0,0,0,0,0,0,0,0,0,0,0,0
20200528,708827,群聯統一97購02,,,,,,0.00,0,0,0,0,0,0,0,0,0,0,0,0,0
20200528,708828,六角凱基99購01,,,,,,0.00,0,0,0,0,0,0,0,0,0,0,0,0,0
20200528,708829,宜鼎凱基98購01,0.64,0.64,0.64,0.64,+0.04,6.67,5000,1,3200,0,0,0,0,0,0,0,0,0,0
20200528,708830,信昌電凱基97購03,,,,,,0.00,0,0,0,0,0,0,0,0,0,0,0,0,0
20200528,708831,廣明凱基99購01,1.66,1.66,1.66,1.66,-0.06,-3.49,10000,1,16600,0,0,0,0,0,0,0,10000,-10000,-10000
20200528,708832,群聯台新97購04,,,,,,0.00,0,0,0,0,0,0,0,0,0,0,0,0,0
20200528,708833,中美晶元大97購05,,,,,,0.00,0,0,0,0,0,0,0,0,0,0,0,0,0
20200528,708834,中美晶元大97購06,1.54,1.56,1.47,1.47,-0.09,-5.77,183000,4,280100,0,0,0,0,0,0,95000,88000,7000,7000
20200528,708836,宣德元大97購02,1.03,1.03,1.03,1.03,+0.06,6.19,3000,1,3090,0,0,0,0,0,0,3000,0,3000,3000
20200528,708837,新普元大97購04,2.08,2.13,2.08,2.13,+0.44,26.04,15000,2,31700,0,0,0,0,0,0,10000,5000,5000,5000
20200528,708838,新普元大97購05,2.20,2.62,2.20,2.51,-0.02,-0.79,189000,28,461660,0,0,0,0,0,0,80000,179000,-99000,-99000
20200528,708839,群聯元大97購06,,,,,,0.00,0,0,0,0,0,0,0,0,0,0,0,0,0
20200528,708840,雍智元大99購01,,,,,,0.00,0,0,0,0,0,0,0,0,0,0,0,0,0
20200528,708841,網龍元大98購01,,,,,,0.00,0,0,0,0,0,0,0,0,0,0,0,0,0
20200528,708842,環球晶元大97購04,1.76,1.77,1.76,1.77,+0.03,1.72,100000,2,176500,0,0,0,0,0,0,50000,50000,0,0
20200528,708843,環球晶元大97購05,1.85,1.93,1.84,1.84,+0.04,2.22,96000,4,179410,0,0,0,0,0,0,0,96000,-96000,-96000
20200528,708844,聯亞元大97購07,1.41,1.41,1.35,1.35,-0.06,-4.26,89000,2,124230,0,0,0,0,0,0,21000,68000,-47000,-47000
20200528,708845,雙鴻元大97購03,,,,,,0.00,0,0,0,0,0,0,0,0,0,0,0,0,0
20200528,708846,鈊象元大98購04,1.50,1.66,1.41,1.41,+0.31,28.18,107000,16,159080,0,0,0,0,0,0,60000,28000,32000,32000
20200528,708847,群聯第一97購01,,,,,,0.00,0,0,0,0,0,0,0,0,0,0,0,0,0
20200528,708848,中美晶永豐97購01,,,,,,0.00,0,0,0,0,0,0,0,0,0,0,0,0,0
20200528,708849,胡連永豐97購01,,,,,,0.00,0,0,0,0,0,0,0,0,0,0,0,0,0
20200528,708850,閎康永豐97購02,,,,,,0.00,0,0,0,0,0,0,0,0,0,0,0,0,0
20200528,708851,精測永豐97購02,,,,,,0.00,0,0,0,0,0,0,0,0,0,0,0,0,0
20200528,708852,鈊象永豐97購02,0.58,1.16,0.58,1.16,+0.68,141.67,190000,28,193700,0,0,0,0,0,0,37000,148000,-111000,-111000
20200528,708853,世界群益98購04,0.14,0.15,0.14,0.15,0.00,0.0,51000,2,7150,0,0,0,0,0,0,0,51000,-51000,-51000
20200528,708854,晶焱群益99購02,,,,,,0.00,0,0,0,0,0,0,0,0,0,0,0,0,0
20200528,708855,大江元富97購01,0.81,0.91,0.81,0.90,+0.05,5.88,39000,5,32850,0,0,0,0,0,0,33000,6000,27000,27000
20200528,708856,台燿元富97購01,1.27,1.34,1.24,1.34,+0.02,1.52,354000,32,456630,0,0,0,0,0,0,243000,111000,132000,132000
20200528,708857,宜鼎元富97購01,1.08,1.08,1.08,1.08,+0.01,0.93,3000,1,3240,0,0,0,0,0,0,0,3000,-3000,-3000
20200528,708858,昇達科元富97購01,,,,,,0.00,0,0,0,0,0,0,0,0,0,0,0,0,0
20200528,708859,信驊元富97購01,5.75,5.95,5.65,5.65,+0.50,9.71,19000,4,109250,0,0,0,0,0,0,0,19000,-19000,-19000
20200528,708860,威剛元富97購02,0.02,0.02,0.02,0.02,-0.08,-80.0,1000,1,20,0,0,0,0,0,0,1000,1000,0,0
20200528,708861,新普元富97購01,1.38,1.54,1.34,1.43,+0.07,5.15,849000,35,1229420,0,0,0,0,0,0,230000,619000,-389000,-389000
20200528,708862,網家元富97購01,,,,,,0.00,0,0,0,0,0,0,0,0,0,0,0,0,0
20200528,708863,聚積元富97購01,,,,,,0.00,0,0,0,0,0,0,0,0,0,0,0,0,0
20200528,708864,穩懋元富97購03,,,,,,0.00,0,0,0,0,0,0,0,0,0,0,0,0,0
20200528,708865,直得國票97購01,0.68,0.68,0.20,0.20,-0.40,-66.67,492000,22,223230,0,0,0,0,0,0,325000,139000,186000,186000
20200528,708866,原相國泰98購04,2.26,2.31,2.03,2.03,-0.12,-5.58,106000,13,229050,0,0,0,0,0,0,106000,0,106000,106000
20200528,708867,鈊象國泰99購01,1.93,2.00,1.93,2.00,+0.55,37.93,6000,2,11650,0,0,0,0,0,0,6000,0,6000,6000
20200528,708868,鈊象中信99購01,1.20,1.31,1.20,1.30,+0.48,58.54,43000,7,55200,0,0,0,0,0,0,9000,32000,-23000,-23000
20200528,708869,凡甲凱基98購01,1.20,1.20,1.10,1.10,-0.12,-9.84,188000,13,214670,0,0,0,0,0,0,88000,100000,-12000,-12000
20200528,708870,大江凱基98購03,,,,,,0.00,0,0,0,0,0,0,0,0,0,0,0,0,0
20200528,708871,信驊凱基98購01,3.83,4.00,3.44,3.44,+0.05,1.47,34000,8,129130,0,0,0,0,0,0,5000,29000,-24000,-24000
20200528,708872,新鉅科凱基97購01,,,,,,0.00,0,0,0,0,0,0,0,0,0,0,0,0,0
20200528,708873,精測凱基98購02,,,,,,0.00,0,0,0,0,0,0,0,0,0,0,0,0,0
20200528,708874,群聯統一97購03,,,,,,0.00,0,0,0,0,0,0,0,0,0,0,0,0,0
20200528,708875,譜瑞統一97購01,,,,,,0.00,0,0,0,0,0,0,0,0,0,0,0,0,0
20200528,708876,信昌電兆豐98購01,,,,,,0.00,0,0,0,0,0,0,0,0,0,0,0,0,0
20200528,708877,胡連康和97購01,,,,,,0.00,0,0,0,0,0,0,0,0,0,0,0,0,0
20200528,708878,台燿群益97購01,0.89,0.99,0.86,0.99,+0.09,10.0,312000,17,279190,0,0,0,0,0,0,278000,34000,244000,244000
20200528,708879,博智群益97購01,,,,,,0.00,0,0,0,0,0,0,0,0,0,0,0,0,0
20200528,708880,雙鴻群益99購01,,,,,,0.00,0,0,0,0,0,0,0,0,0,0,0,0,0
20200528,708881,金居國泰99購01,1.00,1.00,0.86,0.86,-0.15,-14.85,76000,5,73240,0,0,0,0,0,0,71000,5000,66000,66000
20200528,708882,威剛元富97購04,0.43,0.43,0.43,0.43,-0.01,-2.27,5000,1,2150,0,0,0,0,0,0,5000,0,5000,5000
20200528,708883,原相元富97購02,,,,,,0.00,0,0,0,0,0,0,0,0,0,0,0,0,0
20200528,708884,聯亞元富97購03,,,,,,0.00,0,0,0,0,0,0,0,0,0,0,0,0,0
20200528,708885,穩懋元富97購04,0.47,0.48,0.45,0.47,-0.01,-2.08,191000,10,89070,0,0,0,0,0,0,91000,100000,-9000,-9000
20200528,708886,鈊象元富97購02,2.98,3.81,2.98,3.81,+1.17,44.32,100000,15,339230,0,0,0,0,0,0,10000,90000,-80000,-80000
20200528,708887,鈊象台新97購02,,,,,,0.00,0,0,0,0,0,0,0,0,0,0,0,0,0
20200528,708888,中美晶元大97購07,1.00,1.00,1.00,1.00,-0.13,-11.5,68000,1,68000,0,0,0,0,0,0,68000,0,68000,68000
20200528,708889,台燿元大97購01,1.10,1.15,1.07,1.15,+0.03,2.68,50000,6,55180,0,0,0,0,0,0,38000,12000,26000,26000
20200528,708890,宜鼎元大97購02,1.17,1.24,1.12,1.14,+0.04,3.64,430000,15,507740,0,0,0,0,0,0,92000,328000,-236000,-236000
20200528,708891,金居元大99購01,0.68,0.68,0.66,0.66,-0.06,-8.33,511000,4,347460,0,0,0,0,0,0,510000,1000,509000,509000
20200528,708892,胡連元大97購01,0.28,0.28,0.23,0.23,-0.04,-14.81,45000,2,11350,0,0,0,0,0,0,25000,20000,5000,5000
20200528,708893,泰博元大97購03,,,,,,0.00,0,0,0,0,0,0,0,0,0,0,0,0,0
20200528,708894,閎康元大97購01,0.78,0.80,0.77,0.80,-0.02,-2.44,208000,5,162670,0,0,0,0,0,0,181000,27000,154000,154000
20200528,708895,環球晶元大97購06,,,,,,0.00,0,0,0,0,0,0,0,0,0,0,0,0,0
20200528,708896,環球晶元大97購07,,,,,,0.00,0,0,0,0,0,0,0,0,0,0,0,0,0
20200528,708897,櫃200元大99購03,,,,,,0.00,0,0,0,0,0,0,0,0,0,0,0,0,0
20200528,708898,櫃200元大99購04,,,,,,0.00,0,0,0,0,0,0,0,0,0,0,0,0,0
20200528,708899,頎邦元大97購05,1.03,1.03,0.95,0.95,+0.01,1.06,108000,2,105800,0,0,0,0,0,0,40000,68000,-28000,-28000
20200528,708900,中美晶元大97購08,1.22,1.22,1.21,1.21,0.00,0.0,207000,3,251550,0,0,0,0,0,0,0,207000,-207000,-207000
20200528,708901,台燿元大97購02,1.20,1.26,1.15,1.24,+0.04,3.33,433000,14,530820,0,0,0,0,0,0,233000,210000,23000,23000
20200528,708902,迅得元大99購01,0.30,0.30,0.30,0.30,-0.04,-11.76,100000,1,30000,0,0,0,0,0,0,0,100000,-100000,-100000
20200528,708903,宜鼎元大97購03,,,,,,0.00,0,0,0,0,0,0,0,0,0,0,0,0,0
20200528,708904,旺矽元大98購01,,,,,,0.00,0,0,0,0,0,0,0,0,0,0,0,0,0
20200528,708905,威剛元大97購01,,,,,,0.00,0,0,0,0,0,0,0,0,0,0,0,0,0
20200528,708906,泰博元大97購04,,,,,,0.00,0,0,0,0,0,0,0,0,0,0,0,0,0
20200528,708907,精測元大97購06,,,,,,0.00,0,0,0,0,0,0,0,0,0,0,0,0,0
20200528,708908,廣明元大97購03,1.57,1.57,1.57,1.57,-0.15,-8.72,17000,1,26690,0,0,0,0,0,0,17000,0,17000,17000
20200528,708909,優群元大99購01,,,,,,0.00,0,0,0,0,0,0,0,0,0,0,0,0,0
20200528,708910,環球晶元大97購08,1.02,1.11,1.02,1.11,+0.09,8.82,136000,2,144840,0,0,0,0,0,0,68000,68000,0,0
20200528,708911,環球晶元大97購09,0.51,0.51,0.51,0.51,-0.06,-10.53,10000,1,5100,0,0,0,0,0,0,0,10000,-10000,-10000
20200528,708912,世界麥證97購02,,,,,,0.00,0,0,0,0,0,0,0,0,0,0,0,0,0
20200528,708913,大江永豐97購03,0.51,0.55,0.50,0.55,+0.04,7.84,29000,3,14850,0,0,0,0,0,0,19000,10000,9000,9000
20200528,708914,旺矽永豐97購04,0.31,0.31,0.26,0.26,-0.04,-13.33,120000,6,34500,0,0,0,0,0,0,0,120000,-120000,-120000
20200528,708915,新普永豐97購01,0.52,0.62,0.52,0.62,+0.03,5.08,171000,4,97140,0,0,0,0,0,0,103000,68000,35000,35000
20200528,708916,精華永豐97購01,,,,,,0.00,0,0,0,0,0,0,0,0,0,0,0,0,0
20200528,708917,原相兆豐98購01,,,,,,0.00,0,0,0,0,0,0,0,0,0,0,0,0,0
20200528,708918,群聯台新97購05,,,,,,0.00,0,0,0,0,0,0,0,0,0,0,0,0,0
20200528,708919,中美晶群益97購04,,,,,,0.00,0,0,0,0,0,0,0,0,0,0,0,0,0
20200528,708920,同致群益97購01,,,,,,0.00,0,0,0,0,0,0,0,0,0,0,0,0,0
20200528,708921,勝麗群益97購01,0.91,0.91,0.88,0.88,-0.08,-8.33,16000,2,14530,0,0,0,0,0,0,16000,0,16000,16000
20200528,708922,緯軟群益98購02,,,,,,0.00,0,0,0,0,0,0,0,0,0,0,0,0,0
20200528,708923,鈊象群益97購01,2.34,2.34,2.34,2.34,+0.89,61.38,2000,1,4680,0,0,0,0,0,0,2000,0,2000,2000
20200528,708924,穩懋永昌9C購01,,,,,,0.00,0,0,0,0,0,0,0,0,0,0,0,0,0
20200528,708925,世界統一97購02,,,,,,0.00,0,0,0,0,0,0,0,0,0,0,0,0,0
20200528,708926,胡連統一98購01,,,,,,0.00,0,0,0,0,0,0,0,0,0,0,0,0,0
20200528,708927,胡連統一99購01,,,,,,0.00,0,0,0,0,0,0,0,0,0,0,0,0,0
20200528,708928,環球晶統一97購02,0.61,0.61,0.55,0.55,0.00,0.0,102000,3,61040,0,0,0,0,0,0,7000,95000,-88000,-88000
20200528,708929,雍智中信97購01,0.50,0.50,0.41,0.41,-0.10,-19.61,418000,18,187360,0,0,0,0,0,0,60000,358000,-298000,-298000
20200528,708930,聚積中信97購01,,,,,,0.00,0,0,0,0,0,0,0,0,0,0,0,0,0
20200528,708931,VHQ凱基97購01,,,,,,0.00,0,0,0,0,0,0,0,0,0,0,0,0,0
20200528,708932,VHQ凱基98購01,,,,,,0.00,0,0,0,0,0,0,0,0,0,0,0,0,0
20200528,708933,神盾凱基98購02,,,,,,0.00,0,0,0,0,0,0,0,0,0,0,0,0,0
20200528,708934,晶焱凱基98購02,,,,,,0.00,0,0,0,0,0,0,0,0,0,0,0,0,0
20200528,708935,環球晶凱基97購04,,,,,,0.00,0,0,0,0,0,0,0,0,0,0,0,0,0
20200528,708936,環球晶凱基97購05,,,,,,0.00,0,0,0,0,0,0,0,0,0,0,0,0,0
20200528,708937,雙鴻富邦98購01,,,,,,0.00,0,0,0,0,0,0,0,0,0,0,0,0,0
20200528,708938,大宇資國票98購01,,,,,,0.00,0,0,0,0,0,0,0,0,0,0,0,0,0
20200528,708939,金居國票98購03,2.05,2.09,1.86,1.86,-0.44,-19.13,100000,3,198740,0,0,0,0,0,0,38000,62000,-24000,-24000
20200528,708940,碩禾國票98購01,,,,,,0.00,0,0,0,0,0,0,0,0,0,0,0,0,0
20200528,708941,M31元富97購01,0.73,0.73,0.71,0.71,-0.07,-8.97,340000,9,244580,0,0,0,0,0,0,340000,0,340000,340000
20200528,708942,金居第一97購01,0.22,0.22,0.21,0.21,-0.10,-32.26,117000,2,25240,0,0,0,0,0,0,117000,117000,0,0
20200528,708943,M31元富97購02,0.70,0.71,0.64,0.64,-0.12,-15.79,298000,10,201440,0,0,0,0,0,0,298000,0,298000,298000
20200528,708944,閎康元富97購01,0.49,0.49,0.48,0.48,0.00,0.0,25000,2,12050,0,0,0,0,0,0,20000,5000,15000,15000
20200528,708945,大田永豐97購01,,,,,,0.00,0,0,0,0,0,0,0,0,0,0,0,0,0
20200528,708946,六角永豐97購02,0.26,0.26,0.26,0.26,-0.07,-21.21,29000,1,7540,0,0,0,0,0,0,29000,0,29000,29000
20200528,708947,群聯永豐97購01,,,,,,0.00,0,0,0,0,0,0,0,0,0,0,0,0,0
20200528,708948,雙鴻永豐97購04,,,,,,0.00,0,0,0,0,0,0,0,0,0,0,0,0,0
20200528,708949,旺矽康和97購02,,,,,,0.00,0,0,0,0,0,0,0,0,0,0,0,0,0
20200528,708950,威剛康和97購02,,,,,,0.00,0,0,0,0,0,0,0,0,0,0,0,0,0
20200528,708951,合晶群益99購01,2.02,2.02,1.86,1.86,-0.07,-3.63,177000,3,333940,0,0,0,0,0,0,74000,103000,-29000,-29000
20200528,708952,迅得群益98購01,0.34,0.34,0.34,0.34,-0.01,-2.86,100000,1,34000,0,0,0,0,0,0,100000,0,100000,100000
20200528,708953,宜鼎群益97購02,,,,,,0.00,0,0,0,0,0,0,0,0,0,0,0,0,0
20200528,708954,胡連群益97購01,,,,,,0.00,0,0,0,0,0,0,0,0,0,0,0,0,0
20200528,708955,雙美群益98購01,,,,,,0.00,0,0,0,0,0,0,0,0,0,0,0,0,0
20200528,708956,大江凱基97購02,,,,,,0.00,0,0,0,0,0,0,0,0,0,0,0,0,0
20200528,708957,世界凱基97購01,,,,,,0.00,0,0,0,0,0,0,0,0,0,0,0,0,0
20200528,708958,台燿凱基98購01,2.61,2.69,2.54,2.69,-0.04,-1.47,31000,10,79450,0,0,0,0,0,0,31000,0,31000,31000
20200528,708959,宣德凱基98購01,0.90,0.93,0.88,0.88,-0.05,-5.38,74000,6,67350,0,0,0,0,0,0,3000,71000,-68000,-68000
20200528,708960,璟德凱基97購01,0.95,0.95,0.95,0.95,-0.07,-6.86,10000,1,9500,0,0,0,0,0,0,0,10000,-10000,-10000
20200528,708961,環球晶凱基97購06,,,,,,0.00,0,0,0,0,0,0,0,0,0,0,0,0,0
20200528,708962,鈊象凱基98購04,1.40,1.80,1.40,1.80,+0.67,59.29,31000,4,47800,0,0,0,0,0,0,20000,0,20000,20000
20200528,708963,譜瑞凱基97購02,3.90,4.21,3.88,3.88,-1.07,-21.62,35000,10,137940,0,0,0,0,0,0,28000,7000,21000,21000
20200528,708964,信昌電國票98購03,0.78,0.78,0.70,0.70,-0.10,-12.5,101000,3,75690,0,0,0,0,0,0,100000,1000,99000,99000
20200528,708965,廣明國票98購03,1.94,2.01,1.93,1.93,-0.13,-6.31,100000,3,197780,0,0,0,0,0,0,35000,65000,-30000,-30000
20200528,708966,聯亞國票98購01,,,,,,0.00,0,0,0,0,0,0,0,0,0,0,0,0,0
20200528,708967,大江元大97購05,,,,,,0.00,0,0,0,0,0,0,0,0,0,0,0,0,0
20200528,708968,中美晶元大97購09,,,,,,0.00,0,0,0,0,0,0,0,0,0,0,0,0,0
20200528,708969,宣德元大97購03,,,,,,0.00,0,0,0,0,0,0,0,0,0,0,0,0,0
20200528,708970,群聯元大97購07,,,,,,0.00,0,0,0,0,0,0,0,0,0,0,0,0,0
20200528,708971,精測元大97購07,,,,,,0.00,0,0,0,0,0,0,0,0,0,0,0,0,0
20200528,708972,網龍元大98購02,,,,,,0.00,0,0,0,0,0,0,0,0,0,0,0,0,0
20200528,708973,聚積元大97購01,0.17,0.17,0.17,0.17,-0.01,-5.56,100000,1,17000,0,0,0,0,0,0,0,100000,-100000,-100000
20200528,708974,環球晶元大97購10,0.85,0.91,0.85,0.91,+0.02,2.25,68000,2,61280,0,0,0,0,0,0,68000,0,68000,68000
20200528,708975,環球晶元大97購11,,,,,,0.00,0,0,0,0,0,0,0,0,0,0,0,0,0
20200528,708976,環球晶元大97購12,0.91,0.93,0.91,0.93,+0.06,6.9,68000,3,63040,0,0,0,0,0,0,0,68000,-68000,-68000
20200528,708977,M31兆豐97購01,0.28,0.28,0.25,0.25,-0.06,-19.35,90000,12,24150,0,0,0,0,0,0,85000,15000,70000,70000
20200528,708978,頎邦兆豐97購01,0.44,0.44,0.40,0.40,-0.02,-4.76,225000,5,90550,0,0,0,0,0,0,205000,20000,185000,185000
20200528,708979,VHQ統一98購01,,,,,,0.00,0,0,0,0,0,0,0,0,0,0,0,0,0
20200528,708980,威剛統一98購01,,,,,,0.00,0,0,0,0,0,0,0,0,0,0,0,0,0
20200528,708981,光頡國票98購03,0.49,0.49,0.47,0.47,-0.03,-6.0,165000,3,80810,0,0,0,0,0,0,2000,163000,-161000,-161000
20200528,708982,大學光國泰99購01,6.60,6.60,6.60,6.60,+0.30,4.76,5000,1,33000,0,0,0,0,0,0,5000,0,5000,5000
20200528,708983,穩懋國泰98購02,,,,,,0.00,0,0,0,0,0,0,0,0,0,0,0,0,0
20200528,708984,大江凱基97購03,,,,,,0.00,0,0,0,0,0,0,0,0,0,0,0,0,0
20200528,708985,六角凱基99購02,0.21,0.21,0.21,0.21,-0.04,-16.0,13000,1,2730,0,0,0,0,0,0,0,13000,-13000,-13000
20200528,708986,旺矽凱基97購02,1.28,1.28,1.20,1.20,-0.03,-2.44,611000,11,763280,0,0,0,0,0,0,10000,601000,-591000,-591000
20200528,708987,環球晶凱基97購07,,,,,,0.00,0,0,0,0,0,0,0,0,0,0,0,0,0
20200528,708988,雙鴻凱基98購02,0.97,0.97,0.91,0.91,-0.09,-9.0,287000,8,272840,0,0,0,0,0,0,50000,237000,-187000,-187000
20200528,708989,穩懋凱基97購05,1.41,1.41,1.41,1.41,-0.10,-6.62,49000,1,69090,0,0,0,0,0,0,0,49000,-49000,-49000
20200528,708990,穩懋凱基98購01,,,,,,0.00,0,0,0,0,0,0,0,0,0,0,0,0,0
20200528,708991,穩懋凱基98購02,,,,,,0.00,0,0,0,0,0,0,0,0,0,0,0,0,0
20200528,708992,M31元大98購02,0.93,0.93,0.92,0.92,+0.03,3.37,100000,3,92930,0,0,0,0,0,0,100000,0,100000,100000
20200528,708993,大學光元大98購01,,,,,,0.00,0,0,0,0,0,0,0,0,0,0,0,0,0
20200528,708994,中美晶元大98購01,,,,,,0.00,0,0,0,0,0,0,0,0,0,0,0,0,0
20200528,708995,世界元大97購01,0.52,0.56,0.52,0.55,+0.04,7.84,425000,3,234390,0,0,0,0,0,0,89000,425000,-336000,-336000
20200528,708996,保瑞元大97購01,,,,,,0.00,0,0,0,0,0,0,0,0,0,0,0,0,0
20200528,708997,晶焱元大99購01,0.38,0.38,0.38,0.38,-0.01,-2.56,27000,1,10260,0,0,0,0,0,0,27000,27000,0,0
20200528,708998,大學光康和9B購01,,,,,,0.00,0,0,0,0,0,0,0,0,0,0,0,0,0
20200528,708999,泰博群益97購02,21.70,21.70,21.70,21.70,+0.90,4.33,10000,1,217000,0,0,0,0,0,0,10000,0,10000,10000
20200528,709000,環球晶群益98購01,2.04,2.05,2.04,2.04,+0.07,3.55,34000,3,69370,0,0,0,0,0,0,1000,34000,-33000,-33000
20200528,709001,鈺太群益97購01,0.75,0.75,0.61,0.61,-0.17,-21.79,462000,6,328550,0,0,0,0,0,0,267000,95000,172000,172000
20200528,709002,環球晶日盛97購01,,,,,,0.00,0,0,0,0,0,0,0,0,0,0,0,0,0
20200528,709003,世禾永豐97購02,,,,,,0.00,0,0,0,0,0,0,0,0,0,0,0,0,0
20200528,709004,順達永豐97購01,1.32,1.32,1.06,1.07,-0.24,-18.32,128000,11,154290,0,0,0,0,0,0,79000,49000,30000,30000
20200528,709005,新揚科永豐97購01,,,,,,0.00,0,0,0,0,0,0,0,0,0,0,0,0,0
20200528,709006,穩懋永豐97購03,,,,,,0.00,0,0,0,0,0,0,0,0,0,0,0,0,0
20200528,709007,勝麗台新97購01,0.44,0.44,0.40,0.40,-0.05,-11.11,290000,9,123980,0,0,0,0,0,0,290000,0,290000,290000
20200528,709008,中美晶元富99購01,,,,,,0.00,0,0,0,0,0,0,0,0,0,0,0,0,0
20200528,709009,信昌電元富97購02,0.61,0.61,0.61,0.61,-0.03,-4.69,10000,1,6100,0,0,0,0,0,0,10000,0,10000,10000
20200528,709010,宣德元富97購01,1.63,1.76,1.63,1.76,+0.06,3.53,77000,7,132100,0,0,0,0,0,0,17000,60000,-43000,-43000
20200528,709011,緯軟元富97購01,,,,,,0.00,0,0,0,0,0,0,0,0,0,0,0,0,0
20200528,709012,環球晶元富97購03,,,,,,0.00,0,0,0,0,0,0,0,0,0,0,0,0,0
20200528,709013,環球晶元富97購04,0.62,0.63,0.62,0.63,0.00,0.0,20000,2,12500,0,0,0,0,0,0,20000,0,20000,20000
20200528,709014,鈊象元富97購04,4.54,5.40,4.49,5.40,+1.42,35.68,74000,10,346370,0,0,0,0,0,0,1000,72000,-71000,-71000
20200528,709015,世禾統一99購01,,,,,,0.00,0,0,0,0,0,0,0,0,0,0,0,0,0
20200528,709016,世禾統一9A購01,0.21,0.21,0.20,0.20,-0.03,-13.04,55000,3,11280,0,0,0,0,0,0,55000,0,55000,55000
20200528,709017,金居統一98購01,2.44,2.44,2.17,2.17,-0.39,-15.23,14000,2,33080,0,0,0,0,0,0,4000,14000,-10000,-10000
20200528,709018,順達統一99購01,1.23,1.23,1.13,1.13,-0.09,-7.38,6000,5,7140,0,0,0,0,0,0,0,6000,-6000,-6000
20200528,709019,中美晶凱基9A購01,0.25,0.25,0.25,0.25,-0.01,-3.85,10000,1,2500,0,0,0,0,0,0,0,10000,-10000,-10000
20200528,709020,迅得凱基9A購01,,,,,,0.00,0,0,0,0,0,0,0,0,0,0,0,0,0
20200528,709021,亞泰凱基9A購01,,,,,,0.00,0,0,0,0,0,0,0,0,0,0,0,0,0
20200528,709022,保瑞凱基98購01,,,,,,0.00,0,0,0,0,0,0,0,0,0,0,0,0,0
20200528,709023,新普凱基98購02,0.73,0.85,0.73,0.84,+0.11,15.07,837000,73,669020,0,0,0,0,0,0,583000,239000,344000,344000
20200528,709024,環球晶凱基98購01,,,,,,0.00,0,0,0,0,0,0,0,0,0,0,0,0,0
20200528,709025,環球晶凱基99購01,0.20,0.20,0.17,0.18,+0.01,5.88,74000,6,13100,0,0,0,0,0,0,0,74000,-74000,-74000
20200528,709026,穩懋日盛98購01,0.30,0.30,0.30,0.30,-0.01,-3.23,25000,3,7500,0,0,0,0,0,0,25000,20000,5000,5000
20200528,709027,大江國票99購01,1.55,1.55,1.55,1.55,+0.03,1.97,5000,1,7750,0,0,0,0,0,0,0,5000,-5000,-5000
20200528,709028,凡甲富邦9A購01,1.45,1.45,1.32,1.35,-0.11,-7.53,662000,58,918400,0,0,0,0,0,0,564000,276000,288000,288000
20200528,709029,聯亞富邦9A購01,0.22,0.22,0.20,0.20,-0.01,-4.76,1900000,4,389980,0,0,0,0,0,0,1900000,0,1900000,1900000
20200528,709030,大江元大98購01,,,,,,0.00,0,0,0,0,0,0,0,0,0,0,0,0,0
20200528,709031,群聯元大99購01,,,,,,0.00,0,0,0,0,0,0,0,0,0,0,0,0,0
20200528,709032,碩禾元大99購01,,,,,,0.00,0,0,0,0,0,0,0,0,0,0,0,0,0
20200528,709033,優群元大99購02,3.80,3.80,3.80,3.80,+0.18,4.97,2000,1,7600,0,0,0,0,0,0,2000,0,2000,2000
20200528,709034,環球晶元大98購01,0.84,0.87,0.83,0.83,+0.01,1.22,63000,4,54610,0,0,0,0,0,0,1000,62000,-61000,-61000
20200528,709035,環球晶元大98購02,,,,,,0.00,0,0,0,0,0,0,0,0,0,0,0,0,0
20200528,709036,環球晶元大98購03,0.30,0.30,0.30,0.30,+0.02,7.14,10000,1,3000,0,0,0,0,0,0,10000,0,10000,10000
20200528,709037,聯亞元大99購01,0.86,0.86,0.86,0.86,-0.04,-4.44,4000,1,3440,0,0,0,0,0,0,0,4000,-4000,-4000
20200528,709038,譜瑞元大98購02,,,,,,0.00,0,0,0,0,0,0,0,0,0,0,0,0,0
20200528,709039,譜瑞元富98購01,,,,,,0.00,0,0,0,0,0,0,0,0,0,0,0,0,0
20200528,709040,勝麗台新98購01,0.45,0.45,0.43,0.43,-0.08,-15.69,174000,7,75120,0,0,0,0,0,0,174000,0,174000,174000
20200528,709041,精測台新99購01,,,,,,0.00,0,0,0,0,0,0,0,0,0,0,0,0,0
20200528,709042,宣德兆豐98購01,1.04,1.17,1.04,1.09,-0.03,-2.68,215000,13,236160,0,0,0,0,0,0,69000,205000,-136000,-136000
20200528,709043,威剛群益9A購01,,,,,,0.00,0,0,0,0,0,0,0,0,0,0,0,0,0
20200528,709044,統新康和98購01,0.45,0.47,0.45,0.47,+0.03,6.82,50000,3,22950,0,0,0,0,0,0,0,50000,-50000,-50000
20200528,709045,神盾群益9A購01,1.34,1.34,1.34,1.34,-0.06,-4.29,1000,1,1340,0,0,0,0,0,0,1000,0,1000,1000
20200528,709046,廣明群益98購01,1.19,1.24,1.19,1.24,-0.13,-9.49,106000,3,127190,0,0,0,0,0,0,21000,85000,-64000,-64000
20200528,709047,世禾永豐98購01,1.18,1.18,0.85,0.85,-0.20,-19.05,627000,17,635230,0,0,0,0,0,0,526000,101000,425000,425000
20200528,709048,合晶永豐98購01,1.23,1.27,1.16,1.16,+0.03,2.65,54000,3,66680,0,0,0,0,0,0,44000,10000,34000,34000
20200528,709049,亞泰永豐99購01,1.06,1.08,1.05,1.06,-0.03,-2.75,214000,9,227530,0,0,0,0,0,0,204000,10000,194000,194000
20200528,709050,金居永豐98購01,1.92,1.93,1.63,1.64,-0.30,-15.46,61000,8,112180,0,0,0,0,0,0,11000,51000,-40000,-40000
20200528,709051,統新永豐98購01,0.33,0.34,0.33,0.34,+0.04,13.33,40000,4,13300,0,0,0,0,0,0,0,40000,-40000,-40000
20200528,709052,鈊象永豐98購02,0.80,0.83,0.63,0.83,+0.45,118.42,157000,13,114130,0,0,0,0,0,0,88000,58000,30000,30000
20200528,709053,M31元大98購03,1.89,1.90,1.55,1.60,-0.30,-15.79,901000,55,1544910,0,0,0,0,0,0,753000,246000,507000,507000
20200528,709054,凡甲元大9A購01,2.51,2.52,2.39,2.39,-0.05,-2.05,161000,13,399070,0,0,0,0,0,0,151000,85000,66000,66000
20200528,709055,中美晶元大99購01,,,,,,0.00,0,0,0,0,0,0,0,0,0,0,0,0,0
20200528,709056,群聯元大98購03,,,,,,0.00,0,0,0,0,0,0,0,0,0,0,0,0,0
20200528,709057,精測元大98購02,0.11,0.11,0.11,0.11,-0.07,-38.89,200000,1,22000,0,0,0,0,0,0,200000,200000,0,0
20200528,709058,緯軟元大98購01,0.56,0.57,0.54,0.56,+0.04,7.69,500000,10,276400,0,0,0,0,0,0,440000,60000,380000,380000
20200528,709059,鈊象元大99購02,3.03,3.30,3.03,3.30,+0.96,41.03,20000,5,63200,0,0,0,0,0,0,10000,0,10000,10000
20200528,709060,大江國泰9A購01,,,,,,0.00,0,0,0,0,0,0,0,0,0,0,0,0,0
20200528,709061,台燿國泰99購01,2.27,2.33,2.20,2.31,+0.02,0.87,135000,17,309370,0,0,0,0,0,0,135000,0,135000,135000
20200528,709062,合晶國泰99購01,2.06,2.06,2.06,2.06,-0.08,-3.74,25000,1,51500,0,0,0,0,0,0,25000,0,25000,25000
20200528,709063,雍智國票99購01,5.75,5.75,4.71,4.71,-1.24,-20.84,63000,5,323330,0,0,0,0,0,0,54000,9000,45000,45000
20200528,709064,網龍國票99購01,0.55,0.74,0.55,0.57,-0.02,-3.39,615000,19,384950,0,0,0,0,0,0,200000,415000,-215000,-215000
20200528,709065,雙鴻國票99購01,1.28,1.33,1.26,1.27,0.00,0.0,103000,10,136040,0,0,0,0,0,0,1000,103000,-102000,-102000
20200528,709066,中美晶統一98購01,1.21,1.21,1.20,1.20,+0.01,0.84,48000,2,57870,0,0,0,0,0,0,0,48000,-48000,-48000
20200528,709067,統新統一01購01,,,,,,0.00,0,0,0,0,0,0,0,0,0,0,0,0,0
20200528,709068,統新統一98購01,0.96,0.96,0.88,0.89,+0.01,1.14,50000,3,45700,0,0,0,0,0,0,0,50000,-50000,-50000
20200528,709069,統新統一9B購01,0.95,0.95,0.94,0.94,-0.01,-1.05,54000,2,50810,0,0,0,0,0,0,54000,0,54000,54000
20200528,709070,統新統一9C購01,,,,,,0.00,0,0,0,0,0,0,0,0,0,0,0,0,0
20200528,709071,鈊象統一9A購01,,,,,,0.00,0,0,0,0,0,0,0,0,0,0,0,0,0
20200528,709072,鈊象中信98購01,0.48,0.62,0.48,0.61,+0.21,52.5,166000,24,95720,0,0,0,0,0,0,34000,64000,-30000,-30000
20200528,709073,大江凱基98購04,,,,,,0.00,0,0,0,0,0,0,0,0,0,0,0,0,0
20200528,709074,大學光凱基9A購01,,,,,,0.00,0,0,0,0,0,0,0,0,0,0,0,0,0
20200528,709075,中美晶凱基98購01,1.49,1.49,1.49,1.49,+0.02,1.36,50000,1,74500,0,0,0,0,0,0,50000,0,50000,50000
20200528,709076,合晶凱基98購02,1.88,1.88,1.81,1.81,+0.07,4.02,4000,2,7380,0,0,0,0,0,0,2000,2000,0,0
20200528,709077,宜鼎凱基98購02,3.02,3.08,3.02,3.08,+0.05,1.65,35000,5,106510,0,0,0,0,0,0,3000,35000,-32000,-32000
20200528,709078,昇達科凱基98購01,0.97,0.97,0.97,0.97,+0.09,10.23,10000,1,9700,0,0,0,0,0,0,10000,0,10000,10000
20200528,709079,信昌電凱基98購03,1.41,1.42,1.39,1.40,-0.06,-4.11,104000,6,146020,0,0,0,0,0,0,58000,51000,7000,7000
20200528,709080,宣德凱基98購02,1.60,1.75,1.60,1.71,+0.13,8.23,410000,20,684610,0,0,0,0,0,0,35000,400000,-365000,-365000
20200528,709081,原相凱基98購03,1.27,1.27,1.27,1.27,-0.27,-17.53,30000,1,38100,0,0,0,0,0,0,30000,30000,0,0
20200528,709082,精測凱基98購03,,,,,,0.00,0,0,0,0,0,0,0,0,0,0,0,0,0
20200528,709083,廣明凱基98購03,2.04,2.04,2.04,2.04,-0.01,-0.49,49000,1,99960,0,0,0,0,0,0,49000,0,49000,49000
20200528,709084,優群凱基9A購01,,,,,,0.00,0,0,0,0,0,0,0,0,0,0,0,0,0
20200528,709085,環球晶凱基98購02,1.24,1.25,1.21,1.21,+0.09,8.04,158000,9,196320,0,0,0,0,0,0,58000,118000,-60000,-60000
20200528,709086,環球晶凱基99購02,1.44,1.44,1.44,1.44,0.00,0.0,40000,1,57600,0,0,0,0,0,0,40000,0,40000,40000
20200528,709087,聯亞凱基98購02,1.15,1.16,1.15,1.16,+0.07,6.42,30000,2,34600,0,0,0,0,0,0,10000,20000,-10000,-10000
20200528,709088,鈊象凱基9A購01,,,,,,0.00,0,0,0,0,0,0,0,0,0,0,0,0,0
20200528,709089,統新元富98購01,,,,,,0.00,0,0,0,0,0,0,0,0,0,0,0,0,0
20200528,709090,統新元富98購02,0.99,1.00,0.99,1.00,-0.02,-1.96,40000,2,39800,0,0,0,0,0,0,0,40000,-40000,-40000
20200528,709091,穩懋統一98購03,,,,,,0.00,0,0,0,0,0,0,0,0,0,0,0,0,0
20200528,709092,鈊象中信99購02,0.89,0.89,0.89,0.89,+0.35,64.81,2000,2,1780,0,0,0,0,0,0,2000,0,2000,2000
20200528,709093,VHQ元大99購01,0.49,0.49,0.47,0.47,-0.03,-6.0,70000,2,33500,0,0,0,0,0,0,70000,0,70000,70000
20200528,709094,大江元大99購01,,,,,,0.00,0,0,0,0,0,0,0,0,0,0,0,0,0
20200528,709095,六角元大99購01,0.74,0.76,0.67,0.67,-0.09,-11.84,27000,3,20110,0,0,0,0,0,0,20000,7000,13000,13000
20200528,709096,同致元大99購01,,,,,,0.00,0,0,0,0,0,0,0,0,0,0,0,0,0
20200528,709097,建榮元大98購01,,,,,,0.00,0,0,0,0,0,0,0,0,0,0,0,0,0
20200528,709098,原相元大9A購01,1.62,1.62,1.59,1.59,-0.02,-1.24,9000,2,14460,0,0,0,0,0,0,0,9000,-9000,-9000
20200528,709099,鈊象元大99購03,1.30,1.61,1.30,1.48,+0.36,32.14,124000,18,186890,0,0,0,0,0,0,7000,60000,-53000,-53000
20200528,709100,鈺太元大99購02,,,,,,0.00,0,0,0,0,0,0,0,0,0,0,0,0,0
20200528,709101,泰博元富98購01,,,,,,0.00,0,0,0,0,0,0,0,0,0,0,0,0,0
20200528,709102,三貝德群益98購01,0.73,0.74,0.67,0.67,+0.17,34.0,66000,4,44870,0,0,0,0,0,0,0,66000,-66000,-66000
20200528,709103,中美晶群益98購01,,,,,,0.00,0,0,0,0,0,0,0,0,0,0,0,0,0
20200528,709104,良維群益98購01,3.19,3.19,3.19,3.19,+0.05,1.59,38000,1,121220,0,0,0,0,0,0,38000,0,38000,38000
20200528,709105,宣德群益98購01,3.32,3.47,3.27,3.39,+0.35,11.51,395000,25,1334280,0,0,0,0,0,0,45000,350000,-305000,-305000
20200528,709106,統新群益98購01,2.40,2.54,2.35,2.35,+0.03,1.29,172000,10,423450,0,0,0,0,0,0,46000,126000,-80000,-80000
20200528,709107,晶焱群益98購02,,,,,,0.00,0,0,0,0,0,0,0,0,0,0,0,0,0
20200528,709108,金居國票99購01,1.46,1.46,1.41,1.41,-0.12,-7.84,47000,3,68370,0,0,0,0,0,0,47000,0,47000,47000
20200528,709109,統新國票98購01,2.24,2.24,2.24,2.24,+0.10,4.67,20000,1,44800,0,0,0,0,0,0,0,20000,-20000,-20000
20200528,709110,聯亞國票99購01,3.17,3.28,3.17,3.28,-0.14,-4.09,27000,3,87030,0,0,0,0,0,0,0,27000,-27000,-27000
20200528,709111,VHQ永豐98購01,,,,,,0.00,0,0,0,0,0,0,0,0,0,0,0,0,0
20200528,709112,大宇資永豐98購01,0.39,0.60,0.39,0.60,+0.27,81.82,90000,13,44830,0,0,0,0,0,0,0,60000,-60000,-60000
20200528,709113,大學光永豐9A購01,2.61,2.61,2.61,2.61,-0.12,-4.4,1000,1,2610,0,0,0,0,0,0,0,1000,-1000,-1000
20200528,709114,波若威永豐99購01,1.54,1.59,1.51,1.57,-0.13,-7.65,383000,9,605530,0,0,0,0,0,0,383000,0,383000,383000
20200528,709115,金可永豐98購01,,,,,,0.00,0,0,0,0,0,0,0,0,0,0,0,0,0
20200528,709116,環球晶永豐98購01,,,,,,0.00,0,0,0,0,0,0,0,0,0,0,0,0,0
20200528,709117,大江凱基98購05,,,,,,0.00,0,0,0,0,0,0,0,0,0,0,0,0,0
20200528,709118,元太凱基98購01,5.00,5.55,4.62,4.72,-0.73,-13.39,115000,15,579300,0,0,0,0,0,0,54000,54000,0,0
20200528,709119,台燿凱基98購02,1.64,1.74,1.59,1.74,-0.02,-1.14,81000,13,133760,0,0,0,0,0,0,50000,31000,19000,19000
20200528,709120,同致凱基98購03,,,,,,0.00,0,0,0,0,0,0,0,0,0,0,0,0,0
20200528,709121,合晶凱基98購03,2.30,2.30,2.15,2.15,-0.12,-5.29,47000,3,101650,0,0,0,0,0,0,0,47000,-47000,-47000
20200528,709122,宜鼎凱基98購03,1.27,1.27,1.25,1.25,+0.09,7.76,3000,2,3790,0,0,0,0,0,0,0,3000,-3000,-3000
20200528,709123,昇達科凱基98購02,,,,,,0.00,0,0,0,0,0,0,0,0,0,0,0,0,0
20200528,709124,信昌電凱基98購04,,,,,,0.00,0,0,0,0,0,0,0,0,0,0,0,0,0
20200528,709125,原相凱基98購04,1.74,1.78,1.74,1.78,-0.49,-21.59,200000,4,354000,0,0,0,0,0,0,200000,200000,0,0
20200528,709126,勝麗凱基98購02,1.18,1.18,1.04,1.04,-0.16,-13.33,52000,13,59700,0,0,0,0,0,0,48000,2000,46000,46000
20200528,709127,群聯凱基98購03,,,,,,0.00,0,0,0,0,0,0,0,0,0,0,0,0,0
20200528,709128,廣明凱基98購04,,,,,,0.00,0,0,0,0,0,0,0,0,0,0,0,0,0
20200528,709129,璟德凱基98購02,1.38,1.38,1.38,1.38,-0.05,-3.5,10000,1,13800,0,0,0,0,0,0,10000,0,10000,10000
20200528,709130,優群凱基9A購02,2.79,2.89,2.79,2.89,+0.21,7.84,13000,3,37330,0,0,0,0,0,0,3000,10000,-7000,-7000
20200528,709131,穩懋凱基98購03,,,,,,0.00,0,0,0,0,0,0,0,0,0,0,0,0,0
20200528,709132,穩懋凱基98購04,,,,,,0.00,0,0,0,0,0,0,0,0,0,0,0,0,0
20200528,709133,頎邦凱基98購01,1.29,1.29,1.15,1.15,-0.07,-5.74,131000,9,161430,0,0,0,0,0,0,115000,26000,89000,89000
20200528,709134,環球晶統一98購01,,,,,,0.00,0,0,0,0,0,0,0,0,0,0,0,0,0
20200528,709135,原相凱基99購01,,,,,,0.00,0,0,0,0,0,0,0,0,0,0,0,0,0
20200528,709136,群聯凱基98購04,,,,,,0.00,0,0,0,0,0,0,0,0,0,0,0,0,0
20200528,709137,碩禾凱基9A購01,0.08,0.08,0.08,0.08,-0.10,-55.56,1000,1,80,0,0,0,0,0,0,1000,0,1000,1000
20200528,709138,M31元大99購02,0.99,0.99,0.82,0.84,-0.22,-20.75,452000,26,435780,0,0,0,0,0,0,207000,207000,0,0
20200528,709139,鈊象元大99購04,3.06,3.06,3.06,3.06,+0.71,30.21,1000,1,3060,0,0,0,0,0,0,0,1000,-1000,-1000
20200528,709140,泰博國票99購01,24.90,30.00,24.20,30.00,+5.50,22.45,39000,16,1004800,0,0,0,0,0,0,24000,14000,10000,10000
20200528,709141,神盾國泰9A購01,0.98,0.98,0.98,0.98,-0.08,-7.55,1000,1,980,0,0,0,0,0,0,1000,0,1000,1000
20200528,709142,宣德富邦9A購01,1.90,2.06,1.90,2.03,+0.20,10.93,565000,44,1117120,0,0,0,0,0,0,158000,346000,-188000,-188000
20200528,709143,環球晶富邦9A購01,0.30,0.30,0.29,0.29,+0.01,3.57,37000,3,10950,0,0,0,0,0,0,22000,15000,7000,7000
20200528,709144,信昌電亞東99購01,,,,,,0.00,0,0,0,0,0,0,0,0,0,0,0,0,0
20200528,709145,大江永豐98購01,1.86,1.97,1.86,1.97,+0.09,4.79,79000,4,149740,0,0,0,0,0,0,30000,49000,-19000,-19000
20200528,709146,同致永豐98購01,0.69,0.69,0.69,0.69,+0.05,7.81,5000,1,3450,0,0,0,0,0,0,5000,0,5000,5000
20200528,709147,合晶永豐98購02,,,,,,0.00,0,0,0,0,0,0,0,0,0,0,0,0,0
20200528,709148,良維永豐98購01,1.11,1.11,1.11,1.11,-0.06,-5.13,68000,1,75480,0,0,0,0,0,0,68000,0,68000,68000
20200528,709149,東隆興永豐98購01,0.03,0.08,0.03,0.08,-0.04,-33.33,16000,2,780,0,0,0,0,0,0,10000,0,10000,10000
20200528,709150,南光永豐98購01,0.15,0.15,0.14,0.14,-0.02,-12.5,195000,4,27650,0,0,0,0,0,0,195000,0,195000,195000
20200528,709151,茂達永豐98購01,0.90,1.10,0.89,0.90,-0.04,-4.26,402000,37,404330,0,0,0,0,0,0,89000,282000,-193000,-193000
20200528,709152,新潤永豐98購01,,,,,,0.00,0,0,0,0,0,0,0,0,0,0,0,0,0
20200528,709153,大江兆豐98購01,1.34,1.36,1.34,1.36,-0.14,-9.33,11000,2,14760,0,0,0,0,0,0,11000,0,11000,11000
20200528,709154,VHQ康和98購01,,,,,,0.00,0,0,0,0,0,0,0,0,0,0,0,0,0
20200528,709155,世界群益9A購01,0.72,0.76,0.72,0.75,+0.02,2.74,204000,4,152730,0,0,0,0,0,0,85000,119000,-34000,-34000
20200528,709156,台燿群益99購01,1.20,1.20,1.20,1.20,+0.04,3.45,5000,1,6000,0,0,0,0,0,0,5000,0,5000,5000
20200528,709157,威剛群益9A購02,,,,,,0.00,0,0,0,0,0,0,0,0,0,0,0,0,0
20200528,709158,廣明群益98購02,,,,,,0.00,0,0,0,0,0,0,0,0,0,0,0,0,0
20200528,709159,優群群益99購02,,,,,,0.00,0,0,0,0,0,0,0,0,0,0,0,0,0
20200528,709160,大江元富98購01,,,,,,0.00,0,0,0,0,0,0,0,0,0,0,0,0,0
20200528,709161,元太台新98購01,,,,,,0.00,0,0,0,0,0,0,0,0,0,0,0,0,0
20200528,709162,鈊象台新98購02,,,,,,0.00,0,0,0,0,0,0,0,0,0,0,0,0,0
20200528,709163,宇峻元大99購01,,,,,,0.00,0,0,0,0,0,0,0,0,0,0,0,0,0
20200528,709164,金居元大99購02,1.55,1.55,1.53,1.53,-0.08,-4.97,16000,2,24520,0,0,0,0,0,0,16000,14000,2000,2000
20200528,709165,新鉅科元大98購01,,,,,,0.00,0,0,0,0,0,0,0,0,0,0,0,0,0
20200528,709166,上詮永豐98購01,0.20,0.20,0.20,0.20,-0.01,-4.76,250000,3,50000,0,0,0,0,0,0,250000,0,250000,250000
20200528,709167,光頡永豐98購01,,,,,,0.00,0,0,0,0,0,0,0,0,0,0,0,0,0
20200528,709168,波若威永豐98購02,1.01,1.01,0.92,0.92,-0.11,-10.68,69000,5,66620,0,0,0,0,0,0,40000,29000,11000,11000
20200528,709169,建榮永豐99購02,,,,,,0.00,0,0,0,0,0,0,0,0,0,0,0,0,0
20200528,709170,健信永豐98購01,,,,,,0.00,0,0,0,0,0,0,0,0,0,0,0,0,0
20200528,709171,璟德永豐98購01,,,,,,0.00,0,0,0,0,0,0,0,0,0,0,0,0,0
20200528,709172,統新國泰99購01,1.22,1.26,1.18,1.18,-0.04,-3.28,271000,3,331220,0,0,0,0,0,0,185000,86000,99000,99000
20200528,709173,環球晶統一99購02,,,,,,0.00,0,0,0,0,0,0,0,0,0,0,0,0,0
20200528,709174,太醫中信99購01,0.61,0.61,0.57,0.57,-0.06,-9.52,36000,4,21220,0,0,0,0,0,0,26000,10000,16000,16000
20200528,709175,環球晶中信98購01,0.05,0.05,0.05,0.05,0.00,0.0,10000,1,500,0,0,0,0,0,0,0,10000,-10000,-10000
20200528,709176,大江凱基98購06,2.72,2.88,2.68,2.88,+0.18,6.67,13000,3,36920,0,0,0,0,0,0,3000,10000,-7000,-7000
20200528,709177,宣德凱基98購03,1.18,1.32,1.18,1.26,+0.01,0.8,290000,19,364790,0,0,0,0,0,0,26000,290000,-264000,-264000
20200528,709178,精測凱基98購04,,,,,,0.00,0,0,0,0,0,0,0,0,0,0,0,0,0
20200528,709179,雙鴻兆豐99購01,0.57,0.57,0.57,0.57,+0.05,9.62,100000,10,57000,0,0,0,0,0,0,0,80000,-80000,-80000
20200528,709180,統新康和98購02,0.88,0.91,0.82,0.82,-0.04,-4.65,120000,5,103900,0,0,0,0,0,0,0,120000,-120000,-120000
20200528,709181,太景*群益99購01,0.39,0.39,0.39,0.39,0.00,0.0,10000,2,3900,0,0,0,0,0,0,0,10000,-10000,-10000
20200528,709182,大江富邦9A購01,2.38,2.43,2.38,2.43,+0.13,5.65,74000,3,178710,0,0,0,0,0,0,2000,72000,-70000,-70000
20200528,709183,原相麥證99購01,,,,,,0.00,0,0,0,0,0,0,0,0,0,0,0,0,0
20200528,709184,順達麥證98購01,2.87,2.87,2.87,2.87,-0.50,-14.84,1000,1,2870,1000,0,1000,0,0,0,1000,0,1000,1000
20200528,709185,璟德麥證98購01,0.76,0.76,0.67,0.67,-0.14,-17.28,194000,2,130880,184000,10000,174000,0,0,0,184000,194000,-10000,-10000
20200528,709186,鈊象台新98購03,,,,,,0.00,0,0,0,0,0,0,0,0,0,0,0,0,0
20200528,709187,大中元富98購01,,,,,,0.00,0,0,0,0,0,0,0,0,0,0,0,0,0
20200528,709188,太景*元富98購01,,,,,,0.00,0,0,0,0,0,0,0,0,0,0,0,0,0
20200528,709189,台半元富98購01,0.51,0.51,0.51,0.51,+0.01,2.0,200000,2,102000,0,0,0,0,0,0,0,200000,-200000,-200000
20200528,709190,由田元富98購01,1.04,1.18,1.04,1.17,+0.14,13.59,90000,9,103000,0,0,0,0,0,0,10000,80000,-70000,-70000
20200528,709191,杰力元富98購01,3.06,3.15,2.88,2.88,-0.15,-4.95,207000,10,624620,0,0,0,0,0,0,20000,185000,-165000,-165000
20200528,709192,金居元富99購01,,,,,,0.00,0,0,0,0,0,0,0,0,0,0,0,0,0
20200528,709193,美琪瑪元富98購01,,,,,,0.00,0,0,0,0,0,0,0,0,0,0,0,0,0
20200528,709194,統新元富98購03,2.05,2.08,2.05,2.08,-0.05,-2.35,71000,5,147140,0,0,0,0,0,0,0,71000,-71000,-71000
20200528,709195,碩禾元富9B購01,0.21,0.47,0.21,0.47,-0.03,-6.0,11000,3,2570,0,0,0,0,0,0,0,10000,-10000,-10000
20200528,709196,群聯中信99購01,0.07,0.07,0.06,0.06,-0.01,-14.29,25000,3,1550,0,0,0,0,0,0,0,25000,-25000,-25000
20200528,709197,大學光統一99購01,,,,,,0.00,0,0,0,0,0,0,0,0,0,0,0,0,0
20200528,709198,原相統一99購01,3.66,3.66,3.44,3.44,-0.12,-3.37,148000,12,520780,0,0,0,0,0,0,148000,0,148000,148000
20200528,709199,M31凱基98購02,1.34,1.34,1.34,1.34,-0.21,-13.55,10000,1,13400,0,0,0,0,0,0,0,10000,-10000,-10000
20200528,709200,中美晶凱基98購02,,,,,,0.00,0,0,0,0,0,0,0,0,0,0,0,0,0
20200528,709201,建榮凱基9A購01,,,,,,0.00,0,0,0,0,0,0,0,0,0,0,0,0,0
20200528,709202,神盾凱基99購01,0.33,0.33,0.29,0.29,-0.04,-12.12,125000,8,38650,0,0,0,0,0,0,0,125000,-125000,-125000
20200528,709203,金可兆豐99購01,,,,,,0.00,0,0,0,0,0,0,0,0,0,0,0,0,0
20200528,709204,宣德兆豐98購02,1.11,1.19,1.11,1.18,0.00,0.0,58000,8,67220,0,0,0,0,0,0,11000,47000,-36000,-36000
20200528,709205,環球晶兆豐98購02,0.27,0.27,0.27,0.27,+0.19,237.5,110000,2,29700,0,0,0,0,0,0,0,110000,-110000,-110000
20200528,709206,合晶群益98購01,,,,,,0.00,0,0,0,0,0,0,0,0,0,0,0,0,0
20200528,709207,原相群益9B購01,3.12,3.12,3.03,3.03,-0.08,-2.57,20000,16,62220,0,0,0,0,0,0,20000,0,20000,20000
20200528,709208,統新群益98購02,0.78,0.83,0.69,0.69,0.00,0.0,76000,4,55980,0,0,0,0,0,0,40000,36000,4000,4000
20200528,709209,廣明群益98購03,0.77,0.77,0.77,0.77,-0.08,-9.41,10000,1,7700,0,0,0,0,0,0,10000,0,10000,10000
20200528,709210,緯軟群益99購01,0.53,0.56,0.48,0.48,-0.01,-2.04,390000,14,201810,0,0,0,0,0,0,107000,360000,-253000,-253000
20200528,709211,鈺太群益98購01,1.80,1.81,1.70,1.70,-0.10,-5.56,416000,4,748940,0,0,0,0,0,0,414000,2000,412000,412000
20200528,709212,建榮國票99購02,,,,,,0.00,0,0,0,0,0,0,0,0,0,0,0,0,0
20200528,709213,雍智國票99購02,,,,,,0.00,0,0,0,0,0,0,0,0,0,0,0,0,0
20200528,709214,中美晶元大99購02,1.23,1.23,1.21,1.21,-0.03,-2.42,80000,2,96900,0,0,0,0,0,0,5000,75000,-70000,-70000
20200528,709215,金居元大9A購01,,,,,,0.00,0,0,0,0,0,0,0,0,0,0,0,0,0
20200528,709216,威剛元大99購02,0.53,0.53,0.53,0.53,-0.04,-7.02,10000,1,5300,0,0,0,0,0,0,10000,0,10000,10000
20200528,709217,宣德元大99購01,1.67,1.67,1.67,1.67,+0.05,3.09,24000,1,40080,0,0,0,0,0,0,24000,0,24000,24000
20200528,709218,群聯元大98購04,,,,,,0.00,0,0,0,0,0,0,0,0,0,0,0,0,0
20200528,709219,碩禾元大99購02,,,,,,0.00,0,0,0,0,0,0,0,0,0,0,0,0,0
20200528,709220,網家元大99購01,2.22,2.22,2.22,2.22,-0.37,-14.29,1000,1,2220,0,0,0,0,0,0,1000,0,1000,1000
20200528,709221,環球晶元大98購04,0.71,0.71,0.69,0.69,+0.03,4.55,40000,3,27800,0,0,0,0,0,0,30000,10000,20000,20000
20200528,709222,環球晶元大99購01,,,,,,0.00,0,0,0,0,0,0,0,0,0,0,0,0,0
20200528,709223,雙鴻元大99購05,0.66,0.67,0.66,0.67,0.00,0.0,11000,2,7270,0,0,0,0,0,0,11000,0,11000,11000
20200528,709224,穩懋元大98購02,1.10,1.10,1.10,1.10,-0.07,-5.98,1000,1,1100,0,0,0,0,0,0,1000,1000,0,0
20200528,709225,穩懋元大99購01,,,,,,0.00,0,0,0,0,0,0,0,0,0,0,0,0,0
20200528,709226,泰博國泰99購01,,,,,,0.00,0,0,0,0,0,0,0,0,0,0,0,0,0
20200528,709227,大江富邦9A購02,,,,,,0.00,0,0,0,0,0,0,0,0,0,0,0,0,0
20200528,709228,中美晶富邦9A購01,0.12,0.12,0.12,0.12,0.00,0.0,25000,2,3000,0,0,0,0,0,0,20000,5000,15000,15000
20200528,709229,精測富邦99購01,,,,,,0.00,0,0,0,0,0,0,0,0,0,0,0,0,0
20200528,709230,環球晶富邦9B購01,0.14,0.14,0.14,0.14,+0.01,7.69,3000,1,420,0,0,0,0,0,0,3000,0,3000,3000
20200528,709231,威剛麥證98購01,,,,,,0.00,0,0,0,0,0,0,0,0,0,0,0,0,0
20200528,709232,群聯麥證98購01,0.71,0.71,0.64,0.64,-0.05,-7.25,192000,5,124670,172000,20000,152000,0,0,0,172000,20000,152000,152000
20200528,709233,聯亞麥證98購01,1.56,1.56,1.56,1.56,-0.07,-4.29,9000,1,14040,9000,0,9000,0,0,0,9000,0,9000,9000
20200528,709234,力旺元富98購01,2.54,2.75,2.20,2.49,+0.11,4.62,1289000,123,3193900,0,0,0,0,0,0,672000,682000,-10000,-10000
20200528,709235,大江元富98購02,4.70,4.70,4.70,4.70,0.00,0.0,3000,1,14100,0,0,0,0,0,0,0,3000,-3000,-3000
20200528,709236,原相元富98購01,2.44,2.44,2.05,2.05,-0.35,-14.58,290000,29,666890,0,0,0,0,0,0,258000,22000,236000,236000
20200528,709237,新鉅科元富98購01,,,,,,0.00,0,0,0,0,0,0,0,0,0,0,0,0,0
20200528,709238,聚積元富98購01,,,,,,0.00,0,0,0,0,0,0,0,0,0,0,0,0,0
20200528,709239,環球晶第一01購01,0.40,0.40,0.40,0.40,+0.02,5.26,15000,2,6000,0,0,0,0,0,0,0,15000,-15000,-15000
20200528,709240,M31永豐98購01,1.39,1.40,1.20,1.20,-0.19,-13.67,201000,9,274070,0,0,0,0,0,0,179000,22000,157000,157000
20200528,709241,凡甲永豐98購01,3.61,3.61,3.47,3.47,-0.14,-3.88,61000,7,215850,0,0,0,0,0,0,61000,20000,41000,41000
20200528,709242,大中永豐98購01,,,,,,0.00,0,0,0,0,0,0,0,0,0,0,0,0,0
20200528,709243,迅得永豐98購01,,,,,,0.00,0,0,0,0,0,0,0,0,0,0,0,0,0
20200528,709244,杰力永豐98購01,1.16,1.16,1.11,1.11,-0.07,-5.93,70000,2,81000,0,0,0,0,0,0,4000,66000,-62000,-62000
20200528,709245,統新永豐98購02,0.21,0.21,0.21,0.21,-0.09,-30.0,30000,1,6300,0,0,0,0,0,0,0,30000,-30000,-30000
20200528,709246,晶焱永豐98購01,,,,,,0.00,0,0,0,0,0,0,0,0,0,0,0,0,0
20200528,709247,網龍永豐98購01,0.80,0.95,0.80,0.87,+0.09,11.54,193000,22,173510,0,0,0,0,0,0,39000,154000,-115000,-115000
20200528,709248,優群永豐98購01,,,,,,0.00,0,0,0,0,0,0,0,0,0,0,0,0,0
20200528,709249,原相台新9A購01,,,,,,0.00,0,0,0,0,0,0,0,0,0,0,0,0,0
20200528,709250,聯亞台新9A購01,,,,,,0.00,0,0,0,0,0,0,0,0,0,0,0,0,0
20200528,709251,前鼎統一99購01,0.57,0.57,0.57,0.57,+0.01,1.79,1000,1,570,0,0,0,0,0,0,0,1000,-1000,-1000
20200528,709252,聯亞中信98購01,0.59,0.63,0.59,0.63,0.00,0.0,369000,9,222170,0,0,0,0,0,0,121000,248000,-127000,-127000
20200528,709253,晶焱凱基98購03,1.43,1.43,1.43,1.43,0.00,0.0,50000,1,71500,0,0,0,0,0,0,50000,0,50000,50000
20200528,709254,群聯凱基99購01,,,,,,0.00,0,0,0,0,0,0,0,0,0,0,0,0,0
20200528,709255,神盾台新98購02,,,,,,0.00,0,0,0,0,0,0,0,0,0,0,0,0,0
20200528,709256,精測台新99購02,,,,,,0.00,0,0,0,0,0,0,0,0,0,0,0,0,0
20200528,709257,VHQ元富98購01,,,,,,0.00,0,0,0,0,0,0,0,0,0,0,0,0,0
20200528,709258,前鼎元富98購01,0.83,0.91,0.82,0.83,-0.03,-3.49,426000,15,358360,0,50000,-50000,0,0,0,340000,86000,254000,204000
20200528,709259,精測元富98購02,,,,,,0.00,0,0,0,0,0,0,0,0,0,0,0,0,0
20200528,709260,中美晶國票98購01,1.30,1.30,1.30,1.30,+0.05,4.0,20000,1,26000,0,0,0,0,0,0,0,20000,-20000,-20000
20200528,709261,保瑞國票98購01,,,,,,0.00,0,0,0,0,0,0,0,0,0,0,0,0,0
20200528,709262,前鼎國票99購01,1.87,2.08,1.86,1.86,-0.09,-4.62,165000,7,316600,0,90000,-90000,0,0,0,115000,50000,65000,-25000
20200528,709263,原相國票99購01,1.00,1.00,0.87,0.87,-0.35,-28.69,31000,2,27100,0,0,0,0,0,0,31000,30000,1000,1000
20200528,709264,泰博國票99購02,,,,,,0.00,0,0,0,0,0,0,0,0,0,0,0,0,0
20200528,709265,統新國票99購01,0.68,0.69,0.63,0.64,+0.01,1.59,196000,8,128970,0,0,0,0,0,0,42000,154000,-112000,-112000
20200528,709266,六角兆豐98購01,0.41,0.42,0.41,0.41,-0.02,-4.65,77000,5,31970,0,0,0,0,0,0,77000,0,77000,77000
20200528,709267,宇峻群益9A購01,,,,,,0.00,0,0,0,0,0,0,0,0,0,0,0,0,0
20200528,709268,博智群益98購01,,,,,,0.00,0,0,0,0,0,0,0,0,0,0,0,0,0
20200528,709269,網龍群益98購03,2.78,3.00,2.64,2.64,-0.03,-1.12,344000,14,990570,0,0,0,0,0,0,78000,273000,-195000,-195000
20200528,709270,太景*國泰9A購01,0.70,0.70,0.48,0.48,+0.12,33.33,14000,2,7600,0,0,0,0,0,0,0,0,0,0
20200528,709271,前鼎國泰99購01,,,,,,0.00,0,0,0,0,0,0,0,0,0,0,0,0,0
20200528,709272,新鉅科國泰99購01,,,,,,0.00,0,0,0,0,0,0,0,0,0,0,0,0,0
20200528,709273,環宇富邦9A購01,0.36,0.36,0.33,0.33,-0.02,-5.71,60000,5,21100,0,0,0,0,0,0,40000,20000,20000,20000
20200528,709274,大江元大98購02,,,,,,0.00,0,0,0,0,0,0,0,0,0,0,0,0,0
20200528,709275,前鼎元大99購01,0.97,1.05,0.95,1.04,+0.07,7.22,206000,8,207400,0,0,0,0,0,0,69000,137000,-68000,-68000
20200528,709276,威剛元大9A購01,,,,,,0.00,0,0,0,0,0,0,0,0,0,0,0,0,0
20200528,709277,神盾元大9A購01,0.65,0.65,0.65,0.65,-0.11,-14.47,41000,1,26650,0,0,0,0,0,0,0,41000,-41000,-41000
20200528,709278,群聯元大99購02,,,,,,0.00,0,0,0,0,0,0,0,0,0,0,0,0,0
20200528,709279,緯軟元大98購02,0.43,0.43,0.43,0.43,-0.01,-2.27,81000,1,34830,0,0,0,0,0,0,81000,81000,0,0
20200528,709280,璟德元大98購01,2.30,2.30,2.10,2.10,-0.27,-11.39,63000,2,134900,0,0,0,0,0,0,0,63000,-63000,-63000
20200528,709281,中美晶日盛9A購01,0.47,0.47,0.47,0.47,-0.03,-6.0,2000,1,940,0,0,0,0,0,0,2000,0,2000,2000
20200528,709282,伍豐永豐98購01,,,,,,0.00,0,0,0,0,0,0,0,0,0,0,0,0,0
20200528,709283,兆利永豐98購01,,,,,,0.00,0,0,0,0,0,0,0,0,0,0,0,0,0
20200528,709284,宜鼎永豐98購01,0.57,0.59,0.52,0.55,-0.01,-1.79,114000,4,62440,0,0,0,0,0,0,68000,46000,22000,22000
20200528,709285,前鼎永豐98購01,0.59,0.63,0.59,0.63,+0.04,6.78,28000,2,17120,0,0,0,0,0,0,15000,13000,2000,2000
20200528,709286,建榮永豐9A購01,,,,,,0.00,0,0,0,0,0,0,0,0,0,0,0,0,0
20200528,709287,新鉅科永豐98購01,,,,,,0.00,0,0,0,0,0,0,0,0,0,0,0,0,0
20200528,709288,聯亞永豐98購01,0.81,0.87,0.81,0.87,+0.03,3.57,13000,2,11250,0,0,0,0,0,0,0,13000,-13000,-13000
20200528,709289,雙鴻永豐99購01,0.74,0.79,0.74,0.75,+0.02,2.74,308000,13,238350,0,0,0,0,0,0,50000,257000,-207000,-207000
20200528,709290,金居凱基98購02,2.22,2.22,2.15,2.15,-0.25,-10.42,12000,2,26500,0,0,0,0,0,0,2000,12000,-10000,-10000
20200528,709291,威剛凱基9A購01,0.17,0.17,0.17,0.17,-0.05,-22.73,4000,1,680,0,0,0,0,0,0,4000,4000,0,0
20200528,709292,環球晶凱基98購04,0.75,0.75,0.75,0.75,+0.03,4.17,10000,1,7500,0,0,0,0,0,0,0,10000,-10000,-10000
20200528,709293,環球晶康和98購01,,,,,,0.00,0,0,0,0,0,0,0,0,0,0,0,0,0
20200528,709294,大江群益98購01,,,,,,0.00,0,0,0,0,0,0,0,0,0,0,0,0,0
20200528,709295,宇峻群益9A購02,0.35,0.38,0.35,0.38,+0.05,15.15,2000,2,730,0,0,0,0,0,0,0,0,0,0
20200528,709296,神盾群益9A購02,0.80,0.80,0.80,0.80,-0.09,-10.11,60000,1,48000,0,0,0,0,0,0,60000,0,60000,60000
20200528,709297,宣德國票99購01,2.44,2.66,2.44,2.59,+0.25,10.68,376000,34,969160,0,0,0,0,0,0,23000,355000,-332000,-332000
20200528,709298,群聯國票99購01,,,,,,0.00,0,0,0,0,0,0,0,0,0,0,0,0,0
20200528,709299,VHQ國泰99購01,0.53,0.53,0.53,0.53,-0.02,-3.64,222000,1,117660,0,0,0,0,0,0,222000,0,222000,222000
20200528,709300,宣德國泰9A購01,1.70,1.70,1.64,1.65,+0.14,9.27,14000,5,23260,0,0,0,0,0,0,0,13000,-13000,-13000
20200528,709301,大宇資永豐98購02,,,,,,0.00,0,0,0,0,0,0,0,0,0,0,0,0,0
20200528,709302,六角永豐98購01,0.89,0.90,0.86,0.86,-0.04,-4.44,219000,13,194330,0,0,0,0,0,0,182000,37000,145000,145000
20200528,709303,亞泰永豐98購01,0.89,0.89,0.89,0.89,-0.06,-6.32,107000,1,95230,0,0,0,0,0,0,107000,0,107000,107000
20200528,709304,信昌電永豐98購01,,,,,,0.00,0,0,0,0,0,0,0,0,0,0,0,0,0
20200528,709305,宣德永豐98購01,1.87,2.01,1.87,1.97,-0.01,-0.51,85000,7,164100,0,0,0,0,0,0,43000,54000,-11000,-11000
20200528,709306,原相永豐98購02,0.14,0.15,0.12,0.12,-0.05,-29.41,1196000,6,163850,0,0,0,0,0,0,1181000,15000,1166000,1166000
20200528,709307,神盾永豐99購01,0.55,0.55,0.47,0.48,-0.06,-11.11,67000,9,33990,0,0,0,0,0,0,47000,37000,10000,10000
20200528,709308,雙美永豐99購01,1.29,1.35,1.29,1.35,+0.07,5.47,89000,3,116000,0,0,0,0,0,0,55000,34000,21000,21000
20200528,709309,譜瑞永豐98購01,2.03,2.22,1.92,1.92,-0.22,-10.28,148000,14,298570,0,0,0,0,0,0,55000,85000,-30000,-30000
20200528,709310,合晶元富98購01,1.68,1.68,1.59,1.59,-0.13,-7.56,31000,4,50620,0,0,0,0,0,0,20000,11000,9000,9000
20200528,709311,前鼎元富98購02,1.07,1.21,1.07,1.08,-0.01,-0.92,347000,17,397690,0,0,0,0,0,0,145000,202000,-57000,-57000
20200528,709312,大學光元大99購01,,,,,,0.00,0,0,0,0,0,0,0,0,0,0,0,0,0
20200528,709313,保瑞元大98購01,1.43,1.43,1.43,1.43,-0.05,-3.38,20000,1,28600,0,0,0,0,0,0,0,20000,-20000,-20000
20200528,709314,前鼎元大99購02,0.92,1.00,0.91,0.96,+0.04,4.35,395000,17,370940,0,0,0,0,0,0,38000,248000,-210000,-210000
20200528,709315,胡連元大98購01,0.63,0.66,0.58,0.58,-0.04,-6.45,151000,11,94330,0,0,0,0,0,0,5000,136000,-131000,-131000
20200528,709316,神盾元大9A購02,0.90,0.90,0.81,0.83,-0.07,-7.78,188000,13,162160,0,0,0,0,0,0,88000,100000,-12000,-12000
20200528,709317,群聯元大98購05,,,,,,0.00,0,0,0,0,0,0,0,0,0,0,0,0,0
20200528,709318,環球晶元大98購09,,,,,,0.00,0,0,0,0,0,0,0,0,0,0,0,0,0
20200528,709319,環球晶元大98購10,,,,,,0.00,0,0,0,0,0,0,0,0,0,0,0,0,0
20200528,709320,雙鴻元大9A購01,0.80,0.80,0.80,0.80,+0.03,3.9,32000,2,25600,0,0,0,0,0,0,30000,0,30000,30000
20200528,709321,譜瑞元大98購03,7.20,7.20,7.20,7.20,-1.45,-16.76,4000,1,28800,0,0,0,0,0,0,4000,4000,0,0
20200528,709322,六角台新98購01,0.48,0.48,0.48,0.48,-0.15,-23.81,20000,1,9600,0,0,0,0,0,0,20000,0,20000,20000
20200528,709323,群聯麥證98購02,,,,,,0.00,0,0,0,0,0,0,0,0,0,0,0,0,0
20200528,709324,同致元富98購01,0.80,0.83,0.80,0.83,+0.07,9.21,3000,2,2430,0,0,0,0,0,0,3000,0,3000,3000
20200528,709325,神盾元富99購01,0.69,0.69,0.67,0.67,-0.01,-1.47,31000,4,21180,0,0,0,0,0,0,31000,30000,1000,1000
20200528,709326,群聯元富98購01,,,,,,0.00,0,0,0,0,0,0,0,0,0,0,0,0,0
20200528,709327,碩禾元富9B購02,0.18,0.18,0.18,0.18,-0.02,-10.0,11000,1,1980,0,0,0,0,0,0,11000,0,11000,11000
20200528,709328,三貝德凱基98購01,0.30,0.30,0.30,0.30,+0.06,25.0,1000,1,300,0,0,0,0,0,0,0,0,0,0
20200528,709329,大江凱基98購07,,,,,,0.00,0,0,0,0,0,0,0,0,0,0,0,0,0
20200528,709330,威剛凱基9A購02,,,,,,0.00,0,0,0,0,0,0,0,0,0,0,0,0,0
20200528,709331,雍智凱基99購01,1.75,1.75,1.45,1.45,-0.26,-15.2,45000,8,73010,0,0,0,0,0,0,40000,5000,35000,35000
20200528,709332,環球晶凱基98購05,,,,,,0.00,0,0,0,0,0,0,0,0,0,0,0,0,0
20200528,709333,聯亞凱基99購03,2.12,2.12,2.12,2.12,+0.02,0.95,10000,1,21200,0,0,0,0,0,0,0,10000,-10000,-10000
20200528,709334,穩懋凱基98購06,0.77,0.77,0.77,0.77,-0.10,-11.49,49000,1,37730,0,0,0,0,0,0,0,49000,-49000,-49000
20200528,709335,泰博永豐98購01,,,,,,0.00,0,0,0,0,0,0,0,0,0,0,0,0,0
20200528,709336,博智永豐98購01,0.95,1.00,0.94,0.94,-0.01,-1.05,217000,18,212010,0,0,0,0,0,0,69000,148000,-79000,-79000
20200528,709337,緯軟永豐98購01,,,,,,0.00,0,0,0,0,0,0,0,0,0,0,0,0,0
20200528,709338,環宇永豐98購02,,,,,,0.00,0,0,0,0,0,0,0,0,0,0,0,0,0
20200528,709339,VHQ統一99購01,,,,,,0.00,0,0,0,0,0,0,0,0,0,0,0,0,0
20200528,709340,大學光統一9A購01,,,,,,0.00,0,0,0,0,0,0,0,0,0,0,0,0,0
20200528,709341,廣明統一99購01,1.58,1.59,1.58,1.59,-0.07,-4.22,10000,2,15830,0,0,0,0,0,0,10000,7000,3000,3000
20200528,709342,穩懋統一98購04,,,,,,0.00,0,0,0,0,0,0,0,0,0,0,0,0,0
20200528,709343,凡甲元大98購03,,,,,,0.00,0,0,0,0,0,0,0,0,0,0,0,0,0
20200528,709344,中美晶元大98購03,,,,,,0.00,0,0,0,0,0,0,0,0,0,0,0,0,0
20200528,709345,宇峻元大99購02,,,,,,0.00,0,0,0,0,0,0,0,0,0,0,0,0,0
20200528,709346,博智元大98購01,4.18,4.22,3.89,3.89,-0.40,-9.32,88000,7,357250,0,0,0,0,0,0,30000,58000,-28000,-28000
20200528,709347,群聯元大98購06,,,,,,0.00,0,0,0,0,0,0,0,0,0,0,0,0,0
20200528,709348,網家元大98購01,3.13,3.13,2.82,2.82,-0.43,-13.23,91000,12,276730,0,0,0,0,0,0,0,91000,-91000,-91000
20200528,709349,廣明元大98購01,,,,,,0.00,0,0,0,0,0,0,0,0,0,0,0,0,0
20200528,709350,中美晶兆豐99購01,0.74,0.74,0.74,0.74,-0.02,-2.63,20000,2,14800,0,0,0,0,0,0,10000,10000,0,0
20200528,709351,泰博兆豐98購01,7.90,7.90,7.90,7.90,+1.30,19.7,2000,1,15800,0,0,0,0,0,0,2000,0,2000,2000
20200528,709352,精華兆豐99購01,0.99,0.99,0.99,0.99,+0.02,2.06,20000,1,19800,0,0,0,0,0,0,0,20000,-20000,-20000
20200528,709353,頎邦兆豐98購01,0.77,0.77,0.72,0.72,-0.02,-2.7,79000,2,57930,0,0,0,0,0,0,21000,58000,-37000,-37000
20200528,709354,M31群益9A購01,1.40,1.41,1.22,1.24,-0.17,-12.06,1037000,42,1343230,0,0,0,0,0,0,958000,73000,885000,885000
20200528,709355,中美晶群益98購02,,,,,,0.00,0,0,0,0,0,0,0,0,0,0,0,0,0
20200528,709356,宜鼎群益98購02,3.78,3.83,3.78,3.83,+0.13,3.51,181000,2,688680,0,0,0,0,0,0,0,181000,-181000,-181000
20200528,709357,原相群益98購03,,,,,,0.00,0,0,0,0,0,0,0,0,0,0,0,0,0
20200528,709358,譜瑞群益98購01,,,,,,0.00,0,0,0,0,0,0,0,0,0,0,0,0,0
20200528,709359,璟德國泰99購01,,,,,,0.00,0,0,0,0,0,0,0,0,0,0,0,0,0
20200528,709360,神盾富邦9A購01,0.30,0.30,0.30,0.30,-0.02,-6.25,3000,1,900,0,0,0,0,0,0,3000,0,3000,3000
20200528,709361,群聯凱基98購05,2.06,2.06,1.99,1.99,-0.16,-7.44,2000,2,4050,0,0,0,0,0,0,2000,2000,0,0
20200528,709362,網家凱基99購01,,,,,,0.00,0,0,0,0,0,0,0,0,0,0,0,0,0
20200528,709363,晟德凱基98購01,1.11,1.12,1.11,1.11,-0.37,-25.0,40000,4,44500,0,0,0,0,0,0,10000,30000,-20000,-20000
20200528,709364,神盾統一98購02,0.16,0.16,0.16,0.16,-0.04,-20.0,500000,2,80000,0,0,0,0,0,0,500000,0,500000,500000
20200528,709365,VHQ元大99購02,,,,,,0.00,0,0,0,0,0,0,0,0,0,0,0,0,0
20200528,709366,中美晶元大98購04,0.88,0.88,0.85,0.85,-0.01,-1.16,2000,2,1730,0,0,0,0,0,0,0,2000,-2000,-2000
20200528,709367,兆利元大99購01,,,,,,0.00,0,0,0,0,0,0,0,0,0,0,0,0,0
20200528,709368,原相元大9A購02,1.35,1.35,1.35,1.35,-0.08,-5.59,15000,2,20250,0,0,0,0,0,0,0,15000,-15000,-15000
20200528,709369,群聯元大98購07,,,,,,0.00,0,0,0,0,0,0,0,0,0,0,0,0,0
20200528,709370,碩禾元大99購03,,,,,,0.00,0,0,0,0,0,0,0,0,0,0,0,0,0
20200528,709371,廣明元大98購02,1.42,1.44,1.40,1.44,+0.01,0.7,100000,4,142900,0,0,0,0,0,0,50000,50000,0,0
20200528,709372,神盾第一9C購01,,,,,,0.00,0,0,0,0,0,0,0,0,0,0,0,0,0
20200528,709373,三貝德永豐99購01,0.16,0.17,0.16,0.17,+0.04,30.77,388000,2,62280,0,0,0,0,0,0,388000,0,388000,388000
20200528,709374,大田永豐98購01,0.99,0.99,0.91,0.91,-0.04,-4.21,307000,17,293030,0,0,0,0,0,0,227000,80000,147000,147000
20200528,709375,大江永豐98購03,2.29,2.43,2.29,2.43,+0.06,2.53,86000,6,203010,0,0,0,0,0,0,18000,68000,-50000,-50000
20200528,709376,旺矽永豐98購01,1.07,1.07,0.95,0.95,-0.14,-12.84,30000,3,30400,0,0,0,0,0,0,10000,20000,-10000,-10000
20200528,709377,勝麗永豐98購01,0.26,0.26,0.24,0.24,-0.08,-25.0,37000,9,9400,0,0,0,0,0,0,25000,12000,13000,13000
20200528,709378,宜鼎兆豐99購01,1.01,1.04,1.01,1.03,+0.05,5.1,194000,9,197120,0,0,0,0,0,0,1000,194000,-193000,-193000
20200528,709379,神盾兆豐99購01,0.83,0.83,0.73,0.74,-0.09,-10.84,567000,26,452210,0,0,0,0,0,0,353000,208000,145000,145000
20200528,709380,穩懋兆豐99購01,0.27,0.27,0.19,0.19,-0.01,-5.0,20000,2,4600,0,0,0,0,0,0,0,20000,-20000,-20000
20200528,709381,網家康和98購01,1.12,1.12,1.08,1.08,-0.16,-12.9,110000,3,122800,0,0,0,0,0,0,0,110000,-110000,-110000
20200528,709382,大學光群益99購01,7.15,7.35,7.15,7.35,+0.05,0.68,15000,7,108050,0,0,0,0,0,0,15000,0,15000,15000
20200528,709383,六角群益98購03,1.52,1.53,1.50,1.50,-0.08,-5.06,158000,5,240300,0,0,0,0,0,0,114000,44000,70000,70000
20200528,709384,迅得群益9A購01,0.68,0.68,0.63,0.63,-0.06,-8.7,228000,5,144750,0,0,0,0,0,0,228000,0,228000,228000
20200528,709385,環宇群益99購01,0.27,0.27,0.27,0.27,-0.06,-18.18,10000,1,2700,0,0,0,0,0,0,10000,0,10000,10000
20200528,709386,鈺太群益98購02,,,,,,0.00,0,0,0,0,0,0,0,0,0,0,0,0,0
20200528,709387,大學光統一99購02,4.30,4.53,4.23,4.49,+0.20,4.66,177000,13,776790,0,0,0,0,0,0,128000,49000,79000,79000
20200528,709388,穩懋統一98購05,,,,,,0.00,0,0,0,0,0,0,0,0,0,0,0,0,0
20200528,709389,原相中信9A購01,1.01,1.01,0.80,0.80,-0.15,-15.79,92000,12,85650,0,0,0,0,0,0,58000,34000,24000,24000
20200528,709390,大學光凱基98購01,7.75,8.50,7.75,8.50,+0.65,8.28,11000,6,86350,0,0,0,0,0,0,10000,1000,9000,9000
20200528,709391,六角凱基98購01,0.88,0.90,0.88,0.90,-0.02,-2.17,51000,2,45880,0,0,0,0,0,0,1000,50000,-49000,-49000
20200528,709392,穩懋凱基98購07,0.47,0.47,0.47,0.47,-0.04,-7.84,82000,1,38540,0,0,0,0,0,0,82000,0,82000,82000
20200528,709393,宜鼎元富98購01,0.71,0.72,0.71,0.72,+0.04,5.88,40000,5,28700,0,0,0,0,0,0,23000,30000,-7000,-7000
20200528,709394,群聯元富98購02,,,,,,0.00,0,0,0,0,0,0,0,0,0,0,0,0,0
20200528,709395,譜瑞元富98購02,4.50,4.50,4.50,4.50,-0.75,-14.29,3000,1,13500,0,0,0,0,0,0,0,3000,-3000,-3000
20200528,709396,台燿元大98購01,2.86,2.97,2.76,2.90,-0.06,-2.03,52000,8,150100,0,0,0,0,0,0,36000,16000,20000,20000
20200528,709397,神盾元大99購03,0.83,0.83,0.73,0.73,-0.09,-10.98,200000,11,155740,0,0,0,0,0,0,110000,90000,20000,20000
20200528,709398,精測元大99購01,,,,,,0.00,0,0,0,0,0,0,0,0,0,0,0,0,0
20200528,709399,穩懋元大98購05,1.41,1.41,1.34,1.34,-0.12,-8.22,50000,4,68900,0,0,0,0,0,0,50000,0,50000,50000
20200528,709400,穩懋元大98購06,1.09,1.09,1.06,1.08,-0.06,-5.26,237000,4,254650,0,0,0,0,0,0,169000,69000,100000,100000
20200528,709401,穩懋元大98購07,1.30,1.30,1.28,1.28,-0.04,-3.03,29000,3,37500,0,0,0,0,0,0,11000,19000,-8000,-8000
20200528,709402,前鼎國票99購02,1.06,1.14,1.06,1.14,+0.03,2.7,115000,3,122060,0,0,0,0,0,0,113000,2000,111000,111000
20200528,709403,雙美國票9B購01,1.14,1.19,1.14,1.19,+0.05,4.39,200000,3,233000,0,0,0,0,0,0,100000,200000,-100000,-100000
20200528,709404,雙鴻國票9A購01,,,,,,0.00,0,0,0,0,0,0,0,0,0,0,0,0,0
20200528,709405,譜瑞國票99購01,12.00,12.20,12.00,12.20,-0.10,-0.81,12000,2,144400,0,0,0,0,0,0,10000,2000,8000,8000
20200528,709406,博智國泰9A購01,2.73,2.74,2.63,2.74,-0.06,-2.14,69000,7,186370,0,0,0,0,0,0,29000,40000,-11000,-11000
20200528,709407,大學光富邦9C購01,2.30,2.41,2.18,2.18,-0.07,-3.11,61000,25,141160,0,0,0,0,0,0,37000,22000,15000,15000
20200528,709408,VHQ永豐99購01,,,,,,0.00,0,0,0,0,0,0,0,0,0,0,0,0,0
20200528,709409,力致永豐99購01,1.51,1.54,1.36,1.40,-0.07,-4.76,252000,42,373270,0,0,0,0,0,0,218000,20000,198000,198000
20200528,709410,大學光永豐98購01,,,,,,0.00,0,0,0,0,0,0,0,0,0,0,0,0,0
20200528,709411,台燿永豐98購01,0.42,0.44,0.41,0.44,+0.02,4.76,238000,19,102970,0,0,0,0,0,0,122000,116000,6000,6000
20200528,709412,立端永豐98購01,0.79,0.79,0.74,0.74,-0.07,-8.64,30000,3,23100,0,0,0,0,0,0,0,30000,-30000,-30000
20200528,709413,合晶永豐98購03,,,,,,0.00,0,0,0,0,0,0,0,0,0,0,0,0,0
20200528,709414,東隆興永豐98購02,0.10,0.10,0.10,0.10,-0.02,-16.67,10000,1,1000,0,0,0,0,0,0,10000,0,10000,10000
20200528,709415,群聯永豐98購01,,,,,,0.00,0,0,0,0,0,0,0,0,0,0,0,0,0
20200528,709416,緯軟永豐98購02,0.41,0.41,0.41,0.41,0.00,0.0,78000,1,31980,0,0,0,0,0,0,78000,78000,0,0
20200528,709417,穩懋永豐98購01,,,,,,0.00,0,0,0,0,0,0,0,0,0,0,0,0,0
20200528,709418,頎邦永豐98購01,0.60,0.60,0.56,0.56,-0.01,-1.75,16000,3,9460,0,0,0,0,0,0,15000,1000,14000,14000
20200528,709419,泰博兆豐98購02,,,,,,0.00,0,0,0,0,0,0,0,0,0,0,0,0,0
20200528,709420,群聯兆豐99購01,,,,,,0.00,0,0,0,0,0,0,0,0,0,0,0,0,0
20200528,709421,大江群益98購02,,,,,,0.00,0,0,0,0,0,0,0,0,0,0,0,0,0
20200528,709422,中美晶群益99購01,,,,,,0.00,0,0,0,0,0,0,0,0,0,0,0,0,0
20200528,709423,亞泰群益98購01,,,,,,0.00,0,0,0,0,0,0,0,0,0,0,0,0,0
20200528,709424,南光群益98購01,,,,,,0.00,0,0,0,0,0,0,0,0,0,0,0,0,0
20200528,709425,璟德群益98購02,,,,,,0.00,0,0,0,0,0,0,0,0,0,0,0,0,0
20200528,709426,智擎中信98購01,0.85,0.96,0.70,0.70,-0.12,-14.63,391000,42,339660,0,0,0,0,0,0,178000,73000,105000,105000
20200528,709427,力旺凱基98購01,1.82,1.93,1.70,1.70,-0.36,-17.48,206000,21,377420,0,0,0,0,0,0,182000,24000,158000,158000
20200528,709428,三貝德凱基99購02,,,,,,0.00,0,0,0,0,0,0,0,0,0,0,0,0,0
20200528,709429,環球晶凱基99購03,0.15,0.15,0.15,0.15,-0.09,-37.5,50000,1,7500,0,0,0,0,0,0,0,50000,-50000,-50000
20200528,709430,穩懋凱基99購01,,,,,,0.00,0,0,0,0,0,0,0,0,0,0,0,0,0
20200528,709431,M31永豐99購01,1.32,1.34,1.30,1.33,+0.01,0.76,272000,11,360320,0,0,0,0,0,0,262000,10000,252000,252000
20200528,709432,力旺永豐98購01,1.28,1.39,1.25,1.25,-0.08,-6.02,349000,20,461870,0,0,0,0,0,0,329000,20000,309000,309000
20200528,709433,大學光永豐98購02,,,,,,0.00,0,0,0,0,0,0,0,0,0,0,0,0,0
20200528,709434,宣德永豐98購02,1.23,1.27,1.23,1.27,-0.02,-1.55,72000,6,90380,0,0,0,0,0,0,1000,72000,-71000,-71000
20200528,709435,元太亞東99購01,8.75,8.75,8.15,8.30,-0.60,-6.74,70000,3,589250,0,0,0,0,0,0,70000,0,70000,70000
20200528,709436,穩懋麥證98購01,0.31,0.31,0.31,0.31,-0.01,-3.12,100000,1,31000,0,100000,-100000,0,0,0,0,100000,-100000,-100000
20200528,709437,M31元富98購01,1.41,1.45,1.13,1.13,-0.32,-22.07,355000,19,495830,0,0,0,0,0,0,334000,40000,294000,294000
20200528,709438,光頡元富98購01,,,,,,0.00,0,0,0,0,0,0,0,0,0,0,0,0,0
20200528,709439,優群元富98購01,,,,,,0.00,0,0,0,0,0,0,0,0,0,0,0,0,0
20200528,709440,三貝德元大99購01,,,,,,0.00,0,0,0,0,0,0,0,0,0,0,0,0,0
20200528,709441,神盾元大9A購03,,,,,,0.00,0,0,0,0,0,0,0,0,0,0,0,0,0
20200528,709442,神準元大98購01,0.63,0.63,0.63,0.63,-0.13,-17.11,1000,1,630,0,0,0,0,0,0,1000,0,1000,1000
20200528,709443,統新元大99購01,1.47,1.49,1.39,1.39,+0.05,3.73,176000,7,251970,0,0,0,0,0,0,69000,107000,-38000,-38000
20200528,709444,博智元大98購02,,,,,,0.00,0,0,0,0,0,0,0,0,0,0,0,0,0
20200528,709445,雍智元大98購01,2.04,2.05,2.03,2.05,-0.08,-3.76,347000,6,707390,0,0,0,0,0,0,347000,0,347000,347000
20200528,709446,網家元大98購02,1.99,1.99,1.87,1.90,-0.11,-5.47,500000,10,963500,0,0,0,0,0,0,150000,350000,-200000,-200000
20200528,709447,緯軟元大99購01,0.80,0.80,0.72,0.72,-0.01,-1.37,134000,3,100720,0,0,0,0,0,0,80000,134000,-54000,-54000
20200528,709448,環球晶元大98購13,,,,,,0.00,0,0,0,0,0,0,0,0,0,0,0,0,0
20200528,709449,穩懋元大98購08,0.97,0.97,0.91,0.91,-0.05,-5.21,142000,7,134120,0,0,0,0,0,0,142000,0,142000,142000
20200528,709450,宇峻國票99購01,0.72,0.72,0.68,0.68,+0.06,9.68,14000,2,9680,0,0,0,0,0,0,0,14000,-14000,-14000
20200528,709451,大學光兆豐99購01,,,,,,0.00,0,0,0,0,0,0,0,0,0,0,0,0,0
20200528,709452,原相兆豐99購01,,,,,,0.00,0,0,0,0,0,0,0,0,0,0,0,0,0
20200528,709453,穩懋兆豐98購02,,,,,,0.00,0,0,0,0,0,0,0,0,0,0,0,0,0
20200528,709454,網家群益98購01,,,,,,0.00,0,0,0,0,0,0,0,0,0,0,0,0,0
20200528,709455,網家群益98購02,,,,,,0.00,0,0,0,0,0,0,0,0,0,0,0,0,0
20200528,709456,穩懋統一9A購01,0.47,0.47,0.46,0.47,-0.01,-2.08,102000,4,47130,0,0,0,0,0,0,71000,31000,40000,40000
20200528,709457,譜瑞中信9A購01,,,,,,0.00,0,0,0,0,0,0,0,0,0,0,0,0,0
20200528,709458,大江凱基99購01,1.03,1.06,1.00,1.04,-0.05,-4.59,270000,27,276200,0,0,0,0,0,0,10000,260000,-250000,-250000
20200528,709459,中美晶凱基99購01,,,,,,0.00,0,0,0,0,0,0,0,0,0,0,0,0,0
20200528,709460,穩懋凱基99購02,,,,,,0.00,0,0,0,0,0,0,0,0,0,0,0,0,0
20200528,709461,譜瑞麥證98購01,2.99,2.99,2.72,2.72,-0.31,-10.23,62000,7,177280,10000,46000,-36000,0,0,0,10000,46000,-36000,-36000
20200528,709462,環球晶元富98購02,,,,,,0.00,0,0,0,0,0,0,0,0,0,0,0,0,0
20200528,709463,環球晶元富98購03,,,,,,0.00,0,0,0,0,0,0,0,0,0,0,0,0,0
20200528,709464,中美晶元大98購05,1.01,1.01,1.01,1.01,-0.07,-6.48,68000,1,68680,0,0,0,0,0,0,68000,0,68000,68000
20200528,709465,精測元大99購02,,,,,,0.00,0,0,0,0,0,0,0,0,0,0,0,0,0
20200528,709466,環球晶元大98購14,,,,,,0.00,0,0,0,0,0,0,0,0,0,0,0,0,0
20200528,709467,譜瑞元大98購04,6.55,6.55,6.00,6.00,-0.55,-8.4,33000,5,210100,0,0,0,0,0,0,12000,21000,-9000,-9000
20200528,709468,穩懋日盛99購01,,,,,,0.00,0,0,0,0,0,0,0,0,0,0,0,0,0
20200528,709469,久元永豐98購01,1.21,1.30,0.99,0.99,-0.01,-1.0,266000,17,291500,0,0,0,0,0,0,156000,106000,50000,50000
20200528,709470,原相永豐99購01,0.22,0.22,0.17,0.17,-0.05,-22.73,30000,2,5600,0,0,0,0,0,0,20000,30000,-10000,-10000
20200528,709471,環球晶永豐98購02,,,,,,0.00,0,0,0,0,0,0,0,0,0,0,0,0,0
20200528,709472,譜瑞永豐98購02,2.48,2.62,2.42,2.42,-0.27,-10.04,60000,4,154190,0,0,0,0,0,0,9000,51000,-42000,-42000
20200528,709473,網家台新98購01,,,,,,0.00,0,0,0,0,0,0,0,0,0,0,0,0,0
20200528,709474,台燿兆豐98購01,0.94,1.00,0.93,0.98,+0.02,2.08,130000,15,127100,0,0,0,0,0,0,90000,40000,50000,50000
20200528,709475,晟德兆豐99購01,0.93,0.93,0.85,0.85,-0.11,-11.46,38000,9,33920,0,0,0,0,0,0,0,33000,-33000,-33000
20200528,709476,旺矽國票99購01,,,,,,0.00,0,0,0,0,0,0,0,0,0,0,0,0,0
20200528,709477,璟德國票99購01,,,,,,0.00,0,0,0,0,0,0,0,0,0,0,0,0,0
20200528,709478,聯亞國票99購02,1.69,1.80,1.69,1.77,-0.07,-3.8,179000,8,317250,0,0,0,0,0,0,82000,130000,-48000,-48000
20200528,709479,譜瑞國票99購02,9.55,9.55,9.00,9.00,-1.70,-15.89,3000,3,27800,0,0,0,0,0,0,2000,1000,1000,1000
20200528,709480,宇峻康和98購01,0.20,0.21,0.20,0.20,+0.02,11.11,135000,6,27400,0,0,0,0,0,0,0,135000,-135000,-135000
20200528,709481,凡甲群益98購02,,,,,,0.00,0,0,0,0,0,0,0,0,0,0,0,0,0
20200528,709482,大宇資群益9A購01,0.50,0.55,0.50,0.55,+0.11,25.0,8000,4,4110,0,0,0,0,0,0,7000,0,7000,7000
20200528,709483,迅得群益9A購02,0.67,0.67,0.58,0.58,-0.10,-14.71,614000,10,374380,0,0,0,0,0,0,604000,10000,594000,594000
20200528,709484,金居群益9A購01,1.77,1.77,1.77,1.77,-0.18,-9.23,98000,1,173460,0,0,0,0,0,0,98000,0,98000,98000
20200528,709485,晶焱群益9A購01,0.72,0.72,0.72,0.72,-0.03,-4.0,10000,1,7200,0,0,0,0,0,0,10000,0,10000,10000
20200528,709486,群聯群益98購02,,,,,,0.00,0,0,0,0,0,0,0,0,0,0,0,0,0
20200528,709487,環球晶群益98購02,,,,,,0.00,0,0,0,0,0,0,0,0,0,0,0,0,0
20200528,709488,大江國泰9A購02,1.30,1.33,1.30,1.32,+0.04,3.12,55000,3,72000,0,0,0,0,0,0,35000,20000,15000,15000
20200528,709489,譜瑞國泰9A購01,,,,,,0.00,0,0,0,0,0,0,0,0,0,0,0,0,0
20200528,709490,穩懋富邦9A購01,0.17,0.17,0.17,0.17,0.00,0.0,100000,3,17000,0,0,0,0,0,0,20000,80000,-60000,-60000
20200528,709491,譜瑞富邦9A購01,1.17,1.17,1.12,1.12,-0.26,-18.84,25000,3,28650,0,0,0,0,0,0,25000,0,25000,25000
20200528,709492,同致元富9B購01,1.70,1.75,1.70,1.75,+0.21,13.64,10000,2,17350,0,0,0,0,0,0,0,0,0,0
20200528,709493,博智元富98購01,1.76,1.76,1.76,1.76,-0.01,-0.56,21000,1,36960,0,0,0,0,0,0,0,21000,-21000,-21000
20200528,709494,威剛統一9A購02,,,,,,0.00,0,0,0,0,0,0,0,0,0,0,0,0,0
20200528,709495,譜瑞統一99購01,1.39,1.54,1.35,1.37,-0.13,-8.67,150000,7,205600,0,0,0,0,0,0,140000,10000,130000,130000
20200528,709496,中美晶凱基99購02,0.12,0.12,0.12,0.12,+0.02,20.0,1000,1,120,0,0,0,0,0,0,0,1000,-1000,-1000
20200528,709497,網家凱基98購01,1.15,1.15,1.15,1.15,0.00,0.0,70000,1,80500,0,0,0,0,0,0,70000,0,70000,70000
20200528,709498,網龍凱基98購02,1.71,1.87,1.63,1.63,-0.01,-0.61,407000,19,716310,0,0,0,0,0,0,30000,397000,-367000,-367000
20200528,709499,環球晶凱基98購07,,,,,,0.00,0,0,0,0,0,0,0,0,0,0,0,0,0
20200528,709500,環球晶凱基99購04,,,,,,0.00,0,0,0,0,0,0,0,0,0,0,0,0,0
20200528,709501,譜瑞凱基98購01,,,,,,0.00,0,0,0,0,0,0,0,0,0,0,0,0,0
20200528,709502,譜瑞凱基99購01,2.46,2.52,2.29,2.29,-0.23,-9.13,239000,28,577900,0,0,0,0,0,0,49000,188000,-139000,-139000
20200528,709503,譜瑞凱基9A購01,3.46,3.66,3.40,3.40,-0.19,-5.29,4000,4,14000,1000,0,1000,0,0,0,1000,3000,-2000,-1000
20200528,709504,合晶兆豐98購01,1.17,1.18,1.09,1.09,-0.06,-5.22,222000,18,255910,0,0,0,0,0,0,222000,2000,220000,220000
20200528,709505,威剛兆豐99購01,0.37,0.37,0.37,0.37,0.00,0.0,30000,1,11100,0,0,0,0,0,0,30000,0,30000,30000
20200528,709506,聚積兆豐99購01,,,,,,0.00,0,0,0,0,0,0,0,0,0,0,0,0,0
20200528,709507,中美晶永豐98購02,,,,,,0.00,0,0,0,0,0,0,0,0,0,0,0,0,0
20200528,709508,尼克森永豐98購01,0.85,0.85,0.83,0.83,0.00,0.0,21000,2,17630,0,0,0,0,0,0,10000,11000,-1000,-1000
20200528,709509,安勤永豐98購01,,,,,,0.00,0,0,0,0,0,0,0,0,0,0,0,0,0
20200528,709510,信驊永豐98購01,4.26,4.39,3.94,3.94,+0.17,4.51,25000,4,107110,0,0,0,0,0,0,15000,10000,5000,5000
20200528,709511,博智永豐98購02,0.48,0.52,0.48,0.52,-0.03,-5.45,267000,5,133600,0,0,0,0,0,0,198000,69000,129000,129000
20200528,709512,網家永豐98購01,0.26,0.26,0.26,0.26,-0.04,-13.33,25000,1,6500,0,0,0,0,0,0,0,25000,-25000,-25000
20200528,709513,中美晶國票98購02,,,,,,0.00,0,0,0,0,0,0,0,0,0,0,0,0,0
20200528,709514,網家國票99購01,2.06,2.17,1.67,1.67,-0.61,-26.75,63000,6,130180,0,0,0,0,0,0,50000,13000,37000,37000
20200528,709515,穩懋國票99購01,,,,,,0.00,0,0,0,0,0,0,0,0,0,0,0,0,0
20200528,709516,中美晶國泰9A購01,0.99,0.99,0.97,0.97,-0.04,-3.96,62000,2,60340,0,0,0,0,0,0,0,62000,-62000,-62000
20200528,709517,太景*國泰9A購02,0.91,0.92,0.79,0.86,+0.02,2.38,36000,5,31640,0,0,0,0,0,0,0,30000,-30000,-30000
20200528,709518,宇峻國泰9A購01,,,,,,0.00,0,0,0,0,0,0,0,0,0,0,0,0,0
20200528,709519,威剛國泰99購01,0.91,0.91,0.91,0.91,+0.06,7.06,81000,1,73710,0,0,0,0,0,0,81000,0,81000,81000
20200528,709520,原相國泰99購01,,,,,,0.00,0,0,0,0,0,0,0,0,0,0,0,0,0
20200528,709521,博智國泰9A購02,2.56,2.59,2.47,2.47,-0.12,-4.63,176000,13,446090,0,0,0,0,0,0,91000,101000,-10000,-10000
20200528,709522,環球晶國泰99購02,,,,,,0.00,0,0,0,0,0,0,0,0,0,0,0,0,0
20200528,709523,環球晶國泰9A購01,0.44,0.46,0.44,0.45,+0.02,4.65,70000,4,31800,0,0,0,0,0,0,0,70000,-70000,-70000
20200528,709524,鈊象國泰9A購01,1.47,1.50,1.47,1.50,+0.36,31.58,34000,2,50550,0,0,0,0,0,0,34000,0,34000,34000
20200528,709525,譜瑞台新98購01,2.60,2.60,2.53,2.53,-0.73,-22.39,2000,2,5130,0,0,0,0,0,0,2000,0,2000,2000
20200528,709526,大學光富邦98購01,,,,,,0.00,0,0,0,0,0,0,0,0,0,0,0,0,0
20200528,709527,力旺群益99購01,1.95,2.06,1.81,1.81,-0.06,-3.21,245000,31,475320,0,0,0,0,0,0,245000,40000,205000,205000
20200528,709528,中美晶群益99購02,,,,,,0.00,0,0,0,0,0,0,0,0,0,0,0,0,0
20200528,709529,宜鼎群益98購03,1.71,1.79,1.71,1.79,+0.08,4.68,467000,4,823130,0,0,0,0,0,0,0,467000,-467000,-467000
20200528,709530,神盾群益9A購03,,,,,,0.00,0,0,0,0,0,0,0,0,0,0,0,0,0
20200528,709531,碩禾群益98購01,,,,,,0.00,0,0,0,0,0,0,0,0,0,0,0,0,0
20200528,709532,精測群益98購01,0.26,0.26,0.26,0.26,-0.04,-13.33,110000,1,28600,0,0,0,0,0,0,110000,0,110000,110000
20200528,709533,譜瑞群益98購02,4.36,4.36,4.16,4.16,-0.20,-4.59,105000,3,456300,0,0,0,0,0,0,105000,0,105000,105000
20200528,709534,M31元大9A購01,1.19,1.19,0.99,1.05,-0.15,-12.5,437000,43,497000,0,0,0,0,0,0,322000,120000,202000,202000
20200528,709535,宣德元大99購02,2.88,3.05,2.87,3.01,+0.22,7.89,429000,31,1275420,0,0,0,0,0,0,109000,397000,-288000,-288000
20200528,709536,網家元大98購03,2.90,2.90,2.90,2.90,-0.04,-1.36,53000,2,153700,0,0,0,0,0,0,12000,41000,-29000,-29000
20200528,709537,環球晶元大9A購01,,,,,,0.00,0,0,0,0,0,0,0,0,0,0,0,0,0
20200528,709538,穩懋元大98購09,1.47,1.47,1.47,1.47,-0.03,-2.0,29000,3,42630,0,0,0,0,0,0,27000,3000,24000,24000
20200528,709539,鈺太元大99購03,1.39,1.39,1.20,1.20,-0.24,-16.67,143000,6,186480,0,0,0,0,0,0,71000,126000,-55000,-55000
20200528,709540,雍智元富98購01,2.18,2.18,1.85,1.85,-0.28,-13.15,466000,45,968880,0,0,0,0,0,0,354000,127000,227000,227000
20200528,709541,環球晶中信99購03,0.08,0.08,0.08,0.08,0.00,0.0,15000,2,1200,0,0,0,0,0,0,0,15000,-15000,-15000
20200528,709542,大江凱基9A購01,,,,,,0.00,0,0,0,0,0,0,0,0,0,0,0,0,0
20200528,709543,中美晶凱基9A購02,,,,,,0.00,0,0,0,0,0,0,0,0,0,0,0,0,0
20200528,709544,台半凱基98購02,,,,,,0.00,0,0,0,0,0,0,0,0,0,0,0,0,0
20200528,709545,安勤凱基98購01,,,,,,0.00,0,0,0,0,0,0,0,0,0,0,0,0,0
20200528,709546,環球晶凱基99購05,,,,,,0.00,0,0,0,0,0,0,0,0,0,0,0,0,0
20200528,709547,穩懋凱基98購09,,,,,,0.00,0,0,0,0,0,0,0,0,0,0,0,0,0
20200528,709548,威剛統一99購01,,,,,,0.00,0,0,0,0,0,0,0,0,0,0,0,0,0
20200528,709549,網家統一9A購01,0.67,0.68,0.59,0.59,-0.06,-9.23,1062000,38,674940,0,0,0,0,0,0,473000,586000,-113000,-113000
20200528,709550,環球晶統一99購03,,,,,,0.00,0,0,0,0,0,0,0,0,0,0,0,0,0
20200528,709551,大江元大99購02,2.81,2.88,2.81,2.88,+0.10,3.6,46000,4,130210,0,0,0,0,0,0,0,46000,-46000,-46000
20200528,709552,神盾元大99購04,0.99,0.99,0.87,0.87,-0.10,-10.31,137000,11,128870,0,0,0,0,0,0,135000,2000,133000,133000
20200528,709553,博智元大98購03,2.53,2.55,2.37,2.37,-0.06,-2.47,176000,9,436130,0,0,0,0,0,0,87000,104000,-17000,-17000
20200528,709554,群聯元大99購03,,,,,,0.00,0,0,0,0,0,0,0,0,0,0,0,0,0
20200528,709555,譜瑞元大98購06,6.85,6.85,6.35,6.35,-0.50,-7.3,44000,5,292750,0,0,0,0,0,0,15000,29000,-14000,-14000
20200528,709556,威剛國票99購01,,,,,,0.00,0,0,0,0,0,0,0,0,0,0,0,0,0
20200528,709557,神盾國票99購01,0.99,0.99,0.99,0.99,-0.03,-2.94,10000,1,9900,0,0,0,0,0,0,0,10000,-10000,-10000
20200528,709558,廣明國票99購01,,,,,,0.00,0,0,0,0,0,0,0,0,0,0,0,0,0
20200528,709559,環球晶國票99購01,1.46,1.46,1.38,1.38,0.00,0.0,23000,3,33490,0,0,0,0,0,0,0,23000,-23000,-23000
20200528,709560,雙美國票99購02,,,,,,0.00,0,0,0,0,0,0,0,0,0,0,0,0,0
20200528,709561,聚積國泰99購01,0.35,0.35,0.35,0.35,-0.01,-2.78,6000,1,2100,0,0,0,0,0,0,6000,0,6000,6000
20200528,709562,中美晶群益98購03,,,,,,0.00,0,0,0,0,0,0,0,0,0,0,0,0,0
20200528,709563,合晶群益98購02,,,,,,0.00,0,0,0,0,0,0,0,0,0,0,0,0,0
20200528,709564,旺矽群益99購01,1.02,1.02,1.02,1.02,-0.13,-11.3,5000,1,5100,0,0,0,0,0,0,0,5000,-5000,-5000
20200528,709565,宣德群益98購02,2.60,2.80,2.60,2.75,+0.04,1.48,467000,20,1267210,0,0,0,0,0,0,21000,446000,-425000,-425000
20200528,709566,鈺太群益98購03,,,,,,0.00,0,0,0,0,0,0,0,0,0,0,0,0,0
20200528,709567,穩懋台新98購02,,,,,,0.00,0,0,0,0,0,0,0,0,0,0,0,0,0
20200528,709568,原相亞東99購02,,,,,,0.00,0,0,0,0,0,0,0,0,0,0,0,0,0
20200528,709569,群聯亞東98購01,,,,,,0.00,0,0,0,0,0,0,0,0,0,0,0,0,0
20200528,709570,直得永豐98購01,0.30,0.30,0.13,0.15,-0.15,-50.0,230000,5,33500,0,0,0,0,0,0,200000,10000,190000,190000
20200528,709571,網龍永豐98購02,1.58,1.66,1.54,1.54,+0.09,6.21,206000,12,332170,0,0,0,0,0,0,1000,206000,-205000,-205000
20200528,709572,聚積永豐98購01,,,,,,0.00,0,0,0,0,0,0,0,0,0,0,0,0,0
20200528,709573,鈺太永豐98購01,,,,,,0.00,0,0,0,0,0,0,0,0,0,0,0,0,0
20200528,709574,元太台新98購02,,,,,,0.00,0,0,0,0,0,0,0,0,0,0,0,0,0
20200528,709575,中美晶元大98購06,,,,,,0.00,0,0,0,0,0,0,0,0,0,0,0,0,0
20200528,709576,原相元大9A購03,1.67,1.67,1.67,1.67,-0.05,-2.91,10000,1,16700,0,0,0,0,0,0,0,10000,-10000,-10000
20200528,709577,泰博元大98購01,9.60,9.60,9.60,9.60,+0.35,3.78,10000,1,96000,0,0,0,0,0,0,10000,0,10000,10000
20200528,709578,聚積元大9A購01,,,,,,0.00,0,0,0,0,0,0,0,0,0,0,0,0,0
20200528,709579,環球晶元大98購15,0.52,0.52,0.52,0.52,+0.04,8.33,5000,1,2600,0,0,0,0,0,0,0,5000,-5000,-5000
20200528,709580,宇峻中信98購01,0.20,0.20,0.20,0.20,-0.01,-4.76,20000,2,4000,0,0,0,0,0,0,0,20000,-20000,-20000
20200528,709581,原相統一99購02,,,,,,0.00,0,0,0,0,0,0,0,0,0,0,0,0,0
20200528,709582,雙鴻統一99購02,0.70,0.71,0.68,0.68,-0.04,-5.56,382000,7,267790,0,0,0,0,0,0,100000,282000,-182000,-182000
20200528,709583,大宇資凱基99購01,0.27,0.34,0.27,0.34,+0.11,47.83,348000,22,102280,0,0,0,0,0,0,18000,330000,-312000,-312000
20200528,709584,威剛凱基98購01,,,,,,0.00,0,0,0,0,0,0,0,0,0,0,0,0,0
20200528,709585,博智凱基9A購01,0.56,0.58,0.53,0.53,-0.09,-14.52,48000,6,26590,0,0,0,0,0,0,10000,38000,-28000,-28000
20200528,709586,精測凱基99購02,,,,,,0.00,0,0,0,0,0,0,0,0,0,0,0,0,0
20200528,709587,譜瑞凱基98購02,,,,,,0.00,0,0,0,0,0,0,0,0,0,0,0,0,0
20200528,709588,中美晶群益98購04,,,,,,0.00,0,0,0,0,0,0,0,0,0,0,0,0,0
20200528,709589,元太群益99購01,4.80,4.95,4.40,4.40,-0.37,-7.76,42000,10,195240,0,0,0,0,0,0,17000,31000,-14000,-14000
20200528,709590,網家群益98購03,,,,,,0.00,0,0,0,0,0,0,0,0,0,0,0,0,0
20200528,709591,譜瑞群益98購03,4.05,4.05,4.05,4.05,-0.35,-7.95,10000,1,40500,0,0,0,0,0,0,0,10000,-10000,-10000
20200528,709592,泰博國票99購03,,,,,,0.00,0,0,0,0,0,0,0,0,0,0,0,0,0
20200528,709593,合晶國泰99購02,,,,,,0.00,0,0,0,0,0,0,0,0,0,0,0,0,0
20200528,709594,保瑞國泰9A購01,,,,,,0.00,0,0,0,0,0,0,0,0,0,0,0,0,0
20200528,709595,璟德兆豐99購01,,,,,,0.00,0,0,0,0,0,0,0,0,0,0,0,0,0
20200528,709596,亞泰永豐99購02,,,,,,0.00,0,0,0,0,0,0,0,0,0,0,0,0,0
20200528,709597,保瑞永豐98購01,,,,,,0.00,0,0,0,0,0,0,0,0,0,0,0,0,0
20200528,709598,建榮永豐99購03,,,,,,0.00,0,0,0,0,0,0,0,0,0,0,0,0,0
20200528,709599,神盾永豐98購01,,,,,,0.00,0,0,0,0,0,0,0,0,0,0,0,0,0
20200528,709600,新鉅科永豐98購02,,,,,,0.00,0,0,0,0,0,0,0,0,0,0,0,0,0
20200528,709601,雙美永豐99購02,0.90,0.95,0.90,0.92,+0.01,1.1,134000,8,123260,0,0,0,0,0,0,27000,107000,-80000,-80000
20200528,709602,穩懋永豐98購03,1.07,1.07,1.07,1.07,-0.05,-4.46,1000,1,1070,0,0,0,0,0,0,1000,0,1000,1000
20200528,709603,晟德永豐98購01,1.35,1.36,1.25,1.27,-0.32,-20.13,456000,23,589890,0,0,0,0,0,0,401000,55000,346000,346000
20200528,709604,鈊象永豐98購03,0.43,0.61,0.43,0.58,+0.24,70.59,328000,14,179900,0,0,0,0,0,0,107000,221000,-114000,-114000
20200528,709605,中美晶元富99購02,,,,,,0.00,0,0,0,0,0,0,0,0,0,0,0,0,0
20200528,709606,尼克森元富98購01,0.67,0.67,0.67,0.67,-0.18,-21.18,2000,1,1340,0,0,0,0,0,0,2000,0,2000,2000
20200528,709607,博智元富98購02,1.54,1.56,1.50,1.56,-0.05,-3.11,92000,11,139400,0,0,0,0,0,0,60000,32000,28000,28000
20200528,709608,網龍元富98購01,1.64,1.77,1.62,1.62,+0.02,1.25,141000,14,241130,0,0,0,0,0,0,20000,121000,-101000,-101000
20200528,709609,穩懋元富02購01,,,,,,0.00,0,0,0,0,0,0,0,0,0,0,0,0,0
20200528,709610,穩懋元富02購02,1.57,1.57,1.55,1.55,-0.01,-0.64,15000,2,23430,0,0,0,0,0,0,9000,6000,3000,3000
20200528,709611,穩懋元富02購03,1.59,1.59,1.56,1.56,-0.06,-3.7,49000,2,76710,0,0,0,0,0,0,49000,0,49000,49000
20200528,709612,穩懋元富02購04,,,,,,0.00,0,0,0,0,0,0,0,0,0,0,0,0,0
20200528,709613,凡甲凱基98購02,3.55,3.56,3.42,3.42,-0.17,-4.74,24000,5,84750,0,0,0,0,0,0,24000,0,24000,24000
20200528,709614,中美晶凱基99購03,0.38,0.38,0.37,0.37,-0.02,-5.13,13000,3,4910,0,0,0,0,0,0,13000,0,13000,13000
20200528,709615,緯軟凱基98購04,0.49,0.51,0.46,0.46,0.00,0.0,50000,3,24600,0,0,0,0,0,0,10000,50000,-40000,-40000
20200528,709616,大江兆豐99購01,1.28,1.36,1.28,1.36,+0.06,4.62,430000,15,557700,0,0,0,0,0,0,211000,219000,-8000,-8000
20200528,709617,大江群益98購03,,,,,,0.00,0,0,0,0,0,0,0,0,0,0,0,0,0
20200528,709618,安勤群益98購01,,,,,,0.00,0,0,0,0,0,0,0,0,0,0,0,0,0
20200528,709619,杰力群益98購01,1.76,1.76,1.68,1.76,+0.06,3.53,222000,4,389430,0,0,0,0,0,0,35000,187000,-152000,-152000
20200528,709620,群聯群益98購03,2.36,2.36,2.12,2.12,-0.22,-9.4,209000,10,480320,0,0,0,0,0,0,209000,79000,130000,130000
20200528,709621,環球晶群益98購04,1.39,1.39,1.35,1.35,-0.03,-2.17,79000,4,109390,0,0,0,0,0,0,69000,11000,58000,58000
20200528,709622,M31永豐98購02,1.09,1.09,1.03,1.03,-0.09,-8.04,199000,3,206460,0,0,0,0,0,0,199000,0,199000,199000
20200528,709623,尼克森永豐98購02,,,,,,0.00,0,0,0,0,0,0,0,0,0,0,0,0,0
20200528,709624,泰博永豐99購01,3.07,3.52,3.07,3.52,+0.39,12.46,41000,4,134100,0,0,0,0,0,0,31000,10000,21000,21000
20200528,709625,力旺國票99購01,3.17,3.37,2.98,2.99,-0.27,-8.28,545000,35,1760590,0,0,0,0,0,0,339000,206000,133000,133000
20200528,709626,建榮國票9A購01,,,,,,0.00,0,0,0,0,0,0,0,0,0,0,0,0,0
20200528,709627,博智國票99購01,2.15,2.15,2.08,2.08,-0.22,-9.57,77000,4,164150,0,0,0,0,0,0,77000,0,77000,77000
20200528,709628,優群國票99購01,,,,,,0.00,0,0,0,0,0,0,0,0,0,0,0,0,0
20200528,709629,環球晶國票99購02,1.76,1.82,1.75,1.75,+0.06,3.55,80000,9,144070,0,0,0,0,0,0,0,80000,-80000,-80000
20200528,709630,聯亞國票99購03,,,,,,0.00,0,0,0,0,0,0,0,0,0,0,0,0,0
20200528,709631,大中元大98購01,,,,,,0.00,0,0,0,0,0,0,0,0,0,0,0,0,0
20200528,709632,合晶元大99購01,2.57,2.57,2.38,2.42,-0.14,-5.47,128000,7,309570,0,0,0,0,0,0,51000,77000,-26000,-26000
20200528,709633,宜鼎元大99購01,0.98,1.05,0.96,0.96,0.00,0.0,412000,16,411850,0,0,0,0,0,0,121000,352000,-231000,-231000
20200528,709634,保瑞元大98購02,1.45,1.45,1.45,1.45,-0.04,-2.68,20000,1,29000,0,0,0,0,0,0,0,20000,-20000,-20000
20200528,709635,譜瑞元大98購07,3.37,3.37,3.22,3.22,-0.30,-8.52,30000,3,98400,0,0,0,0,0,0,0,30000,-30000,-30000
20200528,709636,晟德元大98購01,2.16,2.20,1.90,1.92,-0.24,-11.11,708000,47,1476840,0,40000,-40000,0,0,0,623000,78000,545000,505000
20200528,709637,安勤元富98購01,,,,,,0.00,0,0,0,0,0,0,0,0,0,0,0,0,0
20200528,709638,威剛富邦9A購01,0.12,0.12,0.12,0.12,-0.03,-20.0,10000,1,1200,0,0,0,0,0,0,10000,0,10000,10000
20200528,709639,雙鴻富邦99購01,0.38,0.38,0.37,0.37,-0.01,-2.63,18000,2,6740,0,0,0,0,0,0,18000,0,18000,18000
20200528,709640,博智台新98購01,0.65,0.68,0.61,0.62,-0.06,-8.82,284000,20,187310,0,0,0,0,0,0,183000,101000,82000,82000
20200528,709641,久元群益98購01,2.99,3.30,2.42,2.42,+0.07,2.98,203000,20,576420,0,0,0,0,0,0,70000,175000,-105000,-105000
20200528,709642,群聯群益98購04,,,,,,0.00,0,0,0,0,0,0,0,0,0,0,0,0,0
20200528,709643,聖暉群益98購01,2.32,2.32,2.10,2.10,-0.19,-8.3,96000,5,212120,0,0,0,0,0,0,76000,20000,56000,56000
20200528,709644,璟德中信98購01,1.90,1.90,1.76,1.76,-0.18,-9.28,11000,2,19500,0,0,0,0,0,0,1000,10000,-9000,-9000
20200528,709645,合晶統一9A購01,0.68,0.68,0.65,0.67,+0.03,4.69,328000,4,213750,0,0,0,0,0,0,309000,19000,290000,290000
20200528,709646,神盾統一99購01,,,,,,0.00,0,0,0,0,0,0,0,0,0,0,0,0,0
20200528,709647,環球晶統一99購04,,,,,,0.00,0,0,0,0,0,0,0,0,0,0,0,0,0
20200528,709648,穩懋統一98購06,0.78,0.79,0.78,0.78,-0.04,-4.88,102000,3,80060,0,0,0,0,0,0,102000,0,102000,102000
20200528,709649,中美晶凱基99購04,,,,,,0.00,0,0,0,0,0,0,0,0,0,0,0,0,0
20200528,709650,精測凱基98購05,,,,,,0.00,0,0,0,0,0,0,0,0,0,0,0,0,0
20200528,709651,聯亞凱基99購04,,,,,,0.00,0,0,0,0,0,0,0,0,0,0,0,0,0
20200528,709652,大學光國票99購01,,,,,,0.00,0,0,0,0,0,0,0,0,0,0,0,0,0
20200528,709653,原相國票99購02,1.48,1.48,1.29,1.29,-0.19,-12.84,94000,6,136660,0,0,0,0,0,0,94000,0,94000,94000
20200528,709654,安勤國泰99購01,0.50,0.50,0.50,0.50,0.00,0.0,10000,1,5000,0,0,0,0,0,0,10000,0,10000,10000
20200528,709655,大江元大98購03,2.92,3.04,2.86,3.04,+0.15,5.19,90000,5,264340,0,0,0,0,0,0,18000,72000,-54000,-54000
20200528,709656,中美晶元大99購03,1.15,1.15,1.15,1.15,-0.01,-0.86,10000,1,11500,0,0,0,0,0,0,0,10000,-10000,-10000
20200528,709657,宇峻元大99購03,0.82,0.86,0.80,0.80,+0.03,3.9,185000,8,150400,0,0,0,0,0,0,0,185000,-185000,-185000
20200528,709658,博智元大99購01,2.96,2.99,2.87,2.99,+0.10,3.46,127000,10,374810,0,0,0,0,0,0,61000,81000,-20000,-20000
20200528,709659,網家元大99購02,,,,,,0.00,0,0,0,0,0,0,0,0,0,0,0,0,0
20200528,709660,環球晶元大98購16,0.77,0.77,0.77,0.77,+0.01,1.32,30000,1,23100,0,0,0,0,0,0,0,30000,-30000,-30000
20200528,709661,環球晶元大99購02,,,,,,0.00,0,0,0,0,0,0,0,0,0,0,0,0,0
20200528,709662,穩懋元大98購10,1.56,1.56,1.56,1.56,-0.12,-7.14,10000,1,15600,0,0,0,0,0,0,10000,0,10000,10000
20200528,709663,譜瑞元大98購08,6.00,6.00,6.00,6.00,-0.45,-6.98,2000,1,12000,0,0,0,0,0,0,2000,0,2000,2000
20200528,709664,神盾第一9C購02,,,,,,0.00,0,0,0,0,0,0,0,0,0,0,0,0,0
20200528,709665,台半永豐98購01,,,,,,0.00,0,0,0,0,0,0,0,0,0,0,0,0,0
20200528,709666,兆利永豐98購02,,,,,,0.00,0,0,0,0,0,0,0,0,0,0,0,0,0
20200528,709667,金居永豐98購02,0.72,0.72,0.59,0.60,-0.13,-17.81,30000,6,19450,0,0,0,0,0,0,23000,7000,16000,16000
20200528,709668,宣德永豐98購03,1.35,1.43,1.35,1.43,+0.06,4.38,80000,6,110860,0,0,0,0,0,0,0,80000,-80000,-80000
20200528,709669,博智永豐99購01,0.48,0.48,0.45,0.45,0.00,0.0,30000,3,13800,0,0,0,0,0,0,0,30000,-30000,-30000
20200528,709670,晶焱永豐98購03,,,,,,0.00,0,0,0,0,0,0,0,0,0,0,0,0,0
20200528,709671,雍智永豐99購01,1.63,1.63,1.42,1.43,-0.17,-10.63,112000,21,167890,0,0,0,0,0,0,65000,47000,18000,18000
20200528,709672,環宇永豐98購03,,,,,,0.00,0,0,0,0,0,0,0,0,0,0,0,0,0
20200528,709673,環球晶元富98購04,,,,,,0.00,0,0,0,0,0,0,0,0,0,0,0,0,0
20200528,709674,力旺元大98購01,5.30,5.40,5.30,5.40,-0.25,-4.42,14000,2,74600,0,0,0,0,0,0,14000,0,14000,14000
20200528,709675,力旺元大98購02,3.12,3.19,2.95,2.95,-0.24,-7.52,22000,4,66530,0,0,0,0,0,0,18000,4000,14000,14000
20200528,709676,中美晶元大98購08,,,,,,0.00,0,0,0,0,0,0,0,0,0,0,0,0,0
20200528,709677,聚積元大99購01,0.32,0.32,0.32,0.32,-0.01,-3.03,1000,1,320,0,0,0,0,0,0,1000,0,1000,1000
20200528,709678,聯亞元大98購05,0.99,0.99,0.88,0.88,-0.03,-3.3,12000,3,10770,0,0,0,0,0,0,10000,2000,8000,8000
20200528,709679,譜瑞元大98購09,4.01,4.01,4.01,4.01,-0.01,-0.25,2000,1,8020,0,0,0,0,0,0,0,2000,-2000,-2000
20200528,709680,中美晶國票99購01,1.05,1.05,1.05,1.05,-0.04,-3.67,60000,3,63000,0,0,0,0,0,0,0,60000,-60000,-60000
20200528,709681,宣德國票98購02,2.95,3.27,2.93,3.22,+0.40,14.18,264000,19,818160,0,0,0,0,0,0,5000,259000,-254000,-254000
20200528,709682,建榮國票9A購02,,,,,,0.00,0,0,0,0,0,0,0,0,0,0,0,0,0
20200528,709683,網家國票99購02,,,,,,0.00,0,0,0,0,0,0,0,0,0,0,0,0,0
20200528,709684,雍智國泰9A購01,2.05,2.05,1.82,1.82,-0.17,-8.54,127000,8,240330,0,0,0,0,0,0,64000,63000,1000,1000
20200528,709685,安勤統一98購01,,,,,,0.00,0,0,0,0,0,0,0,0,0,0,0,0,0
20200528,709686,元太中信9A購01,2.72,2.83,2.58,2.59,-0.14,-5.13,278000,35,751040,0,0,0,0,0,0,13000,265000,-252000,-252000
20200528,709687,台燿中信9A購01,0.83,0.85,0.81,0.84,+0.02,2.44,71000,28,59270,0,0,0,0,0,0,51000,14000,37000,37000
20200528,709688,合晶中信9A購02,,,,,,0.00,0,0,0,0,0,0,0,0,0,0,0,0,0
20200528,709689,中美晶凱基99購05,,,,,,0.00,0,0,0,0,0,0,0,0,0,0,0,0,0
20200528,709690,六角凱基99購03,,,,,,0.00,0,0,0,0,0,0,0,0,0,0,0,0,0
20200528,709691,智崴凱基98購01,0.15,0.15,0.15,0.15,+0.02,15.38,3000,1,450,0,0,0,0,0,0,0,0,0,0
20200528,709692,昇達科永豐98購01,,,,,,0.00,0,0,0,0,0,0,0,0,0,0,0,0,0
20200528,709693,建榮永豐99購04,1.15,1.15,1.07,1.07,-0.10,-8.55,30000,3,33500,0,0,0,0,0,0,30000,0,30000,30000
20200528,709694,順達永豐98購01,3.39,3.40,3.39,3.40,-0.13,-3.68,59000,3,200450,0,0,0,0,0,0,59000,0,59000,59000
20200528,709695,精測永豐98購01,0.44,0.44,0.44,0.44,-0.05,-10.2,112000,1,49280,0,0,0,0,0,0,112000,0,112000,112000
20200528,709696,穩懋永豐98購04,0.55,0.55,0.55,0.55,-0.07,-11.29,7000,1,3850,0,0,0,0,0,0,7000,0,7000,7000
20200528,709697,鈊象永豐99購01,0.37,0.51,0.37,0.51,+0.20,64.52,278000,17,127890,0,0,0,0,0,0,31000,247000,-216000,-216000
20200528,709698,力旺中信99購01,2.71,2.79,2.45,2.45,-0.14,-5.41,101000,29,270150,0,0,0,0,0,0,71000,30000,41000,41000
20200528,709699,凡甲元大9A購02,2.05,2.05,1.96,1.96,-0.13,-6.22,27000,2,53640,0,0,0,0,0,0,27000,0,27000,27000
20200528,709700,安勤元大99購01,0.59,0.59,0.57,0.57,-0.02,-3.39,20000,2,11600,0,0,0,0,0,0,0,20000,-20000,-20000
20200528,709701,宏捷科元大99購01,1.67,1.70,1.56,1.56,-0.18,-10.34,238000,11,388630,0,0,0,0,0,0,238000,0,238000,238000
20200528,709702,宜鼎元大9A購01,0.95,1.00,0.94,0.94,0.00,0.0,427000,13,412040,0,0,0,0,0,0,133000,293000,-160000,-160000
20200528,709703,直得元大99購01,2.72,2.86,1.98,2.05,-0.55,-21.15,768000,100,1823340,0,0,0,0,0,0,287000,463000,-176000,-176000
20200528,709704,南光元大99購01,1.50,1.50,1.06,1.06,-0.08,-7.02,29000,2,31180,0,0,0,0,0,0,0,28000,-28000,-28000
20200528,709705,原相元大99購03,,,,,,0.00,0,0,0,0,0,0,0,0,0,0,0,0,0
20200528,709706,新鉅科元大99購01,,,,,,0.00,0,0,0,0,0,0,0,0,0,0,0,0,0
20200528,709707,穩懋元大99購02,1.25,1.25,1.25,1.25,-0.16,-11.35,10000,1,12500,0,0,0,0,0,0,10000,0,10000,10000
20200528,709708,晟德元大99購01,2.29,2.32,2.10,2.10,-0.19,-8.3,523000,32,1172990,0,0,0,0,0,0,467000,56000,411000,411000
20200528,709709,大宇資國票9A購01,,,,,,0.00,0,0,0,0,0,0,0,0,0,0,0,0,0
20200528,709710,宏捷科國票9A購01,,,,,,0.00,0,0,0,0,0,0,0,0,0,0,0,0,0
20200528,709711,穩懋國泰9A購01,1.59,1.60,1.56,1.60,-0.03,-1.84,169000,7,264270,0,0,0,0,0,0,148000,21000,127000,127000
20200528,709712,穩懋國泰9B購01,0.93,0.93,0.79,0.79,-0.07,-8.14,15000,2,12550,0,0,0,0,0,0,10000,15000,-5000,-5000
20200528,709713,亞泰元富99購01,1.30,1.33,1.28,1.28,-0.04,-3.03,343000,15,451690,0,0,0,0,0,0,300000,43000,257000,257000
20200528,709714,合晶統一9A購02,1.12,1.15,1.12,1.15,0.00,0.0,137000,7,153720,0,0,0,0,0,0,128000,10000,118000,118000
20200528,709715,宏捷科統一9A購01,0.60,0.61,0.58,0.58,-0.02,-3.33,324000,9,194040,0,0,0,0,0,0,205000,119000,86000,86000
20200528,709716,泰博統一9A購01,4.50,4.73,4.50,4.73,+0.64,15.65,30000,3,138400,0,0,0,0,0,0,0,30000,-30000,-30000
20200528,709717,神盾統一9A購01,0.46,0.46,0.43,0.43,-0.02,-4.44,25000,3,11100,0,0,0,0,0,0,0,25000,-25000,-25000
20200528,709718,雙鴻統一9A購01,0.76,0.78,0.75,0.75,+0.03,4.17,849000,15,641030,0,0,0,0,0,0,346000,503000,-157000,-157000
20200528,709719,宏捷科日盛99購01,0.99,0.99,0.99,0.99,-0.04,-3.88,10000,1,9900,0,0,0,0,0,0,10000,0,10000,10000
20200528,709720,VHQ凱基9A購01,,,,,,0.00,0,0,0,0,0,0,0,0,0,0,0,0,0
20200528,709721,三貝德凱基9A購01,,,,,,0.00,0,0,0,0,0,0,0,0,0,0,0,0,0
20200528,709722,太景*凱基99購01,,,,,,0.00,0,0,0,0,0,0,0,0,0,0,0,0,0
20200528,709723,宏捷科凱基99購01,0.60,0.60,0.60,0.60,-0.06,-9.09,97000,2,58200,0,0,0,0,0,0,97000,0,97000,97000
20200528,709724,晶焱凱基99購01,,,,,,0.00,0,0,0,0,0,0,0,0,0,0,0,0,0
20200528,709725,大學光永豐99購01,,,,,,0.00,0,0,0,0,0,0,0,0,0,0,0,0,0
20200528,709726,宏捷科永豐99購01,1.64,1.64,1.61,1.61,-0.11,-6.4,83000,2,134080,0,0,0,0,0,0,15000,68000,-53000,-53000
20200528,709727,信驊永豐99購01,3.75,3.75,3.50,3.50,0.00,0.0,15000,2,53750,0,0,0,0,0,0,0,15000,-15000,-15000
20200528,709728,威剛永豐99購02,1.16,1.16,1.07,1.07,-0.07,-6.14,93000,3,102930,0,0,0,0,0,0,30000,63000,-33000,-33000
20200528,709729,環球晶永豐99購01,0.31,0.31,0.31,0.31,+0.01,3.33,10000,1,3100,0,0,0,0,0,0,0,10000,-10000,-10000
20200528,709730,宏捷科康和99購01,0.80,0.80,0.79,0.79,-0.03,-3.66,66000,2,52500,0,0,0,0,0,0,66000,0,66000,66000
20200528,709731,宏捷科群益99購01,0.86,0.87,0.84,0.86,-0.10,-10.42,210000,13,180090,0,0,0,0,0,0,210000,0,210000,210000
20200528,709732,宏捷科元富99購01,1.06,1.06,1.00,1.00,-0.04,-3.85,187000,6,190600,0,0,0,0,0,0,62000,125000,-63000,-63000
20200528,709733,智擎元富99購01,2.13,2.43,1.88,1.88,-0.32,-14.55,1556000,113,3478690,0,0,0,0,0,0,1089000,375000,714000,714000
20200528,709734,中美晶統一9B購02,,,,,,0.00,0,0,0,0,0,0,0,0,0,0,0,0,0
20200528,709735,宏捷科統一9B購01,0.75,0.77,0.73,0.73,-0.05,-6.41,258000,5,193510,0,0,0,0,0,0,245000,13000,232000,232000
20200528,709736,宏捷科凱基9B購01,1.11,1.12,1.10,1.11,-0.05,-4.31,62000,6,68920,0,0,0,0,0,0,62000,0,62000,62000
20200528,709737,威剛凱基9B購01,0.51,0.52,0.51,0.52,-0.03,-5.45,7000,2,3620,0,0,0,0,0,0,2000,5000,-3000,-3000
20200528,709738,建榮凱基9A購02,,,,,,0.00,0,0,0,0,0,0,0,0,0,0,0,0,0
20200528,709739,神盾凱基9A購01,0.85,0.85,0.85,0.85,-0.01,-1.16,7000,1,5950,0,0,0,0,0,0,7000,7000,0,0
20200528,709740,新鉅科凱基99購01,0.21,0.22,0.21,0.22,-0.04,-15.38,200000,2,43000,0,0,0,0,0,0,100000,100000,0,0
20200528,709741,聚積凱基9A購01,0.50,0.50,0.50,0.50,+0.01,2.04,1000,1,500,0,0,0,0,0,0,1000,0,1000,1000
20200528,709742,久元元大99購01,2.73,2.82,2.39,2.39,+0.23,10.65,195000,8,490900,0,0,0,0,0,0,185000,10000,175000,175000
20200528,709743,久元元大99購02,2.42,2.95,2.27,2.31,+0.06,2.67,443000,32,1084850,0,0,0,0,0,0,317000,115000,202000,202000
20200528,709744,光頡元大99購01,1.40,1.43,1.40,1.41,+0.02,1.44,135000,5,190550,0,0,0,0,0,0,0,135000,-135000,-135000
20200528,709745,合晶元大99購02,1.07,1.07,1.07,1.07,+0.02,1.9,68000,1,72760,0,0,0,0,0,0,0,68000,-68000,-68000
20200528,709746,宏捷科元大99購03,2.25,2.27,2.13,2.13,-0.12,-5.33,157000,12,344200,0,0,0,0,0,0,157000,0,157000,157000
20200528,709747,迅得元大9B購01,0.74,0.75,0.70,0.70,-0.04,-5.41,91000,7,66640,0,0,0,0,0,0,10000,81000,-71000,-71000
20200528,709748,勝麗元大99購01,2.39,2.39,2.32,2.32,-0.20,-7.94,135000,8,314400,0,0,0,0,0,0,135000,0,135000,135000
20200528,709749,宏捷科群益99購02,0.44,0.46,0.42,0.43,-0.03,-6.52,66000,8,28510,0,0,0,0,0,0,42000,24000,18000,18000
20200528,709750,信昌電群益99購01,1.52,1.52,1.43,1.43,-0.18,-11.18,199000,5,296640,0,0,0,0,0,0,101000,98000,3000,3000
20200528,709751,安勤國票99購01,,,,,,0.00,0,0,0,0,0,0,0,0,0,0,0,0,0
20200528,709752,中美晶富邦9B購01,0.23,0.23,0.23,0.23,-0.01,-4.17,10000,1,2300,0,0,0,0,0,0,0,10000,-10000,-10000
20200528,709753,宏捷科富邦9B購01,0.58,0.58,0.54,0.54,-0.04,-6.9,66000,6,37160,0,0,0,0,0,0,8000,58000,-50000,-50000
20200528,709754,穩懋富邦9B購01,0.82,0.82,0.80,0.80,-0.03,-3.61,184000,10,149680,0,0,0,0,0,0,184000,0,184000,184000
20200528,709755,力致永豐99購02,2.89,2.92,2.61,2.61,-0.49,-15.81,97000,8,273310,0,0,0,0,0,0,65000,32000,33000,33000
20200528,709756,大學光永豐99購02,,,,,,0.00,0,0,0,0,0,0,0,0,0,0,0,0,0
20200528,709757,宏捷科永豐99購02,1.54,1.58,1.48,1.48,-0.11,-6.92,163000,14,248380,0,0,0,0,0,0,107000,56000,51000,51000
20200528,709758,精華永豐99購01,0.18,0.19,0.18,0.19,+0.01,5.56,40000,4,7500,0,0,0,0,0,0,0,40000,-40000,-40000
20200528,709759,鈺太永豐99購01,1.05,1.06,0.90,0.90,-0.16,-15.09,248000,7,261370,0,0,0,0,0,0,0,248000,-248000,-248000
20200528,709760,合晶凱基9A購01,1.79,1.79,1.70,1.70,0.00,0.0,16000,2,27740,0,0,0,0,0,0,0,16000,-16000,-16000
20200528,709761,雙鴻凱基9A購01,1.42,1.45,1.42,1.44,+0.04,2.86,231000,8,331000,0,0,0,0,0,0,81000,231000,-150000,-150000
20200528,709762,宏捷科統一9B購02,1.10,1.10,1.07,1.07,-0.04,-3.6,185000,7,202950,0,0,0,0,0,0,165000,15000,150000,150000
20200528,709763,宣德統一99購01,,,,,,0.00,0,0,0,0,0,0,0,0,0,0,0,0,0
20200528,709764,建榮統一9B購01,,,,,,0.00,0,0,0,0,0,0,0,0,0,0,0,0,0
20200528,709765,海韻電永豐99購01,2.93,2.93,2.77,2.83,-0.24,-7.82,63000,8,178090,0,0,0,0,0,0,53000,7000,46000,46000
20200528,709766,優群永豐99購01,,,,,,0.00,0,0,0,0,0,0,0,0,0,0,0,0,0
20200528,709767,穩懋永豐9A購01,,,,,,0.00,0,0,0,0,0,0,0,0,0,0,0,0,0
20200528,709768,海韻電元富99購01,4.19,4.26,3.95,3.95,-0.55,-12.22,55000,9,226430,0,0,0,0,0,0,22000,23000,-1000,-1000
20200528,709769,宏捷科國票99購02,1.71,1.75,1.56,1.56,-0.26,-14.29,560000,6,955420,0,0,0,0,0,0,560000,0,560000,560000
20200528,709770,威剛國票9A購01,0.89,0.89,0.80,0.80,-0.07,-8.05,267000,5,228170,0,0,0,0,0,0,160000,107000,53000,53000
20200528,709771,宏捷科元大99購04,,,,,,0.00,0,0,0,0,0,0,0,0,0,0,0,0,0
20200528,709772,穩懋元大99購03,1.88,1.88,1.84,1.85,-0.05,-2.63,77000,7,142980,0,0,0,0,0,0,77000,1000,76000,76000
20200528,709773,宏捷科國泰9A購01,,,,,,0.00,0,0,0,0,0,0,0,0,0,0,0,0,0
20200528,709774,海韻電國泰9B購01,4.03,4.07,4.03,4.07,-0.18,-4.24,12000,3,48480,0,0,0,0,0,0,12000,0,12000,12000
20200528,709775,原相富邦9B購01,0.30,0.30,0.30,0.30,0.00,0.0,10000,1,3000,0,0,0,0,0,0,0,10000,-10000,-10000
20200528,709776,環球晶富邦9B購02,0.34,0.35,0.34,0.34,+0.01,3.03,850000,12,289700,0,0,0,0,0,0,470000,380000,90000,90000
20200528,709777,神盾群益9B購01,0.84,0.84,0.78,0.78,-0.08,-9.3,92000,4,73410,0,0,0,0,0,0,60000,32000,28000,28000
20200528,709778,波若威永豐99購02,1.42,1.43,1.25,1.25,-0.22,-14.97,218000,20,299690,0,0,0,0,0,0,191000,27000,164000,164000
20200528,709779,信昌電永豐99購01,0.56,0.56,0.50,0.50,-0.06,-10.71,15000,2,8100,0,0,0,0,0,0,10000,5000,5000,5000
20200528,709780,晶焱永豐99購01,,,,,,0.00,0,0,0,0,0,0,0,0,0,0,0,0,0
20200528,709781,緯軟永豐99購01,0.57,0.61,0.53,0.53,-0.02,-3.64,140000,12,81240,0,0,0,0,0,0,32000,130000,-98000,-98000
20200528,709782,雙鴻永豐99購02,0.55,0.57,0.55,0.57,0.00,0.0,225000,6,126900,0,0,0,0,0,0,0,225000,-225000,-225000
20200528,709783,宏捷科元富9C購01,1.07,1.07,1.05,1.05,-0.07,-6.25,100000,6,106400,0,0,0,0,0,0,100000,0,100000,100000
20200528,709784,閎康中信99購01,1.47,1.51,1.40,1.41,-0.05,-3.42,494000,17,712920,0,0,0,0,0,0,339000,158000,181000,181000
20200528,709785,合晶凱基9A購02,,,,,,0.00,0,0,0,0,0,0,0,0,0,0,0,0,0
20200528,709786,金居凱基99購01,2.63,2.63,2.63,2.63,-0.13,-4.71,25000,1,65750,0,0,0,0,0,0,25000,0,25000,25000
20200528,709787,金居凱基9A購01,1.52,1.52,1.37,1.37,-0.17,-11.04,234000,17,336320,0,0,0,0,0,0,134000,118000,16000,16000
20200528,709788,泰博凱基9A購01,,,,,,0.00,0,0,0,0,0,0,0,0,0,0,0,0,0
20200528,709789,神盾凱基99購02,,,,,,0.00,0,0,0,0,0,0,0,0,0,0,0,0,0
20200528,709790,網龍凱基9A購01,3.83,4.09,3.83,4.01,+0.11,2.82,105000,14,416330,0,0,0,0,0,0,2000,105000,-103000,-103000
20200528,709791,雙鴻凱基99購01,2.13,2.22,2.13,2.13,+0.05,2.4,69000,7,149290,0,0,0,0,0,0,39000,69000,-30000,-30000
20200528,709792,穩懋凱基99購03,1.43,1.43,1.43,1.43,-0.03,-2.05,70000,2,100100,0,0,0,0,0,0,70000,0,70000,70000
20200528,709793,威剛統一9B購01,,,,,,0.00,0,0,0,0,0,0,0,0,0,0,0,0,0
20200528,709794,原相統一9B購01,0.60,0.60,0.51,0.51,-0.08,-13.56,884000,37,470510,0,0,0,0,0,0,172000,712000,-540000,-540000
20200528,709795,穩懋統一9B購01,0.60,0.61,0.60,0.61,0.00,0.0,100000,3,60100,0,0,0,0,0,0,80000,20000,60000,60000
20200528,709796,三貝德國票9A購01,0.30,0.30,0.27,0.28,+0.05,21.74,303000,4,87840,0,0,0,0,0,0,0,303000,-303000,-303000
20200528,709797,群聯國票9A購01,0.40,0.40,0.40,0.40,0.00,0.0,10000,2,4000,0,0,0,0,0,0,0,0,0,0
20200528,709798,優群國票9A購01,7.95,7.95,7.95,7.95,+0.65,8.9,1000,1,7950,0,0,0,0,0,0,1000,0,1000,1000
20200528,709799,鈺太國泰9C購01,1.27,1.28,1.11,1.11,-0.16,-12.6,748000,34,897680,0,0,0,0,0,0,590000,142000,448000,448000
20200528,709800,建榮富邦9B購01,,,,,,0.00,0,0,0,0,0,0,0,0,0,0,0,0,0
20200528,709801,凡甲兆豐99購01,,,,,,0.00,0,0,0,0,0,0,0,0,0,0,0,0,0
20200528,709802,中美晶兆豐9A購01,0.45,0.45,0.45,0.45,-0.01,-2.17,5000,1,2250,0,0,0,0,0,0,0,5000,-5000,-5000
20200528,709803,穩懋兆豐99購02,0.69,0.69,0.68,0.68,-0.02,-2.86,4000,3,2750,0,0,0,0,0,0,0,4000,-4000,-4000
20200528,709804,譜瑞兆豐99購01,3.13,3.13,3.13,3.13,-0.27,-7.94,3000,1,9390,0,0,0,0,0,0,3000,0,3000,3000
20200528,709805,VHQ群益9B購01,,,,,,0.00,0,0,0,0,0,0,0,0,0,0,0,0,0
20200528,709806,建榮群益9B購01,0.97,0.97,0.97,0.97,-0.04,-3.96,200000,2,194000,0,0,0,0,0,0,200000,200000,0,0
20200528,709807,博智群益99購01,2.11,2.13,2.11,2.13,-0.07,-3.18,10000,2,21200,0,0,0,0,0,0,5000,5000,0,0
20200528,709808,聚積群益99購01,,,,,,0.00,0,0,0,0,0,0,0,0,0,0,0,0,0
20200528,709809,力致元大9A購01,2.26,2.31,2.09,2.09,-0.11,-5.0,342000,42,759090,0,0,0,0,0,0,289000,59000,230000,230000
20200528,709810,大宇資元大99購01,0.38,0.47,0.38,0.47,+0.13,38.24,459000,8,190500,0,0,0,0,0,0,10000,449000,-439000,-439000
20200528,709811,大江元大99購03,4.10,4.35,4.10,4.35,+0.07,1.64,79000,8,337530,0,0,0,0,0,0,15000,64000,-49000,-49000
20200528,709812,光頡元大99購02,1.39,1.43,1.35,1.35,-0.02,-1.46,192000,5,267950,0,0,0,0,0,0,0,192000,-192000,-192000
20200528,709813,迅得元大99購02,1.98,2.03,1.71,1.73,-0.21,-10.82,545000,34,1057100,0,0,0,0,0,0,477000,53000,424000,424000
20200528,709814,建榮元大99購01,2.22,2.22,2.22,2.22,-0.27,-10.84,2000,1,4440,0,0,0,0,0,0,2000,2000,0,0
20200528,709815,網龍元大9A購01,2.19,2.39,2.19,2.19,+0.04,1.86,179000,11,417320,0,0,0,0,0,0,2000,179000,-177000,-177000
20200528,709816,環宇元大99購01,,,,,,0.00,0,0,0,0,0,0,0,0,0,0,0,0,0
20200528,709817,網家群益99購01,2.23,2.23,2.04,2.04,-0.08,-3.77,160000,11,342600,0,0,0,0,0,0,60000,100000,-40000,-40000
20200528,709818,安勤永豐9A購01,,,,,,0.00,0,0,0,0,0,0,0,0,0,0,0,0,0
20200528,709819,宏捷科永豐99購03,0.98,0.99,0.98,0.99,-0.04,-3.88,109000,2,107650,0,0,0,0,0,0,109000,0,109000,109000
20200528,709820,迅得永豐99購01,0.90,0.94,0.76,0.78,-0.13,-14.29,1277000,38,1138080,0,0,0,0,0,0,1067000,210000,857000,857000
20200528,709821,宣德永豐99購01,2.12,2.17,2.12,2.17,+0.05,2.36,66000,5,140760,0,0,0,0,0,0,25000,66000,-41000,-41000
20200528,709822,原相永豐9A購01,0.23,0.23,0.21,0.21,-0.02,-8.7,320000,6,71900,0,0,0,0,0,0,180000,120000,60000,60000
20200528,709823,博智永豐9A購01,,,,,,0.00,0,0,0,0,0,0,0,0,0,0,0,0,0
20200528,709824,新普永豐99購01,2.18,2.44,2.18,2.34,+0.04,1.74,158000,17,368460,0,0,0,0,0,0,79000,120000,-41000,-41000
20200528,709825,聖暉永豐99購01,1.22,1.22,1.13,1.13,-0.05,-4.24,140000,9,167320,0,0,0,0,0,0,33000,107000,-74000,-74000
20200528,709826,優群永豐9A購01,2.16,2.25,1.89,2.20,+0.25,12.82,277000,28,581080,0,0,0,0,0,0,170000,35000,135000,135000
20200528,709827,穩懋永豐99購01,,,,,,0.00,0,0,0,0,0,0,0,0,0,0,0,0,0
20200528,709828,信驊國票9A購01,12.10,12.70,12.10,12.70,+1.30,11.4,6000,2,74400,0,0,0,0,0,0,3000,3000,0,0
20200528,709829,聖暉國票9A購01,,,,,,0.00,0,0,0,0,0,0,0,0,0,0,0,0,0
20200528,709830,信驊國泰9B購01,3.96,3.96,3.93,3.93,+0.12,3.15,5000,2,19710,0,0,0,0,0,0,0,5000,-5000,-5000
20200528,709831,原相富邦9C購01,0.23,0.23,0.20,0.21,-0.05,-19.23,53000,5,10930,0,0,0,0,0,0,25000,28000,-3000,-3000
20200528,709832,宏捷科元富9C購02,1.49,1.52,1.49,1.52,+0.03,2.01,41000,2,61300,0,0,0,0,0,0,34000,7000,27000,27000
20200528,709833,聖暉元富99購01,2.08,2.08,2.08,2.08,-0.14,-6.31,55000,2,114400,0,0,0,0,0,0,45000,10000,35000,35000
20200528,709834,建榮統一9B購02,,,,,,0.00,0,0,0,0,0,0,0,0,0,0,0,0,0
20200528,709835,台半元大99購01,0.77,0.78,0.74,0.74,-0.01,-1.33,305000,8,235760,0,0,0,0,0,0,200000,305000,-105000,-105000
20200528,709836,金居元大99購03,1.81,1.82,1.65,1.66,-0.18,-9.78,472000,24,833630,0,0,0,0,0,0,319000,153000,166000,166000
20200528,709837,博智元大99購02,0.81,0.81,0.81,0.81,+0.03,3.85,50000,1,40500,0,0,0,0,0,0,50000,0,50000,50000
20200528,709838,網龍元大9A購02,2.04,2.14,2.04,2.09,+0.15,7.73,162000,8,338340,0,0,0,0,0,0,4000,159000,-155000,-155000
20200528,709839,力旺凱基99購01,2.36,2.48,2.17,2.17,-0.39,-15.23,449000,44,1075150,0,0,0,0,0,0,439000,39000,400000,400000
20200528,709840,合晶凱基9A購03,1.38,1.38,1.34,1.34,+0.05,3.88,60000,2,82400,0,0,0,0,0,0,60000,10000,50000,50000
20200528,709841,聯亞凱基9A購01,1.80,1.80,1.80,1.80,+0.02,1.12,10000,1,18000,0,0,0,0,0,0,10000,10000,0,0
20200528,709842,譜瑞凱基9A購02,,,,,,0.00,0,0,0,0,0,0,0,0,0,0,0,0,0
20200528,709843,雙鴻中信9B購01,0.40,0.40,0.40,0.40,+0.02,5.26,150000,2,60000,0,0,0,0,0,0,0,150000,-150000,-150000
20200528,709844,宏捷科凱基9A購01,1.55,1.56,1.55,1.56,+0.01,0.65,15000,2,23300,0,0,0,0,0,0,10000,5000,5000,5000
20200528,709845,金可凱基9A購01,0.45,0.45,0.43,0.43,+0.01,2.38,28000,3,12200,0,0,0,0,0,0,0,28000,-28000,-28000
20200528,709846,凡甲元大99購01,4.80,4.80,4.80,4.80,-0.09,-1.84,6000,1,28800,0,0,0,0,0,0,6000,0,6000,6000
20200528,709847,宇峻元大9C購01,0.51,0.52,0.51,0.52,+0.04,8.33,37000,3,18890,0,0,0,0,0,0,5000,32000,-27000,-27000
20200528,709848,金可元大99購01,0.85,0.85,0.85,0.85,+0.26,44.07,49000,2,41650,0,0,0,0,0,0,0,49000,-49000,-49000
20200528,709849,保瑞元大9A購01,0.91,0.91,0.89,0.89,-0.05,-5.32,131000,8,118290,0,0,0,0,0,0,1000,130000,-129000,-129000
20200528,709850,建榮元大99購02,1.99,1.99,1.99,1.99,-0.03,-1.49,1000,1,1990,0,0,0,0,0,0,1000,1000,0,0
20200528,709851,晶焱元大9A購01,,,,,,0.00,0,0,0,0,0,0,0,0,0,0,0,0,0
20200528,709852,群聯元大99購04,,,,,,0.00,0,0,0,0,0,0,0,0,0,0,0,0,0
20200528,709853,大江國票9A購01,1.74,1.85,1.74,1.85,+0.08,4.52,70000,6,126410,0,0,0,0,0,0,70000,53000,17000,17000
20200528,709854,穩懋國票99購02,0.91,0.95,0.91,0.94,-0.07,-6.93,50000,5,46800,0,0,0,0,0,0,0,50000,-50000,-50000
20200528,709855,穩懋富邦9B購02,0.62,0.63,0.61,0.63,+0.01,1.61,1274000,15,786000,0,0,0,0,0,0,610000,664000,-54000,-54000
20200528,709856,晶焱兆豐9A購01,0.64,0.64,0.64,0.64,-0.03,-4.48,10000,1,6400,0,0,0,0,0,0,10000,0,10000,10000
20200528,709857,環球晶兆豐99購01,,,,,,0.00,0,0,0,0,0,0,0,0,0,0,0,0,0
20200528,709858,穩懋兆豐9A購01,1.03,1.04,1.02,1.04,-0.03,-2.8,50000,3,51700,20000,0,20000,0,0,0,30000,20000,10000,30000
20200528,709859,安勤群益99購01,,,,,,0.00,0,0,0,0,0,0,0,0,0,0,0,0,0
20200528,709860,新鉅科群益9A購01,0.71,0.71,0.63,0.63,-0.07,-10.0,471000,24,318780,0,0,0,0,0,0,444000,27000,417000,417000
20200528,709861,環球晶群益99購01,1.69,1.69,1.67,1.67,+0.07,4.38,4000,3,6730,0,0,0,0,0,0,3000,2000,1000,1000
20200528,709862,碩禾永豐99購01,,,,,,0.00,0,0,0,0,0,0,0,0,0,0,0,0,0
20200528,709863,網龍永豐9A購01,1.87,1.87,1.78,1.78,+0.10,5.95,30000,3,55200,0,0,0,0,0,0,30000,0,30000,30000
20200528,709864,璟德元富99購01,2.06,2.06,1.96,1.96,-0.14,-6.67,79000,3,160140,0,0,0,0,0,0,78000,1000,77000,77000
20200528,709865,鈺太元富99購01,1.97,2.06,1.72,1.72,-0.33,-16.1,294000,20,580900,0,0,0,0,0,0,282000,12000,270000,270000
20200528,709866,凡甲永豐9A購01,1.54,1.55,1.44,1.44,-0.11,-7.1,261000,12,395490,0,0,0,0,0,0,208000,138000,70000,70000
20200528,709867,兆利永豐99購01,,,,,,0.00,0,0,0,0,0,0,0,0,0,0,0,0,0
20200528,709868,欣銓永豐99購01,0.78,0.78,0.71,0.71,-0.09,-11.25,178000,4,128930,0,0,0,0,0,0,165000,13000,152000,152000
20200528,709869,信驊永豐99購02,1.46,1.55,1.35,1.37,+0.07,5.38,363000,38,540430,0,0,0,0,0,0,21000,338000,-317000,-317000
20200528,709870,群聯永豐99購01,,,,,,0.00,0,0,0,0,0,0,0,0,0,0,0,0,0
20200528,709871,聚積永豐99購01,,,,,,0.00,0,0,0,0,0,0,0,0,0,0,0,0,0
20200528,709872,環球晶永豐99購02,0.77,0.78,0.75,0.76,0.00,0.0,152000,5,117460,0,0,0,0,0,0,70000,82000,-12000,-12000
20200528,709873,東洋統一9B購01,1.84,1.84,1.79,1.79,-0.06,-3.24,93000,4,167420,0,0,0,0,0,0,72000,21000,51000,51000
20200528,709874,建榮凱基9A購03,,,,,,0.00,0,0,0,0,0,0,0,0,0,0,0,0,0
20200528,709875,大中國票9A購01,1.51,1.51,1.51,1.51,-0.06,-3.82,19000,1,28690,0,0,0,0,0,0,19000,0,19000,19000
20200528,709876,台燿國票9A購01,4.22,4.44,4.22,4.44,+0.05,1.14,62000,6,270780,0,0,0,0,0,0,45000,17000,28000,28000
20200528,709877,泰博國泰9A購01,,,,,,0.00,0,0,0,0,0,0,0,0,0,0,0,0,0
20200528,709878,大江元大99購04,1.79,1.85,1.75,1.81,+0.04,2.26,206000,12,368950,0,0,0,0,0,0,110000,96000,14000,14000
20200528,709879,安勤元大99購02,,,,,,0.00,0,0,0,0,0,0,0,0,0,0,0,0,0
20200528,709880,宏捷科元大99購06,,,,,,0.00,0,0,0,0,0,0,0,0,0,0,0,0,0
20200528,709881,聖暉元大99購01,1.93,1.93,1.87,1.89,-0.01,-0.53,305000,4,580450,0,0,0,0,0,0,300000,5000,295000,295000
20200528,709882,優群元大99購03,2.24,2.27,2.03,2.24,+0.04,1.82,331000,30,718150,0,0,0,0,0,0,324000,5000,319000,319000
20200528,709883,優群元大9B購01,2.51,2.54,2.28,2.49,-0.01,-0.4,816000,30,2015850,0,0,0,0,0,0,390000,437000,-47000,-47000
20200528,709884,穩懋元大99購05,1.94,1.96,1.90,1.96,-0.06,-2.97,59000,4,112480,0,0,0,0,0,0,50000,9000,41000,41000
20200528,709885,信驊兆豐99購01,2.08,2.23,2.01,2.01,+0.10,5.24,140000,7,300000,0,0,0,0,0,0,2000,138000,-136000,-136000
20200528,709886,中美晶群益9A購01,,,,,,0.00,0,0,0,0,0,0,0,0,0,0,0,0,0
20200528,709887,神盾群益9B購02,2.26,2.26,2.26,2.26,-0.02,-0.88,27000,1,61020,0,0,0,0,0,0,27000,0,27000,27000
20200528,709888,聯亞群益99購01,1.30,1.30,1.27,1.27,-0.03,-2.31,214000,2,277750,0,0,0,0,0,0,15000,199000,-184000,-184000
20200528,709889,台燿元富9C購01,3.01,3.12,2.94,3.08,-0.01,-0.32,387000,24,1175020,0,0,0,0,0,0,228000,159000,69000,69000
20200528,709890,原相統一9A購01,1.05,1.05,0.92,0.92,-0.10,-9.8,814000,28,799620,0,0,0,0,0,0,794000,10000,784000,784000
20200528,709891,大宇資凱基9B購01,0.65,0.78,0.65,0.78,+0.17,27.87,214000,21,162590,0,0,0,0,0,0,70000,144000,-74000,-74000
20200528,709892,宇峻凱基9B購01,0.78,0.80,0.77,0.77,+0.04,5.48,633000,11,500830,0,0,0,0,0,0,25000,608000,-583000,-583000
20200528,709893,信驊凱基9A購01,3.59,3.68,3.59,3.68,-0.15,-3.92,32000,2,115060,0,0,0,0,0,0,0,32000,-32000,-32000
20200528,709894,統新凱基9B購01,1.01,1.01,0.96,0.97,+0.02,2.11,68000,9,66550,0,0,0,0,0,0,11000,57000,-46000,-46000
20200528,709895,順達凱基99購01,2.57,2.57,2.35,2.35,-0.27,-10.31,130000,3,327860,0,0,0,0,0,0,130000,0,130000,130000
20200528,709896,雙美凱基9B購01,1.31,1.32,1.31,1.32,-0.08,-5.71,350000,3,460000,0,0,0,0,0,0,28000,350000,-322000,-322000
20200528,709897,雙鴻元大99購06,1.37,1.37,1.34,1.37,+0.02,1.48,339000,9,462180,0,0,0,0,0,0,129000,277000,-148000,-148000
20200528,709898,穩懋元大99購06,2.11,2.11,2.11,2.11,-0.03,-1.4,51000,2,107610,0,0,0,0,0,0,1000,51000,-50000,-50000
20200528,709899,穩懋元大99購07,1.06,1.06,1.03,1.04,-0.02,-1.89,21000,3,21760,0,0,0,0,0,0,11000,11000,0,0
20200528,709900,力致永豐99購03,,,,,,0.00,0,0,0,0,0,0,0,0,0,0,0,0,0
20200528,709901,光頡永豐99購01,0.78,0.80,0.75,0.75,-0.03,-3.85,840000,10,661540,0,0,0,0,0,0,15000,825000,-810000,-810000
20200528,709902,新鉅科永豐99購01,,,,,,0.00,0,0,0,0,0,0,0,0,0,0,0,0,0
20200528,709903,精測永豐9A購01,,,,,,0.00,0,0,0,0,0,0,0,0,0,0,0,0,0
20200528,709904,璟德永豐99購01,1.19,1.19,1.12,1.12,-0.06,-5.08,95000,7,108940,0,0,0,0,0,0,46000,70000,-24000,-24000
20200528,709905,環球晶永豐99購03,1.32,1.32,1.32,1.32,-0.03,-2.22,1000,1,1320,0,0,0,0,0,0,1000,0,1000,1000
20200528,709906,兆利國票99購01,,,,,,0.00,0,0,0,0,0,0,0,0,0,0,0,0,0
20200528,709907,金居國票9A購01,3.00,3.00,3.00,3.00,-0.11,-3.54,9000,1,27000,0,0,0,0,0,0,0,9000,-9000,-9000
20200528,709908,信驊國票9A購02,9.90,9.90,9.20,9.20,-1.90,-17.12,18000,6,174200,0,0,0,0,0,0,0,18000,-18000,-18000
20200528,709909,兆利國泰9A購01,0.34,0.34,0.34,0.34,0.00,0.0,176000,1,59840,0,0,0,0,0,0,0,176000,-176000,-176000
20200528,709910,宏捷科國泰9B購01,1.02,1.02,0.97,0.97,-0.09,-8.49,137000,3,138240,0,0,0,0,0,0,137000,0,137000,137000
20200528,709911,精測國泰9C購01,0.61,0.61,0.56,0.56,-0.04,-6.67,349000,8,209370,0,0,0,0,0,0,281000,68000,213000,213000
20200528,709912,威剛富邦9C購01,0.11,0.11,0.11,0.11,-0.02,-15.38,9000,1,990,0,0,0,0,0,0,0,0,0,0
20200528,709913,M31群益99購01,0.97,1.00,0.80,0.85,-0.14,-14.14,335000,45,316020,0,0,0,0,0,0,230000,200000,30000,30000
20200528,709914,中美晶群益9B購01,,,,,,0.00,0,0,0,0,0,0,0,0,0,0,0,0,0
20200528,709915,台燿群益99購02,1.73,1.82,1.69,1.79,+0.06,3.47,912000,29,1602970,0,0,0,0,0,0,649000,312000,337000,337000
20200528,709916,合晶群益9A購01,1.24,1.24,1.24,1.24,+0.03,2.48,102000,3,126480,0,0,0,0,0,0,72000,30000,42000,42000
20200528,709917,緯軟群益9A購01,1.23,1.24,1.14,1.14,+0.03,2.7,364000,7,440540,0,0,0,0,0,0,122000,364000,-242000,-242000
20200528,709918,璟德群益99購01,,,,,,0.00,0,0,0,0,0,0,0,0,0,0,0,0,0
20200528,709919,環球晶群益99購02,1.96,1.96,1.96,1.96,+0.11,5.95,1000,1,1960,0,0,0,0,0,0,1000,1000,0,0
20200528,709920,原相日盛9B購01,0.48,0.48,0.48,0.48,-0.04,-7.69,2000,1,960,0,0,0,0,0,0,0,2000,-2000,-2000
20200528,709921,雍智國泰9C購01,1.34,1.34,1.21,1.21,-0.13,-9.7,240000,8,301360,0,0,0,0,0,0,209000,31000,178000,178000
20200528,709922,璟德國泰9A購01,2.15,2.15,2.08,2.08,-0.11,-5.02,56000,4,116750,0,0,0,0,0,0,56000,0,56000,56000
20200528,709923,VHQ群益99購01,,,,,,0.00,0,0,0,0,0,0,0,0,0,0,0,0,0
20200528,709924,中美晶群益99購03,0.57,0.57,0.57,0.57,+0.02,3.64,56000,1,31920,0,0,0,0,0,0,56000,0,56000,56000
20200528,709925,精測群益99購01,,,,,,0.00,0,0,0,0,0,0,0,0,0,0,0,0,0
20200528,709926,精測富邦9A購01,0.14,0.14,0.13,0.14,-0.02,-12.5,786000,10,108740,0,0,0,0,0,0,0,656000,-656000,-656000
20200528,709927,聯亞國票9A購01,5.05,5.25,5.05,5.25,+0.15,2.94,13000,2,67650,0,0,0,0,0,0,3000,10000,-7000,-7000
20200528,709928,穩懋國票99購03,6.35,6.35,6.15,6.15,-0.35,-5.38,4000,2,25200,0,0,0,0,0,0,1000,3000,-2000,-2000
20200528,709929,大江永豐99購01,2.91,3.02,2.91,3.02,+0.09,3.07,14000,2,41180,0,0,0,0,0,0,10000,14000,-4000,-4000
20200528,709930,精測永豐99購01,,,,,,0.00,0,0,0,0,0,0,0,0,0,0,0,0,0
20200528,709931,建榮統一9B購03,,,,,,0.00,0,0,0,0,0,0,0,0,0,0,0,0,0
20200528,709932,中美晶凱基99購07,,,,,,0.00,0,0,0,0,0,0,0,0,0,0,0,0,0
20200528,709933,碩禾凱基9B購01,0.34,0.34,0.34,0.34,-0.01,-2.86,40000,2,13600,0,0,0,0,0,0,0,40000,-40000,-40000
20200528,709934,精測元富99購02,0.77,0.77,0.68,0.68,-0.10,-12.82,296000,15,217300,0,0,0,0,0,0,234000,56000,178000,178000
20200528,709935,鈺太元富99購02,2.46,2.48,2.14,2.14,-0.32,-13.01,207000,9,471020,0,0,0,0,0,0,42000,155000,-113000,-113000
20200528,709936,元太元大99購01,,,,,,0.00,0,0,0,0,0,0,0,0,0,0,0,0,0
20200528,709937,兆利元大9B購01,,,,,,0.00,0,0,0,0,0,0,0,0,0,0,0,0,0
20200528,709938,宏捷科元大99購07,0.97,0.97,0.92,0.92,-0.06,-6.12,40000,3,37900,0,0,0,0,0,0,0,40000,-40000,-40000
20200528,709939,良維元大99購01,3.03,3.03,3.03,3.03,-0.06,-1.94,9000,1,27270,0,0,0,0,0,0,0,9000,-9000,-9000
20200528,709940,信驊元大99購01,9.75,9.75,9.70,9.70,+0.65,7.18,15000,2,146100,0,0,0,0,0,0,3000,15000,-12000,-12000
20200528,709941,信驊元大99購02,,,,,,0.00,0,0,0,0,0,0,0,0,0,0,0,0,0
20200528,709942,威剛元大9A購02,,,,,,0.00,0,0,0,0,0,0,0,0,0,0,0,0,0
20200528,709943,泰博元大99購01,,,,,,0.00,0,0,0,0,0,0,0,0,0,0,0,0,0
20200528,709944,順達元大99購01,3.30,3.30,3.26,3.26,-0.39,-10.68,45000,2,147900,0,0,0,0,0,0,45000,15000,30000,30000
20200528,709945,群聯元大99購05,,,,,,0.00,0,0,0,0,0,0,0,0,0,0,0,0,0
20200528,709946,精華元大99購01,1.01,1.05,0.98,0.98,-0.02,-2.0,864000,15,859050,0,0,0,0,0,0,436000,452000,-16000,-16000
20200528,709947,神盾永豐99購02,0.94,0.94,0.82,0.84,-0.09,-9.68,154000,10,134720,0,0,0,0,0,0,108000,84000,24000,24000
20200528,709948,穩懋永豐99購02,1.51,1.51,1.51,1.51,-0.05,-3.21,30000,3,45300,0,0,0,0,0,0,10000,20000,-10000,-10000
20200528,709949,中美晶日盛99購01,,,,,,0.00,0,0,0,0,0,0,0,0,0,0,0,0,0
20200528,709950,大學光元大99購02,,,,,,0.00,0,0,0,0,0,0,0,0,0,0,0,0,0
20200528,709951,台燿元大99購01,1.75,1.82,1.69,1.80,+0.05,2.86,303000,14,530500,0,0,0,0,0,0,89000,214000,-125000,-125000
20200528,709952,良維元大99購02,3.29,3.29,3.24,3.24,+0.01,0.31,19000,2,62060,0,0,0,0,0,0,10000,9000,1000,1000
20200528,709953,建榮元大9B購01,1.17,1.17,1.17,1.17,-0.02,-1.68,21000,1,24570,0,0,0,0,0,0,0,21000,-21000,-21000
20200528,709954,M31國票9A購01,2.81,2.81,2.42,2.42,-0.32,-11.68,65000,5,169250,0,0,0,0,0,0,53000,12000,41000,41000
20200528,709955,大江國票9A購02,3.12,3.28,3.12,3.20,-0.04,-1.23,61000,5,197840,0,0,0,0,0,0,0,61000,-61000,-61000
20200528,709956,群聯統一9B購01,0.86,0.87,0.86,0.87,+0.01,1.16,203000,6,175110,0,0,0,0,0,0,203000,0,203000,203000
20200528,709957,璟德兆豐99購02,1.01,1.01,1.01,1.01,0.00,0.0,1000,1,1010,0,0,0,0,0,0,1000,0,1000,1000
20200528,709958,迅得凱基99購01,2.01,2.02,1.71,1.72,-0.24,-12.24,621000,26,1184330,0,0,0,0,0,0,537000,74000,463000,463000
20200528,709959,保瑞凱基9B購01,1.35,1.35,1.35,1.35,-0.04,-2.88,19000,1,25650,0,0,0,0,0,0,0,19000,-19000,-19000
20200528,709960,原相凱基9A購01,2.36,2.36,2.07,2.07,-0.21,-9.21,91000,24,211200,0,0,0,0,0,0,74000,17000,57000,57000
20200528,709961,雍智凱基9B購01,1.57,1.57,1.51,1.51,-0.12,-7.36,25000,3,38950,0,0,0,0,0,0,25000,0,25000,25000
20200528,709962,精測凱基99購03,,,,,,0.00,0,0,0,0,0,0,0,0,0,0,0,0,0
20200528,709963,廣明凱基99購02,,,,,,0.00,0,0,0,0,0,0,0,0,0,0,0,0,0
20200528,709964,璟德凱基99購01,4.17,4.17,4.06,4.06,-0.26,-6.02,58000,3,239660,0,0,0,0,0,0,20000,38000,-18000,-18000
20200528,709965,環球晶凱基99購07,,,,,,0.00,0,0,0,0,0,0,0,0,0,0,0,0,0
20200528,709966,金居群益9B購01,2.83,2.86,2.69,2.69,-0.21,-7.24,114000,3,320710,0,0,0,0,0,0,114000,0,114000,114000
20200528,709967,信驊群益99購01,3.12,3.21,3.12,3.21,+0.20,6.64,109000,2,340170,0,0,0,0,0,0,0,109000,-109000,-109000
20200528,709968,聯亞群益99購02,2.69,2.69,2.69,2.69,+0.10,3.86,100000,1,269000,0,0,0,0,0,0,0,100000,-100000,-100000
20200528,709969,譜瑞兆豐99購02,2.46,2.46,2.46,2.46,-0.15,-5.75,2000,2,4920,0,0,0,0,0,0,1000,1000,0,0
20200528,709970,宏捷科元大9A購01,,,,,,0.00,0,0,0,0,0,0,0,0,0,0,0,0,0
20200528,709971,邦特元大99購01,1.60,1.62,1.51,1.54,-0.09,-5.52,2250000,52,3487550,0,0,0,0,0,0,1228000,945000,283000,283000
20200528,709972,旺矽元大9B購01,1.73,1.73,1.62,1.62,-0.05,-2.99,167000,11,275610,0,0,0,0,0,0,114000,53000,61000,61000
20200528,709973,中美晶國票9A購01,,,,,,0.00,0,0,0,0,0,0,0,0,0,0,0,0,0
20200528,709974,旺矽國票99購02,6.25,6.25,6.25,6.25,+0.20,3.31,38000,1,237500,0,0,0,0,0,0,38000,0,38000,38000
20200528,709975,宣德國票9A購01,2.60,2.87,2.60,2.80,+0.31,12.45,304000,22,834920,0,0,0,0,0,0,92000,212000,-120000,-120000
20200528,709976,鈺太國票9A購01,2.83,2.87,2.83,2.87,+0.03,1.06,47000,3,133390,0,0,0,0,0,0,18000,29000,-11000,-11000
20200528,709977,M31永豐99購02,2.92,2.92,2.88,2.90,+0.13,4.69,30000,3,87000,0,0,0,0,0,0,30000,0,30000,30000
20200528,709978,建榮永豐9A購02,,,,,,0.00,0,0,0,0,0,0,0,0,0,0,0,0,0
20200528,709979,晶焱永豐9A購01,,,,,,0.00,0,0,0,0,0,0,0,0,0,0,0,0,0
20200528,709980,鈊象永豐9A購01,1.47,1.68,1.47,1.66,+0.35,26.72,203000,7,316020,0,0,0,0,0,0,37000,166000,-129000,-129000
20200528,709981,M31凱基99購02,3.03,3.10,2.70,2.70,-0.44,-14.01,342000,36,1023300,0,0,0,0,0,0,252000,90000,162000,162000
20200528,709982,穩懋凱基99購05,1.82,1.82,1.82,1.82,-0.13,-6.67,65000,1,118300,0,0,0,0,0,0,0,65000,-65000,-65000
20200528,709983,群聯日盛9B購01,,,,,,0.00,0,0,0,0,0,0,0,0,0,0,0,0,0
20200528,709984,原相群益9C購01,1.67,1.67,1.50,1.50,-0.13,-7.98,226000,9,361160,0,0,0,0,0,0,152000,74000,78000,78000
20200528,709985,大江富邦9B購02,,,,,,0.00,0,0,0,0,0,0,0,0,0,0,0,0,0
20200528,709986,金可中信99購01,1.57,1.60,1.50,1.60,+0.10,6.67,40000,4,62100,0,0,0,0,0,0,20000,20000,0,0
20200528,709987,精華中信99購01,1.98,1.98,1.98,1.98,-0.01,-0.5,10000,1,19800,0,0,0,0,0,0,0,10000,-10000,-10000
20200528,709988,大江永豐99購02,3.49,3.56,3.49,3.55,+0.04,1.14,36000,5,127220,0,0,0,0,0,0,5000,36000,-31000,-31000
20200528,709989,茂達永豐99購01,2.32,2.51,2.26,2.27,+0.02,0.89,217000,16,511820,0,0,0,0,0,0,110000,107000,3000,3000
20200528,709990,精測永豐99購02,0.96,0.96,0.96,0.96,-0.06,-5.88,15000,1,14400,0,0,0,0,0,0,15000,0,15000,15000
20200528,709991,環球晶凱基99購08,,,,,,0.00,0,0,0,0,0,0,0,0,0,0,0,0,0
20200528,709992,中美晶元大99購04,1.05,1.05,1.05,1.05,+0.01,0.96,20000,1,21000,0,0,0,0,0,0,0,20000,-20000,-20000
20200528,709993,中美晶元大99購05,1.09,1.09,1.06,1.06,-0.02,-1.85,15000,2,16200,0,0,0,0,0,0,0,15000,-15000,-15000
20200528,709994,中美晶元大9B購01,0.89,0.89,0.89,0.89,+0.02,2.3,10000,1,8900,0,0,0,0,0,0,10000,0,10000,10000
20200528,709995,環球晶元大99購03,3.24,3.24,3.17,3.24,+0.17,5.54,47000,6,149490,0,0,0,0,0,0,41000,8000,33000,33000
20200528,709996,環球晶元大99購04,3.56,3.65,3.56,3.65,+0.18,5.19,10000,3,35870,0,0,0,0,0,0,3000,10000,-7000,-7000
20200528,709997,聯亞元大99購02,2.16,2.25,2.16,2.21,+0.07,3.27,138000,4,306640,0,0,0,0,0,0,94000,94000,0,0
20200528,709998,穩懋元大99購09,1.94,1.94,1.91,1.94,-0.01,-0.51,89000,8,171730,0,0,0,0,0,0,42000,48000,-6000,-6000
20200528,709999,穩懋元大99購10,1.52,1.52,1.49,1.51,0.00,0.0,68000,5,102600,0,0,0,0,0,0,32000,38000,-6000,-6000
20200528,710000,穩懋元大99購11,1.66,1.66,1.58,1.61,-0.03,-1.83,118000,7,191590,0,0,0,0,0,0,14000,105000,-91000,-91000
20200528,710001,M31國票9A購02,9.10,9.10,8.00,8.00,-1.95,-19.6,98000,9,868300,0,0,0,0,0,0,82000,16000,66000,66000
20200528,710002,穩懋國票9A購01,,,,,,0.00,0,0,0,0,0,0,0,0,0,0,0,0,0
20200528,710003,精測元大99購03,0.83,0.83,0.83,0.83,0.00,0.0,40000,1,33200,0,0,0,0,0,0,40000,0,40000,40000
20200528,710004,中美晶元富9B購01,1.52,1.52,1.50,1.50,0.00,0.0,31000,4,46920,0,0,0,0,0,0,0,31000,-31000,-31000
20200528,710005,中美晶元富9B購02,,,,,,0.00,0,0,0,0,0,0,0,0,0,0,0,0,0
20200528,710006,神盾元富9B購01,1.83,1.83,1.66,1.66,-0.15,-8.29,96000,9,161620,0,0,0,0,0,0,51000,47000,4000,4000
20200528,710007,環球晶元富9B購01,1.79,1.84,1.75,1.79,+0.02,1.13,223000,15,401020,0,0,0,0,0,0,67000,174000,-107000,-107000
20200528,710008,環球晶元富9B購02,2.37,2.38,2.37,2.38,+0.03,1.28,12000,2,28500,0,0,0,0,0,0,6000,6000,0,0
20200528,710009,穩懋元富99購01,3.23,3.23,3.23,3.23,-0.11,-3.29,10000,2,32300,0,0,0,0,0,0,0,10000,-10000,-10000
20200528,710010,中美晶國票9A購02,1.80,1.81,1.78,1.81,+0.04,2.26,50000,4,89800,0,0,0,0,0,0,50000,0,50000,50000
20200528,710011,泰博國票9A購01,30.90,30.90,30.90,30.90,+4.20,15.73,1000,1,30900,0,0,0,0,0,0,0,1000,-1000,-1000
20200528,710012,大宇資凱基9B購02,1.11,1.50,1.11,1.50,+0.39,35.14,999000,75,1248700,0,0,0,0,0,0,272000,689000,-417000,-417000
20200528,710013,金可凱基99購01,1.71,1.71,1.71,1.71,+0.11,6.88,70000,1,119700,0,0,0,0,0,0,0,70000,-70000,-70000
20200528,710014,信驊凱基99購01,,,,,,0.00,0,0,0,0,0,0,0,0,0,0,0,0,0
20200528,710015,統新凱基9A購01,1.39,1.39,1.36,1.36,-0.01,-0.73,23000,3,31670,0,0,0,0,0,0,0,23000,-23000,-23000
20200528,710016,群聯凱基9A購01,1.75,1.75,1.66,1.66,-0.06,-3.49,304000,14,521590,10000,0,10000,0,0,0,177000,168000,9000,19000
20200528,710017,環球晶凱基99購09,1.82,1.85,1.79,1.79,0.00,0.0,31000,3,56150,0,0,0,0,0,0,11000,20000,-9000,-9000
20200528,710018,譜瑞凱基99購02,4.90,4.90,4.88,4.88,-0.92,-15.86,5000,2,24460,0,0,0,0,0,0,0,5000,-5000,-5000
20200528,710019,精測中信9A購01,0.60,0.60,0.54,0.55,-0.05,-8.33,435000,14,247850,0,0,0,0,0,0,93000,340000,-247000,-247000
20200528,710020,合晶永豐99購01,3.18,3.23,3.18,3.23,+0.13,4.19,107000,4,345560,0,0,0,0,0,0,107000,0,107000,107000
20200528,710021,雙鴻永豐99購03,2.09,2.13,2.09,2.12,+0.05,2.42,134000,7,283420,0,0,0,0,0,0,47000,87000,-40000,-40000
20200528,710022,譜瑞永豐99購01,,,,,,0.00,0,0,0,0,0,0,0,0,0,0,0,0,0
20200528,710023,鈊象永豐99購03,1.26,1.63,1.26,1.63,+0.44,36.97,452000,13,642870,0,0,0,0,0,0,38000,414000,-376000,-376000
20200528,710024,宏捷科永豐99購04,,,,,,0.00,0,0,0,0,0,0,0,0,0,0,0,0,0
20200528,710025,泰博永豐99購02,,,,,,0.00,0,0,0,0,0,0,0,0,0,0,0,0,0
20200528,710026,群聯永豐99購02,1.62,1.63,1.51,1.51,-0.07,-4.43,227000,7,349160,0,0,0,0,0,0,186000,41000,145000,145000
20200528,710027,優群永豐99購02,3.78,3.86,3.78,3.82,+0.31,8.83,37000,6,141060,0,0,0,0,0,0,37000,0,37000,37000
20200528,710028,原相群益9C購02,1.70,1.71,1.54,1.54,-0.13,-7.78,530000,35,872800,0,0,0,0,0,0,425000,93000,332000,332000
20200528,710029,優群群益9A購01,,,,,,0.00,0,0,0,0,0,0,0,0,0,0,0,0,0
20200528,710030,大宇資元大9A購01,2.23,2.82,2.23,2.82,+0.60,27.03,95000,10,227010,0,0,0,0,0,0,33000,60000,-27000,-27000
20200528,710031,金居元大99購04,,,,,,0.00,0,0,0,0,0,0,0,0,0,0,0,0,0
20200528,710032,精測元大99購04,0.83,0.84,0.74,0.75,-0.07,-8.54,592000,18,458750,0,0,0,0,0,0,221000,371000,-150000,-150000
20200528,710033,聯亞元大9A購01,3.48,3.62,3.47,3.47,+0.02,0.58,130000,11,461160,0,0,0,0,0,0,30000,100000,-70000,-70000
20200528,710034,穩懋元大9A購01,1.73,1.73,1.70,1.73,-0.01,-0.57,23000,4,39490,0,0,0,0,0,0,11000,13000,-2000,-2000
20200528,710035,雙鴻元富99購01,1.40,1.40,1.35,1.35,+0.02,1.5,31000,5,42610,0,0,0,0,0,0,11000,30000,-19000,-19000
20200528,710036,大學光凱基9A購02,4.08,4.30,4.08,4.16,+0.02,0.48,83000,30,344290,0,0,0,0,0,0,50000,33000,17000,17000
20200528,710037,群聯凱基99購03,2.86,2.86,2.82,2.82,-0.03,-1.05,45000,2,128660,0,0,0,0,0,0,45000,1000,44000,44000
20200528,710038,泰博群益9A購01,4.42,4.63,4.42,4.63,+0.61,15.17,30000,3,135700,0,0,0,0,0,0,0,30000,-30000,-30000
20200528,710039,宏捷科富邦9B購02,1.61,1.61,1.57,1.57,-0.05,-3.09,418000,39,667620,0,0,0,0,0,0,418000,0,418000,418000
20200528,710040,穩懋亞東99購01,,,,,,0.00,0,0,0,0,0,0,0,0,0,0,0,0,0
20200528,710041,原相凱基99購02,2.49,2.49,2.24,2.24,-0.20,-8.2,91000,19,223970,0,0,0,0,0,0,91000,25000,66000,66000
20200528,710042,群聯凱基99購04,3.34,3.36,3.31,3.31,+0.01,0.3,58000,6,194540,0,0,0,0,0,0,58000,1000,57000,57000
20200528,710043,碩禾凱基9B購02,0.85,0.85,0.83,0.83,-0.03,-3.49,15000,2,12650,0,0,0,0,0,0,5000,10000,-5000,-5000
20200528,710044,雙美凱基99購03,,,,,,0.00,0,0,0,0,0,0,0,0,0,0,0,0,0
20200528,710045,穩懋凱基99購06,2.03,2.08,2.03,2.08,-0.03,-1.42,77000,3,157210,0,0,0,0,0,0,0,77000,-77000,-77000
20200528,710046,威剛元大9A購03,2.36,2.36,2.26,2.26,-0.02,-0.88,88000,5,201660,0,0,0,0,0,0,36000,52000,-16000,-16000
20200528,710047,群聯元大99購06,8.75,8.75,8.60,8.60,-0.10,-1.15,5000,4,43550,0,0,0,0,0,0,2000,5000,-3000,-3000
20200528,710048,環球晶元大99購05,4.85,5.00,4.85,4.85,+0.17,3.63,14000,7,68800,0,0,0,0,0,0,0,14000,-14000,-14000
20200528,710049,環球晶元大99購06,4.65,4.83,4.65,4.83,+0.19,4.09,59000,10,280590,0,0,0,0,0,0,4000,59000,-55000,-55000
20200528,710050,中美晶永豐99購01,1.06,1.07,1.06,1.07,-0.04,-3.6,97000,2,103270,0,0,0,0,0,0,52000,45000,7000,7000
20200528,710051,宏捷科永豐99購05,3.42,3.45,3.42,3.42,-0.11,-3.12,110000,15,377300,0,0,0,0,0,0,109000,1000,108000,108000
20200528,710052,原相永豐99購03,1.48,1.48,1.27,1.27,-0.16,-11.19,1296000,58,1848740,0,0,0,0,0,0,1188000,98000,1090000,1090000
20200528,710053,環球晶永豐99購04,1.49,1.53,1.47,1.47,0.00,0.0,133000,7,199910,0,0,0,0,0,0,10000,123000,-113000,-113000
20200528,710054,聯亞永豐99購01,1.54,1.55,1.51,1.51,-0.05,-3.21,60000,5,92350,0,0,0,0,0,0,0,60000,-60000,-60000
20200528,710055,雙鴻永豐9A購01,,,,,,0.00,0,0,0,0,0,0,0,0,0,0,0,0,0
20200528,710056,大江元大99購05,,,,,,0.00,0,0,0,0,0,0,0,0,0,0,0,0,0
20200528,710057,M31永豐99購03,,,,,,0.00,0,0,0,0,0,0,0,0,0,0,0,0,0
20200528,710058,力致永豐9A購01,,,,,,0.00,0,0,0,0,0,0,0,0,0,0,0,0,0
20200528,710059,大田永豐99購01,2.27,2.27,2.11,2.12,-0.08,-3.64,52000,12,113470,0,0,0,0,0,0,46000,7000,39000,39000
20200528,710060,光頡永豐99購02,2.54,2.54,2.54,2.54,0.00,0.0,10000,1,25400,0,0,0,0,0,0,0,10000,-10000,-10000
20200528,710061,迅得永豐99購02,2.51,2.51,2.51,2.51,+0.03,1.21,20000,1,50200,0,0,0,0,0,0,20000,0,20000,20000
20200528,710062,原相永豐99購04,1.61,1.61,1.39,1.40,-0.16,-10.26,1528000,44,2338620,0,0,0,0,0,0,1384000,138000,1246000,1246000
20200528,710063,神盾永豐99購03,2.37,2.37,2.37,2.37,+0.02,0.85,11000,1,26070,0,0,0,0,0,0,11000,0,11000,11000
20200528,710064,聚積永豐99購02,1.68,1.68,1.68,1.68,-0.05,-2.89,17000,1,28560,0,0,0,0,0,0,17000,0,17000,17000
20200528,710065,璟德永豐99購02,2.05,2.05,1.92,1.95,-0.08,-3.94,80000,8,158300,0,0,0,0,0,0,30000,50000,-20000,-20000
20200528,710066,宏捷科群益99購03,3.21,3.24,3.15,3.17,-0.03,-0.94,199000,22,637580,0,0,0,0,0,0,193000,24000,169000,169000
20200528,710067,原相群益9C購03,4.49,4.51,4.08,4.08,-0.39,-8.72,268000,35,1180880,0,0,0,0,0,0,239000,6000,233000,233000
20200528,710068,威剛康和99購01,2.85,2.85,2.58,2.58,-0.20,-7.19,22000,5,61640,0,0,0,0,0,0,14000,10000,4000,4000
20200528,710069,大江凱基99購02,3.54,3.54,3.54,3.54,-0.18,-4.84,1000,1,3540,0,0,0,0,0,0,1000,1000,0,0
20200528,710070,中美晶凱基99購08,,,,,,0.00,0,0,0,0,0,0,0,0,0,0,0,0,0
20200528,710071,原相凱基99購03,1.80,1.80,1.65,1.65,-0.12,-6.78,63000,13,109570,0,0,0,0,0,0,43000,20000,23000,23000
20200528,710072,環球晶凱基99購11,1.30,1.30,1.29,1.29,+0.03,2.38,23000,3,29800,0,0,0,0,0,0,3000,20000,-17000,-17000
20200528,710073,穩懋兆豐9A購02,,,,,,0.00,0,0,0,0,0,0,0,0,0,0,0,0,0
20200528,710074,群聯元富99購01,3.19,3.19,2.99,2.99,-0.14,-4.47,194000,14,591570,10000,0,10000,0,0,0,124000,65000,59000,69000
20200528,710075,大江富邦9B購03,,,,,,0.00,0,0,0,0,0,0,0,0,0,0,0,0,0
20200528,710076,穩懋富邦9B購03,1.73,1.73,1.73,1.73,-0.05,-2.81,5000,1,8650,0,0,0,0,0,0,5000,0,5000,5000
20200528,710077,中美晶元大9A購01,1.54,1.54,1.52,1.52,+0.01,0.66,110000,2,169200,0,0,0,0,0,0,0,110000,-110000,-110000
20200528,710078,宇峻元大9A購01,1.87,2.01,1.87,2.01,+0.16,8.65,165000,7,316950,0,0,0,0,0,0,0,165000,-165000,-165000
20200528,710079,宣德元大9A購01,,,,,,0.00,0,0,0,0,0,0,0,0,0,0,0,0,0
20200528,710080,環球晶元大99購09,4.71,4.71,4.71,4.71,+0.17,3.74,1000,1,4710,0,0,0,0,0,0,1000,1000,0,0
20200528,710081,穩懋元大99購13,5.05,5.05,5.05,5.05,-0.05,-0.98,3000,2,15150,0,0,0,0,0,0,2000,3000,-1000,-1000
20200528,710082,穩懋元大99購14,,,,,,0.00,0,0,0,0,0,0,0,0,0,0,0,0,0
20200528,710083,宏捷科凱基99購02,1.57,1.57,1.56,1.56,-0.05,-3.11,20000,2,31300,0,0,0,0,0,0,20000,0,20000,20000
20200528,710084,泰博凱基99購02,,,,,,0.00,0,0,0,0,0,0,0,0,0,0,0,0,0
20200528,710085,群聯凱基99購05,2.35,2.36,2.31,2.31,-0.03,-1.28,55000,3,129500,0,0,0,0,0,0,50000,5000,45000,45000
20200528,710086,穩懋凱基99購07,,,,,,0.00,0,0,0,0,0,0,0,0,0,0,0,0,0
20200528,710087,大學光永豐99購03,,,,,,0.00,0,0,0,0,0,0,0,0,0,0,0,0,0
20200528,710088,威剛永豐99購03,2.22,2.22,2.22,2.22,+0.03,1.37,10000,1,22200,0,0,0,0,0,0,10000,0,10000,10000
20200528,710089,宣德永豐99購02,,,,,,0.00,0,0,0,0,0,0,0,0,0,0,0,0,0
20200528,710090,碩禾永豐99購02,,,,,,0.00,0,0,0,0,0,0,0,0,0,0,0,0,0
20200528,710091,優群元富99購01,6.35,6.50,6.00,6.00,0.00,0.0,65000,6,410150,0,0,0,0,0,0,65000,0,65000,65000
20200528,710092,網家元大99購03,3.83,3.83,3.83,3.83,-0.97,-20.21,1000,1,3830,0,0,0,0,0,0,0,1000,-1000,-1000
20200528,710093,聚積元大9C購01,,,,,,0.00,0,0,0,0,0,0,0,0,0,0,0,0,0
20200528,710094,雙美元大9C購01,1.84,1.84,1.84,1.84,+0.06,3.37,10000,1,18400,0,0,0,0,0,0,10000,10000,0,0
20200528,710095,穩懋元大99購15,4.66,4.66,4.60,4.60,-0.10,-2.13,9000,2,41460,0,0,0,0,0,0,9000,1000,8000,8000
20200528,710096,鈺太元大9A購01,,,,,,0.00,0,0,0,0,0,0,0,0,0,0,0,0,0
20200528,710097,大學光群益9A購01,,,,,,0.00,0,0,0,0,0,0,0,0,0,0,0,0,0
20200528,710098,尼克森永豐99購01,2.11,2.11,2.11,2.11,+0.11,5.5,10000,1,21100,0,0,0,0,0,0,0,10000,-10000,-10000
20200528,710099,亞泰永豐99購03,1.87,1.89,1.85,1.89,-0.02,-1.05,215000,11,402910,0,0,0,0,0,0,215000,0,215000,215000
20200528,710100,旺矽永豐99購01,,,,,,0.00,0,0,0,0,0,0,0,0,0,0,0,0,0
20200528,710101,昇達科永豐99購01,,,,,,0.00,0,0,0,0,0,0,0,0,0,0,0,0,0
20200528,710102,信昌電永豐99購02,2.09,2.09,2.08,2.08,-0.04,-1.89,85000,4,176930,0,0,0,0,0,0,85000,0,85000,85000
20200528,710103,威剛永豐99購04,3.16,3.16,2.98,2.98,-0.11,-3.56,40000,3,122200,0,0,0,0,0,0,18000,22000,-4000,-4000
20200528,710104,新鉅科永豐99購02,1.53,1.56,1.47,1.47,-0.06,-3.92,114000,6,175500,0,0,0,0,0,0,114000,0,114000,114000
20200528,710105,網龍永豐99購01,,,,,,0.00,0,0,0,0,0,0,0,0,0,0,0,0,0
20200528,710106,廣明永豐99購01,,,,,,0.00,0,0,0,0,0,0,0,0,0,0,0,0,0
20200528,710107,緯軟永豐99購02,1.99,2.02,1.87,1.88,+0.02,1.08,236000,8,461250,0,0,0,0,0,0,33000,236000,-203000,-203000
20200528,710108,環宇永豐99購01,1.30,1.30,1.27,1.27,-0.03,-2.31,20000,2,25700,0,0,0,0,0,0,0,20000,-20000,-20000
20200528,710109,晟德永豐99購01,3.47,3.47,3.26,3.26,-0.25,-7.12,29000,4,96690,0,0,0,0,0,0,29000,0,29000,29000
20200528,710110,信昌電富邦9C購01,,,,,,0.00,0,0,0,0,0,0,0,0,0,0,0,0,0
20200528,710111,三貝德凱基99購03,2.10,2.10,2.09,2.09,+0.31,17.42,14000,2,29360,0,0,0,0,0,0,0,14000,-14000,-14000
20200528,710112,大江凱基99購03,,,,,,0.00,0,0,0,0,0,0,0,0,0,0,0,0,0
20200528,710113,宣德凱基99購01,3.41,3.41,3.41,3.41,+0.09,2.71,2000,1,6820,0,0,0,0,0,0,0,2000,-2000,-2000
20200528,710114,原相凱基99購04,,,,,,0.00,0,0,0,0,0,0,0,0,0,0,0,0,0
20200528,710115,群聯凱基99購06,1.11,1.11,1.11,1.11,-0.01,-0.89,5000,1,5550,0,0,0,0,0,0,5000,0,5000,5000
20200528,710116,環球晶凱基99購12,,,,,,0.00,0,0,0,0,0,0,0,0,0,0,0,0,0
20200528,710117,聯亞凱基99購05,,,,,,0.00,0,0,0,0,0,0,0,0,0,0,0,0,0
20200528,710118,雙鴻凱基99購02,2.09,2.13,2.09,2.13,-0.05,-2.29,33000,4,69770,0,0,0,0,0,0,13000,33000,-20000,-20000
20200528,710119,穩懋凱基99購08,1.24,1.24,1.24,1.24,-0.02,-1.59,9000,1,11160,0,0,0,0,0,0,9000,0,9000,9000
20200528,710120,鈊象凱基99購02,1.25,1.43,1.25,1.39,+0.25,21.93,54000,9,73750,0,0,0,0,0,0,5000,50000,-45000,-45000
20200528,710121,三貝德永豐99購02,2.07,2.07,2.07,2.07,+0.21,11.29,2000,1,4140,0,0,0,0,0,0,0,2000,-2000,-2000
20200528,710122,大江永豐99購03,,,,,,0.00,0,0,0,0,0,0,0,0,0,0,0,0,0
20200528,710123,安勤永豐99購01,0.98,0.98,0.97,0.97,-0.03,-3.0,244000,7,237900,0,0,0,0,0,0,244000,0,244000,244000
20200528,710124,良維永豐99購01,,,,,,0.00,0,0,0,0,0,0,0,0,0,0,0,0,0
20200528,710125,金居永豐99購01,2.30,2.35,2.30,2.35,-0.03,-1.26,60000,6,138800,0,0,0,0,0,0,10000,50000,-40000,-40000
20200528,710126,南光永豐99購01,0.98,0.98,0.98,0.98,-0.05,-4.85,5000,1,4900,0,0,0,0,0,0,0,5000,-5000,-5000
20200528,710127,原相永豐99購05,1.77,1.77,1.70,1.71,-0.02,-1.16,670000,34,1159740,0,0,0,0,0,0,670000,0,670000,670000
20200528,710128,晶焱永豐99購02,,,,,,0.00,0,0,0,0,0,0,0,0,0,0,0,0,0
20200528,710129,群聯永豐99購03,1.38,1.39,1.38,1.39,+0.01,0.72,119000,4,165300,0,0,0,0,0,0,108000,11000,97000,97000
20200528,710130,精測永豐99購03,0.69,0.69,0.69,0.69,-0.04,-5.48,21000,1,14490,0,0,0,0,0,0,21000,0,21000,21000
20200528,710131,璟德永豐99購03,1.35,1.35,1.31,1.31,-0.06,-4.38,61000,5,81550,0,0,0,0,0,0,31000,30000,1000,1000
20200528,710132,鈊象永豐99購04,1.09,1.29,1.09,1.25,+0.27,27.55,369000,21,427780,0,0,0,0,0,0,49000,360000,-311000,-311000
20200528,710133,宏捷科國泰9B購02,2.15,2.22,2.15,2.22,+0.05,2.3,28000,2,60550,0,0,0,0,0,0,23000,5000,18000,18000
20200528,710134,環球晶國泰9A購03,2.00,2.06,1.97,1.97,+0.02,1.03,37000,18,74630,0,0,0,0,0,0,16000,24000,-8000,-8000
20200528,710135,穩懋國泰9A購02,1.89,1.89,1.82,1.86,-0.01,-0.53,100000,8,188430,0,0,0,0,0,0,90000,10000,80000,80000
20200528,710136,大江元大9A購01,,,,,,0.00,0,0,0,0,0,0,0,0,0,0,0,0,0
20200528,710137,原相元大9B購01,5.85,5.85,5.40,5.40,-0.25,-4.42,88000,11,503400,0,0,0,0,0,0,70000,34000,36000,36000
20200528,710138,群聯元大99購07,7.30,7.30,6.95,6.95,-0.25,-3.47,42000,10,296300,0,0,0,0,0,0,42000,42000,0,0
20200528,710139,環球晶元大99購10,3.46,3.63,3.41,3.41,+0.04,1.19,144000,12,502860,0,0,0,0,0,0,3000,143000,-140000,-140000
20200528,710140,環球晶元大99購11,3.64,3.72,3.59,3.72,+0.17,4.79,58000,6,211170,0,0,0,0,0,0,3000,58000,-55000,-55000
20200528,710141,聯亞元大99購03,3.48,3.50,3.44,3.44,+0.08,2.38,62000,4,215940,0,0,0,0,0,0,50000,62000,-12000,-12000
20200528,710142,穩懋元大99購16,4.95,4.95,4.80,4.86,-0.03,-0.61,40000,4,194160,0,0,0,0,0,0,10000,31000,-21000,-21000
20200528,710143,譜瑞元大99購01,,,,,,0.00,0,0,0,0,0,0,0,0,0,0,0,0,0
20200528,710144,鈊象元大9A購01,2.44,3.00,2.44,2.98,+0.62,26.27,476000,50,1321770,0,0,0,0,0,0,173000,322000,-149000,-149000
20200528,710145,原相台新99購02,2.16,2.16,1.99,1.99,-0.14,-6.57,85000,4,182150,0,0,0,0,0,0,80000,5000,75000,75000
20200528,710146,群聯台新99購01,,,,,,0.00,0,0,0,0,0,0,0,0,0,0,0,0,0
20200528,710147,精測元富99購03,1.56,1.56,1.42,1.42,-0.08,-5.33,130000,13,197080,0,0,0,0,0,0,100000,30000,70000,70000
20200528,710148,精測元富99購04,1.44,1.45,1.32,1.32,-0.11,-7.69,110000,9,157210,0,0,0,0,0,0,53000,57000,-4000,-4000
20200528,710149,鈊象元富99購02,3.90,4.01,3.90,4.01,+0.78,24.15,21000,3,82610,0,0,0,0,0,0,0,21000,-21000,-21000
20200528,710150,M31凱基9A購01,,,,,,0.00,0,0,0,0,0,0,0,0,0,0,0,0,0
20200528,710151,VHQ凱基99購01,1.55,1.55,1.55,1.55,+0.02,1.31,10000,1,15500,0,0,0,0,0,0,10000,0,10000,10000
20200528,710152,中美晶凱基9A購03,,,,,,0.00,0,0,0,0,0,0,0,0,0,0,0,0,0
20200528,710153,威剛凱基9A購03,2.11,2.11,2.00,2.00,-0.09,-4.31,25000,2,52200,0,0,0,0,0,0,20000,5000,15000,15000
20200528,710154,原相凱基9A購02,,,,,,0.00,0,0,0,0,0,0,0,0,0,0,0,0,0
20200528,710155,群聯凱基9A購02,,,,,,0.00,0,0,0,0,0,0,0,0,0,0,0,0,0
20200528,710156,精測凱基9A購01,0.87,0.87,0.86,0.86,-0.03,-3.37,64000,4,55080,0,0,0,0,0,0,0,64000,-64000,-64000
20200528,710157,優群凱基9A購03,2.35,2.35,2.20,2.31,+0.10,4.52,42000,8,97200,0,0,0,0,0,0,24000,18000,6000,6000
20200528,710158,環球晶凱基9A購01,1.01,1.01,1.01,1.01,+0.03,3.06,3000,1,3030,0,0,0,0,0,0,3000,0,3000,3000
20200528,710159,雙美凱基9A購01,,,,,,0.00,0,0,0,0,0,0,0,0,0,0,0,0,0
20200528,710160,穩懋凱基9A購01,1.18,1.18,1.18,1.18,0.00,0.0,20000,3,23600,0,0,0,0,0,0,20000,0,20000,20000
20200528,710161,鈊象凱基9A購02,1.02,1.06,1.02,1.05,+0.22,26.51,125000,7,131260,0,0,0,0,0,0,112000,53000,59000,59000
20200528,710162,鈊象凱基9B購01,0.65,0.74,0.65,0.74,+0.14,23.33,4424000,165,3163550,0,0,0,0,0,0,3186000,944000,2242000,2242000
20200528,710163,鈺太國泰9B購01,,,,,,0.00,0,0,0,0,0,0,0,0,0,0,0,0,0
20200528,710164,大江元大9A購02,8.80,8.80,8.60,8.60,-0.15,-1.71,14000,2,121200,0,0,0,0,0,0,4000,10000,-6000,-6000
20200528,710165,大學光元大9C購01,,,,,,0.00,0,0,0,0,0,0,0,0,0,0,0,0,0
20200528,710166,中美晶元大9A購02,3.26,3.26,3.11,3.11,-0.13,-4.01,27000,3,87720,0,0,0,0,0,0,27000,25000,2000,2000
20200528,710167,宏捷科元大9B購01,1.34,1.35,1.33,1.34,-0.04,-2.9,100000,10,134200,0,0,0,0,0,0,100000,0,100000,100000
20200528,710168,原相元大9A購04,5.10,5.10,4.67,4.78,-0.06,-1.24,101000,19,497450,0,0,0,0,0,0,86000,53000,33000,33000
20200528,710169,晶焱元大99購02,2.85,2.85,2.85,2.85,+0.01,0.35,132000,3,376200,0,0,0,0,0,0,90000,42000,48000,48000
20200528,710170,聯亞元大99購04,2.80,2.81,2.74,2.78,-0.02,-0.71,112000,8,312690,0,0,0,0,0,0,51000,93000,-42000,-42000
20200528,710171,穩懋元大99購17,2.88,2.88,2.78,2.83,-0.03,-1.05,63000,6,177940,0,0,0,0,0,0,59000,5000,54000,54000
20200528,710172,穩懋元大99購18,2.44,2.44,2.35,2.35,-0.09,-3.69,78000,7,186730,0,0,0,0,0,0,78000,1000,77000,77000
20200528,710173,原相台新99購03,3.36,3.36,3.30,3.30,+0.10,3.13,44000,3,146640,0,0,0,0,0,0,44000,0,44000,44000
20200528,710174,群聯台新99購02,,,,,,0.00,0,0,0,0,0,0,0,0,0,0,0,0,0
20200528,710175,伍豐永豐99購01,1.70,1.70,1.33,1.41,-0.29,-17.06,257000,27,379970,0,0,0,0,0,0,146000,98000,48000,48000
20200528,710176,兆利永豐99購02,0.94,0.97,0.94,0.97,-0.01,-1.02,110000,3,104300,0,0,0,0,0,0,110000,0,110000,110000
20200528,710177,同亨永豐99購01,1.19,1.20,1.19,1.20,+0.01,0.84,110000,5,131270,0,0,0,0,0,0,110000,0,110000,110000
20200528,710178,合晶永豐99購02,1.79,1.82,1.77,1.77,+0.03,1.72,198000,6,359040,0,0,0,0,0,0,164000,34000,130000,130000
20200528,710179,宜鼎永豐99購01,1.63,1.65,1.63,1.65,+0.06,3.77,94000,5,154530,0,0,0,0,0,0,10000,84000,-74000,-74000
20200528,710180,信驊永豐99購04,1.25,1.32,1.20,1.20,+0.05,4.35,509000,31,639400,0,0,0,0,0,0,145000,359000,-214000,-214000
20200528,710181,聯亞永豐99購02,,,,,,0.00,0,0,0,0,0,0,0,0,0,0,0,0,0
20200528,710182,M31凱基99購03,2.32,2.32,2.32,2.32,-0.09,-3.73,10000,1,23200,0,0,0,0,0,0,10000,0,10000,10000
20200528,710183,中美晶凱基99購09,1.24,1.24,1.21,1.21,-0.04,-3.2,97000,2,120250,0,0,0,0,0,0,96000,1000,95000,95000
20200528,710184,雍智凱基99購02,3.24,3.24,3.24,3.24,-0.42,-11.48,1000,1,3240,0,0,0,0,0,0,1000,0,1000,1000
20200528,710185,精測凱基99購04,0.66,0.66,0.66,0.66,-0.04,-5.71,6000,1,3960,0,0,0,0,0,0,6000,0,6000,6000
20200528,710186,環球晶凱基99購13,0.77,0.77,0.77,0.77,+0.01,1.32,30000,2,23100,0,0,0,0,0,0,0,30000,-30000,-30000
20200528,710187,聯亞凱基99購06,0.97,0.97,0.97,0.97,-0.02,-2.02,30000,1,29100,0,0,0,0,0,0,30000,0,30000,30000
20200528,710188,穩懋凱基99購09,0.89,0.90,0.89,0.90,+0.01,1.12,100000,2,89500,0,0,0,0,0,0,0,100000,-100000,-100000
20200528,710189,譜瑞凱基99購03,,,,,,0.00,0,0,0,0,0,0,0,0,0,0,0,0,0
20200528,710190,鈊象凱基99購03,0.75,0.90,0.75,0.90,+0.20,28.57,446000,45,380010,0,0,0,0,0,0,180000,259000,-79000,-79000
20200528,710191,中美晶國票99購02,4.22,4.22,4.22,4.22,-0.10,-2.31,10000,1,42200,0,0,0,0,0,0,0,10000,-10000,-10000
20200528,710192,穩懋國票99購04,2.59,2.59,2.59,2.59,-0.05,-1.89,5000,1,12950,0,0,0,0,0,0,0,5000,-5000,-5000
20200528,710193,三貝德康和99購01,2.16,2.16,1.95,2.01,+0.32,18.93,52000,10,106180,0,0,0,0,0,0,0,52000,-52000,-52000
20200528,710194,優群康和99購01,1.56,1.56,1.41,1.52,+0.09,6.29,184000,7,275470,0,0,0,0,0,0,184000,0,184000,184000
20200528,710195,原相元富99購01,3.98,3.98,3.77,3.85,0.00,0.0,187000,14,721090,0,0,0,0,0,0,187000,0,187000,187000
20200528,710196,穩懋元富99購02,2.40,2.40,2.32,2.32,-0.16,-6.45,104000,3,245760,0,0,0,0,0,0,6000,98000,-92000,-92000
20200528,710197,由田永豐99購01,0.84,0.87,0.84,0.87,+0.10,12.99,20000,2,17100,0,0,0,0,0,0,0,20000,-20000,-20000
20200528,710198,長科*永豐99購01,1.62,1.62,1.60,1.60,-0.16,-9.09,32000,2,51300,0,0,0,0,0,0,27000,0,27000,27000
20200528,710199,皇田永豐99購01,1.08,1.16,1.08,1.11,0.00,0.0,230000,10,252530,0,0,0,0,0,0,220000,10000,210000,210000
20200528,710200,美琪瑪永豐99購01,,,,,,0.00,0,0,0,0,0,0,0,0,0,0,0,0,0
20200528,710201,新揚科永豐99購01,1.39,1.39,1.37,1.38,-0.01,-0.72,379000,19,523490,0,0,0,0,0,0,379000,0,379000,379000
20200528,710202,雍智永豐99購02,,,,,,0.00,0,0,0,0,0,0,0,0,0,0,0,0,0
20200528,710203,精華永豐99購02,1.11,1.11,1.09,1.09,+0.01,0.93,28000,2,31060,0,0,0,0,0,0,27000,1000,26000,26000
20200528,710204,網家永豐99購01,,,,,,0.00,0,0,0,0,0,0,0,0,0,0,0,0,0
20200528,710205,網龍永豐99購02,,,,,,0.00,0,0,0,0,0,0,0,0,0,0,0,0,0
20200528,710206,鈊象永豐99購05,0.87,0.87,0.87,0.87,+0.11,14.47,144000,1,125280,0,0,0,0,0,0,0,144000,-144000,-144000
20200528,710207,中美晶國泰9B購01,2.10,2.11,2.03,2.08,+0.01,0.48,1450000,39,3021490,0,0,0,0,0,0,847000,615000,232000,232000
20200528,710208,群聯國泰9B購01,2.07,2.07,1.96,1.96,-0.06,-2.97,271000,11,541930,0,0,0,0,0,0,161000,112000,49000,49000
20200528,710209,群聯富邦9A購01,1.65,1.65,1.63,1.63,-0.01,-0.61,30000,3,49300,0,0,0,0,0,0,30000,0,30000,30000
20200528,710210,環球晶富邦9B購03,,,,,,0.00,0,0,0,0,0,0,0,0,0,0,0,0,0
20200528,710211,穩懋富邦9B購04,0.88,0.89,0.86,0.88,0.00,0.0,390000,14,342890,0,0,0,0,0,0,281000,109000,172000,172000
20200528,710212,群聯元大99購08,4.51,4.53,4.24,4.24,-0.18,-4.07,39000,5,173900,0,0,0,0,0,0,39000,13000,26000,26000
20200528,710213,鈊象元大99購06,2.42,3.08,2.42,2.97,+0.62,26.38,200000,25,536910,0,0,0,0,0,0,102000,172000,-70000,-70000
20200528,710214,大江凱基99購04,2.20,2.20,2.20,2.20,+0.03,1.38,10000,1,22000,0,0,0,0,0,0,0,10000,-10000,-10000
20200528,710215,旺矽凱基99購01,,,,,,0.00,0,0,0,0,0,0,0,0,0,0,0,0,0
20200528,710216,泰博凱基99購03,,,,,,0.00,0,0,0,0,0,0,0,0,0,0,0,0,0
20200528,710217,晶焱凱基99購02,0.87,0.87,0.85,0.85,-0.02,-2.3,80000,3,69400,0,0,0,0,0,0,80000,0,80000,80000
20200528,710218,群聯凱基99購07,1.11,1.11,1.09,1.09,-0.03,-2.68,15000,3,16550,0,0,0,0,0,0,5000,10000,-5000,-5000
20200528,710219,精測凱基99購05,,,,,,0.00,0,0,0,0,0,0,0,0,0,0,0,0,0
20200528,710220,鈊象凱基99購04,0.93,1.07,0.93,1.07,+0.23,27.38,651000,20,672770,0,0,0,0,0,0,638000,51000,587000,587000
20200528,710221,原相國票99購03,3.37,3.37,3.03,3.03,-0.23,-7.06,135000,10,437030,0,0,0,0,0,0,131000,4000,127000,127000
20200528,710222,力麒康和99購01,,,,,,0.00,0,0,0,0,0,0,0,0,0,0,0,0,0
20200528,710223,美琪瑪康和99購01,,,,,,0.00,0,0,0,0,0,0,0,0,0,0,0,0,0
20200528,710224,新鉅科康和99購01,2.41,2.42,2.29,2.29,-0.05,-2.14,55000,9,131900,0,0,0,0,0,0,50000,5000,45000,45000
20200528,710225,聯亞康和99購01,1.39,1.44,1.39,1.44,+0.03,2.13,163000,8,229620,0,0,0,0,0,0,0,163000,-163000,-163000
20200528,710226,良維永豐99購02,1.45,1.45,1.38,1.38,-0.06,-4.17,76000,3,108730,0,0,0,0,0,0,55000,21000,34000,34000
20200528,710227,保瑞永豐99購01,,,,,,0.00,0,0,0,0,0,0,0,0,0,0,0,0,0
20200528,710228,原相永豐99購06,1.15,1.15,1.06,1.06,-0.11,-9.4,187000,13,211390,0,0,0,0,0,0,187000,0,187000,187000
20200528,710229,神盾永豐99購04,1.42,1.42,1.42,1.42,-0.01,-0.7,46000,1,65320,0,0,0,0,0,0,46000,0,46000,46000
20200528,710230,神盾永豐99購05,1.49,1.49,1.39,1.39,-0.11,-7.33,159000,4,229880,0,0,0,0,0,0,83000,76000,7000,7000
20200528,710231,優群永豐99購03,2.33,2.40,2.20,2.34,+0.31,15.27,146000,11,335020,0,0,0,0,0,0,40000,106000,-66000,-66000
20200528,710232,鈺太永豐99購02,1.40,1.43,1.25,1.25,-0.17,-11.97,145000,9,196990,0,0,0,0,0,0,87000,58000,29000,29000
20200528,710233,精測富邦9A購02,,,,,,0.00,0,0,0,0,0,0,0,0,0,0,0,0,0
20200528,710234,台燿凱基99購01,1.55,1.61,1.54,1.58,-0.03,-1.86,43000,17,67180,0,0,0,0,0,0,37000,6000,31000,31000
20200528,710235,保瑞凱基99購01,1.10,1.10,1.10,1.10,-0.06,-5.17,30000,1,33000,0,0,0,0,0,0,30000,0,30000,30000
20200528,710236,原相凱基99購05,1.35,1.35,1.20,1.20,-0.10,-7.69,301000,28,386210,0,0,0,0,0,0,171000,130000,41000,41000
20200528,710237,神盾凱基99購03,,,,,,0.00,0,0,0,0,0,0,0,0,0,0,0,0,0
20200528,710238,精測凱基9A購02,,,,,,0.00,0,0,0,0,0,0,0,0,0,0,0,0,0
20200528,710239,鈊象凱基99購05,1.16,1.28,1.16,1.26,+0.23,22.33,202000,12,251040,0,0,0,0,0,0,179000,63000,116000,116000
20200528,710240,原相元大99購05,3.23,3.23,2.87,2.87,-0.20,-6.51,238000,29,731510,0,0,0,0,0,0,228000,109000,119000,119000
20200528,710241,神盾元大9A購04,5.25,5.25,5.10,5.10,-0.05,-0.97,35000,5,179700,0,0,0,0,0,0,35000,35000,0,0
20200528,710242,環球晶元大99購13,1.76,1.80,1.76,1.80,+0.09,5.26,62000,3,111020,0,0,0,0,0,0,50000,12000,38000,38000
20200528,710243,穩懋元大99購20,1.14,1.14,1.13,1.13,-0.03,-2.59,98000,3,111620,0,0,0,0,0,0,68000,30000,38000,38000
20200528,710244,穩懋元大99購21,1.23,1.23,1.22,1.22,0.00,0.0,11000,2,13430,0,0,0,0,0,0,11000,0,11000,11000
20200528,710245,中美晶群益99購04,1.74,1.74,1.74,1.74,+0.05,2.96,70000,1,121800,0,0,0,0,0,0,70000,0,70000,70000
20200528,710246,鈊象群益99購06,1.49,1.76,1.49,1.76,+0.42,31.34,231000,11,371600,0,0,0,0,0,0,146000,130000,16000,16000
20200528,710247,信驊元富99購01,2.14,2.27,2.04,2.06,+0.09,4.57,390000,25,840160,0,0,0,0,0,0,91000,299000,-208000,-208000
20200528,710248,原相元富99購02,2.69,2.72,2.45,2.45,-0.28,-10.26,989000,65,2556640,0,0,0,0,0,0,979000,5000,974000,974000
20200528,710249,群聯元富99購02,,,,,,0.00,0,0,0,0,0,0,0,0,0,0,0,0,0
20200528,710250,大江國票99購02,12.30,12.30,12.30,12.30,+0.10,0.82,5000,1,61500,0,0,0,0,0,0,0,5000,-5000,-5000
20200528,710251,泰博國票9A購02,,,,,,0.00,0,0,0,0,0,0,0,0,0,0,0,0,0
20200528,710252,群聯國票99購02,1.96,1.96,1.83,1.83,-0.12,-6.15,86000,6,162560,0,0,0,0,0,0,18000,68000,-50000,-50000
20200528,710253,網龍康和99購01,,,,,,0.00,0,0,0,0,0,0,0,0,0,0,0,0,0
20200528,710254,鈊象國泰9B購01,1.83,2.23,1.83,2.23,+0.47,26.7,1859000,96,3852830,0,0,0,0,0,0,877000,1013000,-136000,-136000
20200528,710255,中美晶富邦9B購03,0.72,0.72,0.72,0.72,0.00,0.0,10000,1,7200,0,0,0,0,0,0,0,10000,-10000,-10000
20200528,710256,金居群益9B購02,,,,,,0.00,0,0,0,0,0,0,0,0,0,0,0,0,0
20200528,710257,群聯群益99購02,2.37,2.37,2.32,2.32,0.00,0.0,21000,3,49220,0,0,0,0,0,0,11000,11000,0,0
20200528,710258,鈊象國票9B購01,1.82,2.16,1.82,2.16,+0.49,29.34,209000,12,424050,0,0,0,0,0,0,123000,129000,-6000,-6000
20200528,710259,宇峻元大9B購01,2.50,2.68,2.50,2.56,+0.09,3.64,262000,13,671380,0,0,0,0,0,0,49000,211000,-162000,-162000
20200528,710260,威剛元大9B購01,3.82,3.82,3.56,3.56,-0.13,-3.52,64000,7,238160,0,0,0,0,0,0,18000,54000,-36000,-36000
20200528,710261,神盾元大9B購01,2.35,2.35,2.35,2.35,-0.16,-6.37,48000,1,112800,0,0,0,0,0,0,0,48000,-48000,-48000
20200528,710262,精測元大99購05,1.07,1.07,1.07,1.07,+0.01,0.94,13000,1,13910,0,0,0,0,0,0,13000,13000,0,0
20200528,710263,環球晶元大99購14,2.66,2.66,2.66,2.66,+0.19,7.69,68000,1,180880,0,0,0,0,0,0,68000,0,68000,68000
20200528,710264,環球晶元大99購15,1.74,1.79,1.74,1.76,+0.07,4.14,110000,6,194800,0,0,0,0,0,0,40000,60000,-20000,-20000
20200528,710265,穩懋元大99購22,1.74,1.74,1.68,1.68,-0.10,-5.62,69000,3,116460,0,0,0,0,0,0,1000,68000,-67000,-67000
20200528,710266,譜瑞元大99購02,4.19,4.19,4.19,4.19,-0.09,-2.1,10000,1,41900,0,0,0,0,0,0,10000,0,10000,10000
20200528,710267,中美晶凱基9B購01,,,,,,0.00,0,0,0,0,0,0,0,0,0,0,0,0,0
20200528,710268,世界凱基99購01,1.94,1.94,1.94,1.94,+0.05,2.65,10000,1,19400,0,0,0,0,0,0,10000,0,10000,10000
20200528,710269,建榮凱基99購01,,,,,,0.00,0,0,0,0,0,0,0,0,0,0,0,0,0
20200528,710270,碩禾凱基99購01,,,,,,0.00,0,0,0,0,0,0,0,0,0,0,0,0,0
20200528,710271,精測凱基99購06,0.48,0.48,0.45,0.45,-0.03,-6.25,230000,7,106200,0,0,0,0,0,0,190000,40000,150000,150000
20200528,710272,環球晶凱基9B購01,1.06,1.06,1.06,1.06,+0.02,1.92,2000,1,2120,0,0,0,0,0,0,2000,0,2000,2000
20200528,710273,穩懋凱基99購10,0.61,0.61,0.61,0.61,-0.01,-1.61,10000,1,6100,0,0,0,0,0,0,0,10000,-10000,-10000
20200528,710274,力致永豐99購04,2.14,2.17,2.00,2.00,-0.10,-4.76,46000,13,96220,0,0,0,0,0,0,35000,11000,24000,24000
20200528,710275,三貝德永豐99購03,1.04,1.16,1.04,1.07,+0.14,15.05,142000,19,154610,0,0,0,0,0,0,37000,105000,-68000,-68000
20200528,710276,宏捷科永豐99購06,1.04,1.04,1.02,1.02,-0.08,-7.27,198000,4,202440,0,0,0,0,0,0,198000,0,198000,198000
20200528,710277,杰力永豐99購01,,,,,,0.00,0,0,0,0,0,0,0,0,0,0,0,0,0
20200528,710278,直得永豐99購01,2.34,2.40,1.88,1.88,-0.41,-17.9,80000,19,176880,0,0,0,0,0,0,53000,22000,31000,31000
20200528,710279,威剛永豐99購05,1.44,1.44,1.38,1.38,+0.01,0.73,26000,5,36980,0,0,0,0,0,0,16000,10000,6000,6000
20200528,710280,新鉅科永豐99購03,1.09,1.09,1.06,1.07,+0.01,0.94,373000,10,402560,0,0,0,0,0,0,373000,0,373000,373000
20200528,710281,碩禾永豐99購03,,,,,,0.00,0,0,0,0,0,0,0,0,0,0,0,0,0
20200528,710282,精測永豐99購04,0.37,0.37,0.37,0.37,-0.01,-2.63,8000,1,2960,0,0,0,0,0,0,0,8000,-8000,-8000
20200528,710283,原相群益9A購01,1.03,1.03,0.93,0.93,-0.08,-7.92,1288000,31,1297100,0,0,0,0,0,0,1003000,265000,738000,738000
20200528,710284,群聯群益9A購01,2.99,2.99,2.85,2.85,-0.13,-4.36,17000,5,50560,0,0,0,0,0,0,17000,4000,13000,13000
20200528,710285,大江富邦9C購01,,,,,,0.00,0,0,0,0,0,0,0,0,0,0,0,0,0
20200528,710286,神盾元富9A購01,1.78,1.78,1.64,1.65,-0.08,-4.62,70000,7,117600,0,0,0,0,0,0,10000,60000,-50000,-50000
20200528,710287,群聯元富9A購01,,,,,,0.00,0,0,0,0,0,0,0,0,0,0,0,0,0
20200528,710288,環球晶元富9A購01,,,,,,0.00,0,0,0,0,0,0,0,0,0,0,0,0,0
20200528,710289,環球晶元富9A購02,2.09,2.15,2.09,2.15,+0.05,2.38,93000,4,197250,0,0,0,0,0,0,7000,86000,-79000,-79000
20200528,710290,穩懋元富9A購01,1.24,1.24,1.19,1.22,-0.01,-0.81,72000,5,88450,0,0,0,0,0,0,71000,1000,70000,70000
20200528,710291,鈺太元富9A購01,2.48,2.54,2.48,2.50,-0.06,-2.34,82000,9,206120,0,0,0,0,0,0,82000,0,82000,82000
20200528,710292,弘塑元大9B購01,2.54,2.54,2.54,2.54,-0.07,-2.68,10000,1,25400,0,0,0,0,0,0,0,10000,-10000,-10000
20200528,710293,金可元大9A購01,2.48,2.48,2.48,2.48,+0.16,6.9,40000,2,99200,0,0,0,0,0,0,0,40000,-40000,-40000
20200528,710294,博智元大9A購01,2.05,2.05,1.95,1.95,-0.07,-3.47,143000,9,289170,0,0,0,0,0,0,68000,75000,-7000,-7000
20200528,710295,群聯元大9A購02,2.75,2.75,2.59,2.59,-0.12,-4.43,50000,6,134350,0,0,0,0,0,0,18000,32000,-14000,-14000
20200528,710296,雍智元大9B購01,,,,,,0.00,0,0,0,0,0,0,0,0,0,0,0,0,0
20200528,710297,環球晶元大9A購02,2.27,2.35,2.26,2.26,+0.04,1.8,68000,7,156230,0,0,0,0,0,0,18000,52000,-34000,-34000
20200528,710298,穩懋元大9A購02,1.71,1.72,1.71,1.71,-0.01,-0.58,9000,4,15450,0,0,0,0,0,0,9000,1000,8000,8000
20200528,710299,大中永豐9A購01,1.53,1.53,1.53,1.53,-0.03,-1.92,61000,1,93330,0,0,0,0,0,0,61000,0,61000,61000
20200528,710300,尼克森永豐9A購01,1.80,1.80,1.70,1.70,-0.03,-1.73,27000,4,48150,0,0,0,0,0,0,0,27000,-27000,-27000
20200528,710301,弘塑永豐9A購01,1.00,1.00,0.94,0.94,-0.09,-8.74,15000,3,14700,0,0,0,0,0,0,15000,0,15000,15000
20200528,710302,均豪永豐9A購01,,,,,,0.00,0,0,0,0,0,0,0,0,0,0,0,0,0
20200528,710303,迅得永豐9A購01,2.00,2.03,1.82,1.82,-0.18,-9.0,286000,13,563590,0,0,0,0,0,0,226000,60000,166000,166000
20200528,710304,波若威永豐9A購01,2.42,2.42,2.22,2.22,-0.19,-7.88,325000,35,769810,0,0,0,0,0,0,305000,18000,287000,287000
20200528,710305,前鼎永豐9A購01,,,,,,0.00,0,0,0,0,0,0,0,0,0,0,0,0,0
20200528,710306,建榮永豐9B購01,,,,,,0.00,0,0,0,0,0,0,0,0,0,0,0,0,0
20200528,710307,泰博永豐9A購01,2.71,3.06,2.71,3.06,+0.65,26.97,100000,9,283790,0,0,0,0,0,0,40000,60000,-20000,-20000
20200528,710308,神盾永豐9A購01,1.75,1.75,1.75,1.75,-0.01,-0.57,46000,2,80500,0,0,0,0,0,0,46000,0,46000,46000
20200528,710309,高技永豐9A購01,2.63,2.65,2.57,2.60,+0.05,1.96,78000,15,202290,0,0,0,0,0,0,64000,14000,50000,50000
20200528,710310,博智永豐9A購02,0.63,0.63,0.63,0.63,-0.01,-1.56,20000,1,12600,0,0,0,0,0,0,0,20000,-20000,-20000
20200528,710311,群聯永豐9A購01,,,,,,0.00,0,0,0,0,0,0,0,0,0,0,0,0,0
20200528,710312,鈊象永豐9A購02,0.69,0.69,0.67,0.69,+0.16,30.19,172000,4,116680,0,0,0,0,0,0,170000,2000,168000,168000
20200528,710313,大中凱基9A購01,,,,,,0.00,0,0,0,0,0,0,0,0,0,0,0,0,0
20200528,710314,弘塑凱基9A購01,1.43,1.43,1.41,1.41,-0.02,-1.4,108000,3,153000,0,0,0,0,0,0,38000,70000,-32000,-32000
20200528,710315,良維凱基9A購01,1.39,1.39,1.39,1.39,-0.08,-5.44,2000,1,2780,0,0,0,0,0,0,2000,0,2000,2000
20200528,710316,胡連凱基9A購01,,,,,,0.00,0,0,0,0,0,0,0,0,0,0,0,0,0
20200528,710317,群聯凱基9B購01,1.15,1.15,1.11,1.11,-0.04,-3.48,173000,4,196840,0,0,0,0,0,0,129000,44000,85000,85000
20200528,710318,環球晶凱基9A購02,,,,,,0.00,0,0,0,0,0,0,0,0,0,0,0,0,0
20200528,710319,穩懋凱基9A購02,0.82,0.82,0.81,0.82,0.00,0.0,220000,4,178900,0,0,0,0,0,0,200000,20000,180000,180000
20200528,710320,鈊象國票9A購02,2.98,3.64,2.98,3.55,+0.88,32.96,108000,19,371300,0,0,0,0,0,0,53000,108000,-55000,-55000
20200528,710321,弘塑康和9A購01,1.97,1.97,1.97,1.97,-0.17,-7.94,1000,1,1970,0,0,0,0,0,0,1000,0,1000,1000
20200528,710322,昇達科康和9A購01,2.48,2.48,2.48,2.48,+0.10,4.2,5000,1,12400,0,0,0,0,0,0,0,5000,-5000,-5000
20200528,710323,緯軟康和9A購01,1.84,1.87,1.69,1.69,-0.09,-5.06,306000,7,534330,0,0,0,0,0,0,245000,216000,29000,29000
20200528,710324,環球晶台新9A購01,,,,,,0.00,0,0,0,0,0,0,0,0,0,0,0,0,0
20200528,710325,三貝德國泰9C購01,1.19,1.40,1.19,1.33,+0.17,14.66,267000,10,332430,0,0,0,0,0,0,100000,152000,-52000,-52000
20200528,710326,美琪瑪國泰9B購01,1.79,1.79,1.79,1.79,-0.05,-2.72,16000,2,28640,0,0,0,0,0,0,0,16000,-16000,-16000
20200528,710327,譜瑞國泰9C購01,3.13,3.13,3.13,3.13,-0.33,-9.54,2000,1,6260,0,0,0,0,0,0,2000,0,2000,2000
20200528,710328,精測台新9A購01,0.48,0.48,0.48,0.48,-0.01,-2.04,10000,1,4800,0,0,0,0,0,0,0,10000,-10000,-10000
20200528,710329,M31元大9A購02,4.51,4.53,3.98,4.06,-0.66,-13.98,414000,24,1748020,0,0,0,0,0,0,239000,175000,64000,64000
20200528,710330,元太元大9A購01,,,,,,0.00,0,0,0,0,0,0,0,0,0,0,0,0,0
20200528,710331,世界元大9A購01,3.87,4.01,3.83,3.83,-0.06,-1.54,85000,7,333520,0,0,0,0,0,0,13000,72000,-59000,-59000
20200528,710332,良維元大9A購01,3.56,3.56,3.51,3.51,+0.04,1.15,16000,2,56560,0,0,0,0,0,0,8000,8000,0,0
20200528,710333,信驊元大9A購01,5.15,5.35,5.00,5.00,+0.15,3.09,93000,11,483050,0,0,0,0,0,0,43000,93000,-50000,-50000
20200528,710334,威剛元大9A購04,3.62,3.62,3.62,3.62,+0.06,1.69,30000,1,108600,0,0,0,0,0,0,0,30000,-30000,-30000
20200528,710335,精測元大9A購01,1.22,1.22,1.22,1.22,+0.01,0.83,15000,1,18300,0,0,0,0,0,0,15000,15000,0,0
20200528,710336,頎邦元大9A購01,2.98,2.98,2.82,2.83,-0.07,-2.41,286000,15,820820,0,0,0,0,0,0,161000,125000,36000,36000
20200528,710337,杰力群益9C購01,3.05,3.09,2.96,3.00,-0.09,-2.91,27000,4,81150,0,0,0,0,0,0,10000,17000,-7000,-7000
20200528,710338,保瑞群益9B購01,1.13,1.13,1.10,1.10,-0.05,-4.35,30000,2,33600,0,0,0,0,0,0,0,30000,-30000,-30000
20200528,710339,網龍群益9C購01,,,,,,0.00,0,0,0,0,0,0,0,0,0,0,0,0,0
20200528,710340,兆利凱基9C購01,0.97,0.99,0.97,0.97,-0.01,-1.02,390000,12,381700,0,0,0,0,0,0,100000,290000,-190000,-190000
20200528,710341,威剛凱基9A購04,1.64,1.64,1.64,1.64,-0.01,-0.61,20000,1,32800,0,0,0,0,0,0,20000,0,20000,20000
20200528,710342,泰博凱基9A購02,3.20,3.20,3.20,3.20,+0.17,5.61,9000,1,28800,0,0,0,0,0,0,9000,0,9000,9000
20200528,710343,網龍凱基9C購01,4.35,4.35,4.35,4.35,+0.24,5.84,1000,1,4350,0,0,0,0,0,0,1000,1000,0,0
20200528,710344,聚積凱基9C購01,1.24,1.24,1.24,1.24,+0.02,1.64,10000,1,12400,0,0,0,0,0,0,0,10000,-10000,-10000
20200528,710345,穩懋麥證9A購01,1.18,1.18,1.18,1.18,-0.01,-0.84,10000,1,11800,0,10000,-10000,0,0,0,0,10000,-10000,-10000
20200528,710346,弘塑元富9A購01,2.58,2.58,2.38,2.38,-0.25,-9.51,63000,5,156440,0,0,0,0,0,0,63000,0,63000,63000
20200528,710347,弘塑元富9A購02,1.92,1.92,1.89,1.90,-0.06,-3.06,51000,6,97000,0,0,0,0,0,0,51000,0,51000,51000
20200528,710348,神盾元富9B購02,2.34,2.34,2.16,2.16,-0.15,-6.49,373000,16,845890,0,0,0,0,0,0,205000,168000,37000,37000
20200528,710349,精華元富9A購01,3.89,3.91,3.88,3.91,+0.02,0.51,65000,4,252940,0,0,0,0,0,0,58000,7000,51000,51000
20200528,710350,宏捷科國票9A購02,3.55,3.65,3.47,3.47,-0.29,-7.71,62000,6,220800,5000,0,5000,0,0,0,16000,46000,-30000,-25000
20200528,710351,原相國票9B購01,,,,,,0.00,0,0,0,0,0,0,0,0,0,0,0,0,0
20200528,710352,神盾國票9B購01,,,,,,0.00,0,0,0,0,0,0,0,0,0,0,0,0,0
20200528,710353,神盾國票9C購01,2.21,2.21,2.02,2.02,-0.18,-8.18,445000,11,971660,0,0,0,0,0,0,440000,5000,435000,435000
20200528,710354,博智康和9A購01,0.61,0.62,0.58,0.58,-0.04,-6.45,492000,3,296120,0,0,0,0,0,0,292000,200000,92000,92000
20200528,710355,新普康和9A購01,2.39,2.63,2.39,2.63,+0.22,9.13,194000,26,488540,0,0,0,0,0,0,152000,153000,-1000,-1000
20200528,710356,精測康和9A購01,,,,,,0.00,0,0,0,0,0,0,0,0,0,0,0,0,0
20200528,710357,應華康和9A購01,2.33,2.49,2.33,2.49,+0.11,4.62,51000,6,126630,0,0,0,0,0,0,1000,50000,-49000,-49000
20200528,710358,世禾永豐9A購01,2.01,2.01,1.64,1.74,-0.14,-7.45,629000,40,1169490,0,0,0,0,0,0,590000,29000,561000,561000
20200528,710359,光隆永豐9A購01,,,,,,0.00,0,0,0,0,0,0,0,0,0,0,0,0,0
20200528,710360,宇峻永豐9A購01,0.87,0.94,0.87,0.88,+0.04,4.76,303000,9,275860,0,0,0,0,0,0,0,303000,-303000,-303000
20200528,710361,佳邦永豐9A購01,1.83,1.83,1.83,1.83,-0.06,-3.17,40000,2,73200,0,0,0,0,0,0,40000,0,40000,40000
20200528,710362,振曜永豐9A購01,,,,,,0.00,0,0,0,0,0,0,0,0,0,0,0,0,0
20200528,710363,盛弘永豐9A購01,1.70,2.14,1.60,1.90,+0.20,11.76,258000,77,511640,0,0,0,0,0,0,0,0,0,0
20200528,710364,新潤永豐9A購01,,,,,,0.00,0,0,0,0,0,0,0,0,0,0,0,0,0
20200528,710365,是方國泰9B購01,2.80,2.80,2.54,2.79,+0.13,4.89,37000,7,96940,0,0,0,0,0,0,8000,26000,-18000,-18000
20200528,710366,原相國泰9B購01,1.59,1.63,1.40,1.40,-0.17,-10.83,681000,45,1036830,0,0,0,0,0,0,575000,105000,470000,470000
20200528,710367,建榮永豐9A購03,,,,,,0.00,0,0,0,0,0,0,0,0,0,0,0,0,0
20200528,710368,是方永豐9A購01,1.84,1.85,1.70,1.85,+0.06,3.35,290000,19,511320,0,0,0,0,0,0,200000,85000,115000,115000
20200528,710369,森鉅永豐9A購01,0.94,0.94,0.93,0.93,-0.03,-3.12,159000,5,148910,0,0,0,0,0,0,159000,0,159000,159000
20200528,710370,磐亞永豐9A購01,0.54,0.54,0.54,0.54,-0.01,-1.82,197000,2,106380,0,0,0,0,0,0,197000,0,197000,197000
20200528,710371,寶雅永豐9A購01,,,,,,0.00,0,0,0,0,0,0,0,0,0,0,0,0,0
20200528,710372,原相群益9A購02,2.82,2.85,2.53,2.53,-0.26,-9.32,763000,46,2059400,0,0,0,0,0,0,753000,10000,743000,743000
20200528,710373,精華元富9A購02,,,,,,0.00,0,0,0,0,0,0,0,0,0,0,0,0,0
20200528,710374,譜瑞元富9A購01,2.60,2.60,2.49,2.49,-0.12,-4.6,10000,2,25450,0,0,0,0,0,0,0,10000,-10000,-10000
20200528,710375,原相元大9B購02,3.03,3.05,2.84,2.89,-0.04,-1.37,307000,39,899800,0,0,0,0,0,0,294000,76000,218000,218000
20200528,710376,泰博元大9C購01,,,,,,0.00,0,0,0,0,0,0,0,0,0,0,0,0,0
20200528,710377,新鉅科元大9B購01,2.79,2.86,2.67,2.67,-0.12,-4.3,356000,28,999680,0,0,0,0,0,0,221000,113000,108000,108000
20200528,710378,群聯元大9A購03,2.60,2.60,2.57,2.59,+0.02,0.78,58000,6,150020,0,0,0,0,0,0,58000,0,58000,58000
20200528,710379,精測元大9A購02,1.10,1.10,1.00,1.00,-0.06,-5.66,154000,8,164080,0,0,0,0,0,0,129000,60000,69000,69000
20200528,710380,鈊象元大9A購02,1.46,1.76,1.46,1.76,+0.43,32.33,546000,21,906440,0,0,0,0,0,0,161000,401000,-240000,-240000
20200528,710381,鈊象元大9B購01,1.48,1.80,1.48,1.80,+0.41,29.5,430000,34,706840,0,0,0,0,0,0,116000,338000,-222000,-222000
20200528,710382,凡甲凱基9A購01,2.26,2.26,2.13,2.14,-0.08,-3.6,803000,24,1731480,0,0,0,0,0,0,233000,570000,-337000,-337000
20200528,710383,凡甲凱基9A購02,1.50,1.50,1.41,1.44,-0.09,-5.88,257000,18,370650,0,0,0,0,0,0,257000,0,257000,257000
20200528,710384,威剛凱基9B購02,2.02,2.02,2.02,2.02,-0.03,-1.46,10000,1,20200,0,0,0,0,0,0,10000,0,10000,10000
20200528,710385,博智凱基9A購02,0.83,0.84,0.79,0.79,-0.01,-1.25,202000,5,164800,0,0,0,0,0,0,168000,34000,134000,134000
20200528,710386,大江國票9A購03,7.95,7.95,7.95,7.95,+0.05,0.63,4000,1,31800,0,0,0,0,0,0,0,4000,-4000,-4000
20200528,710387,穩懋國票9A購02,1.53,1.53,1.51,1.51,-0.05,-3.21,147000,2,224710,0,0,0,0,0,0,137000,10000,127000,127000
20200528,710388,鈊象國票9B購02,2.29,2.67,2.29,2.67,+0.53,24.77,244000,19,618060,0,0,0,0,0,0,70000,221000,-151000,-151000
20200528,710389,原相台新9A購02,1.42,1.42,1.39,1.39,+0.03,2.21,80000,4,111650,0,0,0,0,0,0,80000,0,80000,80000
20200528,710390,M31群益9A購02,2.56,2.59,2.19,2.24,-0.36,-13.85,711000,51,1748620,0,0,0,0,0,0,518000,293000,225000,225000
20200528,710391,原相元大9B購03,2.16,2.16,1.95,1.95,-0.12,-5.8,314000,27,652170,0,0,0,0,0,0,309000,108000,201000,201000
20200528,710392,精測元大9A購03,,,,,,0.00,0,0,0,0,0,0,0,0,0,0,0,0,0
20200528,710393,雙鴻元大9C購01,3.56,3.63,3.48,3.48,-0.02,-0.57,142000,16,505190,0,0,0,0,0,0,53000,121000,-68000,-68000
20200528,710394,鈊象元大9C購01,1.25,1.50,1.25,1.46,+0.28,23.73,136000,6,179650,0,0,0,0,0,0,44000,133000,-89000,-89000
20200528,710395,神盾富邦01購01,0.91,0.91,0.84,0.84,-0.07,-7.69,137000,11,120120,0,0,0,0,0,0,86000,51000,35000,35000
20200528,710396,雙鴻富邦9B購01,0.84,0.86,0.83,0.84,+0.01,1.2,1525000,26,1293560,0,0,0,0,0,0,617000,1290000,-673000,-673000
20200528,710397,群聯中信9C購01,,,,,,0.00,0,0,0,0,0,0,0,0,0,0,0,0,0
20200528,710398,精測中信9A購02,,,,,,0.00,0,0,0,0,0,0,0,0,0,0,0,0,0
20200528,710399,環球晶中信9A購02,,,,,,0.00,0,0,0,0,0,0,0,0,0,0,0,0,0
20200528,710400,中美晶永豐9A購01,,,,,,0.00,0,0,0,0,0,0,0,0,0,0,0,0,0
20200528,710401,建榮永豐9A購04,,,,,,0.00,0,0,0,0,0,0,0,0,0,0,0,0,0
20200528,710402,神盾永豐9A購02,,,,,,0.00,0,0,0,0,0,0,0,0,0,0,0,0,0
20200528,710403,閎康永豐9A購01,1.73,1.78,1.72,1.72,-0.12,-6.52,127000,9,221710,0,0,0,0,0,0,87000,40000,47000,47000
20200528,710404,雙鴻永豐9A購02,1.29,1.34,1.29,1.29,+0.01,0.78,236000,9,308510,0,0,0,0,0,0,96000,140000,-44000,-44000
20200528,710405,大學光凱基9A購03,6.65,6.75,6.65,6.75,+0.10,1.5,10000,8,66950,0,0,0,0,0,0,10000,0,10000,10000
20200528,710406,中美晶凱基9A購04,,,,,,0.00,0,0,0,0,0,0,0,0,0,0,0,0,0
20200528,710407,泰博凱基9B購01,3.10,3.54,2.96,3.54,+0.59,20.0,116000,9,353730,0,0,0,0,0,0,109000,82000,27000,27000
20200528,710408,博智凱基9B購01,1.02,1.02,1.02,1.02,-0.05,-4.67,70000,1,71400,0,0,0,0,0,0,70000,0,70000,70000
20200528,710409,環球晶凱基9B購02,1.63,1.65,1.60,1.60,-0.02,-1.23,69000,4,111010,0,0,0,0,0,0,54000,15000,39000,39000
20200528,710410,雙鴻凱基9A購02,2.36,2.39,2.35,2.35,-0.03,-1.26,119000,7,282170,0,0,0,0,0,0,82000,49000,33000,33000
20200528,710411,穩懋凱基9B購01,,,,,,0.00,0,0,0,0,0,0,0,0,0,0,0,0,0
20200528,710412,宇峻國票9B購01,1.03,1.13,1.02,1.03,+0.03,3.0,161000,13,170290,0,0,0,0,0,0,86000,75000,11000,11000
20200528,710413,威剛中信9B購01,0.83,0.84,0.78,0.79,-0.03,-3.66,32000,5,26090,0,0,0,0,0,0,10000,22000,-12000,-12000
20200528,710414,雙鴻中信9A購01,1.31,1.34,1.29,1.29,-0.04,-3.01,68000,10,90630,0,0,0,0,0,0,68000,21000,47000,47000
20200528,710415,原相元大9A購05,1.25,1.26,1.10,1.10,-0.12,-9.84,649000,46,765030,0,0,0,0,0,0,507000,156000,351000,351000
20200528,710416,神盾元大9B購02,1.96,1.96,1.80,1.80,-0.11,-5.76,224000,18,427310,0,0,0,0,0,0,165000,59000,106000,106000
20200528,710417,博智元大9B購01,0.90,0.92,0.87,0.87,-0.03,-3.33,148000,20,133240,0,0,0,0,0,0,49000,89000,-40000,-40000
20200528,710418,群聯元大9A購05,1.77,1.77,1.75,1.75,+0.02,1.16,168000,8,295550,0,0,0,0,0,0,168000,0,168000,168000
20200528,710419,雙鴻元大9B購01,1.66,1.68,1.62,1.63,-0.02,-1.21,104000,9,172640,0,0,0,0,0,0,13000,92000,-79000,-79000
20200528,710420,鈊象元大9B購02,0.89,1.19,0.89,1.19,+0.35,41.67,947000,38,942290,0,0,0,0,0,0,229000,746000,-517000,-517000
20200528,710421,宏捷科永豐9A購01,,,,,,0.00,0,0,0,0,0,0,0,0,0,0,0,0,0
20200528,710422,昇達科永豐9A購01,1.03,1.06,1.03,1.03,+0.03,3.0,171000,8,178720,0,0,0,0,0,0,0,171000,-171000,-171000
20200528,710423,晶焱永豐9A購02,,,,,,0.00,0,0,0,0,0,0,0,0,0,0,0,0,0
20200528,710424,業強永豐9A購01,0.77,0.77,0.77,0.77,+0.01,1.32,60000,1,46200,0,0,0,0,0,0,60000,0,60000,60000
20200528,710425,頎邦永豐9A購01,1.38,1.38,1.38,1.38,+0.03,2.22,71000,2,97980,0,0,0,0,0,0,71000,0,71000,71000
20200528,710426,宏捷科凱基9A購02,,,,,,0.00,0,0,0,0,0,0,0,0,0,0,0,0,0
20200528,710427,神盾凱基9B購02,1.81,1.81,1.76,1.76,-0.04,-2.22,73000,2,128730,0,0,0,0,0,0,0,73000,-73000,-73000
20200528,710428,群聯凱基9B購02,,,,,,0.00,0,0,0,0,0,0,0,0,0,0,0,0,0
20200528,710429,群聯麥證9B購01,2.18,2.18,2.15,2.15,+0.01,0.47,14000,2,30310,7000,7000,0,0,0,0,7000,7000,0,0
20200528,710430,宏捷科國泰9B購03,1.76,1.78,1.72,1.73,-0.09,-4.95,442000,16,774060,0,0,0,0,0,0,438000,294000,144000,144000
20200528,710431,宇峻群益9B購01,0.50,0.50,0.50,0.50,+0.02,4.17,100000,1,50000,0,0,0,0,0,0,0,100000,-100000,-100000
20200528,710432,泰博群益9B購01,2.15,2.44,2.13,2.44,+0.49,25.13,22000,7,48790,0,0,0,0,0,0,0,6000,-6000,-6000
20200528,710433,原相富邦9C購02,0.86,0.87,0.75,0.75,-0.05,-6.25,565000,45,470520,0,0,0,0,0,0,545000,20000,525000,525000
20200528,710434,群聯富邦9B購01,0.77,0.77,0.77,0.77,0.00,0.0,67000,4,51590,0,0,0,0,0,0,65000,2000,63000,63000
20200528,710435,旺矽元富9A購01,,,,,,0.00,0,0,0,0,0,0,0,0,0,0,0,0,0
20200528,710436,威剛元富9A購01,3.16,3.16,3.16,3.16,+0.03,0.96,10000,1,31600,0,0,0,0,0,0,10000,0,10000,10000
20200528,710437,威剛元富9A購02,,,,,,0.00,0,0,0,0,0,0,0,0,0,0,0,0,0
20200528,710438,泰博元富9A購01,,,,,,0.00,0,0,0,0,0,0,0,0,0,0,0,0,0
20200528,710439,泰博元富9A購02,,,,,,0.00,0,0,0,0,0,0,0,0,0,0,0,0,0
20200528,710440,雙鴻元富9A購01,4.83,4.93,4.76,4.76,-0.09,-1.86,118000,11,572640,0,0,0,0,0,0,68000,50000,18000,18000
20200528,710441,鈊象元富9A購01,1.77,2.07,1.77,2.07,+0.45,27.78,83000,9,162490,0,0,0,0,0,0,10000,73000,-63000,-63000
20200528,710442,鈊象元富9A購02,2.33,2.39,2.31,2.37,+0.52,28.11,90000,9,211500,0,0,0,0,0,0,0,90000,-90000,-90000
20200528,710443,威剛國泰9C購01,2.00,2.01,1.86,1.86,-0.08,-4.12,332000,10,651240,0,0,0,0,0,0,243000,91000,152000,152000
20200528,710444,雙鴻國泰9C購01,1.92,1.95,1.88,1.90,+0.02,1.06,283000,22,543500,0,0,0,0,0,0,114000,180000,-66000,-66000
20200528,710445,博智群益9A購01,0.59,0.59,0.59,0.59,-0.03,-4.84,30000,1,17700,0,0,0,0,0,0,30000,0,30000,30000
20200528,710446,神盾凱基9A購02,1.41,1.41,1.38,1.38,-0.08,-5.48,10000,2,13920,0,0,0,0,0,0,10000,10000,0,0
20200528,710447,群聯凱基9A購04,,,,,,0.00,0,0,0,0,0,0,0,0,0,0,0,0,0
20200528,710448,優群凱基9A購04,1.93,1.93,1.75,1.89,+0.16,9.25,65000,6,120700,0,0,0,0,0,0,55000,10000,45000,45000
20200528,710449,環球晶凱基9C購01,,,,,,0.00,0,0,0,0,0,0,0,0,0,0,0,0,0
20200528,710450,雙鴻凱基9B購01,1.70,1.71,1.67,1.67,-0.03,-1.76,144000,4,243460,0,0,0,0,0,0,6000,144000,-138000,-138000
20200528,710451,穩懋凱基9C購01,,,,,,0.00,0,0,0,0,0,0,0,0,0,0,0,0,0
20200528,710452,鈊象凱基9A購03,,,,,,0.00,0,0,0,0,0,0,0,0,0,0,0,0,0
20200528,710453,鈊象第一9A購01,0.66,0.68,0.65,0.65,+0.12,22.64,66000,4,43660,0,0,0,0,0,0,66000,0,66000,66000
20200528,710454,精測中信9B購01,0.46,0.47,0.46,0.47,-0.03,-6.0,108000,2,50680,0,0,0,0,0,0,0,108000,-108000,-108000
20200528,710455,鈊象中信9A購01,0.62,0.69,0.62,0.69,+0.15,27.78,170000,7,113100,0,0,0,0,0,0,70000,100000,-30000,-30000
20200528,710456,台半永豐9A購01,1.02,1.04,1.02,1.04,+0.04,4.0,263000,10,270890,0,0,0,0,0,0,20000,253000,-233000,-233000
20200528,710457,台燿永豐9A購01,1.09,1.11,1.07,1.10,0.00,0.0,80000,25,87670,0,0,0,0,0,0,30000,50000,-20000,-20000
20200528,710458,合晶永豐9A購01,1.15,1.18,1.15,1.17,+0.04,3.54,117000,4,137360,0,0,0,0,0,0,116000,1000,115000,115000
20200528,710459,宜特永豐9A購01,2.66,2.78,2.55,2.73,+0.16,6.23,70000,6,185010,0,0,0,0,0,0,69000,0,69000,69000
20200528,710460,旺矽永豐9A購01,1.94,1.94,1.81,1.81,-0.19,-9.5,65000,7,121500,0,0,0,0,0,0,0,65000,-65000,-65000
20200528,710461,信昌電永豐9A購01,0.98,0.98,0.98,0.98,-0.01,-1.01,10000,1,9800,0,0,0,0,0,0,10000,0,10000,10000
20200528,710462,威剛永豐9A購01,,,,,,0.00,0,0,0,0,0,0,0,0,0,0,0,0,0
20200528,710463,聚積永豐9A購01,,,,,,0.00,0,0,0,0,0,0,0,0,0,0,0,0,0
20200528,710464,緯軟永豐9A購01,0.93,0.94,0.87,0.87,+0.01,1.16,252000,6,229080,0,0,0,0,0,0,83000,252000,-169000,-169000
20200528,710465,優群永豐9A購02,1.54,1.59,1.40,1.56,+0.27,20.93,201000,12,303220,0,0,0,0,0,0,111000,90000,21000,21000
20200528,710466,環宇永豐9A購01,0.87,0.88,0.85,0.85,-0.02,-2.3,395000,4,343700,0,0,0,0,0,0,0,395000,-395000,-395000
20200528,710467,穩懋永豐9A購02,,,,,,0.00,0,0,0,0,0,0,0,0,0,0,0,0,0
20200528,710468,鈊象永豐9A購03,0.54,0.58,0.54,0.58,+0.11,23.4,80000,3,44000,0,0,0,0,0,0,0,80000,-80000,-80000
20200528,710469,宏捷科元大9C購01,1.26,1.28,1.25,1.25,-0.06,-4.58,110000,11,139100,0,0,0,0,0,0,110000,0,110000,110000
20200528,710470,信驊元大9A購02,2.58,2.77,2.58,2.61,+0.18,7.41,30000,8,80540,0,0,0,0,0,0,25000,12000,13000,13000
20200528,710471,原相元大9B購04,1.44,1.44,1.25,1.25,-0.12,-8.76,378000,39,516810,1000,0,1000,0,0,0,304000,91000,213000,214000
20200528,710472,群聯元大9A購06,1.60,1.60,1.54,1.54,-0.05,-3.14,86000,2,133520,0,0,0,0,0,0,18000,68000,-50000,-50000
20200528,710473,精測元大9A購04,1.27,1.27,1.20,1.20,-0.05,-4.0,76000,3,91760,0,0,0,0,0,0,75000,8000,67000,67000
20200528,710474,環球晶富邦9C購01,0.68,0.68,0.68,0.68,+0.02,3.03,155000,2,105400,0,0,0,0,0,0,0,155000,-155000,-155000
20200528,710475,聯亞富邦9B購02,0.83,0.85,0.81,0.82,-0.02,-2.38,332000,11,275060,0,0,0,0,0,0,223000,109000,114000,114000
20200528,710476,鈊象富邦9B購01,0.46,0.57,0.46,0.57,+0.14,32.56,317000,21,160110,0,0,0,0,0,0,53000,262000,-209000,-209000
20200528,710477,弘塑元大9A購01,2.22,2.22,2.15,2.15,-0.18,-7.73,100000,2,218500,0,0,0,0,0,0,50000,50000,0,0
20200528,710478,神盾元大9A購05,1.74,1.74,1.60,1.61,-0.12,-6.94,318000,15,534460,0,0,0,0,0,0,245000,147000,98000,98000
20200528,710479,群聯元大9A購07,1.93,1.93,1.93,1.93,-0.06,-3.02,1000,1,1930,0,0,0,0,0,0,0,1000,-1000,-1000
20200528,710480,鈊象元大9B購03,1.69,2.02,1.69,1.96,+0.41,26.45,408000,16,770770,0,0,0,0,0,0,136000,314000,-178000,-178000
20200528,710481,精測國泰9B購01,0.87,0.87,0.80,0.80,-0.06,-6.98,1369000,10,1172270,0,0,0,0,0,0,299000,1070000,-771000,-771000
20200528,710482,威剛群益9A購03,1.73,1.73,1.69,1.69,-0.01,-0.59,82000,3,140440,0,0,0,0,0,0,72000,10000,62000,62000
20200528,710483,雙鴻群益9A購01,2.01,2.09,1.98,2.00,+0.02,1.01,391000,13,801810,0,0,0,0,0,0,122000,341000,-219000,-219000
20200528,710484,鈊象群益9A購01,0.69,0.83,0.69,0.81,+0.20,32.79,298000,11,220320,0,0,0,0,0,0,30000,268000,-238000,-238000
20200528,710485,譜瑞富邦9C購01,1.56,1.58,1.51,1.51,-0.18,-10.65,75000,5,115200,0,0,0,0,0,0,50000,25000,25000,25000
20200528,710486,大江第一9A購01,,,,,,0.00,0,0,0,0,0,0,0,0,0,0,0,0,0
20200528,710487,環球晶第一9A購01,,,,,,0.00,0,0,0,0,0,0,0,0,0,0,0,0,0
20200528,710488,穩懋第一9A購01,0.51,0.51,0.51,0.51,-0.03,-5.56,15000,2,7650,0,0,0,0,0,0,10000,5000,5000,5000
20200528,710489,力旺永豐9A購01,2.39,2.47,2.35,2.39,-0.15,-5.91,212000,12,504060,0,0,0,0,0,0,212000,0,212000,212000
20200528,710490,世界永豐9A購01,1.61,1.61,1.61,1.61,-0.02,-1.23,22000,1,35420,0,0,0,0,0,0,22000,0,22000,22000
20200528,710491,宇峻永豐9A購02,0.83,0.84,0.81,0.84,+0.07,9.09,185000,5,154250,0,0,0,0,0,0,0,185000,-185000,-185000
20200528,710492,建榮永豐9B購02,1.64,1.64,1.64,1.64,-0.02,-1.2,43000,1,70520,0,0,0,0,0,0,43000,0,43000,43000
20200528,710493,原相永豐9A購02,0.91,0.91,0.86,0.86,-0.04,-4.44,230000,12,198550,0,0,0,0,0,0,230000,0,230000,230000
20200528,710494,博智國票9A購01,1.12,1.15,1.10,1.10,-0.04,-3.51,90000,4,102790,0,0,0,0,0,0,0,90000,-90000,-90000
20200528,710495,威剛統一9C購01,,,,,,0.00,0,0,0,0,0,0,0,0,0,0,0,0,0
20200528,710496,穩懋統一9C購01,,,,,,0.00,0,0,0,0,0,0,0,0,0,0,0,0,0
20200528,710497,網家麥證9A購01,,,,,,0.00,0,0,0,0,0,0,0,0,0,0,0,0,0
20200528,710498,建榮凱基9C購01,2.51,2.51,2.51,2.51,+0.05,2.03,10000,1,25100,0,0,0,0,0,0,10000,0,10000,10000
20200528,710499,網家國泰9B購01,,,,,,0.00,0,0,0,0,0,0,0,0,0,0,0,0,0
20200528,710500,弘塑群益9A購01,,,,,,0.00,0,0,0,0,0,0,0,0,0,0,0,0,0
20200528,710501,威剛元大9A購05,2.23,2.23,2.05,2.05,-0.07,-3.3,151000,15,325230,0,0,0,0,0,0,121000,30000,91000,91000
20200528,710502,泰博元大9B購01,,,,,,0.00,0,0,0,0,0,0,0,0,0,0,0,0,0
20200528,710503,雙鴻元大9C購02,1.41,1.42,1.38,1.38,0.00,0.0,758000,13,1063520,0,0,0,0,0,0,488000,270000,218000,218000
20200528,710504,世界富邦9C購01,0.99,1.01,0.97,0.97,-0.02,-2.02,281000,11,280870,0,0,0,0,0,0,110000,171000,-61000,-61000
20200528,710505,泰博富邦9B購01,,,,,,0.00,0,0,0,0,0,0,0,0,0,0,0,0,0
20200528,710506,頎邦富邦9C購01,1.06,1.06,1.00,1.01,-0.02,-1.94,163000,15,168450,0,0,0,0,0,0,112000,31000,81000,81000
20200528,710507,宏捷科凱基9C購01,1.21,1.22,1.19,1.19,-0.04,-3.25,161000,11,193900,0,0,0,0,0,0,161000,0,161000,161000
20200528,710508,南光凱基9A購01,,,,,,0.00,0,0,0,0,0,0,0,0,0,0,0,0,0
20200528,710509,建榮凱基9B購01,,,,,,0.00,0,0,0,0,0,0,0,0,0,0,0,0,0
20200528,710510,群聯凱基9B購03,,,,,,0.00,0,0,0,0,0,0,0,0,0,0,0,0,0
20200528,710511,網家凱基9A購01,,,,,,0.00,0,0,0,0,0,0,0,0,0,0,0,0,0
20200528,710512,中美晶統一9A購01,0.81,0.81,0.81,0.81,-0.02,-2.41,5000,1,4050,0,0,0,0,0,0,5000,0,5000,5000
20200528,710513,雙鴻統一9C購01,0.85,0.86,0.85,0.85,-0.02,-2.3,383000,7,327240,0,0,0,0,0,0,155000,228000,-73000,-73000
20200528,710514,穩懋統一9A購02,0.67,0.67,0.66,0.66,-0.02,-2.94,51000,2,34160,0,0,0,0,0,0,51000,0,51000,51000
20200528,710515,大學光永豐9A購02,,,,,,0.00,0,0,0,0,0,0,0,0,0,0,0,0,0
20200528,710516,宇峻永豐9B購01,0.65,0.65,0.65,0.65,+0.06,10.17,4000,1,2600,0,0,0,0,0,0,4000,0,4000,4000
20200528,710517,保瑞永豐9A購01,1.08,1.08,1.06,1.06,-0.05,-4.5,293000,8,312980,0,0,0,0,0,0,218000,75000,143000,143000
20200528,710518,建榮永豐9A購05,1.56,1.59,1.56,1.59,-0.04,-2.45,11000,2,17460,0,0,0,0,0,0,1000,10000,-9000,-9000
20200528,710519,胡連永豐9A購01,1.48,1.48,1.42,1.42,-0.07,-4.7,156000,3,221760,0,0,0,0,0,0,156000,0,156000,156000
20200528,710520,泰博永豐9A購02,,,,,,0.00,0,0,0,0,0,0,0,0,0,0,0,0,0
20200528,710521,神盾永豐9A購03,1.25,1.25,1.22,1.22,-0.08,-6.15,101000,2,124840,0,0,0,0,0,0,54000,47000,7000,7000
20200528,710522,博智永豐9A購03,0.72,0.74,0.72,0.74,-0.05,-6.33,208000,4,152340,0,0,0,0,0,0,161000,47000,114000,114000
20200528,710523,網龍永豐9A購02,2.08,2.22,2.08,2.17,+0.08,3.83,90000,9,193200,0,0,0,0,0,0,10000,80000,-70000,-70000
20200528,710524,大江國票9A購04,7.40,7.80,7.40,7.80,+0.15,1.96,8000,2,61600,0,0,0,0,0,0,0,8000,-8000,-8000
20200528,710525,弘塑國票9A購01,3.95,3.95,3.95,3.95,-0.28,-6.62,36000,2,142200,0,0,0,0,0,0,36000,0,36000,36000
20200528,710526,網家國票9A購01,9.55,9.75,9.05,9.05,-0.75,-7.65,14000,6,133100,0,0,0,0,0,0,7000,7000,0,0
20200528,710527,大江國泰9C購01,2.29,2.36,2.26,2.36,+0.09,3.96,52000,3,120450,0,0,0,0,0,0,52000,21000,31000,31000
20200528,710528,雍智群益9A購01,2.91,2.96,2.82,2.82,-0.16,-5.37,7000,4,20100,0,0,0,0,0,0,5000,2000,3000,3000
20200528,710529,威剛元大9A購06,2.27,2.27,2.09,2.09,-0.08,-3.69,472000,11,1045890,0,0,0,0,0,0,222000,250000,-28000,-28000
20200528,710530,泰博元大9A購01,,,,,,0.00,0,0,0,0,0,0,0,0,0,0,0,0,0
20200528,710531,神盾元大9A購06,3.85,3.85,3.52,3.52,-0.30,-7.85,77000,5,280910,0,0,0,0,0,0,47000,57000,-10000,-10000
20200528,710532,群聯元大9A購08,1.86,1.86,1.76,1.76,-0.06,-3.3,35000,4,62400,0,0,0,0,0,0,20000,15000,5000,5000
20200528,710533,鈊象元大9B購04,2.02,2.55,2.02,2.46,+0.55,28.8,301000,21,695810,0,0,0,0,0,0,109000,221000,-112000,-112000
20200528,710534,鈺太元大9B購01,2.02,2.03,1.79,1.80,-0.21,-10.45,225000,14,431770,0,0,0,0,0,0,199000,96000,103000,103000
20200528,710535,網家第一9A購01,,,,,,0.00,0,0,0,0,0,0,0,0,0,0,0,0,0
20200528,710536,凡甲永豐9A購02,1.77,1.80,1.66,1.66,-0.09,-5.14,138000,9,237560,0,0,0,0,0,0,70000,98000,-28000,-28000
20200528,710537,金居永豐9A購01,1.40,1.40,1.30,1.30,-0.16,-10.96,74000,5,101200,0,0,0,0,0,0,24000,50000,-26000,-26000
20200528,710538,原相永豐9A購04,0.91,0.91,0.91,0.91,+0.06,7.06,20000,3,18200,0,0,0,0,0,0,20000,0,20000,20000
20200528,710539,華研永豐9A購01,0.77,0.77,0.75,0.75,-0.05,-6.25,30000,4,22900,0,0,0,0,0,0,20000,10000,10000,10000
20200528,710540,群聯永豐9A購02,,,,,,0.00,0,0,0,0,0,0,0,0,0,0,0,0,0
20200528,710541,雍智永豐9A購01,1.66,1.66,1.54,1.54,-0.12,-7.23,142000,11,226870,0,0,0,0,0,0,92000,50000,42000,42000
20200528,710542,網家永豐9A購01,1.70,1.70,1.60,1.60,-0.13,-7.51,11000,2,18500,0,0,0,0,0,0,9000,2000,7000,7000
20200528,710543,網龍永豐9A購03,1.88,2.02,1.88,1.88,+0.01,0.53,56000,5,107970,0,0,0,0,0,0,1000,56000,-55000,-55000
20200528,710544,鈺太永豐9A購01,1.04,1.05,0.95,0.95,-0.09,-8.65,245000,7,250250,0,0,0,0,0,0,10000,235000,-225000,-225000
20200528,710545,力旺凱基9A購01,2.86,2.86,2.80,2.80,+0.02,0.72,27000,4,76450,0,0,0,0,0,0,13000,14000,-1000,-1000
20200528,710546,宏捷科凱基9A購03,1.06,1.06,1.06,1.06,+0.03,2.91,9000,1,9540,0,0,0,0,0,0,0,9000,-9000,-9000
20200528,710547,原相凱基9A購03,1.27,1.27,1.23,1.23,+0.02,1.65,55000,10,68850,0,0,0,0,0,0,55000,0,55000,55000
20200528,710548,泰博凱基9A購03,3.40,3.40,3.40,3.40,+0.46,15.65,2000,1,6800,0,0,0,0,0,0,0,2000,-2000,-2000
20200528,710549,精華凱基9A購01,1.02,1.02,0.97,0.97,-0.01,-1.02,50000,3,49500,0,0,0,0,0,0,20000,30000,-10000,-10000
20200528,710550,網家凱基9C購01,1.60,1.60,1.60,1.60,-0.05,-3.03,5000,2,8000,0,0,0,0,0,0,0,5000,-5000,-5000
20200528,710551,鈺太凱基9A購01,1.69,1.70,1.48,1.48,-0.23,-13.45,52000,9,80860,0,0,0,0,0,0,41000,11000,30000,30000
20200528,710552,泰博統一9C購01,2.64,2.97,2.64,2.97,+0.36,13.79,70000,7,194700,0,0,0,0,0,0,0,70000,-70000,-70000
20200528,710553,穩懋統一9B購03,,,,,,0.00,0,0,0,0,0,0,0,0,0,0,0,0,0
20200528,710554,中美晶國票9A購04,1.87,1.87,1.77,1.80,-0.03,-1.64,86000,7,157450,0,0,0,0,0,0,0,86000,-86000,-86000
20200528,710555,宇峻國票9A購01,1.45,1.51,1.45,1.51,+0.19,14.39,127000,5,186010,0,0,0,0,0,0,0,127000,-127000,-127000
20200528,710556,良維國票9A購01,,,,,,0.00,0,0,0,0,0,0,0,0,0,0,0,0,0
20200528,710557,優群國票9A購02,3.99,4.50,3.99,4.31,+0.35,8.84,74000,5,312980,0,0,0,0,0,0,20000,54000,-34000,-34000
20200528,710558,雙鴻國票9A購03,3.20,3.35,3.20,3.24,-0.18,-5.26,143000,12,466790,0,0,0,0,0,0,71000,90000,-19000,-19000
20200528,710559,世界元大9A購03,3.00,3.13,2.95,2.95,-0.05,-1.67,144000,11,439690,0,0,0,0,0,0,18000,126000,-108000,-108000
20200528,710560,宏捷科元大9B購02,,,,,,0.00,0,0,0,0,0,0,0,0,0,0,0,0,0
20200528,710561,威剛元大9B購02,1.25,1.25,1.23,1.23,0.00,0.0,44000,3,54780,0,0,0,0,0,0,44000,11000,33000,33000
20200528,710562,胡連元大9A購01,2.45,2.50,2.41,2.42,0.00,0.0,178000,8,440660,0,0,0,0,0,0,100000,78000,22000,22000
20200528,710563,原相元大9A購08,1.66,1.68,1.55,1.55,-0.04,-2.52,220000,21,359240,0,0,0,0,0,0,152000,86000,66000,66000
20200528,710564,群聯元大9A購09,1.00,1.00,0.96,0.97,-0.03,-3.0,123000,8,119230,0,0,0,0,0,0,103000,20000,83000,83000
20200528,710565,群聯元大9A購10,,,,,,0.00,0,0,0,0,0,0,0,0,0,0,0,0,0
20200528,710566,碩禾元大9B購01,,,,,,0.00,0,0,0,0,0,0,0,0,0,0,0,0,0
20200528,710567,優群元大9A購01,3.16,3.20,2.95,3.16,+0.36,12.86,93000,8,290990,0,0,0,0,0,0,4000,91000,-87000,-87000
20200528,710568,鈊象兆豐9A購01,0.82,1.04,0.82,1.04,+0.26,33.33,1522000,33,1473880,0,0,0,0,0,0,185000,1342000,-1157000,-1157000
20200528,710569,中美晶富邦9B購04,0.75,0.75,0.74,0.74,-0.02,-2.63,81000,2,60070,0,0,0,0,0,0,0,81000,-81000,-81000
20200528,710570,宏捷科群益9A購01,1.09,1.10,1.07,1.09,-0.06,-5.22,222000,13,240780,0,0,0,0,0,0,222000,0,222000,222000
20200528,710571,新鉅科群益9A購02,1.36,1.36,1.31,1.36,+0.03,2.26,246000,13,326880,0,0,0,0,0,0,193000,53000,140000,140000
20200528,710572,網家群益9A購01,1.80,1.86,1.64,1.64,-0.13,-7.34,320000,15,569150,0,0,0,0,0,0,63000,257000,-194000,-194000
20200528,710573,網龍群益9A購01,3.33,3.53,3.33,3.53,+0.36,11.36,101000,5,345240,0,0,0,0,0,0,1000,101000,-100000,-100000
20200528,710574,鈊象群益9A購02,1.23,1.43,1.22,1.38,+0.29,26.61,170000,10,222580,0,0,0,0,0,0,42000,169000,-127000,-127000
20200528,710575,環球晶中信9B購01,,,,,,0.00,0,0,0,0,0,0,0,0,0,0,0,0,0
20200528,710576,M31永豐9A購01,1.79,1.79,1.57,1.57,-0.22,-12.29,254000,15,445040,0,0,0,0,0,0,221000,32000,189000,189000
20200528,710577,大江永豐9A購01,1.18,1.18,1.18,1.18,+0.03,2.61,18000,1,21240,0,0,0,0,0,0,0,18000,-18000,-18000
20200528,710578,世界永豐9A購02,1.02,1.02,1.02,1.02,+0.04,4.08,27000,2,27540,0,0,0,0,0,0,0,27000,-27000,-27000
20200528,710579,伍豐永豐9A購01,0.90,0.96,0.84,0.84,-0.04,-4.55,147000,12,136000,0,0,0,0,0,0,47000,100000,-53000,-53000
20200528,710580,兆利永豐9A購01,,,,,,0.00,0,0,0,0,0,0,0,0,0,0,0,0,0
20200528,710581,欣銓永豐9A購01,1.29,1.29,1.19,1.19,-0.09,-7.03,220000,10,274950,0,0,0,0,0,0,130000,90000,40000,40000
20200528,710582,新鉅科永豐9A購01,0.73,0.73,0.70,0.70,-0.02,-2.78,121000,11,85210,0,0,0,0,0,0,121000,0,121000,121000
20200528,710583,精測永豐9A購02,0.33,0.33,0.33,0.33,+0.01,3.12,20000,1,6600,0,0,0,0,0,0,0,20000,-20000,-20000
20200528,710584,網家永豐9A購02,1.48,1.50,1.46,1.46,-0.06,-3.95,62000,3,91800,0,0,0,0,0,0,62000,0,62000,62000
20200528,710585,穩懋麥證9A購02,,,,,,0.00,0,0,0,0,0,0,0,0,0,0,0,0,0
20200528,710586,原相統一9C購01,0.92,0.92,0.81,0.81,-0.09,-10.0,97000,16,82920,0,0,0,0,0,0,71000,26000,45000,45000
20200528,710587,宏捷科凱基9C購02,1.13,1.13,1.11,1.12,-0.03,-2.61,291000,19,324810,0,0,0,0,0,0,291000,0,291000,291000
20200528,710588,信驊凱基9A購03,2.33,2.39,2.25,2.25,+0.07,3.21,46000,5,109210,0,0,0,0,0,0,8000,38000,-30000,-30000
20200528,710589,威剛凱基9A購05,1.31,1.31,1.31,1.31,0.00,0.0,10000,1,13100,0,0,0,0,0,0,10000,0,10000,10000
20200528,710590,鈺太凱基9B購01,1.34,1.34,1.26,1.26,-0.08,-5.97,44000,2,55760,0,0,0,0,0,0,40000,44000,-4000,-4000
20200528,710591,凡甲國票9A購01,3.98,3.98,3.65,3.65,-0.28,-7.12,165000,11,631730,0,0,0,0,0,0,134000,31000,103000,103000
20200528,710592,大江國票9A購05,2.01,2.12,2.01,2.07,-0.09,-4.17,34000,3,71160,0,0,0,0,0,0,0,34000,-34000,-34000
20200528,710593,弘塑國票9A購02,4.85,4.85,4.82,4.82,-0.38,-7.31,30000,2,144780,0,0,0,0,0,0,0,30000,-30000,-30000
20200528,710594,泰博國票9A購03,,,,,,0.00,0,0,0,0,0,0,0,0,0,0,0,0,0
20200528,710595,雍智國票9A購01,4.99,4.99,4.80,4.80,-0.85,-15.04,50000,4,243350,0,0,0,0,0,0,5000,45000,-40000,-40000
20200528,710596,大江元大9A購03,1.36,1.38,1.36,1.38,+0.01,0.73,15000,2,20500,0,0,0,0,0,0,10000,5000,5000,5000
20200528,710597,大學光元大9A購01,,,,,,0.00,0,0,0,0,0,0,0,0,0,0,0,0,0
20200528,710598,原相元大9A購09,2.44,2.44,2.21,2.22,-0.15,-6.33,265000,31,615050,0,0,0,0,0,0,255000,110000,145000,145000
20200528,710599,泰博元大9A購02,,,,,,0.00,0,0,0,0,0,0,0,0,0,0,0,0,0
20200528,710600,群聯元大9A購11,2.42,2.42,2.28,2.28,-0.09,-3.8,116000,6,267820,0,0,0,0,0,0,66000,66000,0,0
20200528,710601,精測元大9A購05,1.55,1.55,1.53,1.53,+0.03,2.0,39000,3,60130,0,0,0,0,0,0,39000,16000,23000,23000
20200528,710602,鈊象元大9A購04,2.16,2.69,2.16,2.61,+0.53,25.48,271000,19,678890,0,0,0,0,0,0,84000,216000,-132000,-132000
20200528,710603,大江凱基9B購01,1.64,1.67,1.64,1.67,+0.05,3.09,120000,4,199100,0,0,0,0,0,0,10000,110000,-100000,-100000
20200528,710604,大學光凱基9A購04,5.20,5.30,5.20,5.25,+0.36,7.36,20000,3,104850,0,0,0,0,0,0,20000,0,20000,20000
20200528,710605,原相凱基9B購01,1.23,1.23,1.09,1.09,-0.07,-6.03,138000,11,161610,0,0,0,0,0,0,138000,0,138000,138000
20200528,710606,太醫統一9C購01,0.56,0.56,0.56,0.56,0.00,0.0,24000,1,13440,0,0,0,0,0,0,0,24000,-24000,-24000
20200528,710607,寶雅統一9C購01,1.28,1.28,1.22,1.22,-0.10,-7.58,251000,5,316980,0,0,0,0,0,0,236000,15000,221000,221000
20200528,710608,鈊象統一9A購02,0.65,0.76,0.65,0.72,+0.13,22.03,129000,6,96200,0,0,0,0,0,0,16000,113000,-97000,-97000
20200528,710609,鈊象統一9A購03,0.75,0.76,0.75,0.76,+0.18,31.03,130000,3,97800,0,0,0,0,0,0,0,130000,-130000,-130000
20200528,710610,凡甲兆豐9A購01,1.90,1.90,1.84,1.87,-0.07,-3.61,349000,37,652320,0,0,0,0,0,0,322000,27000,295000,295000
20200528,710611,泰博兆豐9A購01,3.68,4.44,3.57,4.41,-0.07,-1.56,78000,9,288410,0,0,0,0,0,0,10000,64000,-54000,-54000
20200528,710612,環球晶兆豐9B購01,1.22,1.24,1.21,1.23,+0.06,5.13,340000,15,418310,0,0,0,0,0,0,10000,330000,-320000,-320000
20200528,710613,聯亞兆豐9A購01,1.03,1.03,0.96,0.97,-0.04,-3.96,67000,4,68300,0,0,0,0,0,0,3000,64000,-61000,-61000
20200528,710614,雙鴻兆豐9B購01,1.41,1.44,1.38,1.41,-0.04,-2.76,29000,6,40990,0,0,0,0,0,0,13000,19000,-6000,-6000
20200528,710615,穩懋兆豐9A購03,0.69,0.71,0.69,0.71,0.00,0.0,46000,5,31880,0,0,0,0,0,0,34000,12000,22000,22000
20200528,710616,穩懋兆豐9B購01,,,,,,0.00,0,0,0,0,0,0,0,0,0,0,0,0,0
20200528,710617,大江永豐9A購02,1.05,1.05,1.05,1.05,-0.01,-0.94,50000,1,52500,0,0,0,0,0,0,0,50000,-50000,-50000
20200528,710618,六角永豐9A購01,1.01,1.04,0.98,0.98,-0.04,-3.92,219000,13,224950,0,0,0,0,0,0,214000,5000,209000,209000
20200528,710619,太醫永豐9A購01,,,,,,0.00,0,0,0,0,0,0,0,0,0,0,0,0,0
20200528,710620,信昌電永豐9A購02,0.74,0.74,0.74,0.74,-0.01,-1.33,13000,1,9620,0,0,0,0,0,0,13000,0,13000,13000
20200528,710621,原相永豐9A購05,0.73,0.73,0.69,0.69,-0.05,-6.76,110000,6,76500,0,0,0,0,0,0,110000,0,110000,110000
20200528,710622,雍智永豐9A購02,1.49,1.49,1.35,1.36,-0.11,-7.48,56000,8,81900,0,0,0,0,0,0,42000,14000,28000,28000
20200528,710623,碩禾永豐9A購01,0.63,0.63,0.63,0.63,-0.03,-4.55,10000,1,6300,0,0,0,0,0,0,10000,0,10000,10000
20200528,710624,寶雅永豐9A購02,1.35,1.35,1.27,1.33,-0.13,-8.9,177000,11,231130,0,0,0,0,0,0,176000,1000,175000,175000
20200528,710625,大江國票9A購06,5.60,5.70,5.60,5.70,+0.05,0.88,33000,4,186600,0,0,0,0,0,0,0,33000,-33000,-33000
20200528,710626,弘塑國票9A購03,2.42,2.43,2.42,2.43,-0.06,-2.41,62000,3,150060,0,0,0,0,0,0,62000,0,62000,62000
20200528,710627,宏捷科國票9A購03,,,,,,0.00,0,0,0,0,0,0,0,0,0,0,0,0,0
20200528,710628,鈊象國票9A購04,4.48,5.65,4.48,5.40,+1.31,32.03,105000,24,549500,0,0,0,0,0,0,64000,98000,-34000,-34000
20200528,710629,凡甲群益9A購01,1.46,1.46,1.36,1.38,-0.04,-2.82,673000,26,966360,0,0,0,0,0,0,653000,20000,633000,633000
20200528,710630,大江群益9A購01,1.61,1.66,1.61,1.66,+0.02,1.22,70000,3,113600,0,0,0,0,0,0,60000,10000,50000,50000
20200528,710631,宇峻群益9A購03,0.75,0.79,0.73,0.73,+0.03,4.29,659000,13,508630,0,0,0,0,0,0,0,659000,-659000,-659000
20200528,710632,群聯群益9A購02,1.23,1.25,1.23,1.24,-0.07,-5.34,107000,3,133630,0,0,0,0,0,0,1000,106000,-105000,-105000
20200528,710633,雙鴻群益9A購02,1.30,1.32,1.27,1.32,+0.03,2.33,318000,11,415400,0,0,0,0,0,0,316000,314000,2000,2000
20200528,710634,鈊象群益9A購03,0.88,1.02,0.88,1.02,+0.24,30.77,320000,11,312510,0,0,0,0,0,0,10000,310000,-300000,-300000
20200528,710635,鈺太群益9A購01,1.17,1.19,1.02,1.02,-0.19,-15.7,129000,8,144710,0,0,0,0,0,0,127000,40000,87000,87000
20200528,710636,寶雅凱基9A購01,1.41,1.42,1.37,1.37,-0.12,-8.05,57000,5,79590,0,3000,-3000,0,0,0,53000,4000,49000,46000
20200528,710637,原相統一9A購03,0.79,0.79,0.66,0.66,-0.09,-12.0,688000,27,505070,0,0,0,0,0,0,470000,218000,252000,252000
20200528,710638,精測統一9B購01,0.56,0.56,0.56,0.56,-0.02,-3.45,15000,2,8400,0,0,0,0,0,0,5000,10000,-5000,-5000
20200528,710639,穩懋統一9C購02,0.60,0.60,0.60,0.60,0.00,0.0,5000,1,3000,0,0,0,0,0,0,0,5000,-5000,-5000
20200528,710640,大江元大9A購04,1.41,1.46,1.41,1.45,-0.01,-0.68,129000,6,187390,0,0,0,0,0,0,1000,128000,-127000,-127000
20200528,710641,信驊元大9A購03,4.08,4.28,4.08,4.14,+0.38,10.11,73000,11,305070,0,0,0,0,0,0,62000,73000,-11000,-11000
20200528,710642,原相元大9A購10,1.59,1.59,1.40,1.40,-0.14,-9.09,700000,43,1051460,0,0,0,0,0,0,645000,89000,556000,556000
20200528,710643,泰博元大9B購02,5.40,6.35,5.35,6.20,+0.95,18.1,197000,35,1135300,0,0,0,0,0,0,18000,170000,-152000,-152000
20200528,710644,博智元大9A購02,1.11,1.11,1.07,1.07,-0.04,-3.6,150000,9,161700,0,0,0,0,0,0,150000,0,150000,150000
20200528,710645,網家元大9A購01,3.67,3.71,3.57,3.57,-0.15,-4.03,66000,7,240360,0,0,0,0,0,0,36000,42000,-6000,-6000
20200528,710646,優群元大9A購02,2.42,2.49,2.28,2.42,+0.17,7.56,222000,19,524710,0,0,0,0,0,0,80000,126000,-46000,-46000
20200528,710647,威剛富邦9B購01,0.83,0.83,0.83,0.83,+0.03,3.75,62000,7,51460,0,0,0,0,0,0,62000,0,62000,62000
20200528,710648,弘塑國泰9C購01,1.52,1.52,1.39,1.39,-0.14,-9.15,64000,3,95330,0,0,0,0,0,0,64000,0,64000,64000
20200528,710649,神盾國泰9C購01,2.01,2.01,1.87,1.87,-0.13,-6.5,283000,17,549440,0,0,0,0,0,0,283000,48000,235000,235000
20200528,710650,新普國泰9C購01,1.89,2.05,1.88,2.04,+0.15,7.94,896000,60,1783060,0,0,0,0,0,0,319000,765000,-446000,-446000
20200528,710651,信驊群益9A購01,,,,,,0.00,0,0,0,0,0,0,0,0,0,0,0,0,0
20200528,710652,原相中信03購01,0.88,0.88,0.80,0.80,-0.06,-6.98,118000,23,101090,0,0,0,0,0,0,78000,40000,38000,38000
20200528,710653,博智中信9A購01,0.39,0.40,0.39,0.40,0.00,0.0,30000,2,11900,0,0,0,0,0,0,30000,0,30000,30000
20200528,710654,弘塑永豐9A購02,,,,,,0.00,0,0,0,0,0,0,0,0,0,0,0,0,0
20200528,710655,佳邦永豐9A購02,,,,,,0.00,0,0,0,0,0,0,0,0,0,0,0,0,0
20200528,710656,博智永豐9A購04,0.51,0.51,0.51,0.51,-0.01,-1.92,20000,1,10200,0,0,0,0,0,0,0,20000,-20000,-20000
20200528,710657,閎康永豐9A購02,1.13,1.13,1.11,1.12,-0.03,-2.61,207000,6,231960,0,0,0,0,0,0,207000,0,207000,207000
20200528,710658,順達永豐9A購01,1.72,1.72,1.53,1.53,-0.21,-12.07,302000,11,505930,0,0,0,0,0,0,302000,0,302000,302000
20200528,710659,雍智永豐9A購03,2.14,2.14,1.97,1.97,-0.26,-11.66,13000,2,27310,0,0,0,0,0,0,10000,3000,7000,7000
20200528,710660,雙美永豐9A購01,1.28,1.35,1.28,1.35,+0.08,6.3,690000,20,903840,0,0,0,0,0,0,202000,635000,-433000,-433000
20200528,710661,良維兆豐9B購01,1.34,1.35,1.34,1.35,+0.02,1.5,62000,3,83200,0,0,0,0,0,0,62000,0,62000,62000
20200528,710662,金居兆豐9A購01,1.93,1.93,1.93,1.93,-0.11,-5.39,5000,1,9650,0,0,0,0,0,0,0,5000,-5000,-5000
20200528,710663,原相兆豐9B購01,1.08,1.08,1.00,1.03,-0.01,-0.96,299000,13,311800,0,0,0,0,0,0,299000,0,299000,299000
20200528,710664,神盾兆豐9B購01,1.32,1.32,1.28,1.28,-0.03,-2.29,177000,7,231140,0,0,0,0,0,0,167000,10000,157000,157000
20200528,710665,新普兆豐9A購01,1.59,1.73,1.59,1.73,+0.18,11.61,629000,33,1044700,0,0,0,0,0,0,94000,478000,-384000,-384000
20200528,710666,凡甲元大9A購03,2.72,2.73,2.60,2.60,-0.13,-4.76,224000,23,602580,0,0,0,0,0,0,199000,25000,174000,174000
20200528,710667,泰博元大9A購03,,,,,,0.00,0,0,0,0,0,0,0,0,0,0,0,0,0
20200528,710668,原相兆豐9B購02,1.03,1.03,0.96,0.96,-0.04,-4.0,202000,17,207670,0,0,0,0,0,0,197000,5000,192000,192000
20200528,710669,環球晶兆豐9B購02,,,,,,0.00,0,0,0,0,0,0,0,0,0,0,0,0,0
20200528,710670,雙美群益9B購01,1.43,1.49,1.43,1.48,+0.08,5.71,430000,13,626700,0,0,0,0,0,0,230000,430000,-200000,-200000
20200528,710671,大江富邦9C購02,0.91,0.96,0.91,0.93,+0.02,2.2,299000,10,281050,0,0,0,0,0,0,110000,189000,-79000,-79000
20200528,710672,M31凱基9A購02,1.43,1.46,1.23,1.23,-0.24,-16.33,462000,21,660190,0,0,0,0,0,0,311000,213000,98000,98000
20200528,710673,大江凱基9A購02,1.27,1.30,1.27,1.30,+0.04,3.17,137000,3,176030,0,0,0,0,0,0,69000,68000,1000,1000
20200528,710674,原相凱基9A購06,0.84,0.84,0.79,0.79,0.00,0.0,52000,14,42480,0,0,0,0,0,0,22000,30000,-8000,-8000
20200528,710675,群聯凱基9B購04,0.94,0.94,0.94,0.94,0.00,0.0,60000,1,56400,0,0,0,0,0,0,60000,0,60000,60000
20200528,710676,精測凱基9A購04,0.82,0.82,0.82,0.82,-0.05,-5.75,2000,1,1640,0,0,0,0,0,0,2000,0,2000,2000
20200528,710677,聯亞凱基9A購02,,,,,,0.00,0,0,0,0,0,0,0,0,0,0,0,0,0
20200528,710678,穩懋凱基9A購04,,,,,,0.00,0,0,0,0,0,0,0,0,0,0,0,0,0
20200528,710679,譜瑞凱基9A購03,1.91,1.91,1.91,1.91,-0.09,-4.5,10000,1,19100,0,0,0,0,0,0,0,10000,-10000,-10000
20200528,710680,雙鴻第一9B購01,,,,,,0.00,0,0,0,0,0,0,0,0,0,0,0,0,0
20200528,710681,泰博中信9B購01,2.85,2.85,2.85,2.85,+0.08,2.89,1000,1,2850,0,0,0,0,0,0,0,0,0,0
20200528,710682,精測中信9A購03,0.72,0.72,0.72,0.72,-0.03,-4.0,4000,1,2880,0,0,0,0,0,0,0,4000,-4000,-4000
20200528,710683,弘塑永豐9A購03,,,,,,0.00,0,0,0,0,0,0,0,0,0,0,0,0,0
20200528,710684,旺矽永豐9A購02,1.61,1.61,1.61,1.61,-0.03,-1.83,3000,1,4830,0,0,0,0,0,0,3000,0,3000,3000
20200528,710685,業強永豐9A購02,0.53,0.53,0.53,0.53,+0.01,1.92,60000,1,31800,0,0,0,0,0,0,60000,0,60000,60000
20200528,710686,中美晶麥證9A購01,,,,,,0.00,0,0,0,0,0,0,0,0,0,0,0,0,0
20200528,710687,威剛麥證9B購01,,,,,,0.00,0,0,0,0,0,0,0,0,0,0,0,0,0
20200528,710688,博智統一9A購01,0.54,0.54,0.54,0.54,-0.03,-5.26,50000,2,27000,0,0,0,0,0,0,0,50000,-50000,-50000
20200528,710689,博智統一9A購02,0.73,0.73,0.73,0.73,-0.04,-5.19,4000,1,2920,0,0,0,0,0,0,0,4000,-4000,-4000
20200528,710690,環球晶統一9C購01,0.86,0.86,0.84,0.84,0.00,0.0,110000,3,92600,0,0,0,0,0,0,100000,10000,90000,90000
20200528,710691,群聯國泰9C購01,1.60,1.60,1.51,1.51,-0.05,-3.21,203000,11,318190,0,0,0,0,0,0,147000,56000,91000,91000
20200528,710692,精測國泰9C購02,1.98,2.01,1.82,1.84,-0.10,-5.15,247000,16,473450,0,0,0,0,0,0,152000,95000,57000,57000
20200528,710693,優群國泰9B購01,2.06,2.11,1.84,2.04,-0.08,-3.77,562000,38,1142010,0,0,0,0,0,0,363000,190000,173000,173000
20200528,710694,晟德兆豐9B購01,1.93,1.96,1.85,1.85,-0.15,-7.5,125000,19,240170,0,0,0,0,0,0,10000,115000,-105000,-105000
20200528,710695,鈊象兆豐9B購01,0.96,1.19,0.96,1.19,+0.27,29.35,347000,25,366500,0,0,0,0,0,0,57000,298000,-241000,-241000
20200528,710696,大江元大9A購05,1.44,1.51,1.44,1.51,+0.07,4.86,108000,3,155940,0,0,0,0,0,0,100000,8000,92000,92000
20200528,710697,信驊元大9A購05,,,,,,0.00,0,0,0,0,0,0,0,0,0,0,0,0,0
20200528,710698,雍智元大9A購01,2.92,2.92,2.61,2.61,-0.25,-8.74,110000,6,309660,0,0,0,0,0,0,55000,55000,0,0
20200528,710699,優群元大9A購03,3.17,3.25,2.95,3.17,+0.25,8.56,125000,14,388070,0,0,0,0,0,0,67000,100000,-33000,-33000
20200528,710700,雙美元大9A購01,2.23,2.33,2.20,2.26,+0.06,2.73,743000,41,1686040,0,0,0,0,0,0,423000,350000,73000,73000
20200528,710701,鈊象元大9A購05,2.15,2.57,2.15,2.48,+0.49,24.62,280000,23,664710,0,0,0,0,0,0,61000,249000,-188000,-188000
20200528,710702,鈺太元大9A購02,1.40,1.42,1.24,1.25,-0.17,-11.97,378000,20,516840,0,0,0,0,0,0,340000,97000,243000,243000
20200528,710703,信驊群益9A購02,3.11,3.11,2.89,2.89,+0.14,5.09,36000,3,111140,0,0,0,0,0,0,0,36000,-36000,-36000
20200528,710704,泰博群益9A購02,4.82,5.70,4.82,5.60,+0.90,19.15,25000,7,125150,0,0,0,0,0,0,2000,23000,-21000,-21000
20200528,710705,精測群益9A購02,2.06,2.06,1.94,1.94,-0.09,-4.43,207000,5,411120,0,0,0,0,0,0,135000,72000,63000,63000
20200528,710706,精測永豐9A購03,1.20,1.20,1.20,1.20,-0.01,-0.83,27000,1,32400,0,0,0,0,0,0,27000,0,27000,27000
20200528,710707,璟德永豐9A購01,1.02,1.02,1.02,1.02,-0.06,-5.56,68000,1,69360,0,0,0,0,0,0,0,68000,-68000,-68000
20200528,710708,晟德永豐9A購01,1.85,1.86,1.72,1.72,-0.13,-7.03,172000,18,311430,0,0,0,0,0,0,158000,14000,144000,144000
20200528,710709,頎邦永豐9A購02,1.14,1.14,1.09,1.09,0.00,0.0,82000,2,90080,0,0,0,0,0,0,14000,68000,-54000,-54000
20200528,710710,群聯麥證9A購01,,,,,,0.00,0,0,0,0,0,0,0,0,0,0,0,0,0
20200528,710711,穩懋統一9A購04,0.49,0.49,0.49,0.49,-0.01,-2.0,50000,1,24500,0,0,0,0,0,0,50000,0,50000,50000
20200528,710712,M31凱基9A購03,1.45,1.47,1.27,1.29,-0.17,-11.64,302000,21,426620,0,0,0,0,0,0,276000,52000,224000,224000
20200528,710713,弘塑凱基9B購01,0.93,0.93,0.93,0.93,-0.09,-8.82,30000,2,27900,0,0,0,0,0,0,20000,10000,10000,10000
20200528,710714,環球晶凱基9B購03,,,,,,0.00,0,0,0,0,0,0,0,0,0,0,0,0,0
20200528,710715,穩懋凱基9A購05,0.94,0.96,0.94,0.96,-0.02,-2.04,6000,2,5700,0,0,0,0,0,0,3000,3000,0,0
20200528,710716,凡甲永豐9A購03,0.90,0.90,0.86,0.86,-0.04,-4.44,268000,13,237810,0,0,0,0,0,0,258000,10000,248000,248000
20200528,710717,宏捷科永豐9B購01,0.86,0.87,0.86,0.87,-0.07,-7.45,152000,2,130870,0,0,0,0,0,0,152000,0,152000,152000
20200528,710718,良維永豐9A購01,1.01,1.01,0.98,0.98,-0.04,-3.92,94000,2,94640,0,0,0,0,0,0,94000,0,94000,94000
20200528,710719,南光永豐9A購01,,,,,,0.00,0,0,0,0,0,0,0,0,0,0,0,0,0
20200528,710720,優群永豐9A購03,1.38,1.38,1.38,1.38,+0.23,20.0,10000,1,13800,0,0,0,0,0,0,0,10000,-10000,-10000
20200528,710721,威剛統一9C購02,0.99,0.99,0.93,0.93,-0.02,-2.11,207000,6,203770,0,0,0,0,0,0,202000,5000,197000,197000
20200528,710722,宏捷科凱基9B購02,1.22,1.22,1.21,1.21,-0.01,-0.82,88000,2,106560,0,0,0,0,0,0,80000,8000,72000,72000
20200528,710723,原相凱基9B購02,2.77,2.77,2.69,2.70,+0.13,5.06,65000,16,177480,0,0,0,0,0,0,65000,0,65000,65000
20200528,710724,精測凱基9A購05,1.29,1.29,1.21,1.21,-0.05,-3.97,331000,18,408190,0,0,0,0,0,0,114000,207000,-93000,-93000
20200528,710725,優群凱基9B購01,1.28,1.28,1.10,1.22,+0.07,6.09,1249000,141,1506200,0,0,0,0,0,0,98000,1127000,-1029000,-1029000
20200528,710726,頎邦凱基9A購01,2.20,2.21,2.14,2.14,-0.06,-2.73,180000,3,397180,0,0,0,0,0,0,174000,6000,168000,168000
20200528,710727,凡甲元大9B購01,1.10,1.13,1.07,1.07,-0.05,-4.46,100000,10,109010,0,0,0,0,0,0,93000,4000,89000,89000
20200528,710728,弘塑元大9B購02,1.18,1.18,1.11,1.11,-0.11,-9.02,269000,7,305620,0,0,0,0,0,0,264000,5000,259000,259000
20200528,710729,宏捷科元大9A購02,2.83,2.87,2.70,2.70,-0.22,-7.53,137000,17,381880,0,0,0,0,0,0,93000,44000,49000,49000
20200528,710730,威剛元大9B購03,1.01,1.01,0.95,0.95,-0.02,-2.06,209000,10,205800,0,0,0,0,0,0,204000,41000,163000,163000
20200528,710731,網龍元大9A購03,,,,,,0.00,0,0,0,0,0,0,0,0,0,0,0,0,0
20200528,710732,雙鴻元大9C購03,1.02,1.03,1.01,1.01,0.00,0.0,229000,9,232840,0,0,0,0,0,0,109000,124000,-15000,-15000
20200528,710733,鈊象元大9A購06,1.73,2.12,1.73,2.05,+0.39,23.49,690000,40,1380010,50000,0,50000,0,0,0,187000,544000,-357000,-307000
20200528,710734,精測兆豐9B購01,0.63,0.63,0.62,0.62,-0.01,-1.59,420000,2,262490,0,0,0,0,0,0,209000,211000,-2000,-2000
20200528,710735,鈺太兆豐9B購01,1.18,1.21,1.07,1.07,-0.13,-10.83,87000,7,102340,0,0,0,0,0,0,64000,23000,41000,41000
20200528,710736,宏捷科群益9A購02,1.16,1.17,1.14,1.14,-0.02,-1.72,287000,17,331020,0,0,0,0,0,0,287000,0,287000,287000
20200528,710737,璟德群益9A購01,,,,,,0.00,0,0,0,0,0,0,0,0,0,0,0,0,0
20200528,710738,宏捷科國票9A購04,,,,,,0.00,0,0,0,0,0,0,0,0,0,0,0,0,0
20200528,710739,南光國票9A購01,2.27,2.27,2.24,2.24,-0.20,-8.2,48000,2,107820,0,0,0,0,0,0,38000,10000,28000,28000
20200528,710740,優群國票9A購03,5.70,5.95,5.70,5.95,+0.70,13.33,76000,5,440350,0,0,0,0,0,0,49000,27000,22000,22000
20200528,710741,雙美國票9A購01,2.06,2.06,2.06,2.06,-0.07,-3.29,1000,1,2060,0,0,0,0,0,0,1000,0,1000,1000
20200528,710742,聯亞中信9A購01,,,,,,0.00,0,0,0,0,0,0,0,0,0,0,0,0,0
20200528,710743,大學光元大9A購02,,,,,,0.00,0,0,0,0,0,0,0,0,0,0,0,0,0
20200528,710744,太醫元大9A購01,0.99,0.99,0.95,0.95,-0.05,-5.0,105000,10,102010,0,0,0,0,0,0,99000,6000,93000,93000
20200528,710745,宏捷科元大9A購03,2.32,2.34,2.24,2.24,-0.08,-3.45,163000,15,375730,0,0,0,0,0,0,85000,78000,7000,7000
20200528,710746,良維元大9A購02,1.92,1.92,1.87,1.87,0.00,0.0,13000,4,24840,0,0,0,0,0,0,10000,3000,7000,7000
20200528,710747,信昌電元大9A購01,1.36,1.36,1.27,1.27,-0.08,-5.93,198000,11,266760,0,0,0,0,0,0,175000,23000,152000,152000
20200528,710748,是方元大9A購01,2.92,2.92,2.67,2.88,0.00,0.0,117000,14,329190,1000,0,1000,0,0,0,59000,58000,1000,2000
20200528,710749,順達元大9A購01,2.67,2.72,2.36,2.39,-0.30,-11.15,196000,12,491500,0,0,0,0,0,0,65000,159000,-94000,-94000
20200528,710750,群聯元大9B購01,1.19,1.19,1.12,1.12,-0.05,-4.27,401000,16,461170,0,0,0,0,0,0,401000,130000,271000,271000
20200528,710751,璟德元大9A購01,1.58,1.58,1.55,1.55,-0.03,-1.9,7000,2,11000,0,0,0,0,0,0,0,7000,-7000,-7000
20200528,710752,鈊象元大9A購07,2.47,3.08,2.47,2.98,+0.60,25.21,218000,16,611700,0,0,0,0,0,0,50000,197000,-147000,-147000
20200528,710753,鈺太元大9A購03,1.84,1.88,1.65,1.65,-0.25,-13.16,259000,17,463770,0,0,0,0,0,0,256000,185000,71000,71000
20200528,710754,精測富邦9B購01,,,,,,0.00,0,0,0,0,0,0,0,0,0,0,0,0,0
20200528,710755,良維群益9A購01,1.58,1.58,1.58,1.58,+0.03,1.94,19000,1,30020,0,0,0,0,0,0,19000,0,19000,19000
20200528,710756,順達群益9B購01,4.04,4.04,3.57,3.57,-0.50,-12.29,81000,12,310880,0,0,0,0,0,0,80000,38000,42000,42000
20200528,710757,頎邦群益9B購01,2.90,2.91,2.79,2.79,-0.06,-2.11,251000,9,727140,0,0,0,0,0,0,220000,40000,180000,180000
20200528,710758,凡甲國票9A購02,2.49,2.49,2.29,2.34,-0.08,-3.31,579000,31,1357750,0,0,0,0,0,0,202000,377000,-175000,-175000
20200528,710759,優群國票9A購04,2.50,2.67,2.50,2.67,+0.17,6.8,80000,4,206800,0,0,0,0,0,0,0,80000,-80000,-80000
20200528,710760,頎邦國票9A購01,5.15,5.20,5.05,5.05,+0.10,2.02,4000,3,20550,0,0,0,0,0,0,4000,0,4000,4000
20200528,710761,穩懋中信9A購01,,,,,,0.00,0,0,0,0,0,0,0,0,0,0,0,0,0
20200528,710762,穩懋中信9C購01,,,,,,0.00,0,0,0,0,0,0,0,0,0,0,0,0,0
20200528,710763,頎邦中信9A購01,1.05,1.05,1.00,1.00,-0.01,-0.99,22000,3,22750,0,0,0,0,0,0,22000,0,22000,22000
20200528,710764,良維凱基9B購01,0.99,0.99,0.96,0.96,-0.07,-6.8,34000,4,32980,0,0,0,0,0,0,14000,10000,4000,4000
20200528,710765,大學光永豐9A購03,,,,,,0.00,0,0,0,0,0,0,0,0,0,0,0,0,0
20200528,710766,泰博永豐9A購03,2.79,3.35,2.75,3.17,+0.52,19.62,208000,11,607710,0,0,0,0,0,0,58000,150000,-92000,-92000
20200528,710767,雙鴻永豐9B購01,0.88,0.88,0.88,0.88,-0.03,-3.3,33000,2,29040,0,0,0,0,0,0,16000,17000,-1000,-1000
20200528,710768,中美晶統一9C購01,0.92,0.92,0.90,0.90,0.00,0.0,92000,5,83220,0,0,0,0,0,0,15000,77000,-62000,-62000
20200528,710769,宏捷科統一9C購01,0.92,0.94,0.88,0.88,-0.05,-5.38,283000,14,259430,0,0,0,0,0,0,247000,36000,211000,211000
20200528,710770,中美晶兆豐9B購01,1.02,1.02,0.99,1.00,-0.02,-1.96,25000,4,25050,0,0,0,0,0,0,0,25000,-25000,-25000
20200528,710771,金可兆豐9A購01,1.36,1.38,1.31,1.31,+0.02,1.55,423000,7,575430,0,0,0,0,0,0,60000,363000,-303000,-303000
20200528,710772,穩懋兆豐9B購02,1.43,1.43,1.42,1.43,0.00,0.0,123000,5,175460,0,0,0,0,0,0,79000,44000,35000,35000
20200528,710773,大學光元大9A購03,,,,,,0.00,0,0,0,0,0,0,0,0,0,0,0,0,0
20200528,710774,新普元大9A購02,1.71,1.81,1.68,1.81,+0.15,9.04,898000,52,1591560,0,0,0,0,0,0,61000,851000,-790000,-790000
20200528,710775,雍智元大9A購02,1.93,1.94,1.73,1.73,-0.31,-15.2,90000,5,170200,0,0,0,0,0,0,15000,75000,-60000,-60000
20200528,710776,精華元大9A購01,2.07,2.13,2.04,2.04,-0.03,-1.45,30000,3,61800,0,0,0,0,0,0,16000,14000,2000,2000
20200528,710777,聚積元大9A購02,,,,,,0.00,0,0,0,0,0,0,0,0,0,0,0,0,0
20200528,710778,璟德元大9A購02,2.18,2.18,2.11,2.17,-0.07,-3.13,90000,6,194840,0,0,0,0,0,0,83000,7000,76000,76000
20200528,710779,頎邦元大9A購03,3.65,3.72,3.58,3.58,+0.04,1.13,62000,4,224060,0,0,0,0,0,0,0,52000,-52000,-52000
20200528,710780,群聯群益9A購03,0.90,0.90,0.90,0.90,-0.05,-5.26,31000,1,27900,0,0,0,0,0,0,31000,0,31000,31000
20200528,710781,大學光凱基9A購05,3.16,3.32,2.90,2.90,-0.22,-7.05,143000,32,453960,0,0,0,0,0,0,79000,61000,18000,18000
20200528,710782,精測凱基9A購07,,,,,,0.00,0,0,0,0,0,0,0,0,0,0,0,0,0
20200528,710783,優群凱基9A購05,0.87,0.92,0.78,0.87,+0.06,7.41,101000,11,85300,0,0,0,0,0,0,57000,44000,13000,13000
20200528,710784,寶雅凱基9A購02,1.80,1.80,1.70,1.72,-0.20,-10.42,138000,5,237520,0,0,0,0,0,0,138000,0,138000,138000
20200528,710785,鈊象凱基9B購02,2.64,3.12,2.64,3.11,+0.58,22.92,100000,8,291830,0,0,0,0,0,0,70000,73000,-3000,-3000
20200528,710786,神盾中信9C購01,0.89,0.89,0.81,0.83,-0.05,-5.68,113000,14,96120,5000,0,5000,0,0,0,80000,33000,47000,52000
20200528,710787,世界國票9A購01,3.81,3.81,3.55,3.55,-0.15,-4.05,74000,3,272060,0,0,0,0,0,0,74000,0,74000,74000
20200528,710788,良維國票9A購02,4.45,4.45,4.45,4.45,-0.03,-0.67,20000,1,89000,0,0,0,0,0,0,0,20000,-20000,-20000
20200528,710789,信驊國票9A購04,3.52,3.52,3.52,3.52,+0.01,0.28,4000,2,14080,0,0,0,0,0,0,0,4000,-4000,-4000
20200528,710790,原相國票9C購01,2.28,2.28,2.09,2.09,-0.19,-8.33,101000,10,221980,0,0,0,0,0,0,99000,2000,97000,97000
20200528,710791,泰博國票9A購04,13.30,14.70,13.20,14.70,+2.90,24.58,17000,5,239700,0,0,0,0,0,0,4000,13000,-9000,-9000
20200528,710792,聖暉國票9A購02,2.26,2.33,2.26,2.33,+0.03,1.3,391000,5,889750,0,0,0,0,0,0,300000,91000,209000,209000
20200528,710793,璟德國票9A購01,,,,,,0.00,0,0,0,0,0,0,0,0,0,0,0,0,0
20200528,710794,雙美國票9A購02,2.01,2.11,2.01,2.09,+0.09,4.5,135000,4,281610,0,0,0,0,0,0,130000,135000,-5000,-5000
20200528,710795,原相元大9B購05,1.11,1.11,0.97,0.97,-0.09,-8.49,141000,16,148990,0,0,0,0,0,0,116000,39000,77000,77000
20200528,710796,優群元大9A購04,2.00,2.00,1.83,1.95,+0.26,15.38,238000,20,462080,0,0,0,0,0,0,96000,142000,-46000,-46000
20200528,710797,雙鴻元大9B購02,0.90,0.91,0.89,0.91,-0.01,-1.09,151000,6,135590,0,0,0,0,0,0,101000,50000,51000,51000
20200528,710798,頎邦元大9A購04,3.32,3.32,3.30,3.30,+0.15,4.76,38000,2,125600,0,0,0,0,0,0,38000,0,38000,38000
20200528,710799,網龍群益9A購02,3.50,3.82,3.44,3.44,-0.06,-1.71,290000,12,1050390,0,0,0,0,0,0,16000,279000,-263000,-263000
20200528,710800,磐亞群益9A購01,0.87,0.87,0.87,0.87,+0.02,2.35,60000,1,52200,0,0,0,0,0,0,60000,0,60000,60000
20200528,710801,鈺太群益9A購02,2.24,2.24,1.98,1.98,-0.25,-11.21,133000,6,283340,0,0,0,0,0,0,40000,133000,-93000,-93000
20200528,710802,金居凱基9A購02,1.94,1.94,1.83,1.83,-0.13,-6.63,71000,4,136830,0,0,0,0,0,0,71000,10000,61000,61000
20200528,710803,信驊凱基9A購04,1.85,1.99,1.77,1.81,+0.08,4.62,317000,11,589860,0,0,0,0,0,0,178000,139000,39000,39000
20200528,710804,鈊象凱基9A購04,,,,,,0.00,0,0,0,0,0,0,0,0,0,0,0,0,0
20200528,710805,精測統一9B購02,0.83,0.83,0.77,0.77,-0.06,-7.23,302000,11,244150,0,0,0,0,0,0,134000,168000,-34000,-34000
20200528,710806,久元永豐9A購01,2.18,2.18,1.84,1.86,+0.06,3.33,206000,17,428220,0,0,0,0,0,0,121000,91000,30000,30000
20200528,710807,亞泰永豐9A購01,0.93,0.94,0.92,0.93,-0.03,-3.12,632000,16,588330,0,0,0,0,0,0,632000,0,632000,632000
20200528,710808,宜特永豐9A購02,1.84,2.00,1.84,1.98,+0.06,3.12,801000,20,1543110,0,0,0,0,0,0,685000,86000,599000,599000
20200528,710809,信驊永豐9A購01,1.28,1.36,1.22,1.22,+0.03,2.52,480000,17,634240,0,0,0,0,0,0,80000,398000,-318000,-318000
20200528,710810,威剛永豐9A購03,0.94,0.94,0.94,0.94,+0.02,2.17,10000,1,9400,0,0,0,0,0,0,10000,0,10000,10000
20200528,710811,原相永豐9B購01,0.88,0.88,0.88,0.88,+0.01,1.15,23000,5,20240,0,0,0,0,0,0,23000,0,23000,23000
20200528,710812,聖暉永豐9A購01,0.90,0.90,0.90,0.90,+0.01,1.12,10000,1,9000,0,0,0,0,0,0,0,10000,-10000,-10000
20200528,710813,網家永豐9A購03,1.49,1.49,1.45,1.45,-0.06,-3.97,33000,4,48680,0,0,0,0,0,0,32000,1000,31000,31000
20200528,710814,網龍永豐9A購04,1.85,1.97,1.85,1.94,+0.17,9.6,139000,12,263830,0,0,0,0,0,0,2000,137000,-135000,-135000
20200528,710815,雙美永豐9A購02,1.40,1.47,1.40,1.47,+0.08,5.76,439000,14,631270,0,0,0,0,0,0,257000,374000,-117000,-117000
20200528,710816,雙鴻永豐9A購03,0.82,0.86,0.81,0.81,-0.07,-7.95,227000,5,189140,0,0,0,0,0,0,53000,174000,-121000,-121000
20200528,710817,群聯國票9A購03,4.36,4.55,4.36,4.43,-0.17,-3.7,66000,17,288190,0,0,0,0,0,0,66000,66000,0,0
20200528,710818,雙鴻富邦9B購02,0.59,0.60,0.59,0.60,+0.03,5.26,214000,3,126270,0,0,0,0,0,0,0,213000,-213000,-213000
20200528,710819,原相元大9B購06,1.98,1.99,1.74,1.74,-0.16,-8.42,282000,23,536890,0,0,0,0,0,0,277000,20000,257000,257000
20200528,710820,泰博元大9A購04,4.58,5.10,4.52,5.10,+0.69,15.65,51000,8,245170,0,0,0,0,0,0,28000,23000,5000,5000
20200528,710821,櫃200元大9A購02,4.00,4.00,4.00,4.00,-0.19,-4.53,6000,1,24000,0,0,0,0,0,0,0,6000,-6000,-6000
20200528,710822,凡甲群益9A購02,1.99,1.99,1.88,1.89,-0.06,-3.08,701000,21,1337540,0,0,0,0,0,0,592000,105000,487000,487000
20200528,710823,大江群益9A購02,2.31,2.31,2.31,2.31,+0.02,0.87,1000,1,2310,0,0,0,0,0,0,1000,0,1000,1000
20200528,710824,新鉅科群益9A購03,2.44,2.44,2.24,2.24,-0.16,-6.67,214000,18,500450,0,0,0,0,0,0,202000,12000,190000,190000
20200528,710825,群聯群益9A購04,2.07,2.08,1.98,1.98,-0.10,-4.81,38000,5,78540,0,0,0,0,0,0,35000,38000,-3000,-3000
20200528,710826,聚積群益9A購01,1.40,1.40,1.40,1.40,+0.03,2.19,10000,1,14000,0,0,0,0,0,0,0,10000,-10000,-10000
20200528,710827,優群群益9A購02,2.97,3.13,2.77,3.01,+0.45,17.58,104000,13,309160,0,0,0,0,0,0,38000,66000,-28000,-28000
20200528,710828,鈊象群益9A購06,2.67,3.34,2.67,3.22,+0.69,27.27,381000,25,1176630,0,0,0,0,0,0,102000,331000,-229000,-229000
20200528,710829,宜鼎國票9A購01,3.68,3.83,3.68,3.72,+0.27,7.83,69000,9,260460,0,0,0,0,0,0,5000,69000,-64000,-64000
20200528,710830,網龍國票9A購01,4.89,5.25,4.89,5.25,+0.52,10.99,73000,15,368680,0,0,0,0,0,0,10000,73000,-63000,-63000
20200528,710831,宜鼎中信9B購01,0.78,0.81,0.78,0.80,+0.04,5.26,310000,4,248000,0,0,0,0,0,0,310000,0,310000,310000
20200528,710832,信驊中信9A購01,1.18,1.25,1.13,1.13,+0.05,4.63,62000,12,72510,0,0,0,0,0,0,46000,16000,30000,30000
20200528,710833,群聯中信9C購02,0.66,0.66,0.66,0.66,-0.02,-2.94,50000,1,33000,0,0,0,0,0,0,50000,0,50000,50000
20200528,710834,中美晶凱基9A購06,2.58,2.58,2.51,2.51,-0.09,-3.46,44000,2,110510,0,0,0,0,0,0,1000,43000,-42000,-42000
20200528,710835,宏捷科凱基9A購06,1.78,1.78,1.76,1.76,-0.06,-3.3,20000,2,35400,0,0,0,0,0,0,20000,0,20000,20000
20200528,710836,是方凱基9A購01,2.11,2.11,1.91,2.03,0.00,0.0,283000,14,589630,0,0,0,0,0,0,256000,27000,229000,229000
20200528,710837,碩禾凱基9A購02,,,,,,0.00,0,0,0,0,0,0,0,0,0,0,0,0,0
20200528,710838,精測凱基9B購01,1.54,1.54,1.52,1.52,-0.05,-3.18,134000,4,205000,0,0,0,0,0,0,66000,68000,-2000,-2000
20200528,710839,網家凱基9A購02,2.27,2.27,2.11,2.11,-0.20,-8.66,18000,5,39640,0,0,0,0,0,0,0,18000,-18000,-18000
20200528,710840,環球晶凱基9A購05,2.84,2.84,2.84,2.84,+0.06,2.16,35000,1,99400,0,0,0,0,0,0,35000,0,35000,35000
20200528,710841,穩懋凱基9A購07,,,,,,0.00,0,0,0,0,0,0,0,0,0,0,0,0,0
20200528,710842,鈊象凱基9B購03,0.93,1.05,0.93,1.05,+0.20,23.53,98000,2,95940,0,0,0,0,0,0,98000,40000,58000,58000
20200528,710843,原相麥證9A購01,1.14,1.16,1.11,1.11,+0.07,6.73,15000,12,17130,15000,0,15000,0,0,0,15000,0,15000,15000
20200528,710844,直得永豐9A購01,1.45,1.51,1.08,1.11,-0.25,-18.38,1033000,92,1287420,0,0,0,0,0,0,326000,689000,-363000,-363000
20200528,710845,是方永豐9A購02,1.50,1.50,1.41,1.50,+0.03,2.04,60000,7,87930,0,0,0,0,0,0,50000,10000,40000,40000
20200528,710846,群聯元大9B購02,3.10,3.11,2.95,2.95,-0.11,-3.59,74000,5,222770,0,0,0,0,0,0,34000,42000,-8000,-8000
20200528,710847,精測元大9B購01,1.45,1.45,1.38,1.38,-0.06,-4.17,102000,4,143070,0,0,0,0,0,0,81000,82000,-1000,-1000
20200528,710848,網家元大9B購01,1.73,1.73,1.61,1.61,-0.07,-4.17,292000,15,493550,0,0,0,0,0,0,161000,147000,14000,14000
20200528,710849,鈊象元大9B購06,2.02,2.45,2.02,2.36,+0.49,26.2,214000,14,484400,0,0,0,0,0,0,30000,214000,-184000,-184000
20200528,710850,鈊象元大9C購02,1.23,1.42,1.22,1.38,+0.26,23.21,138000,21,181980,0,0,0,0,0,0,63000,116000,-53000,-53000
20200528,710851,力旺永豐9B購01,2.04,2.10,1.99,1.99,-0.19,-8.72,180000,18,368830,0,0,0,0,0,0,140000,40000,100000,100000
20200528,710852,宇峻永豐9B購02,0.67,0.70,0.67,0.70,+0.07,11.11,196000,6,135750,0,0,0,0,0,0,0,196000,-196000,-196000
20200528,710853,建榮永豐9B購03,1.63,1.66,1.63,1.66,0.00,0.0,73000,2,119380,0,0,0,0,0,0,60000,13000,47000,47000
20200528,710854,神盾永豐9C購01,0.97,0.97,0.96,0.96,-0.02,-2.04,15000,2,14490,0,0,0,0,0,0,15000,15000,0,0
20200528,710855,神準永豐9B購01,0.72,0.72,0.67,0.67,-0.04,-5.63,255000,3,175800,0,0,0,0,0,0,255000,0,255000,255000
20200528,710856,廣明永豐9B購01,,,,,,0.00,0,0,0,0,0,0,0,0,0,0,0,0,0
20200528,710857,優群永豐9B購01,1.00,1.04,0.88,0.98,+0.15,18.07,276000,30,269470,0,0,0,0,0,0,66000,210000,-144000,-144000
20200528,710858,聯亞永豐9B購01,0.75,0.78,0.75,0.78,0.00,0.0,220000,3,171300,0,0,0,0,0,0,10000,210000,-200000,-200000
20200528,710859,威剛國票9B購01,1.08,1.08,1.08,1.08,0.00,0.0,70000,1,75600,0,0,0,0,0,0,70000,0,70000,70000
20200528,710860,原相國票9C購02,2.69,2.69,2.38,2.38,-0.32,-11.85,129000,10,330840,0,0,0,0,0,0,129000,0,129000,129000
20200528,710861,網家國票9B購01,2.87,2.87,2.87,2.87,-0.33,-10.31,5000,1,14350,0,0,0,0,0,0,0,5000,-5000,-5000
20200528,710862,雙鴻國票9B購01,1.41,1.45,1.41,1.41,+0.05,3.68,44000,4,62880,0,0,0,0,0,0,2000,44000,-42000,-42000
20200528,710863,神盾麥證9C購01,0.65,0.65,0.65,0.65,-0.02,-2.99,3000,1,1950,0,3000,-3000,0,0,0,0,3000,-3000,-3000
20200528,710864,群聯麥證9B購02,1.57,1.57,1.54,1.55,+0.01,0.65,40000,4,62000,30000,10000,20000,0,0,0,30000,30000,0,0
20200528,710865,大江凱基9C購01,,,,,,0.00,0,0,0,0,0,0,0,0,0,0,0,0,0
20200528,710866,信昌電凱基9B購01,0.99,0.99,0.99,0.99,-0.02,-1.98,32000,2,31680,0,0,0,0,0,0,32000,0,32000,32000
20200528,710867,原相凱基9B購03,2.25,2.25,2.11,2.11,-0.07,-3.21,68000,20,150740,0,0,0,0,0,0,66000,2000,64000,64000
20200528,710868,群聯凱基9B購05,,,,,,0.00,0,0,0,0,0,0,0,0,0,0,0,0,0
20200528,710869,璟德凱基9B購01,0.93,0.94,0.92,0.94,-0.06,-6.0,80000,3,74900,0,0,0,0,0,0,0,80000,-80000,-80000
20200528,710870,大學光群益9B購01,7.75,8.00,7.75,7.90,+0.10,1.28,74000,15,582900,0,0,0,0,0,0,74000,20000,54000,54000
20200528,710871,中美晶群益9B購02,,,,,,0.00,0,0,0,0,0,0,0,0,0,0,0,0,0
20200528,710872,是方群益9B購01,2.35,2.35,2.12,2.28,+0.07,3.17,18000,4,38610,0,0,0,0,0,0,15000,3000,12000,12000
20200528,710873,原相群益9B購02,1.54,1.56,1.32,1.32,-0.18,-12.0,917000,47,1317790,0,0,0,0,0,0,785000,132000,653000,653000
20200528,710874,神盾群益9C購01,1.29,1.29,1.17,1.18,-0.08,-6.35,372000,19,460720,0,0,0,0,0,0,326000,41000,285000,285000
20200528,710875,環球晶群益9B購01,,,,,,0.00,0,0,0,0,0,0,0,0,0,0,0,0,0
20200528,710876,環球晶群益9B購02,1.41,1.41,1.38,1.38,+0.06,4.55,136000,2,189180,0,0,0,0,0,0,50000,86000,-36000,-36000
20200528,710877,聯亞群益9B購01,2.39,2.39,2.39,2.39,0.00,0.0,84000,2,200760,0,0,0,0,0,0,0,84000,-84000,-84000
20200528,710878,晟德群益9B購01,2.84,2.84,2.59,2.59,-0.29,-10.07,269000,34,745980,0,0,0,0,0,0,250000,3000,247000,247000
20200528,710879,神盾國泰01購01,1.59,1.59,1.44,1.45,-0.10,-6.45,538000,37,816940,0,0,0,0,0,0,389000,190000,199000,199000
20200528,710880,信昌電群益9B購01,1.92,1.92,1.80,1.80,-0.18,-9.09,214000,17,400260,0,0,0,0,0,0,188000,71000,117000,117000
20200528,710881,原相群益9B購03,1.55,1.57,1.34,1.34,-0.22,-14.1,331000,26,491990,0,0,0,0,0,0,251000,80000,171000,171000
20200528,710882,泰博群益9B購02,2.14,2.61,2.14,2.54,+0.55,27.64,64000,10,151860,0,0,0,0,0,0,25000,35000,-10000,-10000
20200528,710883,群聯群益9B購01,2.38,2.42,2.26,2.29,-0.09,-3.78,402000,21,953330,0,0,0,0,0,0,269000,184000,85000,85000
20200528,710884,精測群益9B購01,,,,,,0.00,0,0,0,0,0,0,0,0,0,0,0,0,0
20200528,710885,譜瑞群益9B購01,,,,,,0.00,0,0,0,0,0,0,0,0,0,0,0,0,0
20200528,710886,六角凱基9B購01,1.07,1.09,1.06,1.06,-0.03,-2.75,75000,5,79950,0,0,0,0,0,0,75000,0,75000,75000
20200528,710887,建榮凱基9B購02,,,,,,0.00,0,0,0,0,0,0,0,0,0,0,0,0,0
20200528,710888,網家凱基9B購01,1.38,1.38,1.27,1.27,-0.16,-11.19,19000,3,25710,0,0,0,0,0,0,16000,13000,3000,3000
20200528,710889,廣明凱基9B購01,,,,,,0.00,0,0,0,0,0,0,0,0,0,0,0,0,0
20200528,710890,聯亞統一9C購01,0.74,0.74,0.71,0.71,-0.02,-2.74,548000,5,393260,0,0,0,0,0,0,402000,146000,256000,256000
20200528,710891,穩懋統一9C購03,1.23,1.23,1.23,1.23,0.00,0.0,49000,1,60270,0,0,0,0,0,0,49000,0,49000,49000
20200528,710892,大江國票9B購01,4.68,4.93,4.68,4.93,-0.03,-0.6,43000,6,208890,0,0,0,0,0,0,4000,39000,-35000,-35000
20200528,710893,宇峻國票9B購02,0.71,0.74,0.68,0.68,+0.02,3.03,432000,7,309360,0,0,0,0,0,0,0,432000,-432000,-432000
20200528,710894,是方國票9B購01,4.89,5.40,4.89,5.40,+0.15,2.86,24000,8,122990,0,0,0,0,0,0,16000,8000,8000,8000
20200528,710895,群聯國票9B購01,6.15,6.15,5.75,5.75,-0.15,-2.54,13000,10,76900,0,0,0,0,0,0,13000,13000,0,0
20200528,710896,聯亞國票9B購01,2.86,2.95,2.81,2.81,-0.28,-9.06,72000,7,210130,0,0,0,0,0,0,10000,62000,-52000,-52000
20200528,710897,雙美國票9B購02,,,,,,0.00,0,0,0,0,0,0,0,0,0,0,0,0,0
20200528,710898,鈊象國票9B購03,2.85,3.47,2.85,3.38,+0.77,29.5,96000,16,314630,0,0,0,0,0,0,50000,96000,-46000,-46000
20200528,710899,凡甲元大9B購02,2.52,2.52,2.36,2.36,-0.10,-4.07,192000,15,474960,0,0,0,0,0,0,167000,25000,142000,142000
20200528,710900,威剛元大9C購01,,,,,,0.00,0,0,0,0,0,0,0,0,0,0,0,0,0
20200528,710901,是方元大9B購01,4.59,4.59,4.22,4.52,+0.08,1.8,104000,9,470530,0,0,0,0,0,0,94000,9000,85000,85000
20200528,710902,群聯元大9B購03,3.12,3.12,2.95,2.95,-0.08,-2.64,12000,3,37190,0,0,0,0,0,0,12000,2000,10000,10000
20200528,710903,雍智元大9C購01,2.78,2.79,2.50,2.50,-0.25,-9.09,141000,14,386540,0,0,0,0,0,0,93000,48000,45000,45000
20200528,710904,璟德元大9B購01,2.49,2.49,2.49,2.49,-0.21,-7.78,48000,1,119520,0,0,0,0,0,0,0,48000,-48000,-48000
20200528,710905,璟德元大9B購02,1.92,1.92,1.81,1.85,-0.06,-3.14,285000,13,530300,0,0,0,0,0,0,248000,187000,61000,61000
20200528,710906,聯亞元大9B購01,2.30,2.37,2.30,2.37,-0.03,-1.25,63000,2,148400,0,0,0,0,0,0,0,63000,-63000,-63000
20200528,710907,聯亞元大9B購02,1.78,1.78,1.76,1.76,+0.05,2.92,46000,3,81540,0,0,0,0,0,0,43000,29000,14000,14000
20200528,710908,力旺中信9B購01,1.93,1.99,1.80,1.80,-0.04,-2.17,234000,35,450630,0,0,0,0,0,0,215000,18000,197000,197000
20200528,710909,宜鼎永豐9B購01,0.93,0.94,0.93,0.94,+0.05,5.62,211000,2,198230,0,0,0,0,0,0,0,211000,-211000,-211000
20200528,710910,金可永豐9B購01,0.76,0.76,0.76,0.76,+0.04,5.56,35000,1,26600,0,0,0,0,0,0,35000,0,35000,35000
20200528,710911,建榮永豐9B購04,,,,,,0.00,0,0,0,0,0,0,0,0,0,0,0,0,0
20200528,710912,穩懋永豐9B購01,,,,,,0.00,0,0,0,0,0,0,0,0,0,0,0,0,0
20200528,710913,雙鴻國泰01購01,1.46,1.48,1.41,1.43,+0.01,0.7,664000,35,970250,0,0,0,0,0,0,108000,575000,-467000,-467000
20200528,710914,原相元大01購01,1.32,1.33,1.17,1.17,-0.11,-8.59,316000,33,401510,0,0,0,0,0,0,249000,45000,204000,204000
20200528,710915,精測元大9B購02,2.65,2.65,2.47,2.48,-0.10,-3.88,140000,23,360990,0,0,0,0,0,0,115000,67000,48000,48000
20200528,710916,鈊象元大9C購03,2.55,3.00,2.55,2.90,+0.57,24.46,220000,15,615490,0,0,0,0,0,0,80000,170000,-90000,-90000
20200528,710917,碩禾台新9C購01,,,,,,0.00,0,0,0,0,0,0,0,0,0,0,0,0,0
20200528,710918,威剛國票9B購02,5.20,5.20,5.20,5.20,-0.20,-3.7,1000,1,5200,0,0,0,0,0,0,1000,0,1000,1000
20200528,710919,網家國票9B購02,,,,,,0.00,0,0,0,0,0,0,0,0,0,0,0,0,0
20200528,710920,網龍國票9B購01,,,,,,0.00,0,0,0,0,0,0,0,0,0,0,0,0,0
20200528,710921,雙鴻國票9B購02,1.54,1.58,1.49,1.49,-0.10,-6.29,62000,3,96030,0,0,0,0,0,0,0,62000,-62000,-62000
20200528,710922,聯亞中信01購01,,,,,,0.00,0,0,0,0,0,0,0,0,0,0,0,0,0
20200528,710923,六角永豐9B購01,0.69,0.69,0.69,0.69,-0.07,-9.21,68000,1,46920,0,0,0,0,0,0,68000,0,68000,68000
20200528,710924,邦特永豐9B購01,1.03,1.08,1.03,1.05,-0.05,-4.55,347000,8,366490,0,0,0,0,0,0,280000,57000,223000,223000
20200528,710925,金居永豐9B購01,,,,,,0.00,0,0,0,0,0,0,0,0,0,0,0,0,0
20200528,710926,新普永豐9B購01,1.09,1.18,1.09,1.13,+0.03,2.73,701000,35,806980,0,0,0,0,0,0,91000,642000,-551000,-551000
20200528,710927,環球晶永豐9B購01,,,,,,0.00,0,0,0,0,0,0,0,0,0,0,0,0,0
20200528,710928,鈺太永豐9B購01,0.72,0.72,0.63,0.63,-0.09,-12.5,163000,4,113040,0,0,0,0,0,0,159000,4000,155000,155000
20200528,710929,神盾凱基9B購03,,,,,,0.00,0,0,0,0,0,0,0,0,0,0,0,0,0
20200528,710930,群聯統一01購01,0.74,0.74,0.74,0.74,+0.02,2.78,4000,1,2960,0,0,0,0,0,0,0,4000,-4000,-4000
20200528,710931,廣明統一9B購01,,,,,,0.00,0,0,0,0,0,0,0,0,0,0,0,0,0
20200528,710932,群聯富邦9B購02,0.48,0.48,0.46,0.46,-0.02,-4.17,70000,3,32400,0,0,0,0,0,0,40000,30000,10000,10000
20200528,710933,泰博群益9B購03,4.53,5.90,4.53,5.90,+1.62,37.85,71000,8,338900,0,0,0,0,0,0,0,70000,-70000,-70000
20200528,710934,神盾群益9B購03,1.52,1.54,1.45,1.45,-0.12,-7.64,213000,8,322390,0,0,0,0,0,0,123000,90000,33000,33000
20200528,710935,聯亞群益9B購02,2.34,2.34,2.34,2.34,-0.06,-2.5,51000,1,119340,0,0,0,0,0,0,0,51000,-51000,-51000
20200528,710936,鈊象群益9B購01,2.89,3.43,2.89,3.32,+0.63,23.42,212000,23,678960,0,0,0,0,0,0,93000,168000,-75000,-75000
20200528,710937,精測台新9B購01,0.86,0.86,0.80,0.80,-0.03,-3.61,58000,5,47760,0,0,0,0,0,0,21000,37000,-16000,-16000
20200528,710938,環球晶國泰9C購01,1.61,1.68,1.61,1.62,-0.02,-1.22,72000,12,117980,0,0,0,0,0,0,39000,63000,-24000,-24000
20200528,710939,合晶群益9B購01,1.98,1.99,1.93,1.93,+0.04,2.12,184000,11,363020,0,0,0,0,0,0,175000,67000,108000,108000
20200528,710940,原相群益9B購04,0.75,0.75,0.68,0.68,-0.12,-15.0,313000,20,225560,0,0,0,0,0,0,311000,0,311000,311000
20200528,710941,博智群益9B購01,2.17,2.24,2.09,2.09,-0.15,-6.7,275000,8,596610,0,0,0,0,0,0,153000,148000,5000,5000
20200528,710942,網家群益9B購01,2.66,2.68,2.45,2.45,-0.35,-12.5,36000,3,95130,0,0,0,0,0,0,26000,15000,11000,11000
20200528,710943,六角元大9B購01,1.44,1.45,1.31,1.31,-0.10,-7.09,835000,21,1190500,0,0,0,0,0,0,772000,61000,711000,711000
20200528,710944,宏捷科元大9B購04,2.19,2.22,2.10,2.10,-0.16,-7.08,211000,16,455830,0,0,0,0,0,0,143000,68000,75000,75000
20200528,710945,博智元大9B購02,1.57,1.57,1.51,1.51,-0.06,-3.82,117000,9,181070,0,0,0,0,0,0,117000,0,117000,117000
20200528,710946,群聯元大9B購04,2.58,2.58,2.44,2.44,-0.11,-4.31,184000,17,468240,0,0,0,0,0,0,159000,25000,134000,134000
20200528,710947,網龍元大9B購01,3.57,3.87,3.57,3.57,+0.03,0.85,188000,20,704670,0,0,0,0,0,0,8000,188000,-180000,-180000
20200528,710948,穩懋元大9B購01,2.46,2.46,2.36,2.36,-0.04,-1.67,98000,8,236880,0,0,0,0,0,0,83000,69000,14000,14000
20200528,710949,金居中信9C購02,0.66,0.66,0.60,0.60,-0.09,-13.04,316000,6,199490,0,0,0,0,0,0,166000,150000,16000,16000
20200528,710950,譜瑞中信03購01,,,,,,0.00,0,0,0,0,0,0,0,0,0,0,0,0,0
20200528,710951,譜瑞中信05購01,1.50,1.55,1.43,1.43,-0.10,-6.54,44000,9,65960,0,0,0,0,0,0,0,44000,-44000,-44000
20200528,710952,台燿永豐9B購01,0.76,0.79,0.74,0.79,+0.01,1.28,456000,15,355290,0,0,0,0,0,0,221000,235000,-14000,-14000
20200528,710953,欣銓永豐9B購01,0.94,0.94,0.87,0.87,-0.07,-7.45,45000,5,41630,0,0,0,0,0,0,2000,43000,-41000,-41000
20200528,710954,博智永豐9B購01,,,,,,0.00,0,0,0,0,0,0,0,0,0,0,0,0,0
20200528,710955,譜瑞永豐9B購01,1.57,1.59,1.52,1.53,-0.11,-6.71,73000,8,113210,0,0,0,0,0,0,38000,35000,3000,3000
20200528,710956,大江凱基9B購02,1.72,1.73,1.72,1.73,-0.04,-2.26,110000,3,189300,0,0,0,0,0,0,0,110000,-110000,-110000
20200528,710957,泰博凱基9B購02,4.94,5.95,4.90,5.75,+1.12,24.19,82000,13,425900,0,0,0,0,0,0,61000,11000,50000,50000
20200528,710958,博智凱基9B購02,0.78,0.78,0.78,0.78,-0.02,-2.5,1000,1,780,0,0,0,0,0,0,1000,0,1000,1000
20200528,710959,神盾統一9C購01,0.86,0.86,0.78,0.79,-0.07,-8.14,171000,5,146510,0,0,0,0,0,0,170000,1000,169000,169000
20200528,710960,群聯統一9B購02,1.29,1.30,1.29,1.30,+0.01,0.78,23000,2,29870,0,0,0,0,0,0,23000,23000,0,0
20200528,710961,環球晶統一01購01,0.73,0.73,0.70,0.71,0.00,0.0,9000,4,6340,0,0,0,0,0,0,0,9000,-9000,-9000
20200528,710962,環球晶統一9B購01,,,,,,0.00,0,0,0,0,0,0,0,0,0,0,0,0,0
20200528,710963,環球晶統一9B購02,1.53,1.53,1.52,1.53,+0.01,0.66,172000,4,262270,0,0,0,0,0,0,1000,171000,-170000,-170000
20200528,710964,環球晶統一9C購02,1.53,1.53,1.53,1.53,+0.02,1.32,7000,1,10710,0,0,0,0,0,0,0,7000,-7000,-7000
20200528,710965,頎邦統一9C購01,1.46,1.46,1.40,1.40,+0.02,1.45,97000,8,139120,0,0,0,0,0,0,18000,79000,-61000,-61000
20200528,710966,弘塑國票9B購01,2.45,2.45,2.28,2.28,-0.30,-11.63,76000,3,179220,0,0,0,0,0,0,38000,38000,0,0
20200528,710967,宜鼎國票9B購01,2.72,2.83,2.72,2.83,+0.08,2.91,75000,6,206060,0,0,0,0,0,0,53000,25000,28000,28000
20200528,710968,環球晶國票9C購01,1.34,1.35,1.33,1.33,-0.02,-1.48,56000,3,74950,0,0,0,0,0,0,29000,45000,-16000,-16000
20200528,710969,雙鴻國票9B購03,1.58,1.68,1.58,1.64,-0.10,-5.75,73000,6,118420,0,0,0,0,0,0,37000,39000,-2000,-2000
20200528,710970,元太元大9B購01,5.45,5.60,5.05,5.05,-0.40,-7.34,109000,12,594850,0,0,0,0,0,0,41000,104000,-63000,-63000
20200528,710971,弘塑元大9C購01,,,,,,0.00,0,0,0,0,0,0,0,0,0,0,0,0,0
20200528,710972,金可元大9B購01,2.20,2.26,2.12,2.12,0.00,0.0,117000,7,255420,0,0,0,0,0,0,0,117000,-117000,-117000
20200528,710973,金居元大9B購01,2.49,2.49,2.24,2.24,-0.27,-10.76,177000,10,411960,0,0,0,0,0,0,92000,85000,7000,7000
20200528,710974,南光元大9B購01,1.58,1.58,1.58,1.58,-0.04,-2.47,5000,1,7900,0,0,0,0,0,0,5000,0,5000,5000
20200528,710975,威剛元大9B購04,2.70,2.70,2.61,2.61,+0.03,1.16,64000,3,168500,0,0,0,0,0,0,19000,45000,-26000,-26000
20200528,710976,原相元大01購02,3.12,3.14,2.85,2.85,-0.15,-5.0,324000,35,978680,0,0,0,0,0,0,286000,106000,180000,180000
20200528,710977,泰博元大01購01,7.40,8.35,7.40,8.35,+1.15,15.97,62000,10,466050,0,0,0,0,0,0,49000,0,49000,49000
20200528,710978,群聯元大9B購05,2.95,2.97,2.95,2.97,+0.07,2.41,40000,2,118600,0,0,0,0,0,0,40000,0,40000,40000
20200528,710979,精測元大9B購03,1.85,1.85,1.73,1.73,-0.07,-3.89,115000,7,205950,0,0,0,0,0,0,86000,45000,41000,41000
20200528,710980,網家元大9B購02,3.03,3.06,2.94,2.94,-0.13,-4.23,111000,5,333600,0,0,0,0,0,0,41000,72000,-31000,-31000
20200528,710981,璟德元大9B購03,2.65,2.65,2.59,2.59,-0.12,-4.43,19000,2,49750,0,0,0,0,0,0,19000,0,19000,19000
20200528,710982,聯亞元大9B購03,1.31,1.31,1.31,1.31,-0.03,-2.24,22000,1,28820,0,0,0,0,0,0,0,22000,-22000,-22000
20200528,710983,雙鴻元大9C購04,1.58,1.60,1.54,1.54,-0.06,-3.75,245000,8,386300,0,0,0,0,0,0,93000,152000,-59000,-59000
20200528,710984,鈊象元大9C購04,1.52,1.82,1.52,1.80,+0.33,22.45,815000,53,1388300,0,0,0,0,0,0,230000,560000,-330000,-330000
20200528,710985,鈺太元大9C購01,1.31,1.32,1.18,1.18,-0.13,-9.92,293000,22,370650,0,0,0,0,0,0,230000,232000,-2000,-2000
20200528,710986,頎邦元大9B購01,3.58,3.58,3.50,3.50,+0.15,4.48,101000,2,356140,0,0,0,0,0,0,68000,33000,35000,35000
20200528,710987,頎邦元大9B購02,2.89,2.89,2.74,2.74,-0.06,-2.14,130000,8,366700,0,0,0,0,0,0,90000,40000,50000,50000
20200528,710988,群聯中信01購01,0.58,0.58,0.56,0.56,-0.04,-6.67,110000,2,61800,0,0,0,0,0,0,100000,10000,90000,90000
20200528,710989,環球晶中信9C購02,,,,,,0.00,0,0,0,0,0,0,0,0,0,0,0,0,0
20200528,710990,頎邦中信01購01,0.70,0.70,0.66,0.66,-0.01,-1.49,42000,2,28600,0,0,0,0,0,0,22000,20000,2000,2000
20200528,710991,大江永豐9B購01,0.89,0.89,0.89,0.89,+0.01,1.14,30000,1,26700,0,0,0,0,0,0,0,30000,-30000,-30000
20200528,710992,旺矽永豐9B購01,1.23,1.23,1.14,1.14,-0.04,-3.39,25000,3,29820,0,0,0,0,0,0,12000,13000,-1000,-1000
20200528,710993,雍智永豐9B購01,1.02,1.02,0.91,0.95,-0.08,-7.77,68000,9,66460,0,0,0,0,0,0,26000,42000,-16000,-16000
20200528,710994,環球晶麥證9B購01,,,,,,0.00,0,0,0,0,0,0,0,0,0,0,0,0,0
20200528,710995,群聯統一01購02,0.83,0.84,0.79,0.79,-0.04,-4.82,384000,20,314330,0,0,0,0,0,0,261000,123000,138000,138000
20200528,710996,網家統一01購01,1.08,1.09,1.01,1.01,-0.05,-4.72,461000,24,486190,0,0,0,0,0,0,382000,78000,304000,304000
20200528,710997,穩懋統一9B購05,,,,,,0.00,0,0,0,0,0,0,0,0,0,0,0,0,0
20200528,710998,大江國泰01購01,1.47,1.52,1.44,1.48,+0.03,2.07,555000,26,825160,0,0,0,0,0,0,259000,372000,-113000,-113000
20200528,710999,聯亞國泰01購01,1.26,1.31,1.25,1.25,-0.06,-4.58,405000,9,514370,0,0,0,0,0,0,358000,80000,278000,278000
20200528,711000,雙美國泰01購01,1.36,1.36,1.33,1.33,0.00,0.0,115000,2,156250,0,0,0,0,0,0,110000,115000,-5000,-5000
20200528,711001,環球晶富邦01購01,0.53,0.53,0.51,0.51,+0.01,2.0,50000,6,25990,0,0,0,0,0,0,3000,47000,-44000,-44000
20200528,711002,宏捷科群益9B購01,1.73,1.76,1.70,1.76,+0.01,0.57,100000,10,171920,0,0,0,0,0,0,100000,0,100000,100000
20200528,711003,環球晶群益9B購04,2.28,2.28,2.28,2.28,+0.03,1.33,1000,1,2280,0,0,0,0,0,0,1000,1000,0,0
20200528,711004,大江元大9B購01,2.76,2.81,2.74,2.81,+0.11,4.07,103000,3,284880,0,0,0,0,0,0,35000,68000,-33000,-33000
20200528,711005,欣銓元大9B購01,2.13,2.13,1.96,1.96,-0.18,-8.41,88000,7,181690,0,0,0,0,0,0,10000,78000,-68000,-68000
20200528,711006,金居元大9B購02,2.24,2.29,2.10,2.11,-0.18,-7.86,225000,7,486930,0,0,0,0,0,0,138000,87000,51000,51000
20200528,711007,建榮元大9B購02,,,,,,0.00,0,0,0,0,0,0,0,0,0,0,0,0,0
20200528,711008,雙美元大9C購02,1.68,1.71,1.68,1.71,+0.08,4.91,320000,5,539700,0,0,0,0,0,0,320000,70000,250000,250000
20200528,711009,鈺太元大9B購02,3.12,3.14,2.77,2.77,-0.47,-14.51,134000,10,400330,0,0,0,0,0,0,99000,108000,-9000,-9000
20200528,711010,大江國票9B購02,4.83,4.83,4.83,4.83,-0.08,-1.63,40000,1,193200,0,0,0,0,0,0,40000,0,40000,40000
20200528,711011,神盾國票9C購02,1.95,1.95,1.80,1.80,-0.16,-8.16,44000,2,81450,0,0,0,0,0,0,44000,0,44000,44000
20200528,711012,群聯國票9B購02,2.86,2.86,2.73,2.73,-0.08,-2.85,28000,10,79160,0,0,0,0,0,0,28000,26000,2000,2000
20200528,711013,環球晶國票9B購01,1.75,1.76,1.75,1.76,+0.10,6.02,34000,2,59670,0,0,0,0,0,0,0,34000,-34000,-34000
20200528,711014,久元永豐9B購01,1.71,1.71,1.48,1.48,+0.10,7.25,150000,6,246960,0,0,0,0,0,0,125000,31000,94000,94000
20200528,711015,大學光永豐9B購01,3.58,3.86,3.42,3.42,-0.26,-7.07,89000,14,327120,0,0,0,0,0,0,59000,20000,39000,39000
20200528,711016,直得永豐9B購01,1.08,1.14,0.82,0.84,-0.23,-21.5,831000,38,832820,0,0,0,0,0,0,584000,237000,347000,347000
20200528,711017,南光永豐9B購01,,,,,,0.00,0,0,0,0,0,0,0,0,0,0,0,0,0
20200528,711018,泰博永豐9B購01,2.07,2.59,2.06,2.55,+0.57,28.79,833000,83,1863900,0,0,0,0,0,0,401000,295000,106000,106000
20200528,711019,磐亞永豐9B購01,,,,,,0.00,0,0,0,0,0,0,0,0,0,0,0,0,0
20200528,711020,雙美永豐9B購01,0.74,0.77,0.74,0.77,+0.03,4.05,80000,4,61000,0,0,0,0,0,0,0,80000,-80000,-80000
20200528,711021,力旺群益9B購01,2.87,2.99,2.83,2.99,+0.09,3.1,107000,7,305860,0,0,0,0,0,0,107000,0,107000,107000
20200528,711022,大江群益9B購01,1.89,1.97,1.89,1.96,+0.01,0.51,173000,6,332300,0,0,0,0,0,0,54000,119000,-65000,-65000
20200528,711023,宇峻群益9B購02,0.58,0.59,0.55,0.55,+0.03,5.77,331000,8,192500,0,0,0,0,0,0,0,331000,-331000,-331000
20200528,711024,建榮群益9C購01,1.02,1.05,0.96,0.96,-0.12,-11.11,220000,3,223800,0,0,0,0,0,0,60000,160000,-100000,-100000
20200528,711025,原相群益9B購05,1.91,1.93,1.78,1.78,-0.05,-2.73,427000,28,792200,0,0,0,0,0,0,427000,0,427000,427000
20200528,711026,群聯群益9B購02,2.71,2.73,2.53,2.53,-0.15,-5.6,73000,10,197010,0,0,0,0,0,0,73000,24000,49000,49000
20200528,711027,精測群益9B購02,,,,,,0.00,0,0,0,0,0,0,0,0,0,0,0,0,0
20200528,711028,網家群益9B購02,2.07,2.11,1.90,1.90,-0.22,-10.38,37000,4,75940,0,0,0,0,0,0,32000,10000,22000,22000
20200528,711029,網龍群益9B購01,2.70,2.70,2.70,2.70,+0.22,8.87,10000,2,27000,0,0,0,0,0,0,10000,0,10000,10000
20200528,711030,環球晶群益9B購05,,,,,,0.00,0,0,0,0,0,0,0,0,0,0,0,0,0
20200528,711031,頎邦群益9C購01,,,,,,0.00,0,0,0,0,0,0,0,0,0,0,0,0,0
20200528,711032,博智群益9B購02,1.31,1.36,1.27,1.27,-0.10,-7.3,249000,6,332790,0,0,0,0,0,0,179000,70000,109000,109000
20200528,711033,大江凱基9C購02,1.17,1.19,1.17,1.19,+0.02,1.71,30000,2,35500,0,0,0,0,0,0,10000,20000,-10000,-10000
20200528,711034,元太凱基9B購01,2.72,2.83,2.51,2.52,-0.20,-7.35,176000,23,468350,0,0,0,0,0,0,68000,102000,-34000,-34000
20200528,711035,欣銓凱基9B購01,1.35,1.35,1.23,1.23,-0.13,-9.56,115000,7,146660,0,0,0,0,0,0,47000,68000,-21000,-21000
20200528,711036,金居凱基9B購01,0.99,0.99,0.99,0.99,-0.07,-6.6,20000,1,19800,0,0,0,0,0,0,20000,20000,0,0
20200528,711037,威剛凱基9B購03,1.21,1.21,1.21,1.21,+0.03,2.54,10000,1,12100,0,0,0,0,0,0,10000,0,10000,10000
20200528,711038,新鉅科凱基9B購01,1.03,1.03,1.01,1.01,+0.01,1.0,115000,10,117300,0,0,0,0,0,0,115000,0,115000,115000
20200528,711039,中美晶統一9B購03,0.79,0.79,0.79,0.79,-0.02,-2.47,40000,1,31600,0,0,0,0,0,0,0,40000,-40000,-40000
20200528,711040,穩懋統一9B購06,,,,,,0.00,0,0,0,0,0,0,0,0,0,0,0,0,0
20200528,711041,頎邦統一9B購01,,,,,,0.00,0,0,0,0,0,0,0,0,0,0,0,0,0
20200528,711042,弘塑麥證9B購01,0.94,0.94,0.94,0.94,-0.04,-4.08,76000,1,71440,76000,0,76000,0,0,0,76000,0,76000,76000
20200528,711043,鈊象麥證9B購01,1.63,1.92,1.63,1.92,+0.45,30.61,146000,8,255170,0,146000,-146000,0,0,0,42000,146000,-104000,-104000
20200528,711044,久元元大9B購01,2.81,3.12,2.47,2.50,+0.05,2.04,256000,21,714850,0,0,0,0,0,0,113000,136000,-23000,-23000
20200528,711045,大江元大9C購01,2.83,2.95,2.80,2.88,+0.06,2.13,255000,13,732470,0,0,0,0,0,0,133000,183000,-50000,-50000
20200528,711046,金居元大9B購03,1.83,1.83,1.71,1.71,-0.16,-8.56,35000,4,61500,0,0,0,0,0,0,25000,10000,15000,15000
20200528,711047,建榮元大9B購03,1.81,1.81,1.81,1.81,-0.15,-7.65,31000,2,56110,0,0,0,0,0,0,15000,16000,-1000,-1000
20200528,711048,網家元大9B購03,3.66,3.66,3.21,3.21,-0.31,-8.81,108000,11,383130,0,0,0,0,0,0,10000,98000,-88000,-88000
20200528,711049,聯亞元大9B購04,1.21,1.23,1.21,1.23,+0.04,3.36,109000,2,132710,0,0,0,0,0,0,0,109000,-109000,-109000
20200528,711050,鈊象國泰01購01,1.66,2.04,1.66,2.03,+0.41,25.31,1360000,78,2602300,0,0,0,0,0,0,409000,992000,-583000,-583000
20200528,711051,弘塑群益9B購01,,,,,,0.00,0,0,0,0,0,0,0,0,0,0,0,0,0
20200528,711052,精測群益9B購03,,,,,,0.00,0,0,0,0,0,0,0,0,0,0,0,0,0
20200528,711053,磐亞群益9B購01,,,,,,0.00,0,0,0,0,0,0,0,0,0,0,0,0,0
20200528,711054,優群群益9B購01,2.07,2.18,1.98,2.10,+0.29,16.02,138000,11,286290,0,0,0,0,0,0,67000,71000,-4000,-4000
20200528,711055,鈺太群益9B購01,1.76,1.76,1.59,1.59,-0.29,-15.43,176000,2,307040,0,0,0,0,0,0,176000,0,176000,176000
20200528,711056,碩禾中信03購01,,,,,,0.00,0,0,0,0,0,0,0,0,0,0,0,0,0
20200528,711057,良維永豐9B購01,0.67,0.67,0.63,0.63,-0.02,-3.08,40000,2,26400,0,0,0,0,0,0,40000,0,40000,40000
20200528,711058,宜特永豐9B購01,1.38,1.48,1.33,1.45,+0.10,7.41,611000,36,855490,0,0,0,0,0,0,525000,86000,439000,439000
20200528,711059,建榮永豐9B購05,0.71,0.71,0.70,0.70,-0.03,-4.11,122000,4,86270,0,0,0,0,0,0,95000,27000,68000,68000
20200528,711060,聚積永豐9B購01,,,,,,0.00,0,0,0,0,0,0,0,0,0,0,0,0,0
20200528,711061,環宇永豐9B購01,,,,,,0.00,0,0,0,0,0,0,0,0,0,0,0,0,0
20200528,711062,宏捷科凱基9C購03,2.97,3.00,2.85,2.85,-0.20,-6.56,66000,10,194330,10000,0,10000,0,0,0,56000,10000,46000,56000
20200528,711063,頎邦凱基9C購01,3.49,3.49,3.49,3.49,+0.01,0.29,34000,1,118660,0,0,0,0,0,0,0,34000,-34000,-34000
20200528,711064,凡甲統一01購01,0.65,0.65,0.65,0.65,-0.03,-4.41,7000,1,4550,0,0,0,0,0,0,7000,0,7000,7000
20200528,711065,穩懋統一9B購08,,,,,,0.00,0,0,0,0,0,0,0,0,0,0,0,0,0
20200528,711066,大學光國票9C購01,9.75,10.20,9.75,9.85,+0.35,3.68,41000,15,405400,0,0,0,0,0,0,39000,2000,37000,37000
20200528,711067,宇峻國票9B購03,1.39,1.42,1.36,1.36,+0.14,11.48,51000,4,71130,0,0,0,0,0,0,0,51000,-51000,-51000
20200528,711068,群聯國泰01購01,1.36,1.36,1.26,1.26,-0.07,-5.26,148000,8,192880,0,0,0,0,0,0,98000,55000,43000,43000
20200528,711069,台燿永豐9B購02,0.50,0.53,0.49,0.52,+0.01,1.96,304000,11,157550,0,0,0,0,0,0,226000,78000,148000,148000
20200528,711070,穩懋永豐9B購02,,,,,,0.00,0,0,0,0,0,0,0,0,0,0,0,0,0
20200528,711071,凡甲元大9C購01,1.74,1.74,1.71,1.71,-0.04,-2.29,53000,6,91890,0,0,0,0,0,0,52000,1000,51000,51000
20200528,711072,大江元大9C購02,1.03,1.08,1.03,1.06,+0.03,2.91,83000,12,87220,0,0,0,0,0,0,37000,46000,-9000,-9000
20200528,711073,台燿元大9B購01,1.41,1.46,1.36,1.44,+0.05,3.6,810000,26,1154220,0,0,0,0,0,0,241000,569000,-328000,-328000
20200528,711074,台燿元大9C購01,2.04,2.11,1.99,2.08,+0.01,0.48,199000,11,409990,0,0,0,0,0,0,33000,166000,-133000,-133000
20200528,711075,宇峻元大01購01,1.05,1.15,1.05,1.15,+0.12,11.65,435000,8,472210,0,0,0,0,0,0,0,435000,-435000,-435000
20200528,711076,宏捷科元大9C購02,1.16,1.18,1.15,1.15,-0.03,-2.54,110000,11,128100,0,0,0,0,0,0,110000,0,110000,110000
20200528,711077,宜鼎元大9B購01,2.06,2.11,1.99,1.99,+0.02,1.02,287000,16,585740,0,0,0,0,0,0,47000,287000,-240000,-240000
20200528,711078,泰博元大9C購02,4.10,4.73,4.10,4.73,+1.07,29.23,42000,7,187380,0,0,0,0,0,0,1000,32000,-31000,-31000
20200528,711079,群聯元大9B購06,1.83,1.83,1.83,1.83,-0.06,-3.17,10000,1,18300,0,0,0,0,0,0,10000,0,10000,10000
20200528,711080,群聯元大9B購07,2.55,2.55,2.45,2.45,-0.06,-2.39,162000,13,408250,0,0,0,0,0,0,159000,4000,155000,155000
20200528,711081,雍智元大9C購02,1.79,1.79,1.59,1.61,-0.13,-7.47,553000,22,946410,0,0,0,0,0,0,180000,373000,-193000,-193000
20200528,711082,環球晶元大9C購01,1.64,1.64,1.64,1.64,+0.05,3.14,15000,1,24600,0,0,0,0,0,0,15000,0,15000,15000
20200528,711083,精測富邦9C購01,0.48,0.48,0.46,0.46,0.00,0.0,427000,6,198440,0,0,0,0,0,0,426000,427000,-1000,-1000
20200528,711084,穩懋富邦01購01,0.72,0.74,0.72,0.74,0.00,0.0,17000,2,12540,0,0,0,0,0,0,2000,15000,-13000,-13000
20200528,711085,台燿凱基9B購01,0.81,0.86,0.81,0.85,0.00,0.0,143000,13,117640,0,0,0,0,0,0,95000,48000,47000,47000
20200528,711086,威剛凱基01購01,1.09,1.09,1.09,1.09,+0.02,1.87,50000,1,54500,0,0,0,0,0,0,50000,0,50000,50000
20200528,711087,神盾凱基9B購04,2.37,2.37,2.26,2.26,-0.09,-3.83,88000,3,201740,0,0,0,0,0,0,24000,64000,-40000,-40000
20200528,711088,勝麗凱基9B購01,1.57,1.57,1.53,1.56,-0.15,-8.77,126000,17,195550,0,0,0,0,0,0,121000,5000,116000,116000
20200528,711089,環球晶凱基9B購04,,,,,,0.00,0,0,0,0,0,0,0,0,0,0,0,0,0
20200528,711090,網家麥證9B購01,1.94,1.94,1.87,1.87,-0.08,-4.1,33000,2,62270,33000,0,33000,0,0,0,33000,0,33000,33000
20200528,711091,弘塑統一01購01,,,,,,0.00,0,0,0,0,0,0,0,0,0,0,0,0,0
20200528,711092,金居統一9B購01,0.72,0.72,0.68,0.68,-0.07,-9.33,60000,3,42800,0,0,0,0,0,0,60000,0,60000,60000
20200528,711093,頎邦統一9C購02,1.41,1.41,1.35,1.35,0.00,0.0,58000,3,79560,0,0,0,0,0,0,53000,5000,48000,48000
20200528,711094,信驊元大9B購01,4.61,4.76,4.46,4.46,+0.20,4.69,107000,17,495420,0,0,0,0,0,0,79000,67000,12000,12000
20200528,711095,精測元大9C購01,1.57,1.57,1.57,1.57,+0.02,1.29,74000,3,116180,0,0,0,0,0,0,6000,74000,-68000,-68000
20200528,711096,網家元大9B購04,3.28,3.28,3.17,3.17,-0.16,-4.8,36000,2,115220,0,0,0,0,0,0,36000,0,36000,36000
20200528,711097,中美晶國泰01購01,1.64,1.64,1.62,1.62,+0.02,1.25,41000,3,66540,0,0,0,0,0,0,0,41000,-41000,-41000
20200528,711098,大學光群益9B購02,3.83,4.00,3.26,3.26,-0.42,-11.41,371000,50,1400160,0,0,0,0,0,0,338000,15000,323000,323000
20200528,711099,台燿群益9B購02,1.39,1.45,1.35,1.44,+0.04,2.86,177000,18,248640,0,15000,-15000,0,0,0,110000,67000,43000,28000
20200528,711100,新普群益9C購01,2.23,2.41,2.18,2.37,+0.02,0.85,545000,51,1243010,0,0,0,0,0,0,156000,496000,-340000,-340000
20200528,711101,環宇群益9B購01,,,,,,0.00,0,0,0,0,0,0,0,0,0,0,0,0,0
20200528,711102,中美晶國票9B購01,,,,,,0.00,0,0,0,0,0,0,0,0,0,0,0,0,0
20200528,711103,元太國票9B購01,4.98,5.30,4.63,4.63,-0.36,-7.21,80000,6,389390,0,0,0,0,0,0,2000,78000,-76000,-76000
20200528,711104,磐亞國票9B購01,1.42,1.42,1.42,1.42,+0.02,1.43,1000,1,1420,0,0,0,0,0,0,1000,0,1000,1000
20200528,711105,博智凱基9B購03,1.51,1.51,1.51,1.51,-0.07,-4.43,20000,1,30200,0,0,0,0,0,0,20000,0,20000,20000
20200528,711106,群聯凱基9B購06,2.77,2.77,2.77,2.77,-0.03,-1.07,10000,1,27700,0,0,0,0,0,0,0,10000,-10000,-10000
20200528,711107,璟德凱基9B購02,2.58,2.58,2.51,2.51,-0.13,-4.92,91000,3,234010,0,0,0,0,0,0,91000,0,91000,91000
20200528,711108,鈺太凱基9C購01,0.92,0.92,0.83,0.83,-0.10,-10.75,80000,4,71300,0,0,0,0,0,0,40000,40000,0,0
20200528,711109,頎邦凱基9B購01,1.03,1.03,0.96,0.96,-0.02,-2.04,634000,15,638290,0,0,0,0,0,0,415000,169000,246000,246000
20200528,711110,台燿統一01購01,0.55,0.58,0.55,0.57,-0.01,-1.72,237000,14,130950,0,0,0,0,0,0,223000,14000,209000,209000
20200528,711111,群聯統一9C購01,,,,,,0.00,0,0,0,0,0,0,0,0,0,0,0,0,0
20200528,711112,穩懋統一01購01,0.92,0.92,0.92,0.92,-0.01,-1.08,50000,1,46000,0,0,0,0,0,0,0,50000,-50000,-50000
20200528,711113,穩懋統一9C購04,,,,,,0.00,0,0,0,0,0,0,0,0,0,0,0,0,0
20200528,711114,寶雅中信9B購01,1.18,1.18,1.13,1.13,-0.11,-8.87,190000,5,220220,0,0,0,0,0,0,164000,26000,138000,138000
20200528,711115,中美晶永豐9B購01,,,,,,0.00,0,0,0,0,0,0,0,0,0,0,0,0,0
20200528,711116,台半永豐9B購01,0.67,0.67,0.67,0.67,+0.01,1.52,25000,2,16750,0,0,0,0,0,0,10000,25000,-15000,-15000
20200528,711117,旺矽永豐9B購02,,,,,,0.00,0,0,0,0,0,0,0,0,0,0,0,0,0
20200528,711118,金居永豐9B購02,,,,,,0.00,0,0,0,0,0,0,0,0,0,0,0,0,0
20200528,711119,群聯永豐9B購02,,,,,,0.00,0,0,0,0,0,0,0,0,0,0,0,0,0
20200528,711120,精華永豐9B購01,,,,,,0.00,0,0,0,0,0,0,0,0,0,0,0,0,0
20200528,711121,璟德永豐9B購01,0.74,0.74,0.74,0.74,-0.06,-7.5,24000,1,17760,0,0,0,0,0,0,24000,0,24000,24000
20200528,711122,雙美永豐9B購02,,,,,,0.00,0,0,0,0,0,0,0,0,0,0,0,0,0
20200528,711123,大江元大9C購03,2.45,2.53,2.41,2.53,+0.11,4.55,167000,8,412370,0,0,0,0,0,0,60000,107000,-47000,-47000
20200528,711124,原相元大9C購01,1.80,1.82,1.62,1.62,-0.13,-7.43,1558000,73,2679640,0,0,0,0,0,0,1166000,434000,732000,732000
20200528,711125,神盾元大9C購02,1.88,1.88,1.88,1.88,+0.03,1.62,40000,1,75200,0,0,0,0,0,0,40000,0,40000,40000
20200528,711126,聯亞元大9B購05,1.13,1.13,1.09,1.09,-0.04,-3.54,184000,2,204560,0,0,0,0,0,0,84000,184000,-100000,-100000
20200528,711127,頎邦元大9B購03,1.78,1.78,1.65,1.65,-0.03,-1.79,170000,10,297030,0,0,0,0,0,0,91000,79000,12000,12000
20200528,711128,金居國泰01購01,1.55,1.59,1.42,1.42,-0.16,-10.13,45000,10,66360,0,0,0,0,0,0,32000,43000,-11000,-11000
20200528,711129,威剛國泰01購01,1.56,1.56,1.43,1.43,-0.06,-4.03,174000,10,265040,0,0,0,0,0,0,143000,40000,103000,103000
20200528,711130,譜瑞國泰01購01,1.83,1.89,1.74,1.75,-0.11,-5.91,388000,39,693990,0,0,0,0,0,0,209000,274000,-65000,-65000
20200528,711131,胡連永豐9B購01,,,,,,0.00,0,0,0,0,0,0,0,0,0,0,0,0,0
20200528,711132,僑威永豐9B購01,1.03,1.04,0.90,0.92,-0.09,-8.91,196000,32,192510,0,0,0,0,0,0,98000,77000,21000,21000
20200528,711133,寶雅永豐9B購01,1.03,1.03,0.97,0.99,-0.12,-10.81,173000,6,171840,0,0,0,0,0,0,173000,0,173000,173000
20200528,711134,中美晶群益9B購03,,,,,,0.00,0,0,0,0,0,0,0,0,0,0,0,0,0
20200528,711135,元太群益9B購01,3.22,3.37,2.98,2.98,-0.27,-8.31,201000,20,642290,0,0,0,0,0,0,43000,189000,-146000,-146000
20200528,711136,威剛群益9C購01,1.41,1.41,1.30,1.30,-0.10,-7.14,117000,4,160460,0,0,0,0,0,0,76000,41000,35000,35000
20200528,711137,胡連群益9B購01,1.21,1.22,1.21,1.22,+0.04,3.39,100000,2,121500,0,0,0,0,0,0,0,100000,-100000,-100000
20200528,711138,雙美群益9C購01,1.69,1.78,1.69,1.77,+0.08,4.73,481000,7,845190,0,0,0,0,0,0,476000,201000,275000,275000
20200528,711139,中美晶凱基9B購02,,,,,,0.00,0,0,0,0,0,0,0,0,0,0,0,0,0
20200528,711140,旺矽凱基9B購01,,,,,,0.00,0,0,0,0,0,0,0,0,0,0,0,0,0
20200528,711141,胡連凱基9B購01,1.37,1.37,1.34,1.34,-0.01,-0.74,173000,3,236410,0,0,0,0,0,0,0,173000,-173000,-173000
20200528,711142,鈊象凱基9C購01,2.50,2.77,2.50,2.77,+0.53,23.66,104000,12,285430,0,0,0,0,0,0,41000,104000,-63000,-63000
20200528,711143,大學光統一02購01,1.27,1.38,1.16,1.16,-0.11,-8.66,1087000,78,1405290,0,0,0,0,0,0,814000,191000,623000,623000
20200528,711144,寶雅統一01購01,0.87,0.87,0.83,0.84,-0.05,-5.62,244000,8,209750,0,0,0,0,0,0,224000,20000,204000,204000
20200528,711145,環球晶國票9B購02,1.76,1.76,1.76,1.76,+0.07,4.14,17000,1,29920,0,0,0,0,0,0,0,17000,-17000,-17000
20200528,711146,雍智群益9B購01,1.70,1.70,1.57,1.57,-0.23,-12.78,283000,7,465270,0,0,0,0,0,0,273000,10000,263000,263000
20200528,711147,優群群益9B購02,1.77,1.84,1.61,1.76,+0.24,15.79,688000,35,1201780,0,0,0,0,0,0,425000,337000,88000,88000
20200528,711148,凡甲國泰01購01,1.69,1.69,1.58,1.59,-0.09,-5.36,1015000,46,1662920,0,0,0,0,0,0,806000,230000,576000,576000
20200528,711149,網龍國泰01購01,2.02,2.19,1.94,1.94,-0.06,-3.0,969000,40,1996640,0,0,0,0,0,0,271000,679000,-408000,-408000
20200528,711150,環球晶國泰9B購01,2.44,2.51,2.39,2.39,-0.06,-2.45,233000,18,572350,0,0,0,0,0,0,4000,233000,-229000,-229000
20200528,711151,泰博中信01購01,0.66,0.82,0.64,0.77,+0.12,18.46,366000,43,273450,0,0,0,0,0,0,66000,253000,-187000,-187000
20200528,711152,大田永豐9B購01,1.05,1.05,1.00,1.00,-0.04,-3.85,246000,6,246850,0,0,0,0,0,0,236000,72000,164000,164000
20200528,711153,大學光永豐9B購02,1.35,1.42,1.20,1.20,-0.15,-11.11,965000,54,1316030,0,0,0,0,0,0,760000,125000,635000,635000
20200528,711154,合晶永豐9B購01,0.78,0.78,0.78,0.78,-0.02,-2.5,31000,2,24180,0,0,0,0,0,0,31000,0,31000,31000
20200528,711155,泰博永豐9B購02,1.50,1.80,1.40,1.80,+0.44,32.35,922000,21,1382780,0,0,0,0,0,0,835000,87000,748000,748000
20200528,711156,網龍永豐9B購01,1.09,1.18,1.06,1.06,0.00,0.0,320000,19,360350,0,0,0,0,0,0,50000,272000,-222000,-222000
20200528,711157,大學光元大9C購02,2.76,2.87,2.39,2.39,-0.28,-10.49,912000,68,2525530,0,0,0,0,0,0,664000,238000,426000,426000
20200528,711158,中美晶元大9B購02,2.22,2.22,2.22,2.22,-0.08,-3.48,37000,1,82140,0,0,0,0,0,0,37000,0,37000,37000
20200528,711159,中美晶元大9B購03,,,,,,0.00,0,0,0,0,0,0,0,0,0,0,0,0,0
20200528,711160,元太元大9B購02,4.60,4.74,4.45,4.45,-0.05,-1.11,294000,27,1347200,0,0,0,0,0,0,69000,284000,-215000,-215000
20200528,711161,泰博元大9C購03,1.97,2.32,1.95,2.30,+0.39,20.42,430000,56,935260,0,0,0,0,0,0,216000,281000,-65000,-65000
20200528,711162,雍智元大9C購03,3.60,3.60,3.19,3.24,-0.35,-9.75,103000,13,363700,0,0,0,0,0,0,65000,38000,27000,27000
20200528,711163,網龍元大9B購02,1.79,1.97,1.79,1.79,+0.01,0.56,312000,23,590070,0,0,0,0,0,0,7000,295000,-288000,-288000
20200528,711164,環球晶元大9C購02,1.45,1.47,1.41,1.41,-0.02,-1.4,71000,5,103690,0,0,0,0,0,0,10000,61000,-51000,-51000
20200528,711165,聯亞元大9C購01,1.27,1.31,1.27,1.28,+0.01,0.79,214000,6,275880,0,0,0,0,0,0,20000,214000,-194000,-194000
20200528,711166,雙美元大9C購03,1.10,1.14,1.10,1.13,+0.02,1.8,305000,6,345530,0,0,0,0,0,0,304000,55000,249000,249000
20200528,711167,神盾麥證9C購02,,,,,,0.00,0,0,0,0,0,0,0,0,0,0,0,0,0
20200528,711168,原相凱基9B購04,1.88,1.88,1.63,1.63,-0.21,-11.41,313000,27,550110,0,0,0,0,0,0,231000,172000,59000,59000
20200528,711169,精測凱基01購01,1.13,1.13,1.06,1.06,-0.05,-4.5,128000,3,142680,0,0,0,0,0,0,18000,110000,-92000,-92000
20200528,711170,網家凱基9B購02,1.86,1.86,1.79,1.79,-0.17,-8.67,25000,3,46250,0,0,0,0,0,0,22000,3000,19000,19000
20200528,711171,雙鴻凱基9B購02,1.77,1.77,1.75,1.75,-0.03,-1.69,75000,4,132650,0,0,0,0,0,0,1000,74000,-73000,-73000
20200528,711172,穩懋凱基9B購03,1.09,1.09,1.09,1.09,0.00,0.0,20000,1,21800,0,0,0,0,0,0,20000,0,20000,20000
20200528,711173,群聯統一9B購03,1.07,1.07,1.07,1.07,-0.01,-0.93,7000,1,7490,0,0,0,0,0,0,7000,7000,0,0
20200528,711174,寶雅統一01購02,0.91,0.91,0.88,0.90,-0.05,-5.26,434000,7,390980,0,0,0,0,0,0,423000,11000,412000,412000
20200528,711175,寶雅統一9B購01,,,,,,0.00,0,0,0,0,0,0,0,0,0,0,0,0,0
20200528,711176,久元國票9B購01,4.00,4.33,3.49,3.49,+0.19,5.76,160000,11,624130,0,0,0,0,0,0,89000,72000,17000,17000
20200528,711177,大江國票9B購03,4.22,4.38,4.21,4.38,+0.09,2.1,66000,5,281460,0,0,0,0,0,0,3000,63000,-60000,-60000
20200528,711178,宇峻國票9B購04,0.98,1.05,0.98,1.05,+0.12,12.9,329000,9,336700,0,0,0,0,0,0,20000,329000,-309000,-309000
20200528,711179,胡連國票9B購01,2.76,2.76,2.76,2.76,+0.05,1.85,11000,1,30360,0,0,0,0,0,0,0,11000,-11000,-11000
20200528,711180,環球晶國票9C購02,2.21,2.21,2.21,2.21,+0.06,2.79,14000,1,30940,0,0,0,0,0,0,0,14000,-14000,-14000
20200528,711181,譜瑞台新9B購01,1.47,1.52,1.40,1.40,-0.14,-9.09,577000,33,837960,0,0,0,0,0,0,158000,409000,-251000,-251000
20200528,711182,原相國泰9C購01,3.68,3.74,3.12,3.12,-0.40,-11.36,151000,21,542500,0,0,0,0,0,0,111000,40000,71000,71000
20200528,711183,泰博國泰01購01,1.36,1.63,1.36,1.62,+0.32,24.62,278000,4,447860,0,0,0,0,0,0,250000,28000,222000,222000
20200528,711184,穩懋國泰9C購01,2.57,2.62,2.57,2.62,-0.03,-1.13,99000,6,258050,0,0,0,0,0,0,99000,0,99000,99000
20200528,711185,大學光元大9C購03,2.01,2.09,1.79,1.79,-0.18,-9.14,1249000,64,2517920,0,0,0,0,0,0,922000,264000,658000,658000
20200528,711186,中美晶元大9B購04,2.01,2.04,1.95,2.01,-0.01,-0.5,120000,9,236860,0,0,0,0,0,0,35000,85000,-50000,-50000
20200528,711187,環球晶元大9B購01,2.22,2.30,2.22,2.30,+0.05,2.22,44000,6,99360,0,0,0,0,0,0,2000,44000,-42000,-42000
20200528,711188,穩懋元大9C購01,1.65,1.65,1.65,1.65,-0.01,-0.6,78000,4,128700,0,0,0,0,0,0,0,78000,-78000,-78000
20200528,711189,久元凱基9B購01,2.93,3.29,2.51,2.55,+0.05,2.0,421000,55,1206460,0,0,0,0,0,0,253000,253000,0,0
20200528,711190,大江凱基9B購03,1.47,1.47,1.47,1.47,0.00,0.0,20000,1,29400,0,0,0,0,0,0,20000,0,20000,20000
20200528,711191,信驊凱基9B購01,3.46,3.55,3.46,3.55,-0.13,-3.53,31000,2,107350,0,0,0,0,0,0,0,31000,-31000,-31000
20200528,711192,群聯凱基9B購07,3.09,3.11,3.06,3.06,+0.03,0.99,80000,7,248050,0,0,0,0,0,0,80000,11000,69000,69000
20200528,711193,碩禾凱基9B購03,,,,,,0.00,0,0,0,0,0,0,0,0,0,0,0,0,0
20200528,711194,環球晶凱基9B購05,1.01,1.01,1.01,1.01,+0.04,4.12,18000,1,18180,0,0,0,0,0,0,18000,18000,0,0
20200528,711195,元太統一9B購01,0.98,1.01,0.89,0.91,-0.06,-6.19,680000,33,646780,0,0,0,0,0,0,261000,418000,-157000,-157000
20200528,711196,世界統一9C購01,0.94,0.94,0.90,0.90,+0.01,1.12,442000,5,403560,0,0,0,0,0,0,20000,422000,-402000,-402000
20200528,711197,精測統一9C購01,1.05,1.05,0.98,0.98,-0.04,-3.92,276000,5,277920,0,0,0,0,0,0,207000,69000,138000,138000
20200528,711198,聯亞統一9B購01,0.80,0.82,0.80,0.82,0.00,0.0,274000,3,220420,0,0,0,0,0,0,213000,61000,152000,152000
20200528,711199,元太富邦9C購01,1.43,1.47,1.30,1.32,-0.09,-6.38,826000,43,1149600,0,0,0,0,0,0,395000,429000,-34000,-34000
20200528,711200,合晶富邦9C購01,0.54,0.54,0.54,0.54,+0.02,3.85,20000,1,10800,0,0,0,0,0,0,0,20000,-20000,-20000
20200528,711201,泰博群益9B購04,2.08,2.49,1.96,2.43,+0.49,25.26,415000,23,880610,0,0,0,0,0,0,148000,353000,-205000,-205000
20200528,711202,群聯群益9B購05,2.34,2.36,2.20,2.20,-0.10,-4.35,118000,7,267120,0,0,0,0,0,0,64000,75000,-11000,-11000
20200528,711203,雍智群益9B購02,2.06,2.06,1.87,1.87,-0.17,-8.33,1020000,18,1931860,0,0,0,0,0,0,52000,968000,-916000,-916000
20200528,711204,雙鴻群益9C購01,1.40,1.41,1.37,1.37,-0.02,-1.44,341000,4,477310,0,0,0,0,0,0,89000,254000,-165000,-165000
20200528,711205,合晶兆豐9B購01,1.27,1.30,1.23,1.26,-0.05,-3.82,134000,17,171800,0,0,0,0,0,0,131000,3000,128000,128000
20200528,711206,金可兆豐9B購01,1.43,1.45,1.39,1.45,+0.08,5.84,366000,7,525560,0,0,0,0,0,0,20000,346000,-326000,-326000
20200528,711207,群聯兆豐9C購01,0.99,0.99,0.93,0.93,-0.03,-3.12,36000,9,34170,0,0,0,0,0,0,0,36000,-36000,-36000
20200528,711208,群聯兆豐9C購02,0.88,0.88,0.84,0.84,-0.03,-3.45,230000,5,199000,0,0,0,0,0,0,40000,190000,-150000,-150000
20200528,711209,譜瑞兆豐9B購01,1.73,1.75,1.73,1.75,-0.30,-14.63,78000,2,135140,0,0,0,0,0,0,68000,10000,58000,58000
20200528,711210,世界國票9B購01,,,,,,0.00,0,0,0,0,0,0,0,0,0,0,0,0,0
20200528,711211,是方國票9B購02,,,,,,0.00,0,0,0,0,0,0,0,0,0,0,0,0,0
20200528,711212,聯亞國票9B購03,3.82,3.88,3.82,3.88,-0.17,-4.2,16000,2,61600,0,0,0,0,0,0,0,16000,-16000,-16000
20200528,711213,鈊象國票9B購04,2.30,2.75,2.30,2.68,+0.54,25.23,156000,19,394540,0,0,0,0,0,0,74000,128000,-54000,-54000
20200528,711214,是方中信9B購01,1.26,1.26,1.12,1.24,+0.05,4.2,298000,19,349790,0,0,0,0,0,0,239000,37000,202000,202000
20200528,711215,力旺永豐9B購02,1.81,1.91,1.73,1.73,-0.03,-1.7,469000,22,865660,0,0,0,0,0,0,417000,52000,365000,365000
20200528,711216,世界永豐9B購01,0.89,0.89,0.89,0.89,+0.04,4.71,17000,1,15130,0,0,0,0,0,0,0,17000,-17000,-17000
20200528,711217,建榮永豐9C購01,1.02,1.04,1.02,1.04,+0.04,4.0,110000,2,113300,0,0,0,0,0,0,55000,55000,0,0
20200528,711218,泰博永豐9C購01,1.07,1.25,1.04,1.25,+0.23,22.55,134000,7,146180,0,0,0,0,0,0,1000,132000,-131000,-131000
20200528,711219,雍智永豐9B購02,1.17,1.17,1.04,1.04,-0.15,-12.61,97000,6,109240,0,0,0,0,0,0,87000,10000,77000,77000
20200528,711220,信驊永豐9B購01,1.02,1.06,0.99,0.99,+0.04,4.21,316000,8,329520,0,0,0,0,0,0,13000,303000,-290000,-290000
20200528,711221,建榮永豐9B購06,,,,,,0.00,0,0,0,0,0,0,0,0,0,0,0,0,0
20200528,711222,泰博永豐9B購03,0.75,0.97,0.74,0.91,+0.19,26.39,551000,26,429980,0,0,0,0,0,0,114000,406000,-292000,-292000
20200528,711223,譜瑞永豐9B購02,1.13,1.13,1.02,1.02,-0.09,-8.11,30000,3,32600,0,0,0,0,0,0,10000,20000,-10000,-10000
20200528,711224,凡甲元大9C購02,,,,,,0.00,0,0,0,0,0,0,0,0,0,0,0,0,0
20200528,711225,金居元大9B購04,2.79,2.80,2.58,2.58,-0.21,-7.53,124000,3,332110,0,0,0,0,0,0,68000,56000,12000,12000
20200528,711226,新普元大9B購01,2.19,2.38,2.19,2.36,+0.16,7.27,639000,49,1467430,0,0,0,0,0,0,150000,515000,-365000,-365000
20200528,711227,新鉅科元大9B購02,2.80,2.87,2.80,2.82,+0.02,0.71,189000,19,537150,0,0,0,0,0,0,137000,52000,85000,85000
20200528,711228,精測元大9C購02,1.95,1.97,1.86,1.86,-0.06,-3.12,138000,11,264690,0,0,0,0,0,0,103000,73000,30000,30000
20200528,711229,廣明元大9B購01,2.02,2.02,1.91,1.91,-0.10,-4.98,50000,5,98800,0,0,0,0,0,0,0,50000,-50000,-50000
20200528,711230,譜瑞元大9B購01,2.93,3.13,2.88,2.88,-0.22,-7.1,238000,20,702500,0,0,0,0,0,0,51000,232000,-181000,-181000
20200528,711231,群聯統一9B購04,0.98,0.98,0.93,0.93,-0.04,-4.12,226000,4,221230,0,0,0,0,0,0,181000,45000,136000,136000
20200528,711232,中美晶凱基9C購01,3.08,3.08,2.94,2.94,-0.06,-2.0,48000,6,146210,0,0,0,0,0,0,23000,25000,-2000,-2000
20200528,711233,世界凱基9B購01,2.09,2.10,2.03,2.03,0.00,0.0,70000,4,145800,0,0,0,0,0,0,0,70000,-70000,-70000
20200528,711234,宏捷科凱基9C購04,0.90,0.90,0.90,0.90,-0.04,-4.26,2000,1,1800,0,0,0,0,0,0,0,2000,-2000,-2000
20200528,711235,網家凱基9C購02,1.85,1.86,1.85,1.86,-0.09,-4.62,28000,2,51900,0,0,0,0,0,0,28000,0,28000,28000
20200528,711236,元太國票9B購02,3.72,3.89,3.37,3.42,-0.35,-9.28,139000,16,520230,0,0,0,0,0,0,76000,63000,13000,13000
20200528,711237,信驊國票9B購01,3.41,3.55,3.28,3.28,+0.18,5.81,39000,5,136240,0,0,0,0,0,0,10000,29000,-19000,-19000
20200528,711238,泰博國票9B購02,2.49,3.07,2.42,2.96,+0.53,21.81,437000,53,1152380,0,0,0,0,0,0,41000,386000,-345000,-345000
20200528,711239,雍智國票9B購01,1.45,1.45,1.31,1.31,-0.13,-9.03,131000,7,184550,0,0,0,0,0,0,94000,37000,57000,57000
20200528,711240,廣明國票9B購01,2.37,2.40,2.37,2.40,+0.06,2.56,26000,2,62010,0,0,0,0,0,0,0,26000,-26000,-26000
20200528,711241,譜瑞國票9B購01,3.60,3.83,3.39,3.39,-0.35,-9.36,48000,7,171010,0,0,0,0,0,0,12000,36000,-24000,-24000
20200528,711242,世界群益9C購01,1.61,1.61,1.61,1.61,+0.07,4.55,47000,1,75670,0,0,0,0,0,0,0,47000,-47000,-47000
20200528,711243,旺矽群益9B購01,,,,,,0.00,0,0,0,0,0,0,0,0,0,0,0,0,0
20200528,711244,金可群益9B購01,,,,,,0.00,0,0,0,0,0,0,0,0,0,0,0,0,0
20200528,711245,大江兆豐9C購01,0.85,0.86,0.85,0.86,+0.02,2.38,20000,2,17100,0,0,0,0,0,0,20000,0,20000,20000
20200528,711246,台燿兆豐9B購01,0.93,0.97,0.92,0.97,+0.01,1.04,32000,11,29710,0,0,0,0,0,0,30000,2000,28000,28000
20200528,711247,旺矽兆豐9B購01,1.13,1.13,1.13,1.13,-0.05,-4.24,9000,1,10170,0,0,0,0,0,0,0,9000,-9000,-9000
20200528,711248,金居兆豐9B購01,,,,,,0.00,0,0,0,0,0,0,0,0,0,0,0,0,0
20200528,711249,頎邦兆豐9B購01,1.32,1.32,1.24,1.24,-0.01,-0.8,59000,4,75970,0,0,0,0,0,0,52000,7000,45000,45000
20200528,711250,元太元富9B購01,2.21,2.27,2.02,2.02,-0.16,-7.34,605000,29,1336200,0,0,0,0,0,0,88000,497000,-409000,-409000
20200528,711251,金居元富9B購01,,,,,,0.00,0,0,0,0,0,0,0,0,0,0,0,0,0
20200528,711252,信驊元富9B購01,1.90,1.97,1.78,1.78,+0.03,1.71,774000,41,1460420,0,0,0,0,0,0,182000,592000,-410000,-410000
20200528,711253,神盾元富9B購03,1.40,1.40,1.40,1.40,+0.03,2.19,47000,2,65800,0,0,0,0,0,0,47000,0,47000,47000
20200528,711254,群聯麥證9C購01,1.18,1.18,1.16,1.16,+0.01,0.87,26000,3,30390,13000,13000,0,0,0,0,13000,13000,0,0
20200528,711255,大學光國泰9C購01,1.89,1.99,1.82,1.82,-0.10,-5.21,137000,25,261890,0,0,0,0,0,0,121000,12000,109000,109000
20200528,711256,元太國泰01購01,2.28,2.41,2.19,2.23,-0.07,-3.04,202000,20,476960,0,0,0,0,0,0,120000,197000,-77000,-77000
20200528,711257,勝麗群益9B購01,2.26,2.27,2.20,2.20,-0.08,-3.51,136000,13,305290,0,0,0,0,0,0,96000,40000,56000,56000
20200528,711258,環球晶富邦01購02,0.73,0.73,0.70,0.72,+0.01,1.41,170000,8,122800,0,0,0,0,0,0,0,170000,-170000,-170000
20200528,711259,大學光國票9C購03,1.82,1.93,1.64,1.64,-0.12,-6.82,1438000,39,2646620,0,0,0,0,0,0,173000,1265000,-1092000,-1092000
20200528,711260,旺矽國票9B購01,2.64,2.64,2.57,2.60,-0.28,-9.72,52000,3,137170,0,0,0,0,0,0,52000,50000,2000,2000
20200528,711261,金居國票9B購01,2.91,2.96,2.60,2.60,-0.43,-14.19,12000,3,35110,0,0,0,0,0,0,1000,11000,-10000,-10000
20200528,711262,新普國票9B購01,3.06,3.27,3.00,3.19,+0.05,1.59,227000,20,707320,0,0,0,0,0,0,91000,191000,-100000,-100000
20200528,711263,雙美國票9B購03,3.30,3.51,3.30,3.42,+0.06,1.79,502000,5,1699560,0,0,0,0,0,0,200000,502000,-302000,-302000
20200528,711264,大學光永豐9B購03,1.08,1.12,0.98,0.98,-0.09,-8.41,1531000,65,1651730,0,0,0,0,0,0,1378000,115000,1263000,1263000
20200528,711265,神盾永豐9B購02,1.37,1.37,1.31,1.31,-0.07,-5.07,103000,3,140930,0,0,0,0,0,0,103000,12000,91000,91000
20200528,711266,鈊象永豐9B購02,1.24,1.50,1.24,1.48,+0.39,35.78,162000,7,210190,0,0,0,0,0,0,1000,162000,-161000,-161000
20200528,711267,金居凱基9B購02,3.50,3.51,3.28,3.28,-0.34,-9.39,87000,7,302790,0,0,0,0,0,0,33000,65000,-32000,-32000
20200528,711268,新普凱基9B購01,1.68,1.76,1.60,1.76,+0.09,5.39,365000,54,629980,0,0,0,0,0,0,137000,320000,-183000,-183000
20200528,711269,聯亞凱基9B購01,2.69,2.84,2.69,2.84,+0.03,1.07,21000,2,57990,0,0,0,0,0,0,0,21000,-21000,-21000
20200528,711270,台燿統一01購02,0.72,0.73,0.72,0.73,0.00,0.0,176000,12,127400,0,0,0,0,0,0,176000,0,176000,176000
20200528,711271,瓦城統一01購01,1.19,1.20,1.05,1.08,-0.08,-6.9,1788000,49,2015660,0,0,0,0,0,0,1407000,306000,1101000,1101000
20200528,711272,譜瑞統一9C購01,0.94,0.97,0.93,0.93,-0.06,-6.06,61000,9,57970,0,0,0,0,0,0,20000,41000,-21000,-21000
20200528,711273,鈊象統一9B購02,1.06,1.33,1.06,1.31,+0.27,25.96,580000,36,698900,0,0,0,0,0,0,137000,494000,-357000,-357000
20200528,711274,力旺元大9B購01,2.83,2.92,2.69,2.77,+0.04,1.47,503000,34,1424950,0,0,0,0,0,0,443000,149000,294000,294000
20200528,711275,元太元大9B購03,3.41,3.52,3.19,3.19,-0.15,-4.49,977000,54,3293530,0,0,0,0,0,0,317000,830000,-513000,-513000
20200528,711276,宇峻元大9C購02,1.02,1.10,1.02,1.08,+0.07,6.93,204000,9,218450,0,0,0,0,0,0,0,204000,-204000,-204000
20200528,711277,旺矽元大9B購02,2.26,2.27,2.19,2.19,0.00,0.0,92000,6,204290,0,0,0,0,0,0,20000,72000,-52000,-52000
20200528,711278,旺矽元大9B購03,1.81,1.81,1.72,1.72,-0.05,-2.82,78000,4,137630,0,0,0,0,0,0,18000,60000,-42000,-42000
20200528,711279,信驊元大9B購02,2.50,2.64,2.40,2.40,+0.09,3.9,241000,23,603170,0,0,0,0,0,0,97000,190000,-93000,-93000
20200528,711280,是方元大9C購01,3.41,3.41,3.29,3.29,-0.01,-0.3,14000,2,47260,0,0,0,0,0,0,10000,4000,6000,6000
20200528,711281,閎康元大9B購01,2.12,2.16,2.10,2.16,0.00,0.0,340000,9,718970,0,0,0,0,0,0,285000,61000,224000,224000
20200528,711282,群聯元大9B購09,3.65,3.65,3.49,3.49,-0.10,-2.79,52000,6,188820,0,0,0,0,0,0,52000,12000,40000,40000
20200528,711283,聯亞元大9B購06,1.68,1.77,1.68,1.68,-0.03,-1.75,621000,8,1071950,0,0,0,0,0,0,565000,621000,-56000,-56000
20200528,711284,信驊兆豐9B購01,1.80,1.91,1.74,1.74,+0.06,3.57,475000,10,874050,0,0,0,0,0,0,8000,467000,-459000,-459000
20200528,711285,穩懋兆豐9C購01,0.70,0.72,0.70,0.72,0.00,0.0,65000,6,46150,0,0,0,0,0,0,46000,19000,27000,27000
20200528,711286,弘塑元富9B購02,1.43,1.43,1.39,1.39,-0.07,-4.79,221000,6,310900,0,0,0,0,0,0,100000,121000,-21000,-21000
20200528,711287,環球晶元富9B購03,,,,,,0.00,0,0,0,0,0,0,0,0,0,0,0,0,0
20200528,711288,環球晶元富9B購04,1.35,1.36,1.35,1.36,-0.01,-0.73,22000,2,29810,0,0,0,0,0,0,11000,11000,0,0
20200528,711289,新普麥證9B購01,1.39,1.48,1.39,1.47,+0.05,3.52,77000,7,110240,35000,42000,-7000,0,0,0,35000,42000,-7000,-7000
20200528,711290,鈊象麥證9C購01,1.78,2.00,1.78,2.00,+0.34,20.48,192000,20,358590,32000,150000,-118000,0,0,0,74000,150000,-76000,-76000
20200528,711291,網家國泰01購01,,,,,,0.00,0,0,0,0,0,0,0,0,0,0,0,0,0
20200528,711292,M31永豐9B購01,1.25,1.25,1.09,1.13,-0.16,-12.4,202000,9,241930,0,0,0,0,0,0,139000,63000,76000,76000
20200528,711293,力旺永豐9B購03,1.08,1.13,1.01,1.03,-0.03,-2.83,1153000,42,1246310,0,0,0,0,0,0,971000,167000,804000,804000
20200528,711294,原相永豐9B購02,1.20,1.20,1.11,1.11,-0.01,-0.89,298000,12,337220,0,0,0,0,0,0,288000,10000,278000,278000
20200528,711295,精測永豐9B購01,1.29,1.32,1.29,1.32,-0.06,-4.35,120000,3,155120,0,0,0,0,0,0,120000,0,120000,120000
20200528,711296,力旺元大9B購02,1.96,2.02,1.79,1.83,-0.27,-12.86,422000,29,828800,0,0,0,0,0,0,409000,45000,364000,364000
20200528,711297,中美晶元大9B購05,2.19,2.19,2.19,2.19,+0.03,1.39,5000,1,10950,0,0,0,0,0,0,0,5000,-5000,-5000
20200528,711298,世界元大9B購01,4.25,4.28,4.25,4.27,+0.26,6.48,35000,3,148870,0,0,0,0,0,0,0,35000,-35000,-35000
20200528,711299,世界元大9B購02,3.51,3.54,3.51,3.54,+0.14,4.12,58000,6,203720,0,0,0,0,0,0,0,58000,-58000,-58000
20200528,711300,信昌電元大9B購01,2.10,2.10,2.00,2.08,+0.01,0.48,114000,18,236620,0,0,0,0,0,0,114000,51000,63000,63000
20200528,711301,博智元大9C購01,1.72,1.72,1.68,1.72,-0.01,-0.58,119000,5,203800,0,0,0,0,0,0,6000,113000,-107000,-107000
20200528,711302,群聯元大9B購10,,,,,,0.00,0,0,0,0,0,0,0,0,0,0,0,0,0
20200528,711303,譜瑞元大9B購02,2.71,2.81,2.61,2.61,-0.16,-5.78,165000,11,441930,0,0,0,0,0,0,37000,165000,-128000,-128000
20200528,711304,信驊群益9B購01,1.86,1.88,1.82,1.82,+0.09,5.2,196000,7,362490,0,0,0,0,0,0,130000,66000,64000,64000
20200528,711305,精測群益9B購04,1.41,1.41,1.40,1.40,-0.06,-4.11,80000,2,112300,0,0,0,0,0,0,80000,0,80000,80000
20200528,711306,環球晶群益9C購01,0.96,0.96,0.95,0.95,+0.03,3.26,229000,9,219040,0,0,0,0,0,0,18000,229000,-211000,-211000
20200528,711307,聚積國票9B購01,2.64,2.64,2.64,2.64,+0.08,3.12,20000,1,52800,0,0,0,0,0,0,0,20000,-20000,-20000
20200528,711308,M31統一9C購01,1.54,1.54,1.34,1.34,-0.23,-14.65,833000,32,1259720,0,0,0,0,0,0,704000,124000,580000,580000
20200528,711309,久元統一01購01,1.06,1.17,1.06,1.07,+0.13,13.83,416000,13,464890,0,0,0,0,0,0,53000,363000,-310000,-310000
20200528,711310,原相統一01購01,0.88,0.89,0.80,0.81,-0.04,-4.71,455000,24,390550,0,0,0,0,0,0,83000,372000,-289000,-289000
20200528,711311,環球晶統一9C購03,1.32,1.32,1.30,1.30,+0.03,2.36,203000,4,267860,0,0,0,0,0,0,0,203000,-203000,-203000
20200528,711312,雙鴻統一9C購02,0.78,0.79,0.77,0.77,+0.01,1.32,620000,9,483210,0,0,0,0,0,0,158000,462000,-304000,-304000
20200528,711313,穩懋凱基9C購02,3.01,3.03,3.01,3.03,-0.01,-0.33,2000,2,6040,0,0,0,0,0,0,0,2000,-2000,-2000
20200528,711314,凡甲麥證9B購01,1.55,1.55,1.55,1.55,0.00,0.0,10000,1,15500,10000,0,10000,0,0,0,10000,0,10000,10000
20200528,711315,精測麥證9C購01,1.69,1.70,1.56,1.56,-0.08,-4.88,101000,9,167580,50000,51000,-1000,0,0,0,50000,51000,-1000,-1000
20200528,711316,中美晶元富9B購03,,,,,,0.00,0,0,0,0,0,0,0,0,0,0,0,0,0
20200528,711317,博智元富9B購01,1.12,1.16,1.11,1.16,+0.01,0.87,184000,5,208640,0,0,0,0,0,0,93000,91000,2000,2000
20200528,711318,網家元富9B購01,1.96,1.98,1.96,1.98,-0.03,-1.49,183000,8,359160,0,0,0,0,0,0,164000,19000,145000,145000
20200528,711319,璟德兆豐9B購01,1.33,1.33,1.31,1.31,-0.02,-1.5,41000,3,54080,0,0,0,0,0,0,11000,30000,-19000,-19000
20200528,711320,聯亞兆豐9B購01,0.98,0.98,0.97,0.97,-0.04,-3.96,179000,4,175230,0,0,0,0,0,0,179000,0,179000,179000
20200528,711321,原相元大9B購07,2.41,2.41,2.09,2.09,-0.21,-9.13,350000,36,804390,0,0,0,0,0,0,325000,83000,242000,242000
20200528,711322,環球晶元大9B購02,2.94,2.95,2.94,2.95,+0.03,1.03,26000,2,76690,0,0,0,0,0,0,1000,26000,-25000,-25000
20200528,711323,環球晶元大9B購03,3.01,3.02,2.99,3.02,+0.17,5.96,52000,4,156280,0,0,0,0,0,0,2000,52000,-50000,-50000
20200528,711324,凡甲富邦9C購01,0.69,0.69,0.64,0.64,-0.05,-7.25,432000,30,291010,0,0,0,0,0,0,342000,90000,252000,252000
20200528,711325,久元群益9B購01,2.06,2.15,1.72,1.72,+0.19,12.42,129000,13,262480,0,0,0,0,0,0,7000,129000,-122000,-122000
20200528,711326,金居群益9C購01,,,,,,0.00,0,0,0,0,0,0,0,0,0,0,0,0,0
20200528,711327,群聯群益9B購06,2.10,2.10,1.94,1.98,-0.07,-3.41,134000,9,274530,0,0,0,0,0,0,124000,22000,102000,102000
20200528,711328,譜瑞群益9B購02,1.74,1.74,1.72,1.72,-0.10,-5.49,48000,3,83320,0,0,0,0,0,0,0,48000,-48000,-48000
20200528,711329,譜瑞統一01購01,0.96,1.01,0.94,0.94,-0.06,-6.0,149000,17,147070,0,0,0,0,0,0,13000,136000,-123000,-123000
20200528,711330,元太凱基9C購01,2.17,2.26,2.00,2.03,-0.14,-6.45,201000,21,442400,0,0,0,0,0,0,118000,197000,-79000,-79000
20200528,711331,台燿凱基9B購03,1.85,1.92,1.81,1.90,-0.03,-1.55,106000,11,197730,0,0,0,0,0,0,65000,51000,14000,14000
20200528,711332,聯亞凱基9C購01,2.05,2.05,2.05,2.05,+0.05,2.5,20000,2,41000,0,0,0,0,0,0,20000,20000,0,0
20200528,711333,久元中信9B購01,1.23,1.23,1.23,1.23,+0.23,23.0,10000,1,12300,0,0,0,0,0,0,0,10000,-10000,-10000
20200528,711334,久元永豐9B購02,0.99,0.99,0.96,0.96,+0.04,4.35,109000,2,104670,0,0,0,0,0,0,109000,0,109000,109000
20200528,711335,大田永豐9B購02,0.79,0.79,0.75,0.75,-0.08,-9.64,9000,2,6910,0,0,0,0,0,0,4000,5000,-1000,-1000
20200528,711336,茂達永豐9B購01,1.02,1.11,1.00,1.11,+0.12,12.12,116000,8,120250,0,0,0,0,0,0,86000,30000,56000,56000
20200528,711337,順達永豐9B購01,1.26,1.30,1.18,1.30,0.00,0.0,99000,10,121420,0,0,0,0,0,0,90000,5000,85000,85000
20200528,711338,網家永豐9B購01,0.86,0.87,0.80,0.80,-0.10,-11.11,64000,5,53710,0,0,0,0,0,0,52000,0,52000,52000
20200528,711339,晟德永豐9B購01,1.32,1.35,1.26,1.26,-0.09,-6.67,389000,13,514530,0,0,0,0,0,0,388000,1000,387000,387000
20200528,711340,M31國票9C購01,5.65,5.65,5.10,5.10,-0.85,-14.29,72000,6,400300,0,0,0,0,0,0,67000,5000,62000,62000
20200528,711341,世界元富9B購01,2.23,2.32,2.23,2.32,+0.13,5.94,96000,6,221190,0,0,0,0,0,0,2000,94000,-92000,-92000
20200528,711342,晶焱元富9B購01,2.70,2.70,2.70,2.70,+0.03,1.12,4000,1,10800,0,0,0,0,0,0,4000,0,4000,4000
20200528,711343,雍智國泰01購01,1.57,1.57,1.38,1.38,-0.16,-10.39,195000,8,292950,0,0,0,0,0,0,165000,30000,135000,135000
20200528,711344,力旺元大9B購03,2.12,2.18,2.05,2.05,+0.02,0.99,374000,29,794710,0,0,0,0,0,0,318000,55000,263000,263000
20200528,711345,久元元大9B購02,2.27,2.50,1.97,1.97,+0.01,0.51,94000,14,207090,0,0,0,0,0,0,22000,79000,-57000,-57000
20200528,711346,大江元大9B購02,1.62,1.69,1.61,1.69,+0.04,2.42,334000,7,551580,0,0,0,0,0,0,245000,334000,-89000,-89000
20200528,711347,元太元大9B購04,2.38,2.45,2.16,2.16,-0.20,-8.47,703000,30,1659140,0,0,0,0,0,0,78000,679000,-601000,-601000
20200528,711348,合晶元大9B購01,1.48,1.48,1.43,1.43,0.00,0.0,210000,3,300800,0,0,0,0,0,0,199000,10000,189000,189000
20200528,711349,宇峻元大9B購02,2.21,2.33,2.21,2.33,+0.24,11.48,37000,2,83210,0,0,0,0,0,0,0,37000,-37000,-37000
20200528,711350,宜鼎元大9B購02,1.65,1.69,1.61,1.62,0.00,0.0,505000,23,834620,0,0,0,0,0,0,166000,480000,-314000,-314000
20200528,711351,金居元大9C購01,1.67,1.67,1.63,1.63,-0.04,-2.4,10000,2,16500,0,0,0,0,0,0,10000,0,10000,10000
20200528,711352,新普元大9B購02,3.22,3.56,3.22,3.52,+0.24,7.32,366000,39,1248560,0,0,0,0,0,0,100000,318000,-218000,-218000
20200528,711353,新普元大9B購03,2.21,2.34,2.16,2.33,+0.13,5.91,390000,38,879230,0,0,0,0,0,0,76000,346000,-270000,-270000
20200528,711354,網家元大9B購05,1.80,1.80,1.80,1.80,-0.06,-3.23,19000,1,34200,0,0,0,0,0,0,19000,0,19000,19000
20200528,711355,環球晶元大9C購03,1.58,1.58,1.57,1.57,+0.07,4.67,50000,2,78900,0,0,0,0,0,0,0,50000,-50000,-50000
20200528,711356,大江群益9C購01,0.83,0.85,0.83,0.83,-0.01,-1.19,173000,7,146300,0,0,0,0,0,0,47000,173000,-126000,-126000
20200528,711357,世界群益9C購02,2.56,2.57,2.56,2.57,+0.11,4.47,48000,5,122930,0,0,0,0,0,0,0,48000,-48000,-48000
20200528,711358,宜鼎群益9B購01,3.63,3.67,3.63,3.67,+0.21,6.07,33000,2,120430,0,0,0,0,0,0,0,33000,-33000,-33000
20200528,711359,雙美群益9C購02,1.05,1.10,1.05,1.06,+0.02,1.92,679000,15,720690,0,0,0,0,0,0,363000,366000,-3000,-3000
20200528,711360,晟德群益9B購02,1.71,1.71,1.65,1.65,-0.14,-7.82,128000,5,214880,0,0,0,0,0,0,78000,50000,28000,28000
20200528,711361,鈊象群益9B購04,1.72,2.03,1.72,1.96,+0.42,27.27,206000,8,396800,0,0,0,0,0,0,45000,206000,-161000,-161000
20200528,711362,原相第一9B購01,0.64,0.64,0.64,0.64,-0.03,-4.48,90000,1,57600,0,0,0,0,0,0,90000,0,90000,90000
20200528,711363,皇田永豐9B購01,0.92,0.92,0.91,0.91,+0.01,1.11,116000,2,105620,0,0,0,0,0,0,110000,0,110000,110000
20200528,711364,力旺麥證9B購01,1.76,1.84,1.68,1.75,-0.03,-1.69,98000,11,172890,62000,36000,26000,0,0,0,62000,36000,26000,26000
20200528,711365,合晶凱基9B購01,1.41,1.41,1.41,1.41,-0.06,-4.08,10000,1,14100,0,0,0,0,0,0,10000,10000,0,0
20200528,711366,是方凱基9B購01,2.41,2.42,2.39,2.39,+0.04,1.7,79000,4,189990,0,0,0,0,0,0,49000,30000,19000,19000
20200528,711367,原相凱基9B購05,1.86,1.86,1.63,1.63,-0.18,-9.94,142000,11,245220,5000,0,5000,0,0,0,137000,75000,62000,67000
20200528,711368,優群凱基9B購02,2.33,2.42,2.12,2.36,+0.41,21.03,78000,13,178810,2000,0,2000,0,0,0,19000,63000,-44000,-42000
20200528,711369,聯亞凱基01購01,3.60,3.60,3.60,3.60,+0.18,5.26,10000,1,36000,0,0,0,0,0,0,10000,10000,0,0
20200528,711370,鈊象凱基9B購04,2.23,2.58,2.22,2.58,+0.56,27.72,134000,10,326930,0,0,0,0,0,0,42000,134000,-92000,-92000
20200528,711371,久元統一01購02,0.95,1.02,0.95,1.02,+0.20,24.39,258000,8,252300,0,0,0,0,0,0,61000,197000,-136000,-136000
20200528,711372,久元統一01購03,0.88,0.92,0.88,0.92,+0.16,21.05,186000,4,166500,0,0,0,0,0,0,0,186000,-186000,-186000
20200528,711373,雙鴻統一9B購01,1.13,1.17,1.11,1.11,-0.06,-5.13,567000,16,656920,0,0,0,0,0,0,256000,342000,-86000,-86000
20200528,711374,穩懋統一9C購05,0.96,0.96,0.96,0.96,+0.01,1.05,63000,1,60480,0,0,0,0,0,0,63000,0,63000,63000
20200528,711375,寶雅統一01購03,,,,,,0.00,0,0,0,0,0,0,0,0,0,0,0,0,0
20200528,711376,群聯富邦9C購01,0.79,0.79,0.78,0.79,+0.01,1.28,64000,6,50360,0,0,0,0,0,0,64000,0,64000,64000
20200528,711377,精測富邦9C購02,,,,,,0.00,0,0,0,0,0,0,0,0,0,0,0,0,0
20200528,711378,鈊象富邦9C購01,0.76,0.91,0.76,0.88,+0.18,25.71,809000,47,680140,0,0,0,0,0,0,10000,799000,-789000,-789000
20200528,711379,凡甲國票9C購01,2.66,2.66,2.66,2.66,-0.08,-2.92,4000,1,10640,0,0,0,0,0,0,4000,0,4000,4000
20200528,711380,弘塑國票9C購01,,,,,,0.00,0,0,0,0,0,0,0,0,0,0,0,0,0
20200528,711381,原相國票9B購03,1.61,1.61,1.44,1.44,-0.10,-6.49,376000,24,568670,0,0,0,0,0,0,211000,165000,46000,46000
20200528,711382,雍智國票9B購02,4.95,4.95,4.73,4.73,-0.62,-11.59,12000,3,58010,0,0,0,0,0,0,0,12000,-12000,-12000
20200528,711383,鈊象國票9B購05,4.70,5.70,4.70,5.70,+1.37,31.64,127000,20,682860,0,0,0,0,0,0,48000,127000,-79000,-79000
20200528,711384,久元元富9B購01,1.83,1.91,1.57,1.57,+0.01,0.64,325000,8,561980,0,0,0,0,0,0,132000,193000,-61000,-61000
20200528,711385,旺矽元富9B購01,1.66,1.66,1.66,1.66,-0.03,-1.78,6000,1,9960,0,0,0,0,0,0,0,6000,-6000,-6000
20200528,711386,神盾元富9C購01,1.42,1.42,1.41,1.41,0.00,0.0,13000,2,18440,0,0,0,0,0,0,13000,0,13000,13000
20200528,711387,新普元富9B購01,1.70,1.82,1.69,1.76,+0.09,5.39,552000,16,966870,0,0,0,0,0,0,98000,454000,-356000,-356000
20200528,711388,大江兆豐9B購01,0.96,0.96,0.96,0.96,0.00,0.0,76000,4,72960,0,0,0,0,0,0,60000,16000,44000,44000
20200528,711389,元太兆豐9B購01,1.20,1.27,1.16,1.16,-0.07,-5.69,220000,9,271570,0,0,0,0,0,0,70000,150000,-80000,-80000
20200528,711390,台燿兆豐9B購02,1.31,1.36,1.30,1.34,+0.02,1.52,156000,9,208080,0,0,0,0,0,0,58000,98000,-40000,-40000
20200528,711391,力旺國票9B購01,3.62,3.69,3.35,3.45,-0.40,-10.39,62000,8,217230,0,0,0,0,0,0,25000,37000,-12000,-12000
20200528,711392,元太國票9B購03,,,,,,0.00,0,0,0,0,0,0,0,0,0,0,0,0,0
20200528,711393,金居國票9C購01,,,,,,0.00,0,0,0,0,0,0,0,0,0,0,0,0,0
20200528,711394,頎邦國票9C購01,,,,,,0.00,0,0,0,0,0,0,0,0,0,0,0,0,0
20200528,711395,六角凱基9B購02,2.84,2.84,2.84,2.84,+0.07,2.53,3000,1,8520,0,0,0,0,0,0,3000,3000,0,0
20200528,711396,聯亞凱基9B購02,,,,,,0.00,0,0,0,0,0,0,0,0,0,0,0,0,0
20200528,711397,晟德凱基9B購01,3.47,3.47,3.47,3.47,-0.31,-8.2,1000,1,3470,0,0,0,0,0,0,0,1000,-1000,-1000
20200528,711398,元太富邦01購01,0.98,1.01,0.95,1.01,+0.04,4.12,246000,11,243510,0,0,0,0,0,0,15000,235000,-220000,-220000
20200528,711399,元太統一01購01,1.03,1.05,1.02,1.03,-0.06,-5.5,117000,6,121840,0,0,0,0,0,0,9000,108000,-99000,-99000
20200528,711400,元太統一9C購01,0.98,1.00,0.97,0.97,-0.02,-2.02,181000,4,179870,0,0,0,0,0,0,0,181000,-181000,-181000
20200528,711401,穩懋統一9B購11,,,,,,0.00,0,0,0,0,0,0,0,0,0,0,0,0,0
20200528,711402,寶雅統一01購04,,,,,,0.00,0,0,0,0,0,0,0,0,0,0,0,0,0
20200528,711403,台燿元大9B購02,2.31,2.43,2.31,2.40,-0.02,-0.83,80000,5,191940,0,0,0,0,0,0,8000,72000,-64000,-64000
20200528,711404,旺矽元大9B購04,,,,,,0.00,0,0,0,0,0,0,0,0,0,0,0,0,0
20200528,711405,信驊元大9C購01,2.25,2.29,2.16,2.19,+0.10,4.78,76000,8,171020,0,0,0,0,0,0,52000,69000,-17000,-17000
20200528,711406,胡連元大9B購01,,,,,,0.00,0,0,0,0,0,0,0,0,0,0,0,0,0
20200528,711407,網家元大9B購06,1.71,1.71,1.71,1.71,+0.03,1.79,61000,2,104310,0,0,0,0,0,0,0,61000,-61000,-61000
20200528,711408,環球晶元大9B購04,2.97,2.98,2.95,2.95,+0.14,4.98,15000,4,44300,0,0,0,0,0,0,2000,15000,-13000,-13000
20200528,711409,晟德元大9B購01,1.51,1.51,1.51,1.51,-0.21,-12.21,10000,1,15100,0,0,0,0,0,0,10000,0,10000,10000
20200528,711410,邦特永豐9B購02,0.88,0.88,0.86,0.86,0.00,0.0,97000,3,83620,0,0,0,0,0,0,0,97000,-97000,-97000
20200528,711411,是方永豐9B購01,1.40,1.40,1.40,1.40,-0.27,-16.17,38000,1,53200,0,0,0,0,0,0,38000,0,38000,38000
20200528,711412,聯亞永豐9B購02,1.72,1.72,1.72,1.72,+0.02,1.18,25000,2,43000,0,0,0,0,0,0,0,25000,-25000,-25000
20200528,711413,大江群益9B購03,,,,,,0.00,0,0,0,0,0,0,0,0,0,0,0,0,0
20200528,711414,元太群益9B購02,1.70,1.76,1.55,1.55,-0.15,-8.82,78000,12,133550,0,0,0,0,0,0,21000,73000,-52000,-52000
20200528,711415,威剛群益9C購02,1.50,1.50,1.48,1.48,-0.01,-0.67,2000,2,2980,0,0,0,0,0,0,2000,2000,0,0
20200528,711416,是方群益9B購02,1.40,1.40,1.40,1.40,-0.15,-9.68,14000,1,19600,0,0,0,0,0,0,0,14000,-14000,-14000
20200528,711417,璟德群益9B購01,,,,,,0.00,0,0,0,0,0,0,0,0,0,0,0,0,0
20200528,711418,元太元富9B購02,2.47,2.51,2.42,2.42,+0.01,0.41,98000,7,241930,0,0,0,0,0,0,0,98000,-98000,-98000
20200528,711419,聯亞元富9B購01,2.31,2.31,2.31,2.31,+0.09,4.05,50000,2,115500,0,0,0,0,0,0,0,50000,-50000,-50000
20200528,711420,網家兆豐9C購01,1.68,1.70,1.61,1.61,-0.03,-1.83,73000,5,122810,0,0,0,0,0,0,0,73000,-73000,-73000
20200528,711421,優群兆豐9B購01,2.65,2.65,2.35,2.53,+0.17,7.2,189000,23,476130,0,0,0,0,0,0,10000,179000,-169000,-169000
20200528,711422,信驊國泰01購01,1.53,1.53,1.53,1.53,0.00,0.0,7000,1,10710,0,0,0,0,0,0,0,7000,-7000,-7000
20200528,711423,是方國泰9C購01,1.59,1.59,1.59,1.59,-0.08,-4.79,2000,1,3180,0,0,0,0,0,0,0,2000,-2000,-2000
20200528,711424,大江群益9B購04,,,,,,0.00,0,0,0,0,0,0,0,0,0,0,0,0,0
20200528,711425,宜特群益9B購01,,,,,,0.00,0,0,0,0,0,0,0,0,0,0,0,0,0
20200528,711426,環球晶群益9C購02,1.28,1.28,1.26,1.26,-0.07,-5.26,2000,2,2540,0,0,0,0,0,0,0,2000,-2000,-2000
20200528,711427,雙美群益9C購03,1.36,1.36,1.36,1.36,+0.02,1.49,260000,6,353600,0,0,0,0,0,0,0,260000,-260000,-260000
20200528,711428,雙鴻群益9C購02,2.65,2.69,2.59,2.59,+0.33,14.6,4000,3,10620,0,0,0,0,0,0,4000,4000,0,0
20200528,711429,力旺元大9B購04,,,,,,0.00,0,0,0,0,0,0,0,0,0,0,0,0,0
20200528,711430,元太元大9B購05,2.82,2.98,2.81,2.84,-0.10,-3.4,96000,13,280670,0,0,0,0,0,0,78000,96000,-18000,-18000
20200528,711431,宏捷科元大9C購03,,,,,,0.00,0,0,0,0,0,0,0,0,0,0,0,0,0
20200528,711432,精測元大9C購03,1.56,1.57,1.56,1.57,-0.08,-4.85,25000,2,39040,0,0,0,0,0,0,21000,25000,-4000,-4000
20200528,711433,優群元大9C購01,3.47,3.74,3.47,3.62,+0.71,24.4,11000,3,40270,0,0,0,0,0,0,0,11000,-11000,-11000
20200528,711434,環球晶元大9C購04,1.64,1.64,1.61,1.61,0.00,0.0,6000,4,9750,0,0,0,0,0,0,3000,6000,-3000,-3000
20200528,711435,譜瑞元大9B購03,,,,,,0.00,0,0,0,0,0,0,0,0,0,0,0,0,0
20200528,711436,鈊象元大9C購05,2.29,2.59,2.28,2.52,+0.42,20.0,74000,15,182450,0,0,0,0,0,0,50000,74000,-24000,-24000
20200528,711437,穩懋台新9B購01,,,,,,0.00,0,0,0,0,0,0,0,0,0,0,0,0,0
20200528,711438,久元凱基9C購01,1.11,1.11,1.05,1.05,-0.06,-5.41,12000,3,12910,0,0,0,0,0,0,6000,12000,-6000,-6000
20200528,711439,大江凱基9B購04,,,,,,0.00,0,0,0,0,0,0,0,0,0,0,0,0,0
20200528,711440,元太凱基9B購02,2.18,2.30,2.04,2.04,-0.31,-13.19,126000,15,285770,0,0,0,0,0,0,101000,126000,-25000,-25000
20200528,711441,弘塑凱基9C購01,,,,,,0.00,0,0,0,0,0,0,0,0,0,0,0,0,0
20200528,711442,原相凱基01購01,,,,,,0.00,0,0,0,0,0,0,0,0,0,0,0,0,0
20200528,711443,順達凱基9B購01,3.65,3.65,3.65,3.65,+0.08,2.24,13000,2,47450,0,0,0,0,0,0,0,13000,-13000,-13000
20200528,711444,鈊象凱基03購01,1.14,1.30,1.14,1.29,+0.23,21.7,93000,6,120170,0,0,0,0,0,0,42000,93000,-51000,-51000
20200528,711445,久元國票9B購02,,,,,,0.00,0,0,0,0,0,0,0,0,0,0,0,0,0
20200528,711446,邦特國票9C購01,,,,,,0.00,0,0,0,0,0,0,0,0,0,0,0,0,0
20200528,711447,旺矽國票9C購01,,,,,,0.00,0,0,0,0,0,0,0,0,0,0,0,0,0
20200528,711448,中美晶統一9B購04,,,,,,0.00,0,0,0,0,0,0,0,0,0,0,0,0,0
20200528,711449,合晶統一9C購01,,,,,,0.00,0,0,0,0,0,0,0,0,0,0,0,0,0
20200528,711450,網家中信9B購01,,,,,,0.00,0,0,0,0,0,0,0,0,0,0,0,0,0
20200528,711451,雙鴻中信01購01,,,,,,0.00,0,0,0,0,0,0,0,0,0,0,0,0,0
20200528,711452,宜特永豐9B購02,1.04,1.11,1.04,1.06,+0.04,3.92,72000,5,76020,0,0,0,0,0,0,0,72000,-72000,-72000
20200528,711453,信驊永豐9B購03,0.88,0.90,0.86,0.86,-0.01,-1.15,14000,4,12120,0,0,0,0,0,0,0,14000,-14000,-14000
20200528,711454,閎康永豐9B購01,,,,,,0.00,0,0,0,0,0,0,0,0,0,0,0,0,0
20200528,711455,網家永豐9B購02,,,,,,0.00,0,0,0,0,0,0,0,0,0,0,0,0,0
20200528,711456,穩懋永豐9B購03,,,,,,0.00,0,0,0,0,0,0,0,0,0,0,0,0,0
20200528,711457,鈊象永豐9B購03,2.14,2.14,2.09,2.09,+0.38,22.22,3000,2,6370,0,0,0,0,0,0,3000,3000,0,0
