date,sid,name,open,high,low,close,amplitude,amplitude_ratio,capacity,transaction,turnover,foreign_dealers_buy,foreign_dealers_sell,foreign_dealers_total,investment_trust_buy,investment_trust_sell,investment_trust_total,dealer_buy,dealer_sell,dealer_total,institutional_investors_total
20200316,0050,元大台灣50,80.00,80.40,76.95,77.30,-3.70,-4.57,33813951,17505,2652927807,81139,11959000,-11877861,0,0,0,2711000,13049998,-10338998,-22216859
20200316,0051,元大中型100,29.38,29.38,28.05,28.11,-0.99,-3.4,63300,55,1821530,0,0,0,0,0,0,0,41000,-41000,-41000
20200316,0052,富邦科技,63.00,63.00,58.50,58.80,-3.70,-5.92,222933,103,13458196,13000,14000,-1000,0,0,0,107000,162000,-55000,-56000
20200316,0053,元大電子,35.30,35.51,34.02,34.20,-2.00,-5.52,31000,19,1081270,0,0,0,0,0,0,14000,11000,3000,3000
20200316,0054,元大台商50,19.87,19.99,19.40,19.67,+0.08,0.41,65000,25,1287180,3000,0,3000,0,0,0,48000,8000,40000,43000
20200316,0055,元大MSCI金融,16.66,16.66,16.00,16.00,-0.50,-3.03,101560,80,1648030,1000,2000,-1000,0,0,0,9000,2000,7000,6000
20200316,0056,元大高股息,25.10,25.24,24.40,24.41,-0.88,-3.48,92824206,44641,2297360656,51000,3000,48000,0,0,0,1610000,70391000,-68781000,-68733000
20200316,0057,富邦摩台,51.95,52.15,50.50,50.50,-1.80,-3.44,31000,8,1591550,0,0,0,0,0,0,21000,31000,-10000,-10000
20200316,0061,元大寶滬深,17.67,17.85,17.25,17.25,-0.43,-2.43,457950,203,7996815,4000,5000,-1000,0,0,0,132000,68000,64000,63000
20200316,006203,元大MSCI台灣,37.57,37.57,35.94,35.94,-0.01,-0.03,10000,9,364960,3000,1000,2000,0,0,0,1000,6000,-5000,-3000
20200316,006204,永豐臺灣加權,49.52,49.52,48.40,48.40,-1.75,-3.49,9000,7,443000,0,0,0,0,0,0,3000,6000,-3000,-3000
20200316,006205,富邦上証,29.60,29.60,28.80,28.88,-0.77,-2.6,2678218,359,78054250,129000,569000,-440000,0,0,0,1143000,1406000,-263000,-703000
20200316,006206,元大上證50,31.00,31.00,29.79,29.82,-0.68,-2.23,198544,135,5971534,3000,74000,-71000,0,0,0,15000,6000,9000,-62000
20200316,006207,FH滬深,23.10,23.10,22.46,22.46,-0.64,-2.77,737425,95,16735108,1000,692000,-691000,0,0,0,692000,1000,691000,0
20200316,006208,富邦台50,45.90,45.90,44.03,44.10,-1.78,-3.88,1615399,801,72607755,10000,10000,0,0,0,0,349000,1227000,-878000,-878000
20200316,00625K,富邦上証+R,6.78,6.78,6.78,6.78,+0.03,0.44,50000,2,339000,0,0,0,0,0,0,50000,50000,0,0
20200316,00631L,元大台灣50正2,37.03,37.81,34.60,34.63,-3.01,-8.0,17301155,5113,623499903,158000,245000,-87000,0,0,0,3831000,6938000,-3107000,-3194000
20200316,00632R,元大台灣50反1,11.87,12.22,11.73,12.20,+0.48,4.1,560791416,22559,6690315164,76209000,14239000,61970000,0,0,0,323971000,43322000,280649000,342619000
20200316,00633L,富邦上証正2,40.00,40.17,38.35,38.35,-2.30,-5.66,25707200,4839,1007023200,1593000,3003000,-1410000,0,0,0,5054000,12472000,-7418000,-8828000
20200316,00634R,富邦上証反1,6.03,6.20,6.03,6.20,+0.21,3.51,12647000,1116,77325870,2020000,6000,2014000,0,0,0,3405000,3307000,98000,2112000
20200316,00635U,元大S&P黃金,22.12,22.12,21.66,21.93,-0.53,-2.36,4665623,1611,102110791,33000,493000,-460000,0,0,0,227000,1245000,-1018000,-1478000
20200316,00636,國泰中國A50,20.38,20.38,19.82,19.86,-0.46,-2.26,1412750,473,28270432,20000,332000,-312000,0,0,0,351000,277635,73365,-238635
20200316,00636K,國泰中國A50+U,6.57,6.57,6.57,6.57,+0.18,2.82,100,1,657,0,0,0,0,0,0,100,100,0,0
20200316,00637L,元大滬深300正2,15.30,15.42,14.68,14.68,-0.92,-5.9,159507413,14947,2401443001,9299000,14480000,-5181000,0,0,0,23037000,70020000,-46983000,-52164000
20200316,00638R,元大滬深300反1,12.25,12.47,12.22,12.47,+0.37,3.06,8662000,1520,106999710,1186000,0,1186000,0,0,0,2684000,1449000,1235000,2421000
20200316,00639,富邦深100,11.79,11.81,10.95,10.95,-0.53,-4.62,3017370,412,33703298,0,1352000,-1352000,0,0,0,977000,1122000,-145000,-1497000
20200316,00640L,富邦日本正2,12.03,12.25,11.73,12.01,-0.40,-3.22,3747000,764,45012700,1000,0,1000,0,0,0,1174000,1421000,-247000,-246000
20200316,00641R,富邦日本反1,18.30,18.33,17.99,18.30,+0.42,2.35,3109015,714,56536077,200000,0,200000,0,0,0,125000,2105000,-1980000,-1780000
20200316,00642U,元大S&P石油,10.94,11.13,10.90,10.95,-0.39,-3.44,51743761,9690,568668196,16000,422000,-406000,0,0,0,2083000,10351000,-8268000,-8674000
20200316,00643,群益深証中小,14.05,14.05,13.20,13.20,-0.63,-4.56,1508500,327,20396619,234000,497000,-263000,0,0,0,1000,274000,-273000,-536000
20200316,00643K,群益深証中小+R,,,,,0.00,0.00,0,0,0,0,0,0,0,0,0,0,0,0,0
20200316,00645,富邦日本,16.63,16.71,16.46,16.46,-0.27,-1.61,174940,55,2903085,0,0,0,0,0,0,65000,151000,-86000,-86000
20200316,00646,元大S&P500,23.45,23.50,22.87,22.88,-0.57,-2.43,2681851,1184,62426765,1094000,62000,1032000,0,0,0,0,1074000,-1074000,-42000
20200316,00647L,元大S&P500正2,24.52,24.63,23.20,23.24,-1.83,-7.3,2461000,832,59024720,45000,9000,36000,0,0,0,373000,29000,344000,380000
20200316,00648R,元大S&P500反1,13.70,14.00,13.68,13.87,+0.20,1.46,6742018,1456,93263693,0,1050000,-1050000,0,0,0,524000,1965000,-1441000,-2491000
20200316,00650L,FH香港正2,21.45,21.45,20.30,20.54,-1.16,-5.35,489000,104,10251500,0,0,0,0,0,0,226000,248000,-22000,-22000
20200316,00651R,FH香港反1,9.03,9.55,9.03,9.55,+0.34,3.69,2091000,317,19724290,249000,120000,129000,0,0,0,1065000,381000,684000,813000
20200316,00652,富邦印度,18.07,18.39,17.87,18.04,-0.01,-0.06,210164,87,3810408,20000,1000,19000,0,0,0,11000,115000,-104000,-85000
20200316,00653L,富邦印度正2,18.01,18.20,16.60,17.22,-0.32,-1.82,1040000,388,18381570,26000,27000,-1000,0,0,0,575000,87000,488000,487000
20200316,00654R,富邦印度反1,17.25,17.40,16.00,16.84,+0.34,2.06,1673000,279,27860170,0,14000,-14000,0,0,0,18000,1077000,-1059000,-1073000
20200316,00655L,國泰中國A50正2,29.00,29.00,27.69,27.69,-1.73,-5.88,9849308,2201,278838718,1000000,10000,990000,0,0,0,1591000,6229308,-4638308,-3648308
20200316,00656R,國泰中國A50反1,11.14,11.33,11.12,11.33,+0.28,2.53,2075000,295,23357860,454000,0,454000,0,0,0,1091000,225000,866000,1320000
20200316,00657,國泰日經225,21.61,21.61,21.40,21.59,+0.59,2.81,107000,7,2291030,4000,0,4000,0,0,0,100000,107000,-7000,-3000
20200316,00657K,國泰日經225+U,7.02,7.02,7.02,7.02,+0.29,4.31,100,1,702,0,0,0,0,0,0,100,100,0,0
20200316,00660,元大歐洲50,18.49,18.49,18.12,18.14,-0.63,-3.36,114000,47,2083140,0,0,0,0,0,0,49000,50000,-1000,-1000
20200316,00661,元大日經225,22.34,22.39,22.15,22.15,-0.32,-1.42,5000,5,111280,0,0,0,0,0,0,2000,3000,-1000,-1000
20200316,00662,富邦NASDAQ,29.04,29.25,27.82,28.45,-0.48,-1.66,327516,204,9438578,9000,8000,1000,0,0,0,1000,40000,-39000,-38000
20200316,00663L,國泰臺灣加權正2,33.52,33.52,30.68,30.75,-2.57,-7.71,428000,145,13727040,0,17000,-17000,0,0,0,111000,238000,-127000,-144000
20200316,00664R,國泰臺灣加權反1,13.44,13.91,13.38,13.87,+0.52,3.9,7998300,1064,109392777,0,0,0,0,0,0,2964000,3903000,-939000,-939000
20200316,00665L,富邦恒生國企正2,20.10,20.10,19.19,19.28,-1.46,-7.04,208000,66,4069660,9000,38000,-29000,0,0,0,87000,83000,4000,-25000
20200316,00666R,富邦恒生國企反1,14.39,14.78,14.39,14.76,+0.37,2.57,104000,24,1529440,29000,0,29000,0,0,0,65000,78000,-13000,16000
20200316,00668,國泰美國道瓊,24.04,24.04,22.71,23.20,-0.56,-2.36,1220050,431,28724135,568000,0,568000,0,0,0,129000,242000,-113000,455000
20200316,00668K,國泰美國道瓊+U,7.77,7.77,7.77,7.77,+0.21,2.78,100,1,777,0,0,0,0,0,0,100,100,0,0
20200316,00669R,國泰美國道瓊反1,15.15,15.22,14.80,15.07,+0.34,2.31,14460000,4307,217588570,0,10000,-10000,0,0,0,841000,8502000,-7661000,-7671000
20200316,00670L,富邦NASDAQ正2,29.80,30.35,27.80,28.61,-1.40,-4.67,3618060,1268,105747717,154000,19000,135000,0,0,0,331000,16000,315000,450000
20200316,00671R,富邦NASDAQ反1,12.58,12.95,12.48,12.55,-0.03,-0.24,4830000,2419,60736880,200000,467000,-267000,0,0,0,238000,2246000,-2008000,-2275000
20200316,00672L,元大S&P原油正2,3.95,4.31,3.75,4.03,-0.33,-7.57,493615256,36508,2022461267,953000,5317000,-4364000,0,0,0,15033000,13398000,1635000,-2729000
20200316,00673R,元大S&P原油反1,22.60,22.84,22.31,22.59,+0.83,3.81,8730114,918,197229496,10000,16000,-6000,0,0,0,3301000,5516000,-2215000,-2221000
20200316,00674R,元大S&P黃金反1,16.06,16.30,16.05,16.16,+0.40,2.54,791000,273,12788110,0,0,0,0,0,0,324000,62000,262000,262000
20200316,00675L,富邦臺灣加權正2,14.39,14.48,13.30,13.38,-1.14,-7.85,1622090,460,22500372,0,1000,-1000,0,0,0,589000,763000,-174000,-175000
20200316,00676R,富邦臺灣加權反1,7.40,7.55,7.25,7.54,+0.35,4.87,10037000,1151,74288690,0,72000,-72000,0,0,0,4764000,2250000,2514000,2442000
20200316,00677U,富邦VIX,8.98,9.28,8.79,9.27,+1.04,12.64,606013616,46566,5464369101,24156000,65992000,-41836000,0,0,0,70547000,27648000,42899000,1063000
20200316,00678,群益NBI生技,19.80,19.81,19.30,19.35,-0.46,-2.32,349000,166,6801840,31000,103000,-72000,0,0,0,0,0,0,-72000
20200316,00680L,元大美債20正2,34.05,34.45,33.73,34.27,+3.37,10.91,820000,269,27868970,0,0,0,0,0,0,348000,183000,165000,165000
20200316,00681R,元大美債20反1,12.81,12.81,12.70,12.70,-0.77,-5.72,490000,82,6251360,0,0,0,0,0,0,182000,245000,-63000,-63000
20200316,00682U,元大美元指數,19.47,19.58,19.45,19.46,+0.14,0.72,8000,7,155800,0,0,0,0,0,0,7000,1000,6000,6000
20200316,00683L,元大美元指數正2,19.77,19.95,19.77,19.95,+0.50,2.57,83000,25,1648330,0,0,0,0,0,0,34000,28000,6000,6000
20200316,00684R,元大美元指數反1,18.14,18.14,18.14,18.14,-0.12,-0.66,12000,2,217680,0,0,0,0,0,0,0,12000,-12000,-12000
20200316,00685L,群益臺灣加權正2,12.53,12.73,11.75,11.80,-0.94,-7.38,215000,83,2630870,0,0,0,0,0,0,75000,116000,-41000,-41000
20200316,00686R,群益臺灣加權反1,7.97,8.22,7.92,8.21,+0.30,3.79,820000,131,6616100,0,0,0,0,0,0,386000,410000,-24000,-24000
20200316,00688L,國泰20年美債正2,34.71,34.91,34.24,34.72,+3.28,10.43,67000,22,2311630,0,0,0,0,0,0,25000,40000,-15000,-15000
20200316,00689R,國泰20年美債反1,13.02,13.16,13.02,13.08,-0.62,-4.53,178000,13,2330860,0,0,0,0,0,0,112000,156000,-44000,-44000
20200316,00690,兆豐藍籌30,20.30,20.30,19.45,19.46,-0.84,-4.14,302250,110,5959570,3000,5000,-2000,0,0,0,166000,272000,-106000,-108000
20200316,00691R,兆豐藍籌30反1,15.90,16.34,15.90,16.34,+0.54,3.42,8000,6,128070,0,0,0,0,0,0,8000,1000,7000,7000
20200316,00692,富邦公司治理,20.70,20.71,19.91,20.01,-0.69,-3.33,6832988,2822,138147445,2000,0,2000,0,0,0,945000,5262000,-4317000,-4315000
20200316,00693U,街口S&P黃豆,13.51,13.73,13.50,13.60,-0.12,-0.87,1929000,209,26341200,0,0,0,0,0,0,1498000,859000,639000,639000
20200316,00700,富邦恒生國企,17.78,18.47,17.42,17.42,-0.36,-2.02,128000,17,2279670,0,0,0,0,0,0,83000,120000,-37000,-37000
20200316,00701,國泰股利精選30,19.79,19.79,18.86,18.89,-0.61,-3.13,5055955,2135,96789311,5000,58000,-53000,0,0,0,1054000,2241000,-1187000,-1240000
20200316,00702,國泰標普低波高息,15.72,15.77,15.71,15.72,+0.17,1.09,73000,32,1147600,0,0,0,0,0,0,56000,0,56000,56000
20200316,00703,台新MSCI中國,19.10,19.10,18.66,18.67,-0.30,-1.58,288100,40,5434448,0,0,0,0,0,0,259000,218000,41000,41000
20200316,00706L,元大S&P日圓正2,17.76,17.89,17.61,17.89,-0.08,-0.45,149000,47,2640250,0,0,0,0,0,0,24000,58000,-34000,-34000
20200316,00707R,元大S&P日圓反1,19.31,19.40,19.30,19.40,+0.36,1.89,37000,11,715840,0,0,0,0,0,0,23000,10000,13000,13000
20200316,00708L,元大S&P黃金正2,22.91,22.92,22.18,22.69,-1.23,-5.14,16276000,3192,367888280,69000,489000,-420000,0,0,0,4645000,6405000,-1760000,-2180000
20200316,00709,富邦歐洲,14.98,14.98,14.70,14.72,-0.83,-5.34,169585,45,2513550,0,0,0,0,0,0,100000,159000,-59000,-59000
20200316,00710B,FH彭博高收益債,18.30,18.58,18.00,18.12,-0.18,-0.98,379120,149,6935879,0,0,0,0,0,0,229000,100000,129000,129000
20200316,00711B,FH彭博新興債,19.63,20.65,19.63,20.60,-0.26,-1.25,527000,25,10815280,0,0,0,0,0,0,509000,502000,7000,7000
20200316,00712,FH富時不動產,13.48,13.53,12.81,12.95,+0.03,0.23,1114000,682,14431060,0,876000,-876000,0,0,0,393000,11000,382000,-494000
20200316,00713,元大台灣高息低波,28.24,28.63,27.50,27.50,-0.73,-2.59,279498,213,7781953,1000,126000,-125000,0,0,0,5000,77000,-72000,-197000
20200316,00714,群益道瓊美國地產,18.20,18.27,18.20,18.26,+0.15,0.83,63000,31,1149320,1000,0,1000,0,0,0,2000,43000,-41000,-40000
20200316,00715L,街口布蘭特油正2,5.52,6.06,5.52,5.79,-0.86,-12.93,43907300,6046,255520214,36000,1078000,-1042000,0,0,0,249000,9744000,-9495000,-10537000
20200316,00717,富邦美國特別股,16.49,16.49,16.13,16.14,-0.25,-1.53,3421723,1028,55508816,2000,0,2000,0,0,0,833000,434086,398914,400914
20200316,00728,第一金工業30,17.27,17.27,16.55,16.55,-0.76,-4.39,1369207,204,23205767,0,0,0,0,0,0,620000,835000,-215000,-215000
20200316,00730,富邦臺灣優質高息,15.56,15.56,15.00,15.00,-0.50,-3.23,1403638,458,21432042,1000,0,1000,0,0,0,477000,1171000,-694000,-693000
20200316,00731,FH富時高息低波,41.95,42.00,40.77,40.84,-1.33,-3.15,434000,121,17965890,1000,1000,0,0,0,0,385000,423000,-38000,-38000
20200316,00732,國泰RMB短期報酬,38.70,38.70,38.70,38.70,+0.22,0.57,100000,2,3870000,0,0,0,0,0,0,100000,100000,0,0
20200316,00733,富邦臺灣中小,17.42,17.42,16.50,16.50,-0.73,-4.24,279630,41,4707402,0,0,0,0,0,0,210000,255000,-45000,-45000
20200316,00735,國泰臺韓科技,18.15,18.17,17.70,17.70,-0.29,-1.61,193000,20,3460480,0,75000,-75000,0,0,0,174000,111000,63000,-12000
20200316,00736,國泰新興市場,16.10,16.14,15.85,15.85,+0.51,3.32,131000,23,2091030,0,10000,-10000,0,0,0,116000,105000,11000,1000
20200316,00737,國泰AI+Robo,17.66,17.66,16.98,16.98,-0.64,-3.63,1058588,426,18168959,0,385000,-385000,0,0,0,0,174000,-174000,-559000
20200316,00738U,元大道瓊白銀,16.47,16.47,16.11,16.30,-1.20,-6.86,4962100,746,80722290,572000,13000,559000,0,0,0,2061000,1324000,737000,1296000
20200316,00739,元大MSCI A股,20.89,20.89,20.21,20.21,-0.68,-3.26,538020,147,11033322,3000,3000,0,0,0,0,141000,360000,-219000,-219000
20200316,00742,新光內需收益,18.97,18.97,18.50,18.50,-0.03,-0.16,20000,7,371850,0,0,0,0,0,0,13000,4000,9000,9000
20200316,00743,國泰中國A150,21.19,21.19,20.51,20.51,-0.59,-2.8,311000,27,6432270,0,292000,-292000,0,0,0,294000,5000,289000,-3000
20200316,00752,中信中國50,21.90,21.98,21.61,21.61,-0.24,-1.1,2341284,922,50974424,0,0,0,0,0,0,782000,1348259,-566259,-566259
20200316,00753L,中信中國50正2,21.00,21.00,20.13,20.13,-0.87,-4.14,148000,51,3029480,0,0,0,0,0,0,104000,94000,10000,10000
20200316,00757,統一FANG+,21.29,21.30,20.75,20.75,-1.04,-4.77,317000,66,6665220,0,0,0,0,0,0,200000,202000,-2000,-2000
20200316,00762,元大全球AI,21.00,21.00,20.00,20.00,-0.55,-2.68,553200,333,11382936,0,2000,-2000,0,0,0,0,76000,-76000,-78000
20200316,00763U,街口道瓊銅,16.70,16.79,16.52,16.52,+0.09,0.55,13000,9,217160,0,0,0,0,0,0,6000,1000,5000,5000
20200316,00766L,台新MSCI中國正2,8.40,8.40,7.89,7.89,-0.41,-4.94,750000,107,6033520,0,0,0,0,0,0,461000,594000,-133000,-133000
20200316,00767,FH美國金融股,21.10,21.10,18.77,18.77,+0.55,3.02,4000,4,82070,0,0,0,0,0,0,0,1000,-1000,-1000
20200316,00770,國泰北美科技,20.00,21.11,20.00,20.91,+0.43,2.1,50000,21,1022030,18000,0,18000,0,0,0,6000,12000,-6000,12000
20200316,00771,元大US高息特別股,16.85,17.00,16.35,16.42,-0.38,-2.26,292720,141,4821644,0,0,0,0,0,0,96000,76720,19280,19280
20200316,00774B,新光中國政金綠債,40.76,40.76,40.76,40.76,-0.14,-0.34,2000,2,81520,0,0,0,0,0,0,2000,2000,0,0
20200316,00774C,新光中政金綠債+R,,,,,0.00,0.00,0,0,0,0,0,0,0,0,0,0,0,0,0
20200316,00775B,新光投等債15+,42.77,43.33,42.77,43.33,+1.37,3.27,5000,3,214970,0,0,0,0,0,0,5000,2000,3000,3000
20200316,00776,新光ICE美國權值,18.50,18.50,18.50,18.50,+0.57,3.18,1000,1,18500,0,0,0,0,0,0,0,1000,-1000,-1000
20200316,00783,富邦中証500,18.50,18.50,18.15,18.16,-0.50,-2.68,1172000,54,21463640,9000,156000,-147000,0,0,0,1081000,816000,265000,118000
20200316,008201,BP上證50,,,,,0.00,0.00,0,0,0,0,0,0,0,0,0,0,0,0,0
20200316,00830,國泰費城半導體,13.80,13.91,13.39,13.79,+0.14,1.03,2354479,719,32379183,1235000,3000,1232000,0,0,0,104000,177000,-73000,1159000
20200316,00850,元大臺灣ESG永續,20.04,20.04,19.33,19.35,-0.69,-3.44,8983372,4472,176609783,2000,1000,1000,0,0,0,873000,6446000,-5573000,-5572000
20200316,00851,台新全球AI,18.88,18.88,18.58,18.72,+0.33,1.79,235000,43,4398470,0,0,0,0,0,0,33000,185000,-152000,-152000
20200316,00852L,國泰美國道瓊正2,9.10,9.16,8.75,8.77,-0.83,-8.65,28683000,2954,255441260,10430000,0,10430000,0,0,0,1706000,23000,1683000,12113000
20200316,00861,元大全球未來通訊,17.81,17.82,17.38,17.50,-0.30,-1.69,9016252,3773,158003948,135000,0,135000,0,0,0,100000,1646000,-1546000,-1411000
20200316,00865B,國泰US短期公債,39.79,39.79,39.48,39.67,-0.14,-0.35,13000,4,513960,0,0,0,0,0,0,12000,0,12000,12000
20200316,00866,新光Shiller CAPE,15.78,15.78,15.78,15.78,+0.12,0.77,48000,9,757440,0,0,0,0,0,0,46000,0,46000,46000
20200316,01001T,土銀富邦R1,16.53,16.53,16.35,16.35,-0.02,-0.12,263000,35,4304770,0,0,0,0,0,0,0,0,0,0
20200316,01002T,土銀國泰R1,17.47,17.50,17.10,17.30,-0.17,-0.97,1485188,136,25767570,118000,0,118000,0,0,0,0,0,0,118000
20200316,01003T,兆豐新光R1,18.60,18.70,18.60,18.65,+0.25,1.36,143000,46,2671900,141000,0,141000,0,0,0,0,0,0,141000
20200316,01004T,土銀富邦R2,14.38,14.40,14.21,14.26,-0.06,-0.42,131000,29,1871440,24000,0,24000,0,0,0,0,0,0,24000
20200316,01007T,兆豐國泰R2,17.40,17.40,17.25,17.40,-0.10,-0.57,413000,49,7138400,0,3000,-3000,0,0,0,0,0,0,-3000
20200316,01009T,王道圓滿R1,9.64,9.64,9.53,9.54,0.00,0.00,176000,19,1679550,0,0,0,0,0,0,0,0,0,0
20200316,01010T,京城樂富R1,10.05,10.05,9.97,10.00,0.00,0.00,77000,24,769260,4000,0,4000,0,0,0,0,0,0,4000
20200316,020000,富邦特選蘋果N,4.63,4.65,4.46,4.46,-0.21,-4.5,295000,46,1348840,0,0,0,0,0,0,170000,97000,73000,73000
20200316,020002,元富新中國N,,,,,0.00,0.00,0,0,0,0,0,0,0,0,0,0,0,0,0
20200316,020004,兆豐電菁英30N,,,,,0.00,0.00,0,0,0,0,0,0,0,0,0,0,0,0,0
20200316,020005,永豐外資50N,,,,,0.00,0.00,0,0,0,0,0,0,0,0,0,0,0,0,0
20200316,020006,永昌中小300N,,,,,0.00,0.00,0,0,0,0,0,0,0,0,0,0,0,0,0
20200316,020007,凱基臺灣500N,,,,,0.00,0.00,0,0,0,0,0,0,0,0,0,0,0,0,0
20200316,020008,元大特股高息N,10.01,10.02,9.88,9.91,-0.17,-1.69,176000,47,1750690,0,0,0,0,0,0,22000,154000,-132000,-132000
20200316,020011,統一微波高息20N,4.40,4.40,4.40,4.40,-0.06,-1.35,10000,1,44000,0,0,0,0,0,0,0,10000,-10000,-10000
20200316,020012,富邦行動通訊N,4.16,4.22,4.01,4.02,-0.17,-4.06,2217000,170,9181820,0,0,0,0,0,0,1663000,294000,1369000,1369000
20200316,03004P,鴻海凱基93售05,,,,,0.00,0.00,0,0,0,0,0,0,0,0,0,0,0,0,0
20200316,03005P,華新科凱基93售04,0.06,0.15,0.06,0.15,+0.01,7.14,7000,2,870,0,0,0,0,0,0,7000,0,7000,7000
20200316,03005X,元展05,,,,,0.00,0.00,0,0,0,0,0,0,0,0,0,0,0,0,0
20200316,03006P,華新科凱基93售05,,,,,0.00,0.00,0,0,0,0,0,0,0,0,0,0,0,0,0
20200316,03006X,元展06,,,,,0.00,0.00,0,0,0,0,0,0,0,0,0,0,0,0,0
20200316,03007X,元展07,,,,,0.00,0.00,0,0,0,0,0,0,0,0,0,0,0,0,0
20200316,03009X,元展09,12.10,12.10,11.40,11.40,-1.60,-12.31,29000,6,337400,0,0,0,0,0,0,0,29000,-29000,-29000
20200316,03010X,元展10,25.20,25.20,23.40,23.40,-0.20,-0.85,3000,3,73000,0,0,0,0,0,0,2000,1000,1000,1000
20200316,03012X,元展12,8.35,8.35,7.95,7.95,-0.55,-6.47,4000,2,32200,0,0,0,0,0,0,0,4000,-4000,-4000
20200316,03013X,元展13,,,,,0.00,0.00,0,0,0,0,0,0,0,0,0,0,0,0,0
20200316,03014X,元展14,,,,,0.00,0.00,0,0,0,0,0,0,0,0,0,0,0,0,0
20200316,03015X,元展15,30.80,30.80,30.80,30.80,-0.40,-1.28,20000,1,616000,0,0,0,0,0,0,20000,0,20000,20000
20200316,03016P,臺股指中信94售01,0.60,0.81,0.58,0.80,+0.28,53.85,378000,25,283240,0,0,0,0,0,0,121000,0,121000,121000
20200316,03016X,元展16,2.17,2.17,2.17,2.17,+0.09,4.33,2000,1,4340,0,0,0,0,0,0,2000,0,2000,2000
20200316,03017X,元展17,,,,,0.00,0.00,0,0,0,0,0,0,0,0,0,0,0,0,0
20200316,03019X,元展19,,,,,0.00,0.00,0,0,0,0,0,0,0,0,0,0,0,0,0
20200316,03020X,元展20,,,,,0.00,0.00,0,0,0,0,0,0,0,0,0,0,0,0,0
20200316,03021P,T50反1凱基94售01,0.30,0.32,0.20,0.20,-0.12,-37.5,467000,20,140390,0,0,0,0,0,0,422000,437000,-15000,-15000
20200316,03022X,富展01,12.50,12.60,12.10,12.10,-1.20,-9.02,20000,3,246500,0,0,0,0,0,0,0,20000,-20000,-20000
20200316,03025P,群創凱基93售07,,,,,0.00,0.00,0,0,0,0,0,0,0,0,0,0,0,0,0
20200316,03025X,元展22,,,,,0.00,0.00,0,0,0,0,0,0,0,0,0,0,0,0,0
20200316,03026P,群創凱基93售08,,,,,0.00,0.00,0,0,0,0,0,0,0,0,0,0,0,0,0
20200316,03026X,元展23,,,,,0.00,0.00,0,0,0,0,0,0,0,0,0,0,0,0,0
20200316,03027P,康控凱基93售01,,,,,0.00,0.00,0,0,0,0,0,0,0,0,0,0,0,0,0
20200316,03027X,元展24,,,,,0.00,0.00,0,0,0,0,0,0,0,0,0,0,0,0,0
20200316,03028X,元展25,,,,,0.00,0.00,0,0,0,0,0,0,0,0,0,0,0,0,0
20200316,03029X,元展26,,,,,0.00,0.00,0,0,0,0,0,0,0,0,0,0,0,0,0
20200316,03033P,台積電中信95售05,0.12,0.21,0.10,0.21,+0.10,90.91,4025000,170,639830,0,10000,-10000,0,0,0,966000,49000,917000,907000
20200316,03033X,元展30,4.82,4.86,4.47,4.54,+0.34,8.1,43000,15,196350,0,0,0,0,0,0,1000,42000,-41000,-41000
20200316,03035X,元展32,5.95,5.95,5.95,5.95,+0.15,2.59,2000,1,11900,0,0,0,0,0,0,0,2000,-2000,-2000
20200316,03038P,智邦兆豐93售03,,,,,0.00,0.00,0,0,0,0,0,0,0,0,0,0,0,0,0
20200316,03038X,元展35,6.45,6.45,6.30,6.30,0.00,0.00,6000,2,38100,0,0,0,0,0,0,6000,0,6000,6000
20200316,03039P,欣興兆豐93售03,,,,,0.00,0.00,0,0,0,0,0,0,0,0,0,0,0,0,0
20200316,03039X,元展36,2.70,2.70,2.57,2.57,-0.41,-13.76,60000,2,155500,0,0,0,0,0,0,60000,0,60000,60000
20200316,03046X,元展43,,,,,0.00,0.00,0,0,0,0,0,0,0,0,0,0,0,0,0
20200316,03047P,台光電凱基93售02,,,,,0.00,0.00,0,0,0,0,0,0,0,0,0,0,0,0,0
20200316,03047X,元展44,,,,,0.00,0.00,0,0,0,0,0,0,0,0,0,0,0,0,0
20200316,03048P,美律凱基93售02,,,,,0.00,0.00,0,0,0,0,0,0,0,0,0,0,0,0,0
20200316,03049X,元展46,3.91,3.91,3.68,3.68,-0.04,-1.08,4000,4,15290,0,0,0,0,0,0,0,4000,-4000,-4000
20200316,03050X,元展47,1.17,1.17,0.99,1.00,-0.40,-28.57,1956000,62,2041340,0,0,0,0,0,0,1261000,345000,916000,916000
20200316,03052X,元展49,15.60,15.60,15.60,15.60,+1.00,6.85,2000,1,31200,0,0,0,0,0,0,0,2000,-2000,-2000
20200316,03059X,元展54,,,,,0.00,0.00,0,0,0,0,0,0,0,0,0,0,0,0,0
20200316,03060X,元展55,,,,,0.00,0.00,0,0,0,0,0,0,0,0,0,0,0,0,0
20200316,03063X,元展58,,,,,0.00,0.00,0,0,0,0,0,0,0,0,0,0,0,0,0
20200316,03064P,元油2X中信94售02,,,,,0.00,0.00,0,0,0,0,0,0,0,0,0,0,0,0,0
20200316,03064X,元展59,4.16,4.16,3.81,3.81,-0.16,-4.03,8000,3,32280,0,0,0,0,0,0,5000,3000,2000,2000
20200316,03071X,元展66,,,,,0.00,0.00,0,0,0,0,0,0,0,0,0,0,0,0,0
20200316,03074X,元展69,,,,,0.00,0.00,0,0,0,0,0,0,0,0,0,0,0,0,0
20200316,03075X,元展70,,,,,0.00,0.00,0,0,0,0,0,0,0,0,0,0,0,0,0
20200316,03077X,元展72,5.10,5.10,5.10,5.10,0.00,0.00,5000,1,25500,0,0,0,0,0,0,0,5000,-5000,-5000
20200316,03078X,元展73,,,,,0.00,0.00,0,0,0,0,0,0,0,0,0,0,0,0,0
20200316,03083P,華通凱基93售02,,,,,0.00,0.00,0,0,0,0,0,0,0,0,0,0,0,0,0
20200316,03085P,美律凱基93售03,0.93,0.93,0.93,0.93,-0.42,-31.11,10000,1,9300,0,0,0,0,0,0,0,10000,-10000,-10000
20200316,03086P,美律凱基93售04,,,,,0.00,0.00,0,0,0,0,0,0,0,0,0,0,0,0,0
20200316,03087P,矽創凱基93售02,0.38,0.38,0.38,0.38,0.00,0.00,10000,1,3800,0,0,0,0,0,0,10000,0,10000,10000
20200316,03088P,世紀鋼凱基93售04,,,,,0.00,0.00,0,0,0,0,0,0,0,0,0,0,0,0,0
20200316,03090X,元展84,,,,,0.00,0.00,0,0,0,0,0,0,0,0,0,0,0,0,0
20200316,03091X,元展85,,,,,0.00,0.00,0,0,0,0,0,0,0,0,0,0,0,0,0
20200316,03093X,永豐金元大61展01,,,,,0.00,0.00,0,0,0,0,0,0,0,0,0,0,0,0,0
20200316,03094X,大立光元大68展08,16.50,16.50,14.70,14.70,-2.40,-14.04,8000,6,125600,1000,0,1000,0,0,0,4000,4000,0,1000
20200316,03098P,技嘉凱基93售01,,,,,0.00,0.00,0,0,0,0,0,0,0,0,0,0,0,0,0
20200316,03100P,緯創凱基93售01,,,,,0.00,0.00,0,0,0,0,0,0,0,0,0,0,0,0,0
20200316,03101P,泰鼎凱基93售01,,,,,0.00,0.00,0,0,0,0,0,0,0,0,0,0,0,0,0
20200316,03102P,瑞儀凱基93售03,,,,,0.00,0.00,0,0,0,0,0,0,0,0,0,0,0,0,0
20200316,03103P,超眾凱基93售02,0.38,0.38,0.38,0.38,+0.06,18.75,10000,1,3800,0,0,0,0,0,0,10000,0,10000,10000
20200316,03108P,旺宏國泰93售02,,,,,0.00,0.00,0,0,0,0,0,0,0,0,0,0,0,0,0
20200316,03109P,聯茂國泰93售01,,,,,0.00,0.00,0,0,0,0,0,0,0,0,0,0,0,0,0
20200316,03110P,台表科國泰93售02,,,,,0.00,0.00,0,0,0,0,0,0,0,0,0,0,0,0,0
20200316,03111P,元油2X富邦97售01,,,,,0.00,0.00,0,0,0,0,0,0,0,0,0,0,0,0,0
20200316,03127P,亞泥凱基93售01,,,,,0.00,0.00,0,0,0,0,0,0,0,0,0,0,0,0,0
20200316,03128P,華通凱基93售04,0.02,0.02,0.02,0.02,0.00,0.00,130000,2,2600,0,0,0,0,0,0,130000,0,130000,130000
20200316,03129P,廣宇凱基93售01,,,,,0.00,0.00,0,0,0,0,0,0,0,0,0,0,0,0,0
20200316,03135P,健策凱基93售03,,,,,0.00,0.00,0,0,0,0,0,0,0,0,0,0,0,0,0
20200316,03136P,台表科凱基93售03,,,,,0.00,0.00,0,0,0,0,0,0,0,0,0,0,0,0,0
20200316,03147P,台積電國泰93售02,,,,,0.00,0.00,0,0,0,0,0,0,0,0,0,0,0,0,0
20200316,03149P,超眾國泰93售04,,,,,0.00,0.00,0,0,0,0,0,0,0,0,0,0,0,0,0
20200316,03152P,台光電凱基93售05,,,,,0.00,0.00,0,0,0,0,0,0,0,0,0,0,0,0,0
20200316,03154P,瑞儀凱基93售04,0.43,0.44,0.43,0.44,0.00,0.00,30000,3,13000,0,0,0,0,0,0,0,30000,-30000,-30000
20200316,03162P,華邦電中信96售02,,,,,0.00,0.00,0,0,0,0,0,0,0,0,0,0,0,0,0
20200316,03171P,元油2X國票93售03,,,,,0.00,0.00,0,0,0,0,0,0,0,0,0,0,0,0,0
20200316,03177P,大立光統一93售01,0.22,1.45,0.22,1.45,+0.06,4.32,217000,11,284640,0,0,0,0,0,0,216000,0,216000,216000
20200316,03179P,力成統一93售01,,,,,0.00,0.00,0,0,0,0,0,0,0,0,0,0,0,0,0
20200316,03180P,華邦電國泰93售01,,,,,0.00,0.00,0,0,0,0,0,0,0,0,0,0,0,0,0
20200316,03181P,道瓊指中信96售01,0.75,2.00,0.73,1.50,+0.81,117.39,250000,35,291160,0,0,0,0,0,0,0,50000,-50000,-50000
20200316,03183P,玉晶光中信93售01,0.01,0.02,0.01,0.02,0.00,0.00,389000,4,4390,0,0,0,0,0,0,379000,10000,369000,369000
20200316,03197P,欣興富邦93售02,0.54,0.96,0.54,0.96,+0.27,39.13,132000,5,90780,0,0,0,0,0,0,60000,72000,-12000,-12000
20200316,03202P,揚明光群益94售01,,,,,0.00,0.00,0,0,0,0,0,0,0,0,0,0,0,0,0
20200316,03237P,玉晶光凱基94售01,0.30,0.45,0.22,0.45,+0.10,28.57,401000,41,104450,0,0,0,0,0,0,0,401000,-401000,-401000
20200316,03242P,玉晶光國泰94售02,0.18,0.50,0.18,0.50,+0.30,150.0,56000,7,11310,0,0,0,0,0,0,0,0,0,0
20200316,03243P,TPK富邦94售01,,,,,0.00,0.00,0,0,0,0,0,0,0,0,0,0,0,0,0
20200316,03252P,玉晶光群益95售02,0.78,0.78,0.78,0.78,+0.08,11.43,3000,1,2340,0,0,0,0,0,0,0,0,0,0
20200316,03253P,玉晶光群益96售01,0.34,0.53,0.34,0.53,+0.15,39.47,762000,40,324430,0,0,0,0,0,0,48000,616000,-568000,-568000
20200316,03267P,玉晶光國票95售01,0.20,0.34,0.20,0.34,+0.05,17.24,263000,6,80300,0,0,0,0,0,0,13000,0,13000,13000
20200316,03292P,美律中信94售01,,,,,0.00,0.00,0,0,0,0,0,0,0,0,0,0,0,0,0
20200316,03296P,康控群益94售01,,,,,0.00,0.00,0,0,0,0,0,0,0,0,0,0,0,0,0
20200316,03298P,元油2X凱基95售01,6.20,6.20,6.20,6.20,-0.15,-2.36,1000,1,6200,0,0,0,0,0,0,0,0,0,0
20200316,03307P,元油2X元大95售03,,,,,0.00,0.00,0,0,0,0,0,0,0,0,0,0,0,0,0
20200316,03314P,滬深2X群益96售02,0.59,0.67,0.59,0.67,+0.13,24.07,36000,3,22320,0,0,0,0,0,0,36000,0,36000,36000
20200316,03334P,元油2X凱基95售02,7.95,7.95,7.95,7.95,0.00,0.00,5000,1,39750,0,0,0,0,0,0,5000,5000,0,0
20200316,03365P,元油2X富邦98售01,,,,,0.00,0.00,0,0,0,0,0,0,0,0,0,0,0,0,0
20200316,03366P,元油2X元大95售05,,,,,0.00,0.00,0,0,0,0,0,0,0,0,0,0,0,0,0
20200316,03387P,元油2X元富94售02,,,,,0.00,0.00,0,0,0,0,0,0,0,0,0,0,0,0,0
20200316,03388P,元油2X元富98售02,3.44,4.10,3.42,4.05,-0.11,-2.64,5000,4,18430,0,0,0,0,0,0,2000,0,2000,2000
20200316,03399P,A50正2中信94售01,0.41,0.48,0.41,0.48,+0.15,45.45,80000,15,36030,0,0,0,0,0,0,42000,38000,4000,4000
20200316,03412P,滬深2X群益98售01,0.62,0.76,0.62,0.76,+0.16,26.67,380000,25,257150,0,0,0,0,0,0,205000,145000,60000,60000
20200316,03413B,臺股指凱基94熊19,2.56,2.94,2.51,2.91,+0.38,15.02,752000,36,2052310,0,0,0,0,0,0,493000,250000,243000,243000
20200316,03414B,臺股指凱基99熊01,3.37,3.78,3.36,3.76,+0.46,13.94,733000,86,2592730,0,1000,-1000,0,0,0,187000,507000,-320000,-321000
20200316,03415B,臺股指元大93熊49,2.93,3.24,2.93,3.22,+0.36,12.59,29000,6,91690,0,0,0,0,0,0,12000,17000,-5000,-5000
20200316,03416B,臺股指凱基95熊05,3.23,3.60,3.22,3.53,+0.46,14.98,80000,18,270550,0,0,0,0,0,0,4000,76000,-72000,-72000
20200316,03417B,臺股指凱基95熊19,3.61,3.61,3.57,3.59,0.00,0.00,55000,6,197150,0,0,0,0,0,0,0,55000,-55000,-55000
20200316,03418B,臺股指元大95熊20,3.37,3.65,3.29,3.63,+0.42,13.08,408000,39,1402840,0,0,0,0,0,0,208000,200000,8000,8000
20200316,03418P,台積電統一94售01,0.12,0.15,0.12,0.15,+0.05,50.0,60000,8,7900,0,0,0,0,0,0,0,40000,-40000,-40000
20200316,03419B,臺股指元富99熊03,,,,,0.00,0.00,0,0,0,0,0,0,0,0,0,0,0,0,0
20200316,03420B,臺股指元大95熊31,3.67,4.01,3.67,4.01,+0.38,10.47,148000,17,553410,0,0,0,0,0,0,80000,68000,12000,12000
20200316,03421B,臺股指元大99熊01,4.37,4.68,4.37,4.68,+0.33,7.59,56000,10,247570,0,0,0,0,0,0,3000,53000,-50000,-50000
20200316,03422B,臺股指凱基96熊28,4.03,4.14,4.03,4.14,+0.33,8.66,50000,3,204800,0,0,0,0,0,0,0,50000,-50000,-50000
20200316,03423B,臺股指元大94熊29,,,,,0.00,0.00,0,0,0,0,0,0,0,0,0,0,0,0,0
20200316,03424B,臺股指元大96熊26,,,,,0.00,0.00,0,0,0,0,0,0,0,0,0,0,0,0,0
20200316,03425B,臺股指元大9A熊01,4.57,4.85,4.55,4.83,+0.43,9.77,66000,18,308530,0,0,0,0,0,0,7000,59000,-52000,-52000
20200316,03426B,臺股指元大95熊33,,,,,0.00,0.00,0,0,0,0,0,0,0,0,0,0,0,0,0
20200316,03426P,台積電兆豐93售04,0.01,0.01,0.01,0.01,0.00,0.00,30000,30,300,0,0,0,0,0,0,0,0,0,0
20200316,03427B,臺股指元大9A熊02,4.93,4.93,4.93,4.93,+0.07,1.44,1000,1,4930,0,0,0,0,0,0,1000,0,1000,1000
20200316,03427P,滬深2X中信94售02,0.28,0.36,0.28,0.33,+0.08,32.0,490000,17,166200,0,0,0,0,0,0,30000,460000,-430000,-430000
20200316,03428B,臺股指凱基97熊18,,,,,0.00,0.00,0,0,0,0,0,0,0,0,0,0,0,0,0
20200316,03428P,道瓊指中信94售02,1.48,1.60,1.16,1.60,+0.02,1.27,132000,16,166330,0,0,0,0,0,0,21000,120000,-99000,-99000
20200316,03429B,臺股指元富97熊07,,,,,0.00,0.00,0,0,0,0,0,0,0,0,0,0,0,0,0
20200316,03430B,臺股指元大9B熊01,3.92,4.23,3.87,4.23,+0.39,10.16,179000,30,721260,0,0,0,0,0,0,81000,98000,-17000,-17000
20200316,03431B,元油2X凱基9B熊03,,,,,0.00,0.00,0,0,0,0,0,0,0,0,0,0,0,0,0
20200316,03432B,臺股指凱基98熊13,,,,,0.00,0.00,0,0,0,0,0,0,0,0,0,0,0,0,0
20200316,03432P,鴻海凱基93售11,,,,,0.00,0.00,0,0,0,0,0,0,0,0,0,0,0,0,0
20200316,03433B,臺股指元大9C熊01,3.92,4.25,3.92,4.25,+0.44,11.55,77000,13,317750,0,0,0,0,0,0,2000,75000,-73000,-73000
20200316,03434B,臺股指元大99熊10,2.94,3.25,2.94,3.25,0.00,0.00,327000,39,997140,0,0,0,0,0,0,0,327000,-327000,-327000
20200316,03436P,力成凱基93售03,,,,,0.00,0.00,0,0,0,0,0,0,0,0,0,0,0,0,0
20200316,03437P,欣興群益93售02,,,,,0.00,0.00,0,0,0,0,0,0,0,0,0,0,0,0,0
20200316,03438P,群創群益98售03,0.32,0.32,0.28,0.29,-0.01,-3.33,369000,15,107110,0,0,0,0,0,0,0,369000,-369000,-369000
20200316,03441P,友達國泰93售03,,,,,0.00,0.00,0,0,0,0,0,0,0,0,0,0,0,0,0
20200316,03444P,裕隆統一93售02,,,,,0.00,0.00,0,0,0,0,0,0,0,0,0,0,0,0,0
20200316,03446P,南亞科統一93售02,,,,,0.00,0.00,0,0,0,0,0,0,0,0,0,0,0,0,0
20200316,03449P,臺股指統一93售05,,,,,0.00,0.00,0,0,0,0,0,0,0,0,0,0,0,0,0
20200316,03450P,元油2X元富98售05,,,,,0.00,0.00,0,0,0,0,0,0,0,0,0,0,0,0,0
20200316,03454P,元油2X元大95售06,,,,,0.00,0.00,0,0,0,0,0,0,0,0,0,0,0,0,0
20200316,03463P,正文國票93售01,,,,,0.00,0.00,0,0,0,0,0,0,0,0,0,0,0,0,0
20200316,03481P,聯茂凱基93售05,0.67,0.67,0.67,0.67,-0.56,-45.53,31000,1,20770,0,0,0,0,0,0,31000,0,31000,31000
20200316,03492P,大立光國泰94售04,,,,,0.00,0.00,0,0,0,0,0,0,0,0,0,0,0,0,0
20200316,03497P,滬深2X元富95售02,1.10,1.36,1.07,1.36,+0.28,25.93,220000,6,250430,0,0,0,0,0,0,220000,0,220000,220000
20200316,03498P,國巨元富94售01,0.02,0.02,0.02,0.02,0.00,0.00,50000,1,1000,0,0,0,0,0,0,50000,0,50000,50000
20200316,03501P,緯穎元富94售01,,,,,0.00,0.00,0,0,0,0,0,0,0,0,0,0,0,0,0
20200316,03517P,臺股指元大93售13,0.32,0.38,0.24,0.38,-0.36,-48.65,710000,8,207200,0,0,0,0,0,0,710000,10000,700000,700000
20200316,03518P,臺股指元大93售14,,,,,0.00,0.00,0,0,0,0,0,0,0,0,0,0,0,0,0
20200316,03519P,臺股指元大93售15,,,,,0.00,0.00,0,0,0,0,0,0,0,0,0,0,0,0,0
20200316,03520P,臺股指元大93售16,1.02,1.90,0.91,1.90,-0.17,-8.21,76000,9,95550,0,0,0,0,0,0,76000,40000,36000,36000
20200316,03525P,和大國票93售01,,,,,0.00,0.00,0,0,0,0,0,0,0,0,0,0,0,0,0
20200316,03526P,大立光國票93售01,,,,,0.00,0.00,0,0,0,0,0,0,0,0,0,0,0,0,0
20200316,035274,華新台新97購01,,,,,0.00,0.00,0,0,0,0,0,0,0,0,0,0,0,0,0
20200316,035275,台積電台新97購01,17.20,17.20,12.80,12.80,-1.50,-10.49,218000,54,3322600,0,0,0,0,0,0,122000,187000,-65000,-65000
20200316,035276,南亞科台新97購01,5.20,5.20,3.78,3.78,-0.66,-14.86,8000,5,33750,0,0,0,0,0,0,2000,6000,-4000,-4000
20200316,035277,景碩台新97購01,1.75,1.75,1.25,1.38,-0.22,-13.75,124000,10,183620,0,0,0,0,0,0,0,124000,-124000,-124000
20200316,03527P,大立光國票93售02,,,,,0.00,0.00,0,0,0,0,0,0,0,0,0,0,0,0,0
20200316,03528P,超眾國票93售02,,,,,0.00,0.00,0,0,0,0,0,0,0,0,0,0,0,0,0
20200316,03543P,T50正2中信95售02,0.48,0.80,0.48,0.80,+0.38,90.48,308000,16,168890,0,0,0,0,0,0,173000,20000,153000,153000
20200316,03544P,貿聯國票93售01,,,,,0.00,0.00,0,0,0,0,0,0,0,0,0,0,0,0,0
20200316,03546P,上銀兆豐93售03,,,,,0.00,0.00,0,0,0,0,0,0,0,0,0,0,0,0,0
20200316,03553P,上銀富邦94售01,,,,,0.00,0.00,0,0,0,0,0,0,0,0,0,0,0,0,0
20200316,03555P,台積電富邦95售01,0.04,0.04,0.02,0.04,0.00,0.00,1147000,28,44380,0,0,0,0,0,0,998000,0,998000,998000
20200316,03557P,大立光元大93售12,0.17,0.36,0.16,0.35,+0.11,45.83,207000,20,54310,0,0,0,0,0,0,61000,141000,-80000,-80000
20200316,03560P,中鋼中信94售02,1.71,1.74,1.71,1.74,+0.15,9.43,3000,3,5160,0,0,0,0,0,0,0,3000,-3000,-3000
20200316,03561P,聯發科中信93售02,0.09,0.09,0.09,0.09,-0.14,-60.87,2000,1,180,0,0,0,0,0,0,2000,0,2000,2000
20200316,03563P,鴻海群益93售03,,,,,0.00,0.00,0,0,0,0,0,0,0,0,0,0,0,0,0
20200316,03564P,致茂群益94售01,0.69,1.01,0.69,1.01,+0.21,26.25,26000,4,24480,0,0,0,0,0,0,1000,25000,-24000,-24000
20200316,03566P,群創群益96售01,0.70,0.70,0.70,0.70,0.00,0.00,1000,1,700,0,0,0,0,0,0,1000,0,1000,1000
20200316,03567P,百和群益94售02,,,,,0.00,0.00,0,0,0,0,0,0,0,0,0,0,0,0,0
20200316,03576P,聯發科統一94售02,0.60,1.04,0.60,1.04,+0.47,82.46,167000,10,108020,0,0,0,0,0,0,126000,20000,106000,106000
20200316,03583P,聯發科富邦94售02,,,,,0.00,0.00,0,0,0,0,0,0,0,0,0,0,0,0,0
20200316,03591P,中環中信94售01,,,,,0.00,0.00,0,0,0,0,0,0,0,0,0,0,0,0,0
20200316,03595P,智易群益94售01,,,,,0.00,0.00,0,0,0,0,0,0,0,0,0,0,0,0,0
20200316,03602C,臺股指元大93牛01,,,,,0.00,0.00,0,0,0,0,0,0,0,0,0,0,0,0,0
20200316,03603P,群創凱基98售04,1.07,1.07,1.07,1.07,-0.13,-10.83,1000,1,1070,0,0,0,0,0,0,1000,0,1000,1000
20200316,03604P,群創凱基98售05,0.91,0.91,0.91,0.91,+0.03,3.41,10000,1,9100,0,0,0,0,0,0,0,10000,-10000,-10000
20200316,03607P,滬深2X富邦95售01,,,,,0.00,0.00,0,0,0,0,0,0,0,0,0,0,0,0,0
20200316,036084,台灣50台新98購01,,,,,0.00,0.00,0,0,0,0,0,0,0,0,0,0,0,0,0
20200316,03612C,臺股指元大95牛01,0.93,0.99,0.73,0.73,-0.25,-25.51,506000,21,481010,0,0,0,0,0,0,409000,62000,347000,347000
20200316,03615C,臺股指元大94牛01,1.45,1.54,1.19,1.19,-0.38,-24.2,281000,34,402180,0,0,0,0,0,0,89000,192000,-103000,-103000
20200316,03618C,高股息凱基95牛01,1.42,1.49,1.42,1.42,-0.03,-2.07,36000,12,51800,0,0,0,0,0,0,0,36000,-36000,-36000
20200316,03619C,臺股指元大95牛02,1.77,1.86,1.50,1.52,-0.40,-20.83,796000,108,1328100,0,0,0,0,0,0,265000,522000,-257000,-257000
20200316,03623P,台積電群益93售03,,,,,0.00,0.00,0,0,0,0,0,0,0,0,0,0,0,0,0
20200316,03626P,可成兆豐93售03,,,,,0.00,0.00,0,0,0,0,0,0,0,0,0,0,0,0,0
20200316,03627P,大立光兆豐93售03,,,,,0.00,0.00,0,0,0,0,0,0,0,0,0,0,0,0,0
20200316,03630C,臺股指元富93牛02,1.59,1.59,1.59,1.59,+0.19,13.57,10000,1,15900,0,0,0,0,0,0,0,10000,-10000,-10000
20200316,03631P,鴻海凱基93售13,,,,,0.00,0.00,0,0,0,0,0,0,0,0,0,0,0,0,0
20200316,03632C,臺股指元大95牛03,0.85,1.02,0.68,0.68,-0.49,-41.88,395000,16,349750,0,0,0,0,0,0,205000,75000,130000,130000
20200316,03633C,臺股指凱基93牛19,,,,,0.00,0.00,0,0,0,0,0,0,0,0,0,0,0,0,0
20200316,03635C,滬深2X元富99牛01,1.87,1.87,1.72,1.72,-0.02,-1.15,103000,5,182060,0,0,0,0,0,0,20000,83000,-63000,-63000
20200316,03637C,臺股指凱基94牛18,0.49,0.50,0.15,0.15,-0.04,-21.05,30000,3,11400,0,0,0,0,0,0,0,10000,-10000,-10000
20200316,03638C,T50反1元大94牛03,1.70,1.97,1.69,1.97,+0.31,18.67,336000,20,639810,0,0,0,0,0,0,231000,105000,126000,126000
20200316,03638P,嘉晶凱基93售03,,,,,0.00,0.00,0,0,0,0,0,0,0,0,0,0,0,0,0
20200316,03639P,祥碩凱基93售05,,,,,0.00,0.00,0,0,0,0,0,0,0,0,0,0,0,0,0
20200316,03640P,百和凱基93售05,,,,,0.00,0.00,0,0,0,0,0,0,0,0,0,0,0,0,0
20200316,03647C,T50反1元富99牛02,3.79,4.07,3.79,4.05,+0.40,10.96,1109000,12,4269740,0,0,0,0,0,0,540000,569000,-29000,-29000
20200316,03647P,京元電元富95售02,1.26,1.50,1.25,1.43,+0.08,5.93,80000,15,109220,0,0,0,0,0,0,47000,63000,-16000,-16000
20200316,03648C,T50反1元大96牛07,3.38,3.52,3.37,3.51,0.00,0.00,190000,19,647400,0,0,0,0,0,0,0,190000,-190000,-190000
20200316,03649C,T50反1凱基99牛05,2.88,3.05,2.86,3.05,0.00,0.00,250000,6,736000,0,0,0,0,0,0,0,250000,-250000,-250000
20200316,03649P,聯發科國泰93售02,,,,,0.00,0.00,0,0,0,0,0,0,0,0,0,0,0,0,0
20200316,03650C,T50反1元大98牛05,3.30,3.61,3.30,3.61,+0.30,9.06,178000,20,624690,0,0,0,0,0,0,6000,172000,-166000,-166000
20200316,03650P,群創國泰93售03,,,,,0.00,0.00,0,0,0,0,0,0,0,0,0,0,0,0,0
20200316,03652C,臺股指元大03牛01,0.52,0.54,0.22,0.30,-0.23,-43.4,1622000,68,682440,0,0,0,0,0,0,481000,311000,170000,170000
20200316,03657C,T50反1元大99牛01,3.32,3.32,3.32,3.32,-0.13,-3.77,5000,1,16600,0,0,0,0,0,0,5000,0,5000,5000
20200316,03658C,T50反1元大9A牛02,3.64,3.72,3.63,3.72,-0.16,-4.12,135000,14,494200,0,0,0,0,0,0,0,135000,-135000,-135000
20200316,03660P,台積電中信93售01,,,,,0.00,0.00,0,0,0,0,0,0,0,0,0,0,0,0,0
20200316,036628,統一台新99購01,2.02,2.03,2.00,2.00,-0.03,-1.48,7000,3,14130,0,0,0,0,0,0,0,7000,-7000,-7000
20200316,036629,智邦台新99購01,,,,,0.00,0.00,0,0,0,0,0,0,0,0,0,0,0,0,0
20200316,03662C,FBVIX凱基03牛01,6.75,6.90,6.55,6.85,+1.00,17.09,58000,9,391400,0,0,0,0,0,0,7000,51000,-44000,-44000
20200316,036630,玉山金台新99購01,4.90,4.90,4.71,4.71,-0.06,-1.26,94000,2,442930,0,0,0,0,0,0,93000,0,93000,93000
20200316,03664C,臺股指元大05牛01,0.90,1.00,0.56,0.59,-0.46,-43.81,696000,31,521440,0,0,0,0,0,0,549000,21000,528000,528000
20200316,03667P,鴻海凱基93售14,,,,,0.00,0.00,0,0,0,0,0,0,0,0,0,0,0,0,0
20200316,03668C,臺股指元大03牛02,0.99,1.60,0.79,0.79,-0.23,-22.55,81000,16,83260,0,0,0,0,0,0,0,75000,-75000,-75000
20200316,03669C,滬深2X元富09牛01,3.15,3.19,3.05,3.07,-0.17,-5.25,67000,6,212150,0,0,0,0,0,0,40000,27000,13000,13000
20200316,03670C,元油2X元富99牛01,1.67,1.75,1.63,1.64,+0.28,20.59,75000,8,127510,0,0,0,0,0,0,1000,74000,-73000,-73000
20200316,03671C,元油2X元大03牛01,3.24,3.24,3.05,3.05,-0.41,-11.85,3000,2,9530,0,0,0,0,0,0,0,3000,-3000,-3000
20200316,03671P,大立光凱基95售02,0.80,0.92,0.80,0.92,0.00,0.00,270000,3,235800,0,0,0,0,0,0,0,270000,-270000,-270000
20200316,03676P,大立光國泰93售03,,,,,0.00,0.00,0,0,0,0,0,0,0,0,0,0,0,0,0
20200316,03686P,大立光統一98售02,0.75,1.05,0.65,1.00,-0.02,-1.96,747000,27,619930,0,0,0,0,0,0,2000,130000,-128000,-128000
20200316,03708P,鴻海亞東93售01,,,,,0.00,0.00,0,0,0,0,0,0,0,0,0,0,0,0,0
20200316,03712P,京元電統一93售02,,,,,0.00,0.00,0,0,0,0,0,0,0,0,0,0,0,0,0
20200316,03720P,元油2X富邦95售01,,,,,0.00,0.00,0,0,0,0,0,0,0,0,0,0,0,0,0
20200316,03737P,臺股指中信95售01,0.05,0.18,0.05,0.15,+0.12,400.0,2119000,19,196670,0,0,0,0,0,0,1799000,0,1799000,1799000
20200316,03740P,奇鋐群益94售01,,,,,0.00,0.00,0,0,0,0,0,0,0,0,0,0,0,0,0
20200316,03751P,旺宏富邦95售01,0.32,0.36,0.32,0.36,-0.05,-12.2,31000,2,10720,0,0,0,0,0,0,31000,0,31000,31000
20200316,03763P,聯發科元富96售01,0.80,1.20,0.74,1.20,+0.49,69.01,255000,26,255800,0,0,0,0,0,0,150000,70000,80000,80000
20200316,03765P,大立光元富96售01,0.88,0.88,0.86,0.86,+0.21,32.31,90000,2,77600,0,0,0,0,0,0,90000,0,90000,90000
20200316,03777P,華通中信95售01,0.23,0.28,0.23,0.28,+0.03,12.0,90000,4,22950,0,0,0,0,0,0,90000,0,90000,90000
20200316,037839,T50反1群益93購01,,,,,0.00,0.00,0,0,0,0,0,0,0,0,0,0,0,0,0
20200316,03786P,鴻海群益94售02,0.01,0.02,0.01,0.02,-0.03,-60.0,8000,2,110,0,0,0,0,0,0,5000,0,5000,5000
20200316,03787P,台積電群益94售02,,,,,0.00,0.00,0,0,0,0,0,0,0,0,0,0,0,0,0
20200316,03788P,聯發科群益94售02,,,,,0.00,0.00,0,0,0,0,0,0,0,0,0,0,0,0,0
20200316,03799P,京元電元大94售01,,,,,0.00,0.00,0,0,0,0,0,0,0,0,0,0,0,0,0
20200316,03808P,旺宏國泰94售02,,,,,0.00,0.00,0,0,0,0,0,0,0,0,0,0,0,0,0
20200316,038095,T50反1群益93購02,0.10,0.12,0.08,0.10,+0.03,42.86,1205000,72,118600,0,0,0,0,0,0,0,50000,-50000,-50000
20200316,03810P,大立光富邦98售01,0.90,0.90,0.90,0.90,+0.09,11.11,3000,1,2700,0,0,0,0,0,0,3000,0,3000,3000
20200316,03821P,上海銀統一95售01,,,,,0.00,0.00,0,0,0,0,0,0,0,0,0,0,0,0,0
20200316,03824P,燿華元大94售01,,,,,0.00,0.00,0,0,0,0,0,0,0,0,0,0,0,0,0
20200316,03826P,瀚宇博元大95售01,1.49,1.60,1.49,1.60,-0.04,-2.44,60000,4,92700,0,0,0,0,0,0,30000,30000,0,0
20200316,03827P,矽創國票94售01,,,,,0.00,0.00,0,0,0,0,0,0,0,0,0,0,0,0,0
20200316,03828P,致茂中信95售01,1.36,1.44,1.36,1.44,-0.08,-5.26,42000,4,58920,0,0,0,0,0,0,42000,0,42000,42000
20200316,03829P,元大金中信95售01,,,,,0.00,0.00,0,0,0,0,0,0,0,0,0,0,0,0,0
20200316,03830P,緯創中信95售01,,,,,0.00,0.00,0,0,0,0,0,0,0,0,0,0,0,0,0
20200316,03831P,臺股指中信95售02,0.91,1.10,0.91,1.10,+0.16,17.02,6000,3,5690,0,0,0,0,0,0,5000,0,5000,5000
20200316,03832P,臺股指中信95售03,,,,,0.00,0.00,0,0,0,0,0,0,0,0,0,0,0,0,0
20200316,03840P,台積電統一99售02,0.55,0.78,0.55,0.69,0.00,0.00,2201000,153,1319360,0,0,0,0,0,0,683000,118000,565000,565000
20200316,038455,群臺反群益94購01,0.02,0.17,0.02,0.10,+0.07,233.33,505000,13,55870,0,0,0,0,0,0,0,0,0,0
20200316,038489,T50反1台新9A購01,0.60,0.90,0.60,0.90,+0.30,50.0,823000,72,621220,0,0,0,0,0,0,138000,0,138000,138000
20200316,03857P,聯發科元富99售02,0.70,0.90,0.63,0.90,+0.23,34.33,1368000,32,984340,0,0,0,0,0,0,829000,404000,425000,425000
20200316,03860P,群創元富97售01,1.13,1.32,1.13,1.32,-0.02,-1.49,52000,6,64220,0,0,0,0,0,0,0,52000,-52000,-52000
20200316,03861P,群創元富99售01,0.80,0.88,0.80,0.88,+0.06,7.32,160000,3,132200,0,0,0,0,0,0,10000,150000,-140000,-140000
20200316,03874P,臺股指群益95售01,,,,,0.00,0.00,0,0,0,0,0,0,0,0,0,0,0,0,0
20200316,03875P,滬深2X國票05售01,,,,,0.00,0.00,0,0,0,0,0,0,0,0,0,0,0,0,0
20200316,03877P,台光電國票94售01,,,,,0.00,0.00,0,0,0,0,0,0,0,0,0,0,0,0,0
20200316,03885P,華新科統一96售01,0.70,0.75,0.70,0.75,+0.15,25.0,20000,2,14500,0,0,0,0,0,0,10000,10000,0,0
20200316,03889P,國巨國泰94售04,,,,,0.00,0.00,0,0,0,0,0,0,0,0,0,0,0,0,0
20200316,03890P,聯詠國泰94售02,0.38,0.38,0.38,0.38,+0.02,5.56,18000,2,6840,0,0,0,0,0,0,18000,0,18000,18000
20200316,03891P,晶技國泰94售02,,,,,0.00,0.00,0,0,0,0,0,0,0,0,0,0,0,0,0
20200316,03892P,元油2X中信95售01,,,,,0.00,0.00,0,0,0,0,0,0,0,0,0,0,0,0,0
20200316,03894P,鴻海凱基94售05,,,,,0.00,0.00,0,0,0,0,0,0,0,0,0,0,0,0,0
20200316,03896P,長榮航凱基95售01,3.10,3.50,3.10,3.50,+0.64,22.38,245000,21,798930,0,0,0,0,0,0,216000,1000,215000,215000
20200316,03899P,滬深2X群益95售03,,,,,0.00,0.00,0,0,0,0,0,0,0,0,0,0,0,0,0
20200316,03902P,義隆國票94售01,,,,,0.00,0.00,0,0,0,0,0,0,0,0,0,0,0,0,0
20200316,03907P,易華電國泰94售03,,,,,0.00,0.00,0,0,0,0,0,0,0,0,0,0,0,0,0
20200316,03917P,鴻海凱基94售07,0.23,0.23,0.22,0.23,-0.25,-52.08,76000,8,17320,0,0,0,0,0,0,26000,50000,-24000,-24000
20200316,039212,台達電台新9A購01,0.30,0.33,0.27,0.27,-0.03,-10.0,57000,10,17060,0,0,0,0,0,0,0,55000,-55000,-55000
20200316,03921P,亞光凱基94售01,1.82,1.82,1.82,1.82,+0.17,10.3,5000,1,9100,0,0,0,0,0,0,5000,0,5000,5000
20200316,03927P,旺宏台新94售01,,,,,0.00,0.00,0,0,0,0,0,0,0,0,0,0,0,0,0
20200316,03935P,可成富邦95售01,1.06,1.12,1.06,1.12,-0.12,-9.68,23000,2,24680,0,0,0,0,0,0,23000,0,23000,23000
20200316,03939P,康控元大95售02,,,,,0.00,0.00,0,0,0,0,0,0,0,0,0,0,0,0,0
20200316,03945P,欣興群益94售01,,,,,0.00,0.00,0,0,0,0,0,0,0,0,0,0,0,0,0
20200316,03947P,新光金國泰94售01,,,,,0.00,0.00,0,0,0,0,0,0,0,0,0,0,0,0,0
20200316,03951P,新光金凱基95售01,1.01,1.17,1.01,1.16,+0.06,5.45,90000,23,97950,0,0,0,0,0,0,40000,50000,-10000,-10000
20200316,03953P,易華電凱基94售01,3.70,3.70,3.70,3.70,0.00,0.00,10000,2,37000,0,0,0,0,0,0,10000,0,10000,10000
20200316,039550,滬深反凱基94購01,0.10,0.13,0.08,0.13,+0.03,30.0,131000,12,13980,0,0,0,0,0,0,1000,130000,-129000,-129000
20200316,03957P,創意統一94售02,,,,,0.00,0.00,0,0,0,0,0,0,0,0,0,0,0,0,0
20200316,03959P,義隆元富96售01,1.33,1.62,1.33,1.62,+0.05,3.18,45000,7,64430,0,0,0,0,0,0,32000,3000,29000,29000
20200316,03960P,新日興元富96售02,1.48,1.77,1.45,1.77,+0.10,5.99,256000,18,408250,0,0,0,0,0,0,121000,135000,-14000,-14000
20200316,03965P,上銀國票94售01,,,,,0.00,0.00,0,0,0,0,0,0,0,0,0,0,0,0,0
20200316,03969P,華新科國票94售01,,,,,0.00,0.00,0,0,0,0,0,0,0,0,0,0,0,0,0
20200316,03975P,大立光元大94售02,0.26,0.26,0.26,0.26,0.00,0.00,20000,2,5200,0,0,0,0,0,0,0,20000,-20000,-20000
20200316,03980P,群創凱基95售02,0.46,0.46,0.46,0.46,-0.13,-22.03,5000,1,2300,0,0,0,0,0,0,0,5000,-5000,-5000
20200316,03982P,智易國票94售02,,,,,0.00,0.00,0,0,0,0,0,0,0,0,0,0,0,0,0
20200316,03993P,滬深2X中信94售03,1.46,1.67,1.43,1.67,+0.33,24.63,75000,8,115600,0,0,0,0,0,0,20000,55000,-35000,-35000
20200316,03995P,滬深2X國泰95售01,,,,,0.00,0.00,0,0,0,0,0,0,0,0,0,0,0,0,0
20200316,03996P,旺宏國泰95售01,0.80,1.10,0.76,1.10,+0.24,27.91,182000,7,153070,0,0,0,0,0,0,121000,61000,60000,60000
20200316,03999P,鴻海凱基94售11,0.55,0.62,0.35,0.55,+0.23,71.87,963000,48,433880,0,0,0,0,0,0,622000,298000,324000,324000
20200316,04003P,麗豐凱基94售03,1.39,1.58,1.39,1.48,-0.24,-13.95,141000,10,209340,0,0,0,0,0,0,26000,115000,-89000,-89000
20200316,04006P,滬深2X國票9B售01,,,,,0.00,0.00,0,0,0,0,0,0,0,0,0,0,0,0,0
20200316,040160,SP黃豆元富95購01,0.06,0.06,0.06,0.06,0.00,0.00,20000,1,1200,0,0,0,0,0,0,20000,0,20000,20000
20200316,040215,上証反凱基95購01,0.18,0.19,0.17,0.19,-0.01,-5.0,142000,4,26740,0,0,0,0,0,0,0,140000,-140000,-140000
20200316,04022P,群創元富96售04,,,,,0.00,0.00,0,0,0,0,0,0,0,0,0,0,0,0,0
20200316,04023P,臺股指元富99售02,1.11,2.00,1.10,1.90,+0.79,71.17,619000,72,1073180,0,0,0,0,0,0,5000,10000,-5000,-5000
20200316,04025P,宏達電國泰94售01,1.22,1.37,1.22,1.37,+0.11,8.73,23000,4,29330,0,0,0,0,0,0,9000,14000,-5000,-5000
20200316,04028P,燿華凱基94售02,2.44,2.58,2.44,2.58,+0.19,7.95,65000,5,164200,0,0,0,0,0,0,10000,65000,-55000,-55000
20200316,04032P,聯茂凱基94售02,,,,,0.00,0.00,0,0,0,0,0,0,0,0,0,0,0,0,0
20200316,040380,SP黃豆元富95購02,,,,,0.00,0.00,0,0,0,0,0,0,0,0,0,0,0,0,0
20200316,040381,元金2X元富95購01,2.63,2.63,2.63,2.63,0.00,0.00,1000,1,2630,0,0,0,0,0,0,0,1000,-1000,-1000
20200316,04041P,大立光統一94售03,,,,,0.00,0.00,0,0,0,0,0,0,0,0,0,0,0,0,0
20200316,04047P,華邦電元大94售03,,,,,0.00,0.00,0,0,0,0,0,0,0,0,0,0,0,0,0
20200316,04049P,大立光元大95售02,0.82,1.20,0.81,1.10,+0.30,37.5,956000,77,922160,0,0,0,0,0,0,455000,495000,-40000,-40000
20200316,04051P,友達中信94售02,0.67,0.67,0.59,0.60,-0.19,-24.05,6000,6,3830,0,0,0,0,0,0,6000,0,6000,6000
20200316,04052P,上銀國泰94售01,1.13,1.59,1.13,1.59,+0.47,41.96,160000,11,184290,0,0,0,0,0,0,159000,151000,8000,8000
20200316,04053P,聯茂國泰94售01,,,,,0.00,0.00,0,0,0,0,0,0,0,0,0,0,0,0,0
20200316,04054P,滬深2X富邦96售02,,,,,0.00,0.00,0,0,0,0,0,0,0,0,0,0,0,0,0
20200316,04055P,奇力新群益93售04,,,,,0.00,0.00,0,0,0,0,0,0,0,0,0,0,0,0,0
20200316,04056P,臺股指群益93售10,,,,,0.00,0.00,0,0,0,0,0,0,0,0,0,0,0,0,0
20200316,040578,SP黃豆元富95購03,,,,,0.00,0.00,0,0,0,0,0,0,0,0,0,0,0,0,0
20200316,04057P,臺股指群益93售11,,,,,0.00,0.00,0,0,0,0,0,0,0,0,0,0,0,0,0
20200316,04058P,臺股指群益93售12,,,,,0.00,0.00,0,0,0,0,0,0,0,0,0,0,0,0,0
20200316,04059P,臺股指群益93售13,,,,,0.00,0.00,0,0,0,0,0,0,0,0,0,0,0,0,0
20200316,04060P,臺股指群益93售14,,,,,0.00,0.00,0,0,0,0,0,0,0,0,0,0,0,0,0
20200316,04061P,臺股指群益93售15,,,,,0.00,0.00,0,0,0,0,0,0,0,0,0,0,0,0,0
20200316,04062P,可成兆豐93售04,,,,,0.00,0.00,0,0,0,0,0,0,0,0,0,0,0,0,0
20200316,04063P,臺股指兆豐93售02,,,,,0.00,0.00,0,0,0,0,0,0,0,0,0,0,0,0,0
20200316,04064P,臺股指兆豐93售03,3.20,3.20,3.20,3.20,+1.94,153.97,10000,1,32000,0,0,0,0,0,0,10000,0,10000,10000
20200316,04065P,台積電凱基93售20,,,,,0.00,0.00,0,0,0,0,0,0,0,0,0,0,0,0,0
20200316,04066P,京元電凱基93售02,,,,,0.00,0.00,0,0,0,0,0,0,0,0,0,0,0,0,0
20200316,04067P,聯發科凱基93售24,,,,,0.00,0.00,0,0,0,0,0,0,0,0,0,0,0,0,0
20200316,04068P,大立光凱基93售27,,,,,0.00,0.00,0,0,0,0,0,0,0,0,0,0,0,0,0
20200316,04069P,聯詠凱基93售05,,,,,0.00,0.00,0,0,0,0,0,0,0,0,0,0,0,0,0
20200316,04070P,臺股指凱基93售06,1.10,1.10,1.10,1.10,-1.27,-53.59,30000,2,33000,0,0,0,0,0,0,30000,0,30000,30000
20200316,04071P,臺股指凱基93售07,1.23,3.51,1.23,3.51,+2.42,222.02,210000,26,469960,0,0,0,0,0,0,134000,206000,-72000,-72000
20200316,04072P,臺股指凱基93售08,3.85,3.85,3.85,3.85,+2.21,134.76,40000,1,154000,0,0,0,0,0,0,40000,0,40000,40000
20200316,04073P,臺股指凱基93售09,,,,,0.00,0.00,0,0,0,0,0,0,0,0,0,0,0,0,0
20200316,040744,滬深2X國票94購01,,,,,0.00,0.00,0,0,0,0,0,0,0,0,0,0,0,0,0
20200316,04074P,臺股指凱基93售10,,,,,0.00,0.00,0,0,0,0,0,0,0,0,0,0,0,0,0
20200316,04075P,臺股指凱基93售11,,,,,0.00,0.00,0,0,0,0,0,0,0,0,0,0,0,0,0
20200316,040760,T50反1凱基95購01,1.84,2.40,1.83,2.30,+0.42,22.34,472000,14,966660,0,0,0,0,0,0,355000,0,355000,355000
20200316,040761,T50反1凱基95購02,0.25,0.50,0.25,0.48,+0.27,128.57,800000,75,231710,0,0,0,0,0,0,60000,590000,-530000,-530000
20200316,04076P,臺股指凱基93售12,,,,,0.00,0.00,0,0,0,0,0,0,0,0,0,0,0,0,0
20200316,04077P,臺股指凱基93售13,0.24,0.51,0.24,0.51,-0.47,-47.96,35000,5,13650,0,0,0,0,0,0,10000,35000,-25000,-25000
20200316,04078P,臺股指凱基93售14,3.85,3.85,3.85,3.85,+2.21,134.76,50000,1,192500,0,0,0,0,0,0,50000,0,50000,50000
20200316,04079P,燿華元大93售04,,,,,0.00,0.00,0,0,0,0,0,0,0,0,0,0,0,0,0
20200316,04080P,可成元大93售11,0.05,0.08,0.05,0.07,-0.28,-80.0,18000,4,1180,0,0,0,0,0,0,18000,0,18000,18000
20200316,04081P,聯詠元大93售11,,,,,0.00,0.00,0,0,0,0,0,0,0,0,0,0,0,0,0
20200316,04082P,智邦統一93售03,,,,,0.00,0.00,0,0,0,0,0,0,0,0,0,0,0,0,0
20200316,04083P,欣興統一94售01,,,,,0.00,0.00,0,0,0,0,0,0,0,0,0,0,0,0,0
20200316,04084P,台表科統一93售01,0.05,0.05,0.05,0.05,-0.01,-16.67,2000,1,100,0,0,0,0,0,0,2000,0,2000,2000
20200316,04085P,欣興元富93售01,,,,,0.00,0.00,0,0,0,0,0,0,0,0,0,0,0,0,0
20200316,04086P,臺股指元富93售04,2.97,3.52,2.97,3.52,+0.55,18.52,20000,2,64900,0,0,0,0,0,0,20000,0,20000,20000
20200316,04087P,臺股指元富93售05,,,,,0.00,0.00,0,0,0,0,0,0,0,0,0,0,0,0,0
20200316,04088P,臺股指元富93售06,,,,,0.00,0.00,0,0,0,0,0,0,0,0,0,0,0,0,0
20200316,04089P,臺股指元富93售07,,,,,0.00,0.00,0,0,0,0,0,0,0,0,0,0,0,0,0
20200316,04090P,臺股指元富93售08,,,,,0.00,0.00,0,0,0,0,0,0,0,0,0,0,0,0,0
20200316,04091P,臺股指元富93售09,,,,,0.00,0.00,0,0,0,0,0,0,0,0,0,0,0,0,0
20200316,04092P,臺股指元富93售10,,,,,0.00,0.00,0,0,0,0,0,0,0,0,0,0,0,0,0
20200316,04093P,上銀國票94售02,,,,,0.00,0.00,0,0,0,0,0,0,0,0,0,0,0,0,0
20200316,04094P,臺股指國票93售01,,,,,0.00,0.00,0,0,0,0,0,0,0,0,0,0,0,0,0
20200316,04095P,臺股指國票93售02,,,,,0.00,0.00,0,0,0,0,0,0,0,0,0,0,0,0,0
20200316,04096P,臺股指國票93售03,,,,,0.00,0.00,0,0,0,0,0,0,0,0,0,0,0,0,0
20200316,04097P,臺股指國票93售04,,,,,0.00,0.00,0,0,0,0,0,0,0,0,0,0,0,0,0
20200316,04098P,臺股指國票93售05,,,,,0.00,0.00,0,0,0,0,0,0,0,0,0,0,0,0,0
20200316,04099P,臺股指國票93售06,,,,,0.00,0.00,0,0,0,0,0,0,0,0,0,0,0,0,0
20200316,04100P,臺股指國票93售07,,,,,0.00,0.00,0,0,0,0,0,0,0,0,0,0,0,0,0
20200316,04101P,臺股指國票93售08,,,,,0.00,0.00,0,0,0,0,0,0,0,0,0,0,0,0,0
20200316,04102P,臺股指國票93售09,,,,,0.00,0.00,0,0,0,0,0,0,0,0,0,0,0,0,0
20200316,04103P,臺股指國票93售10,,,,,0.00,0.00,0,0,0,0,0,0,0,0,0,0,0,0,0
20200316,04104P,臺股指國票93售11,,,,,0.00,0.00,0,0,0,0,0,0,0,0,0,0,0,0,0
20200316,04105P,東陽康和93售03,,,,,0.00,0.00,0,0,0,0,0,0,0,0,0,0,0,0,0
20200316,04106P,滬深2X永豐93售02,0.26,0.32,0.26,0.32,0.00,0.00,100000,4,27800,0,0,0,0,0,0,70000,30000,40000,40000
20200316,04107P,元黃金中信94售01,0.23,0.23,0.18,0.23,+0.06,35.29,260000,6,50800,0,0,0,0,0,0,220000,0,220000,220000
20200316,04108P,臺股指永昌93售03,,,,,0.00,0.00,0,0,0,0,0,0,0,0,0,0,0,0,0
20200316,04109P,臺股指永昌93售04,2.00,2.00,2.00,2.00,+1.50,300.0,40000,1,80000,0,0,0,0,0,0,40000,0,40000,40000
20200316,04110P,臺股指富邦93售03,1.16,1.16,1.16,1.16,-0.96,-45.28,1000,1,1160,0,0,0,0,0,0,1000,0,1000,1000
20200316,04111P,臺股指富邦93售04,,,,,0.00,0.00,0,0,0,0,0,0,0,0,0,0,0,0,0
20200316,04112P,臺股指富邦93售05,,,,,0.00,0.00,0,0,0,0,0,0,0,0,0,0,0,0,0
20200316,04113P,臺股指富邦93售06,0.02,0.02,0.02,0.02,-0.25,-92.59,10000,1,200,0,0,0,0,0,0,10000,0,10000,10000
20200316,04114P,電子類富邦93售02,,,,,0.00,0.00,0,0,0,0,0,0,0,0,0,0,0,0,0
20200316,04115P,欣興群益93售06,,,,,0.00,0.00,0,0,0,0,0,0,0,0,0,0,0,0,0
20200316,04116P,京元電元大94售02,0.71,0.84,0.65,0.82,+0.08,10.81,70000,9,54450,0,0,0,0,0,0,15000,55000,-40000,-40000
20200316,04117P,聯發科元大93售21,,,,,0.00,0.00,0,0,0,0,0,0,0,0,0,0,0,0,0
20200316,04118P,上銀凱基93售06,,,,,0.00,0.00,0,0,0,0,0,0,0,0,0,0,0,0,0
20200316,04119P,旺宏凱基93售06,,,,,0.00,0.00,0,0,0,0,0,0,0,0,0,0,0,0,0
20200316,04120P,智邦凱基93售09,,,,,0.00,0.00,0,0,0,0,0,0,0,0,0,0,0,0,0
20200316,041210,群創元富93購01,,,,,0.00,0.00,0,0,0,0,0,0,0,0,0,0,0,0,0
20200316,04121P,宏碁凱基93售02,,,,,0.00,0.00,0,0,0,0,0,0,0,0,0,0,0,0,0
20200316,04122P,瑞昱凱基93售09,,,,,0.00,0.00,0,0,0,0,0,0,0,0,0,0,0,0,0
20200316,04123P,可成凱基93售11,,,,,0.00,0.00,0,0,0,0,0,0,0,0,0,0,0,0,0
20200316,04124P,可成凱基93售12,,,,,0.00,0.00,0,0,0,0,0,0,0,0,0,0,0,0,0
20200316,04125P,健策凱基93售05,,,,,0.00,0.00,0,0,0,0,0,0,0,0,0,0,0,0,0
20200316,04126P,滬深2X國票95售02,,,,,0.00,0.00,0,0,0,0,0,0,0,0,0,0,0,0,0
20200316,04127P,聯茂國票93售02,,,,,0.00,0.00,0,0,0,0,0,0,0,0,0,0,0,0,0
20200316,04128P,台積電統一93售05,0.01,0.01,0.01,0.01,-0.02,-66.67,240000,13,2400,0,0,0,0,0,0,0,0,0,0
20200316,04129P,亞德客永豐93售04,,,,,0.00,0.00,0,0,0,0,0,0,0,0,0,0,0,0,0
20200316,04130P,台積電永豐93售03,,,,,0.00,0.00,0,0,0,0,0,0,0,0,0,0,0,0,0
20200316,04131P,裕隆群益93售01,,,,,0.00,0.00,0,0,0,0,0,0,0,0,0,0,0,0,0
20200316,04132P,瑞昱群益93售04,1.10,1.10,1.10,1.10,0.00,0.00,10000,1,11000,0,0,0,0,0,0,10000,0,10000,10000
20200316,04133P,友達群益93售01,,,,,0.00,0.00,0,0,0,0,0,0,0,0,0,0,0,0,0
20200316,04134P,華新科群益93售02,,,,,0.00,0.00,0,0,0,0,0,0,0,0,0,0,0,0,0
20200316,04135P,亞德客元大93售04,,,,,0.00,0.00,0,0,0,0,0,0,0,0,0,0,0,0,0
20200316,04136P,智邦元大93售09,0.24,0.30,0.24,0.30,-0.14,-31.82,21000,2,5100,0,0,0,0,0,0,21000,0,21000,21000
20200316,04137P,元油反國票97售01,0.05,0.05,0.05,0.05,0.00,0.00,1000,1,50,0,0,0,0,0,0,0,0,0,0
20200316,04138P,智邦國票93售02,,,,,0.00,0.00,0,0,0,0,0,0,0,0,0,0,0,0,0
20200316,04139P,大立光國票93售03,1.74,1.74,1.74,1.74,-0.36,-17.14,20000,1,34800,0,0,0,0,0,0,20000,0,20000,20000
20200316,04140P,聯茂國票93售03,,,,,0.00,0.00,0,0,0,0,0,0,0,0,0,0,0,0,0
20200316,04141P,啟碁國票93售01,2.91,2.91,2.91,2.91,-0.05,-1.69,10000,1,29100,0,0,0,0,0,0,10000,0,10000,10000
20200316,041427,滬深2X國票93購01,,,,,0.00,0.00,0,0,0,0,0,0,0,0,0,0,0,0,0
20200316,04142P,元油反凱基99售01,0.13,0.13,0.13,0.13,-0.02,-13.33,649000,33,84370,0,0,0,0,0,0,0,222000,-222000,-222000
20200316,04143P,鴻海凱基93售31,,,,,0.00,0.00,0,0,0,0,0,0,0,0,0,0,0,0,0
20200316,04144P,瑞昱凱基93售10,1.02,1.34,1.02,1.34,0.00,0.00,40000,4,50000,0,0,0,0,0,0,0,40000,-40000,-40000
20200316,041453,國巨元富93購03,,,,,0.00,0.00,0,0,0,0,0,0,0,0,0,0,0,0,0
20200316,041454,國巨元富93購04,,,,,0.00,0.00,0,0,0,0,0,0,0,0,0,0,0,0,0
20200316,041455,國巨元富93購05,,,,,0.00,0.00,0,0,0,0,0,0,0,0,0,0,0,0,0
20200316,04145P,聯發科凱基93售28,,,,,0.00,0.00,0,0,0,0,0,0,0,0,0,0,0,0,0
20200316,04146P,可成凱基93售14,,,,,0.00,0.00,0,0,0,0,0,0,0,0,0,0,0,0,0
20200316,04147P,大立光凱基93售30,,,,,0.00,0.00,0,0,0,0,0,0,0,0,0,0,0,0,0
20200316,04148P,GIS凱基93售05,2.39,2.39,2.39,2.39,0.00,0.00,10000,2,23900,0,0,0,0,0,0,10000,0,10000,10000
20200316,04149P,景碩台新93售02,,,,,0.00,0.00,0,0,0,0,0,0,0,0,0,0,0,0,0
20200316,04150P,燿華康和93售01,,,,,0.00,0.00,0,0,0,0,0,0,0,0,0,0,0,0,0
20200316,04151P,日電貿康和93售01,,,,,0.00,0.00,0,0,0,0,0,0,0,0,0,0,0,0,0
20200316,041527,T50反1中信96購01,2.26,2.52,2.26,2.49,+0.35,16.36,117000,5,283750,0,0,0,0,0,0,104000,10000,94000,94000
20200316,041528,國泰金中信93購01,,,,,0.00,0.00,0,0,0,0,0,0,0,0,0,0,0,0,0
20200316,04152P,喬山永豐93售02,,,,,0.00,0.00,0,0,0,0,0,0,0,0,0,0,0,0,0
20200316,041534,T50反1凱基96購01,0.65,0.81,0.65,0.81,+0.24,42.11,506000,16,386910,0,0,0,0,0,0,65000,0,65000,65000
20200316,04153P,旺宏永豐93售03,,,,,0.00,0.00,0,0,0,0,0,0,0,0,0,0,0,0,0
20200316,04154P,南亞科永豐93售02,,,,,0.00,0.00,0,0,0,0,0,0,0,0,0,0,0,0,0
20200316,04155P,全新永豐93售01,,,,,0.00,0.00,0,0,0,0,0,0,0,0,0,0,0,0,0
20200316,04156P,大立光永豐93售02,,,,,0.00,0.00,0,0,0,0,0,0,0,0,0,0,0,0,0
20200316,04157P,鎧勝永豐93售02,2.32,2.32,2.24,2.24,0.00,0.00,20000,3,45600,0,0,0,0,0,0,20000,0,20000,20000
20200316,04158P,南電永豐93售04,,,,,0.00,0.00,0,0,0,0,0,0,0,0,0,0,0,0,0
20200316,041596,S&P反1中信94購01,0.05,0.05,0.05,0.05,-0.06,-54.55,20000,2,1000,0,0,0,0,0,0,0,20000,-20000,-20000
20200316,04159P,滬深2X中信95售08,0.84,1.02,0.84,1.02,-0.07,-6.42,189000,7,177300,0,0,0,0,0,0,90000,99000,-9000,-9000
20200316,04160P,儒鴻中信93售01,2.43,2.51,2.38,2.38,+0.16,7.21,22000,3,54160,0,0,0,0,0,0,22000,0,22000,22000
20200316,04161P,全新國泰94售01,,,,,0.00,0.00,0,0,0,0,0,0,0,0,0,0,0,0,0
20200316,04162P,南亞科統一94售02,3.18,3.18,3.18,3.18,0.00,0.00,10000,1,31800,0,0,0,0,0,0,0,10000,-10000,-10000
20200316,04163P,可成統一93售03,,,,,0.00,0.00,0,0,0,0,0,0,0,0,0,0,0,0,0
20200316,04164P,滬深2X元富93售03,,,,,0.00,0.00,0,0,0,0,0,0,0,0,0,0,0,0,0
20200316,04165P,南亞科元富95售03,2.60,3.18,2.60,3.18,-0.03,-0.93,70000,9,205120,0,0,0,0,0,0,24000,46000,-22000,-22000
20200316,04166P,美利達元富93售03,,,,,0.00,0.00,0,0,0,0,0,0,0,0,0,0,0,0,0
20200316,04167P,滬深反凱基99售01,0.56,0.56,0.52,0.52,+0.03,6.12,510000,7,277600,0,0,0,0,0,0,0,510000,-510000,-510000
20200316,04168P,元金2X凱基99售01,0.61,0.66,0.55,0.59,+0.14,31.11,839000,23,495060,0,0,0,0,0,0,799000,0,799000,799000
20200316,04169P,鴻海凱基93售34,0.02,0.10,0.02,0.10,-0.02,-16.67,129000,4,3420,0,0,0,0,0,0,117000,10000,107000,107000
20200316,04170P,台積電凱基93售24,,,,,0.00,0.00,0,0,0,0,0,0,0,0,0,0,0,0,0
20200316,04171P,旺宏凱基93售07,,,,,0.00,0.00,0,0,0,0,0,0,0,0,0,0,0,0,0
20200316,04172P,大立光凱基93售34,1.08,1.68,1.08,1.68,+0.16,10.53,73000,9,110660,0,0,0,0,0,0,62000,61000,1000,1000
20200316,04173P,上海銀凱基93售02,1.21,1.35,1.21,1.35,0.00,0.00,20000,2,25600,0,0,0,0,0,0,10000,20000,-10000,-10000
20200316,04174P,上銀群益93售06,,,,,0.00,0.00,0,0,0,0,0,0,0,0,0,0,0,0,0
20200316,04175P,台積電群益94售05,0.10,0.13,0.10,0.13,0.00,0.00,300000,3,34000,0,0,0,0,0,0,200000,300000,-100000,-100000
20200316,04176P,台達電元大94售01,,,,,0.00,0.00,0,0,0,0,0,0,0,0,0,0,0,0,0
20200316,04177P,富邦金元大94售01,2.59,3.34,2.59,3.34,0.00,0.00,78000,9,231000,0,0,0,0,0,0,31000,47000,-16000,-16000
20200316,04178P,聯茂元大93售07,,,,,0.00,0.00,0,0,0,0,0,0,0,0,0,0,0,0,0
20200316,04179P,滬深2X國票93售03,,,,,0.00,0.00,0,0,0,0,0,0,0,0,0,0,0,0,0
20200316,04180P,華新科國票93售01,,,,,0.00,0.00,0,0,0,0,0,0,0,0,0,0,0,0,0
20200316,04181P,嘉晶國票93售04,,,,,0.00,0.00,0,0,0,0,0,0,0,0,0,0,0,0,0
20200316,041824,元油2X國票96購01,,,,,0.00,0.00,0,0,0,0,0,0,0,0,0,0,0,0,0
20200316,04182P,祥碩國票93售01,,,,,0.00,0.00,0,0,0,0,0,0,0,0,0,0,0,0,0
20200316,041832,T50反1統一94購01,0.10,0.23,0.10,0.20,+0.11,122.22,2249000,41,260710,0,0,0,0,0,0,0,40000,-40000,-40000
20200316,04183P,大成鋼統一93售03,,,,,0.00,0.00,0,0,0,0,0,0,0,0,0,0,0,0,0
20200316,04184P,台積電統一93售06,,,,,0.00,0.00,0,0,0,0,0,0,0,0,0,0,0,0,0
20200316,04185P,欣興統一93售05,,,,,0.00,0.00,0,0,0,0,0,0,0,0,0,0,0,0,0
20200316,04186P,創意元富93售04,,,,,0.00,0.00,0,0,0,0,0,0,0,0,0,0,0,0,0
20200316,041870,A50正2凱基96購01,0.27,0.29,0.22,0.23,-0.12,-34.29,85000,6,19970,0,0,0,0,0,0,35000,50000,-15000,-15000
20200316,04187P,麗豐元富93售02,1.28,1.28,1.28,1.28,-0.68,-34.69,10000,1,12800,0,0,0,0,0,0,10000,0,10000,10000
20200316,04188P,康控元富93售03,,,,,0.00,0.00,0,0,0,0,0,0,0,0,0,0,0,0,0
20200316,04189P,台積電兆豐94售02,0.14,0.39,0.13,0.39,+0.27,225.0,2118000,142,353880,0,0,0,0,0,0,122000,1948000,-1826000,-1826000
20200316,041900,元油2X富邦96購01,0.08,0.09,0.06,0.07,0.00,0.00,345000,12,26820,0,0,0,0,0,0,0,0,0,0
20200316,04190P,大立光兆豐94售03,,,,,0.00,0.00,0,0,0,0,0,0,0,0,0,0,0,0,0
20200316,04191P,儒鴻永豐93售02,,,,,0.00,0.00,0,0,0,0,0,0,0,0,0,0,0,0,0
20200316,04192P,漢唐永豐93售03,,,,,0.00,0.00,0,0,0,0,0,0,0,0,0,0,0,0,0
20200316,04193P,智原永豐93售01,2.17,2.17,2.17,2.17,0.00,0.00,20000,1,43400,0,0,0,0,0,0,20000,0,20000,20000
20200316,04194P,欣興永豐93售05,,,,,0.00,0.00,0,0,0,0,0,0,0,0,0,0,0,0,0
20200316,04195P,上海銀永豐93售01,,,,,0.00,0.00,0,0,0,0,0,0,0,0,0,0,0,0,0
20200316,04196P,東陽中信93售02,,,,,0.00,0.00,0,0,0,0,0,0,0,0,0,0,0,0,0
20200316,041973,台灣50中信94購01,0.05,0.05,0.02,0.02,-0.04,-66.67,90000,7,3400,0,0,0,0,0,0,0,0,0,0
20200316,04197P,台積電亞東94售01,,,,,0.00,0.00,0,0,0,0,0,0,0,0,0,0,0,0,0
20200316,04198P,滬深2X群益95售04,1.18,1.18,1.18,1.18,+0.24,25.53,5000,1,5900,0,0,0,0,0,0,5000,0,5000,5000
20200316,041990,A50正2國票97購01,,,,,0.00,0.00,0,0,0,0,0,0,0,0,0,0,0,0,0
20200316,041991,元油2X國票98購01,0.06,0.06,0.06,0.06,0.00,0.00,24000,15,1440,0,0,0,0,0,0,0,0,0,0
20200316,04199P,國巨群益93售05,,,,,0.00,0.00,0,0,0,0,0,0,0,0,0,0,0,0,0
20200316,04200P,奇力新群益93售07,,,,,0.00,0.00,0,0,0,0,0,0,0,0,0,0,0,0,0
20200316,04201P,智原群益93售01,,,,,0.00,0.00,0,0,0,0,0,0,0,0,0,0,0,0,0
20200316,04202P,華新科元大93售10,,,,,0.00,0.00,0,0,0,0,0,0,0,0,0,0,0,0,0
20200316,04203P,超眾元大93售04,,,,,0.00,0.00,0,0,0,0,0,0,0,0,0,0,0,0,0
20200316,04204P,臺股指元大93售44,1.60,2.97,1.60,2.97,+1.26,73.68,49000,8,128000,0,0,0,0,0,0,36000,13000,23000,23000
20200316,04205P,臺股指元大93售45,2.00,2.00,2.00,2.00,-1.20,-37.5,10000,1,20000,0,0,0,0,0,0,10000,10000,0,0
20200316,04206P,臺股指元大93售46,3.11,3.22,2.98,3.17,-1.83,-36.6,120000,12,368900,0,0,0,0,0,0,120000,120000,0,0
20200316,04207P,臺股指元大93售47,,,,,0.00,0.00,0,0,0,0,0,0,0,0,0,0,0,0,0
20200316,042089,台灣50中信94購03,0.08,0.08,0.08,0.08,0.00,0.00,10000,1,800,0,0,0,0,0,0,0,10000,-10000,-10000
20200316,04208P,臺股指元大93售48,4.38,4.50,4.38,4.50,-0.15,-3.23,200000,2,888000,0,0,0,0,0,0,200000,0,200000,200000
20200316,042093,台灣50群益94購02,0.12,0.12,0.12,0.12,0.00,0.00,10000,1,1200,0,0,0,0,0,0,0,0,0,0
20200316,04209P,臺股指日盛93售01,,,,,0.00,0.00,0,0,0,0,0,0,0,0,0,0,0,0,0
20200316,04210P,鴻海凱基93售36,0.27,0.28,0.27,0.28,-0.53,-65.43,20000,3,5500,0,0,0,0,0,0,20000,10000,10000,10000
20200316,042116,元油2X國票97購01,0.04,0.05,0.04,0.05,0.00,0.00,15000,6,650,0,0,0,0,0,0,0,0,0,0
20200316,04211P,台積電凱基93售25,,,,,0.00,0.00,0,0,0,0,0,0,0,0,0,0,0,0,0
20200316,04212P,微星凱基93售03,,,,,0.00,0.00,0,0,0,0,0,0,0,0,0,0,0,0,0
20200316,04213P,台光電凱基93售11,,,,,0.00,0.00,0,0,0,0,0,0,0,0,0,0,0,0,0
20200316,04214P,美利達凱基93售04,,,,,0.00,0.00,0,0,0,0,0,0,0,0,0,0,0,0,0
20200316,04215P,鴻海國票93售02,0.01,0.05,0.01,0.05,0.00,0.00,237000,9,6770,0,0,0,0,0,0,65000,0,65000,65000
20200316,042168,台灣50凱基96購01,0.70,1.00,0.43,0.45,-0.67,-59.82,1046000,104,649300,0,0,0,0,0,0,278000,563000,-285000,-285000
20200316,04216P,燿華國票93售02,,,,,0.00,0.00,0,0,0,0,0,0,0,0,0,0,0,0,0
20200316,04217P,漢唐國票93售01,,,,,0.00,0.00,0,0,0,0,0,0,0,0,0,0,0,0,0
20200316,04218P,正文國票93售03,,,,,0.00,0.00,0,0,0,0,0,0,0,0,0,0,0,0,0
20200316,04219P,鴻海兆豐93售02,0.11,0.11,0.11,0.11,+0.02,22.22,10000,1,1100,0,0,0,0,0,0,10000,0,10000,10000
20200316,04220P,聯發科兆豐93售04,,,,,0.00,0.00,0,0,0,0,0,0,0,0,0,0,0,0,0
20200316,04221P,大立光兆豐93售05,,,,,0.00,0.00,0,0,0,0,0,0,0,0,0,0,0,0,0
20200316,042227,元油2X永豐93購01,,,,,0.00,0.00,0,0,0,0,0,0,0,0,0,0,0,0,0
20200316,04222P,台積電統一93售08,,,,,0.00,0.00,0,0,0,0,0,0,0,0,0,0,0,0,0
20200316,042237,鴻海永昌93購01,,,,,0.00,0.00,0,0,0,0,0,0,0,0,0,0,0,0,0
20200316,042238,台積電永昌93購01,,,,,0.00,0.00,0,0,0,0,0,0,0,0,0,0,0,0,0
20200316,042239,大立光永昌93購01,,,,,0.00,0.00,0,0,0,0,0,0,0,0,0,0,0,0,0
20200316,04223P,友達統一93售05,,,,,0.00,0.00,0,0,0,0,0,0,0,0,0,0,0,0,0
20200316,04224P,群創統一93售05,,,,,0.00,0.00,0,0,0,0,0,0,0,0,0,0,0,0,0
20200316,04225P,台積電元富94售02,0.20,0.20,0.20,0.20,+0.05,33.33,10000,2,2000,0,0,0,0,0,0,0,0,0,0
20200316,04226P,宏達電元富93售01,,,,,0.00,0.00,0,0,0,0,0,0,0,0,0,0,0,0,0
20200316,04227P,滬深2X永豐94售04,,,,,0.00,0.00,0,0,0,0,0,0,0,0,0,0,0,0,0
20200316,042280,元石油富邦96購01,0.03,0.08,0.03,0.04,0.00,0.00,303000,30,15210,0,0,0,0,0,0,0,0,0,0
20200316,042281,元油2X富邦96購02,,,,,0.00,0.00,0,0,0,0,0,0,0,0,0,0,0,0,0
20200316,042287,台灣50元大93購10,0.01,0.01,0.01,0.01,-0.34,-97.14,10000,1,100,0,0,0,0,0,0,0,0,0,0
20200316,042288,元油2X元大93購03,,,,,0.00,0.00,0,0,0,0,0,0,0,0,0,0,0,0,0
20200316,04228P,貿聯永豐93售03,,,,,0.00,0.00,0,0,0,0,0,0,0,0,0,0,0,0,0
20200316,04229P,臺股指中信95售05,0.35,0.70,0.35,0.70,+0.39,125.81,80000,4,45500,0,0,0,0,0,0,0,0,0,0
20200316,04230P,臺股指中信95售06,1.70,1.70,1.70,1.70,+0.49,40.5,3000,1,5100,0,0,0,0,0,0,3000,0,3000,3000
20200316,042315,T50反1台新96購01,0.43,0.74,0.30,0.63,+0.24,61.54,169000,21,72330,0,0,0,0,0,0,33000,0,33000,33000
20200316,042317,台灣50永豐96購01,0.41,0.41,0.24,0.26,-0.15,-36.59,429000,79,119170,0,0,0,0,0,0,10000,414000,-404000,-404000
20200316,04231P,聯發科亞東93售03,,,,,0.00,0.00,0,0,0,0,0,0,0,0,0,0,0,0,0
20200316,042326,元油2X國票94購01,,,,,0.00,0.00,0,0,0,0,0,0,0,0,0,0,0,0,0
20200316,04232P,可成亞東93售02,,,,,0.00,0.00,0,0,0,0,0,0,0,0,0,0,0,0,0
20200316,04233P,儒鴻兆豐93售01,,,,,0.00,0.00,0,0,0,0,0,0,0,0,0,0,0,0,0
20200316,04234P,華通群益94售02,,,,,0.00,0.00,0,0,0,0,0,0,0,0,0,0,0,0,0
20200316,04235P,鴻海群益93售08,1.42,1.42,1.42,1.42,0.00,0.00,10000,1,14200,0,0,0,0,0,0,0,10000,-10000,-10000
20200316,04236P,華新科群益93售03,,,,,0.00,0.00,0,0,0,0,0,0,0,0,0,0,0,0,0
20200316,042379,T50反1群益93購03,0.11,0.11,0.11,0.11,-0.09,-45.0,3000,1,330,0,0,0,0,0,0,0,3000,-3000,-3000
20200316,04237P,超眾群益93售02,,,,,0.00,0.00,0,0,0,0,0,0,0,0,0,0,0,0,0
20200316,042387,台積電永昌93購02,0.11,0.11,0.11,0.11,-0.01,-8.33,20000,2,2200,0,0,0,0,0,0,0,20000,-20000,-20000
20200316,042388,大立光永昌93購02,0.01,0.01,0.01,0.01,0.00,0.00,60000,1,600,0,0,0,0,0,0,60000,0,60000,60000
20200316,04238P,滬深2X日盛93售01,,,,,0.00,0.00,0,0,0,0,0,0,0,0,0,0,0,0,0
20200316,04239P,上銀凱基93售08,,,,,0.00,0.00,0,0,0,0,0,0,0,0,0,0,0,0,0
20200316,04240P,台積電凱基93售27,,,,,0.00,0.00,0,0,0,0,0,0,0,0,0,0,0,0,0
20200316,04241P,欣興國泰95售02,,,,,0.00,0.00,0,0,0,0,0,0,0,0,0,0,0,0,0
20200316,04242P,台積電永昌93售08,,,,,0.00,0.00,0,0,0,0,0,0,0,0,0,0,0,0,0
20200316,042433,元油2X永豐96購01,,,,,0.00,0.00,0,0,0,0,0,0,0,0,0,0,0,0,0
20200316,04243P,大立光永昌93售08,,,,,0.00,0.00,0,0,0,0,0,0,0,0,0,0,0,0,0
20200316,04244P,可成元大93售12,,,,,0.00,0.00,0,0,0,0,0,0,0,0,0,0,0,0,0
20200316,04245P,上海銀元大93售03,,,,,0.00,0.00,0,0,0,0,0,0,0,0,0,0,0,0,0
20200316,04246P,義隆永豐93售03,,,,,0.00,0.00,0,0,0,0,0,0,0,0,0,0,0,0,0
20200316,042470,元油2X元大93購04,,,,,0.00,0.00,0,0,0,0,0,0,0,0,0,0,0,0,0
20200316,04247P,宏達電永豐93售02,,,,,0.00,0.00,0,0,0,0,0,0,0,0,0,0,0,0,0
20200316,04248P,臺股指永豐93售03,,,,,0.00,0.00,0,0,0,0,0,0,0,0,0,0,0,0,0
20200316,04249P,大立光統一94售04,1.60,1.60,1.60,1.60,-0.26,-13.98,20000,1,32000,0,0,0,0,0,0,0,0,0,0
20200316,042501,台灣50凱基96購06,1.51,1.66,0.93,0.96,-0.92,-48.94,1146000,137,1459050,0,0,0,0,0,0,708000,1060000,-352000,-352000
20200316,042502,上銀凱基93購01,,,,,0.00,0.00,0,0,0,0,0,0,0,0,0,0,0,0,0
20200316,04250P,嘉晶統一95售02,0.75,0.95,0.75,0.95,0.00,0.00,1072000,111,945030,0,0,0,0,0,0,17000,1055000,-1038000,-1038000
20200316,042516,健策凱基93購01,,,,,0.00,0.00,0,0,0,0,0,0,0,0,0,0,0,0,0
20200316,04251P,欣興統一93售06,,,,,0.00,0.00,0,0,0,0,0,0,0,0,0,0,0,0,0
20200316,042527,台灣50永豐94購01,,,,,0.00,0.00,0,0,0,0,0,0,0,0,0,0,0,0,0
20200316,04252P,台達電元富93售02,,,,,0.00,0.00,0,0,0,0,0,0,0,0,0,0,0,0,0
20200316,04253P,聯發科元富93售01,,,,,0.00,0.00,0,0,0,0,0,0,0,0,0,0,0,0,0
20200316,042542,台灣50元大93購14,,,,,0.00,0.00,0,0,0,0,0,0,0,0,0,0,0,0,0
20200316,04254P,亞德客國票93售03,,,,,0.00,0.00,0,0,0,0,0,0,0,0,0,0,0,0,0
20200316,042556,台灣50中信96購04,,,,,0.00,0.00,0,0,0,0,0,0,0,0,0,0,0,0,0
20200316,042558,瑞昱中信94購01,,,,,0.00,0.00,0,0,0,0,0,0,0,0,0,0,0,0,0
20200316,04255P,台積電國票94售03,,,,,0.00,0.00,0,0,0,0,0,0,0,0,0,0,0,0,0
20200316,04256P,美律國票93售03,,,,,0.00,0.00,0,0,0,0,0,0,0,0,0,0,0,0,0
20200316,04257P,景碩國票93售01,,,,,0.00,0.00,0,0,0,0,0,0,0,0,0,0,0,0,0
20200316,04258P,健策國票94售01,,,,,0.00,0.00,0,0,0,0,0,0,0,0,0,0,0,0,0
20200316,04259P,滬深2X群益93售03,,,,,0.00,0.00,0,0,0,0,0,0,0,0,0,0,0,0,0
20200316,04260P,亞德客群益93售01,,,,,0.00,0.00,0,0,0,0,0,0,0,0,0,0,0,0,0
20200316,04261P,大立光群益93售12,,,,,0.00,0.00,0,0,0,0,0,0,0,0,0,0,0,0,0
20200316,04262P,景碩群益93售03,,,,,0.00,0.00,0,0,0,0,0,0,0,0,0,0,0,0,0
20200316,04263P,南電群益93售03,,,,,0.00,0.00,0,0,0,0,0,0,0,0,0,0,0,0,0
20200316,04264P,宏碁統一93售01,,,,,0.00,0.00,0,0,0,0,0,0,0,0,0,0,0,0,0
20200316,04265P,滬深2X元富93售04,,,,,0.00,0.00,0,0,0,0,0,0,0,0,0,0,0,0,0
20200316,04266P,華新科元富93售02,,,,,0.00,0.00,0,0,0,0,0,0,0,0,0,0,0,0,0
20200316,042676,臺指反元大93購01,0.53,0.53,0.49,0.49,-0.25,-33.78,30000,3,15500,0,0,0,0,0,0,0,30000,-30000,-30000
20200316,04267P,康控元富93售04,3.18,3.18,3.18,3.18,-0.26,-7.56,30000,2,95400,0,0,0,0,0,0,30000,0,30000,30000
20200316,04268P,南電元富93售03,,,,,0.00,0.00,0,0,0,0,0,0,0,0,0,0,0,0,0
20200316,042692,台灣50凱基96購09,2.51,2.87,1.74,1.89,-1.23,-39.42,441000,61,992130,0,0,0,0,0,0,155000,212000,-57000,-57000
20200316,04269P,華通國票93售03,,,,,0.00,0.00,0,0,0,0,0,0,0,0,0,0,0,0,0
20200316,042705,台積電亞東93購01,,,,,0.00,0.00,0,0,0,0,0,0,0,0,0,0,0,0,0
20200316,04270P,台光電國票93售03,,,,,0.00,0.00,0,0,0,0,0,0,0,0,0,0,0,0,0
20200316,042711,台灣50國票93購01,,,,,0.00,0.00,0,0,0,0,0,0,0,0,0,0,0,0,0
20200316,042712,元石油國票95購01,,,,,0.00,0.00,0,0,0,0,0,0,0,0,0,0,0,0,0
20200316,042719,臺指反群益93購01,0.36,0.46,0.36,0.46,+0.11,31.43,122000,13,46420,0,0,0,0,0,0,30000,80000,-50000,-50000
20200316,04271P,南亞科國票93售03,,,,,0.00,0.00,0,0,0,0,0,0,0,0,0,0,0,0,0
20200316,042724,群創群益93購01,,,,,0.00,0.00,0,0,0,0,0,0,0,0,0,0,0,0,0
20200316,04272P,元上證凱基94售01,0.25,0.28,0.25,0.28,-0.01,-3.45,111000,8,30770,0,0,0,0,0,0,11000,100000,-89000,-89000
20200316,04273P,上証反凱基99售01,0.51,0.51,0.42,0.42,0.00,0.00,15000,3,6870,0,0,0,0,0,0,0,15000,-15000,-15000
20200316,04274P,滬深2X凱基94售01,1.08,1.08,1.08,1.08,-0.09,-7.69,1000,1,1080,0,0,0,0,0,0,1000,0,1000,1000
20200316,042752,台灣50元大96購03,1.20,1.23,0.90,1.08,-0.27,-20.0,1015000,135,1015870,0,0,0,0,0,0,125000,0,125000,125000
20200316,042754,元黃金元大93購01,0.10,0.12,0.10,0.12,-0.06,-33.33,8000,3,860,0,0,0,0,0,0,8000,0,8000,8000
20200316,04275P,南亞科凱基93售08,,,,,0.00,0.00,0,0,0,0,0,0,0,0,0,0,0,0,0
20200316,04276P,聯發科凱基93售33,,,,,0.00,0.00,0,0,0,0,0,0,0,0,0,0,0,0,0
20200316,04277P,奇力新凱基93售05,,,,,0.00,0.00,0,0,0,0,0,0,0,0,0,0,0,0,0
20200316,04278P,大立光凱基93售38,0.59,0.99,0.59,0.99,0.00,0.00,20000,2,15800,0,0,0,0,0,0,10000,20000,-10000,-10000
20200316,042792,T50反1台新9C購01,1.18,1.55,1.18,1.55,+0.22,16.54,562000,22,790250,0,0,0,0,0,0,400000,0,400000,400000
20200316,042793,台積電台新9C購01,9.55,10.50,8.30,8.80,-0.75,-7.85,152000,41,1473200,0,0,0,0,0,0,66000,64000,2000,2000
20200316,042796,永冠元大93購01,,,,,0.00,0.00,0,0,0,0,0,0,0,0,0,0,0,0,0
20200316,04279P,超眾凱基93售07,0.34,0.34,0.34,0.34,0.00,0.00,10000,1,3400,0,0,0,0,0,0,0,10000,-10000,-10000
20200316,042801,達邁元大93購01,,,,,0.00,0.00,0,0,0,0,0,0,0,0,0,0,0,0,0
20200316,042803,天鈺元大93購01,,,,,0.00,0.00,0,0,0,0,0,0,0,0,0,0,0,0,0
20200316,04280P,宏達電台新93售01,,,,,0.00,0.00,0,0,0,0,0,0,0,0,0,0,0,0,0
20200316,04281P,旺宏永豐93售05,,,,,0.00,0.00,0,0,0,0,0,0,0,0,0,0,0,0,0
20200316,04282P,微星永豐93售02,,,,,0.00,0.00,0,0,0,0,0,0,0,0,0,0,0,0,0
20200316,04283P,麗豐永豐93售03,,,,,0.00,0.00,0,0,0,0,0,0,0,0,0,0,0,0,0
20200316,04284P,瀚宇博永豐93售01,,,,,0.00,0.00,0,0,0,0,0,0,0,0,0,0,0,0,0
20200316,04285P,超眾永豐93售04,0.71,0.71,0.71,0.71,+0.06,9.23,10000,1,7100,0,0,0,0,0,0,10000,0,10000,10000
20200316,04286P,滬深2X中信96售01,0.70,0.81,0.70,0.80,+0.10,14.29,347000,15,275660,0,0,0,0,0,0,10000,317000,-307000,-307000
20200316,04287P,A50正2中信96售01,0.70,0.81,0.70,0.81,+0.06,8.0,95000,7,68820,0,0,0,0,0,0,70000,25000,45000,45000
20200316,04288P,台積電中信95售06,0.30,0.33,0.30,0.33,-0.01,-2.94,13000,2,4200,0,0,0,0,0,0,10000,0,10000,10000
20200316,04289P,臺股指中信95售07,1.69,1.80,1.37,1.80,+0.10,5.88,39000,14,61750,0,0,0,0,0,0,13000,0,13000,13000
20200316,042901,中纖元大94購01,,,,,0.00,0.00,0,0,0,0,0,0,0,0,0,0,0,0,0
20200316,042902,光寶科元大94購01,,,,,0.00,0.00,0,0,0,0,0,0,0,0,0,0,0,0,0
20200316,042903,金寶元大94購01,0.13,0.13,0.05,0.05,-0.03,-37.5,110000,11,8200,0,0,0,0,0,0,10000,100000,-90000,-90000
20200316,042904,金寶元大94購02,0.31,0.31,0.31,0.31,+0.01,3.33,10000,1,3100,0,0,0,0,0,0,0,10000,-10000,-10000
20200316,042909,順德元大94購01,,,,,0.00,0.00,0,0,0,0,0,0,0,0,0,0,0,0,0
20200316,04290P,滬深2X富邦96售03,2.85,2.85,2.85,2.85,+0.49,20.76,20000,2,57000,0,0,0,0,0,0,0,20000,-20000,-20000
20200316,042912,凌陽元大94購01,,,,,0.00,0.00,0,0,0,0,0,0,0,0,0,0,0,0,0
20200316,042916,佐登元大94購01,,,,,0.00,0.00,0,0,0,0,0,0,0,0,0,0,0,0,0
20200316,042918,矽格元大94購01,0.85,0.88,0.79,0.81,+0.01,1.25,119000,7,96810,0,0,0,0,0,0,109000,10000,99000,99000
20200316,04291P,鴻海富邦93售04,,,,,0.00,0.00,0,0,0,0,0,0,0,0,0,0,0,0,0
20200316,042927,道瓊反中信94購01,1.48,1.48,1.48,1.48,+0.17,12.98,10000,1,14800,0,0,0,0,0,0,0,10000,-10000,-10000
20200316,042928,台積電中信95購01,2.20,2.34,1.41,1.41,-0.84,-37.33,39000,8,67090,0,0,0,0,0,0,11000,28000,-17000,-17000
20200316,042929,台積電中信95購02,1.59,1.72,0.92,0.92,-0.95,-50.8,579000,91,732570,0,0,0,0,0,0,80000,437000,-357000,-357000
20200316,04292P,台積電富邦93售04,,,,,0.00,0.00,0,0,0,0,0,0,0,0,0,0,0,0,0
20200316,042930,大立光中信94購01,,,,,0.00,0.00,0,0,0,0,0,0,0,0,0,0,0,0,0
20200316,042931,啟碁中信95購01,,,,,0.00,0.00,0,0,0,0,0,0,0,0,0,0,0,0,0
20200316,04293P,滬深2X元大96售02,2.07,2.07,1.98,1.98,-0.18,-8.33,15000,2,30600,0,0,0,0,0,0,5000,10000,-5000,-5000
20200316,042942,永冠國票94購01,,,,,0.00,0.00,0,0,0,0,0,0,0,0,0,0,0,0,0
20200316,04294P,台積電元大95售01,0.38,0.60,0.34,0.55,+0.21,61.76,585000,53,269730,0,0,0,0,0,0,209000,356000,-147000,-147000
20200316,042953,鴻海台新01購01,1.88,1.99,1.41,1.48,-0.48,-24.49,1045000,94,1659430,0,0,0,0,0,0,446000,790000,-344000,-344000
20200316,04295P,智邦元大93售10,,,,,0.00,0.00,0,0,0,0,0,0,0,0,0,0,0,0,0
20200316,04296P,技嘉元大93售01,,,,,0.00,0.00,0,0,0,0,0,0,0,0,0,0,0,0,0
20200316,04297P,微星元大93售03,1.22,1.22,1.22,1.22,-0.19,-13.48,10000,1,12200,0,0,0,0,0,0,0,10000,-10000,-10000
20200316,04298P,祥碩元大93售02,,,,,0.00,0.00,0,0,0,0,0,0,0,0,0,0,0,0,0
20200316,042993,葡萄王元大94購01,0.12,0.20,0.11,0.14,+0.06,75.0,197000,10,25650,0,0,0,0,0,0,157000,40000,117000,117000
20200316,042994,葡萄王元大94購02,0.63,0.84,0.56,0.59,+0.03,5.36,481000,57,311460,0,0,0,0,0,0,309000,170000,139000,139000
20200316,042997,新光鋼元大94購01,,,,,0.00,0.00,0,0,0,0,0,0,0,0,0,0,0,0,0
20200316,04299P,卜蜂中信93售02,,,,,0.00,0.00,0,0,0,0,0,0,0,0,0,0,0,0,0
20200316,04300P,華通中信93售02,,,,,0.00,0.00,0,0,0,0,0,0,0,0,0,0,0,0,0
20200316,043019,華晶科元大94購01,,,,,0.00,0.00,0,0,0,0,0,0,0,0,0,0,0,0,0
20200316,04301P,微星中信93售01,,,,,0.00,0.00,0,0,0,0,0,0,0,0,0,0,0,0,0
20200316,043023,康普元大94購01,,,,,0.00,0.00,0,0,0,0,0,0,0,0,0,0,0,0,0
20200316,04302P,和碩中信93售01,0.03,0.03,0.03,0.03,-0.03,-50.0,5000,1,150,0,0,0,0,0,0,5000,0,5000,5000
20200316,04303P,義隆群益93售02,,,,,0.00,0.00,0,0,0,0,0,0,0,0,0,0,0,0,0
20200316,043040,永冠元富94購01,,,,,0.00,0.00,0,0,0,0,0,0,0,0,0,0,0,0,0
20200316,04304P,上海銀亞東93售01,,,,,0.00,0.00,0,0,0,0,0,0,0,0,0,0,0,0,0
20200316,04305P,A50反1凱基93售02,,,,,0.00,0.00,0,0,0,0,0,0,0,0,0,0,0,0,0
20200316,04306P,上銀凱基93售10,1.65,1.65,1.51,1.56,+0.43,38.05,12000,12,19160,0,0,0,0,0,0,12000,0,12000,12000
20200316,04307P,國巨凱基93售09,,,,,0.00,0.00,0,0,0,0,0,0,0,0,0,0,0,0,0
20200316,04308P,京元電凱基93售06,2.54,2.91,2.54,2.91,-0.79,-21.35,26000,3,72240,0,0,0,0,0,0,0,26000,-26000,-26000
20200316,04309P,滬深2X統一93售05,,,,,0.00,0.00,0,0,0,0,0,0,0,0,0,0,0,0,0
20200316,04310P,京元電統一93售03,,,,,0.00,0.00,0,0,0,0,0,0,0,0,0,0,0,0,0
20200316,04311P,奇力新統一95售01,,,,,0.00,0.00,0,0,0,0,0,0,0,0,0,0,0,0,0
20200316,04312P,聯茂統一93售02,,,,,0.00,0.00,0,0,0,0,0,0,0,0,0,0,0,0,0
20200316,04313P,國巨元富95售03,0.25,0.44,0.25,0.44,+0.12,37.5,90000,8,31570,0,0,0,0,0,0,83000,0,83000,83000
20200316,04314P,聯茂元富93售01,0.67,0.67,0.67,0.67,-0.51,-43.22,60000,1,40200,0,0,0,0,0,0,60000,0,60000,60000
20200316,043156,大立光統一94購01,0.02,0.02,0.02,0.02,-0.09,-81.82,10000,1,200,0,0,0,0,0,0,10000,0,10000,10000
20200316,04315P,台光電國票93售04,,,,,0.00,0.00,0,0,0,0,0,0,0,0,0,0,0,0,0
20200316,04316P,華新科國票94售05,,,,,0.00,0.00,0,0,0,0,0,0,0,0,0,0,0,0,0
20200316,04317P,樺漢國票93售03,,,,,0.00,0.00,0,0,0,0,0,0,0,0,0,0,0,0,0
20200316,04318P,大成鋼永豐93售02,,,,,0.00,0.00,0,0,0,0,0,0,0,0,0,0,0,0,0
20200316,04319P,健策永豐93售03,,,,,0.00,0.00,0,0,0,0,0,0,0,0,0,0,0,0,0
20200316,043202,緯穎元大94購01,,,,,0.00,0.00,0,0,0,0,0,0,0,0,0,0,0,0,0
20200316,04320P,亞德客元大93售07,,,,,0.00,0.00,0,0,0,0,0,0,0,0,0,0,0,0,0
20200316,04321P,國巨元大93售12,,,,,0.00,0.00,0,0,0,0,0,0,0,0,0,0,0,0,0
20200316,04322P,可成元大94售01,3.67,3.74,3.56,3.56,0.00,0.00,30000,5,110360,0,0,0,0,0,0,14000,16000,-2000,-2000
20200316,043231,鴻海中信95購01,,,,,0.00,0.00,0,0,0,0,0,0,0,0,0,0,0,0,0
20200316,04323P,強茂元大93售02,,,,,0.00,0.00,0,0,0,0,0,0,0,0,0,0,0,0,0
20200316,04324P,新光金元大94售01,,,,,0.00,0.00,0,0,0,0,0,0,0,0,0,0,0,0,0
20200316,04325P,創意元大93售06,,,,,0.00,0.00,0,0,0,0,0,0,0,0,0,0,0,0,0
20200316,04326P,泰鼎元大93售06,,,,,0.00,0.00,0,0,0,0,0,0,0,0,0,0,0,0,0
20200316,043272,羅麗芬國泰94購01,,,,,0.00,0.00,0,0,0,0,0,0,0,0,0,0,0,0,0
20200316,04327P,台積電國泰95售01,1.09,1.71,1.06,1.57,+0.84,115.07,244000,28,320620,0,0,0,0,0,0,150000,234000,-84000,-84000
20200316,04328P,台達電中信93售02,,,,,0.00,0.00,0,0,0,0,0,0,0,0,0,0,0,0,0
20200316,043290,揚明光元大94購01,,,,,0.00,0.00,0,0,0,0,0,0,0,0,0,0,0,0,0
20200316,04329P,TPK群益93售04,,,,,0.00,0.00,0,0,0,0,0,0,0,0,0,0,0,0,0
20200316,04330P,台達電亞東93售02,,,,,0.00,0.00,0,0,0,0,0,0,0,0,0,0,0,0,0
20200316,04331P,健策國票93售02,0.05,0.05,0.05,0.05,0.00,0.00,20000,1,1000,0,0,0,0,0,0,20000,0,20000,20000
20200316,04332P,A50正2日盛93售01,,,,,0.00,0.00,0,0,0,0,0,0,0,0,0,0,0,0,0
20200316,04333P,儒鴻凱基93售06,,,,,0.00,0.00,0,0,0,0,0,0,0,0,0,0,0,0,0
20200316,04334P,中石化康和93售01,,,,,0.00,0.00,0,0,0,0,0,0,0,0,0,0,0,0,0
20200316,04335P,大成鋼元大93售01,1.81,1.81,1.75,1.75,+0.01,0.57,26000,4,46220,0,0,0,0,0,0,26000,0,26000,26000
20200316,04336P,台達電元大93售04,,,,,0.00,0.00,0,0,0,0,0,0,0,0,0,0,0,0,0
20200316,04337P,台積電元大93售25,0.25,0.52,0.25,0.49,+0.32,188.24,43000,6,12040,0,0,0,0,0,0,32000,11000,21000,21000
20200316,04338P,亞光元大93售04,1.34,1.34,1.34,1.34,-0.53,-28.34,60000,1,80400,0,0,0,0,0,0,60000,0,60000,60000
20200316,043391,康控元大94購01,,,,,0.00,0.00,0,0,0,0,0,0,0,0,0,0,0,0,0
20200316,043394,易華電元大94購01,,,,,0.00,0.00,0,0,0,0,0,0,0,0,0,0,0,0,0
20200316,04339P,欣興元大93售08,,,,,0.00,0.00,0,0,0,0,0,0,0,0,0,0,0,0,0
20200316,04340P,易華電元大94售02,,,,,0.00,0.00,0,0,0,0,0,0,0,0,0,0,0,0,0
20200316,04341P,美律永豐93售03,,,,,0.00,0.00,0,0,0,0,0,0,0,0,0,0,0,0,0
20200316,04342P,揚明光永豐93售03,1.36,1.41,1.36,1.41,0.00,0.00,13000,3,18050,0,0,0,0,0,0,0,13000,-13000,-13000
20200316,04343P,啟碁永豐93售02,,,,,0.00,0.00,0,0,0,0,0,0,0,0,0,0,0,0,0
20200316,043442,大立光台新01購01,2.27,2.27,1.64,1.68,-0.63,-27.27,293000,33,564320,0,0,0,0,0,0,69000,216000,-147000,-147000
20200316,04344P,台達電國泰94售01,,,,,0.00,0.00,0,0,0,0,0,0,0,0,0,0,0,0,0
20200316,04345P,景碩國泰94售02,0.81,1.06,0.81,1.01,+0.04,4.12,82000,11,70700,0,0,0,0,0,0,8000,22000,-14000,-14000
20200316,04346P,大立光兆豐95售02,0.57,0.73,0.53,0.73,+0.18,32.73,16000,4,9200,0,0,0,0,0,0,13000,3000,10000,10000
20200316,04347P,全新群益94售01,,,,,0.00,0.00,0,0,0,0,0,0,0,0,0,0,0,0,0
20200316,04348P,燿華國票94售01,,,,,0.00,0.00,0,0,0,0,0,0,0,0,0,0,0,0,0
20200316,04349P,美律國票94售02,,,,,0.00,0.00,0,0,0,0,0,0,0,0,0,0,0,0,0
20200316,04350P,欣興國票94售01,,,,,0.00,0.00,0,0,0,0,0,0,0,0,0,0,0,0,0
20200316,043513,台灣50元大96購05,0.63,0.63,0.50,0.60,-0.09,-13.04,667000,66,361520,0,0,0,0,0,0,189000,471000,-282000,-282000
20200316,04351P,鴻海永豐94售01,,,,,0.00,0.00,0,0,0,0,0,0,0,0,0,0,0,0,0
20200316,04352P,國巨永豐94售01,,,,,0.00,0.00,0,0,0,0,0,0,0,0,0,0,0,0,0
20200316,043538,元石油國票97購01,0.03,0.04,0.02,0.04,+0.01,33.33,420000,10,12520,0,0,0,0,0,0,0,0,0,0
20200316,04353P,全新永豐94售01,,,,,0.00,0.00,0,0,0,0,0,0,0,0,0,0,0,0,0
20200316,04354P,華新科永豐94售01,0.11,0.21,0.10,0.21,0.00,0.00,273000,30,29080,0,0,0,0,0,0,0,273000,-273000,-273000
20200316,04355P,大立光永豐94售02,,,,,0.00,0.00,0,0,0,0,0,0,0,0,0,0,0,0,0
20200316,04356P,嘉晶永豐94售01,,,,,0.00,0.00,0,0,0,0,0,0,0,0,0,0,0,0,0
20200316,04357P,智易永豐94售01,,,,,0.00,0.00,0,0,0,0,0,0,0,0,0,0,0,0,0
20200316,043580,大立光元富94購01,0.11,0.11,0.11,0.11,+0.03,37.5,10000,1,1100,0,0,0,0,0,0,10000,0,10000,10000
20200316,043585,道瓊反元大94購01,0.44,0.54,0.44,0.52,+0.08,18.18,204000,30,105200,0,0,0,0,0,0,0,164000,-164000,-164000
20200316,04358P,TPK永豐94售01,,,,,0.00,0.00,0,0,0,0,0,0,0,0,0,0,0,0,0
20200316,04359P,中磊永豐94售01,,,,,0.00,0.00,0,0,0,0,0,0,0,0,0,0,0,0,0
20200316,04360P,易華電永豐94售01,,,,,0.00,0.00,0,0,0,0,0,0,0,0,0,0,0,0,0
20200316,04361P,台積電統一94售05,,,,,0.00,0.00,0,0,0,0,0,0,0,0,0,0,0,0,0
20200316,04362P,聯詠統一94售01,,,,,0.00,0.00,0,0,0,0,0,0,0,0,0,0,0,0,0
20200316,04363P,儒鴻元富94售01,,,,,0.00,0.00,0,0,0,0,0,0,0,0,0,0,0,0,0
20200316,043641,深中小國票94購01,0.36,0.36,0.36,0.36,0.00,0.00,20000,1,7200,0,0,0,0,0,0,20000,0,20000,20000
20200316,043642,元金2X國票97購01,0.75,0.83,0.72,0.78,-0.27,-25.71,416000,7,327380,0,0,0,0,0,0,416000,99000,317000,317000
20200316,04364P,台積電元富94售03,,,,,0.00,0.00,0,0,0,0,0,0,0,0,0,0,0,0,0
20200316,043656,上証反元大94購01,0.10,0.15,0.10,0.15,+0.04,36.36,112000,3,11780,0,0,0,0,0,0,112000,0,112000,112000
20200316,04365P,台積電元富95售02,,,,,0.00,0.00,0,0,0,0,0,0,0,0,0,0,0,0,0
20200316,04366P,全新元富95售01,1.68,1.68,1.68,1.68,-0.52,-23.64,32000,1,53760,0,0,0,0,0,0,32000,0,32000,32000
20200316,04367P,滬深2X凱基95售04,,,,,0.00,0.00,0,0,0,0,0,0,0,0,0,0,0,0,0
20200316,04368P,台積電凱基94售02,,,,,0.00,0.00,0,0,0,0,0,0,0,0,0,0,0,0,0
20200316,04369P,台光電凱基94售04,,,,,0.00,0.00,0,0,0,0,0,0,0,0,0,0,0,0,0
20200316,04370P,聯茂凱基94售05,,,,,0.00,0.00,0,0,0,0,0,0,0,0,0,0,0,0,0
20200316,04371P,臺股指凱基94售01,,,,,0.00,0.00,0,0,0,0,0,0,0,0,0,0,0,0,0
20200316,04372P,臺股指凱基94售02,,,,,0.00,0.00,0,0,0,0,0,0,0,0,0,0,0,0,0
20200316,043735,元金2X元大94購01,,,,,0.00,0.00,0,0,0,0,0,0,0,0,0,0,0,0,0
20200316,04373P,滬深2X元大97售01,1.56,1.78,1.46,1.78,+0.38,27.14,203000,16,308900,0,0,0,0,0,0,77000,31000,46000,46000
20200316,04374P,深中小元大94售03,,,,,0.00,0.00,0,0,0,0,0,0,0,0,0,0,0,0,0
20200316,04375P,卜蜂元大94售01,,,,,0.00,0.00,0,0,0,0,0,0,0,0,0,0,0,0,0
20200316,04376P,漢唐元大94售04,,,,,0.00,0.00,0,0,0,0,0,0,0,0,0,0,0,0,0
20200316,04377P,大立光元大94售04,1.68,1.82,1.66,1.82,-1.22,-40.13,70000,4,121200,0,0,0,0,0,0,70000,0,70000,70000
20200316,043784,鴻海凱基94購01,0.34,0.34,0.28,0.29,-0.11,-27.5,205000,20,63010,0,0,0,0,0,0,104000,80000,24000,24000
20200316,04378P,大立光元大94售05,1.71,1.71,1.71,1.71,-1.24,-42.03,10000,2,17100,0,0,0,0,0,0,10000,0,10000,10000
20200316,04379P,大立光元大94售06,1.64,1.64,1.64,1.64,-1.08,-39.71,10000,2,16400,0,0,0,0,0,0,10000,0,10000,10000
20200316,04380P,欣興元大94售02,,,,,0.00,0.00,0,0,0,0,0,0,0,0,0,0,0,0,0
20200316,04381P,世紀鋼元大94售01,,,,,0.00,0.00,0,0,0,0,0,0,0,0,0,0,0,0,0
20200316,043823,羅麗芬群益94購01,,,,,0.00,0.00,0,0,0,0,0,0,0,0,0,0,0,0,0
20200316,04382P,美律國泰95售01,1.82,1.82,1.82,1.82,-0.06,-3.19,10000,1,18200,0,0,0,0,0,0,0,10000,-10000,-10000
20200316,043832,SP黃豆國票95購01,,,,,0.00,0.00,0,0,0,0,0,0,0,0,0,0,0,0,0
20200316,04383P,泰鼎國泰95售01,0.30,0.38,0.28,0.38,-0.05,-11.63,707000,8,245900,0,0,0,0,0,0,257000,450000,-193000,-193000
20200316,04384P,上証2X中信96售01,1.15,1.26,1.14,1.26,-0.02,-1.56,86000,6,105140,0,0,0,0,0,0,86000,0,86000,86000
20200316,04385P,可成日盛94售01,2.20,2.20,2.20,2.20,-0.73,-24.91,13000,1,28600,0,0,0,0,0,0,13000,0,13000,13000
20200316,04386P,大立光日盛94售01,0.82,0.83,0.82,0.83,-0.85,-50.6,91000,2,75490,0,0,0,0,0,0,91000,0,91000,91000
20200316,04387P,玉晶光日盛94售01,,,,,0.00,0.00,0,0,0,0,0,0,0,0,0,0,0,0,0
20200316,04388P,滬深2X凱基95售05,1.19,1.19,1.19,1.19,+0.09,8.18,125000,1,148750,0,0,0,0,0,0,125000,0,125000,125000
20200316,043891,羅麗芬元大94購01,,,,,0.00,0.00,0,0,0,0,0,0,0,0,0,0,0,0,0
20200316,04389P,台積電凱基94售04,,,,,0.00,0.00,0,0,0,0,0,0,0,0,0,0,0,0,0
20200316,04390P,台積電凱基94售05,,,,,0.00,0.00,0,0,0,0,0,0,0,0,0,0,0,0,0
20200316,04391P,玉晶光凱基95售03,0.45,0.45,0.45,0.45,-0.03,-6.25,20000,1,9000,0,0,0,0,0,0,0,20000,-20000,-20000
20200316,04392P,牧德凱基94售05,1.00,1.44,1.00,1.40,+0.31,28.44,90000,32,107800,0,0,0,0,0,0,30000,60000,-30000,-30000
20200316,04393P,牧德凱基94售06,,,,,0.00,0.00,0,0,0,0,0,0,0,0,0,0,0,0,0
20200316,04394P,臻鼎凱基94售01,2.36,2.36,2.36,2.36,0.00,0.00,10000,2,23600,0,0,0,0,0,0,10000,0,10000,10000
20200316,043958,臻鼎元富94購01,,,,,0.00,0.00,0,0,0,0,0,0,0,0,0,0,0,0,0
20200316,04395P,台積電群益94售06,0.26,0.41,0.26,0.41,-0.04,-8.89,12000,2,4620,0,0,0,0,0,0,12000,0,12000,12000
20200316,043961,道瓊反國泰94購01,1.25,1.25,1.25,1.25,+0.30,31.58,1000,1,1250,0,0,0,0,0,0,0,0,0,0
20200316,04396P,玉晶光群益94售02,0.82,0.88,0.82,0.88,0.00,0.00,2000,2,1700,0,0,0,0,0,0,2000,0,2000,2000
20200316,043970,為升富邦94購01,,,,,0.00,0.00,0,0,0,0,0,0,0,0,0,0,0,0,0
20200316,043973,元金2X元大94購02,0.94,0.94,0.94,0.94,0.00,0.00,1000,1,940,0,0,0,0,0,0,0,1000,-1000,-1000
20200316,04397P,玉晶光群益95售03,,,,,0.00,0.00,0,0,0,0,0,0,0,0,0,0,0,0,0
20200316,04398P,致伸群益94售02,,,,,0.00,0.00,0,0,0,0,0,0,0,0,0,0,0,0,0
20200316,04399P,樺漢群益94售01,,,,,0.00,0.00,0,0,0,0,0,0,0,0,0,0,0,0,0
20200316,04400P,台積電兆豐95售02,0.32,0.58,0.32,0.58,+0.22,61.11,2272000,106,838990,0,0,0,0,0,0,193000,2247000,-2054000,-2054000
20200316,04401P,玉晶光兆豐94售01,0.09,0.20,0.07,0.20,+0.07,53.85,1028000,6,78890,0,0,0,0,0,0,1020000,8000,1012000,1012000
20200316,04402P,TPK兆豐95售01,1.31,1.31,1.31,1.31,+0.05,3.97,10000,1,13100,0,0,0,0,0,0,0,10000,-10000,-10000
20200316,04403P,景碩國票95售01,,,,,0.00,0.00,0,0,0,0,0,0,0,0,0,0,0,0,0
20200316,044049,元金2X元大94購03,0.33,0.33,0.29,0.29,-0.37,-56.06,25000,2,7650,0,0,0,0,0,0,15000,10000,5000,5000
20200316,04404P,玉晶光國票94售01,,,,,0.00,0.00,0,0,0,0,0,0,0,0,0,0,0,0,0
20200316,04405P,牧德國票95售01,,,,,0.00,0.00,0,0,0,0,0,0,0,0,0,0,0,0,0
20200316,04406P,貿聯國票94售02,,,,,0.00,0.00,0,0,0,0,0,0,0,0,0,0,0,0,0
20200316,04407P,滬深2X統一94售02,,,,,0.00,0.00,0,0,0,0,0,0,0,0,0,0,0,0,0
20200316,044088,國巨元富95購01,,,,,0.00,0.00,0,0,0,0,0,0,0,0,0,0,0,0,0
20200316,04408P,台積電統一94售06,,,,,0.00,0.00,0,0,0,0,0,0,0,0,0,0,0,0,0
20200316,04409P,台積電統一95售01,,,,,0.00,0.00,0,0,0,0,0,0,0,0,0,0,0,0,0
20200316,044104,鴻海中信95購03,0.02,0.02,0.02,0.02,0.00,0.00,426000,6,8520,0,0,0,0,0,0,0,0,0,0
20200316,044105,聯詠中信95購01,0.32,0.32,0.32,0.32,+0.08,33.33,2000,1,640,0,0,0,0,0,0,2000,0,2000,2000
20200316,04410P,大立光統一94售05,3.10,3.15,3.10,3.13,-0.35,-10.06,75000,3,234400,0,0,0,0,0,0,75000,0,75000,75000
20200316,044118,健策兆豐93購02,,,,,0.00,0.00,0,0,0,0,0,0,0,0,0,0,0,0,0
20200316,04411P,智易統一96售01,,,,,0.00,0.00,0,0,0,0,0,0,0,0,0,0,0,0,0
20200316,044124,燿華凱基93購01,,,,,0.00,0.00,0,0,0,0,0,0,0,0,0,0,0,0,0
20200316,044125,美律凱基93購01,,,,,0.00,0.00,0,0,0,0,0,0,0,0,0,0,0,0,0
20200316,044126,奇力新凱基93購01,,,,,0.00,0.00,0,0,0,0,0,0,0,0,0,0,0,0,0
20200316,044129,群創凱基93購02,,,,,0.00,0.00,0,0,0,0,0,0,0,0,0,0,0,0,0
20200316,04412P,欣興元富94售01,,,,,0.00,0.00,0,0,0,0,0,0,0,0,0,0,0,0,0
20200316,044134,訊芯凱基93購01,,,,,0.00,0.00,0,0,0,0,0,0,0,0,0,0,0,0,0
20200316,044136,百和凱基93購01,,,,,0.00,0.00,0,0,0,0,0,0,0,0,0,0,0,0,0
20200316,04413P,玉晶光元富94售01,,,,,0.00,0.00,0,0,0,0,0,0,0,0,0,0,0,0,0
20200316,04414P,牧德元富94售04,,,,,0.00,0.00,0,0,0,0,0,0,0,0,0,0,0,0,0
20200316,04415P,牧德元富94售05,,,,,0.00,0.00,0,0,0,0,0,0,0,0,0,0,0,0,0
20200316,044167,大立光元大93購03,,,,,0.00,0.00,0,0,0,0,0,0,0,0,0,0,0,0,0
20200316,04416P,牧德元富94售06,,,,,0.00,0.00,0,0,0,0,0,0,0,0,0,0,0,0,0
20200316,04417P,光罩國泰95售02,1.41,1.44,1.41,1.44,-0.03,-2.04,100000,3,141600,0,0,0,0,0,0,0,100000,-100000,-100000
20200316,044183,S&P反1國泰93購01,1.01,1.01,1.01,1.01,+0.15,17.44,1000,1,1010,0,0,0,0,0,0,1000,0,1000,1000
20200316,044184,南亞科國泰93購01,,,,,0.00,0.00,0,0,0,0,0,0,0,0,0,0,0,0,0
20200316,044187,泰鼎國泰93購01,,,,,0.00,0.00,0,0,0,0,0,0,0,0,0,0,0,0,0
20200316,044188,超眾國泰93購01,,,,,0.00,0.00,0,0,0,0,0,0,0,0,0,0,0,0,0
20200316,04418P,燿華永豐94售01,,,,,0.00,0.00,0,0,0,0,0,0,0,0,0,0,0,0,0
20200316,044190,聯詠富邦93購01,,,,,0.00,0.00,0,0,0,0,0,0,0,0,0,0,0,0,0
20200316,04419P,奇力新永豐94售01,0.50,0.61,0.50,0.61,0.00,0.00,50000,4,27100,0,0,0,0,0,0,30000,10000,20000,20000
20200316,044200,群創國票93購01,,,,,0.00,0.00,0,0,0,0,0,0,0,0,0,0,0,0,0
20200316,044201,群創國票95購01,0.03,0.10,0.02,0.02,-0.18,-90.0,527000,11,11020,0,0,0,0,0,0,0,0,0,0
20200316,04420P,奇鋐永豐94售01,,,,,0.00,0.00,0,0,0,0,0,0,0,0,0,0,0,0,0
20200316,044212,鴻海凱基93購04,,,,,0.00,0.00,0,0,0,0,0,0,0,0,0,0,0,0,0
20200316,044216,華新科凱基93購02,0.47,0.51,0.37,0.37,0.00,0.00,50000,5,22000,0,0,0,0,0,0,0,50000,-50000,-50000
20200316,044217,華新科凱基93購03,,,,,0.00,0.00,0,0,0,0,0,0,0,0,0,0,0,0,0
20200316,04421P,玉晶光永豐94售02,,,,,0.00,0.00,0,0,0,0,0,0,0,0,0,0,0,0,0
20200316,044221,群創凱基93購03,,,,,0.00,0.00,0,0,0,0,0,0,0,0,0,0,0,0,0
20200316,044224,超眾凱基93購01,,,,,0.00,0.00,0,0,0,0,0,0,0,0,0,0,0,0,0
20200316,044225,世紀鋼凱基93購02,,,,,0.00,0.00,0,0,0,0,0,0,0,0,0,0,0,0,0
20200316,04422P,玉晶光永豐94售03,,,,,0.00,0.00,0,0,0,0,0,0,0,0,0,0,0,0,0
20200316,04423P,牧德永豐94售01,,,,,0.00,0.00,0,0,0,0,0,0,0,0,0,0,0,0,0
20200316,044242,宏達電統一93購01,,,,,0.00,0.00,0,0,0,0,0,0,0,0,0,0,0,0,0
20200316,044247,道瓊反元富97購01,1.34,1.38,1.25,1.36,+0.13,10.57,636000,58,848980,0,0,0,0,0,0,0,575000,-575000,-575000
20200316,044249,T50反1中信94購01,,,,,0.00,0.00,0,0,0,0,0,0,0,0,0,0,0,0,0
20200316,04424P,台郡永豐94售01,,,,,0.00,0.00,0,0,0,0,0,0,0,0,0,0,0,0,0
20200316,044254,深中小元大94購01,,,,,0.00,0.00,0,0,0,0,0,0,0,0,0,0,0,0,0
20200316,044255,群創元大93購01,,,,,0.00,0.00,0,0,0,0,0,0,0,0,0,0,0,0,0
20200316,04425P,中環康和94售01,,,,,0.00,0.00,0,0,0,0,0,0,0,0,0,0,0,0,0
20200316,044264,大立光富邦93購03,,,,,0.00,0.00,0,0,0,0,0,0,0,0,0,0,0,0,0
20200316,044265,滬深2X中信95購05,0.02,0.02,0.02,0.02,0.00,0.00,150000,15,3000,0,0,0,0,0,0,0,150000,-150000,-150000
20200316,044269,群創中信95購01,,,,,0.00,0.00,0,0,0,0,0,0,0,0,0,0,0,0,0
20200316,04426P,佳世達康和94售02,,,,,0.00,0.00,0,0,0,0,0,0,0,0,0,0,0,0,0
20200316,044270,群創中信95購02,0.09,0.09,0.02,0.02,0.00,0.00,21000,4,490,0,0,0,0,0,0,0,20000,-20000,-20000
20200316,04427P,滬深2X元大97售02,1.68,1.71,1.59,1.59,+0.12,8.16,23000,4,36850,0,0,0,0,0,0,20000,3000,17000,17000
20200316,044280,T50反1凱基94購02,,,,,0.00,0.00,0,0,0,0,0,0,0,0,0,0,0,0,0
20200316,044282,上銀凱基93購03,,,,,0.00,0.00,0,0,0,0,0,0,0,0,0,0,0,0,0
20200316,044285,鴻海凱基93購06,,,,,0.00,0.00,0,0,0,0,0,0,0,0,0,0,0,0,0
20200316,044289,群創凱基93購04,,,,,0.00,0.00,0,0,0,0,0,0,0,0,0,0,0,0,0
20200316,04428P,台光電元大94售02,,,,,0.00,0.00,0,0,0,0,0,0,0,0,0,0,0,0,0
20200316,044290,群創凱基93購05,,,,,0.00,0.00,0,0,0,0,0,0,0,0,0,0,0,0,0
20200316,044291,群創凱基93購06,0.01,0.01,0.01,0.01,0.00,0.00,20000,20,200,0,0,0,0,0,0,0,0,0,0
20200316,044296,嘉聯益凱基93購01,,,,,0.00,0.00,0,0,0,0,0,0,0,0,0,0,0,0,0
20200316,044298,南電凱基93購01,1.13,1.13,1.13,1.13,+0.34,43.04,10000,1,11300,0,0,0,0,0,0,10000,0,10000,10000
20200316,044299,南電凱基93購02,0.07,0.07,0.07,0.07,0.00,0.00,8000,1,560,0,0,0,0,0,0,8000,0,8000,8000
20200316,04429P,和鑫元大94售01,,,,,0.00,0.00,0,0,0,0,0,0,0,0,0,0,0,0,0
20200316,044302,智邦兆豐93購02,1.61,1.61,1.37,1.37,+0.27,24.55,70000,5,110000,0,0,0,0,0,0,70000,0,70000,70000
20200316,044304,臻鼎兆豐93購01,0.01,0.01,0.01,0.01,0.00,0.00,5000,1,50,0,0,0,0,0,0,0,0,0,0
20200316,044305,瀚宇博兆豐93購01,,,,,0.00,0.00,0,0,0,0,0,0,0,0,0,0,0,0,0
20200316,044306,瑞儀兆豐93購02,,,,,0.00,0.00,0,0,0,0,0,0,0,0,0,0,0,0,0
20200316,044307,GIS兆豐93購01,,,,,0.00,0.00,0,0,0,0,0,0,0,0,0,0,0,0,0
20200316,04430P,晶相光元大94售04,,,,,0.00,0.00,0,0,0,0,0,0,0,0,0,0,0,0,0
20200316,044310,元黃金台新93購01,,,,,0.00,0.00,0,0,0,0,0,0,0,0,0,0,0,0,0
20200316,04431P,牧德元大94售03,0.50,0.56,0.50,0.56,0.00,0.00,100000,10,54100,0,0,0,0,0,0,0,100000,-100000,-100000
20200316,04432P,昇陽半元大94售04,3.14,3.14,3.14,3.14,0.00,0.00,10000,1,31400,0,0,0,0,0,0,0,10000,-10000,-10000
20200316,044330,T50反1統一93購01,,,,,0.00,0.00,0,0,0,0,0,0,0,0,0,0,0,0,0
20200316,04433P,上証2X國票95售01,1.10,1.14,1.10,1.14,+0.18,18.75,163000,5,182520,0,0,0,0,0,0,163000,0,163000,163000
20200316,044340,TPK統一93購01,,,,,0.00,0.00,0,0,0,0,0,0,0,0,0,0,0,0,0
20200316,044346,力山富邦95購01,,,,,0.00,0.00,0,0,0,0,0,0,0,0,0,0,0,0,0
20200316,044347,上証2X元大94購01,,,,,0.00,0.00,0,0,0,0,0,0,0,0,0,0,0,0,0
20200316,04434P,玉晶光國票96售02,1.57,2.00,1.57,2.00,+0.47,30.72,164000,28,290900,0,0,0,0,0,0,0,105000,-105000,-105000
20200316,044353,宏達電元大93購04,,,,,0.00,0.00,0,0,0,0,0,0,0,0,0,0,0,0,0
20200316,044354,奇鋐元大93購02,,,,,0.00,0.00,0,0,0,0,0,0,0,0,0,0,0,0,0
20200316,04435P,台積電中信95售07,,,,,0.00,0.00,0,0,0,0,0,0,0,0,0,0,0,0,0
20200316,044362,元油2X中信94購01,0.01,0.01,0.01,0.01,0.00,0.00,362000,22,3620,0,0,0,0,0,0,0,0,0,0
20200316,044364,超眾中信94購01,,,,,0.00,0.00,0,0,0,0,0,0,0,0,0,0,0,0,0
20200316,04436P,聯發科中信96售02,0.83,0.99,0.83,0.99,+0.19,23.75,56000,7,48150,0,0,0,0,0,0,41000,15000,26000,26000
20200316,044374,燿華兆豐93購01,0.03,0.03,0.03,0.03,-0.01,-25.0,16000,2,480,0,0,0,0,0,0,0,16000,-16000,-16000
20200316,044377,南茂兆豐93購01,,,,,0.00,0.00,0,0,0,0,0,0,0,0,0,0,0,0,0
20200316,04437P,滬深2X群益98售03,1.27,1.31,1.27,1.30,+0.04,3.17,26000,5,33250,0,0,0,0,0,0,26000,0,26000,26000
20200316,044382,嘉聯益群益94購01,0.08,0.08,0.08,0.08,+0.02,33.33,80000,1,6400,0,0,0,0,0,0,80000,0,80000,80000
20200316,04438P,微星群益94售01,,,,,0.00,0.00,0,0,0,0,0,0,0,0,0,0,0,0,0
20200316,044396,燿華凱基93購02,,,,,0.00,0.00,0,0,0,0,0,0,0,0,0,0,0,0,0
20200316,04439P,聯發科群益94售04,,,,,0.00,0.00,0,0,0,0,0,0,0,0,0,0,0,0,0
20200316,044401,亞光凱基93購01,,,,,0.00,0.00,0,0,0,0,0,0,0,0,0,0,0,0,0
20200316,044402,景碩凱基93購01,0.01,0.01,0.01,0.01,0.00,0.00,10000,1,100,0,0,0,0,0,0,10000,0,10000,10000
20200316,044405,材料凱基93購01,,,,,0.00,0.00,0,0,0,0,0,0,0,0,0,0,0,0,0
20200316,044407,聯茂凱基93購01,0.37,0.37,0.37,0.37,0.00,0.00,10000,1,3700,0,0,0,0,0,0,0,10000,-10000,-10000
20200316,044408,聯茂凱基93購02,,,,,0.00,0.00,0,0,0,0,0,0,0,0,0,0,0,0,0
20200316,04440P,訊芯群益94售01,0.83,0.83,0.83,0.83,0.00,0.00,5000,1,4150,0,0,0,0,0,0,5000,0,5000,5000
20200316,044411,A50正2統一93購01,,,,,0.00,0.00,0,0,0,0,0,0,0,0,0,0,0,0,0
20200316,04441P,台積電台新95售01,0.14,0.27,0.13,0.27,0.00,0.00,131000,14,21530,0,0,0,0,0,0,0,131000,-131000,-131000
20200316,044426,欣興國泰93購02,,,,,0.00,0.00,0,0,0,0,0,0,0,0,0,0,0,0,0
20200316,044427,群創國泰93購01,,,,,0.00,0.00,0,0,0,0,0,0,0,0,0,0,0,0,0
20200316,044429,元金2X元大94購04,0.12,0.13,0.11,0.11,-0.01,-8.33,65000,6,7870,0,0,0,0,0,0,0,20000,-20000,-20000
20200316,04442P,矽格康和94售02,,,,,0.00,0.00,0,0,0,0,0,0,0,0,0,0,0,0,0
20200316,044439,南電元大93購01,0.12,0.12,0.08,0.08,+0.02,33.33,180000,18,16500,0,0,0,0,0,0,10000,170000,-160000,-160000
20200316,04443P,台積電永豐94售01,,,,,0.00,0.00,0,0,0,0,0,0,0,0,0,0,0,0,0
20200316,04444P,玉晶光永豐94售06,,,,,0.00,0.00,0,0,0,0,0,0,0,0,0,0,0,0,0
20200316,044457,滬深2X國票97購01,,,,,0.00,0.00,0,0,0,0,0,0,0,0,0,0,0,0,0
20200316,04445P,台積電日盛94售01,,,,,0.00,0.00,0,0,0,0,0,0,0,0,0,0,0,0,0
20200316,044461,滬深2X兆豐93購01,,,,,0.00,0.00,0,0,0,0,0,0,0,0,0,0,0,0,0
20200316,044462,漢唐兆豐93購01,,,,,0.00,0.00,0,0,0,0,0,0,0,0,0,0,0,0,0
20200316,044463,全新兆豐93購01,,,,,0.00,0.00,0,0,0,0,0,0,0,0,0,0,0,0,0
20200316,044464,滬深2X群益95購01,0.02,0.02,0.02,0.02,0.00,0.00,50000,1,1000,0,0,0,0,0,0,0,0,0,0
20200316,044465,元油2X群益97購01,0.03,0.03,0.02,0.02,0.00,0.00,711000,6,17920,0,0,0,0,0,0,0,0,0,0
20200316,044466,和大群益93購01,,,,,0.00,0.00,0,0,0,0,0,0,0,0,0,0,0,0,0
20200316,044468,台積電群益93購01,0.45,0.45,0.18,0.18,-0.60,-76.92,140000,14,37300,0,0,0,0,0,0,10000,130000,-120000,-120000
20200316,04446P,元油2X凱基94售03,,,,,0.00,0.00,0,0,0,0,0,0,0,0,0,0,0,0,0
20200316,044475,國巨元富95購02,,,,,0.00,0.00,0,0,0,0,0,0,0,0,0,0,0,0,0
20200316,044478,友達統一93購01,,,,,0.00,0.00,0,0,0,0,0,0,0,0,0,0,0,0,0
20200316,04447P,上銀凱基94售02,0.78,1.07,0.78,1.02,+0.21,25.93,12000,7,10980,0,0,0,0,0,0,12000,0,12000,12000
20200316,044487,元油2X元大94購01,,,,,0.00,0.00,0,0,0,0,0,0,0,0,0,0,0,0,0
20200316,04448P,台積電凱基94售07,,,,,0.00,0.00,0,0,0,0,0,0,0,0,0,0,0,0,0
20200316,044496,群創元大93購02,,,,,0.00,0.00,0,0,0,0,0,0,0,0,0,0,0,0,0
20200316,04449P,智邦凱基94售01,,,,,0.00,0.00,0,0,0,0,0,0,0,0,0,0,0,0,0
20200316,044507,燿華凱基93購03,,,,,0.00,0.00,0,0,0,0,0,0,0,0,0,0,0,0,0
20200316,044509,台光電凱基93購03,,,,,0.00,0.00,0,0,0,0,0,0,0,0,0,0,0,0,0
20200316,04450P,京元電凱基94售01,2.12,2.15,2.12,2.15,-1.51,-41.26,8000,2,17140,0,0,0,0,0,0,0,8000,-8000,-8000
20200316,044510,台光電凱基93購04,,,,,0.00,0.00,0,0,0,0,0,0,0,0,0,0,0,0,0
20200316,044512,奇力新凱基93購02,0.33,0.33,0.33,0.33,+0.14,73.68,10000,1,3300,0,0,0,0,0,0,10000,0,10000,10000
20200316,044513,義隆凱基93購02,,,,,0.00,0.00,0,0,0,0,0,0,0,0,0,0,0,0,0
20200316,044514,亞光凱基93購02,,,,,0.00,0.00,0,0,0,0,0,0,0,0,0,0,0,0,0
20200316,044516,景碩凱基93購02,,,,,0.00,0.00,0,0,0,0,0,0,0,0,0,0,0,0,0
20200316,04451P,可成凱基94售04,4.88,5.00,4.88,5.00,-0.70,-12.28,20000,2,98800,0,0,0,0,0,0,0,20000,-20000,-20000
20200316,044522,TPK凱基93購01,,,,,0.00,0.00,0,0,0,0,0,0,0,0,0,0,0,0,0
20200316,044524,瑞儀凱基93購02,,,,,0.00,0.00,0,0,0,0,0,0,0,0,0,0,0,0,0
20200316,044526,訊芯凱基93購02,,,,,0.00,0.00,0,0,0,0,0,0,0,0,0,0,0,0,0
20200316,044527,易華電凱基93購01,,,,,0.00,0.00,0,0,0,0,0,0,0,0,0,0,0,0,0
20200316,04452P,超眾國泰95售01,,,,,0.00,0.00,0,0,0,0,0,0,0,0,0,0,0,0,0
20200316,044530,台積電富邦94購01,0.52,0.56,0.34,0.34,-0.32,-48.48,52000,15,22790,0,0,0,0,0,0,14000,32000,-18000,-18000
20200316,044531,欣興富邦93購01,,,,,0.00,0.00,0,0,0,0,0,0,0,0,0,0,0,0,0
20200316,044532,康控富邦93購01,,,,,0.00,0.00,0,0,0,0,0,0,0,0,0,0,0,0,0
20200316,044533,S&P反1中信94購02,2.21,2.21,2.03,2.03,-0.13,-6.02,24000,6,50880,0,0,0,0,0,0,10000,14000,-4000,-4000
20200316,044535,華新科麥證93購01,,,,,0.00,0.00,0,0,0,0,0,0,0,0,0,0,0,0,0
20200316,04453P,聯發科富邦94售04,,,,,0.00,0.00,0,0,0,0,0,0,0,0,0,0,0,0,0
20200316,04454P,大立光富邦98售02,1.16,1.38,1.08,1.30,+0.30,30.0,130000,8,159400,0,0,0,0,0,0,100000,10000,90000,90000
20200316,04455P,台積電統一94售07,0.17,0.17,0.17,0.17,-0.08,-32.0,1000,1,170,0,0,0,0,0,0,1000,0,1000,1000
20200316,044567,華通凱基93購03,0.38,0.38,0.09,0.09,-0.19,-67.86,15000,2,4250,0,0,0,0,0,0,5000,10000,-5000,-5000
20200316,04456P,日月光統一94售01,,,,,0.00,0.00,0,0,0,0,0,0,0,0,0,0,0,0,0
20200316,044574,潤泰全凱基93購01,,,,,0.00,0.00,0,0,0,0,0,0,0,0,0,0,0,0,0
20200316,044578,緯創凱基93購02,,,,,0.00,0.00,0,0,0,0,0,0,0,0,0,0,0,0,0
20200316,04457P,同欣電統一94售01,,,,,0.00,0.00,0,0,0,0,0,0,0,0,0,0,0,0,0
20200316,044583,易華電凱基93購02,,,,,0.00,0.00,0,0,0,0,0,0,0,0,0,0,0,0,0
20200316,044584,世紀鋼凱基93購05,0.51,0.51,0.16,0.17,-0.01,-5.56,35000,5,6950,0,0,0,0,0,0,20000,5000,15000,15000
20200316,044588,元金2X統一93購01,,,,,0.00,0.00,0,0,0,0,0,0,0,0,0,0,0,0,0
20200316,044589,國巨統一93購03,,,,,0.00,0.00,0,0,0,0,0,0,0,0,0,0,0,0,0
20200316,04458P,世紀鋼統一96售01,,,,,0.00,0.00,0,0,0,0,0,0,0,0,0,0,0,0,0
20200316,044592,元油2X國票93購02,,,,,0.00,0.00,0,0,0,0,0,0,0,0,0,0,0,0,0
20200316,04459P,元油2X元富94售08,,,,,0.00,0.00,0,0,0,0,0,0,0,0,0,0,0,0,0
20200316,044600,上銀國泰93購01,,,,,0.00,0.00,0,0,0,0,0,0,0,0,0,0,0,0,0
20200316,044601,旺宏國泰93購03,,,,,0.00,0.00,0,0,0,0,0,0,0,0,0,0,0,0,0
20200316,044602,大立光國泰93購01,,,,,0.00,0.00,0,0,0,0,0,0,0,0,0,0,0,0,0
20200316,044604,嘉聯益國泰93購01,,,,,0.00,0.00,0,0,0,0,0,0,0,0,0,0,0,0,0
20200316,044605,超眾國泰93購02,,,,,0.00,0.00,0,0,0,0,0,0,0,0,0,0,0,0,0
20200316,044608,奇力新富邦93購01,,,,,0.00,0.00,0,0,0,0,0,0,0,0,0,0,0,0,0
20200316,04460P,元油2X元富96售04,,,,,0.00,0.00,0,0,0,0,0,0,0,0,0,0,0,0,0
20200316,044610,A50正2兆豐93購01,,,,,0.00,0.00,0,0,0,0,0,0,0,0,0,0,0,0,0
20200316,044612,創意兆豐93購01,,,,,0.00,0.00,0,0,0,0,0,0,0,0,0,0,0,0,0
20200316,044613,智易兆豐94購01,,,,,0.00,0.00,0,0,0,0,0,0,0,0,0,0,0,0,0
20200316,044615,聯茂兆豐93購01,,,,,0.00,0.00,0,0,0,0,0,0,0,0,0,0,0,0,0
20200316,04461P,燿華元富94售01,,,,,0.00,0.00,0,0,0,0,0,0,0,0,0,0,0,0,0
20200316,04462P,全新元富96售01,1.60,2.01,1.60,2.01,+0.17,9.24,132000,10,235240,0,0,0,0,0,0,72000,60000,12000,12000
20200316,044636,創意統一94購01,,,,,0.00,0.00,0,0,0,0,0,0,0,0,0,0,0,0,0
20200316,044637,滬深2X元富94購01,0.02,0.02,0.02,0.02,-0.02,-50.0,100000,1,2000,0,0,0,0,0,0,100000,0,100000,100000
20200316,044639,京元電元富94購01,0.17,0.20,0.17,0.20,+0.07,53.85,83000,5,15670,0,0,0,0,0,0,83000,0,83000,83000
20200316,04463P,可成元富94售03,,,,,0.00,0.00,0,0,0,0,0,0,0,0,0,0,0,0,0
20200316,044643,滬深2X群益96購01,0.04,0.05,0.04,0.05,-0.07,-58.33,182000,2,8080,0,0,0,0,0,0,102000,80000,22000,22000
20200316,044645,元金2X群益93購01,0.12,0.12,0.12,0.12,0.00,0.00,4000,1,480,0,0,0,0,0,0,4000,0,4000,4000
20200316,04464P,可成元富94售04,,,,,0.00,0.00,0,0,0,0,0,0,0,0,0,0,0,0,0
20200316,04465P,大立光元富94售03,1.67,1.67,1.62,1.62,+0.22,15.71,2000,2,3290,0,0,0,0,0,0,2000,0,2000,2000
20200316,04466P,大立光元富94售04,,,,,0.00,0.00,0,0,0,0,0,0,0,0,0,0,0,0,0
20200316,044673,上銀凱基93購04,,,,,0.00,0.00,0,0,0,0,0,0,0,0,0,0,0,0,0
20200316,044675,廣宇凱基93購02,,,,,0.00,0.00,0,0,0,0,0,0,0,0,0,0,0,0,0
20200316,04467P,元油2X元大94售03,,,,,0.00,0.00,0,0,0,0,0,0,0,0,0,0,0,0,0
20200316,044680,華新科凱基93購06,,,,,0.00,0.00,0,0,0,0,0,0,0,0,0,0,0,0,0
20200316,044682,和鑫凱基93購01,,,,,0.00,0.00,0,0,0,0,0,0,0,0,0,0,0,0,0
20200316,044683,聯鈞凱基93購01,,,,,0.00,0.00,0,0,0,0,0,0,0,0,0,0,0,0,0
20200316,044687,南寶凱基93購01,,,,,0.00,0.00,0,0,0,0,0,0,0,0,0,0,0,0,0
20200316,044688,傳奇凱基93購01,,,,,0.00,0.00,0,0,0,0,0,0,0,0,0,0,0,0,0
20200316,044689,超眾凱基93購03,,,,,0.00,0.00,0,0,0,0,0,0,0,0,0,0,0,0,0
20200316,04468P,元油2X元大94售04,,,,,0.00,0.00,0,0,0,0,0,0,0,0,0,0,0,0,0
20200316,044693,滬深2X元大94購01,,,,,0.00,0.00,0,0,0,0,0,0,0,0,0,0,0,0,0
20200316,044694,道瓊反元大94購02,0.91,1.58,0.78,1.58,+0.76,92.68,911000,109,826300,0,0,0,0,0,0,0,910000,-910000,-910000
20200316,044697,美律元大93購02,,,,,0.00,0.00,0,0,0,0,0,0,0,0,0,0,0,0,0
20200316,04469P,元油2X元大94售05,,,,,0.00,0.00,0,0,0,0,0,0,0,0,0,0,0,0,0
20200316,044705,群創元大93購03,,,,,0.00,0.00,0,0,0,0,0,0,0,0,0,0,0,0,0
20200316,04470P,為升元大94售01,,,,,0.00,0.00,0,0,0,0,0,0,0,0,0,0,0,0,0
20200316,044717,旺宏統一94購01,0.15,0.15,0.10,0.10,-0.05,-33.33,70000,4,10000,0,0,0,0,0,0,0,0,0,0
20200316,044718,宏達電統一93購02,,,,,0.00,0.00,0,0,0,0,0,0,0,0,0,0,0,0,0
20200316,044719,欣興亞東93購01,,,,,0.00,0.00,0,0,0,0,0,0,0,0,0,0,0,0,0
20200316,04471P,華通元大95售03,0.85,1.22,0.83,1.22,+0.26,27.08,147000,20,141150,0,0,0,0,0,0,40000,127000,-87000,-87000
20200316,04472P,中環元大94售01,,,,,0.00,0.00,0,0,0,0,0,0,0,0,0,0,0,0,0
20200316,044734,台積電國泰93購01,,,,,0.00,0.00,0,0,0,0,0,0,0,0,0,0,0,0,0
20200316,044735,光磊國泰93購01,,,,,0.00,0.00,0,0,0,0,0,0,0,0,0,0,0,0,0
20200316,04473P,國巨元大94售03,,,,,0.00,0.00,0,0,0,0,0,0,0,0,0,0,0,0,0
20200316,044746,智易群益93購01,,,,,0.00,0.00,0,0,0,0,0,0,0,0,0,0,0,0,0
20200316,044747,健策群益93購01,,,,,0.00,0.00,0,0,0,0,0,0,0,0,0,0,0,0,0
20200316,04474P,聯發科元大94售03,,,,,0.00,0.00,0,0,0,0,0,0,0,0,0,0,0,0,0
20200316,044750,鴻海凱基93購07,,,,,0.00,0.00,0,0,0,0,0,0,0,0,0,0,0,0,0
20200316,044751,鴻海凱基93購08,0.01,0.01,0.01,0.01,0.00,0.00,10000,10,100,0,0,0,0,0,0,0,0,0,0
20200316,044757,益航凱基93購01,,,,,0.00,0.00,0,0,0,0,0,0,0,0,0,0,0,0,0
20200316,04475P,欣興元大94售03,2.90,2.95,2.90,2.95,+0.39,15.23,11000,2,32150,0,0,0,0,0,0,11000,0,11000,11000
20200316,044762,元翎凱基93購01,,,,,0.00,0.00,0,0,0,0,0,0,0,0,0,0,0,0,0
20200316,044763,瀚宇博凱基93購01,0.18,0.19,0.11,0.11,-0.03,-21.43,298000,30,45040,0,0,0,0,0,0,10000,288000,-278000,-278000
20200316,044764,聯茂凱基93購03,,,,,0.00,0.00,0,0,0,0,0,0,0,0,0,0,0,0,0
20200316,044767,世紀鋼凱基93購06,0.36,0.36,0.36,0.36,+0.24,200.0,10000,1,3600,0,0,0,0,0,0,10000,0,10000,10000
20200316,044768,深中小元大94購02,,,,,0.00,0.00,0,0,0,0,0,0,0,0,0,0,0,0,0
20200316,04476P,玉晶光元大94售05,0.34,0.46,0.34,0.46,+0.18,64.29,40000,4,14800,0,0,0,0,0,0,0,40000,-40000,-40000
20200316,044779,GIS元大93購05,,,,,0.00,0.00,0,0,0,0,0,0,0,0,0,0,0,0,0
20200316,04477P,南電元大94售04,,,,,0.00,0.00,0,0,0,0,0,0,0,0,0,0,0,0,0
20200316,044784,華邦電中信96購01,,,,,0.00,0.00,0,0,0,0,0,0,0,0,0,0,0,0,0
20200316,044785,台達電亞東93購01,,,,,0.00,0.00,0,0,0,0,0,0,0,0,0,0,0,0,0
20200316,04478P,元油2X中信95售03,,,,,0.00,0.00,0,0,0,0,0,0,0,0,0,0,0,0,0
20200316,044790,智易群益93購02,,,,,0.00,0.00,0,0,0,0,0,0,0,0,0,0,0,0,0
20200316,04479P,同欣電中信96售02,0.55,0.73,0.55,0.73,+0.23,46.0,210000,6,126300,0,0,0,0,0,0,190000,110000,80000,80000
20200316,044805,旭富凱基93購01,0.11,0.13,0.10,0.10,0.00,0.00,141000,16,16430,0,0,0,0,0,0,10000,131000,-121000,-121000
20200316,044809,道瓊反國票93購01,1.69,1.73,1.52,1.73,+0.35,25.36,71000,5,112740,0,0,0,0,0,0,71000,0,71000,71000
20200316,04480P,微星兆豐94售01,0.51,0.55,0.51,0.53,+0.12,29.27,9000,7,4800,0,0,0,0,0,0,9000,0,9000,9000
20200316,044813,為升兆豐93購02,,,,,0.00,0.00,0,0,0,0,0,0,0,0,0,0,0,0,0
20200316,044814,華邦電兆豐93購02,,,,,0.00,0.00,0,0,0,0,0,0,0,0,0,0,0,0,0
20200316,044817,可成兆豐93購01,,,,,0.00,0.00,0,0,0,0,0,0,0,0,0,0,0,0,0
20200316,044819,新日興兆豐93購02,,,,,0.00,0.00,0,0,0,0,0,0,0,0,0,0,0,0,0
20200316,04481P,聯發科日盛94售01,,,,,0.00,0.00,0,0,0,0,0,0,0,0,0,0,0,0,0
20200316,044820,臻鼎兆豐93購02,,,,,0.00,0.00,0,0,0,0,0,0,0,0,0,0,0,0,0
20200316,044821,瑞儀兆豐93購03,,,,,0.00,0.00,0,0,0,0,0,0,0,0,0,0,0,0,0
20200316,04482P,臺股指日盛94售01,1.31,2.06,1.31,2.06,+0.93,82.3,17000,2,29770,0,0,0,0,0,0,17000,0,17000,17000
20200316,044836,宏達電元大93購05,,,,,0.00,0.00,0,0,0,0,0,0,0,0,0,0,0,0,0
20200316,04483P,元油2X凱基97售04,,,,,0.00,0.00,0,0,0,0,0,0,0,0,0,0,0,0,0
20200316,044844,國巨統一93購04,,,,,0.00,0.00,0,0,0,0,0,0,0,0,0,0,0,0,0
20200316,044846,旺宏統一93購01,,,,,0.00,0.00,0,0,0,0,0,0,0,0,0,0,0,0,0
20200316,044848,華邦電統一94購01,,,,,0.00,0.00,0,0,0,0,0,0,0,0,0,0,0,0,0
20200316,04484P,台積電凱基94售09,0.32,0.75,0.32,0.64,+0.28,77.78,113000,11,66200,0,0,0,0,0,0,100000,13000,87000,87000
20200316,044850,南亞科統一94購01,0.11,0.11,0.11,0.11,0.00,0.00,1000,1,110,0,0,0,0,0,0,0,1000,-1000,-1000
20200316,044852,華邦電國泰93購02,,,,,0.00,0.00,0,0,0,0,0,0,0,0,0,0,0,0,0
20200316,044853,亞光國泰93購01,,,,,0.00,0.00,0,0,0,0,0,0,0,0,0,0,0,0,0
20200316,04485P,台積電凱基94售10,,,,,0.00,0.00,0,0,0,0,0,0,0,0,0,0,0,0,0
20200316,044860,元油2X中信93購01,,,,,0.00,0.00,0,0,0,0,0,0,0,0,0,0,0,0,0
20200316,044864,道瓊反國票96購01,1.01,1.65,0.91,1.65,+0.86,108.86,567000,62,698800,0,0,0,0,0,0,0,10000,-10000,-10000
20200316,04486P,台光電凱基94售05,,,,,0.00,0.00,0,0,0,0,0,0,0,0,0,0,0,0,0
20200316,044871,國巨統一93購05,6.70,6.70,6.70,6.70,0.00,0.00,10000,1,67000,0,0,0,0,0,0,10000,0,10000,10000
20200316,044872,旺宏統一93購02,,,,,0.00,0.00,0,0,0,0,0,0,0,0,0,0,0,0,0
20200316,044875,玉晶光統一93購01,,,,,0.00,0.00,0,0,0,0,0,0,0,0,0,0,0,0,0
20200316,044879,上証2X群益93購01,0.01,0.01,0.01,0.01,-0.11,-91.67,14000,1,140,0,0,0,0,0,0,14000,0,14000,14000
20200316,04487P,南亞科凱基94售01,1.25,2.15,1.25,2.15,0.00,0.00,10000,2,16100,0,0,0,0,0,0,0,10000,-10000,-10000
20200316,044883,玉晶光群益93購01,,,,,0.00,0.00,0,0,0,0,0,0,0,0,0,0,0,0,0
20200316,04488P,聯發科凱基94售05,1.09,1.92,1.09,1.92,+0.74,62.71,55000,12,73530,0,0,0,0,0,0,21000,34000,-13000,-13000
20200316,04489P,大立光凱基94售03,,,,,0.00,0.00,0,0,0,0,0,0,0,0,0,0,0,0,0
20200316,044909,玉晶光凱基93購02,0.15,0.15,0.15,0.15,-0.04,-21.05,3000,1,450,0,0,0,0,0,0,0,3000,-3000,-3000
20200316,04490P,聯發科台新94售02,,,,,0.00,0.00,0,0,0,0,0,0,0,0,0,0,0,0,0
20200316,04491P,光磊康和94售01,,,,,0.00,0.00,0,0,0,0,0,0,0,0,0,0,0,0,0
20200316,044926,聯詠國泰93購01,,,,,0.00,0.00,0,0,0,0,0,0,0,0,0,0,0,0,0
20200316,044927,聯詠國泰94購01,0.56,0.57,0.51,0.51,-0.12,-19.05,81000,3,44980,0,0,0,0,0,0,81000,0,81000,81000
20200316,044928,玉晶光國泰93購01,,,,,0.00,0.00,0,0,0,0,0,0,0,0,0,0,0,0,0
20200316,04492P,元油2X永豐94售03,,,,,0.00,0.00,0,0,0,0,0,0,0,0,0,0,0,0,0
20200316,044930,元黃金富邦93購01,0.14,0.16,0.14,0.16,0.00,0.00,100000,10,15800,0,0,0,0,0,0,0,100000,-100000,-100000
20200316,04493P,漢唐永豐94售01,0.48,0.48,0.48,0.48,+0.02,4.35,40000,2,19200,0,0,0,0,0,0,0,40000,-40000,-40000
20200316,044942,國巨群益94購01,6.50,6.50,6.50,6.50,+1.60,32.65,40000,1,260000,0,0,0,0,0,0,40000,0,40000,40000
20200316,04494P,台積電國票94售04,,,,,0.00,0.00,0,0,0,0,0,0,0,0,0,0,0,0,0
20200316,044950,玉晶光群益94購01,,,,,0.00,0.00,0,0,0,0,0,0,0,0,0,0,0,0,0
20200316,04495P,台積電國票95售01,1.56,1.56,1.56,1.56,+0.01,0.65,1000,1,1560,0,0,0,0,0,0,0,1000,-1000,-1000
20200316,044961,聯電中信94購01,,,,,0.00,0.00,0,0,0,0,0,0,0,0,0,0,0,0,0
20200316,044963,台積電中信96購01,0.97,1.14,0.61,0.61,-0.50,-45.05,596000,64,506330,0,0,0,0,0,0,140000,324000,-184000,-184000
20200316,044964,旺宏中信94購01,,,,,0.00,0.00,0,0,0,0,0,0,0,0,0,0,0,0,0
20200316,044965,大立光中信95購01,0.08,0.08,0.04,0.04,-0.03,-42.86,502000,47,25600,0,0,0,0,0,0,0,412000,-412000,-412000
20200316,044966,台表科中信94購01,,,,,0.00,0.00,0,0,0,0,0,0,0,0,0,0,0,0,0
20200316,04496P,國巨國泰96售02,0.32,0.60,0.31,0.60,+0.24,66.67,1225000,44,527780,0,0,0,0,0,0,678000,0,678000,678000
20200316,044972,元金2X國票96購01,,,,,0.00,0.00,0,0,0,0,0,0,0,0,0,0,0,0,0
20200316,044974,鴻海國票94購01,0.01,0.01,0.01,0.01,0.00,0.00,165000,1,1650,0,0,0,0,0,0,165000,0,165000,165000
20200316,04497P,元油2X富邦97售03,6.80,6.80,6.80,6.80,-0.80,-10.53,7000,1,47600,0,0,0,0,0,0,7000,7000,0,0
20200316,044987,宏達電統一94購01,,,,,0.00,0.00,0,0,0,0,0,0,0,0,0,0,0,0,0
20200316,044988,玉晶光統一95購01,,,,,0.00,0.00,0,0,0,0,0,0,0,0,0,0,0,0,0
20200316,04498P,台積電富邦94售04,,,,,0.00,0.00,0,0,0,0,0,0,0,0,0,0,0,0,0
20200316,044992,力山國泰94購01,,,,,0.00,0.00,0,0,0,0,0,0,0,0,0,0,0,0,0
20200316,044995,大立光國泰94購01,,,,,0.00,0.00,0,0,0,0,0,0,0,0,0,0,0,0,0
20200316,044996,嘉晶國泰95購01,0.71,0.73,0.62,0.62,-0.08,-11.43,101000,7,72310,0,0,0,0,0,0,91000,10000,81000,81000
20200316,044998,玉晶光國泰94購01,,,,,0.00,0.00,0,0,0,0,0,0,0,0,0,0,0,0,0
20200316,04499P,滬深2X統一94售03,,,,,0.00,0.00,0,0,0,0,0,0,0,0,0,0,0,0,0
20200316,045001,旺宏富邦94購01,,,,,0.00,0.00,0,0,0,0,0,0,0,0,0,0,0,0,0
20200316,04500P,燿華統一94售01,3.15,3.18,3.14,3.18,+0.42,15.22,12000,7,37840,0,0,0,0,0,0,12000,0,12000,12000
20200316,045015,玉晶光元大94購01,0.10,0.10,0.10,0.10,0.00,0.00,10000,1,1000,0,0,0,0,0,0,10000,0,10000,10000
20200316,045016,創意元大94購01,,,,,0.00,0.00,0,0,0,0,0,0,0,0,0,0,0,0,0
20200316,04501P,元油2X元富98售07,,,,,0.00,0.00,0,0,0,0,0,0,0,0,0,0,0,0,0
20200316,045021,臺股指中信94購02,,,,,0.00,0.00,0,0,0,0,0,0,0,0,0,0,0,0,0
20200316,04502P,元油2X元富98售08,,,,,0.00,0.00,0,0,0,0,0,0,0,0,0,0,0,0,0
20200316,04503P,元油2X元富98售09,,,,,0.00,0.00,0,0,0,0,0,0,0,0,0,0,0,0,0
20200316,04504P,台積電元富94售04,0.23,0.23,0.23,0.23,-0.09,-28.12,3000,1,690,0,0,0,0,0,0,3000,0,3000,3000
20200316,045053,聯發科元富98購01,0.27,0.30,0.17,0.18,-0.12,-40.0,2231000,77,520420,0,0,0,0,0,0,90000,2081000,-1991000,-1991000
20200316,045054,聯發科元富98購02,0.53,0.54,0.32,0.32,-0.23,-41.82,471000,21,192930,0,0,0,0,0,0,224000,170000,54000,54000
20200316,045055,聯發科元富98購03,1.15,1.16,0.80,0.83,-0.37,-30.83,854000,40,788560,0,0,0,0,0,0,519000,139000,380000,380000
20200316,045058,華邦電國泰94購01,,,,,0.00,0.00,0,0,0,0,0,0,0,0,0,0,0,0,0
20200316,04505P,佳世達元富96售03,1.76,1.79,1.75,1.79,+0.01,0.56,30000,3,52780,0,0,0,0,0,0,30000,0,30000,30000
20200316,04506P,旺宏元大94售06,0.80,1.08,0.74,1.08,+0.04,3.85,44000,4,43780,0,0,0,0,0,0,32000,12000,20000,20000
20200316,045071,奇力新元大94購01,,,,,0.00,0.00,0,0,0,0,0,0,0,0,0,0,0,0,0
20200316,04507P,台光電元大94售03,,,,,0.00,0.00,0,0,0,0,0,0,0,0,0,0,0,0,0
20200316,045086,玉晶光元大94購02,,,,,0.00,0.00,0,0,0,0,0,0,0,0,0,0,0,0,0
20200316,045087,玉晶光元大95購01,0.46,0.51,0.27,0.27,-0.24,-47.06,274000,16,100000,0,0,0,0,0,0,191000,83000,108000,108000
20200316,045088,康控元大94購02,,,,,0.00,0.00,0,0,0,0,0,0,0,0,0,0,0,0,0
20200316,045089,中磊元大94購01,,,,,0.00,0.00,0,0,0,0,0,0,0,0,0,0,0,0,0
20200316,04508P,臺股指元大94售03,2.40,2.92,2.33,2.78,0.00,0.00,1000000,100,2605200,0,0,0,0,0,0,1000000,1000000,0,0
20200316,045095,緯穎元大94購02,,,,,0.00,0.00,0,0,0,0,0,0,0,0,0,0,0,0,0
20200316,04509P,臺股指元大94售04,,,,,0.00,0.00,0,0,0,0,0,0,0,0,0,0,0,0,0
20200316,045101,玉晶光中信94購01,,,,,0.00,0.00,0,0,0,0,0,0,0,0,0,0,0,0,0
20200316,045103,上海銀亞東94購01,,,,,0.00,0.00,0,0,0,0,0,0,0,0,0,0,0,0,0
20200316,045106,玉晶光群益95購01,0.32,0.32,0.22,0.22,0.00,0.00,20000,2,5400,0,0,0,0,0,0,10000,10000,0,0
20200316,04510P,臺股指元大94售05,,,,,0.00,0.00,0,0,0,0,0,0,0,0,0,0,0,0,0
20200316,045115,玉晶光永豐94購01,,,,,0.00,0.00,0,0,0,0,0,0,0,0,0,0,0,0,0
20200316,04511P,臺股指元大94售06,,,,,0.00,0.00,0,0,0,0,0,0,0,0,0,0,0,0,0
20200316,04512P,臺股指元大94售07,,,,,0.00,0.00,0,0,0,0,0,0,0,0,0,0,0,0,0
20200316,04513P,元石油中信94售01,,,,,0.00,0.00,0,0,0,0,0,0,0,0,0,0,0,0,0
20200316,04514P,元石油中信97售01,,,,,0.00,0.00,0,0,0,0,0,0,0,0,0,0,0,0,0
20200316,04515P,元油2X群益97售02,,,,,0.00,0.00,0,0,0,0,0,0,0,0,0,0,0,0,0
20200316,045161,玉晶光國泰94購03,,,,,0.00,0.00,0,0,0,0,0,0,0,0,0,0,0,0,0
20200316,045162,玉晶光國泰94購04,,,,,0.00,0.00,0,0,0,0,0,0,0,0,0,0,0,0,0
20200316,04516P,台積電群益94售07,,,,,0.00,0.00,0,0,0,0,0,0,0,0,0,0,0,0,0
20200316,045172,欣興兆豐94購01,0.06,0.06,0.05,0.05,-0.04,-44.44,800000,80,44000,0,0,0,0,0,0,0,800000,-800000,-800000
20200316,045173,A50正2國票95購01,,,,,0.00,0.00,0,0,0,0,0,0,0,0,0,0,0,0,0
20200316,04517P,宏達電群益95售01,3.23,3.23,3.23,3.23,+0.55,20.52,5000,1,16150,0,0,0,0,0,0,5000,0,5000,5000
20200316,045185,致伸統一94購01,,,,,0.00,0.00,0,0,0,0,0,0,0,0,0,0,0,0,0
20200316,045189,大立光元富98購01,0.67,0.67,0.44,0.45,-0.22,-32.84,3703000,188,1955400,0,0,0,0,0,0,2011000,1061000,950000,950000
20200316,04518P,高鐵群益95售01,2.32,2.32,2.20,2.21,-0.31,-12.3,30000,4,68450,0,0,0,0,0,0,5000,25000,-20000,-20000
20200316,04519P,國泰金群益94售01,,,,,0.00,0.00,0,0,0,0,0,0,0,0,0,0,0,0,0
20200316,045208,力成國泰94購01,,,,,0.00,0.00,0,0,0,0,0,0,0,0,0,0,0,0,0
20200316,045209,T50反1富邦94購01,,,,,0.00,0.00,0,0,0,0,0,0,0,0,0,0,0,0,0
20200316,04520P,欣興群益94售02,,,,,0.00,0.00,0,0,0,0,0,0,0,0,0,0,0,0,0
20200316,045213,A50正2元大95購01,,,,,0.00,0.00,0,0,0,0,0,0,0,0,0,0,0,0,0
20200316,04521P,元油2X日盛94售02,,,,,0.00,0.00,0,0,0,0,0,0,0,0,0,0,0,0,0
20200316,045220,漢唐元大94購01,0.53,0.57,0.33,0.33,-0.05,-13.16,160000,15,76600,0,0,0,0,0,0,70000,90000,-20000,-20000
20200316,04522P,卜蜂凱基94售02,,,,,0.00,0.00,0,0,0,0,0,0,0,0,0,0,0,0,0
20200316,045231,南電元大94購01,,,,,0.00,0.00,0,0,0,0,0,0,0,0,0,0,0,0,0
20200316,04523P,亞德客凱基94售02,,,,,0.00,0.00,0,0,0,0,0,0,0,0,0,0,0,0,0
20200316,04524P,台積電凱基94售13,,,,,0.00,0.00,0,0,0,0,0,0,0,0,0,0,0,0,0
20200316,045250,華通凱基94購01,1.29,1.29,1.29,1.29,0.00,0.00,3000,1,3870,0,0,0,0,0,0,0,3000,-3000,-3000
20200316,04525P,台積電凱基94售14,,,,,0.00,0.00,0,0,0,0,0,0,0,0,0,0,0,0,0
20200316,045265,和鑫凱基94購01,,,,,0.00,0.00,0,0,0,0,0,0,0,0,0,0,0,0,0
20200316,04526P,美律凱基94售03,,,,,0.00,0.00,0,0,0,0,0,0,0,0,0,0,0,0,0
20200316,045272,元油2X統一94購01,,,,,0.00,0.00,0,0,0,0,0,0,0,0,0,0,0,0,0
20200316,04527P,大立光凱基94售04,0.59,0.61,0.59,0.61,-0.19,-23.75,8000,2,4760,0,0,0,0,0,0,8000,0,8000,8000
20200316,045280,儒鴻富邦94購01,,,,,0.00,0.00,0,0,0,0,0,0,0,0,0,0,0,0,0
20200316,045287,元油2X元大95購01,0.01,0.01,0.01,0.01,0.00,0.00,15000,1,150,0,0,0,0,0,0,0,0,0,0
20200316,045288,元油2X元大95購02,,,,,0.00,0.00,0,0,0,0,0,0,0,0,0,0,0,0,0
20200316,04528P,智原凱基94售01,,,,,0.00,0.00,0,0,0,0,0,0,0,0,0,0,0,0,0
20200316,045293,鴻海元大94購01,0.20,0.20,0.11,0.11,-0.09,-45.0,20000,11,3020,0,0,0,0,0,0,0,10000,-10000,-10000
20200316,045298,旺宏元大94購01,0.57,0.57,0.57,0.57,+0.22,62.86,30000,1,17100,0,0,0,0,0,0,30000,0,30000,30000
20200316,04529P,正文凱基94售04,1.57,1.57,1.57,1.57,+0.04,2.61,10000,1,15700,0,0,0,0,0,0,0,10000,-10000,-10000
20200316,04530P,上海銀凱基94售03,,,,,0.00,0.00,0,0,0,0,0,0,0,0,0,0,0,0,0
20200316,045311,GIS元大94購01,,,,,0.00,0.00,0,0,0,0,0,0,0,0,0,0,0,0,0
20200316,04531P,台郡凱基94售02,,,,,0.00,0.00,0,0,0,0,0,0,0,0,0,0,0,0,0
20200316,045325,元油2X永豐94購01,,,,,0.00,0.00,0,0,0,0,0,0,0,0,0,0,0,0,0
20200316,04532P,臺股指凱基94售04,,,,,0.00,0.00,0,0,0,0,0,0,0,0,0,0,0,0,0
20200316,045331,旺宏群益94購01,0.31,0.31,0.13,0.13,-0.03,-18.75,20000,3,4450,0,0,0,0,0,0,10000,10000,0,0
20200316,045337,滬深2X凱基95購01,,,,,0.00,0.00,0,0,0,0,0,0,0,0,0,0,0,0,0
20200316,04533P,臺股指凱基94售05,,,,,0.00,0.00,0,0,0,0,0,0,0,0,0,0,0,0,0
20200316,04534P,臻鼎元富94售03,,,,,0.00,0.00,0,0,0,0,0,0,0,0,0,0,0,0,0
20200316,04535P,華新統一94售01,,,,,0.00,0.00,0,0,0,0,0,0,0,0,0,0,0,0,0
20200316,04536P,長榮航統一94售01,2.63,2.63,2.63,2.63,+0.02,0.77,5000,1,13150,0,0,0,0,0,0,5000,0,5000,5000
20200316,045371,元石油元大95購01,0.02,0.02,0.02,0.02,0.00,0.00,1000,1,20,0,0,0,0,0,0,0,0,0,0
20200316,04537P,新光金統一94售01,,,,,0.00,0.00,0,0,0,0,0,0,0,0,0,0,0,0,0
20200316,04538P,TPK台新94售01,,,,,0.00,0.00,0,0,0,0,0,0,0,0,0,0,0,0,0
20200316,045396,群創國泰94購01,,,,,0.00,0.00,0,0,0,0,0,0,0,0,0,0,0,0,0
20200316,04539P,力山永豐94售02,,,,,0.00,0.00,0,0,0,0,0,0,0,0,0,0,0,0,0
20200316,04540P,聯詠永豐94售02,0.11,0.11,0.11,0.11,-0.04,-26.67,5000,1,550,0,0,0,0,0,0,5000,0,5000,5000
20200316,045410,華邦電群益94購01,,,,,0.00,0.00,0,0,0,0,0,0,0,0,0,0,0,0,0
20200316,045414,康控群益94購02,,,,,0.00,0.00,0,0,0,0,0,0,0,0,0,0,0,0,0
20200316,04541P,智易永豐94售03,,,,,0.00,0.00,0,0,0,0,0,0,0,0,0,0,0,0,0
20200316,045428,彩晶凱基94購01,0.19,0.19,0.10,0.10,-0.01,-9.09,105000,11,10950,0,0,0,0,0,0,5000,100000,-95000,-95000
20200316,04542P,致伸永豐94售01,,,,,0.00,0.00,0,0,0,0,0,0,0,0,0,0,0,0,0
20200316,045435,鴻海統一94購01,0.50,0.50,0.32,0.32,+0.05,18.52,57000,3,26440,0,0,0,0,0,0,40000,10000,30000,30000
20200316,045437,大立光統一94購02,,,,,0.00,0.00,0,0,0,0,0,0,0,0,0,0,0,0,0
20200316,045438,台郡統一94購01,,,,,0.00,0.00,0,0,0,0,0,0,0,0,0,0,0,0,0
20200316,04543P,鴻海富邦95售03,0.91,1.06,0.84,1.05,+0.43,69.35,155000,16,145900,0,0,0,0,0,0,65000,120000,-55000,-55000
20200316,045443,群創元富98購01,0.54,0.54,0.44,0.44,+0.01,2.33,20000,2,9800,0,0,0,0,0,0,10000,10000,0,0
20200316,045444,群創元富98購02,0.69,0.69,0.50,0.50,-0.11,-18.03,227000,25,134240,0,0,0,0,0,0,10000,217000,-207000,-207000
20200316,045446,鴻海國泰94購01,,,,,0.00,0.00,0,0,0,0,0,0,0,0,0,0,0,0,0
20200316,045447,鴻海國泰94購02,,,,,0.00,0.00,0,0,0,0,0,0,0,0,0,0,0,0,0
20200316,045449,嘉聯益國泰94購01,,,,,0.00,0.00,0,0,0,0,0,0,0,0,0,0,0,0,0
20200316,04544P,欣興富邦96售02,,,,,0.00,0.00,0,0,0,0,0,0,0,0,0,0,0,0,0
20200316,04545P,國巨元大94售05,0.02,0.02,0.02,0.02,0.00,0.00,480000,4,9600,0,0,0,0,0,0,480000,0,480000,480000
20200316,045468,健策元大94購01,1.07,1.07,1.07,1.07,0.00,0.00,10000,1,10700,0,0,0,0,0,0,10000,10000,0,0
20200316,04546P,台積電元大94售09,0.55,0.55,0.55,0.55,-0.42,-43.3,10000,2,5500,0,0,0,0,0,0,10000,0,10000,10000
20200316,045470,康控元大94購03,,,,,0.00,0.00,0,0,0,0,0,0,0,0,0,0,0,0,0
20200316,045479,T50反1中信95購01,0.56,0.99,0.56,0.82,+0.22,36.67,746000,17,588630,0,0,0,0,0,0,549000,0,549000,549000
20200316,04547P,高鐵元大94售01,2.81,2.87,2.81,2.87,-0.28,-8.89,15000,2,42750,0,0,0,0,0,0,15000,0,15000,15000
20200316,045480,滬深2X中信94購01,,,,,0.00,0.00,0,0,0,0,0,0,0,0,0,0,0,0,0
20200316,045484,聯電亞東94購01,,,,,0.00,0.00,0,0,0,0,0,0,0,0,0,0,0,0,0
20200316,04548P,大立光元大94售14,2.47,2.47,2.47,2.47,-1.37,-35.68,10000,2,24700,0,0,0,0,0,0,10000,0,10000,10000
20200316,04549P,茂林元大94售02,0.20,0.25,0.20,0.25,+0.02,8.7,92000,7,20350,0,0,0,0,0,0,62000,30000,32000,32000
20200316,045504,群創凱基94購01,0.21,0.21,0.13,0.13,-0.02,-13.33,212000,20,36240,0,0,0,0,0,0,62000,192000,-130000,-130000
20200316,04550P,超眾元大94售01,1.85,2.52,1.85,2.47,-0.01,-0.4,180000,18,428900,0,0,0,0,0,0,10000,170000,-160000,-160000
20200316,045516,聯茂統一94購01,,,,,0.00,0.00,0,0,0,0,0,0,0,0,0,0,0,0,0
20200316,045517,元油2X元富98購01,0.06,0.08,0.04,0.04,-0.04,-50.0,335000,12,20400,0,0,0,0,0,0,0,0,0,0
20200316,04551P,台表科元大94售02,0.61,0.61,0.61,0.61,-0.12,-16.44,20000,2,12200,0,0,0,0,0,0,0,20000,-20000,-20000
20200316,045522,滬深2X永豐94購01,,,,,0.00,0.00,0,0,0,0,0,0,0,0,0,0,0,0,0
20200316,04552P,南電元大94售06,,,,,0.00,0.00,0,0,0,0,0,0,0,0,0,0,0,0,0
20200316,045534,深中小群益94購01,,,,,0.00,0.00,0,0,0,0,0,0,0,0,0,0,0,0,0
20200316,045535,A50正2群益94購01,0.03,0.03,0.03,0.03,0.00,0.00,50000,5,1500,0,0,0,0,0,0,0,50000,-50000,-50000
20200316,045537,華新群益94購01,,,,,0.00,0.00,0,0,0,0,0,0,0,0,0,0,0,0,0
20200316,04553P,S&P正2中信95售01,2.40,2.40,2.40,2.40,+0.38,18.81,10000,1,24000,0,0,0,0,0,0,0,0,0,0
20200316,045543,百和群益94購01,,,,,0.00,0.00,0,0,0,0,0,0,0,0,0,0,0,0,0
20200316,045547,滬深2X國票95購01,,,,,0.00,0.00,0,0,0,0,0,0,0,0,0,0,0,0,0
20200316,04554P,可成中信94售01,,,,,0.00,0.00,0,0,0,0,0,0,0,0,0,0,0,0,0
20200316,04555P,元油2X群益95售01,7.40,7.40,7.40,7.40,+0.30,4.23,50000,1,370000,0,0,0,0,0,0,50000,50000,0,0
20200316,045568,上証2X元大95購01,,,,,0.00,0.00,0,0,0,0,0,0,0,0,0,0,0,0,0
20200316,04556P,大成鋼群益94售02,,,,,0.00,0.00,0,0,0,0,0,0,0,0,0,0,0,0,0
20200316,045571,元油2X元大95購04,,,,,0.00,0.00,0,0,0,0,0,0,0,0,0,0,0,0,0
20200316,045572,元油2X元大98購01,0.04,0.08,0.04,0.05,+0.02,66.67,738000,13,35710,0,0,0,0,0,0,0,0,0,0
20200316,04557P,茂林群益94售03,0.55,0.56,0.55,0.56,-0.18,-24.32,40000,2,22200,0,0,0,0,0,0,40000,0,40000,40000
20200316,04558P,瑞昱日盛94售01,,,,,0.00,0.00,0,0,0,0,0,0,0,0,0,0,0,0,0
20200316,045598,上証2X中信94購02,0.03,0.03,0.02,0.02,0.00,0.00,100000,10,2500,0,0,0,0,0,0,0,100000,-100000,-100000
20200316,04559P,華通凱基94售03,1.19,1.49,1.19,1.49,+0.09,6.43,16000,2,22040,0,0,0,0,0,0,0,16000,-16000,-16000
20200316,045600,道瓊指國票95購01,,,,,0.00,0.00,0,0,0,0,0,0,0,0,0,0,0,0,0
20200316,04560P,台積電凱基94售16,0.21,0.21,0.21,0.21,0.00,0.00,200000,2,42000,0,0,0,0,0,0,200000,0,200000,200000
20200316,045618,元油2X永豐98購01,0.04,0.06,0.04,0.06,+0.02,50.0,95000,2,4500,0,0,0,0,0,0,0,0,0,0
20200316,04561P,台積電凱基94售17,,,,,0.00,0.00,0,0,0,0,0,0,0,0,0,0,0,0,0
20200316,04562P,南亞科凱基94售02,,,,,0.00,0.00,0,0,0,0,0,0,0,0,0,0,0,0,0
20200316,04563P,可成凱基94售05,1.64,1.68,1.64,1.68,-0.91,-35.14,7000,2,11720,0,0,0,0,0,0,6000,1000,5000,5000
20200316,04564P,大立光凱基94售06,0.50,1.00,0.50,1.00,+0.47,88.68,107000,14,69230,0,0,0,0,0,0,17000,90000,-73000,-73000
20200316,045657,T50反1國泰94購01,0.29,0.60,0.29,0.60,-0.20,-25.0,255000,10,114490,0,0,0,0,0,0,151000,0,151000,151000
20200316,045659,華新科國泰94購01,,,,,0.00,0.00,0,0,0,0,0,0,0,0,0,0,0,0,0
20200316,04565P,聯詠凱基94售01,0.76,0.76,0.76,0.76,-0.17,-18.28,6000,1,4560,0,0,0,0,0,0,0,6000,-6000,-6000
20200316,045662,華邦電統一94購02,,,,,0.00,0.00,0,0,0,0,0,0,0,0,0,0,0,0,0
20200316,045663,元油2X元富94購01,,,,,0.00,0.00,0,0,0,0,0,0,0,0,0,0,0,0,0
20200316,045664,元油2X元富96購01,,,,,0.00,0.00,0,0,0,0,0,0,0,0,0,0,0,0,0
20200316,04566P,GIS凱基94售04,1.40,1.40,1.33,1.38,-0.40,-22.47,18000,3,24660,0,0,0,0,0,0,6000,12000,-6000,-6000
20200316,045678,華新科元大95購01,1.14,1.21,0.80,0.80,-0.28,-25.93,506000,30,525350,0,0,0,0,0,0,349000,197000,152000,152000
20200316,045679,欣興元大94購01,,,,,0.00,0.00,0,0,0,0,0,0,0,0,0,0,0,0,0
20200316,04567P,臺股指凱基95售01,1.08,2.10,1.08,2.10,+1.10,110.0,137000,17,252050,0,0,0,0,0,0,27000,105000,-78000,-78000
20200316,045685,康控元大95購01,,,,,0.00,0.00,0,0,0,0,0,0,0,0,0,0,0,0,0
20200316,04568P,瑞昱兆豐94售02,0.90,1.20,0.90,1.20,+0.24,25.0,397000,16,408290,0,0,0,0,0,0,26000,371000,-345000,-345000
20200316,04569P,聯詠兆豐94售01,0.25,0.31,0.25,0.31,-0.08,-20.51,7000,2,1810,0,0,0,0,0,0,7000,0,7000,7000
20200316,045700,道瓊指中信94購01,0.14,0.14,0.05,0.05,-0.08,-61.54,23000,2,1870,0,0,0,0,0,0,0,0,0,0
20200316,04570P,台積電國票94售05,,,,,0.00,0.00,0,0,0,0,0,0,0,0,0,0,0,0,0
20200316,04571P,華新科國泰95售03,1.07,1.40,0.98,1.40,+0.28,25.0,488000,22,581160,0,0,0,0,0,0,364000,266000,98000,98000
20200316,04572P,T50反1統一94售06,,,,,0.00,0.00,0,0,0,0,0,0,0,0,0,0,0,0,0
20200316,045736,台積電群益94購01,2.95,3.18,1.48,1.48,-1.72,-53.75,97000,13,224290,0,0,0,0,0,0,60000,47000,13000,13000
20200316,045737,友達群益94購01,,,,,0.00,0.00,0,0,0,0,0,0,0,0,0,0,0,0,0
20200316,04573P,聯電統一94售02,,,,,0.00,0.00,0,0,0,0,0,0,0,0,0,0,0,0,0
20200316,04574P,台達電統一94售05,,,,,0.00,0.00,0,0,0,0,0,0,0,0,0,0,0,0,0
20200316,045750,鈺齊富邦94購01,0.30,0.30,0.29,0.29,0.00,0.00,28000,3,8320,0,0,0,0,0,0,0,28000,-28000,-28000
20200316,045753,大立光國泰94購02,0.43,0.43,0.20,0.20,-0.28,-58.33,86000,17,30710,0,0,0,0,0,0,47000,33000,14000,14000
20200316,045754,大立光國泰94購03,0.65,0.65,0.34,0.36,-0.20,-35.71,121000,11,68700,0,0,0,0,0,0,70000,61000,9000,9000
20200316,045758,易華電國泰94購01,,,,,0.00,0.00,0,0,0,0,0,0,0,0,0,0,0,0,0
20200316,045759,T50反1統一94購02,1.04,1.04,1.04,1.04,-0.23,-18.11,10000,1,10400,0,0,0,0,0,0,10000,10000,0,0
20200316,04575P,新日興統一94售02,,,,,0.00,0.00,0,0,0,0,0,0,0,0,0,0,0,0,0
20200316,045764,智易統一94購01,,,,,0.00,0.00,0,0,0,0,0,0,0,0,0,0,0,0,0
20200316,045767,大立光元富95購01,1.70,1.72,1.12,1.18,-0.64,-35.16,95000,12,124790,0,0,0,0,0,0,30000,75000,-45000,-45000
20200316,045768,大立光元富95購02,1.21,1.21,0.65,0.70,-0.63,-47.37,777000,23,789570,0,0,0,0,0,0,636000,139000,497000,497000
20200316,04576P,上海銀統一94售04,,,,,0.00,0.00,0,0,0,0,0,0,0,0,0,0,0,0,0
20200316,04577P,康友元富94售02,,,,,0.00,0.00,0,0,0,0,0,0,0,0,0,0,0,0,0
20200316,045780,奇鋐元大94購01,,,,,0.00,0.00,0,0,0,0,0,0,0,0,0,0,0,0,0
20200316,04578P,微星富邦96售01,,,,,0.00,0.00,0,0,0,0,0,0,0,0,0,0,0,0,0
20200316,045793,台積電兆豐93購03,,,,,0.00,0.00,0,0,0,0,0,0,0,0,0,0,0,0,0
20200316,045794,奇力新兆豐93購01,0.88,0.88,0.88,0.88,+0.52,144.44,10000,1,8800,0,0,0,0,0,0,10000,0,10000,10000
20200316,045795,瀚宇博兆豐94購01,,,,,0.00,0.00,0,0,0,0,0,0,0,0,0,0,0,0,0
20200316,045796,廣達中信93購01,,,,,0.00,0.00,0,0,0,0,0,0,0,0,0,0,0,0,0
20200316,045797,健策中信93購01,,,,,0.00,0.00,0,0,0,0,0,0,0,0,0,0,0,0,0
20200316,045798,華邦電亞東93購02,,,,,0.00,0.00,0,0,0,0,0,0,0,0,0,0,0,0,0
20200316,045799,微星亞東93購01,,,,,0.00,0.00,0,0,0,0,0,0,0,0,0,0,0,0,0
20200316,04579P,聯茂台新94售01,,,,,0.00,0.00,0,0,0,0,0,0,0,0,0,0,0,0,0
20200316,045800,漢唐亞東93購01,,,,,0.00,0.00,0,0,0,0,0,0,0,0,0,0,0,0,0
20200316,045803,旺宏國票93購01,,,,,0.00,0.00,0,0,0,0,0,0,0,0,0,0,0,0,0
20200316,045807,上緯控國票93購01,0.01,0.01,0.01,0.01,0.00,0.00,10000,1,100,0,0,0,0,0,0,10000,0,10000,10000
20200316,04580P,楠梓電康和94售02,,,,,0.00,0.00,0,0,0,0,0,0,0,0,0,0,0,0,0
20200316,045814,可成麥證93購01,,,,,0.00,0.00,0,0,0,0,0,0,0,0,0,0,0,0,0
20200316,045817,滬深2X凱基95購02,0.16,0.16,0.15,0.15,-0.07,-31.82,809000,15,129340,0,0,0,0,0,0,0,809000,-809000,-809000
20200316,045818,鴻海凱基93購10,,,,,0.00,0.00,0,0,0,0,0,0,0,0,0,0,0,0,0
20200316,04581P,楠梓電康和94售03,,,,,0.00,0.00,0,0,0,0,0,0,0,0,0,0,0,0,0
20200316,045822,TPK凱基93購03,,,,,0.00,0.00,0,0,0,0,0,0,0,0,0,0,0,0,0
20200316,045824,嘉聯益凱基93購02,,,,,0.00,0.00,0,0,0,0,0,0,0,0,0,0,0,0,0
20200316,045825,力成凱基93購02,1.31,1.31,1.31,1.31,+0.44,50.57,50000,1,65500,0,0,0,0,0,0,50000,0,50000,50000
20200316,045829,滬深2X群益95購02,0.03,0.03,0.02,0.02,-0.01,-33.33,55000,2,1150,0,0,0,0,0,0,0,0,0,0
20200316,04582P,燿華康和94售01,,,,,0.00,0.00,0,0,0,0,0,0,0,0,0,0,0,0,0
20200316,045836,群創群益98購01,0.71,0.71,0.69,0.69,+0.14,25.45,210000,2,148900,0,0,0,0,0,0,200000,10000,190000,190000
20200316,045837,群創群益98購02,0.40,0.41,0.40,0.41,+0.03,7.89,93000,3,37800,0,0,0,0,0,0,93000,0,93000,93000
20200316,045838,揚明光群益93購01,,,,,0.00,0.00,0,0,0,0,0,0,0,0,0,0,0,0,0
20200316,04583P,滬深2X永豐94售06,,,,,0.00,0.00,0,0,0,0,0,0,0,0,0,0,0,0,0
20200316,045842,T50反1台新98購01,,,,,0.00,0.00,0,0,0,0,0,0,0,0,0,0,0,0,0
20200316,04584P,楠梓電永豐94售01,1.77,1.77,1.77,1.77,-0.20,-10.15,1000,1,1770,0,0,0,0,0,0,1000,0,1000,1000
20200316,045854,貿聯富邦93購01,,,,,0.00,0.00,0,0,0,0,0,0,0,0,0,0,0,0,0
20200316,045855,緯穎富邦93購01,,,,,0.00,0.00,0,0,0,0,0,0,0,0,0,0,0,0,0
20200316,045856,南亞科國泰94購01,0.09,0.09,0.07,0.07,+0.01,16.67,40000,4,3200,0,0,0,0,0,0,0,40000,-40000,-40000
20200316,045857,友達國泰93購02,,,,,0.00,0.00,0,0,0,0,0,0,0,0,0,0,0,0,0
20200316,045858,元油2X統一94購02,,,,,0.00,0.00,0,0,0,0,0,0,0,0,0,0,0,0,0
20200316,04585P,楠梓電永豐94售02,,,,,0.00,0.00,0,0,0,0,0,0,0,0,0,0,0,0,0
20200316,045860,鴻海統一93購03,,,,,0.00,0.00,0,0,0,0,0,0,0,0,0,0,0,0,0
20200316,045861,智邦統一93購02,0.02,0.02,0.01,0.01,0.00,0.00,140000,5,1500,0,0,0,0,0,0,140000,0,140000,140000
20200316,045862,大立光統一93購02,,,,,0.00,0.00,0,0,0,0,0,0,0,0,0,0,0,0,0
20200316,045864,致伸統一93購01,,,,,0.00,0.00,0,0,0,0,0,0,0,0,0,0,0,0,0
20200316,045865,緯穎統一93購02,,,,,0.00,0.00,0,0,0,0,0,0,0,0,0,0,0,0,0
20200316,045866,南茂統一94購01,0.27,0.27,0.26,0.26,0.00,0.00,60000,2,15700,0,0,0,0,0,0,60000,0,60000,60000
20200316,045867,臺股指統一93購03,,,,,0.00,0.00,0,0,0,0,0,0,0,0,0,0,0,0,0
20200316,045868,臺股指統一93購04,,,,,0.00,0.00,0,0,0,0,0,0,0,0,0,0,0,0,0
20200316,045869,滬深2X元富95購01,,,,,0.00,0.00,0,0,0,0,0,0,0,0,0,0,0,0,0
20200316,04586P,光罩永豐94售02,,,,,0.00,0.00,0,0,0,0,0,0,0,0,0,0,0,0,0
20200316,045870,元油2X元富96購02,,,,,0.00,0.00,0,0,0,0,0,0,0,0,0,0,0,0,0
20200316,045871,元油2X元富96購03,0.06,0.06,0.06,0.06,+0.04,200.0,10000,1,600,0,0,0,0,0,0,0,0,0,0
20200316,045872,元油2X元富98購03,0.05,0.06,0.04,0.06,-0.02,-25.0,2998000,90,153600,0,0,0,0,0,0,0,0,0,0
20200316,045873,元油2X元富98購04,0.09,0.10,0.04,0.04,-0.07,-63.64,1147000,15,57610,0,0,0,0,0,0,0,0,0,0
20200316,045877,友達元富95購01,0.49,0.58,0.47,0.47,-0.01,-2.08,243000,4,115320,0,0,0,0,0,0,243000,0,243000,243000
20200316,04587P,聯發科永豐94售02,,,,,0.00,0.00,0,0,0,0,0,0,0,0,0,0,0,0,0
20200316,045882,滬深2X元大95購01,,,,,0.00,0.00,0,0,0,0,0,0,0,0,0,0,0,0,0
20200316,045883,元油2X元大95購07,,,,,0.00,0.00,0,0,0,0,0,0,0,0,0,0,0,0,0
20200316,04588P,茂林永豐94售04,0.12,0.13,0.12,0.13,0.00,0.00,60000,2,7500,0,0,0,0,0,0,60000,0,60000,60000
20200316,045892,和鑫元大93購03,,,,,0.00,0.00,0,0,0,0,0,0,0,0,0,0,0,0,0
20200316,045897,泰鼎元大93購04,,,,,0.00,0.00,0,0,0,0,0,0,0,0,0,0,0,0,0
20200316,045898,康控元大93購04,,,,,0.00,0.00,0,0,0,0,0,0,0,0,0,0,0,0,0
20200316,04589P,祥碩永豐94售01,0.06,0.06,0.06,0.06,0.00,0.00,139000,2,8340,0,0,0,0,0,0,139000,0,139000,139000
20200316,045906,鴻海中信94購01,0.51,0.55,0.39,0.39,-0.08,-17.02,84000,6,37520,0,0,0,0,0,0,84000,0,84000,84000
20200316,045907,鴻海中信94購02,0.41,0.46,0.38,0.38,-0.15,-28.3,389000,39,154210,0,0,0,0,0,0,189000,200000,-11000,-11000
20200316,04590P,元石油元大97售01,,,,,0.00,0.00,0,0,0,0,0,0,0,0,0,0,0,0,0
20200316,045914,超眾國票93購01,,,,,0.00,0.00,0,0,0,0,0,0,0,0,0,0,0,0,0
20200316,04591P,上銀元大94售01,1.23,1.31,1.23,1.31,+0.05,3.97,18000,16,22380,0,0,0,0,0,0,3000,15000,-12000,-12000
20200316,04592P,台積電元大94售10,0.71,1.35,0.68,1.35,+0.64,90.14,106000,15,89860,0,0,0,0,0,0,103000,15000,88000,88000
20200316,045931,緯穎永豐93購01,4.26,4.26,3.81,3.81,0.00,0.00,143000,4,607530,0,0,0,0,0,0,120000,23000,97000,97000
20200316,045934,燿華群益93購01,,,,,0.00,0.00,0,0,0,0,0,0,0,0,0,0,0,0,0
20200316,045936,富邦金群益94購01,,,,,0.00,0.00,0,0,0,0,0,0,0,0,0,0,0,0,0
20200316,045937,臻鼎群益93購02,,,,,0.00,0.00,0,0,0,0,0,0,0,0,0,0,0,0,0
20200316,04593P,台積電元大94售11,0.46,0.58,0.46,0.58,-0.25,-30.12,70000,8,39400,0,0,0,0,0,0,70000,60000,10000,10000
20200316,045947,欣興兆豐93購04,,,,,0.00,0.00,0,0,0,0,0,0,0,0,0,0,0,0,0
20200316,04594P,緯穎元大94售04,,,,,0.00,0.00,0,0,0,0,0,0,0,0,0,0,0,0,0
20200316,045955,宏碁凱基93購01,,,,,0.00,0.00,0,0,0,0,0,0,0,0,0,0,0,0,0
20200316,045956,英業達凱基93購01,,,,,0.00,0.00,0,0,0,0,0,0,0,0,0,0,0,0,0
20200316,045957,技嘉凱基93購03,,,,,0.00,0.00,0,0,0,0,0,0,0,0,0,0,0,0,0
20200316,045958,技嘉凱基93購04,,,,,0.00,0.00,0,0,0,0,0,0,0,0,0,0,0,0,0
20200316,04595P,臺股指元大94售13,3.80,4.27,3.80,4.27,+0.92,27.46,28000,6,114230,0,0,0,0,0,0,28000,0,28000,28000
20200316,045963,新光金凱基93購01,,,,,0.00,0.00,0,0,0,0,0,0,0,0,0,0,0,0,0
20200316,04596P,臺股指元大94售14,4.31,5.80,4.31,5.75,+1.70,41.98,384000,51,1977100,1000,0,1000,0,0,0,47000,337000,-290000,-289000
20200316,045974,傳奇凱基93購02,,,,,0.00,0.00,0,0,0,0,0,0,0,0,0,0,0,0,0
20200316,045975,祥碩凱基93購04,1.88,1.88,1.88,1.88,+0.17,9.94,10000,1,18800,0,0,0,0,0,0,10000,0,10000,10000
20200316,045979,巨大凱基93購01,,,,,0.00,0.00,0,0,0,0,0,0,0,0,0,0,0,0,0
20200316,04597P,為升凱基94售02,8.10,8.10,8.10,8.10,0.00,0.00,10000,2,81000,0,0,0,0,0,0,10000,0,10000,10000
20200316,045980,百和凱基93購03,,,,,0.00,0.00,0,0,0,0,0,0,0,0,0,0,0,0,0
20200316,045984,亞光麥證93購02,,,,,0.00,0.00,0,0,0,0,0,0,0,0,0,0,0,0,0
20200316,045985,台達電永昌93購01,,,,,0.00,0.00,0,0,0,0,0,0,0,0,0,0,0,0,0
20200316,045986,南亞科永昌93購01,,,,,0.00,0.00,0,0,0,0,0,0,0,0,0,0,0,0,0
20200316,045989,緯穎國泰93購03,,,,,0.00,0.00,0,0,0,0,0,0,0,0,0,0,0,0,0
20200316,04598P,光罩凱基94售03,1.78,2.28,1.78,2.28,+0.02,0.88,73000,4,157860,0,0,0,0,0,0,73000,73000,0,0
20200316,045990,元石油富邦93購02,,,,,0.00,0.00,0,0,0,0,0,0,0,0,0,0,0,0,0
20200316,045991,為升富邦95購01,,,,,0.00,0.00,0,0,0,0,0,0,0,0,0,0,0,0,0
20200316,045992,鴻海富邦94購01,,,,,0.00,0.00,0,0,0,0,0,0,0,0,0,0,0,0,0
20200316,045993,美律富邦93購01,,,,,0.00,0.00,0,0,0,0,0,0,0,0,0,0,0,0,0
20200316,045994,康控富邦94購01,,,,,0.00,0.00,0,0,0,0,0,0,0,0,0,0,0,0,0
20200316,045995,台表科富邦93購01,,,,,0.00,0.00,0,0,0,0,0,0,0,0,0,0,0,0,0
20200316,045996,南電富邦94購01,0.69,0.69,0.69,0.69,+0.01,1.47,2000,1,1380,0,0,0,0,0,0,2000,0,2000,2000
20200316,04599P,南亞科凱基94售03,2.49,2.55,2.49,2.55,+0.20,8.51,20000,2,50400,0,0,0,0,0,0,20000,10000,10000,10000
20200316,046001,友達統一93購03,,,,,0.00,0.00,0,0,0,0,0,0,0,0,0,0,0,0,0
20200316,046002,美律統一93購01,,,,,0.00,0.00,0,0,0,0,0,0,0,0,0,0,0,0,0
20200316,046004,群創統一93購02,,,,,0.00,0.00,0,0,0,0,0,0,0,0,0,0,0,0,0
20200316,04600P,可成凱基94售07,,,,,0.00,0.00,0,0,0,0,0,0,0,0,0,0,0,0,0
20200316,046011,欣興元富95購01,0.07,0.07,0.07,0.07,-0.01,-12.5,1040000,5,72800,0,0,0,0,0,0,1040000,0,1040000,1040000
20200316,04601P,大立光凱基94售07,1.14,1.50,1.14,1.50,+0.32,27.12,29000,2,40260,0,0,0,0,0,0,29000,0,29000,29000
20200316,046020,滬深2X元大95購02,,,,,0.00,0.00,0,0,0,0,0,0,0,0,0,0,0,0,0
20200316,04602P,聯詠凱基94售02,0.70,0.70,0.70,0.70,-0.44,-38.6,6000,1,4200,0,0,0,0,0,0,0,6000,-6000,-6000
20200316,04603P,訊芯凱基94售03,1.90,1.90,1.90,1.90,-0.16,-7.77,60000,3,114000,0,0,0,0,0,0,0,60000,-60000,-60000
20200316,046046,世紀鋼元大93購03,0.02,0.02,0.02,0.02,-0.02,-50.0,10000,1,200,0,0,0,0,0,0,10000,0,10000,10000
20200316,046047,臺股指元大93購17,,,,,0.00,0.00,0,0,0,0,0,0,0,0,0,0,0,0,0
20200316,046048,臺股指元大93購18,,,,,0.00,0.00,0,0,0,0,0,0,0,0,0,0,0,0,0
20200316,046049,臺股指元大93購19,,,,,0.00,0.00,0,0,0,0,0,0,0,0,0,0,0,0,0
20200316,04604P,華新科國票95售01,,,,,0.00,0.00,0,0,0,0,0,0,0,0,0,0,0,0,0
20200316,046050,臺股指元大93購20,0.33,0.36,0.20,0.21,-0.45,-68.18,59000,8,14380,0,0,0,0,0,0,13000,36000,-23000,-23000
20200316,046051,華通亞東93購01,,,,,0.00,0.00,0,0,0,0,0,0,0,0,0,0,0,0,0
20200316,046052,國巨中信93購01,,,,,0.00,0.00,0,0,0,0,0,0,0,0,0,0,0,0,0
20200316,046053,滬深2X群益94購01,,,,,0.00,0.00,0,0,0,0,0,0,0,0,0,0,0,0,0
20200316,046054,冠德群益93購01,,,,,0.00,0.00,0,0,0,0,0,0,0,0,0,0,0,0,0
20200316,04605P,台積電兆豐94售03,0.69,1.30,0.68,1.27,+0.76,149.02,181000,26,155230,0,0,0,0,0,0,151000,140000,11000,11000
20200316,046061,中石化凱基98購01,,,,,0.00,0.00,0,0,0,0,0,0,0,0,0,0,0,0,0
20200316,046064,中工凱基94購01,0.17,0.17,0.11,0.11,-0.09,-45.0,50000,3,7000,0,0,0,0,0,0,15000,50000,-35000,-35000
20200316,046065,益航凱基93購02,,,,,0.00,0.00,0,0,0,0,0,0,0,0,0,0,0,0,0
20200316,046066,長榮航凱基94購01,,,,,0.00,0.00,0,0,0,0,0,0,0,0,0,0,0,0,0
20200316,04606P,高股息中信96售01,1.43,1.50,1.43,1.50,+0.12,8.7,13000,2,18730,0,0,0,0,0,0,13000,0,13000,13000
20200316,04607P,A50中信94售01,0.69,0.69,0.69,0.69,+0.04,6.15,8000,1,5520,0,0,0,0,0,0,8000,0,8000,8000
20200316,046087,亞德客兆豐93購01,1.37,1.37,0.94,0.94,+0.20,27.03,13000,2,16520,0,0,0,0,0,0,10000,3000,7000,7000
20200316,04608P,晶相光永豐94售02,,,,,0.00,0.00,0,0,0,0,0,0,0,0,0,0,0,0,0
20200316,04609P,健策永豐94售01,0.25,0.25,0.25,0.25,0.00,0.00,10000,1,2500,0,0,0,0,0,0,10000,10000,0,0
20200316,046108,A50正2元大95購02,,,,,0.00,0.00,0,0,0,0,0,0,0,0,0,0,0,0,0
20200316,04610P,世紀鋼永豐94售03,0.30,0.30,0.30,0.30,-0.10,-25.0,10000,1,3000,0,0,0,0,0,0,10000,0,10000,10000
20200316,046113,旺宏元大93購04,0.47,0.47,0.37,0.37,+0.01,2.78,20000,2,8400,0,0,0,0,0,0,20000,0,20000,20000
20200316,04611P,元油2X群益98售02,,,,,0.00,0.00,0,0,0,0,0,0,0,0,0,0,0,0,0
20200316,04612P,上銀群益94售01,1.00,1.12,1.00,1.12,+0.17,17.89,7000,2,7360,0,0,0,0,0,0,7000,0,7000,7000
20200316,046134,致新國泰93購02,,,,,0.00,0.00,0,0,0,0,0,0,0,0,0,0,0,0,0
20200316,04613P,台積電群益94售10,,,,,0.00,0.00,0,0,0,0,0,0,0,0,0,0,0,0,0
20200316,046142,康舒統一93購01,,,,,0.00,0.00,0,0,0,0,0,0,0,0,0,0,0,0,0
20200316,046145,矽力元富95購01,,,,,0.00,0.00,0,0,0,0,0,0,0,0,0,0,0,0,0
20200316,046147,道瓊指中信96購02,0.07,0.11,0.06,0.10,-0.01,-9.09,697000,27,58680,0,0,0,0,0,0,0,0,0,0
20200316,046148,友達中信94購01,0.31,0.31,0.23,0.23,+0.06,35.29,80000,6,20400,0,0,0,0,0,0,0,80000,-80000,-80000
20200316,046149,宏達電國票93購01,,,,,0.00,0.00,0,0,0,0,0,0,0,0,0,0,0,0,0
20200316,04614P,光罩群益94售02,0.68,0.68,0.68,0.68,-0.27,-28.42,110000,1,74800,0,0,0,0,0,0,110000,0,110000,110000
20200316,046154,道瓊指群益94購01,,,,,0.00,0.00,0,0,0,0,0,0,0,0,0,0,0,0,0
20200316,046155,道瓊反群益94購01,1.24,1.31,1.24,1.27,-0.11,-7.97,127000,14,161940,0,0,0,0,0,0,0,127000,-127000,-127000
20200316,046159,群創群益98購04,0.32,0.32,0.32,0.32,+0.07,28.0,1000,1,320,0,0,0,0,0,0,1000,0,1000,1000
20200316,04615P,華新科群益94售03,,,,,0.00,0.00,0,0,0,0,0,0,0,0,0,0,0,0,0
20200316,046161,易華電群益93購02,,,,,0.00,0.00,0,0,0,0,0,0,0,0,0,0,0,0,0
20200316,046164,健策兆豐93購03,0.18,0.18,0.18,0.18,+0.05,38.46,10000,1,1800,0,0,0,0,0,0,10000,0,10000,10000
20200316,046165,中磊兆豐93購01,,,,,0.00,0.00,0,0,0,0,0,0,0,0,0,0,0,0,0
20200316,046166,嘉聯益兆豐93購01,,,,,0.00,0.00,0,0,0,0,0,0,0,0,0,0,0,0,0
20200316,04616P,臺股指群益95售02,,,,,0.00,0.00,0,0,0,0,0,0,0,0,0,0,0,0,0
20200316,04617P,臺股指群益95售03,,,,,0.00,0.00,0,0,0,0,0,0,0,0,0,0,0,0,0
20200316,046180,裕隆凱基93購01,,,,,0.00,0.00,0,0,0,0,0,0,0,0,0,0,0,0,0
20200316,046182,燿華凱基93購04,,,,,0.00,0.00,0,0,0,0,0,0,0,0,0,0,0,0,0
20200316,046184,台光電凱基93購08,,,,,0.00,0.00,0,0,0,0,0,0,0,0,0,0,0,0,0
20200316,046185,正崴凱基93購02,,,,,0.00,0.00,0,0,0,0,0,0,0,0,0,0,0,0,0
20200316,046187,友達凱基93購03,0.98,0.98,0.98,0.98,+0.18,22.5,93000,1,91140,0,0,0,0,0,0,93000,0,93000,93000
20200316,04618P,電子類群益94售02,0.79,1.70,0.70,1.58,-0.33,-17.28,75000,18,103760,0,0,0,0,0,0,9000,64000,-55000,-55000
20200316,046191,新光金凱基98購01,0.38,0.39,0.38,0.39,-0.06,-13.33,75000,2,29150,0,0,0,0,0,0,75000,0,75000,75000
20200316,04619P,華新統一94售02,3.05,3.05,2.98,2.98,+0.14,4.93,6000,6,18150,0,0,0,0,0,0,6000,0,6000,6000
20200316,046200,上海銀凱基93購01,,,,,0.00,0.00,0,0,0,0,0,0,0,0,0,0,0,0,0
20200316,046202,台表科凱基93購04,0.41,0.41,0.39,0.39,+0.02,5.41,20000,2,8000,0,0,0,0,0,0,20000,0,20000,20000
20200316,046203,GIS凱基93購02,,,,,0.00,0.00,0,0,0,0,0,0,0,0,0,0,0,0,0
20200316,046204,致新凱基93購01,,,,,0.00,0.00,0,0,0,0,0,0,0,0,0,0,0,0,0
20200316,046205,明基材凱基93購01,,,,,0.00,0.00,0,0,0,0,0,0,0,0,0,0,0,0,0
20200316,046206,為升國泰93購01,,,,,0.00,0.00,0,0,0,0,0,0,0,0,0,0,0,0,0
20200316,046207,群創國泰94購02,,,,,0.00,0.00,0,0,0,0,0,0,0,0,0,0,0,0,0
20200316,046208,滬深2X元富95購03,0.23,0.23,0.11,0.11,-0.11,-50.0,134000,12,19400,0,0,0,0,0,0,40000,104000,-64000,-64000
20200316,04620P,聯電統一94售04,,,,,0.00,0.00,0,0,0,0,0,0,0,0,0,0,0,0,0
20200316,046216,滬深2X富邦93購02,,,,,0.00,0.00,0,0,0,0,0,0,0,0,0,0,0,0,0
20200316,046217,康友富邦94購01,,,,,0.00,0.00,0,0,0,0,0,0,0,0,0,0,0,0,0
20200316,046218,T50反1元大93購02,0.23,0.40,0.23,0.40,-0.08,-16.67,144000,11,43220,0,0,0,0,0,0,144000,0,144000,144000
20200316,046219,T50反1元大93購03,0.20,0.40,0.20,0.40,+0.07,21.21,5000,2,1600,0,0,0,0,0,0,2000,3000,-1000,-1000
20200316,04621P,楠梓電統一94售02,,,,,0.00,0.00,0,0,0,0,0,0,0,0,0,0,0,0,0
20200316,046220,滬深2X元大95購03,,,,,0.00,0.00,0,0,0,0,0,0,0,0,0,0,0,0,0
20200316,04622P,臺股指統一94售01,1.41,1.41,1.41,1.41,0.00,0.00,1000,1,1410,0,0,0,0,0,0,0,1000,-1000,-1000
20200316,046232,智易元大93購05,,,,,0.00,0.00,0,0,0,0,0,0,0,0,0,0,0,0,0
20200316,046236,緯穎元大93購05,,,,,0.00,0.00,0,0,0,0,0,0,0,0,0,0,0,0,0
20200316,04623P,台積電元大94售13,0.43,0.51,0.43,0.51,0.00,0.00,30000,3,14300,0,0,0,0,0,0,30000,30000,0,0
20200316,046240,中鋼中信94購01,,,,,0.00,0.00,0,0,0,0,0,0,0,0,0,0,0,0,0
20200316,046241,聯發科中信94購02,,,,,0.00,0.00,0,0,0,0,0,0,0,0,0,0,0,0,0
20200316,046242,大立光中信93購02,0.17,0.17,0.16,0.16,+0.05,45.45,30000,3,4900,0,0,0,0,0,0,10000,20000,-10000,-10000
20200316,046244,大成鋼亞東93購01,,,,,0.00,0.00,0,0,0,0,0,0,0,0,0,0,0,0,0
20200316,046245,奇力新亞東93購01,,,,,0.00,0.00,0,0,0,0,0,0,0,0,0,0,0,0,0
20200316,046246,嘉聯益亞東93購01,,,,,0.00,0.00,0,0,0,0,0,0,0,0,0,0,0,0,0
20200316,046247,南電亞東93購02,,,,,0.00,0.00,0,0,0,0,0,0,0,0,0,0,0,0,0
20200316,046248,技嘉群益93購02,,,,,0.00,0.00,0,0,0,0,0,0,0,0,0,0,0,0,0
20200316,04624P,台積電元大94售14,1.11,1.86,1.11,1.86,+0.81,77.14,110000,17,197100,0,0,0,0,0,0,110000,100000,10000,10000
20200316,046257,A50正2國票94購01,,,,,0.00,0.00,0,0,0,0,0,0,0,0,0,0,0,0,0
20200316,04625P,燿華元大94售03,,,,,0.00,0.00,0,0,0,0,0,0,0,0,0,0,0,0,0
20200316,046261,中環凱基93購01,,,,,0.00,0.00,0,0,0,0,0,0,0,0,0,0,0,0,0
20200316,046264,美律凱基93購05,,,,,0.00,0.00,0,0,0,0,0,0,0,0,0,0,0,0,0
20200316,046268,嘉晶凱基93購02,,,,,0.00,0.00,0,0,0,0,0,0,0,0,0,0,0,0,0
20200316,04626P,聯發科元大94售07,,,,,0.00,0.00,0,0,0,0,0,0,0,0,0,0,0,0,0
20200316,046275,台表科凱基94購01,,,,,0.00,0.00,0,0,0,0,0,0,0,0,0,0,0,0,0
20200316,04627P,聯發科元大94售08,1.38,2.27,1.36,2.27,-1.05,-31.63,66000,7,116720,0,0,0,0,0,0,40000,66000,-26000,-26000
20200316,046285,國巨兆豐93購01,,,,,0.00,0.00,0,0,0,0,0,0,0,0,0,0,0,0,0
20200316,046286,高鐵兆豐93購01,,,,,0.00,0.00,0,0,0,0,0,0,0,0,0,0,0,0,0
20200316,04628P,欣興元大95售01,5.15,5.85,5.15,5.85,+0.91,18.42,13000,3,67750,0,0,0,0,0,0,11000,12000,-1000,-1000
20200316,046290,儒鴻統一93購01,,,,,0.00,0.00,0,0,0,0,0,0,0,0,0,0,0,0,0
20200316,046291,友達統一94購01,0.08,0.08,0.08,0.08,0.00,0.00,26000,1,2080,0,0,0,0,0,0,26000,26000,0,0
20200316,046293,聯發科統一94購01,,,,,0.00,0.00,0,0,0,0,0,0,0,0,0,0,0,0,0
20200316,046298,聯發科富邦94購01,0.06,0.06,0.06,0.06,-0.06,-50.0,20000,1,1200,0,0,0,0,0,0,20000,0,20000,20000
20200316,046299,大立光富邦93購04,,,,,0.00,0.00,0,0,0,0,0,0,0,0,0,0,0,0,0
20200316,04629P,康控元大94售05,,,,,0.00,0.00,0,0,0,0,0,0,0,0,0,0,0,0,0
20200316,046300,嘉聯益富邦94購01,,,,,0.00,0.00,0,0,0,0,0,0,0,0,0,0,0,0,0
20200316,04630P,嘉聯益元大95售02,1.49,1.50,1.49,1.50,+0.17,12.78,7000,2,10450,0,0,0,0,0,0,7000,0,7000,7000
20200316,04631P,臺股指中信95售08,2.07,2.07,2.07,2.07,0.00,0.00,10000,1,20700,0,0,0,0,0,0,10000,0,10000,10000
20200316,04632P,台積電群益94售11,,,,,0.00,0.00,0,0,0,0,0,0,0,0,0,0,0,0,0
20200316,04633P,旺宏群益96售04,,,,,0.00,0.00,0,0,0,0,0,0,0,0,0,0,0,0,0
20200316,046340,滬深2X國票96購01,,,,,0.00,0.00,0,0,0,0,0,0,0,0,0,0,0,0,0
20200316,046341,A50正2國票93購01,,,,,0.00,0.00,0,0,0,0,0,0,0,0,0,0,0,0,0
20200316,046343,和鑫國票93購02,,,,,0.00,0.00,0,0,0,0,0,0,0,0,0,0,0,0,0
20200316,046344,超眾國票94購01,,,,,0.00,0.00,0,0,0,0,0,0,0,0,0,0,0,0,0
20200316,046345,世紀鋼國票93購01,,,,,0.00,0.00,0,0,0,0,0,0,0,0,0,0,0,0,0
20200316,046347,奇力新兆豐93購02,,,,,0.00,0.00,0,0,0,0,0,0,0,0,0,0,0,0,0
20200316,046348,嘉澤兆豐93購01,,,,,0.00,0.00,0,0,0,0,0,0,0,0,0,0,0,0,0
20200316,046349,康控兆豐93購02,,,,,0.00,0.00,0,0,0,0,0,0,0,0,0,0,0,0,0
20200316,04634P,臺股指群益94售09,,,,,0.00,0.00,0,0,0,0,0,0,0,0,0,0,0,0,0
20200316,046356,智伸科群益93購01,,,,,0.00,0.00,0,0,0,0,0,0,0,0,0,0,0,0,0
20200316,04635P,臺股指群益94售10,,,,,0.00,0.00,0,0,0,0,0,0,0,0,0,0,0,0,0
20200316,04636P,臺股指群益94售11,,,,,0.00,0.00,0,0,0,0,0,0,0,0,0,0,0,0,0
20200316,046370,全新麥證93購01,,,,,0.00,0.00,0,0,0,0,0,0,0,0,0,0,0,0,0
20200316,046375,友達凱基98購01,0.69,0.71,0.57,0.57,-0.03,-5.0,5000,3,3230,0,0,0,0,0,0,3000,2000,1000,1000
20200316,046379,奇力新凱基93購03,0.32,0.32,0.32,0.32,+0.17,113.33,10000,1,3200,0,0,0,0,0,0,10000,0,10000,10000
20200316,04637P,臺股指群益94售12,,,,,0.00,0.00,0,0,0,0,0,0,0,0,0,0,0,0,0
20200316,046380,神基凱基93購01,,,,,0.00,0.00,0,0,0,0,0,0,0,0,0,0,0,0,0
20200316,046381,緯創凱基93購03,,,,,0.00,0.00,0,0,0,0,0,0,0,0,0,0,0,0,0
20200316,046382,明泰凱基93購01,,,,,0.00,0.00,0,0,0,0,0,0,0,0,0,0,0,0,0
20200316,046383,群創凱基98購01,,,,,0.00,0.00,0,0,0,0,0,0,0,0,0,0,0,0,0
20200316,046384,群創凱基98購02,,,,,0.00,0.00,0,0,0,0,0,0,0,0,0,0,0,0,0
20200316,046385,群創凱基98購03,0.42,0.47,0.37,0.37,+0.01,2.78,373000,17,155940,0,0,0,0,0,0,343000,122000,221000,221000
20200316,046389,百和凱基93購04,,,,,0.00,0.00,0,0,0,0,0,0,0,0,0,0,0,0,0
20200316,04638P,臺股指群益94售13,,,,,0.00,0.00,0,0,0,0,0,0,0,0,0,0,0,0,0
20200316,046390,旺宏統一94購02,1.32,1.32,1.22,1.22,0.00,0.00,20000,2,25400,0,0,0,0,0,0,0,20000,-20000,-20000
20200316,046391,上海銀統一94購01,,,,,0.00,0.00,0,0,0,0,0,0,0,0,0,0,0,0,0
20200316,046395,友達國泰93購04,,,,,0.00,0.00,0,0,0,0,0,0,0,0,0,0,0,0,0
20200316,046396,矽創國泰93購01,,,,,0.00,0.00,0,0,0,0,0,0,0,0,0,0,0,0,0
20200316,046397,力山富邦94購01,,,,,0.00,0.00,0,0,0,0,0,0,0,0,0,0,0,0,0
20200316,046398,群創富邦93購01,,,,,0.00,0.00,0,0,0,0,0,0,0,0,0,0,0,0,0
20200316,04639P,臺股指群益94售14,21.70,21.70,21.70,21.70,0.00,0.00,1000,1,21700,0,0,0,0,0,0,1000,0,1000,1000
20200316,046404,友達元大93購02,,,,,0.00,0.00,0,0,0,0,0,0,0,0,0,0,0,0,0
20200316,046407,華新科元大93購07,,,,,0.00,0.00,0,0,0,0,0,0,0,0,0,0,0,0,0
20200316,04640P,上銀凱基94售05,0.50,0.56,0.50,0.56,0.00,0.00,20000,2,10600,0,0,0,0,0,0,0,20000,-20000,-20000
20200316,04641P,台積電凱基94售19,,,,,0.00,0.00,0,0,0,0,0,0,0,0,0,0,0,0,0
20200316,04642P,台積電凱基94售20,,,,,0.00,0.00,0,0,0,0,0,0,0,0,0,0,0,0,0
20200316,046432,宏達電中信94購01,,,,,0.00,0.00,0,0,0,0,0,0,0,0,0,0,0,0,0
20200316,046434,國巨群益93購03,,,,,0.00,0.00,0,0,0,0,0,0,0,0,0,0,0,0,0
20200316,046437,大立光群益93購05,,,,,0.00,0.00,0,0,0,0,0,0,0,0,0,0,0,0,0
20200316,046438,群創群益95購01,0.10,0.10,0.10,0.10,+0.02,25.0,60000,1,6000,0,0,0,0,0,0,60000,0,60000,60000
20200316,04643P,京元電凱基94售02,0.31,0.31,0.31,0.31,0.00,0.00,10000,1,3100,0,0,0,0,0,0,0,10000,-10000,-10000
20200316,046440,義隆亞東93購01,,,,,0.00,0.00,0,0,0,0,0,0,0,0,0,0,0,0,0
20200316,046442,聯茂兆豐93購03,,,,,0.00,0.00,0,0,0,0,0,0,0,0,0,0,0,0,0
20200316,046443,超眾兆豐93購01,,,,,0.00,0.00,0,0,0,0,0,0,0,0,0,0,0,0,0
20200316,04644P,全新凱基94售01,,,,,0.00,0.00,0,0,0,0,0,0,0,0,0,0,0,0,0
20200316,046450,鴻海凱基93購12,,,,,0.00,0.00,0,0,0,0,0,0,0,0,0,0,0,0,0
20200316,046451,中環凱基93購02,,,,,0.00,0.00,0,0,0,0,0,0,0,0,0,0,0,0,0
20200316,04645P,禾伸堂凱基94售03,0.64,0.64,0.61,0.61,-0.16,-20.78,30000,2,18900,0,0,0,0,0,0,0,30000,-30000,-30000
20200316,046460,聯鈞凱基93購02,0.29,0.29,0.29,0.29,+0.13,81.25,10000,1,2900,0,0,0,0,0,0,10000,0,10000,10000
20200316,046465,GIS凱基95購01,,,,,0.00,0.00,0,0,0,0,0,0,0,0,0,0,0,0,0
20200316,04646P,TPK凱基94售03,3.08,3.50,3.08,3.45,+0.35,11.29,16000,7,51610,0,0,0,0,0,0,6000,10000,-4000,-4000
20200316,046476,鴻海統一96購01,0.47,0.48,0.40,0.41,-0.10,-19.61,159000,14,69230,0,0,0,0,0,0,89000,51000,38000,38000
20200316,046477,台積電統一94購02,,,,,0.00,0.00,0,0,0,0,0,0,0,0,0,0,0,0,0
20200316,046479,群創元富94購01,0.07,0.07,0.04,0.04,0.00,0.00,935000,5,38750,0,0,0,0,0,0,930000,0,930000,930000
20200316,04647P,上海銀凱基94售04,4.00,4.00,4.00,4.00,+0.13,3.36,10000,1,40000,0,0,0,0,0,0,0,10000,-10000,-10000
20200316,046480,群創元富96購01,,,,,0.00,0.00,0,0,0,0,0,0,0,0,0,0,0,0,0
20200316,046483,華通國泰93購01,,,,,0.00,0.00,0,0,0,0,0,0,0,0,0,0,0,0,0
20200316,046484,華泰國泰93購01,,,,,0.00,0.00,0,0,0,0,0,0,0,0,0,0,0,0,0
20200316,046485,群創國泰93購02,,,,,0.00,0.00,0,0,0,0,0,0,0,0,0,0,0,0,0
20200316,046486,樺漢國泰94購01,,,,,0.00,0.00,0,0,0,0,0,0,0,0,0,0,0,0,0
20200316,04648P,臺股指凱基94售07,,,,,0.00,0.00,0,0,0,0,0,0,0,0,0,0,0,0,0
20200316,046491,滬深2X富邦95購02,,,,,0.00,0.00,0,0,0,0,0,0,0,0,0,0,0,0,0
20200316,046492,旺宏富邦94購02,0.76,0.76,0.51,0.51,-0.17,-25.0,15000,5,8250,0,0,0,0,0,0,0,15000,-15000,-15000
20200316,046493,緯創富邦93購01,,,,,0.00,0.00,0,0,0,0,0,0,0,0,0,0,0,0,0
20200316,04649P,臺股指凱基94售08,,,,,0.00,0.00,0,0,0,0,0,0,0,0,0,0,0,0,0
20200316,04650P,臺股指凱基94售09,,,,,0.00,0.00,0,0,0,0,0,0,0,0,0,0,0,0,0
20200316,04651P,臺股指凱基94售10,,,,,0.00,0.00,0,0,0,0,0,0,0,0,0,0,0,0,0
20200316,046528,聯詠中信94購01,,,,,0.00,0.00,0,0,0,0,0,0,0,0,0,0,0,0,0
20200316,04652P,臺股指凱基94售11,,,,,0.00,0.00,0,0,0,0,0,0,0,0,0,0,0,0,0
20200316,046532,元石油群益93購01,,,,,0.00,0.00,0,0,0,0,0,0,0,0,0,0,0,0,0
20200316,046537,聯發科群益93購02,,,,,0.00,0.00,0,0,0,0,0,0,0,0,0,0,0,0,0
20200316,046538,大立光群益93購06,,,,,0.00,0.00,0,0,0,0,0,0,0,0,0,0,0,0,0
20200316,04653P,臺股指凱基94售12,5.90,5.90,5.90,5.90,0.00,0.00,5000,1,29500,0,0,0,0,0,0,5000,0,5000,5000
20200316,046541,超眾群益93購01,,,,,0.00,0.00,0,0,0,0,0,0,0,0,0,0,0,0,0
20200316,04654P,臺股指凱基94售13,,,,,0.00,0.00,0,0,0,0,0,0,0,0,0,0,0,0,0
20200316,046557,亞泥凱基93購02,,,,,0.00,0.00,0,0,0,0,0,0,0,0,0,0,0,0,0
20200316,04655P,臺股指凱基94售14,,,,,0.00,0.00,0,0,0,0,0,0,0,0,0,0,0,0,0
20200316,046562,大立光凱基95購01,0.51,0.53,0.32,0.32,-0.19,-37.25,396000,4,201760,0,0,0,0,0,0,396000,0,396000,396000
20200316,046568,臻鼎元富95購01,0.04,0.04,0.04,0.04,-0.03,-42.86,200000,2,8000,0,0,0,0,0,0,0,0,0,0
20200316,04656P,台郡台新94售02,,,,,0.00,0.00,0,0,0,0,0,0,0,0,0,0,0,0,0
20200316,046570,旺宏國泰94購01,1.02,1.17,0.69,0.69,-0.32,-31.68,394000,27,408580,0,0,0,0,0,0,369000,25000,344000,344000
20200316,046571,瑞昱國泰93購01,,,,,0.00,0.00,0,0,0,0,0,0,0,0,0,0,0,0,0
20200316,046572,貿聯國泰94購01,,,,,0.00,0.00,0,0,0,0,0,0,0,0,0,0,0,0,0
20200316,046573,上緯控國泰94購01,,,,,0.00,0.00,0,0,0,0,0,0,0,0,0,0,0,0,0
20200316,046574,泰鼎國泰94購01,,,,,0.00,0.00,0,0,0,0,0,0,0,0,0,0,0,0,0
20200316,046575,GIS國泰93購01,,,,,0.00,0.00,0,0,0,0,0,0,0,0,0,0,0,0,0
20200316,046576,S&P反1富邦93購01,,,,,0.00,0.00,0,0,0,0,0,0,0,0,0,0,0,0,0
20200316,04657P,國巨永豐94售03,0.14,0.30,0.14,0.30,+0.03,11.11,248000,32,46710,0,0,0,0,0,0,1000,215000,-214000,-214000
20200316,046588,大立光元大93購13,0.11,0.11,0.07,0.07,+0.01,16.67,30000,3,2700,0,0,0,0,0,0,10000,20000,-10000,-10000
20200316,04658P,臺股指永昌94售02,,,,,0.00,0.00,0,0,0,0,0,0,0,0,0,0,0,0,0
20200316,046597,可成亞東93購01,,,,,0.00,0.00,0,0,0,0,0,0,0,0,0,0,0,0,0
20200316,046598,T50反1群益93購04,0.28,0.42,0.28,0.42,+0.18,75.0,260000,26,93000,0,0,0,0,0,0,260000,260000,0,0
20200316,046599,S&P反1群益93購01,0.93,1.00,0.93,1.00,-0.23,-18.7,39000,2,38370,0,0,0,0,0,0,9000,0,9000,9000
20200316,04659P,臺股指永昌94售03,,,,,0.00,0.00,0,0,0,0,0,0,0,0,0,0,0,0,0
20200316,046600,鴻海群益94購01,0.81,0.84,0.73,0.73,0.00,0.00,5000,4,3850,0,0,0,0,0,0,5000,5000,0,0
20200316,046602,新日興群益94購01,,,,,0.00,0.00,0,0,0,0,0,0,0,0,0,0,0,0,0
20200316,046604,康控群益93購02,,,,,0.00,0.00,0,0,0,0,0,0,0,0,0,0,0,0,0
20200316,046606,世紀鋼群益93購01,,,,,0.00,0.00,0,0,0,0,0,0,0,0,0,0,0,0,0
20200316,046608,超眾兆豐93購02,,,,,0.00,0.00,0,0,0,0,0,0,0,0,0,0,0,0,0
20200316,04660P,臺股指富邦94售03,,,,,0.00,0.00,0,0,0,0,0,0,0,0,0,0,0,0,0
20200316,04661P,臺股指富邦94售04,,,,,0.00,0.00,0,0,0,0,0,0,0,0,0,0,0,0,0
20200316,046624,彩晶凱基94購02,,,,,0.00,0.00,0,0,0,0,0,0,0,0,0,0,0,0,0
20200316,046626,台光電統一94購01,,,,,0.00,0.00,0,0,0,0,0,0,0,0,0,0,0,0,0
20200316,046627,高鐵統一95購01,,,,,0.00,0.00,0,0,0,0,0,0,0,0,0,0,0,0,0
20200316,046628,大立光統一98購01,1.82,1.83,1.39,1.39,-0.21,-13.12,66000,7,117030,0,0,0,0,0,0,52000,14000,38000,38000
20200316,046629,群創統一98購01,,,,,0.00,0.00,0,0,0,0,0,0,0,0,0,0,0,0,0
20200316,04662P,臺股指國票94售01,,,,,0.00,0.00,0,0,0,0,0,0,0,0,0,0,0,0,0
20200316,046630,京元電元富95購03,0.43,0.48,0.41,0.42,+0.26,162.5,142000,31,64120,0,0,0,0,0,0,0,142000,-142000,-142000
20200316,04663P,臺股指國票94售02,,,,,0.00,0.00,0,0,0,0,0,0,0,0,0,0,0,0,0
20200316,046644,台達電國泰93購01,,,,,0.00,0.00,0,0,0,0,0,0,0,0,0,0,0,0,0
20200316,046645,技嘉國泰94購01,0.10,0.10,0.10,0.10,0.00,0.00,16000,2,1600,0,0,0,0,0,0,0,16000,-16000,-16000
20200316,046646,冠德國泰94購01,,,,,0.00,0.00,0,0,0,0,0,0,0,0,0,0,0,0,0
20200316,046647,高鐵國泰93購01,,,,,0.00,0.00,0,0,0,0,0,0,0,0,0,0,0,0,0
20200316,046648,和鑫國泰94購01,,,,,0.00,0.00,0,0,0,0,0,0,0,0,0,0,0,0,0
20200316,046649,致伸國泰94購01,,,,,0.00,0.00,0,0,0,0,0,0,0,0,0,0,0,0,0
20200316,04664P,臺股指國票94售03,,,,,0.00,0.00,0,0,0,0,0,0,0,0,0,0,0,0,0
20200316,046650,台表科國泰94購01,,,,,0.00,0.00,0,0,0,0,0,0,0,0,0,0,0,0,0
20200316,046651,TPK富邦94購02,,,,,0.00,0.00,0,0,0,0,0,0,0,0,0,0,0,0,0
20200316,04665P,臺股指國票94售04,,,,,0.00,0.00,0,0,0,0,0,0,0,0,0,0,0,0,0
20200316,046662,大立光元大93購14,0.75,0.75,0.73,0.75,0.00,0.00,63000,7,46950,0,0,0,0,0,0,20000,63000,-43000,-43000
20200316,04666P,臺股指國票94售05,,,,,0.00,0.00,0,0,0,0,0,0,0,0,0,0,0,0,0
20200316,04667P,臺股指國票94售06,,,,,0.00,0.00,0,0,0,0,0,0,0,0,0,0,0,0,0
20200316,046680,上証反群益95購01,0.30,0.33,0.30,0.33,-0.07,-17.5,180000,4,54300,0,0,0,0,0,0,180000,0,180000,180000
20200316,046685,世紀鋼群益93購02,,,,,0.00,0.00,0,0,0,0,0,0,0,0,0,0,0,0,0
20200316,046686,上銀國票93購01,,,,,0.00,0.00,0,0,0,0,0,0,0,0,0,0,0,0,0
20200316,046687,TPK國票93購01,,,,,0.00,0.00,0,0,0,0,0,0,0,0,0,0,0,0,0
20200316,046688,超眾國票93購03,,,,,0.00,0.00,0,0,0,0,0,0,0,0,0,0,0,0,0
20200316,04668P,臺股指國票94售07,,,,,0.00,0.00,0,0,0,0,0,0,0,0,0,0,0,0,0
20200316,046697,麗豐凱基94購01,,,,,0.00,0.00,0,0,0,0,0,0,0,0,0,0,0,0,0
20200316,04669P,臺股指國票94售08,,,,,0.00,0.00,0,0,0,0,0,0,0,0,0,0,0,0,0
20200316,046703,瑞昱元富95購01,0.41,0.41,0.27,0.27,-0.22,-44.9,488000,13,158280,0,0,0,0,0,0,0,488000,-488000,-488000
20200316,046707,友達康和93購01,,,,,0.00,0.00,0,0,0,0,0,0,0,0,0,0,0,0,0
20200316,04670P,臺股指國票94售09,,,,,0.00,0.00,0,0,0,0,0,0,0,0,0,0,0,0,0
20200316,046713,鴻海國泰93購02,,,,,0.00,0.00,0,0,0,0,0,0,0,0,0,0,0,0,0
20200316,046714,國巨國泰93購02,,,,,0.00,0.00,0,0,0,0,0,0,0,0,0,0,0,0,0
20200316,046715,美律國泰94購01,,,,,0.00,0.00,0,0,0,0,0,0,0,0,0,0,0,0,0
20200316,046716,欣興國泰93購03,,,,,0.00,0.00,0,0,0,0,0,0,0,0,0,0,0,0,0
20200316,046717,世紀鋼國泰94購01,1.55,1.59,1.36,1.38,+0.17,14.05,679000,48,1038940,0,0,0,0,0,0,677000,0,677000,677000
20200316,046719,元石油元大95購02,,,,,0.00,0.00,0,0,0,0,0,0,0,0,0,0,0,0,0
20200316,04671P,華通統一94售01,,,,,0.00,0.00,0,0,0,0,0,0,0,0,0,0,0,0,0
20200316,046720,元油2X元大95購08,,,,,0.00,0.00,0,0,0,0,0,0,0,0,0,0,0,0,0
20200316,046727,新光金元大93購03,,,,,0.00,0.00,0,0,0,0,0,0,0,0,0,0,0,0,0
20200316,04672P,台積電統一94售09,,,,,0.00,0.00,0,0,0,0,0,0,0,0,0,0,0,0,0
20200316,046733,鴻海亞東94購01,,,,,0.00,0.00,0,0,0,0,0,0,0,0,0,0,0,0,0
20200316,04673P,友達統一94售04,,,,,0.00,0.00,0,0,0,0,0,0,0,0,0,0,0,0,0
20200316,046740,大立光群益95購01,0.78,0.78,0.38,0.38,-0.38,-50.0,220000,11,145360,0,0,0,0,0,0,140000,80000,60000,60000
20200316,046741,GIS群益94購01,,,,,0.00,0.00,0,0,0,0,0,0,0,0,0,0,0,0,0
20200316,046744,元油2X凱基94購01,,,,,0.00,0.00,0,0,0,0,0,0,0,0,0,0,0,0,0
20200316,04674P,全新統一95售01,,,,,0.00,0.00,0,0,0,0,0,0,0,0,0,0,0,0,0
20200316,04675P,華新科統一94售05,,,,,0.00,0.00,0,0,0,0,0,0,0,0,0,0,0,0,0
20200316,04676P,彩晶統一94售03,,,,,0.00,0.00,0,0,0,0,0,0,0,0,0,0,0,0,0
20200316,046770,聯發科國泰94購01,0.06,0.06,0.06,0.06,0.00,0.00,25000,1,1500,0,0,0,0,0,0,25000,0,25000,25000
20200316,046771,聯發科國泰94購02,,,,,0.00,0.00,0,0,0,0,0,0,0,0,0,0,0,0,0
20200316,046773,GIS富邦94購01,,,,,0.00,0.00,0,0,0,0,0,0,0,0,0,0,0,0,0
20200316,04677P,臺股指統一94售02,,,,,0.00,0.00,0,0,0,0,0,0,0,0,0,0,0,0,0
20200316,04678P,臺股指統一94售03,,,,,0.00,0.00,0,0,0,0,0,0,0,0,0,0,0,0,0
20200316,046791,台郡統一96購01,0.65,0.65,0.65,0.65,+0.07,12.07,1000,1,650,0,0,0,0,0,0,1000,0,1000,1000
20200316,046792,京元電元富96購01,0.29,0.36,0.28,0.28,+0.08,40.0,144000,22,47680,0,0,0,0,0,0,30000,114000,-84000,-84000
20200316,046793,聯發科元富99購01,0.30,0.30,0.17,0.17,-0.13,-43.33,1560000,47,336470,0,0,0,0,0,0,25000,1505000,-1480000,-1480000
20200316,046797,T50反1元大96購01,1.00,1.00,1.00,1.00,+0.10,11.11,5000,1,5000,0,0,0,0,0,0,0,0,0,0
20200316,046798,元油2X元大96購01,,,,,0.00,0.00,0,0,0,0,0,0,0,0,0,0,0,0,0
20200316,04679P,臺股指統一94售04,,,,,0.00,0.00,0,0,0,0,0,0,0,0,0,0,0,0,0
20200316,046804,群創元大94購01,,,,,0.00,0.00,0,0,0,0,0,0,0,0,0,0,0,0,0
20200316,04680P,臺股指統一94售05,,,,,0.00,0.00,0,0,0,0,0,0,0,0,0,0,0,0,0
20200316,046813,聯電凱基96購01,1.40,1.40,1.29,1.29,-0.07,-5.15,28000,5,38270,0,0,0,0,0,0,20000,8000,12000,12000
20200316,04681P,臺股指統一94售06,,,,,0.00,0.00,0,0,0,0,0,0,0,0,0,0,0,0,0
20200316,046826,統一群益94購01,,,,,0.00,0.00,0,0,0,0,0,0,0,0,0,0,0,0,0
20200316,046828,聯發科群益94購01,,,,,0.00,0.00,0,0,0,0,0,0,0,0,0,0,0,0,0
20200316,04682P,臺股指統一96售01,2.00,2.00,2.00,2.00,+0.10,5.26,53000,2,106000,0,0,0,0,0,0,3000,0,3000,3000
20200316,046831,大立光群益94購01,,,,,0.00,0.00,0,0,0,0,0,0,0,0,0,0,0,0,0
20200316,04683P,南亞科元大94售04,,,,,0.00,0.00,0,0,0,0,0,0,0,0,0,0,0,0,0
20200316,04684P,欣興元大94售07,3.74,3.74,3.74,3.74,0.00,0.00,31000,1,115940,0,0,0,0,0,0,31000,0,31000,31000
20200316,046855,嘉晶元大94購01,0.18,0.18,0.18,0.18,-0.01,-5.26,158000,3,28440,0,0,0,0,0,0,150000,8000,142000,142000
20200316,046858,群創元大94購02,,,,,0.00,0.00,0,0,0,0,0,0,0,0,0,0,0,0,0
20200316,04685P,訊芯元大94售02,,,,,0.00,0.00,0,0,0,0,0,0,0,0,0,0,0,0,0
20200316,046862,台郡元大94購01,0.13,0.13,0.13,0.13,+0.04,44.44,20000,2,2600,0,0,0,0,0,0,0,20000,-20000,-20000
20200316,046864,和大統一97購01,0.16,0.16,0.16,0.16,0.00,0.00,10000,1,1600,0,0,0,0,0,0,0,10000,-10000,-10000
20200316,046865,鴻海統一95購01,,,,,0.00,0.00,0,0,0,0,0,0,0,0,0,0,0,0,0
20200316,046866,台積電統一94購03,1.53,1.53,1.35,1.35,-0.26,-16.15,4000,3,5590,0,0,0,0,0,0,1000,3000,-2000,-2000
20200316,046869,聯發科統一95購01,,,,,0.00,0.00,0,0,0,0,0,0,0,0,0,0,0,0,0
20200316,04686P,台積電凱基94售23,,,,,0.00,0.00,0,0,0,0,0,0,0,0,0,0,0,0,0
20200316,046870,大立光統一95購01,,,,,0.00,0.00,0,0,0,0,0,0,0,0,0,0,0,0,0
20200316,046876,國巨國泰94購01,,,,,0.00,0.00,0,0,0,0,0,0,0,0,0,0,0,0,0
20200316,046877,燿華國泰94購01,0.02,0.02,0.01,0.01,0.00,0.00,40000,2,640,0,0,0,0,0,0,0,0,0,0
20200316,046878,康友國泰94購01,0.17,0.17,0.17,0.17,0.00,0.00,10000,1,1700,0,0,0,0,0,0,10000,0,10000,10000
20200316,04687P,全新凱基94售02,2.08,2.48,2.08,2.48,+0.18,7.83,60000,7,132150,0,0,0,0,0,0,0,60000,-60000,-60000
20200316,046881,智原富邦99購01,0.17,0.19,0.17,0.18,0.00,0.00,40000,3,7300,0,0,0,0,0,0,0,40000,-40000,-40000
20200316,046882,智易富邦97購01,,,,,0.00,0.00,0,0,0,0,0,0,0,0,0,0,0,0,0
20200316,046884,元油反群益95購01,,,,,0.00,0.00,0,0,0,0,0,0,0,0,0,0,0,0,0
20200316,04688P,大立光凱基94售09,,,,,0.00,0.00,0,0,0,0,0,0,0,0,0,0,0,0,0
20200316,046893,華新科群益94購01,,,,,0.00,0.00,0,0,0,0,0,0,0,0,0,0,0,0,0
20200316,046896,臻鼎群益94購01,,,,,0.00,0.00,0,0,0,0,0,0,0,0,0,0,0,0,0
20200316,04689P,台積電中信94售03,,,,,0.00,0.00,0,0,0,0,0,0,0,0,0,0,0,0,0
20200316,046903,友達凱基99購01,,,,,0.00,0.00,0,0,0,0,0,0,0,0,0,0,0,0,0
20200316,046905,新光金凱基99購01,0.54,0.54,0.46,0.46,-0.17,-26.98,115000,10,59450,0,0,0,0,0,0,105000,10000,95000,95000
20200316,046906,新光金凱基99購02,,,,,0.00,0.00,0,0,0,0,0,0,0,0,0,0,0,0,0
20200316,04690P,國巨群益94售06,0.37,0.70,0.37,0.70,+0.21,42.86,95000,6,54660,0,0,0,0,0,0,40000,0,40000,40000
20200316,046914,友達台新96購01,,,,,0.00,0.00,0,0,0,0,0,0,0,0,0,0,0,0,0
20200316,04691P,智邦群益94售02,,,,,0.00,0.00,0,0,0,0,0,0,0,0,0,0,0,0,0
20200316,046922,國巨國泰94購02,,,,,0.00,0.00,0,0,0,0,0,0,0,0,0,0,0,0,0
20200316,046923,友達國泰94購01,,,,,0.00,0.00,0,0,0,0,0,0,0,0,0,0,0,0,0
20200316,046924,華新科國泰94購02,,,,,0.00,0.00,0,0,0,0,0,0,0,0,0,0,0,0,0
20200316,046925,華新科國泰94購03,,,,,0.00,0.00,0,0,0,0,0,0,0,0,0,0,0,0,0
20200316,046926,易華電國泰94購02,,,,,0.00,0.00,0,0,0,0,0,0,0,0,0,0,0,0,0
20200316,046927,上銀富邦95購01,,,,,0.00,0.00,0,0,0,0,0,0,0,0,0,0,0,0,0
20200316,046928,奇鋐富邦97購01,0.11,0.11,0.11,0.11,0.00,0.00,4000,1,440,0,0,0,0,0,0,4000,0,4000,4000
20200316,04692P,大立光群益94售06,1.62,1.98,1.62,1.98,-0.02,-1.0,90000,10,168300,0,0,0,0,0,0,90000,80000,10000,10000
20200316,046934,智邦元富96購01,,,,,0.00,0.00,0,0,0,0,0,0,0,0,0,0,0,0,0
20200316,046937,聯電元大99購01,1.46,1.46,1.41,1.46,-0.06,-3.95,150000,15,213700,0,0,0,0,0,0,110000,120000,-10000,-10000
20200316,046939,燿華元大96購01,,,,,0.00,0.00,0,0,0,0,0,0,0,0,0,0,0,0,0
20200316,04693P,超眾群益95售01,1.55,1.84,1.54,1.84,+0.11,6.36,16000,4,27130,0,0,0,0,0,0,5000,6000,-1000,-1000
20200316,046942,友達元大99購01,0.82,0.89,0.74,0.74,0.00,0.00,456000,14,376920,0,0,0,0,0,0,396000,82000,314000,314000
20200316,046944,奇力新元大96購01,1.99,2.16,1.30,1.30,-0.16,-10.96,109000,17,199090,0,0,0,0,0,0,44000,70000,-26000,-26000
20200316,046946,益航元大94購01,,,,,0.00,0.00,0,0,0,0,0,0,0,0,0,0,0,0,0
20200316,046949,群創元大99購01,0.38,0.38,0.28,0.28,-0.05,-15.15,400000,31,133000,0,0,0,0,0,0,100000,300000,-200000,-200000
20200316,04694P,TPK台新94售02,,,,,0.00,0.00,0,0,0,0,0,0,0,0,0,0,0,0,0
20200316,046953,嘉聯益國票94購01,,,,,0.00,0.00,0,0,0,0,0,0,0,0,0,0,0,0,0
20200316,04695P,正崴康和94售01,,,,,0.00,0.00,0,0,0,0,0,0,0,0,0,0,0,0,0
20200316,046960,台新金中信95購01,,,,,0.00,0.00,0,0,0,0,0,0,0,0,0,0,0,0,0
20200316,046961,大立光中信95購02,1.11,1.11,0.59,0.60,-0.55,-47.83,251000,23,235730,0,0,0,0,0,0,85000,166000,-81000,-81000
20200316,046962,群創中信95購03,,,,,0.00,0.00,0,0,0,0,0,0,0,0,0,0,0,0,0
20200316,046968,台積電群益94購03,,,,,0.00,0.00,0,0,0,0,0,0,0,0,0,0,0,0,0
20200316,04696P,亞德客國泰95售02,1.28,1.51,1.16,1.51,-0.04,-2.58,497000,25,669400,0,0,0,0,0,0,235000,397000,-162000,-162000
20200316,04697P,臺股指元富94售03,,,,,0.00,0.00,0,0,0,0,0,0,0,0,0,0,0,0,0
20200316,046980,智邦兆豐94購01,,,,,0.00,0.00,0,0,0,0,0,0,0,0,0,0,0,0,0
20200316,046981,智伸科兆豐94購01,,,,,0.00,0.00,0,0,0,0,0,0,0,0,0,0,0,0,0
20200316,046982,瀚宇博兆豐94購02,,,,,0.00,0.00,0,0,0,0,0,0,0,0,0,0,0,0,0
20200316,046983,南茂兆豐94購01,,,,,0.00,0.00,0,0,0,0,0,0,0,0,0,0,0,0,0
20200316,04698P,臺股指元富94售04,,,,,0.00,0.00,0,0,0,0,0,0,0,0,0,0,0,0,0
20200316,046996,國巨國泰94購03,,,,,0.00,0.00,0,0,0,0,0,0,0,0,0,0,0,0,0
20200316,046997,國巨國泰95購01,,,,,0.00,0.00,0,0,0,0,0,0,0,0,0,0,0,0,0
20200316,046998,同欣電國泰94購01,,,,,0.00,0.00,0,0,0,0,0,0,0,0,0,0,0,0,0
20200316,046999,康控富邦99購01,,,,,0.00,0.00,0,0,0,0,0,0,0,0,0,0,0,0,0
20200316,04699P,臺股指元富94售05,,,,,0.00,0.00,0,0,0,0,0,0,0,0,0,0,0,0,0
20200316,047004,台積電統一99購01,1.96,1.99,1.84,1.84,-0.34,-15.6,350000,84,669640,0,0,0,0,0,0,0,45000,-45000,-45000
20200316,04700P,臺股指元富94售06,,,,,0.00,0.00,0,0,0,0,0,0,0,0,0,0,0,0,0
20200316,047013,超眾元富96購01,,,,,0.00,0.00,0,0,0,0,0,0,0,0,0,0,0,0,0
20200316,047014,元油反元大99購01,6.10,6.10,6.10,6.10,+0.85,16.19,15000,1,91500,0,0,0,0,0,0,15000,0,15000,15000
20200316,04701P,臺股指元富94售07,,,,,0.00,0.00,0,0,0,0,0,0,0,0,0,0,0,0,0
20200316,047024,奇力新元大95購01,2.07,2.24,1.32,1.32,-0.21,-13.73,173000,20,334890,0,0,0,0,0,0,118000,55000,63000,63000
20200316,047027,新光金元大95購01,0.08,0.08,0.07,0.07,-0.01,-12.5,770000,77,57900,0,0,0,0,0,0,0,770000,-770000,-770000
20200316,04702P,臺股指元富94售08,,,,,0.00,0.00,0,0,0,0,0,0,0,0,0,0,0,0,0
20200316,047033,日月光中信95購01,0.04,0.04,0.04,0.04,0.00,0.00,10000,1,400,0,0,0,0,0,0,0,10000,-10000,-10000
20200316,047035,華邦電群益94購02,,,,,0.00,0.00,0,0,0,0,0,0,0,0,0,0,0,0,0
20200316,04703P,樺漢統一95售01,1.80,1.91,1.80,1.91,+0.38,24.84,4000,2,7420,0,0,0,0,0,0,4000,0,4000,4000
20200316,047046,台積電國票94購01,,,,,0.00,0.00,0,0,0,0,0,0,0,0,0,0,0,0,0
20200316,047047,旺宏國票95購01,0.07,0.07,0.05,0.05,-0.04,-44.44,60000,3,4000,0,0,0,0,0,0,50000,0,50000,50000
20200316,047049,聯發科國票94購01,,,,,0.00,0.00,0,0,0,0,0,0,0,0,0,0,0,0,0
20200316,04704P,臺股指統一95售01,,,,,0.00,0.00,0,0,0,0,0,0,0,0,0,0,0,0,0
20200316,047051,可成國票94購01,0.03,0.03,0.02,0.02,0.00,0.00,10000,2,290,0,0,0,0,0,0,1000,0,1000,1000
20200316,047058,聯茂國票94購01,,,,,0.00,0.00,0,0,0,0,0,0,0,0,0,0,0,0,0
20200316,04705P,臺股指統一95售02,,,,,0.00,0.00,0,0,0,0,0,0,0,0,0,0,0,0,0
20200316,047063,漢唐凱基95購01,0.79,0.79,0.76,0.76,+0.05,7.04,62000,2,48020,0,0,0,0,0,0,62000,0,62000,62000
20200316,04706P,力山元大95售01,,,,,0.00,0.00,0,0,0,0,0,0,0,0,0,0,0,0,0
20200316,047072,義隆兆豐94購01,,,,,0.00,0.00,0,0,0,0,0,0,0,0,0,0,0,0,0
20200316,047073,大立光兆豐94購01,0.14,0.14,0.14,0.14,0.00,0.00,20000,2,2800,0,0,0,0,0,0,0,20000,-20000,-20000
20200316,047074,大立光兆豐94購02,0.06,0.06,0.03,0.03,-0.02,-40.0,119000,9,4470,0,0,0,0,0,0,30000,89000,-59000,-59000
20200316,047076,TPK兆豐94購01,,,,,0.00,0.00,0,0,0,0,0,0,0,0,0,0,0,0,0
20200316,047079,GIS兆豐94購01,,,,,0.00,0.00,0,0,0,0,0,0,0,0,0,0,0,0,0
20200316,04707P,喬山元大94售01,2.43,2.43,2.43,2.43,0.00,0.00,1000,1,2430,0,0,0,0,0,0,0,1000,-1000,-1000
20200316,04708P,國巨元大94售11,0.20,0.20,0.14,0.18,-0.02,-10.0,608000,62,97500,0,0,0,0,0,0,15000,593000,-578000,-578000
20200316,047096,元油反國泰96購01,,,,,0.00,0.00,0,0,0,0,0,0,0,0,0,0,0,0,0
20200316,047097,旺宏國泰94購03,,,,,0.00,0.00,0,0,0,0,0,0,0,0,0,0,0,0,0
20200316,047098,大毅國泰94購01,0.93,0.93,0.93,0.93,-0.30,-24.39,40000,1,37200,0,0,0,0,0,0,40000,0,40000,40000
20200316,047099,華通富邦94購01,,,,,0.00,0.00,0,0,0,0,0,0,0,0,0,0,0,0,0
20200316,04709P,台積電元大94售15,1.54,2.46,1.54,2.42,+1.16,92.06,169000,26,380720,0,0,0,0,0,0,157000,128000,29000,29000
20200316,047102,潤泰全富邦95購01,,,,,0.00,0.00,0,0,0,0,0,0,0,0,0,0,0,0,0
20200316,047105,和大元大94購01,,,,,0.00,0.00,0,0,0,0,0,0,0,0,0,0,0,0,0
20200316,047109,華邦電元大94購01,,,,,0.00,0.00,0,0,0,0,0,0,0,0,0,0,0,0,0
20200316,04710P,台積電元大94售16,0.64,1.02,0.64,0.97,+0.31,46.97,722000,74,580200,0,0,0,0,0,0,355000,707000,-352000,-352000
20200316,047114,全新元大94購01,,,,,0.00,0.00,0,0,0,0,0,0,0,0,0,0,0,0,0
20200316,04711P,台光電元大94售05,,,,,0.00,0.00,0,0,0,0,0,0,0,0,0,0,0,0,0
20200316,047123,中石化中信95購01,0.03,0.03,0.03,0.03,0.00,0.00,420000,42,12600,0,0,0,0,0,0,20000,400000,-380000,-380000
20200316,047127,臻鼎中信95購01,0.11,0.11,0.11,0.11,0.00,0.00,48000,1,5280,0,0,0,0,0,0,48000,0,48000,48000
20200316,04712P,國泰金元大94售01,0.50,0.70,0.50,0.69,-0.04,-5.48,577000,48,368120,0,0,0,0,0,0,226000,517000,-291000,-291000
20200316,047131,鴻海凱基94購03,,,,,0.00,0.00,0,0,0,0,0,0,0,0,0,0,0,0,0
20200316,047136,潤泰全凱基94購01,,,,,0.00,0.00,0,0,0,0,0,0,0,0,0,0,0,0,0
20200316,047137,健策凱基94購01,0.33,0.43,0.30,0.38,+0.01,2.7,190000,7,72800,0,0,0,0,0,0,160000,30000,130000,130000
20200316,04713P,創意元大95售01,1.56,1.56,1.56,1.56,-0.37,-19.17,18000,1,28080,0,0,0,0,0,0,18000,0,18000,18000
20200316,047140,滬深2X兆豐94購01,0.02,0.02,0.02,0.02,0.00,0.00,50000,5,1000,0,0,0,0,0,0,0,50000,-50000,-50000
20200316,047141,宏達電兆豐94購01,,,,,0.00,0.00,0,0,0,0,0,0,0,0,0,0,0,0,0
20200316,047144,華通群益94購01,,,,,0.00,0.00,0,0,0,0,0,0,0,0,0,0,0,0,0
20200316,047145,鴻海群益95購01,0.90,0.90,0.90,0.90,0.00,0.00,20000,1,18000,0,0,0,0,0,0,0,0,0,0
20200316,04714P,上海銀元大94售01,3.11,3.68,3.11,3.68,+0.38,11.52,90000,13,317100,0,0,0,0,0,0,0,90000,-90000,-90000
20200316,047151,台積電國票94購02,0.25,0.33,0.10,0.10,-0.21,-67.74,107000,24,19230,0,0,0,0,0,0,67000,0,67000,67000
20200316,047154,新光金國票95購01,0.08,0.08,0.06,0.06,0.00,0.00,55000,6,3800,0,0,0,0,0,0,0,55000,-55000,-55000
20200316,047156,群創國票94購01,,,,,0.00,0.00,0,0,0,0,0,0,0,0,0,0,0,0,0
20200316,047159,中磊國票94購01,,,,,0.00,0.00,0,0,0,0,0,0,0,0,0,0,0,0,0
20200316,04715P,聯茂元大94售06,,,,,0.00,0.00,0,0,0,0,0,0,0,0,0,0,0,0,0
20200316,047160,台郡國票94購01,,,,,0.00,0.00,0,0,0,0,0,0,0,0,0,0,0,0,0
20200316,047161,世紀鋼國票94購01,0.55,0.55,0.35,0.35,+0.10,40.0,11000,2,4050,0,0,0,0,0,0,10000,1000,9000,9000
20200316,047169,滬深2X永豐95購01,,,,,0.00,0.00,0,0,0,0,0,0,0,0,0,0,0,0,0
20200316,04716P,中石化凱基94售01,,,,,0.00,0.00,0,0,0,0,0,0,0,0,0,0,0,0,0
20200316,04717P,和大凱基94售02,1.11,1.15,1.10,1.15,-0.15,-11.54,102000,4,113750,0,0,0,0,0,0,1000,101000,-100000,-100000
20200316,047184,漢唐元大94購02,0.65,0.65,0.65,0.65,0.00,0.00,10000,1,6500,0,0,0,0,0,0,0,10000,-10000,-10000
20200316,047185,益航元大94購02,,,,,0.00,0.00,0,0,0,0,0,0,0,0,0,0,0,0,0
20200316,047187,亞光元大94購01,,,,,0.00,0.00,0,0,0,0,0,0,0,0,0,0,0,0,0
20200316,04718P,亞德客凱基94售03,0.58,0.85,0.56,0.85,0.00,0.00,81000,3,46850,0,0,0,0,0,0,0,81000,-81000,-81000
20200316,047193,南電元大94購02,,,,,0.00,0.00,0,0,0,0,0,0,0,0,0,0,0,0,0
20200316,047194,世紀鋼元大96購01,3.11,3.12,2.91,3.10,+0.37,13.55,122000,16,372540,0,0,0,0,0,0,101000,21000,80000,80000
20200316,047196,上銀統一97購01,0.42,0.42,0.22,0.28,-0.20,-41.67,32000,4,8740,0,0,0,0,0,0,0,22000,-22000,-22000
20200316,047197,美律統一94購01,,,,,0.00,0.00,0,0,0,0,0,0,0,0,0,0,0,0,0
20200316,04719P,台達電凱基94售09,,,,,0.00,0.00,0,0,0,0,0,0,0,0,0,0,0,0,0
20200316,047202,欣興元富96購01,0.09,0.09,0.05,0.06,-0.05,-45.45,1455000,13,111600,0,0,0,0,0,0,944000,511000,433000,433000
20200316,047206,元金2X國泰94購01,0.05,0.05,0.05,0.05,-0.09,-64.29,100000,2,5000,0,0,0,0,0,0,0,0,0,0
20200316,047207,晶技國泰94購01,,,,,0.00,0.00,0,0,0,0,0,0,0,0,0,0,0,0,0
20200316,047208,智易國泰94購01,,,,,0.00,0.00,0,0,0,0,0,0,0,0,0,0,0,0,0
20200316,047209,滬深2X富邦96購01,,,,,0.00,0.00,0,0,0,0,0,0,0,0,0,0,0,0,0
20200316,04720P,台積電凱基94售25,,,,,0.00,0.00,0,0,0,0,0,0,0,0,0,0,0,0,0
20200316,047210,漢唐富邦95購01,,,,,0.00,0.00,0,0,0,0,0,0,0,0,0,0,0,0,0
20200316,047211,華新科富邦99購01,1.36,1.40,1.13,1.13,-0.13,-10.32,40000,6,51980,0,0,0,0,0,0,12000,28000,-16000,-16000
20200316,047212,宏達電富邦97購01,0.19,0.19,0.10,0.10,-0.09,-47.37,1040000,24,148350,0,0,0,0,0,0,100000,940000,-840000,-840000
20200316,047213,新日興富邦97購01,0.49,0.49,0.32,0.32,-0.20,-38.46,27000,3,11040,0,0,0,0,0,0,27000,12000,15000,15000
20200316,047214,啟碁富邦97購01,,,,,0.00,0.00,0,0,0,0,0,0,0,0,0,0,0,0,0
20200316,047219,美律麥證94購01,0.11,0.11,0.11,0.11,0.00,0.00,50000,1,5500,50000,0,50000,0,0,0,50000,0,50000,50000
20200316,04721P,正崴凱基94售02,2.83,2.83,2.75,2.77,+0.11,4.14,12000,12,33480,0,0,0,0,0,0,12000,0,12000,12000
20200316,047222,鴻海凱基94購04,,,,,0.00,0.00,0,0,0,0,0,0,0,0,0,0,0,0,0
20200316,047224,台光電凱基94購01,,,,,0.00,0.00,0,0,0,0,0,0,0,0,0,0,0,0,0
20200316,047226,義隆凱基94購01,,,,,0.00,0.00,0,0,0,0,0,0,0,0,0,0,0,0,0
20200316,047227,華新科凱基94購01,,,,,0.00,0.00,0,0,0,0,0,0,0,0,0,0,0,0,0
20200316,04722P,南亞科凱基94售05,0.41,0.41,0.41,0.41,-0.03,-6.82,30000,2,12300,0,0,0,0,0,0,30000,30000,0,0
20200316,047231,大立光凱基95購03,,,,,0.00,0.00,0,0,0,0,0,0,0,0,0,0,0,0,0
20200316,047238,傳奇凱基94購01,,,,,0.00,0.00,0,0,0,0,0,0,0,0,0,0,0,0,0
20200316,047239,瀚宇博凱基94購01,,,,,0.00,0.00,0,0,0,0,0,0,0,0,0,0,0,0,0
20200316,04723P,美律凱基94售06,1.78,1.99,1.75,1.99,-0.70,-26.02,289000,8,556540,0,0,0,0,0,0,216000,73000,143000,143000
20200316,047245,聯發科群益94購03,,,,,0.00,0.00,0,0,0,0,0,0,0,0,0,0,0,0,0
20200316,047248,奇鋐群益95購01,,,,,0.00,0.00,0,0,0,0,0,0,0,0,0,0,0,0,0
20200316,04724P,可成凱基94售08,3.93,3.93,3.93,3.93,-0.83,-17.44,10000,1,39300,0,0,0,0,0,0,0,10000,-10000,-10000
20200316,047250,日月光群益94購01,,,,,0.00,0.00,0,0,0,0,0,0,0,0,0,0,0,0,0
20200316,04725P,華新科凱基94售07,,,,,0.00,0.00,0,0,0,0,0,0,0,0,0,0,0,0,0
20200316,047263,揚明光國票94購01,,,,,0.00,0.00,0,0,0,0,0,0,0,0,0,0,0,0,0
20200316,047266,嘉聯益國票94購02,,,,,0.00,0.00,0,0,0,0,0,0,0,0,0,0,0,0,0
20200316,04726P,TPK凱基94售04,3.64,4.08,3.64,4.01,+0.45,12.64,16000,7,60660,0,0,0,0,0,0,6000,10000,-4000,-4000
20200316,047270,元油2X永豐94購02,0.01,0.01,0.01,0.01,0.00,0.00,5000,5,50,0,0,0,0,0,0,0,0,0,0
20200316,04727P,臺股指凱基96售03,1.30,1.60,1.26,1.60,+0.59,58.42,270000,10,421500,0,0,0,0,0,0,10000,70000,-60000,-60000
20200316,047285,鴻海統一95購02,0.01,0.02,0.01,0.02,0.00,0.00,594000,14,6040,0,0,0,0,0,0,0,0,0,0
20200316,047287,貿聯統一95購01,,,,,0.00,0.00,0,0,0,0,0,0,0,0,0,0,0,0,0
20200316,047289,啟碁統一97購01,,,,,0.00,0.00,0,0,0,0,0,0,0,0,0,0,0,0,0
20200316,04728P,美律亞東94售02,4.11,4.16,4.11,4.16,-0.83,-16.63,12000,2,49620,0,0,0,0,0,0,12000,0,12000,12000
20200316,047292,台光電元富96購01,,,,,0.00,0.00,0,0,0,0,0,0,0,0,0,0,0,0,0
20200316,047295,欣興元富96購02,0.04,0.04,0.04,0.04,-0.01,-20.0,100000,1,4000,0,0,0,0,0,0,100000,0,100000,100000
20200316,047296,日月光元富96購01,0.05,0.05,0.05,0.05,0.00,0.00,10000,1,500,0,0,0,0,0,0,0,10000,-10000,-10000
20200316,047298,聯茂元富96購01,0.21,0.21,0.14,0.14,0.00,0.00,25000,4,4200,0,0,0,0,0,0,0,25000,-25000,-25000
20200316,04729P,臺股指中信96售01,0.40,0.50,0.40,0.50,+0.14,38.89,108000,8,52440,0,0,0,0,0,0,0,0,0,0
20200316,047301,啟碁國泰94購01,,,,,0.00,0.00,0,0,0,0,0,0,0,0,0,0,0,0,0
20200316,047302,為升富邦97購01,,,,,0.00,0.00,0,0,0,0,0,0,0,0,0,0,0,0,0
20200316,047303,寶滬深元大96購01,,,,,0.00,0.00,0,0,0,0,0,0,0,0,0,0,0,0,0
20200316,047304,元油2X元大96購02,,,,,0.00,0.00,0,0,0,0,0,0,0,0,0,0,0,0,0
20200316,04730P,臺股指中信96售02,,,,,0.00,0.00,0,0,0,0,0,0,0,0,0,0,0,0,0
20200316,047316,大立光元大94購01,0.18,0.18,0.06,0.07,-0.04,-36.36,930000,93,123700,0,0,0,0,0,0,0,930000,-930000,-930000
20200316,04731P,臺股指中信96售03,1.77,2.10,1.76,2.10,+0.46,28.05,65000,5,128150,0,0,0,0,0,0,40000,0,40000,40000
20200316,04732P,聯茂群益94售01,,,,,0.00,0.00,0,0,0,0,0,0,0,0,0,0,0,0,0
20200316,04733P,康控兆豐95售01,1.26,1.33,1.26,1.33,+0.07,5.56,120000,4,154300,0,0,0,0,0,0,20000,100000,-80000,-80000
20200316,047342,T50反1中信99購01,1.10,1.26,1.10,1.26,+0.13,11.5,15000,2,18100,0,0,0,0,0,0,10000,0,10000,10000
20200316,047343,台達電中信95購01,,,,,0.00,0.00,0,0,0,0,0,0,0,0,0,0,0,0,0
20200316,047345,鴻海凱基94購06,,,,,0.00,0.00,0,0,0,0,0,0,0,0,0,0,0,0,0
20200316,047348,台光電凱基94購02,,,,,0.00,0.00,0,0,0,0,0,0,0,0,0,0,0,0,0
20200316,04734P,上海銀兆豐94售02,1.32,1.32,1.31,1.32,-0.06,-4.35,23000,3,30260,0,0,0,0,0,0,3000,20000,-17000,-17000
20200316,047350,華新科凱基94購02,0.64,0.64,0.64,0.64,+0.29,82.86,10000,1,6400,0,0,0,0,0,0,10000,10000,0,0
20200316,047352,和鑫凱基94購02,,,,,0.00,0.00,0,0,0,0,0,0,0,0,0,0,0,0,0
20200316,047354,訊芯凱基94購01,,,,,0.00,0.00,0,0,0,0,0,0,0,0,0,0,0,0,0
20200316,047355,世紀鋼凱基94購01,1.26,1.33,1.02,1.26,+0.62,96.88,118000,14,146700,0,0,0,0,0,0,20000,98000,-78000,-78000
20200316,047356,貿聯兆豐94購01,0.03,0.03,0.03,0.03,-0.01,-25.0,40000,1,1200,0,0,0,0,0,0,40000,0,40000,40000
20200316,04735P,聯茂兆豐94售01,0.24,0.35,0.24,0.35,-0.02,-5.41,35000,2,9500,0,0,0,0,0,0,25000,10000,15000,15000
20200316,047360,鴻海群益95購02,0.02,0.02,0.02,0.02,0.00,0.00,100000,1,2000,0,0,0,0,0,0,0,0,0,0
20200316,047369,漢唐國票94購01,,,,,0.00,0.00,0,0,0,0,0,0,0,0,0,0,0,0,0
20200316,04736P,台積電永豐94售03,,,,,0.00,0.00,0,0,0,0,0,0,0,0,0,0,0,0,0
20200316,047372,創意國票94購01,,,,,0.00,0.00,0,0,0,0,0,0,0,0,0,0,0,0,0
20200316,047373,TPK國票94購01,,,,,0.00,0.00,0,0,0,0,0,0,0,0,0,0,0,0,0
20200316,047376,南電國票94購01,,,,,0.00,0.00,0,0,0,0,0,0,0,0,0,0,0,0,0
20200316,047379,元油2X元大96購03,0.03,0.03,0.03,0.03,0.00,0.00,200000,2,6000,0,0,0,0,0,0,0,0,0,0
20200316,04737P,正崴永豐94售02,,,,,0.00,0.00,0,0,0,0,0,0,0,0,0,0,0,0,0
20200316,047383,鴻海元大95購01,0.80,0.87,0.52,0.52,-0.40,-43.48,432000,46,295130,0,0,0,0,0,0,104000,337000,-233000,-233000
20200316,047385,華邦電元大94購02,,,,,0.00,0.00,0,0,0,0,0,0,0,0,0,0,0,0,0
20200316,047388,京元電元大95購01,,,,,0.00,0.00,0,0,0,0,0,0,0,0,0,0,0,0,0
20200316,047389,義隆元大94購01,,,,,0.00,0.00,0,0,0,0,0,0,0,0,0,0,0,0,0
20200316,04738P,揚明光永豐94售03,2.26,2.57,2.26,2.57,+0.35,15.77,30000,3,70950,0,0,0,0,0,0,25000,5000,20000,20000
20200316,047395,聯茂元大94購01,,,,,0.00,0.00,0,0,0,0,0,0,0,0,0,0,0,0,0
20200316,04739P,泰鼎永豐94售02,,,,,0.00,0.00,0,0,0,0,0,0,0,0,0,0,0,0,0
20200316,047402,T50反1統一94購03,,,,,0.00,0.00,0,0,0,0,0,0,0,0,0,0,0,0,0
20200316,047404,香港2X統一94購01,,,,,0.00,0.00,0,0,0,0,0,0,0,0,0,0,0,0,0
20200316,047405,香港2X統一96購01,0.22,0.22,0.22,0.22,0.00,0.00,5000,1,1100,0,0,0,0,0,0,0,5000,-5000,-5000
20200316,047406,香港反統一94購01,1.23,1.32,1.23,1.32,-0.10,-7.04,6000,2,7830,0,0,0,0,0,0,1000,5000,-4000,-4000
20200316,047408,嘉晶統一95購01,0.33,0.33,0.29,0.29,+0.03,11.54,395000,3,117780,0,0,0,0,0,0,395000,0,395000,395000
20200316,04740P,台積電富邦95售02,,,,,0.00,0.00,0,0,0,0,0,0,0,0,0,0,0,0,0
20200316,047410,上銀元富96購01,,,,,0.00,0.00,0,0,0,0,0,0,0,0,0,0,0,0,0
20200316,047416,台泥富邦94購01,0.14,0.14,0.14,0.14,0.00,0.00,10000,1,1400,0,0,0,0,0,0,10000,0,10000,10000
20200316,047417,台塑富邦97購01,,,,,0.00,0.00,0,0,0,0,0,0,0,0,0,0,0,0,0
20200316,047418,智邦富邦97購01,0.69,0.69,0.50,0.52,-0.09,-14.75,206000,14,127930,0,0,0,0,0,0,46000,114000,-68000,-68000
20200316,047419,聯發科富邦95購01,,,,,0.00,0.00,0,0,0,0,0,0,0,0,0,0,0,0,0
20200316,04741P,台積電統一94售10,,,,,0.00,0.00,0,0,0,0,0,0,0,0,0,0,0,0,0
20200316,047420,全新富邦97購01,,,,,0.00,0.00,0,0,0,0,0,0,0,0,0,0,0,0,0
20200316,047421,聯茂富邦97購01,0.22,0.26,0.17,0.17,-0.02,-10.53,635000,16,141540,0,0,0,0,0,0,168000,467000,-299000,-299000
20200316,047422,滬深2X兆豐94購02,,,,,0.00,0.00,0,0,0,0,0,0,0,0,0,0,0,0,0
20200316,04742P,瑞昱統一94售01,,,,,0.00,0.00,0,0,0,0,0,0,0,0,0,0,0,0,0
20200316,047435,台積電元大94購01,2.14,2.26,1.07,1.07,-1.19,-52.65,85000,7,159700,0,0,0,0,0,0,70000,15000,55000,55000
20200316,047436,台積電元大94購02,2.44,2.44,1.24,1.36,-0.42,-23.6,200000,20,344100,0,0,0,0,0,0,10000,190000,-180000,-180000
20200316,047437,旺宏元大94購02,,,,,0.00,0.00,0,0,0,0,0,0,0,0,0,0,0,0,0
20200316,047439,漢唐元大95購01,0.55,0.55,0.55,0.55,0.00,0.00,10000,1,5500,0,0,0,0,0,0,0,10000,-10000,-10000
20200316,04743P,台積電元富94售07,0.67,0.95,0.67,0.90,+0.44,95.65,16000,8,13650,0,0,0,0,0,0,16000,0,16000,16000
20200316,047443,智原元大94購01,,,,,0.00,0.00,0,0,0,0,0,0,0,0,0,0,0,0,0
20200316,047446,TPK元大94購01,,,,,0.00,0.00,0,0,0,0,0,0,0,0,0,0,0,0,0
20200316,047447,台郡元大94購02,,,,,0.00,0.00,0,0,0,0,0,0,0,0,0,0,0,0,0
20200316,04744P,臻鼎元富94售04,2.10,2.10,2.10,2.10,+0.11,5.53,20000,3,42000,0,0,0,0,0,0,20000,0,20000,20000
20200316,047454,滬深2X群益96購03,,,,,0.00,0.00,0,0,0,0,0,0,0,0,0,0,0,0,0
20200316,047457,旺宏群益95購01,0.25,0.26,0.20,0.20,-0.01,-4.76,111000,3,28250,0,0,0,0,0,0,1000,110000,-109000,-109000
20200316,04745P,祥碩元大94售04,0.09,0.14,0.09,0.14,+0.01,7.69,347000,5,46470,0,0,0,0,0,0,342000,5000,337000,337000
20200316,047460,富邦金群益95購01,,,,,0.00,0.00,0,0,0,0,0,0,0,0,0,0,0,0,0
20200316,047465,滬深2X國泰94購01,,,,,0.00,0.00,0,0,0,0,0,0,0,0,0,0,0,0,0
20200316,047466,新光金國泰95購01,0.04,0.04,0.03,0.03,0.00,0.00,490000,15,15200,0,0,0,0,0,0,0,490000,-490000,-490000
20200316,047467,滬深2X中信95購06,,,,,0.00,0.00,0,0,0,0,0,0,0,0,0,0,0,0,0
20200316,047468,為升中信95購01,,,,,0.00,0.00,0,0,0,0,0,0,0,0,0,0,0,0,0
20200316,04746P,臺股指元大94售17,6.20,6.20,6.20,6.20,+0.85,15.89,1000,1,6200,0,0,0,0,0,0,1000,0,1000,1000
20200316,047470,聯發科中信94購03,,,,,0.00,0.00,0,0,0,0,0,0,0,0,0,0,0,0,0
20200316,047476,鴻海凱基94購08,,,,,0.00,0.00,0,0,0,0,0,0,0,0,0,0,0,0,0
20200316,047479,美律凱基94購01,,,,,0.00,0.00,0,0,0,0,0,0,0,0,0,0,0,0,0
20200316,04747P,臺股指元大94售22,4.30,5.85,4.30,5.85,-0.10,-1.68,19000,4,90400,0,0,0,0,0,0,16000,0,16000,16000
20200316,047482,新光金凱基99購03,0.21,0.21,0.21,0.21,-0.02,-8.7,60000,1,12600,0,0,0,0,0,0,0,60000,-60000,-60000
20200316,047483,新光金凱基99購04,0.19,0.19,0.15,0.15,-0.06,-28.57,60000,3,9800,0,0,0,0,0,0,40000,20000,20000,20000
20200316,047485,景碩凱基94購01,,,,,0.00,0.00,0,0,0,0,0,0,0,0,0,0,0,0,0
20200316,047486,上海銀凱基94購01,,,,,0.00,0.00,0,0,0,0,0,0,0,0,0,0,0,0,0
20200316,047487,南電凱基94購01,,,,,0.00,0.00,0,0,0,0,0,0,0,0,0,0,0,0,0
20200316,04748P,臺股指元大94售23,,,,,0.00,0.00,0,0,0,0,0,0,0,0,0,0,0,0,0
20200316,047491,旺宏統一94購03,0.08,0.08,0.08,0.08,0.00,0.00,28000,1,2240,0,0,0,0,0,0,28000,0,28000,28000
20200316,047493,旺宏元富96購01,0.19,0.21,0.17,0.20,+0.05,33.33,115000,12,23000,0,0,0,0,0,0,100000,15000,85000,85000
20200316,047494,華邦電元富96購01,0.05,0.05,0.05,0.05,-0.01,-16.67,30000,1,1500,0,0,0,0,0,0,0,30000,-30000,-30000
20200316,047495,新日興元富96購01,0.28,0.28,0.28,0.28,+0.03,12.0,100000,1,28000,0,0,0,0,0,0,100000,0,100000,100000
20200316,04749P,臺股指元大94售25,5.90,5.90,5.90,5.90,+0.05,0.85,25000,1,147500,0,0,0,0,0,0,25000,0,25000,25000
20200316,047504,滬深2X國票9A購01,,,,,0.00,0.00,0,0,0,0,0,0,0,0,0,0,0,0,0
20200316,047505,元金2X國票9B購01,0.26,0.38,0.25,0.28,-0.37,-56.92,1169000,33,344170,0,0,0,0,0,0,203000,0,203000,203000
20200316,047508,旺宏國票94購01,0.69,0.75,0.65,0.67,+0.07,11.67,82000,6,58920,0,0,0,0,0,0,52000,30000,22000,22000
20200316,04750P,臺股指元大94售26,,,,,0.00,0.00,0,0,0,0,0,0,0,0,0,0,0,0,0
20200316,047510,奇力新國票94購01,1.59,1.59,1.59,1.59,+0.68,74.73,30000,1,47700,0,0,0,0,0,0,30000,0,30000,30000
20200316,047512,宏達電國票94購01,0.01,0.01,0.01,0.01,0.00,0.00,50000,1,500,0,0,0,0,0,0,50000,0,50000,50000
20200316,047514,亞光國票94購01,0.01,0.01,0.01,0.01,0.00,0.00,10000,1,100,0,0,0,0,0,0,10000,0,10000,10000
20200316,047515,智易國票94購01,,,,,0.00,0.00,0,0,0,0,0,0,0,0,0,0,0,0,0
20200316,047517,元油反元大96購01,,,,,0.00,0.00,0,0,0,0,0,0,0,0,0,0,0,0,0
20200316,04751P,智邦兆豐95售02,1.00,1.13,1.00,1.13,+0.10,9.71,180000,18,189260,0,0,0,0,0,0,117000,58000,59000,59000
20200316,047521,台積電元大94購03,1.24,1.35,0.57,0.64,-0.47,-42.34,461000,25,369510,0,0,0,0,0,0,360000,351000,9000,9000
20200316,047529,嘉晶元大94購02,0.46,0.50,0.44,0.50,+0.06,13.64,66000,9,31220,0,0,0,0,0,0,31000,43000,-12000,-12000
20200316,04752P,大立光群益94售07,0.12,0.12,0.12,0.12,+0.07,140.0,120000,12,14400,0,0,0,0,0,0,0,120000,-120000,-120000
20200316,04753P,台積電統一94售11,1.76,1.76,1.76,1.76,+0.65,58.56,2000,2,3520,0,0,0,0,0,0,0,2000,-2000,-2000
20200316,047541,深中小凱基94購01,0.96,0.96,0.70,0.70,+0.08,12.9,351000,2,245960,0,0,0,0,0,0,351000,0,351000,351000
20200316,047542,華通凱基94購02,,,,,0.00,0.00,0,0,0,0,0,0,0,0,0,0,0,0,0
20200316,047543,鴻海凱基94購09,0.19,0.19,0.12,0.14,+0.04,40.0,142000,6,21780,0,0,0,0,0,0,110000,32000,78000,78000
20200316,047547,友達凱基99購02,0.54,0.54,0.40,0.40,0.00,0.00,75000,5,33800,0,0,0,0,0,0,25000,20000,5000,5000
20200316,047548,友達凱基99購03,,,,,0.00,0.00,0,0,0,0,0,0,0,0,0,0,0,0,0
20200316,04754P,宏達電元富94售02,3.22,3.22,3.13,3.13,+0.50,19.01,12000,12,38160,0,0,0,0,0,0,12000,0,12000,12000
20200316,047552,潤泰全凱基94購02,,,,,0.00,0.00,0,0,0,0,0,0,0,0,0,0,0,0,0
20200316,047556,群創凱基95購01,0.10,0.10,0.10,0.10,0.00,0.00,99000,1,9900,0,0,0,0,0,0,99000,0,99000,99000
20200316,047557,麗豐凱基94購02,,,,,0.00,0.00,0,0,0,0,0,0,0,0,0,0,0,0,0
20200316,047559,彩晶凱基94購03,,,,,0.00,0.00,0,0,0,0,0,0,0,0,0,0,0,0,0
20200316,04755P,大立光元富94售07,,,,,0.00,0.00,0,0,0,0,0,0,0,0,0,0,0,0,0
20200316,047560,超眾凱基94購01,,,,,0.00,0.00,0,0,0,0,0,0,0,0,0,0,0,0,0
20200316,047562,志超凱基94購01,,,,,0.00,0.00,0,0,0,0,0,0,0,0,0,0,0,0,0
20200316,047564,滬深2X國票99購01,,,,,0.00,0.00,0,0,0,0,0,0,0,0,0,0,0,0,0
20200316,047566,華新科國票94購02,2.28,2.28,2.28,2.28,+0.75,49.02,30000,1,68400,0,0,0,0,0,0,30000,0,30000,30000
20200316,047569,世紀鋼國票94購02,1.17,1.23,0.92,0.96,+0.05,5.49,220000,19,240290,0,0,0,0,0,0,80000,140000,-60000,-60000
20200316,04756P,大立光元富94售08,3.46,4.85,3.46,4.85,+2.02,71.38,106000,14,392760,0,0,0,0,0,0,84000,22000,62000,62000
20200316,047571,滬深2X群益99購01,0.12,0.12,0.10,0.10,-0.05,-33.33,509000,14,58480,0,0,0,0,0,0,0,439000,-439000,-439000
20200316,047572,深中小群益95購01,0.55,0.55,0.47,0.54,-0.17,-23.94,282000,8,137440,0,0,0,0,0,0,202000,80000,122000,122000
20200316,047576,技嘉群益94購01,,,,,0.00,0.00,0,0,0,0,0,0,0,0,0,0,0,0,0
20200316,047579,大立光群益94購02,1.15,1.15,0.76,0.76,-0.54,-41.54,6000,4,6000,0,0,0,0,0,0,0,6000,-6000,-6000
20200316,04757P,元油2X凱基94售04,,,,,0.00,0.00,0,0,0,0,0,0,0,0,0,0,0,0,0
20200316,047580,TPK群益94購01,0.01,0.01,0.01,0.01,0.00,0.00,10000,10,100,0,0,0,0,0,0,0,0,0,0
20200316,047582,滬深2X永豐95購02,,,,,0.00,0.00,0,0,0,0,0,0,0,0,0,0,0,0,0
20200316,047583,深中小永豐94購01,,,,,0.00,0.00,0,0,0,0,0,0,0,0,0,0,0,0,0
20200316,047584,元金2X永豐95購01,0.26,0.26,0.26,0.26,+0.02,8.33,187000,2,48620,0,0,0,0,0,0,0,0,0,0
20200316,047586,聯發科永豐94購01,,,,,0.00,0.00,0,0,0,0,0,0,0,0,0,0,0,0,0
20200316,047588,大立光永豐94購01,,,,,0.00,0.00,0,0,0,0,0,0,0,0,0,0,0,0,0
20200316,04758P,國巨凱基94售03,0.70,0.70,0.70,0.70,0.00,0.00,8000,1,5600,0,0,0,0,0,0,8000,0,8000,8000
20200316,047595,元石油元富97購01,0.04,0.04,0.04,0.04,0.00,0.00,170000,6,6800,0,0,0,0,0,0,0,0,0,0
20200316,047596,元油反元富97購01,,,,,0.00,0.00,0,0,0,0,0,0,0,0,0,0,0,0,0
20200316,047598,深中小統一94購01,,,,,0.00,0.00,0,0,0,0,0,0,0,0,0,0,0,0,0
20200316,04759P,台積電凱基94售27,0.42,0.43,0.42,0.43,-0.17,-28.33,43000,2,18190,0,0,0,0,0,0,0,43000,-43000,-43000
20200316,047603,瑞昱國泰94購01,0.31,0.37,0.27,0.27,-0.16,-37.21,105000,6,32850,0,0,0,0,0,0,30000,75000,-45000,-45000
20200316,047604,智原國泰95購01,,,,,0.00,0.00,0,0,0,0,0,0,0,0,0,0,0,0,0
20200316,047606,元油反富邦94購01,,,,,0.00,0.00,0,0,0,0,0,0,0,0,0,0,0,0,0
20200316,047608,聯發科第一95購01,,,,,0.00,0.00,0,0,0,0,0,0,0,0,0,0,0,0,0
20200316,04760P,旺宏凱基94售02,1.25,1.48,1.25,1.48,-0.19,-11.38,540000,5,755830,0,0,0,0,0,0,19000,521000,-502000,-502000
20200316,047616,鴻海凱基94購10,,,,,0.00,0.00,0,0,0,0,0,0,0,0,0,0,0,0,0
20200316,047618,義隆凱基94購02,,,,,0.00,0.00,0,0,0,0,0,0,0,0,0,0,0,0,0
20200316,04761P,可成凱基94售09,3.09,3.09,3.09,3.09,-1.25,-28.8,10000,1,30900,0,0,0,0,0,0,0,10000,-10000,-10000
20200316,047621,TPK凱基94購01,,,,,0.00,0.00,0,0,0,0,0,0,0,0,0,0,0,0,0
20200316,047623,世紀鋼凱基94購02,0.75,0.84,0.69,0.81,+0.14,20.9,399000,22,294770,0,0,0,0,0,0,353000,45000,308000,308000
20200316,047625,友達國票94購01,,,,,0.00,0.00,0,0,0,0,0,0,0,0,0,0,0,0,0
20200316,047626,全新國票94購01,,,,,0.00,0.00,0,0,0,0,0,0,0,0,0,0,0,0,0
20200316,047627,華新科國票94購03,0.79,0.79,0.40,0.40,-0.04,-9.09,20000,3,13250,0,0,0,0,0,0,20000,0,20000,20000
20200316,047628,新光金國票95購02,,,,,0.00,0.00,0,0,0,0,0,0,0,0,0,0,0,0,0
20200316,047629,深中小元大96購01,0.53,0.53,0.51,0.51,-0.11,-17.74,40000,4,20600,0,0,0,0,0,0,0,40000,-40000,-40000
20200316,04762P,聯詠凱基94售03,,,,,0.00,0.00,0,0,0,0,0,0,0,0,0,0,0,0,0
20200316,047630,元油反元大96購02,5.00,5.05,4.85,4.87,+0.67,15.95,48000,8,237130,0,0,0,0,0,0,15000,33000,-18000,-18000
20200316,047633,力山元大94購01,,,,,0.00,0.00,0,0,0,0,0,0,0,0,0,0,0,0,0
20200316,047637,旺宏元大94購03,,,,,0.00,0.00,0,0,0,0,0,0,0,0,0,0,0,0,0
20200316,04763P,臺股指凱基96售05,1.24,1.70,1.22,1.70,+0.88,107.32,148000,25,191530,0,0,0,0,0,0,105000,22000,83000,83000
20200316,047643,新光金元大95購02,,,,,0.00,0.00,0,0,0,0,0,0,0,0,0,0,0,0,0
20200316,047644,揚明光元大94購02,,,,,0.00,0.00,0,0,0,0,0,0,0,0,0,0,0,0,0
20200316,047646,貿聯元大94購01,,,,,0.00,0.00,0,0,0,0,0,0,0,0,0,0,0,0,0
20200316,04764P,台光電台新94售01,,,,,0.00,0.00,0,0,0,0,0,0,0,0,0,0,0,0,0
20200316,047652,滬深2X兆豐94購03,0.25,0.25,0.15,0.15,-0.19,-55.88,629000,8,148950,0,0,0,0,0,0,20000,609000,-589000,-589000
20200316,047653,上銀兆豐94購01,,,,,0.00,0.00,0,0,0,0,0,0,0,0,0,0,0,0,0
20200316,047657,智易兆豐94購02,,,,,0.00,0.00,0,0,0,0,0,0,0,0,0,0,0,0,0
20200316,04765P,宏達電永豐94售02,1.28,1.48,1.28,1.48,+0.49,49.49,13000,2,17240,0,0,0,0,0,0,0,13000,-13000,-13000
20200316,047661,滬深2X永豐96購01,,,,,0.00,0.00,0,0,0,0,0,0,0,0,0,0,0,0,0
20200316,04766P,緯穎永豐94售02,,,,,0.00,0.00,0,0,0,0,0,0,0,0,0,0,0,0,0
20200316,047673,瑞昱元富96購01,,,,,0.00,0.00,0,0,0,0,0,0,0,0,0,0,0,0,0
20200316,047674,群創元富96購02,,,,,0.00,0.00,0,0,0,0,0,0,0,0,0,0,0,0,0
20200316,047675,群創元富96購03,0.27,0.27,0.24,0.24,+0.07,41.18,30000,2,7500,0,0,0,0,0,0,30000,0,30000,30000
20200316,047676,臺股指元富99購01,,,,,0.00,0.00,0,0,0,0,0,0,0,0,0,0,0,0,0
20200316,04767P,台積電國泰95售04,2.24,3.14,2.24,3.14,-0.48,-13.26,145000,19,395670,0,0,0,0,0,0,131000,144000,-13000,-13000
20200316,047680,上証反中信96購01,0.46,0.46,0.45,0.46,-0.07,-13.21,211000,7,96960,0,0,0,0,0,0,0,211000,-211000,-211000
20200316,047681,滬深反中信95購01,0.71,0.83,0.69,0.82,+0.22,36.67,578000,25,429740,0,0,0,0,0,0,511000,67000,444000,444000
20200316,047682,滬深2X國泰94購02,,,,,0.00,0.00,0,0,0,0,0,0,0,0,0,0,0,0,0
20200316,047683,亞德客國泰95購01,2.31,2.74,1.99,1.99,0.00,0.00,508000,23,1286720,0,0,0,0,0,0,119000,379000,-260000,-260000
20200316,047684,景碩國泰94購01,,,,,0.00,0.00,0,0,0,0,0,0,0,0,0,0,0,0,0
20200316,047685,嘉聯益國泰95購01,0.35,0.35,0.23,0.23,-0.10,-30.3,123000,2,42690,0,0,0,0,0,0,0,123000,-123000,-123000
20200316,047686,元油反富邦94購02,,,,,0.00,0.00,0,0,0,0,0,0,0,0,0,0,0,0,0
20200316,047687,元金2X富邦96購01,0.86,1.00,0.82,0.86,-0.54,-38.57,111000,13,97160,0,0,0,0,0,0,10000,101000,-91000,-91000
20200316,047688,亞德客富邦95購01,0.94,0.95,0.94,0.95,0.00,0.00,262000,7,248300,0,0,0,0,0,0,0,262000,-262000,-262000
20200316,047689,瑞昱富邦97購01,,,,,0.00,0.00,0,0,0,0,0,0,0,0,0,0,0,0,0
20200316,04768P,大立光國泰96售03,2.06,2.80,2.06,2.70,+0.19,7.57,534000,24,1234980,0,0,0,0,0,0,91000,531000,-440000,-440000
20200316,047690,美律富邦97購01,0.16,0.16,0.14,0.14,+0.02,16.67,47000,3,6820,0,0,0,0,0,0,47000,0,47000,47000
20200316,047692,T50反1國票94購01,1.44,1.44,1.44,1.44,+0.14,10.77,50000,1,72000,0,0,0,0,0,0,50000,0,50000,50000
20200316,047693,T50反1國票95購01,,,,,0.00,0.00,0,0,0,0,0,0,0,0,0,0,0,0,0
20200316,047694,SP黃豆國票9B購01,,,,,0.00,0.00,0,0,0,0,0,0,0,0,0,0,0,0,0
20200316,047696,聯發科國票94購02,,,,,0.00,0.00,0,0,0,0,0,0,0,0,0,0,0,0,0
20200316,047697,台郡國票94購02,1.03,1.03,1.03,1.03,+0.42,68.85,20000,1,20600,0,0,0,0,0,0,20000,0,20000,20000
20200316,04769P,高股息元大94售01,1.07,1.40,1.07,1.36,0.00,0.00,23000,3,30810,0,0,0,0,0,0,3000,20000,-17000,-17000
20200316,047700,華新凱基94購01,,,,,0.00,0.00,0,0,0,0,0,0,0,0,0,0,0,0,0
20200316,047701,鴻海凱基94購12,1.22,1.22,1.03,1.06,+0.39,58.21,46000,5,52220,0,0,0,0,0,0,24000,26000,-2000,-2000
20200316,047702,鴻海凱基94購13,,,,,0.00,0.00,0,0,0,0,0,0,0,0,0,0,0,0,0
20200316,047705,燿華凱基94購01,,,,,0.00,0.00,0,0,0,0,0,0,0,0,0,0,0,0,0
20200316,047706,燿華凱基95購01,,,,,0.00,0.00,0,0,0,0,0,0,0,0,0,0,0,0,0
20200316,04770P,鴻海元大94售09,0.17,0.24,0.16,0.24,+0.05,26.32,120000,13,24350,0,0,0,0,0,0,20000,110000,-90000,-90000
20200316,047711,華新科凱基94購03,,,,,0.00,0.00,0,0,0,0,0,0,0,0,0,0,0,0,0
20200316,047718,達興凱基94購01,,,,,0.00,0.00,0,0,0,0,0,0,0,0,0,0,0,0,0
20200316,047719,聯茂凱基94購01,,,,,0.00,0.00,0,0,0,0,0,0,0,0,0,0,0,0,0
20200316,04771P,友達元大96售02,0.71,0.84,0.70,0.83,-0.10,-10.75,508000,56,388180,0,0,0,0,0,0,90000,418000,-328000,-328000
20200316,047720,聯茂凱基94購03,,,,,0.00,0.00,0,0,0,0,0,0,0,0,0,0,0,0,0
20200316,047722,南電凱基94購02,0.76,0.76,0.76,0.76,+0.26,52.0,158000,1,120080,0,0,0,0,0,0,0,158000,-158000,-158000
20200316,047723,廣宇群益94購01,,,,,0.00,0.00,0,0,0,0,0,0,0,0,0,0,0,0,0
20200316,047726,友達群益94購02,0.02,0.02,0.02,0.02,0.00,0.00,8000,1,160,0,0,0,0,0,0,8000,8000,0,0
20200316,047727,拓凱群益94購01,,,,,0.00,0.00,0,0,0,0,0,0,0,0,0,0,0,0,0
20200316,04772P,欣興元大94售08,,,,,0.00,0.00,0,0,0,0,0,0,0,0,0,0,0,0,0
20200316,047733,友達兆豐95購01,,,,,0.00,0.00,0,0,0,0,0,0,0,0,0,0,0,0,0
20200316,047734,欣興兆豐94購02,,,,,0.00,0.00,0,0,0,0,0,0,0,0,0,0,0,0,0
20200316,047735,華邦電台新94購01,,,,,0.00,0.00,0,0,0,0,0,0,0,0,0,0,0,0,0
20200316,047736,聯發科台新94購01,0.07,0.07,0.06,0.06,0.00,0.00,40000,4,2500,0,0,0,0,0,0,0,40000,-40000,-40000
20200316,047737,義隆麥證94購01,0.17,0.17,0.17,0.17,0.00,0.00,50000,1,8500,50000,0,50000,0,0,0,50000,0,50000,50000
20200316,04773P,金融類元大94售01,3.22,4.21,3.21,4.17,+1.52,57.36,344000,38,1261470,0,0,0,0,0,0,0,344000,-344000,-344000
20200316,04774P,金融類元大94售02,2.98,3.14,2.98,3.14,+0.11,3.63,152000,17,457390,0,0,0,0,0,0,0,152000,-152000,-152000
20200316,04775P,台積電凱基94售29,0.53,0.53,0.53,0.53,0.00,0.00,383000,8,202990,0,0,0,0,0,0,0,383000,-383000,-383000
20200316,047760,元油反元大96購03,,,,,0.00,0.00,0,0,0,0,0,0,0,0,0,0,0,0,0
20200316,047763,旺宏元大94購04,0.08,0.08,0.08,0.08,+0.03,60.0,40000,1,3200,0,0,0,0,0,0,40000,0,40000,40000
20200316,047768,大立光元大95購01,1.07,1.07,0.66,0.67,-0.61,-47.66,67000,8,50180,0,0,0,0,0,0,27000,50000,-23000,-23000
20200316,047769,大立光元大96購01,0.88,0.89,0.60,0.64,-0.24,-27.27,220000,32,166580,0,0,0,0,0,0,94000,111000,-17000,-17000
20200316,04776P,聯發科凱基94售06,0.80,0.80,0.80,0.80,-0.91,-53.22,3000,1,2400,0,0,0,0,0,0,3000,0,3000,3000
20200316,047773,超眾元大96購01,,,,,0.00,0.00,0,0,0,0,0,0,0,0,0,0,0,0,0
20200316,047774,台表科元大95購01,0.56,0.56,0.37,0.37,-0.11,-22.92,330000,24,145300,0,0,0,0,0,0,110000,220000,-110000,-110000
20200316,047775,緯穎元大95購01,,,,,0.00,0.00,0,0,0,0,0,0,0,0,0,0,0,0,0
20200316,04777P,聯發科凱基94售10,0.08,0.17,0.08,0.17,+0.04,30.77,56000,5,4720,0,0,0,0,0,0,46000,0,46000,46000
20200316,047780,友達中信96購01,0.22,0.22,0.14,0.14,-0.04,-22.22,25000,4,4720,0,0,0,0,0,0,10000,15000,-5000,-5000
20200316,047781,上銀國泰94購02,,,,,0.00,0.00,0,0,0,0,0,0,0,0,0,0,0,0,0
20200316,047782,燿華國泰95購01,0.02,0.02,0.02,0.02,0.00,0.00,150000,3,3000,0,0,0,0,0,0,150000,0,150000,150000
20200316,047783,聯茂國泰94購02,0.10,0.10,0.09,0.09,+0.03,50.0,2000,2,190,0,0,0,0,0,0,0,2000,-2000,-2000
20200316,047784,元油反富邦94購03,3.76,3.76,3.53,3.61,+0.36,11.08,32000,5,117920,0,0,0,0,0,0,32000,0,32000,32000
20200316,047785,嘉聯益第一93購01,,,,,0.00,0.00,0,0,0,0,0,0,0,0,0,0,0,0,0
20200316,047786,燿華群益93購03,,,,,0.00,0.00,0,0,0,0,0,0,0,0,0,0,0,0,0
20200316,047787,正崴群益93購01,,,,,0.00,0.00,0,0,0,0,0,0,0,0,0,0,0,0,0
20200316,047788,欣興群益93購05,,,,,0.00,0.00,0,0,0,0,0,0,0,0,0,0,0,0,0
20200316,047789,景碩群益93購01,,,,,0.00,0.00,0,0,0,0,0,0,0,0,0,0,0,0,0
20200316,04778P,可成凱基94售10,,,,,0.00,0.00,0,0,0,0,0,0,0,0,0,0,0,0,0
20200316,047790,致伸群益93購04,,,,,0.00,0.00,0,0,0,0,0,0,0,0,0,0,0,0,0
20200316,047791,聯茂群益93購04,,,,,0.00,0.00,0,0,0,0,0,0,0,0,0,0,0,0,0
20200316,047792,美利達群益93購02,,,,,0.00,0.00,0,0,0,0,0,0,0,0,0,0,0,0,0
20200316,047793,臺股指群益93購04,,,,,0.00,0.00,0,0,0,0,0,0,0,0,0,0,0,0,0
20200316,047794,臺股指群益93購05,,,,,0.00,0.00,0,0,0,0,0,0,0,0,0,0,0,0,0
20200316,047795,臺股指群益93購06,,,,,0.00,0.00,0,0,0,0,0,0,0,0,0,0,0,0,0
20200316,047796,臺股指群益93購07,,,,,0.00,0.00,0,0,0,0,0,0,0,0,0,0,0,0,0
20200316,047797,臺股指群益93購08,,,,,0.00,0.00,0,0,0,0,0,0,0,0,0,0,0,0,0
20200316,047798,臺股指群益93購09,,,,,0.00,0.00,0,0,0,0,0,0,0,0,0,0,0,0,0
20200316,047799,技嘉兆豐93購01,,,,,0.00,0.00,0,0,0,0,0,0,0,0,0,0,0,0,0
20200316,04779P,大立光凱基94售10,0.84,1.40,0.84,1.40,+0.30,27.27,16000,2,14000,0,0,0,0,0,0,0,15000,-15000,-15000
20200316,047800,大立光兆豐93購04,,,,,0.00,0.00,0,0,0,0,0,0,0,0,0,0,0,0,0
20200316,047801,臺股指兆豐93購01,,,,,0.00,0.00,0,0,0,0,0,0,0,0,0,0,0,0,0
20200316,047802,滬深2X凱基95購03,,,,,0.00,0.00,0,0,0,0,0,0,0,0,0,0,0,0,0
20200316,047803,卜蜂凱基93購03,,,,,0.00,0.00,0,0,0,0,0,0,0,0,0,0,0,0,0
20200316,047804,鴻海凱基93購26,,,,,0.00,0.00,0,0,0,0,0,0,0,0,0,0,0,0,0
20200316,047805,台積電凱基93購21,,,,,0.00,0.00,0,0,0,0,0,0,0,0,0,0,0,0,0
20200316,047806,旺宏凱基93購05,,,,,0.00,0.00,0,0,0,0,0,0,0,0,0,0,0,0,0
20200316,047807,華邦電凱基93購06,,,,,0.00,0.00,0,0,0,0,0,0,0,0,0,0,0,0,0
20200316,047808,智邦凱基93購07,,,,,0.00,0.00,0,0,0,0,0,0,0,0,0,0,0,0,0
20200316,047809,瑞昱凱基93購08,,,,,0.00,0.00,0,0,0,0,0,0,0,0,0,0,0,0,0
20200316,04780P,大立光凱基94售11,0.25,0.61,0.25,0.58,+0.33,132.0,120000,4,51500,0,0,0,0,0,0,60000,60000,0,0
20200316,047810,聯發科凱基93購22,,,,,0.00,0.00,0,0,0,0,0,0,0,0,0,0,0,0,0
20200316,047811,聯發科凱基93購23,,,,,0.00,0.00,0,0,0,0,0,0,0,0,0,0,0,0,0
20200316,047812,可成凱基93購09,,,,,0.00,0.00,0,0,0,0,0,0,0,0,0,0,0,0,0
20200316,047813,華新科凱基93購07,0.02,0.02,0.02,0.02,-0.05,-71.43,4000,1,80,0,0,0,0,0,0,4000,0,4000,4000
20200316,047814,宏達電凱基93購02,,,,,0.00,0.00,0,0,0,0,0,0,0,0,0,0,0,0,0
20200316,047815,大立光凱基93購25,,,,,0.00,0.00,0,0,0,0,0,0,0,0,0,0,0,0,0
20200316,047816,大立光凱基93購26,,,,,0.00,0.00,0,0,0,0,0,0,0,0,0,0,0,0,0
20200316,047817,聯茂凱基93購08,,,,,0.00,0.00,0,0,0,0,0,0,0,0,0,0,0,0,0
20200316,047818,台郡凱基93購04,,,,,0.00,0.00,0,0,0,0,0,0,0,0,0,0,0,0,0
20200316,047819,南茂凱基93購04,,,,,0.00,0.00,0,0,0,0,0,0,0,0,0,0,0,0,0
20200316,04781P,欣興凱基94售06,4.88,4.88,4.88,4.88,+0.15,3.17,10000,1,48800,0,0,0,0,0,0,0,10000,-10000,-10000
20200316,047820,世紀鋼凱基93購09,,,,,0.00,0.00,0,0,0,0,0,0,0,0,0,0,0,0,0
20200316,047821,臺股指凱基93購15,,,,,0.00,0.00,0,0,0,0,0,0,0,0,0,0,0,0,0
20200316,047822,臺股指凱基93購16,,,,,0.00,0.00,0,0,0,0,0,0,0,0,0,0,0,0,0
20200316,047823,臺股指凱基93購17,,,,,0.00,0.00,0,0,0,0,0,0,0,0,0,0,0,0,0
20200316,047824,臺股指凱基93購18,,,,,0.00,0.00,0,0,0,0,0,0,0,0,0,0,0,0,0
20200316,047825,道瓊反元大96購01,2.44,2.51,2.25,2.51,+0.21,9.13,167000,20,392760,0,0,0,0,0,0,25000,142000,-117000,-117000
20200316,047826,台泥元大93購01,,,,,0.00,0.00,0,0,0,0,0,0,0,0,0,0,0,0,0
20200316,047827,東陽元大93購01,,,,,0.00,0.00,0,0,0,0,0,0,0,0,0,0,0,0,0
20200316,047828,華新元大93購03,,,,,0.00,0.00,0,0,0,0,0,0,0,0,0,0,0,0,0
20200316,047829,旺宏元大93購06,,,,,0.00,0.00,0,0,0,0,0,0,0,0,0,0,0,0,0
20200316,04782P,智伸科統一96售01,1.98,1.98,1.96,1.96,+0.08,4.26,60000,6,117800,0,0,0,0,0,0,0,60000,-60000,-60000
20200316,047830,智邦元大93購08,,,,,0.00,0.00,0,0,0,0,0,0,0,0,0,0,0,0,0
20200316,047831,台光電元大93購07,,,,,0.00,0.00,0,0,0,0,0,0,0,0,0,0,0,0,0
20200316,047832,漢唐元大94購03,0.57,0.61,0.41,0.41,-0.06,-12.77,43000,6,24430,0,0,0,0,0,0,20000,23000,-3000,-3000
20200316,047833,全新元大94購02,0.09,0.09,0.06,0.06,0.00,0.00,121000,20,8660,0,0,0,0,0,0,0,121000,-121000,-121000
20200316,047834,義隆元大93購02,,,,,0.00,0.00,0,0,0,0,0,0,0,0,0,0,0,0,0
20200316,047835,華新科元大93購09,0.08,0.08,0.08,0.08,0.00,0.00,10000,1,800,0,0,0,0,0,0,0,10000,-10000,-10000
20200316,047836,國泰金元大93購01,,,,,0.00,0.00,0,0,0,0,0,0,0,0,0,0,0,0,0
20200316,047837,嘉晶元大93購01,,,,,0.00,0.00,0,0,0,0,0,0,0,0,0,0,0,0,0
20200316,047838,亞光元大93購03,,,,,0.00,0.00,0,0,0,0,0,0,0,0,0,0,0,0,0
20200316,047839,景碩元大93購03,,,,,0.00,0.00,0,0,0,0,0,0,0,0,0,0,0,0,0
20200316,04783P,貿聯元富94售01,1.44,1.59,1.42,1.59,-0.16,-9.14,52000,6,81580,0,0,0,0,0,0,52000,0,52000,52000
20200316,047840,新日興元大93購03,,,,,0.00,0.00,0,0,0,0,0,0,0,0,0,0,0,0,0
20200316,047841,致伸元大94購01,,,,,0.00,0.00,0,0,0,0,0,0,0,0,0,0,0,0,0
20200316,047842,聯茂元大93購06,,,,,0.00,0.00,0,0,0,0,0,0,0,0,0,0,0,0,0
20200316,047843,超眾元大93購02,,,,,0.00,0.00,0,0,0,0,0,0,0,0,0,0,0,0,0
20200316,047844,台虹元大93購02,,,,,0.00,0.00,0,0,0,0,0,0,0,0,0,0,0,0,0
20200316,047845,美利達元大93購02,,,,,0.00,0.00,0,0,0,0,0,0,0,0,0,0,0,0,0
20200316,047846,滬深2X統一93購04,,,,,0.00,0.00,0,0,0,0,0,0,0,0,0,0,0,0,0
20200316,047847,鴻海統一93購07,,,,,0.00,0.00,0,0,0,0,0,0,0,0,0,0,0,0,0
20200316,047848,可成統一93購01,,,,,0.00,0.00,0,0,0,0,0,0,0,0,0,0,0,0,0
20200316,047849,中工統一93購01,,,,,0.00,0.00,0,0,0,0,0,0,0,0,0,0,0,0,0
20200316,04784P,超眾元富94售01,1.69,2.14,1.69,2.10,+0.07,3.45,39000,14,76060,0,0,0,0,0,0,39000,0,39000,39000
20200316,047850,彩晶統一94購01,,,,,0.00,0.00,0,0,0,0,0,0,0,0,0,0,0,0,0
20200316,047851,智易元富93購02,,,,,0.00,0.00,0,0,0,0,0,0,0,0,0,0,0,0,0
20200316,047852,矽創元富93購01,,,,,0.00,0.00,0,0,0,0,0,0,0,0,0,0,0,0,0
20200316,047853,臺股指元富93購03,,,,,0.00,0.00,0,0,0,0,0,0,0,0,0,0,0,0,0
20200316,047854,滬深2X國票96購02,,,,,0.00,0.00,0,0,0,0,0,0,0,0,0,0,0,0,0
20200316,047855,美律國票94購01,,,,,0.00,0.00,0,0,0,0,0,0,0,0,0,0,0,0,0
20200316,047856,GIS國票94購01,,,,,0.00,0.00,0,0,0,0,0,0,0,0,0,0,0,0,0
20200316,047857,臺股指國票93購12,,,,,0.00,0.00,0,0,0,0,0,0,0,0,0,0,0,0,0
20200316,047858,臺股指國票93購13,,,,,0.00,0.00,0,0,0,0,0,0,0,0,0,0,0,0,0
20200316,047859,臺股指國票93購14,,,,,0.00,0.00,0,0,0,0,0,0,0,0,0,0,0,0,0
20200316,04785P,鴻海永豐94售03,1.12,1.46,1.07,1.46,-0.17,-10.43,12000,6,15280,0,0,0,0,0,0,0,12000,-12000,-12000
20200316,047860,臺股指國票93購15,,,,,0.00,0.00,0,0,0,0,0,0,0,0,0,0,0,0,0
20200316,047861,臺股指國票93購16,,,,,0.00,0.00,0,0,0,0,0,0,0,0,0,0,0,0,0
20200316,047862,超眾台新93購01,,,,,0.00,0.00,0,0,0,0,0,0,0,0,0,0,0,0,0
20200316,047863,東陽康和93購02,,,,,0.00,0.00,0,0,0,0,0,0,0,0,0,0,0,0,0
20200316,047864,信邦康和93購01,,,,,0.00,0.00,0,0,0,0,0,0,0,0,0,0,0,0,0
20200316,047865,健鼎康和93購01,,,,,0.00,0.00,0,0,0,0,0,0,0,0,0,0,0,0,0
20200316,047866,得力永豐93購01,,,,,0.00,0.00,0,0,0,0,0,0,0,0,0,0,0,0,0
20200316,047867,旺宏永豐93購02,,,,,0.00,0.00,0,0,0,0,0,0,0,0,0,0,0,0,0
20200316,047868,欣興永豐93購04,,,,,0.00,0.00,0,0,0,0,0,0,0,0,0,0,0,0,0
20200316,047869,景碩永豐93購01,,,,,0.00,0.00,0,0,0,0,0,0,0,0,0,0,0,0,0
20200316,04786P,鴻海永昌96售01,0.53,0.72,0.53,0.72,+0.17,30.91,29000,8,17700,0,0,0,0,0,0,1000,18000,-17000,-17000
20200316,047870,嘉澤永豐93購02,,,,,0.00,0.00,0,0,0,0,0,0,0,0,0,0,0,0,0
20200316,047871,健策永豐93購02,,,,,0.00,0.00,0,0,0,0,0,0,0,0,0,0,0,0,0
20200316,047872,貿聯永豐93購02,,,,,0.00,0.00,0,0,0,0,0,0,0,0,0,0,0,0,0
20200316,047873,上緯控永豐93購02,,,,,0.00,0.00,0,0,0,0,0,0,0,0,0,0,0,0,0
20200316,047874,易華電永豐93購03,,,,,0.00,0.00,0,0,0,0,0,0,0,0,0,0,0,0,0
20200316,047875,南電永豐93購02,,,,,0.00,0.00,0,0,0,0,0,0,0,0,0,0,0,0,0
20200316,047876,美利達永豐93購01,,,,,0.00,0.00,0,0,0,0,0,0,0,0,0,0,0,0,0
20200316,047877,滬深2X中信95購07,,,,,0.00,0.00,0,0,0,0,0,0,0,0,0,0,0,0,0
20200316,047879,台積電中信93購04,,,,,0.00,0.00,0,0,0,0,0,0,0,0,0,0,0,0,0
20200316,04787P,台積電永昌96售04,1.49,2.11,1.49,2.10,+0.70,50.0,780000,28,1253560,0,0,0,0,0,0,141000,657000,-516000,-516000
20200316,047880,聯發科國泰94購03,,,,,0.00,0.00,0,0,0,0,0,0,0,0,0,0,0,0,0
20200316,047881,和鑫國泰95購01,,,,,0.00,0.00,0,0,0,0,0,0,0,0,0,0,0,0,0
20200316,047882,超眾國泰94購01,,,,,0.00,0.00,0,0,0,0,0,0,0,0,0,0,0,0,0
20200316,047883,臺股指永昌93購01,0.01,0.02,0.01,0.02,0.00,0.00,56000,2,780,0,0,0,0,0,0,34000,22000,12000,12000
20200316,047884,臺股指永昌93購02,,,,,0.00,0.00,0,0,0,0,0,0,0,0,0,0,0,0,0
20200316,047885,元金2X富邦99購01,0.49,0.55,0.40,0.50,-0.23,-31.51,2012000,231,1000200,0,0,0,0,0,0,0,1966000,-1966000,-1966000
20200316,047886,京元電富邦95購01,0.19,0.21,0.19,0.20,+0.05,33.33,560000,8,114400,0,0,0,0,0,0,0,550000,-550000,-550000
20200316,047887,智原富邦97購01,,,,,0.00,0.00,0,0,0,0,0,0,0,0,0,0,0,0,0
20200316,047888,臺股指富邦93購01,,,,,0.00,0.00,0,0,0,0,0,0,0,0,0,0,0,0,0
20200316,047889,臺股指富邦93購02,,,,,0.00,0.00,0,0,0,0,0,0,0,0,0,0,0,0,0
20200316,04788P,台積電永昌96售05,0.30,0.30,0.29,0.29,+0.04,16.0,25000,3,7400,0,0,0,0,0,0,0,10000,-10000,-10000
20200316,047890,電子類富邦93購01,,,,,0.00,0.00,0,0,0,0,0,0,0,0,0,0,0,0,0
20200316,047891,滬深2X第一93購01,,,,,0.00,0.00,0,0,0,0,0,0,0,0,0,0,0,0,0
20200316,047892,康控兆豐94購01,,,,,0.00,0.00,0,0,0,0,0,0,0,0,0,0,0,0,0
20200316,047893,嘉聯益兆豐94購01,,,,,0.00,0.00,0,0,0,0,0,0,0,0,0,0,0,0,0
20200316,047894,大成鋼群益93購01,,,,,0.00,0.00,0,0,0,0,0,0,0,0,0,0,0,0,0
20200316,047895,台積電群益94購04,0.49,0.59,0.49,0.49,-0.18,-26.87,101000,15,51300,0,0,0,0,0,0,1000,85000,-84000,-84000
20200316,047896,京元電群益93購01,,,,,0.00,0.00,0,0,0,0,0,0,0,0,0,0,0,0,0
20200316,047897,可成群益94購01,0.02,0.02,0.02,0.02,0.00,0.00,25000,1,500,0,0,0,0,0,0,25000,0,25000,25000
20200316,047898,嘉澤群益93購02,,,,,0.00,0.00,0,0,0,0,0,0,0,0,0,0,0,0,0
20200316,047899,貿聯群益93購03,,,,,0.00,0.00,0,0,0,0,0,0,0,0,0,0,0,0,0
20200316,04789P,台積電富邦95售03,,,,,0.00,0.00,0,0,0,0,0,0,0,0,0,0,0,0,0
20200316,047900,TPK群益93購03,,,,,0.00,0.00,0,0,0,0,0,0,0,0,0,0,0,0,0
20200316,047901,復盛群益93購01,,,,,0.00,0.00,0,0,0,0,0,0,0,0,0,0,0,0,0
20200316,047902,美利達群益93購03,,,,,0.00,0.00,0,0,0,0,0,0,0,0,0,0,0,0,0
20200316,047903,滬深2X元大96購01,,,,,0.00,0.00,0,0,0,0,0,0,0,0,0,0,0,0,0
20200316,047904,臺指反元大96購01,,,,,0.00,0.00,0,0,0,0,0,0,0,0,0,0,0,0,0
20200316,047905,元油反元大96購04,,,,,0.00,0.00,0,0,0,0,0,0,0,0,0,0,0,0,0
20200316,047906,中石化元大94購01,,,,,0.00,0.00,0,0,0,0,0,0,0,0,0,0,0,0,0
20200316,047907,燿華元大93購05,,,,,0.00,0.00,0,0,0,0,0,0,0,0,0,0,0,0,0
20200316,047908,南亞科元大93購02,,,,,0.00,0.00,0,0,0,0,0,0,0,0,0,0,0,0,0
20200316,047909,超眾元大93購03,,,,,0.00,0.00,0,0,0,0,0,0,0,0,0,0,0,0,0
20200316,04790P,台積電元大94售19,0.28,0.50,0.28,0.50,-0.11,-18.03,820000,83,322450,0,0,0,0,0,0,805000,815000,-10000,-10000
20200316,047910,全新麥證94購01,,,,,0.00,0.00,0,0,0,0,0,0,0,0,0,0,0,0,0
20200316,047911,晶技麥證94購01,0.97,0.97,0.88,0.88,+0.10,12.82,860000,18,802400,0,860000,-860000,0,0,0,860000,860000,0,0
20200316,047912,台郡麥證94購01,0.17,0.17,0.17,0.17,0.00,0.00,20000,2,3400,20000,0,20000,0,0,0,20000,0,20000,20000
20200316,047913,美利達麥證93購01,,,,,0.00,0.00,0,0,0,0,0,0,0,0,0,0,0,0,0
20200316,047914,華新凱基93購03,,,,,0.00,0.00,0,0,0,0,0,0,0,0,0,0,0,0,0
20200316,047915,鴻海凱基93購27,,,,,0.00,0.00,0,0,0,0,0,0,0,0,0,0,0,0,0
20200316,047916,台積電凱基93購22,,,,,0.00,0.00,0,0,0,0,0,0,0,0,0,0,0,0,0
20200316,047917,台積電凱基94購01,,,,,0.00,0.00,0,0,0,0,0,0,0,0,0,0,0,0,0
20200316,047918,智邦凱基93購08,,,,,0.00,0.00,0,0,0,0,0,0,0,0,0,0,0,0,0
20200316,047919,技嘉凱基93購06,,,,,0.00,0.00,0,0,0,0,0,0,0,0,0,0,0,0,0
20200316,04791P,台積電元大94售20,0.03,0.03,0.03,0.03,0.00,0.00,40000,2,1200,0,0,0,0,0,0,0,10000,-10000,-10000
20200316,047920,南亞科凱基93購04,,,,,0.00,0.00,0,0,0,0,0,0,0,0,0,0,0,0,0
20200316,047921,南亞科凱基93購05,,,,,0.00,0.00,0,0,0,0,0,0,0,0,0,0,0,0,0
20200316,047922,聯發科凱基94購01,,,,,0.00,0.00,0,0,0,0,0,0,0,0,0,0,0,0,0
20200316,047923,聯發科凱基94購02,,,,,0.00,0.00,0,0,0,0,0,0,0,0,0,0,0,0,0
20200316,047924,可成凱基93購10,,,,,0.00,0.00,0,0,0,0,0,0,0,0,0,0,0,0,0
20200316,047925,可成凱基94購01,,,,,0.00,0.00,0,0,0,0,0,0,0,0,0,0,0,0,0
20200316,047926,可成凱基94購02,,,,,0.00,0.00,0,0,0,0,0,0,0,0,0,0,0,0,0
20200316,047927,宏達電凱基93購03,,,,,0.00,0.00,0,0,0,0,0,0,0,0,0,0,0,0,0
20200316,047928,禾伸堂凱基93購04,,,,,0.00,0.00,0,0,0,0,0,0,0,0,0,0,0,0,0
20200316,047929,景碩凱基93購03,,,,,0.00,0.00,0,0,0,0,0,0,0,0,0,0,0,0,0
20200316,04792P,智邦元大94售06,1.55,1.69,1.50,1.69,-0.85,-33.46,23000,4,38350,0,0,0,0,0,0,0,23000,-23000,-23000
20200316,047930,嘉澤凱基93購03,,,,,0.00,0.00,0,0,0,0,0,0,0,0,0,0,0,0,0
20200316,047931,日月光凱基93購01,,,,,0.00,0.00,0,0,0,0,0,0,0,0,0,0,0,0,0
20200316,047932,麗豐凱基93購01,,,,,0.00,0.00,0,0,0,0,0,0,0,0,0,0,0,0,0
20200316,047933,瑞儀凱基93購06,,,,,0.00,0.00,0,0,0,0,0,0,0,0,0,0,0,0,0
20200316,047934,GIS凱基94購01,,,,,0.00,0.00,0,0,0,0,0,0,0,0,0,0,0,0,0
20200316,047935,美利達凱基93購01,,,,,0.00,0.00,0,0,0,0,0,0,0,0,0,0,0,0,0
20200316,047936,美利達凱基93購02,,,,,0.00,0.00,0,0,0,0,0,0,0,0,0,0,0,0,0
20200316,047937,元金2X國票97購02,,,,,0.00,0.00,0,0,0,0,0,0,0,0,0,0,0,0,0
20200316,047938,台化國票93購01,,,,,0.00,0.00,0,0,0,0,0,0,0,0,0,0,0,0,0
20200316,047939,亞德客國票93購02,,,,,0.00,0.00,0,0,0,0,0,0,0,0,0,0,0,0,0
20200316,04793P,台光電元大94售07,,,,,0.00,0.00,0,0,0,0,0,0,0,0,0,0,0,0,0
20200316,047940,台光電國票93購01,,,,,0.00,0.00,0,0,0,0,0,0,0,0,0,0,0,0,0
20200316,047941,義隆國票94購02,,,,,0.00,0.00,0,0,0,0,0,0,0,0,0,0,0,0,0
20200316,047942,華新科國票94購04,,,,,0.00,0.00,0,0,0,0,0,0,0,0,0,0,0,0,0
20200316,047943,欣興國票93購06,,,,,0.00,0.00,0,0,0,0,0,0,0,0,0,0,0,0,0
20200316,047944,中石化元富96購01,0.01,0.01,0.01,0.01,0.00,0.00,40000,1,400,0,0,0,0,0,0,40000,0,40000,40000
20200316,047945,滬深2X統一94購01,,,,,0.00,0.00,0,0,0,0,0,0,0,0,0,0,0,0,0
20200316,047946,南亞科統一93購04,,,,,0.00,0.00,0,0,0,0,0,0,0,0,0,0,0,0,0
20200316,047947,欣興統一93購04,,,,,0.00,0.00,0,0,0,0,0,0,0,0,0,0,0,0,0
20200316,047948,瑞儀統一93購01,,,,,0.00,0.00,0,0,0,0,0,0,0,0,0,0,0,0,0
20200316,047949,燿華台新93購01,,,,,0.00,0.00,0,0,0,0,0,0,0,0,0,0,0,0,0
20200316,04794P,友達元大96售03,0.64,0.77,0.64,0.77,-0.09,-10.47,255000,28,190570,0,0,0,0,0,0,0,255000,-255000,-255000
20200316,047950,滬深2X永豐94購02,,,,,0.00,0.00,0,0,0,0,0,0,0,0,0,0,0,0,0
20200316,047951,元油反永豐94購01,,,,,0.00,0.00,0,0,0,0,0,0,0,0,0,0,0,0,0
20200316,047952,華通永豐93購03,,,,,0.00,0.00,0,0,0,0,0,0,0,0,0,0,0,0,0
20200316,047953,台積電永豐93購04,,,,,0.00,0.00,0,0,0,0,0,0,0,0,0,0,0,0,0
20200316,047954,漢唐永豐93購02,,,,,0.00,0.00,0,0,0,0,0,0,0,0,0,0,0,0,0
20200316,047955,南亞科永豐93購01,,,,,0.00,0.00,0,0,0,0,0,0,0,0,0,0,0,0,0
20200316,047956,麗豐永豐93購02,,,,,0.00,0.00,0,0,0,0,0,0,0,0,0,0,0,0,0
20200316,047957,鎧勝永豐93購01,,,,,0.00,0.00,0,0,0,0,0,0,0,0,0,0,0,0,0
20200316,047958,矽創永豐93購02,,,,,0.00,0.00,0,0,0,0,0,0,0,0,0,0,0,0,0
20200316,047959,南電永豐93購03,,,,,0.00,0.00,0,0,0,0,0,0,0,0,0,0,0,0,0
20200316,04795P,聯發科元大94售09,1.06,1.81,1.04,1.81,+0.47,35.07,64000,7,84600,0,0,0,0,0,0,50000,64000,-14000,-14000
20200316,047960,鈺齊永豐93購01,,,,,0.00,0.00,0,0,0,0,0,0,0,0,0,0,0,0,0
20200316,047961,百和永豐93購03,,,,,0.00,0.00,0,0,0,0,0,0,0,0,0,0,0,0,0
20200316,047962,T50反1中信96購02,1.53,1.70,1.53,1.70,+0.39,29.77,69000,3,112600,0,0,0,0,0,0,59000,10000,49000,49000
20200316,047963,滬深2X中信94購04,,,,,0.00,0.00,0,0,0,0,0,0,0,0,0,0,0,0,0
20200316,047964,元油反中信95購01,,,,,0.00,0.00,0,0,0,0,0,0,0,0,0,0,0,0,0
20200316,047965,景碩中信93購01,,,,,0.00,0.00,0,0,0,0,0,0,0,0,0,0,0,0,0
20200316,047966,華通國泰94購01,,,,,0.00,0.00,0,0,0,0,0,0,0,0,0,0,0,0,0
20200316,047967,南亞科國泰95購01,,,,,0.00,0.00,0,0,0,0,0,0,0,0,0,0,0,0,0
20200316,047968,南電國泰94購01,0.43,0.43,0.43,0.43,+0.03,7.5,12000,1,5160,0,0,0,0,0,0,12000,12000,0,0
20200316,047969,台達電富邦97購01,0.10,0.10,0.10,0.10,-0.08,-44.44,145000,3,14500,0,0,0,0,0,0,145000,0,145000,145000
20200316,04796P,聯發科元大94售10,0.62,1.29,0.62,1.29,+0.65,101.56,256000,52,186920,0,0,0,0,0,0,60000,256000,-196000,-196000
20200316,047970,鴻海富邦95購01,,,,,0.00,0.00,0,0,0,0,0,0,0,0,0,0,0,0,0
20200316,047971,南亞科富邦95購01,,,,,0.00,0.00,0,0,0,0,0,0,0,0,0,0,0,0,0
20200316,047972,康控富邦95購01,0.01,0.01,0.01,0.01,0.00,0.00,275000,3,2750,0,0,0,0,0,0,0,0,0,0
20200316,047973,華通兆豐94購01,,,,,0.00,0.00,0,0,0,0,0,0,0,0,0,0,0,0,0
20200316,047974,新光金兆豐93購01,,,,,0.00,0.00,0,0,0,0,0,0,0,0,0,0,0,0,0
20200316,047975,緯創兆豐93購01,,,,,0.00,0.00,0,0,0,0,0,0,0,0,0,0,0,0,0
20200316,047976,台光電亞東93購01,,,,,0.00,0.00,0,0,0,0,0,0,0,0,0,0,0,0,0
20200316,047977,南電亞東93購03,,,,,0.00,0.00,0,0,0,0,0,0,0,0,0,0,0,0,0
20200316,047978,元油反群益97購01,,,,,0.00,0.00,0,0,0,0,0,0,0,0,0,0,0,0,0
20200316,047979,中石化群益95購01,,,,,0.00,0.00,0,0,0,0,0,0,0,0,0,0,0,0,0
20200316,04797P,華新科元大94售04,1.51,1.98,1.51,1.98,+0.11,5.88,65000,7,119650,0,0,0,0,0,0,0,65000,-65000,-65000
20200316,047980,東陽群益93購02,,,,,0.00,0.00,0,0,0,0,0,0,0,0,0,0,0,0,0
20200316,047981,南亞科群益93購02,,,,,0.00,0.00,0,0,0,0,0,0,0,0,0,0,0,0,0
20200316,047982,奇力新群益93購05,,,,,0.00,0.00,0,0,0,0,0,0,0,0,0,0,0,0,0
20200316,047983,宏達電群益93購04,,,,,0.00,0.00,0,0,0,0,0,0,0,0,0,0,0,0,0
20200316,047984,禾伸堂群益93購01,,,,,0.00,0.00,0,0,0,0,0,0,0,0,0,0,0,0,0
20200316,047985,欣興群益93購07,,,,,0.00,0.00,0,0,0,0,0,0,0,0,0,0,0,0,0
20200316,047986,明泰群益93購01,,,,,0.00,0.00,0,0,0,0,0,0,0,0,0,0,0,0,0
20200316,047987,力成群益93購01,,,,,0.00,0.00,0,0,0,0,0,0,0,0,0,0,0,0,0
20200316,047988,志超群益93購02,,,,,0.00,0.00,0,0,0,0,0,0,0,0,0,0,0,0,0
20200316,047989,深中小元大96購02,0.44,0.44,0.38,0.38,-0.01,-2.56,100000,10,41300,0,0,0,0,0,0,0,100000,-100000,-100000
20200316,04798P,牧德元大95售02,0.53,0.59,0.53,0.59,+0.09,18.0,116000,13,66530,0,0,0,0,0,0,0,116000,-116000,-116000
20200316,047990,臺指反元大96購02,,,,,0.00,0.00,0,0,0,0,0,0,0,0,0,0,0,0,0
20200316,047991,元油反元大96購05,,,,,0.00,0.00,0,0,0,0,0,0,0,0,0,0,0,0,0
20200316,047992,東陽元大96購01,,,,,0.00,0.00,0,0,0,0,0,0,0,0,0,0,0,0,0
20200316,047993,鑽全元大96購01,,,,,0.00,0.00,0,0,0,0,0,0,0,0,0,0,0,0,0
20200316,047994,亞德客元大93購03,0.43,0.43,0.43,0.43,0.00,0.00,10000,1,4300,0,0,0,0,0,0,0,10000,-10000,-10000
20200316,047995,台達電元大96購01,,,,,0.00,0.00,0,0,0,0,0,0,0,0,0,0,0,0,0
20200316,047996,華邦電元大93購04,,,,,0.00,0.00,0,0,0,0,0,0,0,0,0,0,0,0,0
20200316,047997,南亞科元大93購03,,,,,0.00,0.00,0,0,0,0,0,0,0,0,0,0,0,0,0
20200316,047998,美律元大93購06,,,,,0.00,0.00,0,0,0,0,0,0,0,0,0,0,0,0,0
20200316,047999,聯發科元大93購22,,,,,0.00,0.00,0,0,0,0,0,0,0,0,0,0,0,0,0
20200316,04799P,健策元大94售03,0.39,0.39,0.39,0.39,0.00,0.00,10000,1,3900,0,0,0,0,0,0,10000,10000,0,0
20200316,048000,義隆元大93購03,0.05,0.05,0.05,0.05,0.00,0.00,10000,1,500,0,0,0,0,0,0,10000,0,10000,10000
20200316,048001,中工元大96購01,0.19,0.19,0.18,0.18,-0.04,-18.18,22000,3,4030,0,0,0,0,0,0,22000,22000,0,0
20200316,048002,景碩元大93購04,,,,,0.00,0.00,0,0,0,0,0,0,0,0,0,0,0,0,0
20200316,048003,旭富元大93購01,0.91,0.91,0.91,0.91,+0.57,167.65,20000,1,18200,0,0,0,0,0,0,20000,0,20000,20000
20200316,048004,康控元大93購05,,,,,0.00,0.00,0,0,0,0,0,0,0,0,0,0,0,0,0
20200316,048005,鎧勝元大93購02,,,,,0.00,0.00,0,0,0,0,0,0,0,0,0,0,0,0,0
20200316,048006,瑞儀元大93購03,,,,,0.00,0.00,0,0,0,0,0,0,0,0,0,0,0,0,0
20200316,048007,明基材元大96購01,0.16,0.17,0.12,0.12,0.00,0.00,593000,23,90380,0,0,0,0,0,0,372000,200000,172000,172000
20200316,048008,聯發科富邦95購02,,,,,0.00,0.00,0,0,0,0,0,0,0,0,0,0,0,0,0
20200316,048009,中壽富邦94購01,,,,,0.00,0.00,0,0,0,0,0,0,0,0,0,0,0,0,0
20200316,04800P,聯茂元大94售08,,,,,0.00,0.00,0,0,0,0,0,0,0,0,0,0,0,0,0
20200316,048010,嘉聯益富邦97購01,0.29,0.29,0.18,0.18,-0.05,-21.74,90000,5,19600,0,0,0,0,0,0,0,60000,-60000,-60000
20200316,048011,滬深2X國票93購02,,,,,0.00,0.00,0,0,0,0,0,0,0,0,0,0,0,0,0
20200316,048012,嘉晶國票94購01,0.54,0.54,0.51,0.51,+0.32,168.42,20000,2,10500,0,0,0,0,0,0,20000,0,20000,20000
20200316,048013,智易國票93購01,,,,,0.00,0.00,0,0,0,0,0,0,0,0,0,0,0,0,0
20200316,048014,貿聯國票93購03,,,,,0.00,0.00,0,0,0,0,0,0,0,0,0,0,0,0,0
20200316,048015,致伸國票93購03,,,,,0.00,0.00,0,0,0,0,0,0,0,0,0,0,0,0,0
20200316,048016,啟碁國票94購01,,,,,0.00,0.00,0,0,0,0,0,0,0,0,0,0,0,0,0
20200316,048017,美利達國票93購01,,,,,0.00,0.00,0,0,0,0,0,0,0,0,0,0,0,0,0
20200316,048018,南亞科麥證93購01,,,,,0.00,0.00,0,0,0,0,0,0,0,0,0,0,0,0,0
20200316,048019,GIS麥證94購01,,,,,0.00,0.00,0,0,0,0,0,0,0,0,0,0,0,0,0
20200316,04801P,矽力元大94售02,0.27,0.50,0.27,0.48,+0.14,41.18,102000,12,43040,0,0,0,0,0,0,15000,87000,-72000,-72000
20200316,048020,滬深2X凱基96購02,,,,,0.00,0.00,0,0,0,0,0,0,0,0,0,0,0,0,0
20200316,048021,滬深反凱基93購02,0.05,0.05,0.05,0.05,-0.03,-37.5,26000,1,1300,0,0,0,0,0,0,26000,0,26000,26000
20200316,048022,儒鴻凱基93購04,,,,,0.00,0.00,0,0,0,0,0,0,0,0,0,0,0,0,0
20200316,048023,鴻海凱基93購28,,,,,0.00,0.00,0,0,0,0,0,0,0,0,0,0,0,0,0
20200316,048024,鴻海凱基93購29,,,,,0.00,0.00,0,0,0,0,0,0,0,0,0,0,0,0,0
20200316,048025,鴻海凱基93購30,,,,,0.00,0.00,0,0,0,0,0,0,0,0,0,0,0,0,0
20200316,048026,瑞昱凱基94購01,,,,,0.00,0.00,0,0,0,0,0,0,0,0,0,0,0,0,0
20200316,048027,京元電凱基93購03,,,,,0.00,0.00,0,0,0,0,0,0,0,0,0,0,0,0,0
20200316,048028,聯發科凱基93購25,,,,,0.00,0.00,0,0,0,0,0,0,0,0,0,0,0,0,0
20200316,048029,聯發科凱基93購26,,,,,0.00,0.00,0,0,0,0,0,0,0,0,0,0,0,0,0
20200316,04802P,國巨凱基94售07,0.80,1.00,0.80,1.00,+0.20,25.0,112000,8,95000,0,0,0,0,0,0,67000,0,67000,67000
20200316,048030,聯發科凱基93購27,,,,,0.00,0.00,0,0,0,0,0,0,0,0,0,0,0,0,0
20200316,048031,全新凱基93購02,,,,,0.00,0.00,0,0,0,0,0,0,0,0,0,0,0,0,0
20200316,048032,可成凱基93購13,,,,,0.00,0.00,0,0,0,0,0,0,0,0,0,0,0,0,0
20200316,048033,大立光凱基93購28,,,,,0.00,0.00,0,0,0,0,0,0,0,0,0,0,0,0,0
20200316,048034,大立光凱基93購29,,,,,0.00,0.00,0,0,0,0,0,0,0,0,0,0,0,0,0
20200316,048035,聯詠凱基93購06,,,,,0.00,0.00,0,0,0,0,0,0,0,0,0,0,0,0,0
20200316,048036,隆達凱基93購01,,,,,0.00,0.00,0,0,0,0,0,0,0,0,0,0,0,0,0
20200316,048037,台表科凱基93購05,,,,,0.00,0.00,0,0,0,0,0,0,0,0,0,0,0,0,0
20200316,048038,樺漢凱基93購03,,,,,0.00,0.00,0,0,0,0,0,0,0,0,0,0,0,0,0
20200316,048039,矽創凱基93購03,,,,,0.00,0.00,0,0,0,0,0,0,0,0,0,0,0,0,0
20200316,04803P,台積電凱基94售30,,,,,0.00,0.00,0,0,0,0,0,0,0,0,0,0,0,0,0
20200316,048040,百和凱基93購07,,,,,0.00,0.00,0,0,0,0,0,0,0,0,0,0,0,0,0
20200316,048041,元油反台新94購01,,,,,0.00,0.00,0,0,0,0,0,0,0,0,0,0,0,0,0
20200316,048042,廣越康和93購02,,,,,0.00,0.00,0,0,0,0,0,0,0,0,0,0,0,0,0
20200316,048043,滬深2X永豐94購03,,,,,0.00,0.00,0,0,0,0,0,0,0,0,0,0,0,0,0
20200316,048044,儒鴻永豐93購01,,,,,0.00,0.00,0,0,0,0,0,0,0,0,0,0,0,0,0
20200316,048045,上銀永豐93購02,,,,,0.00,0.00,0,0,0,0,0,0,0,0,0,0,0,0,0
20200316,048046,正崴永豐93購01,,,,,0.00,0.00,0,0,0,0,0,0,0,0,0,0,0,0,0
20200316,048047,全新永豐93購02,,,,,0.00,0.00,0,0,0,0,0,0,0,0,0,0,0,0,0
20200316,048048,大立光永豐93購03,,,,,0.00,0.00,0,0,0,0,0,0,0,0,0,0,0,0,0
20200316,048049,滬深反中信96購01,0.44,0.53,0.44,0.53,+0.14,35.9,224000,6,115650,0,0,0,0,0,0,15000,209000,-194000,-194000
20200316,04804P,聯發科凱基94售12,0.23,0.53,0.21,0.53,+0.29,120.83,139000,9,50740,0,0,0,0,0,0,129000,10000,119000,119000
20200316,048050,元油反中信93購01,,,,,0.00,0.00,0,0,0,0,0,0,0,0,0,0,0,0,0
20200316,048051,大立光中信94購03,0.81,0.88,0.49,0.49,-0.23,-31.94,89000,34,66290,0,0,0,0,0,0,57000,42000,15000,15000
20200316,048052,力成中信93購01,,,,,0.00,0.00,0,0,0,0,0,0,0,0,0,0,0,0,0
20200316,048053,美利達中信93購01,,,,,0.00,0.00,0,0,0,0,0,0,0,0,0,0,0,0,0
20200316,048054,鴻海國泰95購01,,,,,0.00,0.00,0,0,0,0,0,0,0,0,0,0,0,0,0
20200316,048055,燿華國泰95購02,,,,,0.00,0.00,0,0,0,0,0,0,0,0,0,0,0,0,0
20200316,048056,全新國泰94購02,,,,,0.00,0.00,0,0,0,0,0,0,0,0,0,0,0,0,0
20200316,048057,宏達電國泰94購02,,,,,0.00,0.00,0,0,0,0,0,0,0,0,0,0,0,0,0
20200316,048058,大立光國泰95購01,0.71,0.71,0.41,0.43,-0.35,-44.87,70000,7,40500,0,0,0,0,0,0,10000,70000,-60000,-60000
20200316,048059,欣興國泰95購01,,,,,0.00,0.00,0,0,0,0,0,0,0,0,0,0,0,0,0
20200316,04805P,創意元富94售01,1.67,1.86,1.65,1.79,+0.19,11.88,55000,15,94880,0,0,0,0,0,0,55000,0,55000,55000
20200316,048060,台達電統一93購01,,,,,0.00,0.00,0,0,0,0,0,0,0,0,0,0,0,0,0
20200316,048061,鴻海統一95購03,0.06,0.06,0.06,0.06,-0.06,-50.0,60000,2,3600,0,0,0,0,0,0,0,0,0,0
20200316,048062,南亞科統一93購05,,,,,0.00,0.00,0,0,0,0,0,0,0,0,0,0,0,0,0
20200316,048063,聯發科統一93購03,,,,,0.00,0.00,0,0,0,0,0,0,0,0,0,0,0,0,0
20200316,048064,可成統一93購02,,,,,0.00,0.00,0,0,0,0,0,0,0,0,0,0,0,0,0
20200316,048065,群創統一93購04,,,,,0.00,0.00,0,0,0,0,0,0,0,0,0,0,0,0,0
20200316,048066,樺漢統一93購01,,,,,0.00,0.00,0,0,0,0,0,0,0,0,0,0,0,0,0
20200316,048067,台光電元富93購01,,,,,0.00,0.00,0,0,0,0,0,0,0,0,0,0,0,0,0
20200316,048068,南亞科元富95購01,,,,,0.00,0.00,0,0,0,0,0,0,0,0,0,0,0,0,0
20200316,048069,南亞科元富95購02,,,,,0.00,0.00,0,0,0,0,0,0,0,0,0,0,0,0,0
20200316,04806P,臻鼎元富94售06,4.54,4.54,4.24,4.24,-0.09,-2.08,44000,4,195560,0,0,0,0,0,0,44000,0,44000,44000
20200316,048070,聯發科元富99購03,0.21,0.23,0.14,0.14,-0.11,-44.0,424000,26,79910,0,0,0,0,0,0,93000,331000,-238000,-238000
20200316,048071,創意元富93購03,,,,,0.00,0.00,0,0,0,0,0,0,0,0,0,0,0,0,0
20200316,048072,GIS元富93購05,,,,,0.00,0.00,0,0,0,0,0,0,0,0,0,0,0,0,0
20200316,048073,南電元富93購02,,,,,0.00,0.00,0,0,0,0,0,0,0,0,0,0,0,0,0
20200316,048074,美利達元富93購01,,,,,0.00,0.00,0,0,0,0,0,0,0,0,0,0,0,0,0
20200316,048075,美利達元富93購02,,,,,0.00,0.00,0,0,0,0,0,0,0,0,0,0,0,0,0
20200316,048076,亞光第一94購01,,,,,0.00,0.00,0,0,0,0,0,0,0,0,0,0,0,0,0
20200316,048077,中磊亞東93購02,,,,,0.00,0.00,0,0,0,0,0,0,0,0,0,0,0,0,0
20200316,048078,嘉聯益亞東93購02,,,,,0.00,0.00,0,0,0,0,0,0,0,0,0,0,0,0,0
20200316,048079,燿華日盛93購01,,,,,0.00,0.00,0,0,0,0,0,0,0,0,0,0,0,0,0
20200316,04807P,聯茂元富94售01,1.87,1.87,1.78,1.84,-0.30,-14.02,29000,3,53360,0,0,0,0,0,0,29000,5000,24000,24000
20200316,048080,元石油凱基96購01,,,,,0.00,0.00,0,0,0,0,0,0,0,0,0,0,0,0,0
20200316,048081,元油反凱基96購01,,,,,0.00,0.00,0,0,0,0,0,0,0,0,0,0,0,0,0
20200316,048082,台苯凱基93購01,,,,,0.00,0.00,0,0,0,0,0,0,0,0,0,0,0,0,0
20200316,048083,台達電凱基93購04,,,,,0.00,0.00,0,0,0,0,0,0,0,0,0,0,0,0,0
20200316,048084,華通凱基93購05,,,,,0.00,0.00,0,0,0,0,0,0,0,0,0,0,0,0,0
20200316,048085,鴻海凱基93購32,,,,,0.00,0.00,0,0,0,0,0,0,0,0,0,0,0,0,0
20200316,048086,鴻海凱基93購33,,,,,0.00,0.00,0,0,0,0,0,0,0,0,0,0,0,0,0
20200316,048087,國巨凱基93購07,3.73,3.73,2.17,2.17,-1.01,-31.76,60000,2,208200,0,0,0,0,0,0,50000,10000,40000,40000
20200316,048088,台積電凱基93購23,,,,,0.00,0.00,0,0,0,0,0,0,0,0,0,0,0,0,0
20200316,048089,智邦凱基93購10,,,,,0.00,0.00,0,0,0,0,0,0,0,0,0,0,0,0,0
20200316,04808P,訊芯永豐94售02,,,,,0.00,0.00,0,0,0,0,0,0,0,0,0,0,0,0,0
20200316,048090,正崴凱基93購03,,,,,0.00,0.00,0,0,0,0,0,0,0,0,0,0,0,0,0
20200316,048091,漢唐凱基93購03,,,,,0.00,0.00,0,0,0,0,0,0,0,0,0,0,0,0,0
20200316,048092,聯發科凱基93購29,,,,,0.00,0.00,0,0,0,0,0,0,0,0,0,0,0,0,0
20200316,048093,聯發科凱基93購30,,,,,0.00,0.00,0,0,0,0,0,0,0,0,0,0,0,0,0
20200316,048094,大立光凱基93購31,,,,,0.00,0.00,0,0,0,0,0,0,0,0,0,0,0,0,0
20200316,048095,大立光凱基93購32,,,,,0.00,0.00,0,0,0,0,0,0,0,0,0,0,0,0,0
20200316,048096,大立光凱基93購33,,,,,0.00,0.00,0,0,0,0,0,0,0,0,0,0,0,0,0
20200316,048097,聯詠凱基93購07,0.32,0.32,0.32,0.32,+0.22,220.0,10000,1,3200,0,0,0,0,0,0,0,10000,-10000,-10000
20200316,048098,嘉澤凱基93購04,,,,,0.00,0.00,0,0,0,0,0,0,0,0,0,0,0,0,0
20200316,048099,健策凱基93購06,,,,,0.00,0.00,0,0,0,0,0,0,0,0,0,0,0,0,0
20200316,04809P,台光電群益94售04,,,,,0.00,0.00,0,0,0,0,0,0,0,0,0,0,0,0,0
20200316,048100,貿聯凱基93購02,,,,,0.00,0.00,0,0,0,0,0,0,0,0,0,0,0,0,0
20200316,048101,致伸凱基93購05,,,,,0.00,0.00,0,0,0,0,0,0,0,0,0,0,0,0,0
20200316,048102,矽力凱基94購01,1.66,1.66,0.80,0.80,-0.62,-43.66,43000,11,44400,0,0,0,0,0,0,2000,41000,-39000,-39000
20200316,048103,GIS凱基93購06,,,,,0.00,0.00,0,0,0,0,0,0,0,0,0,0,0,0,0
20200316,048104,易華電凱基93購03,,,,,0.00,0.00,0,0,0,0,0,0,0,0,0,0,0,0,0
20200316,048105,滬深2X群益99購02,0.20,0.21,0.20,0.21,0.00,0.00,60000,2,12300,0,0,0,0,0,0,0,60000,-60000,-60000
20200316,048106,臺指反群益93購02,0.83,0.83,0.83,0.83,-0.22,-20.95,1000,1,830,0,0,0,0,0,0,1000,0,1000,1000
20200316,048107,華通群益93購02,,,,,0.00,0.00,0,0,0,0,0,0,0,0,0,0,0,0,0
20200316,048108,鴻海群益93購07,,,,,0.00,0.00,0,0,0,0,0,0,0,0,0,0,0,0,0
20200316,048109,旺宏群益94購02,,,,,0.00,0.00,0,0,0,0,0,0,0,0,0,0,0,0,0
20200316,04810P,亞德客元大94售01,,,,,0.00,0.00,0,0,0,0,0,0,0,0,0,0,0,0,0
20200316,048110,京元電群益94購01,,,,,0.00,0.00,0,0,0,0,0,0,0,0,0,0,0,0,0
20200316,048111,奇力新群益93購06,,,,,0.00,0.00,0,0,0,0,0,0,0,0,0,0,0,0,0
20200316,048112,宏達電群益93購05,,,,,0.00,0.00,0,0,0,0,0,0,0,0,0,0,0,0,0
20200316,048113,欣興群益93購08,,,,,0.00,0.00,0,0,0,0,0,0,0,0,0,0,0,0,0
20200316,048114,景碩群益93購02,,,,,0.00,0.00,0,0,0,0,0,0,0,0,0,0,0,0,0
20200316,048115,樺漢群益93購01,,,,,0.00,0.00,0,0,0,0,0,0,0,0,0,0,0,0,0
20200316,048116,矽創群益93購02,,,,,0.00,0.00,0,0,0,0,0,0,0,0,0,0,0,0,0
20200316,048117,南電群益93購02,,,,,0.00,0.00,0,0,0,0,0,0,0,0,0,0,0,0,0
20200316,048118,百和群益94購03,,,,,0.00,0.00,0,0,0,0,0,0,0,0,0,0,0,0,0
20200316,048119,臺指反元大96購03,1.49,1.49,1.49,1.49,0.00,0.00,10000,1,14900,0,0,0,0,0,0,0,10000,-10000,-10000
20200316,04811P,上銀元大94售02,2.06,2.48,2.06,2.48,+0.13,5.53,20000,2,45400,0,0,0,0,0,0,20000,20000,0,0
20200316,048120,台泥元大93購02,0.65,0.65,0.65,0.65,+0.20,44.44,10000,1,6500,0,0,0,0,0,0,10000,0,10000,10000
20200316,048121,亞德客元大93購05,,,,,0.00,0.00,0,0,0,0,0,0,0,0,0,0,0,0,0
20200316,048122,台達電元大96購02,0.09,0.09,0.09,0.09,-0.01,-10.0,20000,1,1800,0,0,0,0,0,0,20000,0,20000,20000
20200316,048123,大立光元大93購27,,,,,0.00,0.00,0,0,0,0,0,0,0,0,0,0,0,0,0
20200316,048124,大立光元大95購03,0.11,0.13,0.11,0.13,-0.14,-51.85,110000,11,14100,0,0,0,0,0,0,10000,100000,-90000,-90000
20200316,048125,和鑫元大96購01,0.06,0.06,0.06,0.06,0.00,0.00,25000,3,1500,0,0,0,0,0,0,0,25000,-25000,-25000
20200316,048126,TPK元大94購02,,,,,0.00,0.00,0,0,0,0,0,0,0,0,0,0,0,0,0
20200316,048127,麗豐元大94購01,,,,,0.00,0.00,0,0,0,0,0,0,0,0,0,0,0,0,0
20200316,048128,超眾元大95購01,0.20,0.20,0.15,0.15,-0.06,-28.57,60000,6,10200,0,0,0,0,0,0,0,60000,-60000,-60000
20200316,048129,力成元大93購02,0.04,0.04,0.04,0.04,-0.03,-42.86,10000,1,400,0,0,0,0,0,0,10000,0,10000,10000
20200316,04812P,國巨元大95售03,0.09,0.20,0.08,0.20,+0.12,150.0,703000,74,67920,0,0,0,0,0,0,0,575000,-575000,-575000
20200316,048130,美利達元大96購01,0.11,0.11,0.09,0.09,0.00,0.00,33000,2,3430,0,0,0,0,0,0,23000,10000,13000,13000
20200316,048131,全新國票94購02,,,,,0.00,0.00,0,0,0,0,0,0,0,0,0,0,0,0,0
20200316,048132,冠德國票94購01,,,,,0.00,0.00,0,0,0,0,0,0,0,0,0,0,0,0,0
20200316,048133,臻鼎國票94購01,,,,,0.00,0.00,0,0,0,0,0,0,0,0,0,0,0,0,0
20200316,048134,祥碩國票93購02,,,,,0.00,0.00,0,0,0,0,0,0,0,0,0,0,0,0,0
20200316,048135,瀚宇博國票94購01,,,,,0.00,0.00,0,0,0,0,0,0,0,0,0,0,0,0,0
20200316,048136,聯茂國票93購04,,,,,0.00,0.00,0,0,0,0,0,0,0,0,0,0,0,0,0
20200316,048137,力成國票93購01,0.05,0.05,0.05,0.05,-0.03,-37.5,10000,1,500,0,0,0,0,0,0,10000,0,10000,10000
20200316,048138,羅麗芬國票94購01,,,,,0.00,0.00,0,0,0,0,0,0,0,0,0,0,0,0,0
20200316,048139,南電國票94購02,,,,,0.00,0.00,0,0,0,0,0,0,0,0,0,0,0,0,0
20200316,04813P,智邦元大94售07,,,,,0.00,0.00,0,0,0,0,0,0,0,0,0,0,0,0,0
20200316,048140,T50反1統一93購05,,,,,0.00,0.00,0,0,0,0,0,0,0,0,0,0,0,0,0
20200316,048141,大成鋼統一93購02,,,,,0.00,0.00,0,0,0,0,0,0,0,0,0,0,0,0,0
20200316,048142,聯電統一93購01,,,,,0.00,0.00,0,0,0,0,0,0,0,0,0,0,0,0,0
20200316,048143,聯發科統一94購03,,,,,0.00,0.00,0,0,0,0,0,0,0,0,0,0,0,0,0
20200316,048144,華固統一93購01,,,,,0.00,0.00,0,0,0,0,0,0,0,0,0,0,0,0,0
20200316,048145,大立光統一93購10,,,,,0.00,0.00,0,0,0,0,0,0,0,0,0,0,0,0,0
20200316,048146,大立光統一93購11,,,,,0.00,0.00,0,0,0,0,0,0,0,0,0,0,0,0,0
20200316,048147,元油反元富95購01,,,,,0.00,0.00,0,0,0,0,0,0,0,0,0,0,0,0,0
20200316,048148,欣興元富93購02,,,,,0.00,0.00,0,0,0,0,0,0,0,0,0,0,0,0,0
20200316,048149,泰鼎元富95購01,1.16,1.26,1.16,1.20,-0.03,-2.44,12000,10,14730,0,0,0,0,0,0,12000,0,12000,12000
20200316,04814P,健策元大96售01,0.34,0.37,0.33,0.37,+0.03,8.82,973000,99,335070,0,0,0,0,0,0,0,973000,-973000,-973000
20200316,048150,矽力元富93購01,1.40,1.40,1.40,1.40,-0.72,-33.96,10000,1,14000,0,0,0,0,0,0,0,10000,-10000,-10000
20200316,048151,世紀鋼元富93購01,0.49,0.49,0.49,0.49,+0.22,81.48,15000,1,7350,0,0,0,0,0,0,15000,0,15000,15000
20200316,048152,力山兆豐94購01,,,,,0.00,0.00,0,0,0,0,0,0,0,0,0,0,0,0,0
20200316,048153,台積電兆豐94購01,0.22,0.26,0.08,0.08,-0.29,-78.38,1153000,112,197960,0,0,0,0,0,0,48000,983000,-935000,-935000
20200316,048154,旺宏兆豐94購01,0.08,0.08,0.07,0.08,+0.01,14.29,620000,57,47300,0,0,0,0,0,0,0,550000,-550000,-550000
20200316,048155,瑞昱兆豐93購01,,,,,0.00,0.00,0,0,0,0,0,0,0,0,0,0,0,0,0
20200316,048156,正崴兆豐93購01,,,,,0.00,0.00,0,0,0,0,0,0,0,0,0,0,0,0,0
20200316,048157,美律兆豐93購01,,,,,0.00,0.00,0,0,0,0,0,0,0,0,0,0,0,0,0
20200316,048158,大立光兆豐95購01,0.13,0.13,0.09,0.09,-0.01,-10.0,53000,4,5570,0,0,0,0,0,0,0,20000,-20000,-20000
20200316,048159,聯詠兆豐93購03,,,,,0.00,0.00,0,0,0,0,0,0,0,0,0,0,0,0,0
20200316,04815P,致伸元大94售04,,,,,0.00,0.00,0,0,0,0,0,0,0,0,0,0,0,0,0
20200316,048160,GIS兆豐95購01,,,,,0.00,0.00,0,0,0,0,0,0,0,0,0,0,0,0,0
20200316,048161,旺宏麥證94購01,,,,,0.00,0.00,0,0,0,0,0,0,0,0,0,0,0,0,0
20200316,048162,矽力麥證93購01,1.04,1.04,1.04,1.04,-0.63,-37.72,10000,1,10400,0,10000,-10000,0,0,0,0,10000,-10000,-10000
20200316,048163,南亞科台新93購01,,,,,0.00,0.00,0,0,0,0,0,0,0,0,0,0,0,0,0
20200316,048164,台光電康和93購01,,,,,0.00,0.00,0,0,0,0,0,0,0,0,0,0,0,0,0
20200316,048165,嘉澤康和93購01,0.13,0.13,0.13,0.13,-0.01,-7.14,10000,1,1300,0,0,0,0,0,0,10000,0,10000,10000
20200316,048166,滬深2X永豐96購02,,,,,0.00,0.00,0,0,0,0,0,0,0,0,0,0,0,0,0
20200316,048167,旺宏永豐93購04,,,,,0.00,0.00,0,0,0,0,0,0,0,0,0,0,0,0,0
20200316,048168,致茂永豐93購02,,,,,0.00,0.00,0,0,0,0,0,0,0,0,0,0,0,0,0
20200316,048169,瑞昱永豐93購02,,,,,0.00,0.00,0,0,0,0,0,0,0,0,0,0,0,0,0
20200316,04816P,台積電兆豐94售06,0.54,0.94,0.54,0.94,+0.43,84.31,679000,33,401250,0,0,0,0,0,0,397000,639000,-242000,-242000
20200316,048170,智原永豐93購02,,,,,0.00,0.00,0,0,0,0,0,0,0,0,0,0,0,0,0
20200316,048171,創意永豐93購03,,,,,0.00,0.00,0,0,0,0,0,0,0,0,0,0,0,0,0
20200316,048172,祥碩永豐93購02,,,,,0.00,0.00,0,0,0,0,0,0,0,0,0,0,0,0,0
20200316,048173,上海銀永豐93購02,,,,,0.00,0.00,0,0,0,0,0,0,0,0,0,0,0,0,0
20200316,048174,東陽中信93購01,,,,,0.00,0.00,0,0,0,0,0,0,0,0,0,0,0,0,0
20200316,048175,矽力國泰95購01,3.39,3.39,2.36,2.36,-0.62,-20.81,11000,3,31310,0,0,0,0,0,0,5000,6000,-1000,-1000
20200316,048176,美利達國泰94購01,,,,,0.00,0.00,0,0,0,0,0,0,0,0,0,0,0,0,0
20200316,048177,臺指反富邦99購01,1.11,1.34,1.11,1.34,+0.32,31.37,207000,29,245930,0,0,0,0,0,0,177000,193000,-16000,-16000
20200316,048178,上銀富邦95購02,0.10,0.10,0.10,0.10,-0.01,-9.09,515000,21,51500,0,0,0,0,0,0,0,515000,-515000,-515000
20200316,048179,臻鼎富邦97購01,0.15,0.17,0.12,0.14,-0.02,-12.5,390000,12,51400,0,0,0,0,0,0,0,390000,-390000,-390000
20200316,04817P,創意國票95售02,,,,,0.00,0.00,0,0,0,0,0,0,0,0,0,0,0,0,0
20200316,048180,聯茂亞東93購02,,,,,0.00,0.00,0,0,0,0,0,0,0,0,0,0,0,0,0
20200316,048181,A50正2群益95購01,0.10,0.10,0.05,0.05,-0.01,-16.67,390000,7,31000,0,0,0,0,0,0,40000,350000,-310000,-310000
20200316,048182,祥碩群益93購02,,,,,0.00,0.00,0,0,0,0,0,0,0,0,0,0,0,0,0
20200316,048183,上海銀群益94購01,,,,,0.00,0.00,0,0,0,0,0,0,0,0,0,0,0,0,0
20200316,048184,達運群益93購01,,,,,0.00,0.00,0,0,0,0,0,0,0,0,0,0,0,0,0
20200316,048185,台郡群益93購04,,,,,0.00,0.00,0,0,0,0,0,0,0,0,0,0,0,0,0
20200316,048186,元黃金元大96購01,0.60,0.60,0.60,0.60,0.00,0.00,20000,2,12000,0,0,0,0,0,0,0,20000,-20000,-20000
20200316,048187,臺指反元大96購04,,,,,0.00,0.00,0,0,0,0,0,0,0,0,0,0,0,0,0
20200316,048188,臺指反元大96購05,,,,,0.00,0.00,0,0,0,0,0,0,0,0,0,0,0,0,0
20200316,048189,臺指反元大96購06,1.88,1.88,1.88,1.88,+0.22,13.25,10000,1,18800,0,0,0,0,0,0,0,10000,-10000,-10000
20200316,04818P,華新科永豐94售03,0.44,0.67,0.44,0.64,-0.01,-1.54,88000,17,45370,0,0,0,0,0,0,7000,81000,-74000,-74000
20200316,048190,道瓊反元大96購02,2.60,2.63,2.58,2.58,+0.35,15.7,31000,4,80720,0,0,0,0,0,0,0,31000,-31000,-31000
20200316,048191,亞德客元大93購06,1.30,1.30,1.30,1.30,0.00,0.00,10000,1,13000,0,0,0,0,0,0,0,10000,-10000,-10000
20200316,048192,華通元大96購01,0.77,0.80,0.46,0.48,-0.13,-21.31,623000,57,366850,0,0,0,0,0,0,133000,555000,-422000,-422000
20200316,048193,旺宏元大94購05,0.49,0.49,0.49,0.49,+0.16,48.48,10000,1,4900,0,0,0,0,0,0,0,10000,-10000,-10000
20200316,048194,華邦電元大94購04,,,,,0.00,0.00,0,0,0,0,0,0,0,0,0,0,0,0,0
20200316,048195,聯發科元大93購23,,,,,0.00,0.00,0,0,0,0,0,0,0,0,0,0,0,0,0
20200316,048196,聯發科元大93購24,,,,,0.00,0.00,0,0,0,0,0,0,0,0,0,0,0,0,0
20200316,048197,義隆元大93購04,0.03,0.03,0.03,0.03,0.00,0.00,10000,1,300,0,0,0,0,0,0,10000,0,10000,10000
20200316,048198,大立光元大93購28,,,,,0.00,0.00,0,0,0,0,0,0,0,0,0,0,0,0,0
20200316,048199,大立光元大94購03,0.13,0.13,0.13,0.13,-0.03,-18.75,1000,1,130,0,0,0,0,0,0,1000,1000,0,0
20200316,04819P,嘉澤永豐94售01,0.67,0.96,0.67,0.96,+0.02,2.13,26000,3,23220,0,0,0,0,0,0,0,26000,-26000,-26000
20200316,048200,欣興元大93購07,,,,,0.00,0.00,0,0,0,0,0,0,0,0,0,0,0,0,0
20200316,048201,智易元大93購06,,,,,0.00,0.00,0,0,0,0,0,0,0,0,0,0,0,0,0
20200316,048202,瑞儀元大93購04,,,,,0.00,0.00,0,0,0,0,0,0,0,0,0,0,0,0,0
20200316,048203,矽力元大93購02,1.41,1.41,1.41,1.41,-0.14,-9.03,10000,1,14100,0,0,0,0,0,0,10000,0,10000,10000
20200316,048204,訊芯元大93購06,,,,,0.00,0.00,0,0,0,0,0,0,0,0,0,0,0,0,0
20200316,048205,臺股指元大93購39,,,,,0.00,0.00,0,0,0,0,0,0,0,0,0,0,0,0,0
20200316,048206,臺股指元大93購40,,,,,0.00,0.00,0,0,0,0,0,0,0,0,0,0,0,0,0
20200316,048207,臺股指元大93購41,,,,,0.00,0.00,0,0,0,0,0,0,0,0,0,0,0,0,0
20200316,048208,臺股指元大93購42,,,,,0.00,0.00,0,0,0,0,0,0,0,0,0,0,0,0,0
20200316,048209,臺股指元大93購43,,,,,0.00,0.00,0,0,0,0,0,0,0,0,0,0,0,0,0
20200316,04820P,聯茂永豐94售02,1.00,1.00,1.00,1.00,+0.01,1.01,3000,1,3000,0,0,0,0,0,0,0,3000,-3000,-3000
20200316,048210,鴻海日盛93購01,,,,,0.00,0.00,0,0,0,0,0,0,0,0,0,0,0,0,0
20200316,048211,大立光日盛93購01,,,,,0.00,0.00,0,0,0,0,0,0,0,0,0,0,0,0,0
20200316,048212,美利達日盛93購01,,,,,0.00,0.00,0,0,0,0,0,0,0,0,0,0,0,0,0
20200316,048213,群創麥證93購02,,,,,0.00,0.00,0,0,0,0,0,0,0,0,0,0,0,0,0
20200316,048214,滬深2X凱基96購03,,,,,0.00,0.00,0,0,0,0,0,0,0,0,0,0,0,0,0
20200316,048215,A50正2凱基95購01,,,,,0.00,0.00,0,0,0,0,0,0,0,0,0,0,0,0,0
20200316,048216,元油反凱基93購01,,,,,0.00,0.00,0,0,0,0,0,0,0,0,0,0,0,0,0
20200316,048217,亞德客凱基93購06,,,,,0.00,0.00,0,0,0,0,0,0,0,0,0,0,0,0,0
20200316,048218,上銀凱基93購07,,,,,0.00,0.00,0,0,0,0,0,0,0,0,0,0,0,0,0
20200316,048219,為升凱基93購06,0.01,0.01,0.01,0.01,0.00,0.00,10000,10,100,0,0,0,0,0,0,0,0,0,0
20200316,04821P,臺股指永豐94售01,,,,,0.00,0.00,0,0,0,0,0,0,0,0,0,0,0,0,0
20200316,048220,鴻海凱基93購35,1.14,1.14,0.80,0.80,-0.72,-47.37,3000,2,3080,0,0,0,0,0,0,3000,0,3000,3000
20200316,048221,鴻海凱基95購01,1.27,1.27,1.05,1.05,-0.14,-11.76,49000,8,56000,0,0,0,0,0,0,20000,29000,-9000,-9000
20200316,048222,台積電凱基93購26,1.76,1.76,0.93,0.93,-1.27,-57.73,36000,5,44180,0,0,0,0,0,0,36000,16000,20000,20000
20200316,048223,微星凱基93購02,,,,,0.00,0.00,0,0,0,0,0,0,0,0,0,0,0,0,0
20200316,048224,聯發科凱基93購31,,,,,0.00,0.00,0,0,0,0,0,0,0,0,0,0,0,0,0
20200316,048225,全新凱基93購03,,,,,0.00,0.00,0,0,0,0,0,0,0,0,0,0,0,0,0
20200316,048226,大立光凱基93購35,,,,,0.00,0.00,0,0,0,0,0,0,0,0,0,0,0,0,0
20200316,048227,亞光凱基93購05,,,,,0.00,0.00,0,0,0,0,0,0,0,0,0,0,0,0,0
20200316,048228,和鑫凱基93購02,,,,,0.00,0.00,0,0,0,0,0,0,0,0,0,0,0,0,0
20200316,048229,華晶科凱基93購02,,,,,0.00,0.00,0,0,0,0,0,0,0,0,0,0,0,0,0
20200316,04822P,台積電元富94售08,,,,,0.00,0.00,0,0,0,0,0,0,0,0,0,0,0,0,0
20200316,048230,瀚宇博凱基93購03,,,,,0.00,0.00,0,0,0,0,0,0,0,0,0,0,0,0,0
20200316,048231,台表科凱基93購06,,,,,0.00,0.00,0,0,0,0,0,0,0,0,0,0,0,0,0
20200316,048232,GIS凱基93購07,,,,,0.00,0.00,0,0,0,0,0,0,0,0,0,0,0,0,0
20200316,048233,南電凱基93購05,,,,,0.00,0.00,0,0,0,0,0,0,0,0,0,0,0,0,0
20200316,048234,美利達凱基93購03,,,,,0.00,0.00,0,0,0,0,0,0,0,0,0,0,0,0,0
20200316,048235,滬深2X國票93購04,,,,,0.00,0.00,0,0,0,0,0,0,0,0,0,0,0,0,0
20200316,048236,A50正2國票97購02,,,,,0.00,0.00,0,0,0,0,0,0,0,0,0,0,0,0,0
20200316,048237,致茂國票94購01,,,,,0.00,0.00,0,0,0,0,0,0,0,0,0,0,0,0,0
20200316,048238,奇鋐國票94購01,,,,,0.00,0.00,0,0,0,0,0,0,0,0,0,0,0,0,0
20200316,048239,嘉澤國票93購01,,,,,0.00,0.00,0,0,0,0,0,0,0,0,0,0,0,0,0
20200316,04823P,台積電元富94售09,1.47,1.50,1.43,1.43,+0.63,78.75,34000,3,49720,0,0,0,0,0,0,14000,20000,-6000,-6000
20200316,048240,嘉聯益國票94購03,,,,,0.00,0.00,0,0,0,0,0,0,0,0,0,0,0,0,0
20200316,048241,樺漢國票93購01,,,,,0.00,0.00,0,0,0,0,0,0,0,0,0,0,0,0,0
20200316,048242,統一兆豐93購01,,,,,0.00,0.00,0,0,0,0,0,0,0,0,0,0,0,0,0
20200316,048243,儒鴻兆豐94購01,0.02,0.02,0.02,0.02,0.00,0.00,100000,10,2000,0,0,0,0,0,0,0,100000,-100000,-100000
20200316,048244,廣宇兆豐93購01,,,,,0.00,0.00,0,0,0,0,0,0,0,0,0,0,0,0,0
20200316,048245,台積電兆豐93購07,,,,,0.00,0.00,0,0,0,0,0,0,0,0,0,0,0,0,0
20200316,048246,京元電兆豐93購02,,,,,0.00,0.00,0,0,0,0,0,0,0,0,0,0,0,0,0
20200316,048247,聯發科兆豐93購03,,,,,0.00,0.00,0,0,0,0,0,0,0,0,0,0,0,0,0
20200316,048248,聯發科兆豐95購01,0.04,0.04,0.02,0.02,-0.02,-50.0,231000,13,7780,0,0,0,0,0,0,0,85000,-85000,-85000
20200316,048249,嘉澤兆豐94購01,,,,,0.00,0.00,0,0,0,0,0,0,0,0,0,0,0,0,0
20200316,04824P,亞泥中信94售02,0.69,0.69,0.69,0.69,-0.01,-1.43,11000,11,7590,0,0,0,0,0,0,11000,0,11000,11000
20200316,048250,矽創兆豐93購02,,,,,0.00,0.00,0,0,0,0,0,0,0,0,0,0,0,0,0
20200316,048251,T50反1統一93購06,,,,,0.00,0.00,0,0,0,0,0,0,0,0,0,0,0,0,0
20200316,048252,T50反1統一93購07,,,,,0.00,0.00,0,0,0,0,0,0,0,0,0,0,0,0,0
20200316,048253,T50反1統一93購08,,,,,0.00,0.00,0,0,0,0,0,0,0,0,0,0,0,0,0
20200316,048254,深中小統一93購01,,,,,0.00,0.00,0,0,0,0,0,0,0,0,0,0,0,0,0
20200316,048255,臺指反統一94購01,,,,,0.00,0.00,0,0,0,0,0,0,0,0,0,0,0,0,0
20200316,048256,鴻海統一93購08,,,,,0.00,0.00,0,0,0,0,0,0,0,0,0,0,0,0,0
20200316,048257,台積電統一93購07,0.52,0.57,0.29,0.29,-0.20,-40.82,107000,14,38970,0,0,0,0,0,0,107000,74000,33000,33000
20200316,048258,國泰金統一93購01,,,,,0.00,0.00,0,0,0,0,0,0,0,0,0,0,0,0,0
20200316,048259,新日興統一93購01,,,,,0.00,0.00,0,0,0,0,0,0,0,0,0,0,0,0,0
20200316,04825P,元大金中信94售01,,,,,0.00,0.00,0,0,0,0,0,0,0,0,0,0,0,0,0
20200316,048260,鴻海元富93購06,,,,,0.00,0.00,0,0,0,0,0,0,0,0,0,0,0,0,0
20200316,048261,鴻海元富95購01,0.04,0.06,0.04,0.06,0.00,0.00,241000,11,9660,0,0,0,0,0,0,0,40000,-40000,-40000
20200316,048262,台積電元富94購01,2.18,2.18,1.51,1.51,-1.00,-39.84,22000,5,40230,0,0,0,0,0,0,13000,6000,7000,7000
20200316,048263,台積電元富95購01,1.80,1.80,1.11,1.11,-0.69,-38.33,83000,16,127050,0,0,0,0,0,0,24000,58000,-34000,-34000
20200316,048264,華新科元富93購01,0.91,0.91,0.91,0.91,+0.25,37.88,50000,1,45500,0,0,0,0,0,0,50000,0,50000,50000
20200316,048265,創意元富93購05,,,,,0.00,0.00,0,0,0,0,0,0,0,0,0,0,0,0,0
20200316,048266,臺指反中信95購01,,,,,0.00,0.00,0,0,0,0,0,0,0,0,0,0,0,0,0
20200316,048267,元金反中信93購01,,,,,0.00,0.00,0,0,0,0,0,0,0,0,0,0,0,0,0
20200316,048268,長榮航中信95購01,,,,,0.00,0.00,0,0,0,0,0,0,0,0,0,0,0,0,0
20200316,048269,瀚宇博國泰95購01,0.13,0.13,0.13,0.13,-0.05,-27.78,103000,1,13390,0,0,0,0,0,0,103000,0,103000,103000
20200316,04826P,華新科麥證95售01,1.00,1.17,0.99,1.17,+0.05,4.46,565000,5,565800,60000,505000,-445000,0,0,0,565000,560000,5000,5000
20200316,048270,T50反1富邦99購01,1.39,1.63,1.36,1.63,+0.10,6.54,686000,70,961530,0,0,0,0,0,0,0,686000,-686000,-686000
20200316,048271,可成富邦95購02,,,,,0.00,0.00,0,0,0,0,0,0,0,0,0,0,0,0,0
20200316,048272,新光金富邦98購01,,,,,0.00,0.00,0,0,0,0,0,0,0,0,0,0,0,0,0
20200316,048273,南電富邦97購01,0.67,0.67,0.49,0.49,-0.14,-22.22,63000,6,36620,0,0,0,0,0,0,63000,0,63000,63000
20200316,048274,矽力台新93購01,,,,,0.00,0.00,0,0,0,0,0,0,0,0,0,0,0,0,0
20200316,048275,A50正2永豐93購01,,,,,0.00,0.00,0,0,0,0,0,0,0,0,0,0,0,0,0
20200316,048276,旺宏永豐94購01,,,,,0.00,0.00,0,0,0,0,0,0,0,0,0,0,0,0,0
20200316,048277,建準永豐93購02,,,,,0.00,0.00,0,0,0,0,0,0,0,0,0,0,0,0,0
20200316,048278,聯發科永豐93購03,,,,,0.00,0.00,0,0,0,0,0,0,0,0,0,0,0,0,0
20200316,048279,聯鈞永豐93購01,,,,,0.00,0.00,0,0,0,0,0,0,0,0,0,0,0,0,0
20200316,04827P,國巨凱基94售09,0.25,0.27,0.25,0.27,0.00,0.00,20000,2,5200,0,0,0,0,0,0,0,20000,-20000,-20000
20200316,048280,康普永豐93購01,,,,,0.00,0.00,0,0,0,0,0,0,0,0,0,0,0,0,0
20200316,048281,矽力永豐93購02,,,,,0.00,0.00,0,0,0,0,0,0,0,0,0,0,0,0,0
20200316,048282,世紀鋼永豐94購01,,,,,0.00,0.00,0,0,0,0,0,0,0,0,0,0,0,0,0
20200316,048283,亞德客中信94購01,0.34,0.40,0.34,0.40,+0.16,66.67,26000,3,9700,0,0,0,0,0,0,10000,16000,-6000,-6000
20200316,048284,臺股指中信95購04,0.02,0.02,0.02,0.02,0.00,0.00,80000,7,1600,0,0,0,0,0,0,0,60000,-60000,-60000
20200316,048285,華新科亞東93購01,,,,,0.00,0.00,0,0,0,0,0,0,0,0,0,0,0,0,0
20200316,048286,滬深2X兆豐94購04,0.31,0.33,0.20,0.20,-0.19,-48.72,211000,34,59170,0,0,0,0,0,0,0,211000,-211000,-211000
20200316,048287,嘉晶兆豐94購01,0.34,0.36,0.22,0.22,-0.06,-21.43,494000,12,140980,0,0,0,0,0,0,300000,194000,106000,106000
20200316,048288,T50反1群益93購05,0.84,0.84,0.84,0.84,-0.41,-32.8,3000,1,2520,0,0,0,0,0,0,0,3000,-3000,-3000
20200316,048289,臺指反群益95購01,0.98,0.98,0.98,0.98,-0.12,-10.91,10000,1,9800,0,0,0,0,0,0,0,10000,-10000,-10000
20200316,04828P,聯發科凱基94售15,1.35,1.58,1.35,1.58,+0.28,21.54,13000,3,18880,0,0,0,0,0,0,12000,1000,11000,11000
20200316,048290,國巨群益93購06,,,,,0.00,0.00,0,0,0,0,0,0,0,0,0,0,0,0,0
20200316,048291,台積電群益93購09,,,,,0.00,0.00,0,0,0,0,0,0,0,0,0,0,0,0,0
20200316,048292,微星群益93購01,,,,,0.00,0.00,0,0,0,0,0,0,0,0,0,0,0,0,0
20200316,048293,聯詠群益93購04,,,,,0.00,0.00,0,0,0,0,0,0,0,0,0,0,0,0,0
20200316,048294,智原群益93購02,,,,,0.00,0.00,0,0,0,0,0,0,0,0,0,0,0,0,0
20200316,048295,泰鼎群益93購01,,,,,0.00,0.00,0,0,0,0,0,0,0,0,0,0,0,0,0
20200316,048296,康控群益93購03,,,,,0.00,0.00,0,0,0,0,0,0,0,0,0,0,0,0,0
20200316,048297,GIS群益93購02,,,,,0.00,0.00,0,0,0,0,0,0,0,0,0,0,0,0,0
20200316,048298,華通麥證94購01,,,,,0.00,0.00,0,0,0,0,0,0,0,0,0,0,0,0,0
20200316,048299,聯詠麥證93購02,,,,,0.00,0.00,0,0,0,0,0,0,0,0,0,0,0,0,0
20200316,04829P,大立光凱基94售14,0.36,0.36,0.36,0.36,0.00,0.00,280000,3,100800,0,0,0,0,0,0,280000,0,280000,280000
20200316,048300,FB上証凱基93購01,,,,,0.00,0.00,0,0,0,0,0,0,0,0,0,0,0,0,0
20200316,048301,元上證凱基93購01,,,,,0.00,0.00,0,0,0,0,0,0,0,0,0,0,0,0,0
20200316,048302,上証反凱基93購01,,,,,0.00,0.00,0,0,0,0,0,0,0,0,0,0,0,0,0
20200316,048303,A50凱基96購01,,,,,0.00,0.00,0,0,0,0,0,0,0,0,0,0,0,0,0
20200316,048304,滬深2X凱基93購04,,,,,0.00,0.00,0,0,0,0,0,0,0,0,0,0,0,0,0
20200316,048305,深100凱基96購01,0.50,0.50,0.41,0.41,-0.11,-21.15,45000,3,20150,0,0,0,0,0,0,0,45000,-45000,-45000
20200316,048306,A50反1凱基93購01,,,,,0.00,0.00,0,0,0,0,0,0,0,0,0,0,0,0,0
20200316,048307,道瓊指凱基93購01,,,,,0.00,0.00,0,0,0,0,0,0,0,0,0,0,0,0,0
20200316,048308,儒鴻凱基93購05,,,,,0.00,0.00,0,0,0,0,0,0,0,0,0,0,0,0,0
20200316,048309,寶齡凱基93購01,,,,,0.00,0.00,0,0,0,0,0,0,0,0,0,0,0,0,0
20200316,04830P,大立光凱基94售15,0.22,0.56,0.21,0.55,+0.34,161.9,350000,4,80700,0,0,0,0,0,0,0,350000,-350000,-350000
20200316,048310,台達電凱基93購05,,,,,0.00,0.00,0,0,0,0,0,0,0,0,0,0,0,0,0
20200316,048311,台積電凱基93購28,3.18,3.18,2.48,2.48,-0.24,-8.82,22000,2,68560,0,0,0,0,0,0,20000,2000,18000,18000
20200316,048312,致茂凱基93購02,,,,,0.00,0.00,0,0,0,0,0,0,0,0,0,0,0,0,0
20200316,048313,南亞科凱基93購06,,,,,0.00,0.00,0,0,0,0,0,0,0,0,0,0,0,0,0
20200316,048314,京元電凱基93購04,,,,,0.00,0.00,0,0,0,0,0,0,0,0,0,0,0,0,0
20200316,048315,聯發科凱基93購32,,,,,0.00,0.00,0,0,0,0,0,0,0,0,0,0,0,0,0
20200316,048316,可成凱基93購15,,,,,0.00,0.00,0,0,0,0,0,0,0,0,0,0,0,0,0
20200316,048317,大立光凱基93購36,,,,,0.00,0.00,0,0,0,0,0,0,0,0,0,0,0,0,0
20200316,048318,大立光凱基93購37,,,,,0.00,0.00,0,0,0,0,0,0,0,0,0,0,0,0,0
20200316,048319,嘉晶凱基93購04,,,,,0.00,0.00,0,0,0,0,0,0,0,0,0,0,0,0,0
20200316,04831P,聯詠富邦96售01,0.76,0.85,0.74,0.85,+0.14,19.72,187000,6,143080,0,0,0,0,0,0,152000,35000,117000,117000
20200316,048320,聯詠凱基93購08,,,,,0.00,0.00,0,0,0,0,0,0,0,0,0,0,0,0,0
20200316,048321,欣興凱基93購03,,,,,0.00,0.00,0,0,0,0,0,0,0,0,0,0,0,0,0
20200316,048322,康控凱基93購02,,,,,0.00,0.00,0,0,0,0,0,0,0,0,0,0,0,0,0
20200316,048323,聯茂凱基93購09,,,,,0.00,0.00,0,0,0,0,0,0,0,0,0,0,0,0,0
20200316,048324,訊芯凱基93購03,,,,,0.00,0.00,0,0,0,0,0,0,0,0,0,0,0,0,0
20200316,048325,美利達凱基93購05,,,,,0.00,0.00,0,0,0,0,0,0,0,0,0,0,0,0,0
20200316,048326,滬深2X國泰94購03,,,,,0.00,0.00,0,0,0,0,0,0,0,0,0,0,0,0,0
20200316,048327,緯穎國泰94購01,,,,,0.00,0.00,0,0,0,0,0,0,0,0,0,0,0,0,0
20200316,048328,滬深2X永昌94購01,0.43,0.44,0.34,0.35,+0.11,45.83,360000,36,143200,0,0,0,0,0,0,0,360000,-360000,-360000
20200316,048329,台積電永昌93購07,0.33,0.33,0.16,0.16,-0.33,-67.35,30000,3,8100,0,0,0,0,0,0,30000,30000,0,0
20200316,04832P,為升元大94售09,8.10,8.10,8.10,8.10,0.00,0.00,4000,1,32400,0,0,0,0,0,0,4000,0,4000,4000
20200316,048330,大立光永昌93購07,,,,,0.00,0.00,0,0,0,0,0,0,0,0,0,0,0,0,0
20200316,048331,臺指反富邦97購01,0.77,0.97,0.75,0.97,+0.06,6.59,845000,84,680270,0,0,0,0,0,0,0,805000,-805000,-805000
20200316,048332,台積電富邦94購02,,,,,0.00,0.00,0,0,0,0,0,0,0,0,0,0,0,0,0
20200316,048333,大立光富邦95購01,,,,,0.00,0.00,0,0,0,0,0,0,0,0,0,0,0,0,0
20200316,048334,A50正2元大96購01,0.23,0.23,0.22,0.22,-0.04,-15.38,40000,4,9100,0,0,0,0,0,0,0,40000,-40000,-40000
20200316,048335,和大元大93購03,,,,,0.00,0.00,0,0,0,0,0,0,0,0,0,0,0,0,0
20200316,048336,光磊元大93購02,,,,,0.00,0.00,0,0,0,0,0,0,0,0,0,0,0,0,0
20200316,048337,致茂元大93購04,,,,,0.00,0.00,0,0,0,0,0,0,0,0,0,0,0,0,0
20200316,048338,正崴元大93購01,,,,,0.00,0.00,0,0,0,0,0,0,0,0,0,0,0,0,0
20200316,048339,友達元大95購01,,,,,0.00,0.00,0,0,0,0,0,0,0,0,0,0,0,0,0
20200316,04833P,鴻海元大94售16,2.09,2.95,2.09,2.95,+0.95,47.5,173000,6,489190,0,0,0,0,0,0,60000,10000,50000,50000
20200316,048340,聯發科元大93購25,,,,,0.00,0.00,0,0,0,0,0,0,0,0,0,0,0,0,0
20200316,048341,全新元大94購03,,,,,0.00,0.00,0,0,0,0,0,0,0,0,0,0,0,0,0
20200316,048342,強茂元大93購01,,,,,0.00,0.00,0,0,0,0,0,0,0,0,0,0,0,0,0
20200316,048343,大立光元大93購29,,,,,0.00,0.00,0,0,0,0,0,0,0,0,0,0,0,0,0
20200316,048344,大立光元大93購30,,,,,0.00,0.00,0,0,0,0,0,0,0,0,0,0,0,0,0
20200316,048345,緯創元大94購01,,,,,0.00,0.00,0,0,0,0,0,0,0,0,0,0,0,0,0
20200316,048346,智易元大95購01,0.05,0.06,0.05,0.06,+0.01,20.0,155000,14,9150,0,0,0,0,0,0,45000,110000,-65000,-65000
20200316,048347,康普元大93購02,,,,,0.00,0.00,0,0,0,0,0,0,0,0,0,0,0,0,0
20200316,048348,矽力元大93購03,0.30,0.30,0.30,0.30,-0.66,-68.75,5000,1,1500,0,0,0,0,0,0,0,5000,-5000,-5000
20200316,048349,美利達元大96購02,0.20,0.20,0.13,0.13,-0.21,-61.76,254000,26,43580,0,0,0,0,0,0,42000,187000,-145000,-145000
20200316,04834P,鴻海元大94售17,1.08,1.62,1.08,1.62,+0.72,80.0,374000,20,541750,0,0,0,0,0,0,300000,124000,176000,176000
20200316,048350,世紀鋼元大95購01,1.88,1.89,1.52,1.52,0.00,0.00,346000,39,606670,0,0,0,0,0,0,267000,88000,179000,179000
20200316,048351,旺宏台新94購02,,,,,0.00,0.00,0,0,0,0,0,0,0,0,0,0,0,0,0
20200316,048352,嘉澤台新93購01,,,,,0.00,0.00,0,0,0,0,0,0,0,0,0,0,0,0,0
20200316,048353,嘉聯益台新93購02,,,,,0.00,0.00,0,0,0,0,0,0,0,0,0,0,0,0,0
20200316,048354,滬深2X永豐93購03,,,,,0.00,0.00,0,0,0,0,0,0,0,0,0,0,0,0,0
20200316,048355,國巨永豐93購04,0.41,0.41,0.41,0.41,+0.05,13.89,10000,1,4100,0,0,0,0,0,0,10000,0,10000,10000
20200316,048356,華泰永豐93購01,,,,,0.00,0.00,0,0,0,0,0,0,0,0,0,0,0,0,0
20200316,048357,漢唐永豐93購04,,,,,0.00,0.00,0,0,0,0,0,0,0,0,0,0,0,0,0
20200316,048358,嘉晶永豐93購03,0.05,0.08,0.05,0.08,+0.03,60.0,40000,4,2600,0,0,0,0,0,0,0,40000,-40000,-40000
20200316,048359,奇鋐永豐93購02,,,,,0.00,0.00,0,0,0,0,0,0,0,0,0,0,0,0,0
20200316,04835P,鴻海元大94售18,1.79,1.79,1.76,1.76,-1.22,-40.94,13000,2,22970,0,0,0,0,0,0,10000,13000,-3000,-3000
20200316,048360,華晶科永豐93購02,,,,,0.00,0.00,0,0,0,0,0,0,0,0,0,0,0,0,0
20200316,048361,揚明光永豐93購02,,,,,0.00,0.00,0,0,0,0,0,0,0,0,0,0,0,0,0
20200316,048362,康控永豐93購01,,,,,0.00,0.00,0,0,0,0,0,0,0,0,0,0,0,0,0
20200316,048363,中磊永豐93購02,,,,,0.00,0.00,0,0,0,0,0,0,0,0,0,0,0,0,0
20200316,048364,臺股指永豐93購04,,,,,0.00,0.00,0,0,0,0,0,0,0,0,0,0,0,0,0
20200316,048365,T50反1統一93購09,,,,,0.00,0.00,0,0,0,0,0,0,0,0,0,0,0,0,0
20200316,048366,深中小統一93購02,,,,,0.00,0.00,0,0,0,0,0,0,0,0,0,0,0,0,0
20200316,048367,華邦電統一93購01,,,,,0.00,0.00,0,0,0,0,0,0,0,0,0,0,0,0,0
20200316,048368,燿華統一93購01,,,,,0.00,0.00,0,0,0,0,0,0,0,0,0,0,0,0,0
20200316,048369,友達統一93購06,,,,,0.00,0.00,0,0,0,0,0,0,0,0,0,0,0,0,0
20200316,04836P,台積電元大94售22,,,,,0.00,0.00,0,0,0,0,0,0,0,0,0,0,0,0,0
20200316,048370,可成統一93購04,,,,,0.00,0.00,0,0,0,0,0,0,0,0,0,0,0,0,0
20200316,048371,華固統一93購02,,,,,0.00,0.00,0,0,0,0,0,0,0,0,0,0,0,0,0
20200316,048372,美利達統一93購01,,,,,0.00,0.00,0,0,0,0,0,0,0,0,0,0,0,0,0
20200316,048373,A50正2元富95購01,0.50,0.52,0.39,0.39,-0.26,-40.0,165000,9,70600,0,0,0,0,0,0,105000,85000,20000,20000
20200316,048374,味全元富94購01,,,,,0.00,0.00,0,0,0,0,0,0,0,0,0,0,0,0,0
20200316,048375,儒鴻元富93購02,,,,,0.00,0.00,0,0,0,0,0,0,0,0,0,0,0,0,0
20200316,048376,台達電元富93購01,,,,,0.00,0.00,0,0,0,0,0,0,0,0,0,0,0,0,0
20200316,048377,燿華元富93購01,,,,,0.00,0.00,0,0,0,0,0,0,0,0,0,0,0,0,0
20200316,048378,貿聯元富93購01,,,,,0.00,0.00,0,0,0,0,0,0,0,0,0,0,0,0,0
20200316,048379,台郡元富96購01,0.51,0.51,0.40,0.43,+0.06,16.22,18000,3,7680,0,0,0,0,0,0,10000,8000,2000,2000
20200316,04837P,華新科元大94售05,1.41,2.08,1.41,2.08,+0.26,14.29,22000,6,38850,0,0,0,0,0,0,5000,17000,-12000,-12000
20200316,048380,T50反1國票94購02,,,,,0.00,0.00,0,0,0,0,0,0,0,0,0,0,0,0,0
20200316,048381,T50反1國票94購03,,,,,0.00,0.00,0,0,0,0,0,0,0,0,0,0,0,0,0
20200316,048382,T50反1國票96購01,0.60,0.60,0.60,0.60,+0.10,20.0,1000,1,600,0,0,0,0,0,0,1000,0,1000,1000
20200316,048383,元金2X國票99購01,0.52,0.52,0.52,0.52,-0.22,-29.73,10000,1,5200,0,0,0,0,0,0,10000,0,10000,10000
20200316,048384,遠東新國票94購01,,,,,0.00,0.00,0,0,0,0,0,0,0,0,0,0,0,0,0
20200316,048385,亞德客國票94購01,1.70,1.70,1.54,1.54,+0.31,25.2,46000,3,77790,0,0,0,0,0,0,40000,6000,34000,34000
20200316,048386,華新國票94購01,,,,,0.00,0.00,0,0,0,0,0,0,0,0,0,0,0,0,0
20200316,048387,台達電國票94購01,,,,,0.00,0.00,0,0,0,0,0,0,0,0,0,0,0,0,0
20200316,048388,華通國票94購01,0.01,0.01,0.01,0.01,0.00,0.00,200000,1,2000,0,0,0,0,0,0,200000,0,200000,200000
20200316,048389,國巨國票94購01,,,,,0.00,0.00,0,0,0,0,0,0,0,0,0,0,0,0,0
20200316,04838P,宏達電元大95售02,3.23,3.55,3.23,3.55,+0.32,9.91,44000,5,150870,0,0,0,0,0,0,0,44000,-44000,-44000
20200316,048390,國巨國票94購02,7.05,7.05,4.13,4.13,-2.27,-35.47,60000,3,366800,0,0,0,0,0,0,50000,10000,40000,40000
20200316,048391,友訊國票94購01,0.05,0.05,0.05,0.05,-0.01,-16.67,8000,1,400,0,0,0,0,0,0,8000,0,8000,8000
20200316,048392,宏碁國票94購01,,,,,0.00,0.00,0,0,0,0,0,0,0,0,0,0,0,0,0
20200316,048393,台光電國票93購02,0.01,0.01,0.01,0.01,0.00,0.00,1000,1,10,0,0,0,0,0,0,1000,0,1000,1000
20200316,048394,正崴國票94購01,,,,,0.00,0.00,0,0,0,0,0,0,0,0,0,0,0,0,0
20200316,048395,南亞科國票93購02,0.01,0.01,0.01,0.01,0.00,0.00,52000,2,520,0,0,0,0,0,0,52000,0,52000,52000
20200316,048396,奇力新國票94購02,2.17,2.17,2.17,2.17,+0.66,43.71,30000,2,65100,0,0,0,0,0,0,30000,0,30000,30000
20200316,048397,TPK國票94購02,,,,,0.00,0.00,0,0,0,0,0,0,0,0,0,0,0,0,0
20200316,048398,康普國票94購01,,,,,0.00,0.00,0,0,0,0,0,0,0,0,0,0,0,0,0
20200316,048399,祥碩國票94購01,,,,,0.00,0.00,0,0,0,0,0,0,0,0,0,0,0,0,0
20200316,04839P,大立光元大94售17,1.99,1.99,1.99,1.99,+0.24,13.71,10000,1,19900,0,0,0,0,0,0,10000,10000,0,0
20200316,048400,矽創國票93購01,,,,,0.00,0.00,0,0,0,0,0,0,0,0,0,0,0,0,0
20200316,048401,南電國票93購03,,,,,0.00,0.00,0,0,0,0,0,0,0,0,0,0,0,0,0
20200316,048402,聯茂兆豐95購01,,,,,0.00,0.00,0,0,0,0,0,0,0,0,0,0,0,0,0
20200316,048403,聯發科群益93購10,,,,,0.00,0.00,0,0,0,0,0,0,0,0,0,0,0,0,0
20200316,048404,大立光群益93購11,,,,,0.00,0.00,0,0,0,0,0,0,0,0,0,0,0,0,0
20200316,048405,嘉晶群益93購03,,,,,0.00,0.00,0,0,0,0,0,0,0,0,0,0,0,0,0
20200316,048406,欣興群益93購09,,,,,0.00,0.00,0,0,0,0,0,0,0,0,0,0,0,0,0
20200316,048407,貿聯群益93購04,,,,,0.00,0.00,0,0,0,0,0,0,0,0,0,0,0,0,0
20200316,048408,正文群益93購01,,,,,0.00,0.00,0,0,0,0,0,0,0,0,0,0,0,0,0
20200316,048409,致伸群益93購05,,,,,0.00,0.00,0,0,0,0,0,0,0,0,0,0,0,0,0
20200316,04840P,大立光元大94售18,1.17,1.52,1.17,1.51,-0.18,-10.65,80000,9,113100,0,0,0,0,0,0,10000,70000,-60000,-60000
20200316,048410,和碩群益93購01,,,,,0.00,0.00,0,0,0,0,0,0,0,0,0,0,0,0,0
20200316,048411,嘉聯益群益93購02,,,,,0.00,0.00,0,0,0,0,0,0,0,0,0,0,0,0,0
20200316,048412,台勝科亞東93購01,1.35,1.46,1.35,1.46,0.00,0.00,2000,2,2810,0,0,0,0,0,0,2000,0,2000,2000
20200316,048413,國巨第一93購01,,,,,0.00,0.00,0,0,0,0,0,0,0,0,0,0,0,0,0
20200316,048414,滬深2X統一98購01,,,,,0.00,0.00,0,0,0,0,0,0,0,0,0,0,0,0,0
20200316,048415,深中小統一93購03,,,,,0.00,0.00,0,0,0,0,0,0,0,0,0,0,0,0,0
20200316,048416,台達電統一93購02,,,,,0.00,0.00,0,0,0,0,0,0,0,0,0,0,0,0,0
20200316,048417,國巨統一94購01,4.88,4.96,2.95,2.95,-1.37,-31.71,51000,5,217280,0,0,0,0,0,0,21000,30000,-9000,-9000
20200316,048418,瑞昱統一93購04,,,,,0.00,0.00,0,0,0,0,0,0,0,0,0,0,0,0,0
20200316,048419,智易統一93購01,,,,,0.00,0.00,0,0,0,0,0,0,0,0,0,0,0,0,0
20200316,04841P,群創元大94售04,0.94,0.94,0.94,0.94,0.00,0.00,9000,1,8460,0,0,0,0,0,0,0,9000,-9000,-9000
20200316,048420,祥碩統一93購01,,,,,0.00,0.00,0,0,0,0,0,0,0,0,0,0,0,0,0
20200316,048421,聯茂統一93購01,,,,,0.00,0.00,0,0,0,0,0,0,0,0,0,0,0,0,0
20200316,048422,瑞昱元富96購02,,,,,0.00,0.00,0,0,0,0,0,0,0,0,0,0,0,0,0
20200316,048423,聯發科元富93購02,,,,,0.00,0.00,0,0,0,0,0,0,0,0,0,0,0,0,0
20200316,048424,揚明光元富95購01,,,,,0.00,0.00,0,0,0,0,0,0,0,0,0,0,0,0,0
20200316,048425,聯茂元富96購02,0.09,0.09,0.09,0.09,0.00,0.00,33000,3,2970,0,0,0,0,0,0,0,33000,-33000,-33000
20200316,048426,超眾元富93購01,,,,,0.00,0.00,0,0,0,0,0,0,0,0,0,0,0,0,0
20200316,048427,百和元富95購01,0.25,0.25,0.25,0.25,+0.01,4.17,1000,1,250,0,0,0,0,0,0,0,1000,-1000,-1000
20200316,048428,滬深2X國票93購05,,,,,0.00,0.00,0,0,0,0,0,0,0,0,0,0,0,0,0
20200316,048429,旺宏國票94購02,0.01,0.01,0.01,0.01,-0.01,-50.0,15000,1,150,0,0,0,0,0,0,15000,0,15000,15000
20200316,04842P,群創元大96售02,0.75,0.87,0.75,0.87,0.00,0.00,61000,9,49950,0,0,0,0,0,0,15000,56000,-41000,-41000
20200316,048430,瑞昱國票93購02,,,,,0.00,0.00,0,0,0,0,0,0,0,0,0,0,0,0,0
20200316,048431,瑞昱國票94購01,,,,,0.00,0.00,0,0,0,0,0,0,0,0,0,0,0,0,0
20200316,048432,全新國票95購01,,,,,0.00,0.00,0,0,0,0,0,0,0,0,0,0,0,0,0
20200316,048433,聯詠國票94購01,0.53,0.53,0.53,0.53,-0.01,-1.85,120000,2,63600,0,0,0,0,0,0,120000,0,120000,120000
20200316,048434,樺漢國票93購02,,,,,0.00,0.00,0,0,0,0,0,0,0,0,0,0,0,0,0
20200316,048435,致新國票93購01,0.01,0.01,0.01,0.01,-0.01,-50.0,10000,1,100,0,0,0,0,0,0,10000,0,10000,10000
20200316,048436,聯茂日盛93購01,,,,,0.00,0.00,0,0,0,0,0,0,0,0,0,0,0,0,0
20200316,048437,義隆麥證93購01,,,,,0.00,0.00,0,0,0,0,0,0,0,0,0,0,0,0,0
20200316,048438,台表科麥證94購01,,,,,0.00,0.00,0,0,0,0,0,0,0,0,0,0,0,0,0
20200316,048439,上銀凱基93購09,,,,,0.00,0.00,0,0,0,0,0,0,0,0,0,0,0,0,0
20200316,04843P,致新元大94售02,2.20,2.29,2.20,2.21,+0.09,4.25,50000,5,111600,0,0,0,0,0,0,0,50000,-50000,-50000
20200316,048440,國巨凱基93購08,4.47,4.61,2.77,2.77,-0.93,-25.14,88000,6,355420,0,0,0,0,0,0,50000,38000,12000,12000
20200316,048441,台積電凱基93購29,,,,,0.00,0.00,0,0,0,0,0,0,0,0,0,0,0,0,0
20200316,048442,友訊凱基94購01,,,,,0.00,0.00,0,0,0,0,0,0,0,0,0,0,0,0,0
20200316,048443,旺宏凱基93購08,,,,,0.00,0.00,0,0,0,0,0,0,0,0,0,0,0,0,0
20200316,048444,燿華凱基93購05,,,,,0.00,0.00,0,0,0,0,0,0,0,0,0,0,0,0,0
20200316,048445,瑞昱凱基93購11,,,,,0.00,0.00,0,0,0,0,0,0,0,0,0,0,0,0,0
20200316,048446,南亞科凱基93購07,,,,,0.00,0.00,0,0,0,0,0,0,0,0,0,0,0,0,0
20200316,048447,美律凱基93購06,,,,,0.00,0.00,0,0,0,0,0,0,0,0,0,0,0,0,0
20200316,048448,京元電凱基93購05,,,,,0.00,0.00,0,0,0,0,0,0,0,0,0,0,0,0,0
20200316,048449,強茂凱基93購03,,,,,0.00,0.00,0,0,0,0,0,0,0,0,0,0,0,0,0
20200316,04844P,京元電亞東94售01,1.55,1.66,1.52,1.66,-0.11,-6.21,44000,3,72790,0,0,0,0,0,0,0,44000,-44000,-44000
20200316,048450,聯詠凱基93購09,,,,,0.00,0.00,0,0,0,0,0,0,0,0,0,0,0,0,0
20200316,048451,智原凱基93購02,,,,,0.00,0.00,0,0,0,0,0,0,0,0,0,0,0,0,0
20200316,048452,緯創凱基93購04,,,,,0.00,0.00,0,0,0,0,0,0,0,0,0,0,0,0,0
20200316,048453,嘉澤凱基93購05,,,,,0.00,0.00,0,0,0,0,0,0,0,0,0,0,0,0,0
20200316,048454,合勤控凱基94購01,,,,,0.00,0.00,0,0,0,0,0,0,0,0,0,0,0,0,0
20200316,048455,上緯控凱基94購01,,,,,0.00,0.00,0,0,0,0,0,0,0,0,0,0,0,0,0
20200316,048456,利勤凱基95購01,,,,,0.00,0.00,0,0,0,0,0,0,0,0,0,0,0,0,0
20200316,048457,康普凱基93購01,,,,,0.00,0.00,0,0,0,0,0,0,0,0,0,0,0,0,0
20200316,048458,中磊凱基93購03,,,,,0.00,0.00,0,0,0,0,0,0,0,0,0,0,0,0,0
20200316,048459,嘉聯益凱基93購04,,,,,0.00,0.00,0,0,0,0,0,0,0,0,0,0,0,0,0
20200316,04845P,台積電凱基94售33,0.39,0.39,0.34,0.35,0.00,0.00,60000,4,21260,0,0,0,0,0,0,0,60000,-60000,-60000
20200316,048460,盛群凱基94購01,0.24,0.30,0.22,0.24,+0.02,9.09,701000,24,182900,0,0,0,0,0,0,346000,352000,-6000,-6000
20200316,048461,緯穎凱基93購01,,,,,0.00,0.00,0,0,0,0,0,0,0,0,0,0,0,0,0
20200316,048462,南電凱基93購06,,,,,0.00,0.00,0,0,0,0,0,0,0,0,0,0,0,0,0
20200316,048463,美利達凱基93購06,,,,,0.00,0.00,0,0,0,0,0,0,0,0,0,0,0,0,0
20200316,048464,康控台新94購01,,,,,0.00,0.00,0,0,0,0,0,0,0,0,0,0,0,0,0
20200316,048465,南電台新93購01,,,,,0.00,0.00,0,0,0,0,0,0,0,0,0,0,0,0,0
20200316,048466,卜蜂康和93購01,,,,,0.00,0.00,0,0,0,0,0,0,0,0,0,0,0,0,0
20200316,048467,南電康和93購01,,,,,0.00,0.00,0,0,0,0,0,0,0,0,0,0,0,0,0
20200316,048468,光磊永豐93購01,,,,,0.00,0.00,0,0,0,0,0,0,0,0,0,0,0,0,0
20200316,048469,微星永豐93購03,,,,,0.00,0.00,0,0,0,0,0,0,0,0,0,0,0,0,0
20200316,04846P,旺宏凱基94售07,0.27,0.40,0.23,0.40,+0.10,33.33,97000,7,26830,0,0,0,0,0,0,25000,72000,-47000,-47000
20200316,048470,神基永豐93購01,,,,,0.00,0.00,0,0,0,0,0,0,0,0,0,0,0,0,0
20200316,048471,旭富永豐93購01,0.04,0.04,0.03,0.03,0.00,0.00,236000,3,7240,0,0,0,0,0,0,236000,0,236000,236000
20200316,048472,傳奇永豐93購01,,,,,0.00,0.00,0,0,0,0,0,0,0,0,0,0,0,0,0
20200316,048473,瀚宇博永豐93購02,,,,,0.00,0.00,0,0,0,0,0,0,0,0,0,0,0,0,0
20200316,048474,嘉聯益永豐93購03,,,,,0.00,0.00,0,0,0,0,0,0,0,0,0,0,0,0,0
20200316,048475,台郡永豐93購02,,,,,0.00,0.00,0,0,0,0,0,0,0,0,0,0,0,0,0
20200316,048476,同欣電永豐93購01,,,,,0.00,0.00,0,0,0,0,0,0,0,0,0,0,0,0,0
20200316,048477,易華電永豐93購04,,,,,0.00,0.00,0,0,0,0,0,0,0,0,0,0,0,0,0
20200316,048478,羅麗芬永豐94購01,,,,,0.00,0.00,0,0,0,0,0,0,0,0,0,0,0,0,0
20200316,048479,寶成永豐93購01,,,,,0.00,0.00,0,0,0,0,0,0,0,0,0,0,0,0,0
20200316,04847P,聯發科凱基94售17,0.11,34.10,0.05,0.10,0.00,0.00,792000,74,114600,0,0,0,0,0,0,0,770000,-770000,-770000
20200316,048480,FB上証中信94購01,0.02,0.02,0.02,0.02,-0.02,-50.0,10000,1,200,0,0,0,0,0,0,0,10000,-10000,-10000
20200316,048481,瑞儀中信93購01,,,,,0.00,0.00,0,0,0,0,0,0,0,0,0,0,0,0,0
20200316,048482,柏文中信94購01,,,,,0.00,0.00,0,0,0,0,0,0,0,0,0,0,0,0,0
20200316,048483,可成國泰95購01,0.12,0.12,0.10,0.10,-0.02,-16.67,1000000,3,114970,0,0,0,0,0,0,1000000,0,1000000,1000000
20200316,048484,大立光國泰95購02,0.40,0.40,0.21,0.21,-0.16,-43.24,70000,5,24800,0,0,0,0,0,0,50000,30000,20000,20000
20200316,048485,泰鼎國泰94購02,1.90,2.01,1.85,1.92,+0.05,2.67,84000,29,164620,0,0,0,0,0,0,84000,0,84000,84000
20200316,048486,傳奇國泰95購01,,,,,0.00,0.00,0,0,0,0,0,0,0,0,0,0,0,0,0
20200316,048487,華邦電富邦93購02,,,,,0.00,0.00,0,0,0,0,0,0,0,0,0,0,0,0,0
20200316,048488,大立光富邦93購05,,,,,0.00,0.00,0,0,0,0,0,0,0,0,0,0,0,0,0
20200316,048489,明泰富邦93購01,,,,,0.00,0.00,0,0,0,0,0,0,0,0,0,0,0,0,0
20200316,04848P,康控凱基94售02,,,,,0.00,0.00,0,0,0,0,0,0,0,0,0,0,0,0,0
20200316,048490,寶成富邦93購01,,,,,0.00,0.00,0,0,0,0,0,0,0,0,0,0,0,0,0
20200316,048491,A50元大93購01,,,,,0.00,0.00,0,0,0,0,0,0,0,0,0,0,0,0,0
20200316,048492,國巨元大93購11,,,,,0.00,0.00,0,0,0,0,0,0,0,0,0,0,0,0,0
20200316,048493,微星元大93購04,,,,,0.00,0.00,0,0,0,0,0,0,0,0,0,0,0,0,0
20200316,048494,瑞昱元大93購13,,,,,0.00,0.00,0,0,0,0,0,0,0,0,0,0,0,0,0
20200316,048495,南亞科元大93購04,,,,,0.00,0.00,0,0,0,0,0,0,0,0,0,0,0,0,0
20200316,048496,南亞科元大93購05,,,,,0.00,0.00,0,0,0,0,0,0,0,0,0,0,0,0,0
20200316,048497,京元電元大93購02,,,,,0.00,0.00,0,0,0,0,0,0,0,0,0,0,0,0,0
20200316,048498,嘉澤元大94購01,0.23,0.23,0.22,0.22,+0.08,57.14,25000,4,5650,0,0,0,0,0,0,25000,0,25000,25000
20200316,048499,達運元大96購01,0.03,0.03,0.03,0.03,-0.02,-40.0,129000,4,3870,0,0,0,0,0,0,129000,0,129000,129000
20200316,04849P,GIS中信94售01,1.91,1.91,1.91,1.91,0.00,0.00,10000,1,19100,0,0,0,0,0,0,0,10000,-10000,-10000
20200316,048500,樺漢元大93購03,,,,,0.00,0.00,0,0,0,0,0,0,0,0,0,0,0,0,0
20200316,048501,GIS元大94購02,,,,,0.00,0.00,0,0,0,0,0,0,0,0,0,0,0,0,0
20200316,048502,百和元大93購01,,,,,0.00,0.00,0,0,0,0,0,0,0,0,0,0,0,0,0
20200316,048503,百和元大93購02,,,,,0.00,0.00,0,0,0,0,0,0,0,0,0,0,0,0,0
20200316,048504,A50正2中信95購01,0.10,0.10,0.10,0.10,0.00,0.00,50000,1,5000,0,0,0,0,0,0,0,50000,-50000,-50000
20200316,048505,滬深2X群益99購03,0.27,0.27,0.27,0.27,+0.01,3.85,20000,1,5400,0,0,0,0,0,0,20000,0,20000,20000
20200316,048506,華通群益94購03,,,,,0.00,0.00,0,0,0,0,0,0,0,0,0,0,0,0,0
20200316,048507,聯茂群益93購05,,,,,0.00,0.00,0,0,0,0,0,0,0,0,0,0,0,0,0
20200316,048508,元上證凱基94購02,,,,,0.00,0.00,0,0,0,0,0,0,0,0,0,0,0,0,0
20200316,048509,上証反凱基99購02,0.39,0.44,0.39,0.44,-0.03,-6.38,660000,17,274630,0,0,0,0,0,0,10000,640000,-630000,-630000
20200316,04850P,全新永豐94售03,,,,,0.00,0.00,0,0,0,0,0,0,0,0,0,0,0,0,0
20200316,048510,滬深2X凱基93購05,,,,,0.00,0.00,0,0,0,0,0,0,0,0,0,0,0,0,0
20200316,048511,美律凱基93購07,,,,,0.00,0.00,0,0,0,0,0,0,0,0,0,0,0,0,0
20200316,048512,全新凱基93購04,,,,,0.00,0.00,0,0,0,0,0,0,0,0,0,0,0,0,0
20200316,048513,欣興凱基93購04,,,,,0.00,0.00,0,0,0,0,0,0,0,0,0,0,0,0,0
20200316,048514,嘉澤凱基93購06,,,,,0.00,0.00,0,0,0,0,0,0,0,0,0,0,0,0,0
20200316,048515,貿聯凱基93購03,,,,,0.00,0.00,0,0,0,0,0,0,0,0,0,0,0,0,0
20200316,048516,麗豐凱基93購02,,,,,0.00,0.00,0,0,0,0,0,0,0,0,0,0,0,0,0
20200316,048517,致伸凱基93購06,,,,,0.00,0.00,0,0,0,0,0,0,0,0,0,0,0,0,0
20200316,048518,聯茂凱基93購10,,,,,0.00,0.00,0,0,0,0,0,0,0,0,0,0,0,0,0
20200316,048519,緯穎凱基93購02,10.40,10.40,8.55,9.00,+4.22,88.28,191000,23,1830300,0,0,0,0,0,0,191000,0,191000,191000
20200316,04851P,創意永豐94售02,2.27,2.31,2.27,2.31,-0.33,-12.5,20000,2,45800,0,0,0,0,0,0,0,20000,-20000,-20000
20200316,048520,柏文凱基93購03,,,,,0.00,0.00,0,0,0,0,0,0,0,0,0,0,0,0,0
20200316,048521,華通統一93購05,,,,,0.00,0.00,0,0,0,0,0,0,0,0,0,0,0,0,0
20200316,048522,A50正2元富95購02,,,,,0.00,0.00,0,0,0,0,0,0,0,0,0,0,0,0,0
20200316,048523,TPK元富94購01,,,,,0.00,0.00,0,0,0,0,0,0,0,0,0,0,0,0,0
20200316,048524,GIS元富94購01,,,,,0.00,0.00,0,0,0,0,0,0,0,0,0,0,0,0,0
20200316,048525,華通國票94購02,,,,,0.00,0.00,0,0,0,0,0,0,0,0,0,0,0,0,0
20200316,048526,鴻海國票93購03,,,,,0.00,0.00,0,0,0,0,0,0,0,0,0,0,0,0,0
20200316,048527,鴻海國票94購02,,,,,0.00,0.00,0,0,0,0,0,0,0,0,0,0,0,0,0
20200316,048528,華泰國票94購01,,,,,0.00,0.00,0,0,0,0,0,0,0,0,0,0,0,0,0
20200316,048529,京元電國票94購01,,,,,0.00,0.00,0,0,0,0,0,0,0,0,0,0,0,0,0
20200316,04852P,臻鼎永豐94售02,1.66,1.66,1.66,1.66,0.00,0.00,10000,2,16600,0,0,0,0,0,0,10000,0,10000,10000
20200316,048530,大立光國票93購04,,,,,0.00,0.00,0,0,0,0,0,0,0,0,0,0,0,0,0
20200316,048531,大立光國票93購05,,,,,0.00,0.00,0,0,0,0,0,0,0,0,0,0,0,0,0
20200316,048532,大立光國票93購06,,,,,0.00,0.00,0,0,0,0,0,0,0,0,0,0,0,0,0
20200316,048533,景碩國票94購01,,,,,0.00,0.00,0,0,0,0,0,0,0,0,0,0,0,0,0
20200316,048534,貿聯國票94購01,,,,,0.00,0.00,0,0,0,0,0,0,0,0,0,0,0,0,0
20200316,048535,超眾國票94購02,,,,,0.00,0.00,0,0,0,0,0,0,0,0,0,0,0,0,0
20200316,048536,南電國票93購04,,,,,0.00,0.00,0,0,0,0,0,0,0,0,0,0,0,0,0
20200316,048537,柏文國票94購01,,,,,0.00,0.00,0,0,0,0,0,0,0,0,0,0,0,0,0
20200316,048538,美利達國票94購01,,,,,0.00,0.00,0,0,0,0,0,0,0,0,0,0,0,0,0
20200316,048539,巨大國票94購01,,,,,0.00,0.00,0,0,0,0,0,0,0,0,0,0,0,0,0
20200316,04853P,易華電永豐94售03,,,,,0.00,0.00,0,0,0,0,0,0,0,0,0,0,0,0,0
20200316,048540,百和國票93購01,,,,,0.00,0.00,0,0,0,0,0,0,0,0,0,0,0,0,0
20200316,048541,緯穎台新93購01,,,,,0.00,0.00,0,0,0,0,0,0,0,0,0,0,0,0,0
20200316,048542,美利達台新93購01,,,,,0.00,0.00,0,0,0,0,0,0,0,0,0,0,0,0,0
20200316,048543,統一永豐93購01,,,,,0.00,0.00,0,0,0,0,0,0,0,0,0,0,0,0,0
20200316,048544,欣興永豐94購01,,,,,0.00,0.00,0,0,0,0,0,0,0,0,0,0,0,0,0
20200316,048545,嘉澤永豐93購03,,,,,0.00,0.00,0,0,0,0,0,0,0,0,0,0,0,0,0
20200316,048546,廣越永豐93購01,,,,,0.00,0.00,0,0,0,0,0,0,0,0,0,0,0,0,0
20200316,048547,訊芯永豐93購03,,,,,0.00,0.00,0,0,0,0,0,0,0,0,0,0,0,0,0
20200316,048548,緯穎永豐93購02,,,,,0.00,0.00,0,0,0,0,0,0,0,0,0,0,0,0,0
20200316,048549,滬深2X元大96購03,,,,,0.00,0.00,0,0,0,0,0,0,0,0,0,0,0,0,0
20200316,04854P,鴻海國泰96售04,1.97,2.35,1.97,2.35,+0.66,39.05,71000,10,149530,0,0,0,0,0,0,56000,16000,40000,40000
20200316,048550,中鴻元大96購01,,,,,0.00,0.00,0,0,0,0,0,0,0,0,0,0,0,0,0
20200316,048551,鴻海元大94購02,1.66,1.68,1.12,1.13,-0.15,-11.72,288000,34,404110,0,0,0,0,0,0,238000,177000,61000,61000
20200316,048552,鴻海元大94購03,1.28,1.30,0.79,0.80,-0.29,-26.61,104000,13,114020,0,0,0,0,0,0,104000,54000,50000,50000
20200316,048553,光磊元大93購03,,,,,0.00,0.00,0,0,0,0,0,0,0,0,0,0,0,0,0
20200316,048554,燿華元大93購06,,,,,0.00,0.00,0,0,0,0,0,0,0,0,0,0,0,0,0
20200316,048555,技嘉元大93購02,0.01,0.01,0.01,0.01,0.00,0.00,5000,1,50,0,0,0,0,0,0,5000,0,5000,5000
20200316,048556,技嘉元大93購03,,,,,0.00,0.00,0,0,0,0,0,0,0,0,0,0,0,0,0
20200316,048557,瑞昱元大94購01,0.27,0.27,0.22,0.22,-0.14,-38.89,49000,2,11280,0,0,0,0,0,0,49000,39000,10000,10000
20200316,048558,漢唐元大93購06,,,,,0.00,0.00,0,0,0,0,0,0,0,0,0,0,0,0,0
20200316,048559,京元電元大93購03,,,,,0.00,0.00,0,0,0,0,0,0,0,0,0,0,0,0,0
20200316,04855P,上証2X元富94售02,2.80,3.10,2.80,3.10,-0.23,-6.91,9000,5,27080,0,0,0,0,0,0,9000,0,9000,9000
20200316,048560,聯發科元大94購01,,,,,0.00,0.00,0,0,0,0,0,0,0,0,0,0,0,0,0
20200316,048561,可成元大93購13,,,,,0.00,0.00,0,0,0,0,0,0,0,0,0,0,0,0,0
20200316,048562,宏達電元大95購01,0.17,0.17,0.11,0.11,-0.02,-15.38,280000,28,43850,0,0,0,0,0,0,20000,260000,-240000,-240000
20200316,048563,明泰元大94購01,,,,,0.00,0.00,0,0,0,0,0,0,0,0,0,0,0,0,0
20200316,048564,智易元大94購01,,,,,0.00,0.00,0,0,0,0,0,0,0,0,0,0,0,0,0
20200316,048565,康控元大94購04,,,,,0.00,0.00,0,0,0,0,0,0,0,0,0,0,0,0,0
20200316,048566,上海銀元大93購04,,,,,0.00,0.00,0,0,0,0,0,0,0,0,0,0,0,0,0
20200316,048567,台郡元大93購03,0.76,0.76,0.62,0.67,-0.08,-10.67,27000,4,19740,0,0,0,0,0,0,20000,7000,13000,13000
20200316,048568,緯穎元大93購06,8.05,8.05,7.85,7.85,+3.55,82.56,20000,2,159000,0,0,0,0,0,0,20000,0,20000,20000
20200316,048569,台虹元大93購03,0.84,0.95,0.52,0.52,-0.42,-44.68,100000,6,70800,0,0,0,0,0,0,100000,0,100000,100000
20200316,04856P,光磊元富94售01,,,,,0.00,0.00,0,0,0,0,0,0,0,0,0,0,0,0,0
20200316,048570,鈺齊元大93購01,,,,,0.00,0.00,0,0,0,0,0,0,0,0,0,0,0,0,0
20200316,048571,美利達元大96購03,,,,,0.00,0.00,0,0,0,0,0,0,0,0,0,0,0,0,0
20200316,048572,美利達元大96購04,0.26,0.29,0.19,0.19,-0.19,-50.0,1243000,131,312650,0,0,0,0,0,0,85000,1128000,-1043000,-1043000
20200316,048573,世紀鋼元大93購05,1.11,1.11,0.79,0.79,-0.11,-12.22,487000,17,483660,0,0,0,0,0,0,452000,35000,417000,417000
20200316,048574,台積電國泰95購02,7.00,7.45,5.90,5.90,-0.75,-11.28,125000,17,884650,0,0,0,0,0,0,121000,3000,118000,118000
20200316,048575,旺宏國泰94購04,0.77,0.90,0.42,0.42,-0.32,-43.24,458000,24,310350,0,0,0,0,0,0,319000,138000,181000,181000
20200316,048576,義隆國泰95購01,,,,,0.00,0.00,0,0,0,0,0,0,0,0,0,0,0,0,0
20200316,048577,GIS國泰94購01,,,,,0.00,0.00,0,0,0,0,0,0,0,0,0,0,0,0,0
20200316,048578,滬深2X富邦93購04,,,,,0.00,0.00,0,0,0,0,0,0,0,0,0,0,0,0,0
20200316,048579,華新富邦93購01,,,,,0.00,0.00,0,0,0,0,0,0,0,0,0,0,0,0,0
20200316,04857P,美律元富94售01,1.59,1.59,1.59,1.59,-0.45,-22.06,23000,2,36570,0,0,0,0,0,0,23000,0,23000,23000
20200316,048580,台達電富邦93購01,,,,,0.00,0.00,0,0,0,0,0,0,0,0,0,0,0,0,0
20200316,048581,南亞科富邦93購02,,,,,0.00,0.00,0,0,0,0,0,0,0,0,0,0,0,0,0
20200316,048582,國泰金富邦93購01,,,,,0.00,0.00,0,0,0,0,0,0,0,0,0,0,0,0,0
20200316,048583,智原富邦98購01,0.02,0.10,0.02,0.10,0.00,0.00,41000,2,900,0,0,0,0,0,0,40000,1000,39000,39000
20200316,048584,欣興富邦95購01,,,,,0.00,0.00,0,0,0,0,0,0,0,0,0,0,0,0,0
20200316,048585,瑞儀富邦93購01,,,,,0.00,0.00,0,0,0,0,0,0,0,0,0,0,0,0,0
20200316,048586,美利達富邦93購01,,,,,0.00,0.00,0,0,0,0,0,0,0,0,0,0,0,0,0
20200316,048587,康控中信93購01,,,,,0.00,0.00,0,0,0,0,0,0,0,0,0,0,0,0,0
20200316,048588,世紀鋼中信94購01,0.53,0.59,0.52,0.56,+0.07,14.29,432000,39,240260,0,0,0,0,0,0,257000,135000,122000,122000
20200316,048589,國巨兆豐96購01,,,,,0.00,0.00,0,0,0,0,0,0,0,0,0,0,0,0,0
20200316,04858P,健策元富94售01,0.28,0.57,0.28,0.57,+0.14,32.56,56000,4,20700,0,0,0,0,0,0,56000,10000,46000,46000
20200316,048590,貿聯兆豐94購02,0.02,0.02,0.02,0.02,0.00,0.00,490000,49,9800,0,0,0,0,0,0,0,490000,-490000,-490000
20200316,048591,台郡兆豐94購01,,,,,0.00,0.00,0,0,0,0,0,0,0,0,0,0,0,0,0
20200316,048592,漢唐群益93購04,,,,,0.00,0.00,0,0,0,0,0,0,0,0,0,0,0,0,0
20200316,048593,華新科群益93購04,,,,,0.00,0.00,0,0,0,0,0,0,0,0,0,0,0,0,0
20200316,048594,泰鼎群益93購02,,,,,0.00,0.00,0,0,0,0,0,0,0,0,0,0,0,0,0
20200316,048595,儒鴻國票96購01,0.02,0.02,0.02,0.02,0.00,0.00,190000,8,3800,0,0,0,0,0,0,0,0,0,0
20200316,048596,力山國票94購01,,,,,0.00,0.00,0,0,0,0,0,0,0,0,0,0,0,0,0
20200316,048597,台達電國票93購02,,,,,0.00,0.00,0,0,0,0,0,0,0,0,0,0,0,0,0
20200316,048598,瑞昱國票93購03,,,,,0.00,0.00,0,0,0,0,0,0,0,0,0,0,0,0,0
20200316,048599,和鑫國票96購01,,,,,0.00,0.00,0,0,0,0,0,0,0,0,0,0,0,0,0
20200316,04859P,台達電群益94售04,,,,,0.00,0.00,0,0,0,0,0,0,0,0,0,0,0,0,0
20200316,048600,嘉澤國票94購01,,,,,0.00,0.00,0,0,0,0,0,0,0,0,0,0,0,0,0
20200316,048601,智易國票94購03,,,,,0.00,0.00,0,0,0,0,0,0,0,0,0,0,0,0,0
20200316,048602,上緯控國票96購01,,,,,0.00,0.00,0,0,0,0,0,0,0,0,0,0,0,0,0
20200316,048603,中磊國票94購02,,,,,0.00,0.00,0,0,0,0,0,0,0,0,0,0,0,0,0
20200316,048604,美利達國票94購02,,,,,0.00,0.00,0,0,0,0,0,0,0,0,0,0,0,0,0
20200316,048605,百和國票93購02,,,,,0.00,0.00,0,0,0,0,0,0,0,0,0,0,0,0,0
20200316,048606,聯發科日盛93購02,,,,,0.00,0.00,0,0,0,0,0,0,0,0,0,0,0,0,0
20200316,048607,上銀凱基93購11,,,,,0.00,0.00,0,0,0,0,0,0,0,0,0,0,0,0,0
20200316,048608,燿華凱基93購06,,,,,0.00,0.00,0,0,0,0,0,0,0,0,0,0,0,0,0
20200316,048609,京元電凱基93購07,,,,,0.00,0.00,0,0,0,0,0,0,0,0,0,0,0,0,0
20200316,04860P,鴻海群益94售07,4.09,4.09,4.09,4.09,-0.83,-16.87,6000,1,24540,0,0,0,0,0,0,0,6000,-6000,-6000
20200316,048610,華新科凱基94購04,0.59,0.59,0.59,0.59,-0.15,-20.27,10000,1,5900,0,0,0,0,0,0,10000,0,10000,10000
20200316,048611,宏達電凱基93購04,,,,,0.00,0.00,0,0,0,0,0,0,0,0,0,0,0,0,0
20200316,048612,嘉晶凱基93購05,,,,,0.00,0.00,0,0,0,0,0,0,0,0,0,0,0,0,0
20200316,048613,智原凱基93購03,,,,,0.00,0.00,0,0,0,0,0,0,0,0,0,0,0,0,0
20200316,048614,欣興凱基93購05,,,,,0.00,0.00,0,0,0,0,0,0,0,0,0,0,0,0,0
20200316,048615,貿聯凱基93購04,,,,,0.00,0.00,0,0,0,0,0,0,0,0,0,0,0,0,0
20200316,048616,智伸科凱基93購07,,,,,0.00,0.00,0,0,0,0,0,0,0,0,0,0,0,0,0
20200316,048617,瀚宇博凱基93購04,,,,,0.00,0.00,0,0,0,0,0,0,0,0,0,0,0,0,0
20200316,048618,超眾凱基93購08,,,,,0.00,0.00,0,0,0,0,0,0,0,0,0,0,0,0,0
20200316,048619,台表科凱基93購07,,,,,0.00,0.00,0,0,0,0,0,0,0,0,0,0,0,0,0
20200316,04861P,中磊群益94售02,,,,,0.00,0.00,0,0,0,0,0,0,0,0,0,0,0,0,0
20200316,048620,易華電凱基94購02,,,,,0.00,0.00,0,0,0,0,0,0,0,0,0,0,0,0,0
20200316,048621,緯穎凱基93購03,,,,,0.00,0.00,0,0,0,0,0,0,0,0,0,0,0,0,0
20200316,048622,南電凱基93購07,,,,,0.00,0.00,0,0,0,0,0,0,0,0,0,0,0,0,0
20200316,048623,世紀鋼凱基94購03,0.32,0.33,0.32,0.33,0.00,0.00,46000,4,15120,0,0,0,0,0,0,4000,36000,-32000,-32000
20200316,048624,美律台新93購01,,,,,0.00,0.00,0,0,0,0,0,0,0,0,0,0,0,0,0
20200316,048625,GIS台新93購01,,,,,0.00,0.00,0,0,0,0,0,0,0,0,0,0,0,0,0
20200316,048626,矽創台新93購01,,,,,0.00,0.00,0,0,0,0,0,0,0,0,0,0,0,0,0
20200316,048627,T50反1元大96購02,0.93,1.24,0.93,1.24,+0.21,20.39,188000,7,184490,0,0,0,0,0,0,147000,41000,106000,106000
20200316,048628,T50反1元大96購03,0.96,1.36,0.90,1.28,+0.38,42.22,399000,35,409590,0,0,0,0,0,0,176000,0,176000,176000
20200316,048629,滬深2X元大96購04,,,,,0.00,0.00,0,0,0,0,0,0,0,0,0,0,0,0,0
20200316,04862P,台積電元大94售26,1.42,2.11,1.42,2.11,+0.11,5.5,23000,5,36310,0,0,0,0,0,0,12000,11000,1000,1000
20200316,048630,南亞元大93購01,,,,,0.00,0.00,0,0,0,0,0,0,0,0,0,0,0,0,0
20200316,048631,遠東新元大93購01,,,,,0.00,0.00,0,0,0,0,0,0,0,0,0,0,0,0,0
20200316,048632,大成鋼元大93購02,,,,,0.00,0.00,0,0,0,0,0,0,0,0,0,0,0,0,0
20200316,048633,台達電元大94購02,,,,,0.00,0.00,0,0,0,0,0,0,0,0,0,0,0,0,0
20200316,048634,華通元大94購01,0.16,0.16,0.16,0.16,+0.05,45.45,30000,1,4800,0,0,0,0,0,0,30000,0,30000,30000
20200316,048635,鴻海元大94購04,0.76,0.84,0.49,0.49,-0.08,-14.04,60000,3,46100,0,0,0,0,0,0,40000,20000,20000,20000
20200316,048636,鴻海元大94購05,0.89,0.90,0.52,0.53,-0.49,-48.04,110000,15,80100,0,0,0,0,0,0,60000,60000,0,0
20200316,048637,鴻海元大96購01,1.67,1.69,1.20,1.20,-0.66,-35.48,592000,47,828410,0,0,0,0,0,0,574000,533000,41000,41000
20200316,048638,台光電元大94購01,0.16,0.16,0.16,0.16,+0.05,45.45,10000,1,1600,0,0,0,0,0,0,0,10000,-10000,-10000
20200316,048639,漢唐元大93購07,,,,,0.00,0.00,0,0,0,0,0,0,0,0,0,0,0,0,0
20200316,04863P,技嘉元大94售02,1.23,1.46,1.23,1.46,+0.08,5.8,23000,4,30910,0,0,0,0,0,0,13000,10000,3000,3000
20200316,048640,南亞科元大93購06,,,,,0.00,0.00,0,0,0,0,0,0,0,0,0,0,0,0,0
20200316,048641,美律元大94購01,,,,,0.00,0.00,0,0,0,0,0,0,0,0,0,0,0,0,0
20200316,048642,聯發科元大94購02,0.13,0.13,0.10,0.10,+0.02,25.0,30000,3,3300,0,0,0,0,0,0,0,30000,-30000,-30000
20200316,048643,強茂元大94購01,,,,,0.00,0.00,0,0,0,0,0,0,0,0,0,0,0,0,0
20200316,048644,華固元大93購01,1.73,1.90,1.71,1.78,+0.18,11.25,70000,6,124600,0,0,0,0,0,0,60000,10000,50000,50000
20200316,048645,創意元大94購02,,,,,0.00,0.00,0,0,0,0,0,0,0,0,0,0,0,0,0
20200316,048646,上緯控元大93購01,,,,,0.00,0.00,0,0,0,0,0,0,0,0,0,0,0,0,0
20200316,048647,正文元大93購01,,,,,0.00,0.00,0,0,0,0,0,0,0,0,0,0,0,0,0
20200316,048648,祥碩元大93購03,,,,,0.00,0.00,0,0,0,0,0,0,0,0,0,0,0,0,0
20200316,048649,瀚宇博元大93購05,,,,,0.00,0.00,0,0,0,0,0,0,0,0,0,0,0,0,0
20200316,04864P,欣興元大94售10,,,,,0.00,0.00,0,0,0,0,0,0,0,0,0,0,0,0,0
20200316,048650,台表科元大93購05,,,,,0.00,0.00,0,0,0,0,0,0,0,0,0,0,0,0,0
20200316,048651,美利達元大96購05,,,,,0.00,0.00,0,0,0,0,0,0,0,0,0,0,0,0,0
20200316,048652,巨大元大96購01,0.15,0.15,0.15,0.15,-0.03,-16.67,207000,21,31050,0,0,0,0,0,0,0,207000,-207000,-207000
20200316,048653,巨大元大96購02,,,,,0.00,0.00,0,0,0,0,0,0,0,0,0,0,0,0,0
20200316,048654,滬深2X元富93購05,,,,,0.00,0.00,0,0,0,0,0,0,0,0,0,0,0,0,0
20200316,048655,A50正2元富96購01,0.24,0.24,0.17,0.17,-0.14,-45.16,226000,6,41880,0,0,0,0,0,0,0,226000,-226000,-226000
20200316,048656,大立光元富93購05,,,,,0.00,0.00,0,0,0,0,0,0,0,0,0,0,0,0,0
20200316,048657,大成鋼統一93購04,,,,,0.00,0.00,0,0,0,0,0,0,0,0,0,0,0,0,0
20200316,048658,鴻海統一93購09,,,,,0.00,0.00,0,0,0,0,0,0,0,0,0,0,0,0,0
20200316,048659,國巨統一94購02,,,,,0.00,0.00,0,0,0,0,0,0,0,0,0,0,0,0,0
20200316,04865P,台積電亞東95售01,0.57,0.86,0.57,0.86,+0.29,50.88,140000,13,103400,0,0,0,0,0,0,120000,140000,-20000,-20000
20200316,048660,台積電統一93購09,0.91,0.91,0.78,0.78,+0.42,116.67,35000,4,29500,0,0,0,0,0,0,35000,35000,0,0
20200316,048661,瑞昱統一93購05,,,,,0.00,0.00,0,0,0,0,0,0,0,0,0,0,0,0,0
20200316,048662,京元電統一93購04,,,,,0.00,0.00,0,0,0,0,0,0,0,0,0,0,0,0,0
20200316,048663,聯發科統一96購01,,,,,0.00,0.00,0,0,0,0,0,0,0,0,0,0,0,0,0
20200316,048664,華新科統一94購01,,,,,0.00,0.00,0,0,0,0,0,0,0,0,0,0,0,0,0
20200316,048665,欣興統一93購07,,,,,0.00,0.00,0,0,0,0,0,0,0,0,0,0,0,0,0
20200316,048666,康控統一93購01,,,,,0.00,0.00,0,0,0,0,0,0,0,0,0,0,0,0,0
20200316,048667,旺宏永豐94購02,,,,,0.00,0.00,0,0,0,0,0,0,0,0,0,0,0,0,0
20200316,048668,奇力新永豐93購04,,,,,0.00,0.00,0,0,0,0,0,0,0,0,0,0,0,0,0
20200316,048669,強茂永豐93購01,,,,,0.00,0.00,0,0,0,0,0,0,0,0,0,0,0,0,0
20200316,04866P,台積電統一95售02,1.22,1.29,1.22,1.29,+0.11,9.32,20000,2,25100,0,0,0,0,0,0,20000,0,20000,20000
20200316,048670,華新科永豐93購03,,,,,0.00,0.00,0,0,0,0,0,0,0,0,0,0,0,0,0
20200316,048671,大立光永豐93購04,,,,,0.00,0.00,0,0,0,0,0,0,0,0,0,0,0,0,0
20200316,048672,日電貿永豐93購02,,,,,0.00,0.00,0,0,0,0,0,0,0,0,0,0,0,0,0
20200316,048673,智伸科永豐93購02,,,,,0.00,0.00,0,0,0,0,0,0,0,0,0,0,0,0,0
20200316,048674,易華電永豐93購05,,,,,0.00,0.00,0,0,0,0,0,0,0,0,0,0,0,0,0
20200316,048675,台達電國泰94購02,0.21,0.21,0.12,0.12,+0.04,50.0,63000,4,9050,0,0,0,0,0,0,0,63000,-63000,-63000
20200316,048676,和鑫國泰94購02,0.02,0.02,0.02,0.02,0.00,0.00,10000,1,200,0,0,0,0,0,0,0,10000,-10000,-10000
20200316,048677,智伸科國泰94購01,0.05,0.05,0.05,0.05,0.00,0.00,12000,2,600,0,0,0,0,0,0,12000,0,12000,12000
20200316,048678,統一富邦93購01,,,,,0.00,0.00,0,0,0,0,0,0,0,0,0,0,0,0,0
20200316,048679,大成鋼富邦93購01,,,,,0.00,0.00,0,0,0,0,0,0,0,0,0,0,0,0,0
20200316,04867P,美律統一94售03,,,,,0.00,0.00,0,0,0,0,0,0,0,0,0,0,0,0,0
20200316,048680,智邦富邦93購02,,,,,0.00,0.00,0,0,0,0,0,0,0,0,0,0,0,0,0
20200316,048681,漢唐富邦96購01,,,,,0.00,0.00,0,0,0,0,0,0,0,0,0,0,0,0,0
20200316,048682,奇力新富邦96購01,,,,,0.00,0.00,0,0,0,0,0,0,0,0,0,0,0,0,0
20200316,048683,日月光富邦93購01,,,,,0.00,0.00,0,0,0,0,0,0,0,0,0,0,0,0,0
20200316,048684,上海銀富邦93購02,,,,,0.00,0.00,0,0,0,0,0,0,0,0,0,0,0,0,0
20200316,048685,T50反1第一94購01,,,,,0.00,0.00,0,0,0,0,0,0,0,0,0,0,0,0,0
20200316,048686,滬深2X中信95購09,0.12,0.12,0.12,0.12,0.00,0.00,20000,1,2400,0,0,0,0,0,0,0,20000,-20000,-20000
20200316,048687,旺宏群益96購01,0.27,0.27,0.24,0.24,-0.04,-14.29,30000,3,7500,0,0,0,0,0,0,0,30000,-30000,-30000
20200316,048688,瑞昱群益94購01,,,,,0.00,0.00,0,0,0,0,0,0,0,0,0,0,0,0,0
20200316,048689,台光電群益94購01,,,,,0.00,0.00,0,0,0,0,0,0,0,0,0,0,0,0,0
20200316,04868P,可成統一94售03,,,,,0.00,0.00,0,0,0,0,0,0,0,0,0,0,0,0,0
20200316,048690,美律群益94購01,,,,,0.00,0.00,0,0,0,0,0,0,0,0,0,0,0,0,0
20200316,048691,智伸科群益94購01,,,,,0.00,0.00,0,0,0,0,0,0,0,0,0,0,0,0,0
20200316,048692,致伸群益94購01,,,,,0.00,0.00,0,0,0,0,0,0,0,0,0,0,0,0,0
20200316,048693,GIS群益94購02,,,,,0.00,0.00,0,0,0,0,0,0,0,0,0,0,0,0,0
20200316,048694,緯穎群益94購01,8.40,8.40,8.25,8.40,+3.43,69.01,80000,5,669000,0,0,0,0,0,0,80000,0,80000,80000
20200316,048695,滬深2X國票95購03,,,,,0.00,0.00,0,0,0,0,0,0,0,0,0,0,0,0,0
20200316,048696,台達電國票96購01,0.55,0.55,0.55,0.55,-0.05,-8.33,83000,2,45650,0,0,0,0,0,0,83000,0,83000,83000
20200316,048697,華新科國票94購06,,,,,0.00,0.00,0,0,0,0,0,0,0,0,0,0,0,0,0
20200316,048698,宏達電國票95購01,,,,,0.00,0.00,0,0,0,0,0,0,0,0,0,0,0,0,0
20200316,048699,嘉晶國票95購01,1.16,1.16,1.16,1.16,+0.76,190.0,136000,1,157760,0,0,0,0,0,0,136000,0,136000,136000
20200316,04869P,鴻海元富95售02,1.87,2.12,1.87,2.12,-0.17,-7.42,50000,7,98530,0,0,0,0,0,0,30000,20000,10000,10000
20200316,048700,和鑫國票95購01,,,,,0.00,0.00,0,0,0,0,0,0,0,0,0,0,0,0,0
20200316,048701,健策國票95購01,,,,,0.00,0.00,0,0,0,0,0,0,0,0,0,0,0,0,0
20200316,048702,正文國票95購01,,,,,0.00,0.00,0,0,0,0,0,0,0,0,0,0,0,0,0
20200316,048703,康控國票95購01,,,,,0.00,0.00,0,0,0,0,0,0,0,0,0,0,0,0,0
20200316,048704,台表科國票95購01,0.11,0.11,0.11,0.11,-0.17,-60.71,20000,1,2200,0,0,0,0,0,0,20000,0,20000,20000
20200316,048705,GIS國票95購01,,,,,0.00,0.00,0,0,0,0,0,0,0,0,0,0,0,0,0
20200316,048706,緯穎國票94購01,11.90,11.90,11.70,11.70,+6.35,118.69,60000,2,706000,0,0,0,0,0,0,60000,0,60000,60000
20200316,048707,南電國票95購01,,,,,0.00,0.00,0,0,0,0,0,0,0,0,0,0,0,0,0
20200316,048708,智邦亞東94購01,,,,,0.00,0.00,0,0,0,0,0,0,0,0,0,0,0,0,0
20200316,048709,瑞昱亞東94購01,,,,,0.00,0.00,0,0,0,0,0,0,0,0,0,0,0,0,0
20200316,04870P,大立光元富94售11,2.41,2.41,2.41,2.41,0.00,0.00,1000,1,2410,0,0,0,0,0,0,0,1000,-1000,-1000
20200316,048710,奇力新台新94購01,0.89,0.89,0.24,0.24,+0.03,14.29,15000,3,8450,0,0,0,0,0,0,15000,0,15000,15000
20200316,048711,台郡台新94購01,,,,,0.00,0.00,0,0,0,0,0,0,0,0,0,0,0,0,0
20200316,048712,樺漢台新94購01,,,,,0.00,0.00,0,0,0,0,0,0,0,0,0,0,0,0,0
20200316,048713,美利達康和94購01,,,,,0.00,0.00,0,0,0,0,0,0,0,0,0,0,0,0,0
20200316,048714,巨大康和94購01,,,,,0.00,0.00,0,0,0,0,0,0,0,0,0,0,0,0,0
20200316,048715,A50正2永豐94購01,,,,,0.00,0.00,0,0,0,0,0,0,0,0,0,0,0,0,0
20200316,048716,力山永豐94購01,,,,,0.00,0.00,0,0,0,0,0,0,0,0,0,0,0,0,0
20200316,048717,鴻海永豐94購02,,,,,0.00,0.00,0,0,0,0,0,0,0,0,0,0,0,0,0
20200316,048718,台光電永豐94購01,,,,,0.00,0.00,0,0,0,0,0,0,0,0,0,0,0,0,0
20200316,048719,亞光永豐94購01,,,,,0.00,0.00,0,0,0,0,0,0,0,0,0,0,0,0,0
20200316,04871P,力成元富94售02,,,,,0.00,0.00,0,0,0,0,0,0,0,0,0,0,0,0,0
20200316,048720,智易永豐94購02,,,,,0.00,0.00,0,0,0,0,0,0,0,0,0,0,0,0,0
20200316,048721,正文永豐94購01,,,,,0.00,0.00,0,0,0,0,0,0,0,0,0,0,0,0,0
20200316,048722,台表科永豐94購01,0.04,0.04,0.04,0.04,+0.01,33.33,30000,1,1200,0,0,0,0,0,0,30000,0,30000,30000
20200316,048723,世紀鋼永豐94購02,0.28,0.28,0.28,0.28,+0.18,180.0,6000,1,1680,0,0,0,0,0,0,6000,0,6000,6000
20200316,048724,台達電日盛94購01,,,,,0.00,0.00,0,0,0,0,0,0,0,0,0,0,0,0,0
20200316,048725,京元電日盛94購01,,,,,0.00,0.00,0,0,0,0,0,0,0,0,0,0,0,0,0
20200316,048726,儒鴻麥證95購01,,,,,0.00,0.00,0,0,0,0,0,0,0,0,0,0,0,0,0
20200316,048727,大成鋼麥證94購01,,,,,0.00,0.00,0,0,0,0,0,0,0,0,0,0,0,0,0
20200316,048728,台達電麥證94購01,,,,,0.00,0.00,0,0,0,0,0,0,0,0,0,0,0,0,0
20200316,048729,鴻海麥證94購01,0.18,0.18,0.18,0.18,+0.03,20.0,10000,1,1800,10000,0,10000,0,0,0,10000,0,10000,10000
20200316,04872P,高股息中信94售01,,,,,0.00,0.00,0,0,0,0,0,0,0,0,0,0,0,0,0
20200316,048730,智原麥證94購01,,,,,0.00,0.00,0,0,0,0,0,0,0,0,0,0,0,0,0
20200316,048731,創意麥證94購01,,,,,0.00,0.00,0,0,0,0,0,0,0,0,0,0,0,0,0
20200316,048732,台勝科麥證95購01,1.93,2.02,1.82,1.90,-0.14,-6.86,43000,9,83240,25000,16000,9000,0,0,0,25000,16000,9000,9000
20200316,048733,台勝科麥證95購02,2.66,2.91,2.39,2.46,-0.39,-13.68,286000,24,740250,232000,53000,179000,0,0,0,232000,53000,179000,179000
20200316,048734,美利達麥證94購01,,,,,0.00,0.00,0,0,0,0,0,0,0,0,0,0,0,0,0
20200316,048735,美利達麥證95購01,,,,,0.00,0.00,0,0,0,0,0,0,0,0,0,0,0,0,0
20200316,048736,台達電統一94購01,,,,,0.00,0.00,0,0,0,0,0,0,0,0,0,0,0,0,0
20200316,048737,國巨統一94購03,,,,,0.00,0.00,0,0,0,0,0,0,0,0,0,0,0,0,0
20200316,048738,台積電統一94購04,2.31,2.31,2.31,2.31,-0.30,-11.49,10000,1,23100,0,0,0,0,0,0,10000,0,10000,10000
20200316,048739,華新科統一94購02,,,,,0.00,0.00,0,0,0,0,0,0,0,0,0,0,0,0,0
20200316,048740,富邦金統一94購01,,,,,0.00,0.00,0,0,0,0,0,0,0,0,0,0,0,0,0
20200316,048741,欣興統一94購02,,,,,0.00,0.00,0,0,0,0,0,0,0,0,0,0,0,0,0
20200316,048742,瀚宇博統一94購01,,,,,0.00,0.00,0,0,0,0,0,0,0,0,0,0,0,0,0
20200316,048743,美利達統一94購01,,,,,0.00,0.00,0,0,0,0,0,0,0,0,0,0,0,0,0
20200316,048744,儒鴻元富97購01,0.04,0.04,0.03,0.04,0.00,0.00,363000,29,13520,0,0,0,0,0,0,0,263000,-263000,-263000
20200316,048745,儒鴻元富97購02,0.06,0.09,0.06,0.09,-0.01,-10.0,94000,7,6240,0,0,0,0,0,0,0,0,0,0
20200316,048746,台達電元富94購01,,,,,0.00,0.00,0,0,0,0,0,0,0,0,0,0,0,0,0
20200316,048747,華通元富97購01,,,,,0.00,0.00,0,0,0,0,0,0,0,0,0,0,0,0,0
20200316,048748,國巨元富96購01,2.09,2.21,1.58,1.58,-0.35,-18.13,178000,11,355590,0,0,0,0,0,0,151000,24000,127000,127000
20200316,048749,京元電元富94購02,,,,,0.00,0.00,0,0,0,0,0,0,0,0,0,0,0,0,0
20200316,04874P,高股息中信97售01,,,,,0.00,0.00,0,0,0,0,0,0,0,0,0,0,0,0,0
20200316,048750,智原元富94購01,,,,,0.00,0.00,0,0,0,0,0,0,0,0,0,0,0,0,0
20200316,048751,京鼎元富96購01,,,,,0.00,0.00,0,0,0,0,0,0,0,0,0,0,0,0,0
20200316,048752,廣越元富95購01,,,,,0.00,0.00,0,0,0,0,0,0,0,0,0,0,0,0,0
20200316,048753,智伸科元富94購01,,,,,0.00,0.00,0,0,0,0,0,0,0,0,0,0,0,0,0
20200316,048754,瀚宇博元富97購01,,,,,0.00,0.00,0,0,0,0,0,0,0,0,0,0,0,0,0
20200316,048755,志超元富96購01,0.20,0.20,0.20,0.20,+0.02,11.11,10000,1,2000,0,0,0,0,0,0,0,10000,-10000,-10000
20200316,048756,志超元富96購02,,,,,0.00,0.00,0,0,0,0,0,0,0,0,0,0,0,0,0
20200316,048757,美利達元富96購01,0.11,0.11,0.11,0.11,-0.03,-21.43,20000,2,2200,0,0,0,0,0,0,0,20000,-20000,-20000
20200316,048758,美利達元富96購02,,,,,0.00,0.00,0,0,0,0,0,0,0,0,0,0,0,0,0
20200316,048759,巨大元富96購01,,,,,0.00,0.00,0,0,0,0,0,0,0,0,0,0,0,0,0
20200316,04875P,台積電中信94售04,0.43,0.64,0.43,0.63,+0.04,6.78,66000,5,34860,0,0,0,0,0,0,56000,0,56000,56000
20200316,048760,S&P反1凱基94購01,1.01,1.07,1.01,1.07,-0.28,-20.74,105000,11,106950,0,0,0,0,0,0,0,105000,-105000,-105000
20200316,048761,力山凱基94購01,,,,,0.00,0.00,0,0,0,0,0,0,0,0,0,0,0,0,0
20200316,048762,寶齡凱基94購01,,,,,0.00,0.00,0,0,0,0,0,0,0,0,0,0,0,0,0
20200316,048763,台積電凱基94購03,,,,,0.00,0.00,0,0,0,0,0,0,0,0,0,0,0,0,0
20200316,048764,台光電凱基94購03,,,,,0.00,0.00,0,0,0,0,0,0,0,0,0,0,0,0,0
20200316,048765,奇力新凱基94購01,,,,,0.00,0.00,0,0,0,0,0,0,0,0,0,0,0,0,0
20200316,048766,禾伸堂凱基94購01,0.70,0.70,0.70,0.70,-0.04,-5.41,10000,1,7000,0,0,0,0,0,0,0,10000,-10000,-10000
20200316,048767,欣興凱基94購01,,,,,0.00,0.00,0,0,0,0,0,0,0,0,0,0,0,0,0
20200316,048768,景碩凱基94購02,,,,,0.00,0.00,0,0,0,0,0,0,0,0,0,0,0,0,0
20200316,048769,聯鈞凱基94購01,0.76,0.82,0.63,0.63,-0.16,-20.25,31000,9,24300,0,0,0,0,0,0,26000,5000,21000,21000
20200316,04876P,台光電中信94售02,0.81,0.81,0.81,0.81,-0.04,-4.71,1000,1,810,0,0,0,0,0,0,1000,0,1000,1000
20200316,048770,揚明光凱基94購01,,,,,0.00,0.00,0,0,0,0,0,0,0,0,0,0,0,0,0
20200316,048771,嘉澤凱基94購01,,,,,0.00,0.00,0,0,0,0,0,0,0,0,0,0,0,0,0
20200316,048772,智易凱基94購01,,,,,0.00,0.00,0,0,0,0,0,0,0,0,0,0,0,0,0
20200316,048773,貿聯凱基94購01,,,,,0.00,0.00,0,0,0,0,0,0,0,0,0,0,0,0,0
20200316,048774,麗豐凱基94購04,,,,,0.00,0.00,0,0,0,0,0,0,0,0,0,0,0,0,0
20200316,048775,智伸科凱基94購01,,,,,0.00,0.00,0,0,0,0,0,0,0,0,0,0,0,0,0
20200316,048776,正文凱基94購01,,,,,0.00,0.00,0,0,0,0,0,0,0,0,0,0,0,0,0
20200316,048777,瀚宇博凱基94購02,,,,,0.00,0.00,0,0,0,0,0,0,0,0,0,0,0,0,0
20200316,048778,聯茂凱基94購04,,,,,0.00,0.00,0,0,0,0,0,0,0,0,0,0,0,0,0
20200316,048779,美利達凱基94購01,,,,,0.00,0.00,0,0,0,0,0,0,0,0,0,0,0,0,0
20200316,04877P,聯發科麥證94售04,0.99,1.12,0.99,1.12,+0.07,6.67,20000,3,21150,10000,10000,0,0,0,0,10000,10000,0,0
20200316,048780,臺股指凱基94購03,,,,,0.00,0.00,0,0,0,0,0,0,0,0,0,0,0,0,0
20200316,048781,臺股指凱基96購01,,,,,0.00,0.00,0,0,0,0,0,0,0,0,0,0,0,0,0
20200316,048782,亞泥元大94購01,0.05,0.05,0.05,0.05,-0.02,-28.57,24000,3,1200,0,0,0,0,0,0,10000,10000,0,0
20200316,048783,國巨元大94購01,4.92,5.70,2.57,2.57,-2.73,-51.51,60000,4,271700,0,0,0,0,0,0,60000,10000,50000,50000
20200316,048784,台積電元大94購04,0.25,0.25,0.25,0.25,+0.17,212.5,4000,1,1000,0,0,0,0,0,0,0,0,0,0
20200316,048785,台積電元大96購01,2.87,2.98,2.03,2.15,-1.05,-32.81,494000,89,1178970,0,0,0,0,0,0,77000,338000,-261000,-261000
20200316,048786,瑞昱元大94購02,0.03,0.03,0.03,0.03,-0.02,-40.0,10000,1,300,0,0,0,0,0,0,10000,0,10000,10000
20200316,048787,義隆元大94購02,,,,,0.00,0.00,0,0,0,0,0,0,0,0,0,0,0,0,0
20200316,048788,華新科元大95購02,0.83,0.91,0.46,0.46,-0.33,-41.77,204000,22,152770,0,0,0,0,0,0,42000,172000,-130000,-130000
20200316,048789,大立光元大95購04,0.20,0.20,0.20,0.20,+0.04,25.0,1000,1,200,0,0,0,0,0,0,1000,1000,0,0
20200316,04878P,國巨康和94售02,0.51,0.64,0.51,0.64,0.00,0.00,98000,4,51110,0,0,0,0,0,0,0,98000,-98000,-98000
20200316,048790,大立光元大95購05,0.32,0.32,0.32,0.32,0.00,0.00,1000,1,320,0,0,0,0,0,0,1000,1000,0,0
20200316,048791,智原元大94購02,,,,,0.00,0.00,0,0,0,0,0,0,0,0,0,0,0,0,0
20200316,048792,瑞儀元大94購01,,,,,0.00,0.00,0,0,0,0,0,0,0,0,0,0,0,0,0
20200316,048793,超眾元大95購02,,,,,0.00,0.00,0,0,0,0,0,0,0,0,0,0,0,0,0
20200316,048794,易華電元大97購01,,,,,0.00,0.00,0,0,0,0,0,0,0,0,0,0,0,0,0
20200316,048795,復盛元大94購01,,,,,0.00,0.00,0,0,0,0,0,0,0,0,0,0,0,0,0
20200316,048796,國巨國泰95購02,,,,,0.00,0.00,0,0,0,0,0,0,0,0,0,0,0,0,0
20200316,048797,美律國泰95購02,0.28,0.28,0.24,0.24,+0.13,118.18,60000,3,15200,0,0,0,0,0,0,0,60000,-60000,-60000
20200316,048798,華新科國泰95購01,,,,,0.00,0.00,0,0,0,0,0,0,0,0,0,0,0,0,0
20200316,048799,台積電富邦94購03,,,,,0.00,0.00,0,0,0,0,0,0,0,0,0,0,0,0,0
20200316,04879P,康控永豐94售02,,,,,0.00,0.00,0,0,0,0,0,0,0,0,0,0,0,0,0
20200316,048800,瑞昱富邦94購01,,,,,0.00,0.00,0,0,0,0,0,0,0,0,0,0,0,0,0
20200316,048801,漢唐富邦96購02,,,,,0.00,0.00,0,0,0,0,0,0,0,0,0,0,0,0,0
20200316,048802,聯發科富邦94購03,,,,,0.00,0.00,0,0,0,0,0,0,0,0,0,0,0,0,0
20200316,048803,大立光富邦96購01,,,,,0.00,0.00,0,0,0,0,0,0,0,0,0,0,0,0,0
20200316,048804,和碩富邦94購01,,,,,0.00,0.00,0,0,0,0,0,0,0,0,0,0,0,0,0
20200316,048805,瀚宇博富邦95購01,,,,,0.00,0.00,0,0,0,0,0,0,0,0,0,0,0,0,0
20200316,048806,光磊中信94購01,,,,,0.00,0.00,0,0,0,0,0,0,0,0,0,0,0,0,0
20200316,048807,崇越中信94購01,,,,,0.00,0.00,0,0,0,0,0,0,0,0,0,0,0,0,0
20200316,048808,美律亞東94購01,,,,,0.00,0.00,0,0,0,0,0,0,0,0,0,0,0,0,0
20200316,048809,創意亞東94購01,,,,,0.00,0.00,0,0,0,0,0,0,0,0,0,0,0,0,0
20200316,04880P,GIS永豐94售02,,,,,0.00,0.00,0,0,0,0,0,0,0,0,0,0,0,0,0
20200316,048810,玉晶光第一94購01,,,,,0.00,0.00,0,0,0,0,0,0,0,0,0,0,0,0,0
20200316,048811,鴻海日盛94購01,0.12,0.13,0.04,0.12,+0.01,9.09,159000,12,17590,0,0,0,0,0,0,149000,70000,79000,79000
20200316,048812,上証2X凱基96購01,,,,,0.00,0.00,0,0,0,0,0,0,0,0,0,0,0,0,0
20200316,048813,元黃金凱基94購01,0.04,0.04,0.04,0.04,0.00,0.00,4000,1,160,0,0,0,0,0,0,4000,0,4000,4000
20200316,048814,上銀凱基94購01,,,,,0.00,0.00,0,0,0,0,0,0,0,0,0,0,0,0,0
20200316,048815,川湖凱基94購01,,,,,0.00,0.00,0,0,0,0,0,0,0,0,0,0,0,0,0
20200316,048816,光寶科凱基94購01,,,,,0.00,0.00,0,0,0,0,0,0,0,0,0,0,0,0,0
20200316,048817,光寶科凱基94購02,,,,,0.00,0.00,0,0,0,0,0,0,0,0,0,0,0,0,0
20200316,048818,台達電凱基94購01,,,,,0.00,0.00,0,0,0,0,0,0,0,0,0,0,0,0,0
20200316,048819,國巨凱基94購01,3.57,4.04,1.97,2.08,-1.53,-42.38,140000,10,461500,0,0,0,0,0,0,70000,70000,0,0
20200316,04881P,高股息凱基96售01,1.65,2.20,1.63,2.20,+0.50,29.41,925000,64,1726970,0,0,0,0,0,0,860000,911000,-51000,-51000
20200316,048820,台積電凱基94購06,0.92,0.95,0.34,0.34,-0.26,-43.33,63000,9,32570,0,0,0,0,0,0,52000,53000,-1000,-1000
20200316,048821,光磊凱基95購01,,,,,0.00,0.00,0,0,0,0,0,0,0,0,0,0,0,0,0
20200316,048822,燿華凱基94購03,,,,,0.00,0.00,0,0,0,0,0,0,0,0,0,0,0,0,0
20200316,048823,漢唐凱基94購01,,,,,0.00,0.00,0,0,0,0,0,0,0,0,0,0,0,0,0
20200316,048824,聯發科凱基94購03,,,,,0.00,0.00,0,0,0,0,0,0,0,0,0,0,0,0,0
20200316,048825,華新科凱基94購05,,,,,0.00,0.00,0,0,0,0,0,0,0,0,0,0,0,0,0
20200316,048826,宏達電凱基94購01,,,,,0.00,0.00,0,0,0,0,0,0,0,0,0,0,0,0,0
20200316,048827,大立光凱基94購01,,,,,0.00,0.00,0,0,0,0,0,0,0,0,0,0,0,0,0
20200316,048828,禾伸堂凱基94購02,,,,,0.00,0.00,0,0,0,0,0,0,0,0,0,0,0,0,0
20200316,048829,欣興凱基94購02,,,,,0.00,0.00,0,0,0,0,0,0,0,0,0,0,0,0,0
20200316,04882P,鴻海凱基94售19,3.09,3.26,3.09,3.26,+0.74,29.37,20000,2,63500,0,0,0,0,0,0,0,20000,-20000,-20000
20200316,048830,和鑫凱基94購03,,,,,0.00,0.00,0,0,0,0,0,0,0,0,0,0,0,0,0
20200316,048831,玉晶光凱基95購01,1.14,1.24,0.67,0.75,-0.44,-36.97,602000,30,594690,0,0,0,0,0,0,519000,161000,358000,358000
20200316,048832,玉晶光凱基95購02,0.84,0.91,0.72,0.72,-0.03,-4.0,35000,4,28390,0,0,0,0,0,0,25000,15000,10000,10000
20200316,048833,揚明光凱基94購02,,,,,0.00,0.00,0,0,0,0,0,0,0,0,0,0,0,0,0
20200316,048834,牧德凱基94購01,0.17,0.17,0.17,0.17,0.00,0.00,10000,1,1700,0,0,0,0,0,0,10000,0,10000,10000
20200316,048835,牧德凱基94購02,,,,,0.00,0.00,0,0,0,0,0,0,0,0,0,0,0,0,0
20200316,048836,牧德凱基94購03,0.06,0.06,0.06,0.06,0.00,0.00,30000,1,1800,0,0,0,0,0,0,30000,0,30000,30000
20200316,048837,牧德凱基94購04,,,,,0.00,0.00,0,0,0,0,0,0,0,0,0,0,0,0,0
20200316,048838,牧德凱基94購07,0.60,0.60,0.60,0.60,-0.02,-3.23,10000,1,6000,0,0,0,0,0,0,10000,0,10000,10000
20200316,048839,牧德凱基95購01,,,,,0.00,0.00,0,0,0,0,0,0,0,0,0,0,0,0,0
20200316,04883P,台積電凱基94售35,,,,,0.00,0.00,0,0,0,0,0,0,0,0,0,0,0,0,0
20200316,048840,上海銀凱基94購02,,,,,0.00,0.00,0,0,0,0,0,0,0,0,0,0,0,0,0
20200316,048841,聯茂凱基94購06,,,,,0.00,0.00,0,0,0,0,0,0,0,0,0,0,0,0,0
20200316,048842,矽格凱基94購01,0.23,0.23,0.23,0.23,+0.06,35.29,10000,1,2300,0,0,0,0,0,0,10000,0,10000,10000
20200316,048843,台郡凱基94購01,,,,,0.00,0.00,0,0,0,0,0,0,0,0,0,0,0,0,0
20200316,048844,訊芯凱基94購02,,,,,0.00,0.00,0,0,0,0,0,0,0,0,0,0,0,0,0
20200316,048845,GIS凱基94購02,,,,,0.00,0.00,0,0,0,0,0,0,0,0,0,0,0,0,0
20200316,048846,緯穎凱基94購01,,,,,0.00,0.00,0,0,0,0,0,0,0,0,0,0,0,0,0
20200316,048847,A50群益98購01,0.38,0.38,0.31,0.31,-0.13,-29.55,127000,4,39700,0,0,0,0,0,0,0,127000,-127000,-127000
20200316,048848,滬深2X群益98購02,0.63,0.65,0.60,0.60,-0.12,-16.67,87000,13,53240,0,0,0,0,0,0,20000,77000,-57000,-57000
20200316,048849,光寶科群益94購01,,,,,0.00,0.00,0,0,0,0,0,0,0,0,0,0,0,0,0
20200316,04884P,聯發科凱基94售20,0.14,0.39,0.14,0.39,+0.09,30.0,153000,11,31650,0,0,0,0,0,0,108000,45000,63000,63000
20200316,048850,聯電群益96購01,,,,,0.00,0.00,0,0,0,0,0,0,0,0,0,0,0,0,0
20200316,048851,台達電群益94購01,,,,,0.00,0.00,0,0,0,0,0,0,0,0,0,0,0,0,0
20200316,048852,旺宏群益96購02,0.79,0.79,0.50,0.50,-0.24,-32.43,197000,9,121170,0,0,0,0,0,0,105000,97000,8000,8000
20200316,048853,凌陽群益94購01,,,,,0.00,0.00,0,0,0,0,0,0,0,0,0,0,0,0,0
20200316,048854,凌陽群益94購02,,,,,0.00,0.00,0,0,0,0,0,0,0,0,0,0,0,0,0
20200316,048855,華新科群益94購02,,,,,0.00,0.00,0,0,0,0,0,0,0,0,0,0,0,0,0
20200316,048856,高鐵群益94購01,,,,,0.00,0.00,0,0,0,0,0,0,0,0,0,0,0,0,0
20200316,048857,晶豪科群益94購01,,,,,0.00,0.00,0,0,0,0,0,0,0,0,0,0,0,0,0
20200316,048858,大立光群益94購03,,,,,0.00,0.00,0,0,0,0,0,0,0,0,0,0,0,0,0
20200316,048859,玉晶光群益96購02,0.64,0.64,0.60,0.60,+0.01,1.69,10000,2,6200,0,0,0,0,0,0,0,10000,-10000,-10000
20200316,04885P,大立光凱基94售19,0.52,0.70,0.52,0.70,-0.54,-43.55,389000,8,214640,0,0,0,0,0,0,162000,377000,-215000,-215000
20200316,048860,玉晶光群益96購03,0.68,0.68,0.42,0.42,-0.26,-38.24,36000,3,19380,0,0,0,0,0,0,26000,11000,15000,15000
20200316,048861,牧德群益94購01,,,,,0.00,0.00,0,0,0,0,0,0,0,0,0,0,0,0,0
20200316,048862,中磊群益94購01,,,,,0.00,0.00,0,0,0,0,0,0,0,0,0,0,0,0,0
20200316,048863,超眾群益94購01,,,,,0.00,0.00,0,0,0,0,0,0,0,0,0,0,0,0,0
20200316,048864,昇陽半群益94購01,,,,,0.00,0.00,0,0,0,0,0,0,0,0,0,0,0,0,0
20200316,048865,世紀鋼群益94購01,,,,,0.00,0.00,0,0,0,0,0,0,0,0,0,0,0,0,0
20200316,048866,滬深2X兆豐95購01,,,,,0.00,0.00,0,0,0,0,0,0,0,0,0,0,0,0,0
20200316,048867,台積電兆豐95購01,0.74,0.74,0.37,0.37,-0.43,-53.75,777000,86,355640,0,0,0,0,0,0,30000,737000,-707000,-707000
20200316,048868,劍麟國票94購01,,,,,0.00,0.00,0,0,0,0,0,0,0,0,0,0,0,0,0
20200316,048869,光罩國票94購01,,,,,0.00,0.00,0,0,0,0,0,0,0,0,0,0,0,0,0
20200316,04886P,臺股指凱基94售20,,,,,0.00,0.00,0,0,0,0,0,0,0,0,0,0,0,0,0
20200316,048870,義隆國票96購01,,,,,0.00,0.00,0,0,0,0,0,0,0,0,0,0,0,0,0
20200316,048871,晶豪科國票94購01,,,,,0.00,0.00,0,0,0,0,0,0,0,0,0,0,0,0,0
20200316,048872,玉晶光國票94購02,0.07,0.10,0.07,0.10,+0.03,42.86,10000,3,850,0,0,0,0,0,0,0,0,0,0
20200316,048873,玉晶光國票95購02,0.75,0.75,0.35,0.35,-0.25,-41.67,58000,9,21420,0,0,0,0,0,0,8000,52000,-44000,-44000
20200316,048874,玉晶光國票96購01,0.34,0.34,0.29,0.29,-0.25,-46.3,55000,8,16160,0,0,0,0,0,0,0,55000,-55000,-55000
20200316,048875,晶相光國票94購01,,,,,0.00,0.00,0,0,0,0,0,0,0,0,0,0,0,0,0
20200316,048876,牧德國票95購02,0.12,0.12,0.08,0.08,0.00,0.00,30000,4,2750,0,0,0,0,0,0,0,30000,-30000,-30000
20200316,048877,茂林國票94購01,4.42,4.42,3.95,3.95,-0.86,-17.88,79000,8,345870,0,0,0,0,0,0,79000,0,79000,79000
20200316,048878,康控國票95購02,,,,,0.00,0.00,0,0,0,0,0,0,0,0,0,0,0,0,0
20200316,048879,瀚宇博國票95購01,,,,,0.00,0.00,0,0,0,0,0,0,0,0,0,0,0,0,0
20200316,04887P,臺股指凱基94售21,,,,,0.00,0.00,0,0,0,0,0,0,0,0,0,0,0,0,0
20200316,048880,昇陽半國票94購01,,,,,0.00,0.00,0,0,0,0,0,0,0,0,0,0,0,0,0
20200316,048881,美律統一94購02,,,,,0.00,0.00,0,0,0,0,0,0,0,0,0,0,0,0,0
20200316,048882,智原統一96購01,,,,,0.00,0.00,0,0,0,0,0,0,0,0,0,0,0,0,0
20200316,048883,玉晶光統一94購01,,,,,0.00,0.00,0,0,0,0,0,0,0,0,0,0,0,0,0
20200316,048884,川湖元富94購01,,,,,0.00,0.00,0,0,0,0,0,0,0,0,0,0,0,0,0
20200316,048885,中環元富94購01,,,,,0.00,0.00,0,0,0,0,0,0,0,0,0,0,0,0,0
20200316,048886,慧洋元富94購01,,,,,0.00,0.00,0,0,0,0,0,0,0,0,0,0,0,0,0
20200316,048887,牧德元富94購01,,,,,0.00,0.00,0,0,0,0,0,0,0,0,0,0,0,0,0
20200316,048888,牧德元富94購02,0.09,0.09,0.09,0.09,0.00,0.00,30000,1,2700,0,0,0,0,0,0,30000,0,30000,30000
20200316,048889,牧德元富94購03,,,,,0.00,0.00,0,0,0,0,0,0,0,0,0,0,0,0,0
20200316,04888P,臺股指凱基95售03,,,,,0.00,0.00,0,0,0,0,0,0,0,0,0,0,0,0,0
20200316,048890,傳奇元富97購01,,,,,0.00,0.00,0,0,0,0,0,0,0,0,0,0,0,0,0
20200316,048891,傳奇元富97購02,,,,,0.00,0.00,0,0,0,0,0,0,0,0,0,0,0,0,0
20200316,048892,台郡元富97購01,1.04,1.04,0.78,0.78,-0.22,-22.0,53000,6,49560,0,0,0,0,0,0,3000,50000,-47000,-47000
20200316,048893,南電元富94購01,0.08,0.08,0.08,0.08,-0.13,-61.9,100000,1,8000,0,0,0,0,0,0,100000,0,100000,100000
20200316,048894,光罩國泰94購01,,,,,0.00,0.00,0,0,0,0,0,0,0,0,0,0,0,0,0
20200316,048895,光罩國泰95購01,0.15,0.15,0.10,0.10,-0.03,-23.08,120000,12,16300,0,0,0,0,0,0,0,120000,-120000,-120000
20200316,048896,凌陽國泰95購01,,,,,0.00,0.00,0,0,0,0,0,0,0,0,0,0,0,0,0
20200316,048897,日電貿國泰95購01,,,,,0.00,0.00,0,0,0,0,0,0,0,0,0,0,0,0,0
20200316,048898,晶相光國泰96購01,0.50,0.53,0.31,0.31,-0.18,-36.73,1328000,20,545150,0,0,0,0,0,0,635000,729000,-94000,-94000
20200316,048899,茂林國泰95購01,2.30,2.35,2.14,2.22,-0.13,-5.53,82000,18,186790,0,0,0,0,0,0,72000,10000,62000,62000
20200316,04889P,華通元大94售03,1.36,1.81,1.36,1.78,+0.19,11.95,70000,13,116700,0,0,0,0,0,0,62000,7000,55000,55000
20200316,048900,精成科國泰95購01,,,,,0.00,0.00,0,0,0,0,0,0,0,0,0,0,0,0,0
20200316,048901,矽格國泰95購01,0.52,0.52,0.52,0.52,-0.09,-14.75,80000,2,41600,0,0,0,0,0,0,80000,0,80000,80000
20200316,048902,昇陽半國泰96購01,0.11,0.11,0.11,0.11,-0.01,-8.33,20000,1,2200,0,0,0,0,0,0,0,20000,-20000,-20000
20200316,048903,華通富邦95購01,0.46,0.47,0.24,0.24,-0.13,-35.14,110000,5,34100,0,0,0,0,0,0,110000,0,110000,110000
20200316,048904,鴻海富邦94購02,,,,,0.00,0.00,0,0,0,0,0,0,0,0,0,0,0,0,0
20200316,048905,旺宏富邦96購01,,,,,0.00,0.00,0,0,0,0,0,0,0,0,0,0,0,0,0
20200316,048906,強茂富邦95購01,,,,,0.00,0.00,0,0,0,0,0,0,0,0,0,0,0,0,0
20200316,048907,高鐵富邦94購01,,,,,0.00,0.00,0,0,0,0,0,0,0,0,0,0,0,0,0
20200316,048908,慧洋富邦95購01,,,,,0.00,0.00,0,0,0,0,0,0,0,0,0,0,0,0,0
20200316,048909,聯詠富邦94購01,,,,,0.00,0.00,0,0,0,0,0,0,0,0,0,0,0,0,0
20200316,04890P,台積電元大95售05,0.25,0.42,0.22,0.42,+0.21,100.0,1688000,156,450660,0,0,0,0,0,0,162000,1476000,-1314000,-1314000
20200316,048910,和鑫富邦98購01,0.14,0.14,0.14,0.14,+0.09,180.0,17000,2,2380,0,0,0,0,0,0,17000,0,17000,17000
20200316,048911,玉晶光富邦96購01,0.40,0.40,0.40,0.40,-0.01,-2.44,15000,2,6000,0,0,0,0,0,0,0,15000,-15000,-15000
20200316,048912,牧德富邦94購01,,,,,0.00,0.00,0,0,0,0,0,0,0,0,0,0,0,0,0
20200316,048913,傳奇富邦94購01,,,,,0.00,0.00,0,0,0,0,0,0,0,0,0,0,0,0,0
20200316,048914,川湖台新94購01,,,,,0.00,0.00,0,0,0,0,0,0,0,0,0,0,0,0,0
20200316,048915,國巨台新94購01,,,,,0.00,0.00,0,0,0,0,0,0,0,0,0,0,0,0,0
20200316,048916,華新科台新94購01,,,,,0.00,0.00,0,0,0,0,0,0,0,0,0,0,0,0,0
20200316,048917,和鑫台新94購01,,,,,0.00,0.00,0,0,0,0,0,0,0,0,0,0,0,0,0
20200316,048918,上証2X永豐94購01,,,,,0.00,0.00,0,0,0,0,0,0,0,0,0,0,0,0,0
20200316,048919,堤維西永豐94購01,,,,,0.00,0.00,0,0,0,0,0,0,0,0,0,0,0,0,0
20200316,04891P,友達元大94售01,0.74,0.77,0.74,0.77,-0.19,-19.79,30000,3,22500,0,0,0,0,0,0,10000,20000,-10000,-10000
20200316,048920,川湖永豐94購01,,,,,0.00,0.00,0,0,0,0,0,0,0,0,0,0,0,0,0
20200316,048921,劍麟永豐94購01,,,,,0.00,0.00,0,0,0,0,0,0,0,0,0,0,0,0,0
20200316,048922,光寶科永豐94購01,,,,,0.00,0.00,0,0,0,0,0,0,0,0,0,0,0,0,0
20200316,048923,國巨永豐94購02,,,,,0.00,0.00,0,0,0,0,0,0,0,0,0,0,0,0,0
20200316,048924,光罩永豐94購01,,,,,0.00,0.00,0,0,0,0,0,0,0,0,0,0,0,0,0
20200316,048925,佳世達永豐94購01,,,,,0.00,0.00,0,0,0,0,0,0,0,0,0,0,0,0,0
20200316,048926,燿華永豐95購01,,,,,0.00,0.00,0,0,0,0,0,0,0,0,0,0,0,0,0
20200316,048927,兆赫永豐94購01,,,,,0.00,0.00,0,0,0,0,0,0,0,0,0,0,0,0,0
20200316,048928,華新科永豐94購02,,,,,0.00,0.00,0,0,0,0,0,0,0,0,0,0,0,0,0
20200316,048929,裕民永豐94購01,,,,,0.00,0.00,0,0,0,0,0,0,0,0,0,0,0,0,0
20200316,04892P,聯發科元大94售14,1.94,2.95,1.94,2.95,+0.85,40.48,76000,12,170310,0,0,0,0,0,0,41000,66000,-25000,-25000
20200316,048930,慧洋永豐94購01,,,,,0.00,0.00,0,0,0,0,0,0,0,0,0,0,0,0,0
20200316,048931,晶華永豐94購01,,,,,0.00,0.00,0,0,0,0,0,0,0,0,0,0,0,0,0
20200316,048932,美食永豐94購01,,,,,0.00,0.00,0,0,0,0,0,0,0,0,0,0,0,0,0
20200316,048933,晶豪科永豐94購01,,,,,0.00,0.00,0,0,0,0,0,0,0,0,0,0,0,0,0
20200316,048934,日電貿永豐94購01,,,,,0.00,0.00,0,0,0,0,0,0,0,0,0,0,0,0,0
20200316,048935,玉晶光永豐94購04,,,,,0.00,0.00,0,0,0,0,0,0,0,0,0,0,0,0,0
20200316,048936,玉晶光永豐94購05,,,,,0.00,0.00,0,0,0,0,0,0,0,0,0,0,0,0,0
20200316,048937,玉晶光永豐95購01,0.23,0.23,0.14,0.14,-0.03,-17.65,553000,16,109700,0,0,0,0,0,0,553000,520000,33000,33000
20200316,048938,玉晶光永豐95購02,,,,,0.00,0.00,0,0,0,0,0,0,0,0,0,0,0,0,0
20200316,048939,華擎永豐94購01,,,,,0.00,0.00,0,0,0,0,0,0,0,0,0,0,0,0,0
20200316,04893P,創意元大94售03,,,,,0.00,0.00,0,0,0,0,0,0,0,0,0,0,0,0,0
20200316,048940,晶相光永豐94購01,,,,,0.00,0.00,0,0,0,0,0,0,0,0,0,0,0,0,0
20200316,048941,牧德永豐94購02,,,,,0.00,0.00,0,0,0,0,0,0,0,0,0,0,0,0,0
20200316,048942,上緯控永豐94購01,,,,,0.00,0.00,0,0,0,0,0,0,0,0,0,0,0,0,0
20200316,048943,智伸科永豐94購01,,,,,0.00,0.00,0,0,0,0,0,0,0,0,0,0,0,0,0
20200316,048944,茂林永豐94購01,0.63,0.81,0.63,0.63,-0.28,-30.77,48000,14,34110,0,0,0,0,0,0,18000,30000,-12000,-12000
20200316,048945,訊連永豐94購01,0.20,0.23,0.11,0.11,-0.08,-42.11,45000,12,8770,0,0,0,0,0,0,40000,5000,35000,35000
20200316,048946,崇越永豐94購01,,,,,0.00,0.00,0,0,0,0,0,0,0,0,0,0,0,0,0
20200316,048947,凌華永豐94購01,,,,,0.00,0.00,0,0,0,0,0,0,0,0,0,0,0,0,0
20200316,048948,巨路永豐94購01,,,,,0.00,0.00,0,0,0,0,0,0,0,0,0,0,0,0,0
20200316,048949,昇陽半永豐94購01,,,,,0.00,0.00,0,0,0,0,0,0,0,0,0,0,0,0,0
20200316,04894P,世紀鋼元大94售02,0.22,0.22,0.19,0.19,-0.06,-24.0,100000,7,20250,0,0,0,0,0,0,50000,50000,0,0
20200316,048950,達方永豐94購01,,,,,0.00,0.00,0,0,0,0,0,0,0,0,0,0,0,0,0
20200316,048951,宏全永豐94購01,,,,,0.00,0.00,0,0,0,0,0,0,0,0,0,0,0,0,0
20200316,048952,川湖康和94購01,,,,,0.00,0.00,0,0,0,0,0,0,0,0,0,0,0,0,0
20200316,048953,佳世達康和94購01,,,,,0.00,0.00,0,0,0,0,0,0,0,0,0,0,0,0,0
20200316,048954,裕民康和94購01,,,,,0.00,0.00,0,0,0,0,0,0,0,0,0,0,0,0,0
20200316,048955,慧洋康和94購01,,,,,0.00,0.00,0,0,0,0,0,0,0,0,0,0,0,0,0
20200316,048956,美食康和94購01,,,,,0.00,0.00,0,0,0,0,0,0,0,0,0,0,0,0,0
20200316,048957,玉晶光康和94購01,,,,,0.00,0.00,0,0,0,0,0,0,0,0,0,0,0,0,0
20200316,048958,傳奇康和95購01,,,,,0.00,0.00,0,0,0,0,0,0,0,0,0,0,0,0,0
20200316,048959,凌華康和94購01,0.56,0.56,0.56,0.56,0.00,0.00,50000,1,28000,0,0,0,0,0,0,50000,0,50000,50000
20200316,048960,矽格康和94購01,,,,,0.00,0.00,0,0,0,0,0,0,0,0,0,0,0,0,0
20200316,048961,矽創康和94購01,,,,,0.00,0.00,0,0,0,0,0,0,0,0,0,0,0,0,0
20200316,048962,宏全康和94購01,,,,,0.00,0.00,0,0,0,0,0,0,0,0,0,0,0,0,0
20200316,048963,川湖元大94購01,0.14,0.14,0.14,0.14,-0.05,-26.32,10000,1,1400,0,0,0,0,0,0,10000,0,10000,10000
20200316,048964,劍麟元大94購01,,,,,0.00,0.00,0,0,0,0,0,0,0,0,0,0,0,0,0
20200316,048965,佳世達元大94購01,,,,,0.00,0.00,0,0,0,0,0,0,0,0,0,0,0,0,0
20200316,048966,佳世達元大95購01,,,,,0.00,0.00,0,0,0,0,0,0,0,0,0,0,0,0,0
20200316,048967,凌陽元大95購01,,,,,0.00,0.00,0,0,0,0,0,0,0,0,0,0,0,0,0
20200316,048968,可成元大94購02,,,,,0.00,0.00,0,0,0,0,0,0,0,0,0,0,0,0,0
20200316,048969,兆赫元大94購01,,,,,0.00,0.00,0,0,0,0,0,0,0,0,0,0,0,0,0
20200316,04896P,上証2X中信95售01,1.76,1.89,1.74,1.89,-0.23,-10.85,48000,4,85480,0,0,0,0,0,0,28000,20000,8000,8000
20200316,048970,裕民元大94購01,,,,,0.00,0.00,0,0,0,0,0,0,0,0,0,0,0,0,0
20200316,048971,美食元大94購01,,,,,0.00,0.00,0,0,0,0,0,0,0,0,0,0,0,0,0
20200316,048972,晶豪科元大94購01,0.40,0.45,0.29,0.31,-0.08,-20.51,1180000,62,418250,0,0,0,0,0,0,590000,590000,0,0
20200316,048973,禾伸堂元大94購01,,,,,0.00,0.00,0,0,0,0,0,0,0,0,0,0,0,0,0
20200316,048974,日電貿元大94購01,,,,,0.00,0.00,0,0,0,0,0,0,0,0,0,0,0,0,0
20200316,048975,玉晶光元大94購03,0.56,0.74,0.53,0.54,-0.16,-22.86,161000,21,90100,0,0,0,0,0,0,26000,141000,-115000,-115000
20200316,048976,華擎元大94購01,4.91,4.91,4.71,4.71,+0.98,26.27,13000,2,61830,0,0,0,0,0,0,13000,0,13000,13000
20200316,048977,晶相光元大94購01,,,,,0.00,0.00,0,0,0,0,0,0,0,0,0,0,0,0,0
20200316,048978,晶相光元大94購02,,,,,0.00,0.00,0,0,0,0,0,0,0,0,0,0,0,0,0
20200316,048979,晶相光元大94購03,0.25,0.25,0.25,0.25,-0.01,-3.85,40000,4,10000,0,0,0,0,0,0,10000,30000,-20000,-20000
20200316,04897P,喬山中信94售01,1.46,1.46,1.42,1.42,-0.25,-14.97,39000,4,56280,0,0,0,0,0,0,39000,0,39000,39000
20200316,048980,嘉澤元大94購02,,,,,0.00,0.00,0,0,0,0,0,0,0,0,0,0,0,0,0
20200316,048981,牧德元大94購01,,,,,0.00,0.00,0,0,0,0,0,0,0,0,0,0,0,0,0
20200316,048982,牧德元大94購02,0.69,0.69,0.69,0.69,+0.14,25.45,10000,1,6900,0,0,0,0,0,0,10000,0,10000,10000
20200316,048983,牧德元大95購01,0.88,0.92,0.68,0.68,-0.20,-22.73,29000,3,24120,0,0,0,0,0,0,19000,19000,0,0
20200316,048984,上緯控元大94購01,,,,,0.00,0.00,0,0,0,0,0,0,0,0,0,0,0,0,0
20200316,048985,茂林元大94購01,2.52,2.82,1.53,1.53,-0.97,-38.8,65000,8,162370,0,0,0,0,0,0,20000,45000,-25000,-25000
20200316,048986,訊連元大94購01,2.62,2.62,2.12,2.12,+0.26,13.98,65000,5,155150,0,0,0,0,0,0,55000,10000,45000,45000
20200316,048987,崇越元大94購01,0.71,0.71,0.55,0.55,0.00,0.00,20000,3,12250,0,0,0,0,0,0,5000,15000,-10000,-10000
20200316,048988,聯茂元大94購02,,,,,0.00,0.00,0,0,0,0,0,0,0,0,0,0,0,0,0
20200316,048989,矽格元大94購02,0.53,0.53,0.53,0.53,+0.11,26.19,10000,1,5300,0,0,0,0,0,0,10000,0,10000,10000
20200316,04898P,瑞儀中信95售01,1.88,1.92,1.82,1.87,-0.13,-6.5,32000,6,59290,0,0,0,0,0,0,20000,12000,8000,8000
20200316,048990,台表科元大94購01,0.36,0.36,0.36,0.36,0.00,0.00,10000,1,3600,0,0,0,0,0,0,0,10000,-10000,-10000
20200316,048991,昇陽半元大94購01,,,,,0.00,0.00,0,0,0,0,0,0,0,0,0,0,0,0,0
20200316,048992,昇陽半元大94購02,,,,,0.00,0.00,0,0,0,0,0,0,0,0,0,0,0,0,0
20200316,048993,昇陽半元大94購03,,,,,0.00,0.00,0,0,0,0,0,0,0,0,0,0,0,0,0
20200316,048994,南電元大94購03,,,,,0.00,0.00,0,0,0,0,0,0,0,0,0,0,0,0,0
20200316,048995,宏全元大94購01,0.09,0.09,0.09,0.09,0.00,0.00,20000,2,1800,0,0,0,0,0,0,0,20000,-20000,-20000
20200316,048996,中環第一94購01,,,,,0.00,0.00,0,0,0,0,0,0,0,0,0,0,0,0,0
20200316,048997,智原國票95購01,,,,,0.00,0.00,0,0,0,0,0,0,0,0,0,0,0,0,0
20200316,048998,玉晶光國票95購03,0.30,0.35,0.11,0.11,-0.14,-56.0,290000,25,54500,0,0,0,0,0,0,75000,215000,-140000,-140000
20200316,048999,康普國票95購01,,,,,0.00,0.00,0,0,0,0,0,0,0,0,0,0,0,0,0
20200316,04899P,力成中信94售02,,,,,0.00,0.00,0,0,0,0,0,0,0,0,0,0,0,0,0
20200316,049000,元油2X中信95購02,0.02,0.02,0.02,0.02,0.00,0.00,10000,1,200,0,0,0,0,0,0,0,10000,-10000,-10000
20200316,049001,川湖中信94購01,,,,,0.00,0.00,0,0,0,0,0,0,0,0,0,0,0,0,0
20200316,049002,光寶科中信94購01,,,,,0.00,0.00,0,0,0,0,0,0,0,0,0,0,0,0,0
20200316,049003,智邦中信95購01,,,,,0.00,0.00,0,0,0,0,0,0,0,0,0,0,0,0,0
20200316,049004,聯發科中信96購01,0.22,0.23,0.16,0.20,-0.09,-31.03,41000,5,8600,0,0,0,0,0,0,0,41000,-41000,-41000
20200316,049005,可成中信95購01,,,,,0.00,0.00,0,0,0,0,0,0,0,0,0,0,0,0,0
20200316,049006,和鑫中信94購01,,,,,0.00,0.00,0,0,0,0,0,0,0,0,0,0,0,0,0
20200316,049007,玉晶光中信96購01,0.44,0.44,0.20,0.25,-0.04,-13.79,1486000,36,367120,0,0,0,0,0,0,125000,1252000,-1127000,-1127000
20200316,049008,傳奇中信95購01,,,,,0.00,0.00,0,0,0,0,0,0,0,0,0,0,0,0,0
20200316,049009,南亞科麥證94購01,,,,,0.00,0.00,0,0,0,0,0,0,0,0,0,0,0,0,0
20200316,04900P,矽格中信94售02,0.59,0.72,0.59,0.65,-0.04,-5.8,59000,5,39330,0,0,0,0,0,0,29000,20000,9000,9000
20200316,049010,台表科麥證95購01,0.33,0.38,0.24,0.24,-0.09,-27.27,40000,6,12980,28000,12000,16000,0,0,0,28000,12000,16000,16000
20200316,049011,元油2X群益94購01,,,,,0.00,0.00,0,0,0,0,0,0,0,0,0,0,0,0,0
20200316,049012,大成鋼群益94購01,,,,,0.00,0.00,0,0,0,0,0,0,0,0,0,0,0,0,0
20200316,049013,川湖群益94購01,,,,,0.00,0.00,0,0,0,0,0,0,0,0,0,0,0,0,0
20200316,049014,台達電群益94購02,,,,,0.00,0.00,0,0,0,0,0,0,0,0,0,0,0,0,0
20200316,049015,鴻海群益94購03,,,,,0.00,0.00,0,0,0,0,0,0,0,0,0,0,0,0,0
20200316,049016,國巨群益94購02,,,,,0.00,0.00,0,0,0,0,0,0,0,0,0,0,0,0,0
20200316,049017,旺宏群益96購03,0.50,0.50,0.35,0.35,+0.08,29.63,11000,2,4000,0,0,0,0,0,0,0,10000,-10000,-10000
20200316,049018,光罩群益94購01,,,,,0.00,0.00,0,0,0,0,0,0,0,0,0,0,0,0,0
20200316,049019,美律群益94購02,,,,,0.00,0.00,0,0,0,0,0,0,0,0,0,0,0,0,0
20200316,04901P,臺股指麥證94售02,,,,,0.00,0.00,0,0,0,0,0,0,0,0,0,0,0,0,0
20200316,049020,可成群益94購02,,,,,0.00,0.00,0,0,0,0,0,0,0,0,0,0,0,0,0
20200316,049021,慧洋群益94購01,,,,,0.00,0.00,0,0,0,0,0,0,0,0,0,0,0,0,0
20200316,049022,聯詠群益94購01,,,,,0.00,0.00,0,0,0,0,0,0,0,0,0,0,0,0,0
20200316,049023,玉晶光群益96購04,0.15,0.15,0.08,0.08,-0.07,-46.67,1607000,74,171110,0,0,0,0,0,0,217000,1270000,-1053000,-1053000
20200316,049024,玉晶光群益97購01,0.83,0.83,0.44,0.44,-0.26,-37.14,52000,7,27160,0,0,0,0,0,0,2000,52000,-50000,-50000
20200316,049025,華擎群益94購01,,,,,0.00,0.00,0,0,0,0,0,0,0,0,0,0,0,0,0
20200316,049026,晶相光群益94購01,,,,,0.00,0.00,0,0,0,0,0,0,0,0,0,0,0,0,0
20200316,049027,智易群益94購02,,,,,0.00,0.00,0,0,0,0,0,0,0,0,0,0,0,0,0
20200316,049028,麗豐群益94購01,,,,,0.00,0.00,0,0,0,0,0,0,0,0,0,0,0,0,0
20200316,049029,茂林群益94購01,1.34,1.34,1.18,1.18,-0.62,-34.44,99000,17,124970,0,0,0,0,0,0,99000,0,99000,99000
20200316,04902P,國巨台新94售04,0.54,0.58,0.54,0.58,0.00,0.00,169000,4,93460,0,0,0,0,0,0,20000,169000,-149000,-149000
20200316,049030,凌華群益94購01,,,,,0.00,0.00,0,0,0,0,0,0,0,0,0,0,0,0,0
20200316,049031,矽格群益94購01,,,,,0.00,0.00,0,0,0,0,0,0,0,0,0,0,0,0,0
20200316,049032,百和群益94購04,,,,,0.00,0.00,0,0,0,0,0,0,0,0,0,0,0,0,0
20200316,049033,大成鋼兆豐94購01,,,,,0.00,0.00,0,0,0,0,0,0,0,0,0,0,0,0,0
20200316,049034,台達電兆豐94購01,,,,,0.00,0.00,0,0,0,0,0,0,0,0,0,0,0,0,0
20200316,049035,中環兆豐94購01,,,,,0.00,0.00,0,0,0,0,0,0,0,0,0,0,0,0,0
20200316,049036,燿華兆豐95購01,0.02,0.02,0.02,0.02,0.00,0.00,38000,3,760,0,0,0,0,0,0,0,38000,-38000,-38000
20200316,049037,可成兆豐94購01,,,,,0.00,0.00,0,0,0,0,0,0,0,0,0,0,0,0,0
20200316,049038,高鐵兆豐94購01,,,,,0.00,0.00,0,0,0,0,0,0,0,0,0,0,0,0,0
20200316,049039,富邦金兆豐94購01,,,,,0.00,0.00,0,0,0,0,0,0,0,0,0,0,0,0,0
20200316,04903P,全新永豐94售05,,,,,0.00,0.00,0,0,0,0,0,0,0,0,0,0,0,0,0
20200316,049040,亞光兆豐95購01,,,,,0.00,0.00,0,0,0,0,0,0,0,0,0,0,0,0,0
20200316,049041,和鑫兆豐94購01,,,,,0.00,0.00,0,0,0,0,0,0,0,0,0,0,0,0,0
20200316,049042,玉晶光兆豐95購01,,,,,0.00,0.00,0,0,0,0,0,0,0,0,0,0,0,0,0
20200316,049043,新唐兆豐94購01,,,,,0.00,0.00,0,0,0,0,0,0,0,0,0,0,0,0,0
20200316,049044,和碩兆豐94購01,0.28,0.28,0.28,0.28,+0.04,16.67,10000,1,2800,0,0,0,0,0,0,10000,0,10000,10000
20200316,049045,上海銀兆豐94購01,,,,,0.00,0.00,0,0,0,0,0,0,0,0,0,0,0,0,0
20200316,049046,同欣電兆豐94購01,0.03,0.03,0.03,0.03,0.00,0.00,16000,2,480,0,0,0,0,0,0,0,16000,-16000,-16000
20200316,049047,台達電台新94購01,,,,,0.00,0.00,0,0,0,0,0,0,0,0,0,0,0,0,0
20200316,049048,玉晶光台新94購01,,,,,0.00,0.00,0,0,0,0,0,0,0,0,0,0,0,0,0
20200316,049049,玉晶光康和94購02,,,,,0.00,0.00,0,0,0,0,0,0,0,0,0,0,0,0,0
20200316,04904P,奇力新永豐94售05,,,,,0.00,0.00,0,0,0,0,0,0,0,0,0,0,0,0,0
20200316,049050,崇越康和94購01,,,,,0.00,0.00,0,0,0,0,0,0,0,0,0,0,0,0,0
20200316,049051,滬深2X永豐94購05,,,,,0.00,0.00,0,0,0,0,0,0,0,0,0,0,0,0,0
20200316,049052,台積電永豐94購02,0.15,0.15,0.03,0.03,-0.15,-83.33,171000,4,6780,0,0,0,0,0,0,146000,10000,136000,136000
20200316,049053,可成永豐94購01,,,,,0.00,0.00,0,0,0,0,0,0,0,0,0,0,0,0,0
20200316,049054,禾伸堂永豐94購01,,,,,0.00,0.00,0,0,0,0,0,0,0,0,0,0,0,0,0
20200316,049055,聯詠永豐94購01,,,,,0.00,0.00,0,0,0,0,0,0,0,0,0,0,0,0,0
20200316,049056,玉晶光永豐95購03,0.07,0.07,0.06,0.06,-0.01,-14.29,110000,11,6900,0,0,0,0,0,0,0,110000,-110000,-110000
20200316,049057,元翎永豐94購01,,,,,0.00,0.00,0,0,0,0,0,0,0,0,0,0,0,0,0
20200316,049058,茂林永豐94購02,0.35,0.47,0.35,0.47,+0.07,17.5,50000,5,20100,0,0,0,0,0,0,10000,40000,-30000,-30000
20200316,049059,超眾永豐94購01,,,,,0.00,0.00,0,0,0,0,0,0,0,0,0,0,0,0,0
20200316,04905P,國巨國票94售04,,,,,0.00,0.00,0,0,0,0,0,0,0,0,0,0,0,0,0
20200316,049060,易華電永豐94購02,,,,,0.00,0.00,0,0,0,0,0,0,0,0,0,0,0,0,0
20200316,049061,元油2X日盛94購01,,,,,0.00,0.00,0,0,0,0,0,0,0,0,0,0,0,0,0
20200316,049062,華新科日盛94購01,0.06,0.06,0.06,0.06,0.00,0.00,20000,1,1200,0,0,0,0,0,0,20000,0,20000,20000
20200316,049063,緯穎日盛94購01,,,,,0.00,0.00,0,0,0,0,0,0,0,0,0,0,0,0,0
20200316,049064,T50反1凱基96購03,,,,,0.00,0.00,0,0,0,0,0,0,0,0,0,0,0,0,0
20200316,049065,T50反1凱基96購04,,,,,0.00,0.00,0,0,0,0,0,0,0,0,0,0,0,0,0
20200316,049066,元石油凱基97購01,,,,,0.00,0.00,0,0,0,0,0,0,0,0,0,0,0,0,0
20200316,049067,元油2X凱基94購02,,,,,0.00,0.00,0,0,0,0,0,0,0,0,0,0,0,0,0
20200316,049068,元油2X凱基95購03,,,,,0.00,0.00,0,0,0,0,0,0,0,0,0,0,0,0,0
20200316,049069,元油2X凱基95購04,,,,,0.00,0.00,0,0,0,0,0,0,0,0,0,0,0,0,0
20200316,04906P,欣興國票95售01,,,,,0.00,0.00,0,0,0,0,0,0,0,0,0,0,0,0,0
20200316,049070,力山凱基94購02,,,,,0.00,0.00,0,0,0,0,0,0,0,0,0,0,0,0,0
20200316,049071,台達電凱基94購02,,,,,0.00,0.00,0,0,0,0,0,0,0,0,0,0,0,0,0
20200316,049072,台積電凱基94購08,,,,,0.00,0.00,0,0,0,0,0,0,0,0,0,0,0,0,0
20200316,049073,光罩凱基94購01,,,,,0.00,0.00,0,0,0,0,0,0,0,0,0,0,0,0,0
20200316,049074,光罩凱基94購02,,,,,0.00,0.00,0,0,0,0,0,0,0,0,0,0,0,0,0
20200316,049075,光磊凱基94購01,,,,,0.00,0.00,0,0,0,0,0,0,0,0,0,0,0,0,0
20200316,049076,佳世達凱基94購01,,,,,0.00,0.00,0,0,0,0,0,0,0,0,0,0,0,0,0
20200316,049077,佳世達凱基94購02,,,,,0.00,0.00,0,0,0,0,0,0,0,0,0,0,0,0,0
20200316,049078,瑞昱凱基94購02,,,,,0.00,0.00,0,0,0,0,0,0,0,0,0,0,0,0,0
20200316,049079,聯發科凱基94購04,,,,,0.00,0.00,0,0,0,0,0,0,0,0,0,0,0,0,0
20200316,04907P,超眾國票95售01,1.90,2.26,1.90,2.26,-0.28,-11.02,23000,3,48440,0,0,0,0,0,0,23000,0,23000,23000
20200316,049080,可成凱基94購03,,,,,0.00,0.00,0,0,0,0,0,0,0,0,0,0,0,0,0
20200316,049081,兆赫凱基94購01,,,,,0.00,0.00,0,0,0,0,0,0,0,0,0,0,0,0,0
20200316,049082,晶豪科凱基94購01,0.01,0.01,0.01,0.01,0.00,0.00,1000,1,10,0,0,0,0,0,0,1000,0,1000,1000
20200316,049083,大立光凱基94購02,,,,,0.00,0.00,0,0,0,0,0,0,0,0,0,0,0,0,0
20200316,049084,欣興凱基94購03,,,,,0.00,0.00,0,0,0,0,0,0,0,0,0,0,0,0,0
20200316,049085,揚明光凱基94購03,,,,,0.00,0.00,0,0,0,0,0,0,0,0,0,0,0,0,0
20200316,049086,晶相光凱基94購01,,,,,0.00,0.00,0,0,0,0,0,0,0,0,0,0,0,0,0
20200316,049087,晶相光凱基94購02,,,,,0.00,0.00,0,0,0,0,0,0,0,0,0,0,0,0,0
20200316,049088,上緯控凱基94購02,,,,,0.00,0.00,0,0,0,0,0,0,0,0,0,0,0,0,0
20200316,049089,正文凱基94購02,,,,,0.00,0.00,0,0,0,0,0,0,0,0,0,0,0,0,0
20200316,04908P,南電國票95售03,,,,,0.00,0.00,0,0,0,0,0,0,0,0,0,0,0,0,0
20200316,049090,茂林凱基94購01,1.46,1.56,0.81,0.81,-1.03,-55.98,164000,20,223450,0,0,0,0,0,0,124000,40000,84000,84000
20200316,049091,訊連凱基94購01,0.68,0.72,0.48,0.48,-0.12,-20.0,88000,22,57380,0,0,0,0,0,0,68000,20000,48000,48000
20200316,049092,聯茂凱基94購07,,,,,0.00,0.00,0,0,0,0,0,0,0,0,0,0,0,0,0
20200316,049093,昇陽半凱基94購01,,,,,0.00,0.00,0,0,0,0,0,0,0,0,0,0,0,0,0
20200316,049094,昇陽半凱基94購02,,,,,0.00,0.00,0,0,0,0,0,0,0,0,0,0,0,0,0
20200316,049095,昇陽半凱基94購03,,,,,0.00,0.00,0,0,0,0,0,0,0,0,0,0,0,0,0
20200316,049096,南茂凱基94購01,,,,,0.00,0.00,0,0,0,0,0,0,0,0,0,0,0,0,0
20200316,049097,國巨國泰95購03,,,,,0.00,0.00,0,0,0,0,0,0,0,0,0,0,0,0,0
20200316,049098,國巨國泰96購01,,,,,0.00,0.00,0,0,0,0,0,0,0,0,0,0,0,0,0
20200316,049099,華新科國泰95購02,,,,,0.00,0.00,0,0,0,0,0,0,0,0,0,0,0,0,0
20200316,04909P,鴻海統一94售10,2.10,2.10,2.10,2.10,-0.31,-12.86,10000,2,21000,0,0,0,0,0,0,0,10000,-10000,-10000
20200316,049100,華新科國泰96購01,,,,,0.00,0.00,0,0,0,0,0,0,0,0,0,0,0,0,0
20200316,049101,聯詠國泰95購01,0.46,0.49,0.46,0.49,+0.10,25.64,66000,2,30420,0,0,0,0,0,0,66000,0,66000,66000
20200316,049102,智伸科國泰96購01,,,,,0.00,0.00,0,0,0,0,0,0,0,0,0,0,0,0,0
20200316,049103,易華電國泰96購01,,,,,0.00,0.00,0,0,0,0,0,0,0,0,0,0,0,0,0
20200316,049104,元油2X富邦97購02,,,,,0.00,0.00,0,0,0,0,0,0,0,0,0,0,0,0,0
20200316,049105,亞泥富邦94購01,,,,,0.00,0.00,0,0,0,0,0,0,0,0,0,0,0,0,0
20200316,049106,大立光富邦94購01,,,,,0.00,0.00,0,0,0,0,0,0,0,0,0,0,0,0,0
20200316,049107,緯創富邦94購01,,,,,0.00,0.00,0,0,0,0,0,0,0,0,0,0,0,0,0
20200316,049108,玉晶光富邦96購02,0.18,0.18,0.12,0.12,-0.09,-42.86,171000,9,26270,0,0,0,0,0,0,0,171000,-171000,-171000
20200316,049109,嘉澤富邦95購01,,,,,0.00,0.00,0,0,0,0,0,0,0,0,0,0,0,0,0
20200316,04910P,台積電統一94售12,,,,,0.00,0.00,0,0,0,0,0,0,0,0,0,0,0,0,0
20200316,049110,臻鼎富邦94購01,,,,,0.00,0.00,0,0,0,0,0,0,0,0,0,0,0,0,0
20200316,049111,元油2X統一94購03,,,,,0.00,0.00,0,0,0,0,0,0,0,0,0,0,0,0,0
20200316,049112,可成統一94購01,,,,,0.00,0.00,0,0,0,0,0,0,0,0,0,0,0,0,0
20200316,049113,大立光統一94購06,,,,,0.00,0.00,0,0,0,0,0,0,0,0,0,0,0,0,0
20200316,049114,玉晶光統一94購02,0.01,0.01,0.01,0.01,0.00,0.00,110000,1,1100,0,0,0,0,0,0,110000,0,110000,110000
20200316,049115,創意統一94購03,,,,,0.00,0.00,0,0,0,0,0,0,0,0,0,0,0,0,0
20200316,049116,瑞儀統一94購01,,,,,0.00,0.00,0,0,0,0,0,0,0,0,0,0,0,0,0
20200316,049117,矽格統一96購01,0.71,0.71,0.71,0.71,-0.20,-21.98,1000,1,710,0,0,0,0,0,0,1000,0,1000,1000
20200316,049118,元油2X元富94購03,0.02,0.02,0.02,0.02,+0.01,100.0,80000,4,1600,0,0,0,0,0,0,0,0,0,0
20200316,049119,元油2X元富94購04,,,,,0.00,0.00,0,0,0,0,0,0,0,0,0,0,0,0,0
20200316,04911P,美律元富94售02,1.33,1.33,1.33,1.33,-0.39,-22.67,24000,1,31920,0,0,0,0,0,0,24000,0,24000,24000
20200316,049120,元油2X元富94購05,,,,,0.00,0.00,0,0,0,0,0,0,0,0,0,0,0,0,0
20200316,049121,元油2X元富94購06,,,,,0.00,0.00,0,0,0,0,0,0,0,0,0,0,0,0,0
20200316,049122,元油2X元富94購07,,,,,0.00,0.00,0,0,0,0,0,0,0,0,0,0,0,0,0
20200316,049123,可成元富94購01,,,,,0.00,0.00,0,0,0,0,0,0,0,0,0,0,0,0,0
20200316,049124,可成元富94購02,,,,,0.00,0.00,0,0,0,0,0,0,0,0,0,0,0,0,0
20200316,049125,禾伸堂元富94購01,,,,,0.00,0.00,0,0,0,0,0,0,0,0,0,0,0,0,0
20200316,049126,玉晶光元富94購02,,,,,0.00,0.00,0,0,0,0,0,0,0,0,0,0,0,0,0
20200316,049127,上海銀元富94購01,,,,,0.00,0.00,0,0,0,0,0,0,0,0,0,0,0,0,0
20200316,049128,滬深2X元大97購03,,,,,0.00,0.00,0,0,0,0,0,0,0,0,0,0,0,0,0
20200316,049129,S&P反1元大97購01,0.95,1.06,0.95,1.05,-0.16,-13.22,42000,7,42900,0,0,0,0,0,0,0,42000,-42000,-42000
20200316,04912P,可成元富94售06,4.38,4.38,4.38,4.38,-0.92,-17.36,14000,1,61320,0,0,0,0,0,0,14000,0,14000,14000
20200316,049130,臺指反元大98購01,1.09,1.09,1.08,1.08,+0.02,1.89,20000,2,21700,0,0,0,0,0,0,0,20000,-20000,-20000
20200316,049131,元油2X元大94購02,,,,,0.00,0.00,0,0,0,0,0,0,0,0,0,0,0,0,0
20200316,049132,大成鋼元大94購01,0.01,0.01,0.01,0.01,0.00,0.00,20000,1,200,0,0,0,0,0,0,20000,0,20000,20000
20200316,049133,為升元大94購02,,,,,0.00,0.00,0,0,0,0,0,0,0,0,0,0,0,0,0
20200316,049134,為升元大95購01,,,,,0.00,0.00,0,0,0,0,0,0,0,0,0,0,0,0,0
20200316,049135,台達電元大94購03,,,,,0.00,0.00,0,0,0,0,0,0,0,0,0,0,0,0,0
20200316,049136,華通元大95購01,0.15,0.15,0.11,0.12,+0.02,20.0,36000,4,4850,0,0,0,0,0,0,20000,16000,4000,4000
20200316,049137,華通元大95購02,0.29,0.29,0.16,0.16,-0.06,-27.27,342000,30,82890,0,0,0,0,0,0,92000,302000,-210000,-210000
20200316,049138,台積電元大94購05,0.04,0.04,0.04,0.04,+0.01,33.33,1000,1,40,0,0,0,0,0,0,1000,1000,0,0
20200316,049139,台積電元大94購06,0.16,0.16,0.06,0.07,-0.33,-82.5,511000,52,34460,0,0,0,0,0,0,11000,501000,-490000,-490000
20200316,04913P,聯詠元富94售02,1.61,1.61,1.61,1.61,-0.43,-21.08,133000,2,214130,0,0,0,0,0,0,133000,0,133000,133000
20200316,049140,台積電元大94購07,0.52,0.52,0.14,0.14,-0.57,-80.28,1180000,115,216650,0,0,0,0,0,0,120000,1060000,-940000,-940000
20200316,049141,旺宏元大95購01,0.52,0.52,0.29,0.29,-0.15,-34.09,90000,10,38970,0,0,0,0,0,0,47000,43000,4000,4000
20200316,049142,智邦元大94購01,,,,,0.00,0.00,0,0,0,0,0,0,0,0,0,0,0,0,0
20200316,049143,智邦元大94購02,0.44,0.44,0.44,0.44,0.00,0.00,20000,1,8800,0,0,0,0,0,0,20000,0,20000,20000
20200316,049144,瑞昱元大94購03,,,,,0.00,0.00,0,0,0,0,0,0,0,0,0,0,0,0,0
20200316,049145,南亞科元大94購01,,,,,0.00,0.00,0,0,0,0,0,0,0,0,0,0,0,0,0
20200316,049146,南亞科元大94購02,,,,,0.00,0.00,0,0,0,0,0,0,0,0,0,0,0,0,0
20200316,049147,美律元大94購02,,,,,0.00,0.00,0,0,0,0,0,0,0,0,0,0,0,0,0
20200316,049148,全新元大95購01,,,,,0.00,0.00,0,0,0,0,0,0,0,0,0,0,0,0,0
20200316,049149,華新科元大95購03,,,,,0.00,0.00,0,0,0,0,0,0,0,0,0,0,0,0,0
20200316,04914P,國巨國泰95售06,1.20,1.42,1.20,1.42,+0.28,24.56,31000,2,43800,0,0,0,0,0,0,31000,0,31000,31000
20200316,049150,新光金元大96購01,,,,,0.00,0.00,0,0,0,0,0,0,0,0,0,0,0,0,0
20200316,049151,大立光元大94購07,,,,,0.00,0.00,0,0,0,0,0,0,0,0,0,0,0,0,0
20200316,049152,大立光元大95購06,0.10,0.10,0.06,0.06,-0.04,-40.0,284000,7,25140,0,0,0,0,0,0,250000,34000,216000,216000
20200316,049153,大立光元大96購02,0.18,0.18,0.15,0.16,-0.05,-23.81,362000,31,61140,0,0,0,0,0,0,146000,151000,-5000,-5000
20200316,049154,玉晶光元大95購02,0.19,0.19,0.15,0.15,0.00,0.00,55000,4,10050,0,0,0,0,0,0,30000,25000,5000,5000
20200316,049155,同欣電元大94購01,,,,,0.00,0.00,0,0,0,0,0,0,0,0,0,0,0,0,0
20200316,049156,緯穎元大96購01,4.82,4.82,4.79,4.79,+1.29,36.86,30000,2,144000,0,0,0,0,0,0,30000,0,30000,30000
20200316,049157,矽創元大95購01,0.13,0.13,0.06,0.06,-0.03,-33.33,379000,3,28340,0,0,0,0,0,0,379000,0,379000,379000
20200316,049158,元油2X中信94購03,,,,,0.00,0.00,0,0,0,0,0,0,0,0,0,0,0,0,0
20200316,049159,同欣電中信96購01,,,,,0.00,0.00,0,0,0,0,0,0,0,0,0,0,0,0,0
20200316,04915P,鴻海永昌96售02,2.77,2.98,2.77,2.98,+0.56,23.14,66000,2,190380,0,0,0,0,0,0,66000,0,66000,66000
20200316,049160,鴻海第一95購01,0.29,0.34,0.29,0.33,0.00,0.00,120000,12,38500,0,0,0,0,0,0,120000,120000,0,0
20200316,049161,聯發科亞東94購01,,,,,0.00,0.00,0,0,0,0,0,0,0,0,0,0,0,0,0
20200316,049162,聯詠亞東94購01,,,,,0.00,0.00,0,0,0,0,0,0,0,0,0,0,0,0,0
20200316,049163,欣興亞東94購01,,,,,0.00,0.00,0,0,0,0,0,0,0,0,0,0,0,0,0
20200316,049164,滬深2X日盛94購01,,,,,0.00,0.00,0,0,0,0,0,0,0,0,0,0,0,0,0
20200316,049165,元油2X凱基97購01,0.08,0.08,0.06,0.06,0.00,0.00,30000,3,2100,0,0,0,0,0,0,0,0,0,0
20200316,049166,元油2X凱基97購02,0.07,0.07,0.07,0.07,0.00,0.00,1000,1,70,0,0,0,0,0,0,0,0,0,0
20200316,049167,元油2X凱基97購03,,,,,0.00,0.00,0,0,0,0,0,0,0,0,0,0,0,0,0
20200316,049168,卜蜂凱基94購01,,,,,0.00,0.00,0,0,0,0,0,0,0,0,0,0,0,0,0
20200316,049169,統一凱基94購01,,,,,0.00,0.00,0,0,0,0,0,0,0,0,0,0,0,0,0
20200316,04916P,大立光永昌96售02,3.51,3.51,3.51,3.51,-1.11,-24.03,30000,1,105300,0,0,0,0,0,0,30000,0,30000,30000
20200316,049170,亞德客凱基94購01,0.46,0.51,0.21,0.21,+0.04,23.53,110000,11,34900,0,0,0,0,0,0,0,110000,-110000,-110000
20200316,049171,台達電凱基94購03,,,,,0.00,0.00,0,0,0,0,0,0,0,0,0,0,0,0,0
20200316,049172,鴻海凱基94購14,0.35,0.39,0.31,0.36,+0.21,140.0,90000,9,29900,0,0,0,0,0,0,90000,90000,0,0
20200316,049173,鴻海凱基94購15,0.10,0.13,0.10,0.12,0.00,0.00,80000,8,8500,0,0,0,0,0,0,80000,80000,0,0
20200316,049174,台積電凱基94購11,,,,,0.00,0.00,0,0,0,0,0,0,0,0,0,0,0,0,0
20200316,049175,台積電凱基94購12,,,,,0.00,0.00,0,0,0,0,0,0,0,0,0,0,0,0,0
20200316,049176,漢唐凱基94購02,,,,,0.00,0.00,0,0,0,0,0,0,0,0,0,0,0,0,0
20200316,049177,美律凱基94購02,,,,,0.00,0.00,0,0,0,0,0,0,0,0,0,0,0,0,0
20200316,049178,宏達電凱基94購02,,,,,0.00,0.00,0,0,0,0,0,0,0,0,0,0,0,0,0
20200316,049179,高鐵凱基94購01,,,,,0.00,0.00,0,0,0,0,0,0,0,0,0,0,0,0,0
20200316,04917P,台積電凱基94售37,,,,,0.00,0.00,0,0,0,0,0,0,0,0,0,0,0,0,0
20200316,049180,TPK凱基94購02,,,,,0.00,0.00,0,0,0,0,0,0,0,0,0,0,0,0,0
20200316,049181,正文凱基94購03,,,,,0.00,0.00,0,0,0,0,0,0,0,0,0,0,0,0,0
20200316,049182,新唐凱基94購01,,,,,0.00,0.00,0,0,0,0,0,0,0,0,0,0,0,0,0
20200316,049183,鎧勝凱基94購01,,,,,0.00,0.00,0,0,0,0,0,0,0,0,0,0,0,0,0
20200316,049184,啟碁凱基94購01,,,,,0.00,0.00,0,0,0,0,0,0,0,0,0,0,0,0,0
20200316,049185,南電凱基94購03,,,,,0.00,0.00,0,0,0,0,0,0,0,0,0,0,0,0,0
20200316,049186,寶成凱基94購01,,,,,0.00,0.00,0,0,0,0,0,0,0,0,0,0,0,0,0
20200316,049187,義隆台新94購01,,,,,0.00,0.00,0,0,0,0,0,0,0,0,0,0,0,0,0
20200316,049188,可成台新94購01,,,,,0.00,0.00,0,0,0,0,0,0,0,0,0,0,0,0,0
20200316,049189,訊芯康和94購01,,,,,0.00,0.00,0,0,0,0,0,0,0,0,0,0,0,0,0
20200316,04918P,華新科凱基94售12,0.16,0.16,0.16,0.16,+0.04,33.33,10000,1,1600,0,0,0,0,0,0,10000,0,10000,10000
20200316,049190,元油2X永豐94購04,,,,,0.00,0.00,0,0,0,0,0,0,0,0,0,0,0,0,0
20200316,049191,元油2X永豐95購01,,,,,0.00,0.00,0,0,0,0,0,0,0,0,0,0,0,0,0
20200316,049192,元油2X永豐96購02,,,,,0.00,0.00,0,0,0,0,0,0,0,0,0,0,0,0,0
20200316,049193,元油2X永豐97購01,,,,,0.00,0.00,0,0,0,0,0,0,0,0,0,0,0,0,0
20200316,049194,卜蜂永豐94購01,,,,,0.00,0.00,0,0,0,0,0,0,0,0,0,0,0,0,0
20200316,049195,全新永豐94購02,,,,,0.00,0.00,0,0,0,0,0,0,0,0,0,0,0,0,0
20200316,049196,奇力新永豐94購02,,,,,0.00,0.00,0,0,0,0,0,0,0,0,0,0,0,0,0
20200316,049197,信邦永豐94購01,,,,,0.00,0.00,0,0,0,0,0,0,0,0,0,0,0,0,0
20200316,049198,聯鈞永豐94購01,1.20,1.20,1.20,1.20,0.00,0.00,3000,1,3600,0,0,0,0,0,0,3000,0,3000,3000
20200316,049199,茂林永豐95購01,0.52,0.52,0.45,0.45,-0.01,-2.17,76000,12,38020,0,0,0,0,0,0,76000,0,76000,76000
20200316,04919P,聯詠凱基94售05,1.16,1.22,1.13,1.22,-0.23,-15.86,101000,3,121720,0,0,0,0,0,0,0,101000,-101000,-101000
20200316,049200,元黃金群益98購01,0.58,0.71,0.53,0.61,-0.23,-27.38,1150000,20,641970,0,0,0,0,0,0,829000,320000,509000,509000
20200316,049201,劍麟群益94購01,,,,,0.00,0.00,0,0,0,0,0,0,0,0,0,0,0,0,0
20200316,049202,國巨群益94購03,,,,,0.00,0.00,0,0,0,0,0,0,0,0,0,0,0,0,0
20200316,049203,智邦群益94購01,,,,,0.00,0.00,0,0,0,0,0,0,0,0,0,0,0,0,0
20200316,049204,京元電群益94購02,,,,,0.00,0.00,0,0,0,0,0,0,0,0,0,0,0,0,0
20200316,049205,聯發科群益94購05,,,,,0.00,0.00,0,0,0,0,0,0,0,0,0,0,0,0,0
20200316,049206,大立光群益94購04,,,,,0.00,0.00,0,0,0,0,0,0,0,0,0,0,0,0,0
20200316,049207,茂林群益94購02,1.07,1.07,0.72,1.07,-0.30,-21.9,80000,15,65900,0,0,0,0,0,0,70000,10000,60000,60000
20200316,049208,台郡群益94購01,,,,,0.00,0.00,0,0,0,0,0,0,0,0,0,0,0,0,0
20200316,049209,GIS群益94購03,,,,,0.00,0.00,0,0,0,0,0,0,0,0,0,0,0,0,0
20200316,04920P,智易凱基94售05,3.74,3.74,3.74,3.74,-0.04,-1.06,20000,2,74800,0,0,0,0,0,0,0,20000,-20000,-20000
20200316,049210,昇陽半群益94購02,,,,,0.00,0.00,0,0,0,0,0,0,0,0,0,0,0,0,0
20200316,049211,昇陽半群益94購03,,,,,0.00,0.00,0,0,0,0,0,0,0,0,0,0,0,0,0
20200316,049212,T50反1國票94購04,1.83,2.18,1.83,2.17,-0.09,-3.98,31000,3,67080,0,0,0,0,0,0,31000,0,31000,31000
20200316,049213,滬深2X國票94購02,,,,,0.00,0.00,0,0,0,0,0,0,0,0,0,0,0,0,0
20200316,049214,台達電國票95購01,,,,,0.00,0.00,0,0,0,0,0,0,0,0,0,0,0,0,0
20200316,049215,國巨國票94購03,1.10,1.10,1.10,1.10,+0.20,22.22,20000,1,22000,0,0,0,0,0,0,20000,0,20000,20000
20200316,049216,華邦電國票95購01,,,,,0.00,0.00,0,0,0,0,0,0,0,0,0,0,0,0,0
20200316,049217,智邦國票95購01,,,,,0.00,0.00,0,0,0,0,0,0,0,0,0,0,0,0,0
20200316,049218,燿華國票94購02,,,,,0.00,0.00,0,0,0,0,0,0,0,0,0,0,0,0,0
20200316,049219,聯發科國票95購01,,,,,0.00,0.00,0,0,0,0,0,0,0,0,0,0,0,0,0
20200316,04921P,TPK凱基94售05,,,,,0.00,0.00,0,0,0,0,0,0,0,0,0,0,0,0,0
20200316,049220,聯發科國票95購02,,,,,0.00,0.00,0,0,0,0,0,0,0,0,0,0,0,0,0
20200316,049221,健策國票95購02,2.53,2.53,2.53,2.53,-0.04,-1.56,10000,1,25300,0,0,0,0,0,0,10000,0,10000,10000
20200316,049222,和碩國票94購01,0.08,0.08,0.08,0.08,+0.01,14.29,10000,1,800,0,0,0,0,0,0,10000,0,10000,10000
20200316,049223,鎧勝國票95購01,,,,,0.00,0.00,0,0,0,0,0,0,0,0,0,0,0,0,0
20200316,049224,致新國票95購01,0.01,0.01,0.01,0.01,-0.01,-50.0,55000,2,550,0,0,0,0,0,0,55000,0,55000,55000
20200316,049225,達方國票94購01,,,,,0.00,0.00,0,0,0,0,0,0,0,0,0,0,0,0,0
20200316,049226,元石油富邦95購01,,,,,0.00,0.00,0,0,0,0,0,0,0,0,0,0,0,0,0
20200316,049227,元油2X富邦96購03,,,,,0.00,0.00,0,0,0,0,0,0,0,0,0,0,0,0,0
20200316,049228,台塑富邦94購01,,,,,0.00,0.00,0,0,0,0,0,0,0,0,0,0,0,0,0
20200316,049229,台化富邦94購01,,,,,0.00,0.00,0,0,0,0,0,0,0,0,0,0,0,0,0
20200316,04922P,日月光凱基94售02,2.99,3.19,2.99,3.19,-0.35,-9.89,20000,3,61800,0,0,0,0,0,0,10000,10000,0,0
20200316,049230,台達電富邦96購01,,,,,0.00,0.00,0,0,0,0,0,0,0,0,0,0,0,0,0
20200316,049231,鴻海富邦95購02,0.56,0.56,0.50,0.50,+0.12,31.58,125000,12,69700,0,0,0,0,0,0,20000,105000,-85000,-85000
20200316,049232,元油2X統一94購04,,,,,0.00,0.00,0,0,0,0,0,0,0,0,0,0,0,0,0
20200316,049233,聯發科統一94購04,,,,,0.00,0.00,0,0,0,0,0,0,0,0,0,0,0,0,0
20200316,049234,可成統一94購02,,,,,0.00,0.00,0,0,0,0,0,0,0,0,0,0,0,0,0
20200316,049235,元油2X元富96購05,0.07,0.08,0.05,0.07,-0.02,-22.22,5601000,118,340310,0,0,0,0,0,0,0,0,0,0
20200316,049236,元油2X元富96購06,0.02,0.02,0.02,0.02,-0.01,-33.33,593000,12,11860,0,0,0,0,0,0,0,0,0,0
20200316,049237,元油2X元富96購07,0.02,0.02,0.02,0.02,0.00,0.00,10000,1,200,0,0,0,0,0,0,0,0,0,0
20200316,049238,元油2X元富96購08,,,,,0.00,0.00,0,0,0,0,0,0,0,0,0,0,0,0,0
20200316,049239,卜蜂元富94購01,,,,,0.00,0.00,0,0,0,0,0,0,0,0,0,0,0,0,0
20200316,04923P,GIS凱基94售06,1.44,1.64,1.35,1.64,-0.17,-9.39,120000,13,183340,0,0,0,0,0,0,6000,114000,-108000,-108000
20200316,049240,華通元富94購01,,,,,0.00,0.00,0,0,0,0,0,0,0,0,0,0,0,0,0
20200316,049241,智邦元富94購01,0.01,0.02,0.01,0.02,0.00,0.00,200000,2,3000,0,0,0,0,0,0,200000,0,200000,200000
20200316,049242,佳世達元富96購01,,,,,0.00,0.00,0,0,0,0,0,0,0,0,0,0,0,0,0
20200316,049243,佳世達元富96購02,,,,,0.00,0.00,0,0,0,0,0,0,0,0,0,0,0,0,0
20200316,049244,亞光元富94購01,,,,,0.00,0.00,0,0,0,0,0,0,0,0,0,0,0,0,0
20200316,049245,和鑫元富95購01,,,,,0.00,0.00,0,0,0,0,0,0,0,0,0,0,0,0,0
20200316,049246,大成鋼元大94購02,0.06,0.06,0.06,0.06,0.00,0.00,2000,1,120,0,0,0,0,0,0,2000,0,2000,2000
20200316,049247,光寶科元大94購02,0.10,0.10,0.10,0.10,+0.02,25.0,10000,1,1000,0,0,0,0,0,0,10000,0,10000,10000
20200316,049248,台達電元大94購04,,,,,0.00,0.00,0,0,0,0,0,0,0,0,0,0,0,0,0
20200316,049249,台達電元大94購05,,,,,0.00,0.00,0,0,0,0,0,0,0,0,0,0,0,0,0
20200316,04924P,元油2X元大94售12,,,,,0.00,0.00,0,0,0,0,0,0,0,0,0,0,0,0,0
20200316,049250,華通元大95購04,,,,,0.00,0.00,0,0,0,0,0,0,0,0,0,0,0,0,0
20200316,049251,國巨元大95購02,,,,,0.00,0.00,0,0,0,0,0,0,0,0,0,0,0,0,0
20200316,049252,國巨元大96購01,4.29,4.46,3.26,3.26,-0.95,-22.57,155000,14,600360,0,0,0,0,0,0,70000,85000,-15000,-15000
20200316,049253,台積電元大94購08,1.15,1.15,0.49,0.49,-0.99,-66.89,38000,6,28900,0,0,0,0,0,0,16000,22000,-6000,-6000
20200316,049254,台積電元大96購02,2.20,2.20,1.45,1.47,-0.79,-34.96,727000,86,1272520,0,0,0,0,0,0,205000,521000,-316000,-316000
20200316,049255,旺宏元大97購02,0.69,0.73,0.60,0.60,-0.07,-10.45,141000,3,100390,0,0,0,0,0,0,131000,10000,121000,121000
20200316,049256,瑞昱元大94購04,,,,,0.00,0.00,0,0,0,0,0,0,0,0,0,0,0,0,0
20200316,049257,南亞科元大94購03,,,,,0.00,0.00,0,0,0,0,0,0,0,0,0,0,0,0,0
20200316,049258,美律元大94購03,,,,,0.00,0.00,0,0,0,0,0,0,0,0,0,0,0,0,0
20200316,049259,聯發科元大94購04,,,,,0.00,0.00,0,0,0,0,0,0,0,0,0,0,0,0,0
20200316,04925P,和碩元大94售03,,,,,0.00,0.00,0,0,0,0,0,0,0,0,0,0,0,0,0
20200316,049260,華新科元大96購01,0.63,0.65,0.57,0.59,+0.03,5.36,29000,4,17330,0,0,0,0,0,0,25000,2000,23000,23000
20200316,049261,大立光元大94購08,,,,,0.00,0.00,0,0,0,0,0,0,0,0,0,0,0,0,0
20200316,049262,大立光元大94購09,,,,,0.00,0.00,0,0,0,0,0,0,0,0,0,0,0,0,0
20200316,049263,大立光元大94購10,,,,,0.00,0.00,0,0,0,0,0,0,0,0,0,0,0,0,0
20200316,049264,奇鋐元大95購01,0.07,0.08,0.06,0.06,0.00,0.00,85000,9,5900,0,0,0,0,0,0,0,85000,-85000,-85000
20200316,049265,揚明光元大94購03,,,,,0.00,0.00,0,0,0,0,0,0,0,0,0,0,0,0,0
20200316,049266,和碩元大94購01,0.12,0.12,0.12,0.12,+0.02,20.0,10000,1,1200,0,0,0,0,0,0,10000,0,10000,10000
20200316,049267,瀚宇博元大95購02,0.37,0.37,0.33,0.33,+0.04,13.79,50000,5,16900,0,0,0,0,0,0,10000,40000,-30000,-30000
20200316,049268,聯茂元大94購03,,,,,0.00,0.00,0,0,0,0,0,0,0,0,0,0,0,0,0
20200316,049269,超眾元大96購02,,,,,0.00,0.00,0,0,0,0,0,0,0,0,0,0,0,0,0
20200316,04926P,聯發科凱基95售03,2.08,2.80,1.95,2.63,+1.04,65.41,51000,6,130180,0,0,0,0,0,0,0,51000,-51000,-51000
20200316,049270,台表科元大95購02,0.87,0.90,0.48,0.48,-0.29,-37.66,113000,12,76010,0,0,0,0,0,0,32000,82000,-50000,-50000
20200316,049271,百和元大94購01,,,,,0.00,0.00,0,0,0,0,0,0,0,0,0,0,0,0,0
20200316,049272,世紀鋼元大96購02,1.20,1.26,1.12,1.13,+0.05,4.63,276000,32,335650,0,2000,-2000,0,0,0,151000,62000,89000,87000
20200316,049273,臺股指元大94購08,0.36,0.40,0.28,0.28,-0.32,-53.33,60000,4,18800,0,0,0,0,0,0,40000,0,40000,40000
20200316,049274,臺股指元大94購09,,,,,0.00,0.00,0,0,0,0,0,0,0,0,0,0,0,0,0
20200316,049275,臺股指元大94購10,,,,,0.00,0.00,0,0,0,0,0,0,0,0,0,0,0,0,0
20200316,049276,臺股指元大94購11,,,,,0.00,0.00,0,0,0,0,0,0,0,0,0,0,0,0,0
20200316,049277,臺股指元大94購12,,,,,0.00,0.00,0,0,0,0,0,0,0,0,0,0,0,0,0
20200316,049278,南亞科亞東94購01,,,,,0.00,0.00,0,0,0,0,0,0,0,0,0,0,0,0,0
20200316,049279,元油2X國票94購02,,,,,0.00,0.00,0,0,0,0,0,0,0,0,0,0,0,0,0
20200316,04927P,大立光凱基95售06,2.59,3.27,2.59,3.27,+0.53,19.34,87000,5,230810,0,0,0,0,0,0,1000,86000,-85000,-85000
20200316,049280,創意國票95購01,,,,,0.00,0.00,0,0,0,0,0,0,0,0,0,0,0,0,0
20200316,049281,嘉聯益國票95購01,,,,,0.00,0.00,0,0,0,0,0,0,0,0,0,0,0,0,0
20200316,049282,易華電國票95購01,,,,,0.00,0.00,0,0,0,0,0,0,0,0,0,0,0,0,0
20200316,049283,滬深2X中信95購10,0.24,0.24,0.20,0.20,-0.06,-23.08,100000,4,22500,0,0,0,0,0,0,0,100000,-100000,-100000
20200316,049284,瑞昱中信94購02,,,,,0.00,0.00,0,0,0,0,0,0,0,0,0,0,0,0,0
20200316,049285,宏碁兆豐94購01,,,,,0.00,0.00,0,0,0,0,0,0,0,0,0,0,0,0,0
20200316,049286,美律兆豐94購01,,,,,0.00,0.00,0,0,0,0,0,0,0,0,0,0,0,0,0
20200316,049287,可成兆豐95購01,0.02,0.03,0.02,0.02,-0.01,-33.33,110000,9,2600,0,0,0,0,0,0,0,110000,-110000,-110000
20200316,049288,聯茂兆豐95購02,,,,,0.00,0.00,0,0,0,0,0,0,0,0,0,0,0,0,0
20200316,049289,樺漢兆豐94購01,,,,,0.00,0.00,0,0,0,0,0,0,0,0,0,0,0,0,0
20200316,04928P,大立光凱基95售07,,,,,0.00,0.00,0,0,0,0,0,0,0,0,0,0,0,0,0
20200316,049290,元油2X群益94購02,,,,,0.00,0.00,0,0,0,0,0,0,0,0,0,0,0,0,0
20200316,049291,華通群益94購04,,,,,0.00,0.00,0,0,0,0,0,0,0,0,0,0,0,0,0
20200316,049292,鴻海群益94購04,1.47,1.47,1.17,1.17,0.00,0.00,80000,8,106200,0,0,0,0,0,0,0,80000,-80000,-80000
20200316,049293,友訊群益95購01,,,,,0.00,0.00,0,0,0,0,0,0,0,0,0,0,0,0,0
20200316,049294,南亞科群益94購01,,,,,0.00,0.00,0,0,0,0,0,0,0,0,0,0,0,0,0
20200316,049295,全新群益94購02,,,,,0.00,0.00,0,0,0,0,0,0,0,0,0,0,0,0,0
20200316,049296,義隆群益96購01,,,,,0.00,0.00,0,0,0,0,0,0,0,0,0,0,0,0,0
20200316,049297,日電貿群益95購01,0.26,0.26,0.20,0.20,-0.02,-9.09,20000,2,4600,0,0,0,0,0,0,10000,10000,0,0
20200316,049298,矽格群益95購01,,,,,0.00,0.00,0,0,0,0,0,0,0,0,0,0,0,0,0
20200316,049299,矽創群益94購01,,,,,0.00,0.00,0,0,0,0,0,0,0,0,0,0,0,0,0
20200316,04929P,同欣電凱基95售01,1.22,1.36,1.22,1.33,-0.02,-1.48,245000,7,316300,0,0,0,0,0,0,4000,241000,-237000,-237000
20200316,049300,南電群益94購01,,,,,0.00,0.00,0,0,0,0,0,0,0,0,0,0,0,0,0
20200316,049301,致新群益95購01,,,,,0.00,0.00,0,0,0,0,0,0,0,0,0,0,0,0,0
20200316,049302,聯茂日盛94購01,,,,,0.00,0.00,0,0,0,0,0,0,0,0,0,0,0,0,0
20200316,049303,S&P反1凱基94購02,,,,,0.00,0.00,0,0,0,0,0,0,0,0,0,0,0,0,0
20200316,049304,元油2X凱基95購05,,,,,0.00,0.00,0,0,0,0,0,0,0,0,0,0,0,0,0
20200316,049305,元油2X凱基95購06,,,,,0.00,0.00,0,0,0,0,0,0,0,0,0,0,0,0,0
20200316,049306,元油2X凱基96購01,0.02,0.02,0.02,0.02,0.00,0.00,50000,1,1000,0,0,0,0,0,0,0,0,0,0
20200316,049307,上銀凱基94購03,,,,,0.00,0.00,0,0,0,0,0,0,0,0,0,0,0,0,0
20200316,049308,台達電凱基94購04,,,,,0.00,0.00,0,0,0,0,0,0,0,0,0,0,0,0,0
20200316,049309,台達電凱基94購05,,,,,0.00,0.00,0,0,0,0,0,0,0,0,0,0,0,0,0
20200316,04930P,國巨統一94售08,0.80,1.17,0.73,1.17,+0.27,30.0,164000,12,171290,0,0,0,0,0,0,149000,0,149000,149000
20200316,049310,台積電凱基94購15,0.27,0.27,0.18,0.18,-0.16,-47.06,31000,2,5670,0,0,0,0,0,0,30000,1000,29000,29000
20200316,049311,漢唐凱基94購03,,,,,0.00,0.00,0,0,0,0,0,0,0,0,0,0,0,0,0
20200316,049312,亞光凱基94購02,,,,,0.00,0.00,0,0,0,0,0,0,0,0,0,0,0,0,0
20200316,049313,晶技凱基94購01,1.67,1.89,1.67,1.89,0.00,0.00,50000,11,87870,0,0,0,0,0,0,0,50000,-50000,-50000
20200316,049314,京鼎凱基94購01,0.53,0.59,0.24,0.24,0.00,0.00,172000,15,75180,0,0,0,0,0,0,37000,125000,-88000,-88000
20200316,049315,上緯控凱基94購03,,,,,0.00,0.00,0,0,0,0,0,0,0,0,0,0,0,0,0
20200316,049316,茂林凱基94購02,0.51,0.57,0.45,0.45,-0.03,-6.25,42000,19,21910,0,0,0,0,0,0,22000,10000,12000,12000
20200316,049317,啟碁凱基94購02,,,,,0.00,0.00,0,0,0,0,0,0,0,0,0,0,0,0,0
20200316,049318,樺漢凱基94購01,,,,,0.00,0.00,0,0,0,0,0,0,0,0,0,0,0,0,0
20200316,049319,GIS凱基94購03,,,,,0.00,0.00,0,0,0,0,0,0,0,0,0,0,0,0,0
20200316,04931P,臻鼎元富94售09,3.91,3.91,3.91,3.91,0.00,0.00,10000,2,39100,0,0,0,0,0,0,10000,0,10000,10000
20200316,049320,羅麗芬凱基94購01,,,,,0.00,0.00,0,0,0,0,0,0,0,0,0,0,0,0,0
20200316,049321,緯穎凱基94購02,11.70,11.70,10.90,10.90,+4.65,74.4,44000,9,507400,0,0,0,0,0,0,44000,0,44000,44000
20200316,049322,志超凱基94購02,,,,,0.00,0.00,0,0,0,0,0,0,0,0,0,0,0,0,0
20200316,049323,百和凱基94購01,,,,,0.00,0.00,0,0,0,0,0,0,0,0,0,0,0,0,0
20200316,049324,臺股指凱基94購06,,,,,0.00,0.00,0,0,0,0,0,0,0,0,0,0,0,0,0
20200316,049325,智邦元富94購02,0.11,0.11,0.11,0.11,+0.06,120.0,20000,1,2200,0,0,0,0,0,0,20000,0,20000,20000
20200316,049326,聯發科元富94購01,,,,,0.00,0.00,0,0,0,0,0,0,0,0,0,0,0,0,0
20200316,049327,台郡元富94購01,,,,,0.00,0.00,0,0,0,0,0,0,0,0,0,0,0,0,0
20200316,049328,元上證統一94購01,,,,,0.00,0.00,0,0,0,0,0,0,0,0,0,0,0,0,0
20200316,049329,元上證統一94購02,,,,,0.00,0.00,0,0,0,0,0,0,0,0,0,0,0,0,0
20200316,04932P,香港2X中信96售01,1.71,1.82,1.71,1.80,-0.15,-7.69,86000,10,153980,0,0,0,0,0,0,5000,81000,-76000,-76000
20200316,049330,元上證統一94購03,,,,,0.00,0.00,0,0,0,0,0,0,0,0,0,0,0,0,0
20200316,049331,元石油統一94購01,,,,,0.00,0.00,0,0,0,0,0,0,0,0,0,0,0,0,0
20200316,049332,深中小統一94購02,,,,,0.00,0.00,0,0,0,0,0,0,0,0,0,0,0,0,0
20200316,049333,深中小統一94購03,,,,,0.00,0.00,0,0,0,0,0,0,0,0,0,0,0,0,0
20200316,049334,上銀統一94購01,,,,,0.00,0.00,0,0,0,0,0,0,0,0,0,0,0,0,0
20200316,049335,聯電統一97購01,,,,,0.00,0.00,0,0,0,0,0,0,0,0,0,0,0,0,0
20200316,049336,台達電統一94購02,,,,,0.00,0.00,0,0,0,0,0,0,0,0,0,0,0,0,0
20200316,049337,台達電統一94購03,,,,,0.00,0.00,0,0,0,0,0,0,0,0,0,0,0,0,0
20200316,049338,台達電統一94購04,,,,,0.00,0.00,0,0,0,0,0,0,0,0,0,0,0,0,0
20200316,049339,鴻海統一94購02,,,,,0.00,0.00,0,0,0,0,0,0,0,0,0,0,0,0,0
20200316,04933P,中石化中信96售01,1.74,1.79,1.74,1.79,-0.13,-6.77,37000,3,64730,0,0,0,0,0,0,37000,0,37000,37000
20200316,049340,鴻海統一94購03,,,,,0.00,0.00,0,0,0,0,0,0,0,0,0,0,0,0,0
20200316,049341,旺宏統一95購01,,,,,0.00,0.00,0,0,0,0,0,0,0,0,0,0,0,0,0
20200316,049342,聯發科統一94購05,,,,,0.00,0.00,0,0,0,0,0,0,0,0,0,0,0,0,0
20200316,049343,華新科統一94購03,,,,,0.00,0.00,0,0,0,0,0,0,0,0,0,0,0,0,0
20200316,049344,華固統一94購01,,,,,0.00,0.00,0,0,0,0,0,0,0,0,0,0,0,0,0
20200316,049345,富邦金統一94購02,,,,,0.00,0.00,0,0,0,0,0,0,0,0,0,0,0,0,0
20200316,049346,新光金統一95購01,,,,,0.00,0.00,0,0,0,0,0,0,0,0,0,0,0,0,0
20200316,049347,群創統一95購01,,,,,0.00,0.00,0,0,0,0,0,0,0,0,0,0,0,0,0
20200316,049348,瑞昱台新94購01,,,,,0.00,0.00,0,0,0,0,0,0,0,0,0,0,0,0,0
20200316,049349,國巨康和94購01,,,,,0.00,0.00,0,0,0,0,0,0,0,0,0,0,0,0,0
20200316,04934P,鴻海中信94售05,,,,,0.00,0.00,0,0,0,0,0,0,0,0,0,0,0,0,0
20200316,049350,麗豐康和94購01,,,,,0.00,0.00,0,0,0,0,0,0,0,0,0,0,0,0,0
20200316,049351,揚明光永豐94購01,,,,,0.00,0.00,0,0,0,0,0,0,0,0,0,0,0,0,0
20200316,049352,泰鼎永豐95購01,1.42,1.45,1.42,1.45,+0.04,2.84,16000,5,22780,0,0,0,0,0,0,16000,0,16000,16000
20200316,049353,茂林永豐94購03,,,,,0.00,0.00,0,0,0,0,0,0,0,0,0,0,0,0,0
20200316,049354,致新永豐94購01,,,,,0.00,0.00,0,0,0,0,0,0,0,0,0,0,0,0,0
20200316,049355,元油2X富邦96購04,,,,,0.00,0.00,0,0,0,0,0,0,0,0,0,0,0,0,0
20200316,049356,台積電富邦94購05,,,,,0.00,0.00,0,0,0,0,0,0,0,0,0,0,0,0,0
20200316,049357,微星富邦94購01,,,,,0.00,0.00,0,0,0,0,0,0,0,0,0,0,0,0,0
20200316,049358,可成富邦94購01,,,,,0.00,0.00,0,0,0,0,0,0,0,0,0,0,0,0,0
20200316,049359,台達電元大94購06,,,,,0.00,0.00,0,0,0,0,0,0,0,0,0,0,0,0,0
20200316,04935P,鴻海中信96售01,0.82,1.06,0.82,1.06,+0.29,37.66,84000,8,86080,0,0,0,0,0,0,24000,55000,-31000,-31000
20200316,049360,台達電元大94購07,0.34,0.34,0.29,0.29,-0.05,-14.71,20000,2,6300,0,0,0,0,0,0,10000,10000,0,0
20200316,049361,華通元大94購02,0.05,0.05,0.05,0.05,+0.01,25.0,10000,1,500,0,0,0,0,0,0,10000,0,10000,10000
20200316,049362,國巨元大94購04,1.40,1.40,1.36,1.36,-0.14,-9.33,15000,2,20600,0,0,0,0,0,0,15000,0,15000,15000
20200316,049363,旺宏元大94購07,,,,,0.00,0.00,0,0,0,0,0,0,0,0,0,0,0,0,0
20200316,049364,燿華元大94購02,,,,,0.00,0.00,0,0,0,0,0,0,0,0,0,0,0,0,0
20200316,049365,美律元大94購04,,,,,0.00,0.00,0,0,0,0,0,0,0,0,0,0,0,0,0
20200316,049366,聯發科元大94購05,,,,,0.00,0.00,0,0,0,0,0,0,0,0,0,0,0,0,0
20200316,049367,全新元大96購01,,,,,0.00,0.00,0,0,0,0,0,0,0,0,0,0,0,0,0
20200316,049368,奇力新元大94購02,,,,,0.00,0.00,0,0,0,0,0,0,0,0,0,0,0,0,0
20200316,049369,義隆元大95購01,,,,,0.00,0.00,0,0,0,0,0,0,0,0,0,0,0,0,0
20200316,04936P,大立光中信95售03,0.84,0.94,0.84,0.94,+0.19,25.33,33000,4,29860,0,0,0,0,0,0,3000,30000,-27000,-27000
20200316,049370,可成元大94購03,,,,,0.00,0.00,0,0,0,0,0,0,0,0,0,0,0,0,0
20200316,049371,可成元大94購04,,,,,0.00,0.00,0,0,0,0,0,0,0,0,0,0,0,0,0
20200316,049372,華新科元大95購04,,,,,0.00,0.00,0,0,0,0,0,0,0,0,0,0,0,0,0
20200316,049373,大立光元大94購11,,,,,0.00,0.00,0,0,0,0,0,0,0,0,0,0,0,0,0
20200316,049374,大立光元大94購12,,,,,0.00,0.00,0,0,0,0,0,0,0,0,0,0,0,0,0
20200316,049375,大立光元大94購13,,,,,0.00,0.00,0,0,0,0,0,0,0,0,0,0,0,0,0
20200316,049376,奇鋐元大94購02,,,,,0.00,0.00,0,0,0,0,0,0,0,0,0,0,0,0,0
20200316,049377,聯詠元大94購01,0.46,0.48,0.35,0.35,0.00,0.00,30000,3,12900,0,0,0,0,0,0,0,30000,-30000,-30000
20200316,049378,聯詠元大94購02,0.58,0.58,0.33,0.33,-0.07,-17.5,30000,2,14900,0,0,0,0,0,0,20000,10000,10000,10000
20200316,049379,智原元大95購01,,,,,0.00,0.00,0,0,0,0,0,0,0,0,0,0,0,0,0
20200316,049380,欣興元大94購04,,,,,0.00,0.00,0,0,0,0,0,0,0,0,0,0,0,0,0
20200316,049381,欣興元大94購05,,,,,0.00,0.00,0,0,0,0,0,0,0,0,0,0,0,0,0
20200316,049382,牧德元大94購04,0.43,0.43,0.26,0.26,-0.09,-25.71,80000,7,24900,0,0,0,0,0,0,20000,60000,-40000,-40000
20200316,049383,健策元大95購01,1.53,1.53,1.25,1.25,-0.34,-21.38,27000,3,38510,0,0,0,0,0,0,10000,27000,-17000,-17000
20200316,049384,致伸元大94購02,,,,,0.00,0.00,0,0,0,0,0,0,0,0,0,0,0,0,0
20200316,049385,茂林元大94購03,1.52,1.52,0.80,0.80,-0.76,-48.72,59000,5,72450,0,0,0,0,0,0,39000,20000,19000,19000
20200316,049386,嘉聯益元大95購01,,,,,0.00,0.00,0,0,0,0,0,0,0,0,0,0,0,0,0
20200316,049387,緯穎元大94購03,5.60,5.60,5.60,5.60,-0.40,-6.67,4000,1,22400,0,0,0,0,0,0,0,4000,-4000,-4000
20200316,049388,南電元大94購05,,,,,0.00,0.00,0,0,0,0,0,0,0,0,0,0,0,0,0
20200316,049389,元石油中信97購02,0.06,0.08,0.06,0.08,-0.01,-11.11,95000,6,7400,0,0,0,0,0,0,0,0,0,0
20200316,04938P,亞德客國票95售01,,,,,0.00,0.00,0,0,0,0,0,0,0,0,0,0,0,0,0
20200316,049390,元油2X中信96購01,,,,,0.00,0.00,0,0,0,0,0,0,0,0,0,0,0,0,0
20200316,049391,廣宇中信94購01,,,,,0.00,0.00,0,0,0,0,0,0,0,0,0,0,0,0,0
20200316,049392,臺股指麥證94購01,0.01,0.01,0.01,0.01,0.00,0.00,120000,1,1200,120000,0,120000,0,0,0,120000,0,120000,120000
20200316,049393,世紀鋼第一94購01,,,,,0.00,0.00,0,0,0,0,0,0,0,0,0,0,0,0,0
20200316,049394,T50反1群益94購01,0.61,0.72,0.61,0.70,-0.37,-34.58,280000,28,196500,0,0,0,0,0,0,280000,280000,0,0
20200316,049395,元油2X群益94購03,,,,,0.00,0.00,0,0,0,0,0,0,0,0,0,0,0,0,0
20200316,049396,元油2X群益97購03,0.01,0.01,0.01,0.01,-0.01,-50.0,2000,1,20,0,0,0,0,0,0,0,0,0,0
20200316,049397,台達電群益94購03,,,,,0.00,0.00,0,0,0,0,0,0,0,0,0,0,0,0,0
20200316,049398,微星群益94購02,,,,,0.00,0.00,0,0,0,0,0,0,0,0,0,0,0,0,0
20200316,049399,台光電群益94購02,,,,,0.00,0.00,0,0,0,0,0,0,0,0,0,0,0,0,0
20200316,04939P,國巨國票95售03,,,,,0.00,0.00,0,0,0,0,0,0,0,0,0,0,0,0,0
20200316,049400,可成群益94購03,,,,,0.00,0.00,0,0,0,0,0,0,0,0,0,0,0,0,0
20200316,049401,可成群益94購04,,,,,0.00,0.00,0,0,0,0,0,0,0,0,0,0,0,0,0
20200316,049402,奇鋐群益95購02,,,,,0.00,0.00,0,0,0,0,0,0,0,0,0,0,0,0,0
20200316,049403,欣興群益94購03,,,,,0.00,0.00,0,0,0,0,0,0,0,0,0,0,0,0,0
20200316,049404,訊芯群益94購02,,,,,0.00,0.00,0,0,0,0,0,0,0,0,0,0,0,0,0
20200316,049405,羅麗芬群益94購02,,,,,0.00,0.00,0,0,0,0,0,0,0,0,0,0,0,0,0
20200316,049406,T50反1日盛97購01,0.86,1.20,0.80,1.20,+0.38,46.34,151000,10,149160,0,0,0,0,0,0,126000,0,126000,126000
20200316,049407,台積電日盛94購02,0.09,0.11,0.06,0.11,-0.06,-35.29,221000,4,16310,0,0,0,0,0,0,220000,0,220000,220000
20200316,049408,旺宏日盛94購01,0.04,0.04,0.04,0.04,0.00,0.00,2000,1,80,0,0,0,0,0,0,2000,0,2000,2000
20200316,049409,滬深2X凱基96購04,,,,,0.00,0.00,0,0,0,0,0,0,0,0,0,0,0,0,0
20200316,04940P,台積電國票95售02,,,,,0.00,0.00,0,0,0,0,0,0,0,0,0,0,0,0,0
20200316,049410,統一凱基94購02,,,,,0.00,0.00,0,0,0,0,0,0,0,0,0,0,0,0,0
20200316,049411,大成鋼凱基94購01,,,,,0.00,0.00,0,0,0,0,0,0,0,0,0,0,0,0,0
20200316,049412,為升凱基94購01,,,,,0.00,0.00,0,0,0,0,0,0,0,0,0,0,0,0,0
20200316,049413,台達電凱基94購06,,,,,0.00,0.00,0,0,0,0,0,0,0,0,0,0,0,0,0
20200316,049414,台積電凱基94購18,,,,,0.00,0.00,0,0,0,0,0,0,0,0,0,0,0,0,0
20200316,049415,智邦凱基94購02,,,,,0.00,0.00,0,0,0,0,0,0,0,0,0,0,0,0,0
20200316,049416,美律凱基94購04,,,,,0.00,0.00,0,0,0,0,0,0,0,0,0,0,0,0,0
20200316,049417,奇力新凱基94購02,0.10,0.10,0.10,0.10,0.00,0.00,1000,1,100,0,0,0,0,0,0,0,1000,-1000,-1000
20200316,049418,大立光凱基94購05,0.12,0.12,0.12,0.12,-0.06,-33.33,22000,3,2640,0,0,0,0,0,0,0,22000,-22000,-22000
20200316,049419,欣興凱基94購04,,,,,0.00,0.00,0,0,0,0,0,0,0,0,0,0,0,0,0
20200316,04941P,台達電台新94售02,,,,,0.00,0.00,0,0,0,0,0,0,0,0,0,0,0,0,0
20200316,049420,日電貿凱基94購01,,,,,0.00,0.00,0,0,0,0,0,0,0,0,0,0,0,0,0
20200316,049421,鎧勝凱基94購02,,,,,0.00,0.00,0,0,0,0,0,0,0,0,0,0,0,0,0
20200316,049422,矽創凱基94購01,,,,,0.00,0.00,0,0,0,0,0,0,0,0,0,0,0,0,0
20200316,049423,臺股指凱基95購02,,,,,0.00,0.00,0,0,0,0,0,0,0,0,0,0,0,0,0
20200316,049424,中石化兆豐94購01,,,,,0.00,0.00,0,0,0,0,0,0,0,0,0,0,0,0,0
20200316,049425,喬山兆豐95購01,,,,,0.00,0.00,0,0,0,0,0,0,0,0,0,0,0,0,0
20200316,049426,為升兆豐95購01,,,,,0.00,0.00,0,0,0,0,0,0,0,0,0,0,0,0,0
20200316,049427,瑞昱兆豐94購01,,,,,0.00,0.00,0,0,0,0,0,0,0,0,0,0,0,0,0
20200316,049428,力山國票94購02,,,,,0.00,0.00,0,0,0,0,0,0,0,0,0,0,0,0,0
20200316,049429,國巨國票95購01,4.43,4.43,3.66,3.66,+0.26,7.65,508000,3,2235040,0,0,0,0,0,0,498000,10000,488000,488000
20200316,04942P,台積電台新94售01,0.55,0.55,0.55,0.55,0.00,0.00,998000,2,548900,0,0,0,0,0,0,998000,998000,0,0
20200316,049430,國巨國票95購02,1.57,1.87,0.77,0.77,-0.80,-50.96,108000,23,166520,0,0,0,0,0,0,15000,10000,5000,5000
20200316,049431,光罩國票96購01,0.07,0.07,0.07,0.07,+0.01,16.67,20000,2,1400,0,0,0,0,0,0,20000,0,20000,20000
20200316,049432,聯詠國票95購01,,,,,0.00,0.00,0,0,0,0,0,0,0,0,0,0,0,0,0
20200316,049433,健策國票95購03,0.93,0.93,0.69,0.69,-0.34,-33.01,77000,4,67810,0,0,0,0,0,0,67000,10000,57000,57000
20200316,049434,茂林國票95購01,1.11,1.18,0.94,0.94,-0.14,-12.96,141000,10,155740,0,0,0,0,0,0,118000,0,118000,118000
20200316,049435,S&P反1國泰96購01,,,,,0.00,0.00,0,0,0,0,0,0,0,0,0,0,0,0,0
20200316,049436,義隆國泰96購02,0.41,0.41,0.33,0.35,-0.04,-10.26,12000,4,4780,0,0,0,0,0,0,12000,0,12000,12000
20200316,049437,可成國泰96購01,0.07,0.08,0.07,0.08,+0.01,14.29,75000,3,5900,0,0,0,0,0,0,0,0,0,0
20200316,049438,嘉晶國泰96購01,0.84,0.89,0.75,0.75,-0.05,-6.25,208000,8,181970,0,0,0,0,0,0,135000,0,135000,135000
20200316,049439,牧德國泰96購01,0.96,0.96,0.63,0.63,-0.46,-42.2,589000,24,471860,0,0,0,0,0,0,410000,376000,34000,34000
20200316,04943P,臻鼎康和94售01,,,,,0.00,0.00,0,0,0,0,0,0,0,0,0,0,0,0,0
20200316,049440,T50反1統一94購04,,,,,0.00,0.00,0,0,0,0,0,0,0,0,0,0,0,0,0
20200316,049441,T50反1統一94購05,,,,,0.00,0.00,0,0,0,0,0,0,0,0,0,0,0,0,0
20200316,049442,滬深2X統一99購01,,,,,0.00,0.00,0,0,0,0,0,0,0,0,0,0,0,0,0
20200316,049443,元石油統一94購02,,,,,0.00,0.00,0,0,0,0,0,0,0,0,0,0,0,0,0
20200316,049444,元石油統一94購03,,,,,0.00,0.00,0,0,0,0,0,0,0,0,0,0,0,0,0
20200316,049445,遠東新統一94購01,,,,,0.00,0.00,0,0,0,0,0,0,0,0,0,0,0,0,0
20200316,049446,為升統一94購01,,,,,0.00,0.00,0,0,0,0,0,0,0,0,0,0,0,0,0
20200316,049447,聯電統一94購01,0.84,0.84,0.84,0.84,+0.08,10.53,3000,1,2520,0,0,0,0,0,0,3000,0,3000,3000
20200316,049448,光磊統一94購01,,,,,0.00,0.00,0,0,0,0,0,0,0,0,0,0,0,0,0
20200316,049449,宏碁統一94購01,,,,,0.00,0.00,0,0,0,0,0,0,0,0,0,0,0,0,0
20200316,04944P,元油2X永豐94售06,,,,,0.00,0.00,0,0,0,0,0,0,0,0,0,0,0,0,0
20200316,049450,友達統一94購02,,,,,0.00,0.00,0,0,0,0,0,0,0,0,0,0,0,0,0
20200316,049451,富邦金統一94購03,,,,,0.00,0.00,0,0,0,0,0,0,0,0,0,0,0,0,0
20200316,049452,新光金統一94購02,,,,,0.00,0.00,0,0,0,0,0,0,0,0,0,0,0,0,0
20200316,049453,新日興統一94購01,,,,,0.00,0.00,0,0,0,0,0,0,0,0,0,0,0,0,0
20200316,049454,群創統一94購01,,,,,0.00,0.00,0,0,0,0,0,0,0,0,0,0,0,0,0
20200316,049455,上海銀統一94購02,,,,,0.00,0.00,0,0,0,0,0,0,0,0,0,0,0,0,0
20200316,049456,上海銀統一94購03,,,,,0.00,0.00,0,0,0,0,0,0,0,0,0,0,0,0,0
20200316,049457,彩晶統一94購02,,,,,0.00,0.00,0,0,0,0,0,0,0,0,0,0,0,0,0
20200316,049458,SP黃豆元富96購01,,,,,0.00,0.00,0,0,0,0,0,0,0,0,0,0,0,0,0
20200316,049459,全新元富95購02,,,,,0.00,0.00,0,0,0,0,0,0,0,0,0,0,0,0,0
20200316,04945P,鴻海永豐94售06,0.59,0.59,0.59,0.59,-0.05,-7.81,10000,2,5900,0,0,0,0,0,0,0,10000,-10000,-10000
20200316,049460,宏達電元富94購01,,,,,0.00,0.00,0,0,0,0,0,0,0,0,0,0,0,0,0
20200316,049461,嘉聯益元富94購01,,,,,0.00,0.00,0,0,0,0,0,0,0,0,0,0,0,0,0
20200316,049462,康友元富94購01,0.51,0.51,0.51,0.51,0.00,0.00,40000,4,20400,0,0,0,0,0,0,0,40000,-40000,-40000
20200316,049463,華新科富邦97購01,0.42,0.48,0.34,0.34,-0.08,-19.05,293000,33,120610,0,0,0,0,0,0,0,293000,-293000,-293000
20200316,049464,燿華台新95購01,,,,,0.00,0.00,0,0,0,0,0,0,0,0,0,0,0,0,0
20200316,049465,美律台新94購01,,,,,0.00,0.00,0,0,0,0,0,0,0,0,0,0,0,0,0
20200316,049466,創意台新94購01,,,,,0.00,0.00,0,0,0,0,0,0,0,0,0,0,0,0,0
20200316,049467,致伸台新94購01,,,,,0.00,0.00,0,0,0,0,0,0,0,0,0,0,0,0,0
20200316,049468,楠梓電康和94購01,,,,,0.00,0.00,0,0,0,0,0,0,0,0,0,0,0,0,0
20200316,049469,元金2X永豐94購01,0.28,0.28,0.28,0.28,-0.17,-37.78,10000,1,2800,0,0,0,0,0,0,10000,0,10000,10000
20200316,04946P,華通元大94售04,1.40,1.40,1.39,1.39,+0.14,11.2,13000,2,18170,0,0,0,0,0,0,13000,0,13000,13000
20200316,049470,楠梓電永豐94購03,,,,,0.00,0.00,0,0,0,0,0,0,0,0,0,0,0,0,0
20200316,049471,楠梓電永豐94購04,,,,,0.00,0.00,0,0,0,0,0,0,0,0,0,0,0,0,0
20200316,049472,楠梓電永豐95購01,,,,,0.00,0.00,0,0,0,0,0,0,0,0,0,0,0,0,0
20200316,049473,光罩永豐94購03,,,,,0.00,0.00,0,0,0,0,0,0,0,0,0,0,0,0,0
20200316,049474,台光電永豐94購02,,,,,0.00,0.00,0,0,0,0,0,0,0,0,0,0,0,0,0
20200316,049475,高鐵永豐94購01,,,,,0.00,0.00,0,0,0,0,0,0,0,0,0,0,0,0,0
20200316,049476,美食永豐94購02,,,,,0.00,0.00,0,0,0,0,0,0,0,0,0,0,0,0,0
20200316,049477,泰鼎永豐94購01,0.71,0.74,0.52,0.53,-0.13,-19.7,28000,14,18120,0,0,0,0,0,0,28000,0,28000,28000
20200316,049478,祥碩永豐94購02,1.79,1.96,1.79,1.96,+0.24,13.95,3000,3,5590,0,0,0,0,0,0,3000,0,3000,3000
20200316,049479,矽格永豐94購01,,,,,0.00,0.00,0,0,0,0,0,0,0,0,0,0,0,0,0
20200316,04947P,聯詠元大94售05,,,,,0.00,0.00,0,0,0,0,0,0,0,0,0,0,0,0,0
20200316,049480,同欣電永豐94購01,,,,,0.00,0.00,0,0,0,0,0,0,0,0,0,0,0,0,0
20200316,049481,為升元大94購03,,,,,0.00,0.00,0,0,0,0,0,0,0,0,0,0,0,0,0
20200316,049482,國巨元大94購06,1.33,1.33,1.27,1.27,-0.48,-27.43,20000,2,26000,0,0,0,0,0,0,0,20000,-20000,-20000
20200316,049483,台積電元大94購12,1.57,1.68,0.83,0.85,-1.05,-55.26,396000,73,535920,0,0,0,0,0,0,150000,246000,-96000,-96000
20200316,049484,台積電元大95購02,2.04,2.04,1.39,1.39,-0.65,-31.86,563000,79,872900,0,0,0,0,0,0,275000,259000,16000,16000
20200316,049485,台積電元大96購03,1.95,2.39,1.47,1.49,-0.69,-31.65,489000,64,877990,0,0,0,0,0,0,242000,249000,-7000,-7000
20200316,049486,旺宏元大94購08,,,,,0.00,0.00,0,0,0,0,0,0,0,0,0,0,0,0,0
20200316,049487,智邦元大94購03,,,,,0.00,0.00,0,0,0,0,0,0,0,0,0,0,0,0,0
20200316,049488,智邦元大95購01,0.27,0.29,0.25,0.25,0.00,0.00,60000,6,16300,0,0,0,0,0,0,0,60000,-60000,-60000
20200316,049489,美律元大94購05,,,,,0.00,0.00,0,0,0,0,0,0,0,0,0,0,0,0,0
20200316,04948P,瑞儀元大94售03,,,,,0.00,0.00,0,0,0,0,0,0,0,0,0,0,0,0,0
20200316,049490,京元電元大95購02,0.40,0.52,0.40,0.41,-0.09,-18.0,70000,8,30650,0,0,0,0,0,0,50000,30000,20000,20000
20200316,049491,聯發科元大95購01,0.16,0.18,0.06,0.07,-0.12,-63.16,3100000,206,380150,0,0,0,0,0,0,1210000,1870000,-660000,-660000
20200316,049492,聯發科元大95購02,,,,,0.00,0.00,0,0,0,0,0,0,0,0,0,0,0,0,0
20200316,049493,可成元大94購05,,,,,0.00,0.00,0,0,0,0,0,0,0,0,0,0,0,0,0
20200316,049494,華新科元大95購05,,,,,0.00,0.00,0,0,0,0,0,0,0,0,0,0,0,0,0
20200316,049495,欣興元大94購06,,,,,0.00,0.00,0,0,0,0,0,0,0,0,0,0,0,0,0
20200316,049496,和鑫元大95購01,,,,,0.00,0.00,0,0,0,0,0,0,0,0,0,0,0,0,0
20200316,049497,茂林元大94購04,0.96,0.96,0.79,0.79,-0.18,-18.56,80000,2,70000,0,0,0,0,0,0,80000,0,80000,80000
20200316,049498,茂林元大95購01,1.20,1.27,0.76,0.77,-0.45,-36.89,104000,8,116200,0,0,0,0,0,0,64000,40000,24000,24000
20200316,049499,康控元大96購01,,,,,0.00,0.00,0,0,0,0,0,0,0,0,0,0,0,0,0
20200316,04949P,致新元大94售04,1.14,1.23,1.14,1.23,0.00,0.00,20000,2,23700,0,0,0,0,0,0,10000,10000,0,0
20200316,049500,聯茂元大94購04,,,,,0.00,0.00,0,0,0,0,0,0,0,0,0,0,0,0,0
20200316,049501,台郡元大95購01,0.65,0.65,0.65,0.65,0.00,0.00,50000,1,32500,0,0,0,0,0,0,50000,0,50000,50000
20200316,049502,訊芯元大94購01,,,,,0.00,0.00,0,0,0,0,0,0,0,0,0,0,0,0,0
20200316,049503,矽創元大94購01,,,,,0.00,0.00,0,0,0,0,0,0,0,0,0,0,0,0,0
20200316,049504,臺股指元大94購15,0.09,0.09,0.07,0.07,-0.07,-50.0,106000,4,7680,0,0,0,0,0,0,49000,0,49000,49000
20200316,049505,臺股指元大94購16,0.23,0.27,0.12,0.13,-0.22,-62.86,577000,49,116130,0,0,0,0,0,0,129000,344000,-215000,-215000
20200316,049506,可成日盛94購02,,,,,0.00,0.00,0,0,0,0,0,0,0,0,0,0,0,0,0
20200316,049507,和大凱基94購01,,,,,0.00,0.00,0,0,0,0,0,0,0,0,0,0,0,0,0
20200316,049508,上銀凱基94購04,,,,,0.00,0.00,0,0,0,0,0,0,0,0,0,0,0,0,0
20200316,049509,台達電凱基94購07,,,,,0.00,0.00,0,0,0,0,0,0,0,0,0,0,0,0,0
20200316,04950P,上証2X中信96售02,0.53,0.54,0.53,0.54,+0.09,20.0,25000,4,13350,0,0,0,0,0,0,20000,5000,15000,15000
20200316,049510,楠梓電凱基94購01,,,,,0.00,0.00,0,0,0,0,0,0,0,0,0,0,0,0,0
20200316,049511,奇力新凱基94購03,,,,,0.00,0.00,0,0,0,0,0,0,0,0,0,0,0,0,0
20200316,049512,可成凱基94購06,,,,,0.00,0.00,0,0,0,0,0,0,0,0,0,0,0,0,0
20200316,049513,宏達電凱基94購03,,,,,0.00,0.00,0,0,0,0,0,0,0,0,0,0,0,0,0
20200316,049514,奇鋐凱基94購01,,,,,0.00,0.00,0,0,0,0,0,0,0,0,0,0,0,0,0
20200316,049515,同欣電凱基94購01,,,,,0.00,0.00,0,0,0,0,0,0,0,0,0,0,0,0,0
20200316,049516,光罩國票94購02,,,,,0.00,0.00,0,0,0,0,0,0,0,0,0,0,0,0,0
20200316,049517,台光電國票94購02,,,,,0.00,0.00,0,0,0,0,0,0,0,0,0,0,0,0,0
20200316,049518,宏達電國票95購02,,,,,0.00,0.00,0,0,0,0,0,0,0,0,0,0,0,0,0
20200316,049519,新光金國票95購03,,,,,0.00,0.00,0,0,0,0,0,0,0,0,0,0,0,0,0
20200316,04951P,緯創中信94售01,0.87,0.87,0.87,0.87,-0.16,-15.53,8000,1,6960,0,0,0,0,0,0,8000,0,8000,8000
20200316,049520,TPK國票95購01,,,,,0.00,0.00,0,0,0,0,0,0,0,0,0,0,0,0,0
20200316,049521,致伸國票95購01,,,,,0.00,0.00,0,0,0,0,0,0,0,0,0,0,0,0,0
20200316,049522,華通兆豐94購02,0.01,0.02,0.01,0.02,0.00,0.00,20000,11,300,0,0,0,0,0,0,10000,5000,5000,5000
20200316,049523,微星兆豐94購02,,,,,0.00,0.00,0,0,0,0,0,0,0,0,0,0,0,0,0
20200316,049524,可成兆豐95購02,,,,,0.00,0.00,0,0,0,0,0,0,0,0,0,0,0,0,0
20200316,049525,華新科兆豐94購01,,,,,0.00,0.00,0,0,0,0,0,0,0,0,0,0,0,0,0
20200316,049526,緯穎兆豐95購01,3.24,3.24,3.24,3.24,+0.76,30.65,6000,1,19440,0,0,0,0,0,0,6000,0,6000,6000
20200316,049527,國巨中信95購01,0.72,0.72,0.35,0.35,-0.37,-51.39,60000,3,37800,0,0,0,0,0,0,60000,0,60000,60000
20200316,049528,台積電中信94購01,0.25,0.28,0.19,0.19,+0.07,58.33,40000,3,9100,0,0,0,0,0,0,30000,10000,20000,20000
20200316,049529,華新科中信95購01,,,,,0.00,0.00,0,0,0,0,0,0,0,0,0,0,0,0,0
20200316,04952P,台光電亞東94售01,,,,,0.00,0.00,0,0,0,0,0,0,0,0,0,0,0,0,0
20200316,049530,上銀台新94購01,,,,,0.00,0.00,0,0,0,0,0,0,0,0,0,0,0,0,0
20200316,049531,聯詠台新94購01,,,,,0.00,0.00,0,0,0,0,0,0,0,0,0,0,0,0,0
20200316,049532,同欣電台新94購01,,,,,0.00,0.00,0,0,0,0,0,0,0,0,0,0,0,0,0
20200316,049533,美食永豐94購03,,,,,0.00,0.00,0,0,0,0,0,0,0,0,0,0,0,0,0
20200316,049534,華擎永豐94購02,,,,,0.00,0.00,0,0,0,0,0,0,0,0,0,0,0,0,0
20200316,049535,臻鼎永豐94購01,,,,,0.00,0.00,0,0,0,0,0,0,0,0,0,0,0,0,0
20200316,049536,T50反1群益94購02,0.74,0.74,0.74,0.74,-0.39,-34.51,10000,1,7400,0,0,0,0,0,0,10000,10000,0,0
20200316,049537,元石油群益97購01,0.05,0.05,0.04,0.04,-0.01,-20.0,1054000,16,46100,0,0,0,0,0,0,0,0,0,0
20200316,049538,元油2X群益98購01,0.06,0.07,0.05,0.07,-0.05,-41.67,264000,9,16100,0,0,0,0,0,0,0,0,0,0
20200316,049539,元油2X群益9A購01,0.18,0.18,0.18,0.18,0.00,0.00,59000,3,10620,0,0,0,0,0,0,0,0,0,0
20200316,04953P,台積電群益94售13,2.24,2.89,2.10,2.89,+0.64,28.44,216000,25,511780,0,0,0,0,0,0,49000,155000,-106000,-106000
20200316,049540,楠梓電群益94購01,,,,,0.00,0.00,0,0,0,0,0,0,0,0,0,0,0,0,0
20200316,049541,楠梓電群益94購02,,,,,0.00,0.00,0,0,0,0,0,0,0,0,0,0,0,0,0
20200316,049542,鴻海群益94購05,,,,,0.00,0.00,0,0,0,0,0,0,0,0,0,0,0,0,0
20200316,049543,國巨群益94購04,,,,,0.00,0.00,0,0,0,0,0,0,0,0,0,0,0,0,0
20200316,049544,台積電群益94購08,0.88,0.88,0.65,0.65,-0.64,-49.61,25000,2,19700,0,0,0,0,0,0,25000,0,25000,25000
20200316,049545,台積電群益94購09,0.01,0.01,0.01,0.01,-0.01,-50.0,5000,5,50,0,0,0,0,0,0,0,0,0,0
20200316,049546,正崴群益94購01,,,,,0.00,0.00,0,0,0,0,0,0,0,0,0,0,0,0,0
20200316,049547,新光金群益94購01,,,,,0.00,0.00,0,0,0,0,0,0,0,0,0,0,0,0,0
20200316,049548,群創群益94購01,,,,,0.00,0.00,0,0,0,0,0,0,0,0,0,0,0,0,0
20200316,049549,瀚宇博群益94購01,,,,,0.00,0.00,0,0,0,0,0,0,0,0,0,0,0,0,0
20200316,04954P,健策國票96售01,1.03,1.14,1.03,1.14,-0.01,-0.87,15000,2,16000,0,0,0,0,0,0,5000,10000,-5000,-5000
20200316,049550,柏文群益94購01,,,,,0.00,0.00,0,0,0,0,0,0,0,0,0,0,0,0,0
20200316,049551,電子類群益94購01,0.24,0.28,0.18,0.18,0.00,0.00,720000,36,180600,0,0,0,0,0,0,300000,300000,0,0
20200316,049552,鴻海國泰96購01,0.75,0.75,0.75,0.75,-0.38,-33.63,20000,1,15000,0,0,0,0,0,0,0,20000,-20000,-20000
20200316,049553,鴻海國泰96購02,1.11,1.16,0.90,0.90,-0.40,-30.77,284000,14,305160,0,0,0,0,0,0,192000,32000,160000,160000
20200316,049554,禾伸堂富邦96購01,0.40,0.40,0.31,0.31,0.00,0.00,126000,3,39150,0,0,0,0,0,0,126000,0,126000,126000
20200316,049555,台表科富邦94購01,,,,,0.00,0.00,0,0,0,0,0,0,0,0,0,0,0,0,0
20200316,049556,智易元富94購01,,,,,0.00,0.00,0,0,0,0,0,0,0,0,0,0,0,0,0
20200316,049557,南電元富94購02,,,,,0.00,0.00,0,0,0,0,0,0,0,0,0,0,0,0,0
20200316,049558,深中小統一94購04,,,,,0.00,0.00,0,0,0,0,0,0,0,0,0,0,0,0,0
20200316,049559,香港反統一94購02,0.90,0.90,0.90,0.90,-0.24,-21.05,10000,1,9000,0,0,0,0,0,0,0,10000,-10000,-10000
20200316,04955P,大立光日盛94售02,0.77,0.77,0.77,0.77,-0.13,-14.44,64000,1,49280,0,0,0,0,0,0,64000,0,64000,64000
20200316,049560,香港反統一95購01,,,,,0.00,0.00,0,0,0,0,0,0,0,0,0,0,0,0,0
20200316,049561,道瓊銀統一96購01,0.11,0.11,0.11,0.11,+0.07,175.0,10000,1,1100,0,0,0,0,0,0,0,10000,-10000,-10000
20200316,049562,和大統一94購01,,,,,0.00,0.00,0,0,0,0,0,0,0,0,0,0,0,0,0
20200316,049563,華新統一95購01,,,,,0.00,0.00,0,0,0,0,0,0,0,0,0,0,0,0,0
20200316,049564,聯電統一94購03,,,,,0.00,0.00,0,0,0,0,0,0,0,0,0,0,0,0,0
20200316,049565,楠梓電統一94購01,,,,,0.00,0.00,0,0,0,0,0,0,0,0,0,0,0,0,0
20200316,049566,鴻海統一94購04,,,,,0.00,0.00,0,0,0,0,0,0,0,0,0,0,0,0,0
20200316,049567,鴻海統一94購05,,,,,0.00,0.00,0,0,0,0,0,0,0,0,0,0,0,0,0
20200316,049568,台積電統一94購08,,,,,0.00,0.00,0,0,0,0,0,0,0,0,0,0,0,0,0
20200316,049569,光磊統一94購02,,,,,0.00,0.00,0,0,0,0,0,0,0,0,0,0,0,0,0
20200316,04956P,臺股指日盛94售02,19.40,19.50,19.40,19.50,0.00,0.00,30000,2,584000,0,0,0,0,0,0,30000,0,30000,30000
20200316,049570,華新科統一94購04,,,,,0.00,0.00,0,0,0,0,0,0,0,0,0,0,0,0,0
20200316,049571,華固統一94購02,,,,,0.00,0.00,0,0,0,0,0,0,0,0,0,0,0,0,0
20200316,049572,華固統一94購03,2.39,2.54,2.39,2.54,0.00,0.00,30000,3,74700,0,0,0,0,0,0,0,30000,-30000,-30000
20200316,049573,長榮航統一95購01,,,,,0.00,0.00,0,0,0,0,0,0,0,0,0,0,0,0,0
20200316,049574,新日興統一94購03,,,,,0.00,0.00,0,0,0,0,0,0,0,0,0,0,0,0,0
20200316,049575,美食康和94購02,,,,,0.00,0.00,0,0,0,0,0,0,0,0,0,0,0,0,0
20200316,049576,元油2X元大94購06,,,,,0.00,0.00,0,0,0,0,0,0,0,0,0,0,0,0,0
20200316,049577,台達電元大94購08,,,,,0.00,0.00,0,0,0,0,0,0,0,0,0,0,0,0,0
20200316,049578,台達電元大94購09,,,,,0.00,0.00,0,0,0,0,0,0,0,0,0,0,0,0,0
20200316,049579,鴻海元大94購06,1.08,1.18,0.77,0.77,0.00,0.00,31000,4,27780,0,0,0,0,0,0,31000,31000,0,0
20200316,04957P,上証2X凱基96售02,2.33,2.42,2.33,2.42,+0.42,21.0,4000,2,9590,0,0,0,0,0,0,0,4000,-4000,-4000
20200316,049580,國巨元大94購07,1.08,1.08,1.03,1.03,-0.10,-8.85,20000,2,21100,0,0,0,0,0,0,20000,0,20000,20000
20200316,049581,國巨元大94購08,,,,,0.00,0.00,0,0,0,0,0,0,0,0,0,0,0,0,0
20200316,049582,台積電元大95購03,1.09,1.16,0.74,0.74,-0.56,-43.08,386000,39,352600,0,0,0,0,0,0,190000,191000,-1000,-1000
20200316,049583,台積電元大95購04,0.40,0.45,0.25,0.25,-0.29,-53.7,321000,27,114500,0,0,0,0,0,0,45000,86000,-41000,-41000
20200316,049584,台積電元大96購04,1.01,1.20,0.88,0.90,-0.11,-10.89,50000,17,49110,0,0,0,0,0,0,8000,10000,-2000,-2000
20200316,049585,旺宏元大95購02,0.24,0.24,0.12,0.12,-0.07,-36.84,63000,7,14200,0,0,0,0,0,0,8000,55000,-47000,-47000
20200316,049586,正崴元大94購01,,,,,0.00,0.00,0,0,0,0,0,0,0,0,0,0,0,0,0
20200316,049587,美律元大95購01,0.18,0.20,0.14,0.14,+0.07,100.0,154000,13,25860,0,0,0,0,0,0,94000,110000,-16000,-16000
20200316,049588,聯發科元大94購06,,,,,0.00,0.00,0,0,0,0,0,0,0,0,0,0,0,0,0
20200316,049589,奇力新元大95購02,0.67,0.67,0.37,0.37,-0.03,-7.5,38000,5,19770,0,0,0,0,0,0,33000,33000,0,0
20200316,04958P,和大凱基94售04,2.00,2.22,1.99,2.22,+0.19,9.36,60000,6,124100,0,0,0,0,0,0,40000,20000,20000,20000
20200316,049590,華新科元大94購01,,,,,0.00,0.00,0,0,0,0,0,0,0,0,0,0,0,0,0
20200316,049591,開發金元大98購01,0.21,0.21,0.20,0.20,+0.04,25.0,15000,2,3050,0,0,0,0,0,0,0,15000,-15000,-15000
20200316,049592,欣興元大96購01,,,,,0.00,0.00,0,0,0,0,0,0,0,0,0,0,0,0,0
20200316,049593,群創元大9A購01,0.35,0.35,0.28,0.29,-0.05,-14.71,92000,5,29450,0,0,0,0,0,0,63000,29000,34000,34000
20200316,049594,揚明光元大95購01,,,,,0.00,0.00,0,0,0,0,0,0,0,0,0,0,0,0,0
20200316,049595,麗豐元大95購01,,,,,0.00,0.00,0,0,0,0,0,0,0,0,0,0,0,0,0
20200316,049596,智伸科元大95購01,,,,,0.00,0.00,0,0,0,0,0,0,0,0,0,0,0,0,0
20200316,049597,泰鼎元大96購01,1.52,1.52,1.20,1.20,-0.08,-6.25,75000,8,100350,0,0,0,0,0,0,10000,65000,-55000,-55000
20200316,049598,超眾元大95購03,0.07,0.08,0.05,0.05,0.00,0.00,40000,4,2800,0,0,0,0,0,0,10000,30000,-20000,-20000
20200316,049599,樺漢元大95購01,0.40,0.40,0.21,0.21,-0.21,-50.0,140000,11,40400,0,0,0,0,0,0,60000,80000,-20000,-20000
20200316,04959P,可成凱基94售14,,,,,0.00,0.00,0,0,0,0,0,0,0,0,0,0,0,0,0
20200316,049600,緯穎元大95購02,3.98,3.98,3.19,3.19,-0.36,-10.14,19000,3,71560,0,0,0,0,0,0,19000,4000,15000,15000
20200316,049601,矽創元大95購02,0.08,0.09,0.06,0.06,-0.02,-25.0,800000,80,68100,0,0,0,0,0,0,0,800000,-800000,-800000
20200316,049602,南電元大95購01,0.27,0.29,0.16,0.16,-0.03,-15.79,29000,4,6900,0,0,0,0,0,0,10000,19000,-9000,-9000
20200316,049603,富邦金亞東94購01,,,,,0.00,0.00,0,0,0,0,0,0,0,0,0,0,0,0,0
20200316,049604,創意亞東94購02,,,,,0.00,0.00,0,0,0,0,0,0,0,0,0,0,0,0,0
20200316,049605,旺宏第一94購01,,,,,0.00,0.00,0,0,0,0,0,0,0,0,0,0,0,0,0
20200316,049606,可成第一94購01,,,,,0.00,0.00,0,0,0,0,0,0,0,0,0,0,0,0,0
20200316,049607,台積電兆豐94購04,0.07,0.07,0.07,0.07,-0.05,-41.67,10000,1,700,0,0,0,0,0,0,0,10000,-10000,-10000
20200316,049608,旺宏兆豐94購02,,,,,0.00,0.00,0,0,0,0,0,0,0,0,0,0,0,0,0
20200316,049609,全新兆豐95購01,,,,,0.00,0.00,0,0,0,0,0,0,0,0,0,0,0,0,0
20200316,04960P,大立光凱基96售04,1.71,1.80,1.71,1.80,-0.35,-16.28,622000,5,1106540,0,0,0,0,0,0,2000,620000,-618000,-618000
20200316,049610,奇力新兆豐95購01,0.67,0.81,0.47,0.47,-0.07,-12.96,29000,5,19670,0,0,0,0,0,0,5000,19000,-14000,-14000
20200316,049611,緯穎兆豐95購02,3.10,3.10,2.80,2.95,+0.94,46.77,22000,13,65060,0,0,0,0,0,0,12000,10000,2000,2000
20200316,049612,香港反中信96購01,0.82,0.99,0.75,0.94,+0.11,13.25,70000,8,60860,0,0,0,0,0,0,5000,55000,-50000,-50000
20200316,049613,華通中信94購01,0.14,0.14,0.14,0.14,-0.07,-33.33,12000,1,1680,0,0,0,0,0,0,12000,0,12000,12000
20200316,049614,聯茂中信94購01,,,,,0.00,0.00,0,0,0,0,0,0,0,0,0,0,0,0,0
20200316,049615,香港2X群益98購01,,,,,0.00,0.00,0,0,0,0,0,0,0,0,0,0,0,0,0
20200316,049616,卜蜂群益94購01,,,,,0.00,0.00,0,0,0,0,0,0,0,0,0,0,0,0,0
20200316,049617,光罩群益94購03,0.03,0.03,0.03,0.03,0.00,0.00,200000,20,6000,0,0,0,0,0,0,0,200000,-200000,-200000
20200316,049618,美律群益94購03,,,,,0.00,0.00,0,0,0,0,0,0,0,0,0,0,0,0,0
20200316,049619,宏達電群益95購02,0.02,0.02,0.02,0.02,-0.01,-33.33,20000,1,400,0,0,0,0,0,0,20000,0,20000,20000
20200316,04961P,貿聯凱基94售03,2.01,2.29,2.01,2.29,+0.12,5.53,32000,4,68300,0,0,0,0,0,0,9000,23000,-14000,-14000
20200316,049620,美食群益94購01,,,,,0.00,0.00,0,0,0,0,0,0,0,0,0,0,0,0,0
20200316,049621,美食群益94購02,,,,,0.00,0.00,0,0,0,0,0,0,0,0,0,0,0,0,0
20200316,049622,聯詠群益94購02,0.18,0.18,0.18,0.18,-0.16,-47.06,190000,1,34200,0,0,0,0,0,0,190000,0,190000,190000
20200316,049623,創意群益94購01,,,,,0.00,0.00,0,0,0,0,0,0,0,0,0,0,0,0,0
20200316,049624,嘉澤群益94購01,,,,,0.00,0.00,0,0,0,0,0,0,0,0,0,0,0,0,0
20200316,049625,智易群益95購01,,,,,0.00,0.00,0,0,0,0,0,0,0,0,0,0,0,0,0
20200316,049626,健策群益94購01,,,,,0.00,0.00,0,0,0,0,0,0,0,0,0,0,0,0,0
20200316,049627,嘉聯益群益94購02,,,,,0.00,0.00,0,0,0,0,0,0,0,0,0,0,0,0,0
20200316,049628,臺股指群益94購01,,,,,0.00,0.00,0,0,0,0,0,0,0,0,0,0,0,0,0
20200316,049629,臺股指群益94購02,,,,,0.00,0.00,0,0,0,0,0,0,0,0,0,0,0,0,0
20200316,04962P,易華電凱基96售01,,,,,0.00,0.00,0,0,0,0,0,0,0,0,0,0,0,0,0
20200316,049630,臺股指群益94購03,,,,,0.00,0.00,0,0,0,0,0,0,0,0,0,0,0,0,0
20200316,049631,臺股指群益94購04,,,,,0.00,0.00,0,0,0,0,0,0,0,0,0,0,0,0,0
20200316,049632,臺股指群益94購05,0.17,0.17,0.17,0.17,0.00,0.00,1000,1,170,0,0,0,0,0,0,0,0,0,0
20200316,049633,臺股指群益94購06,,,,,0.00,0.00,0,0,0,0,0,0,0,0,0,0,0,0,0
20200316,049634,臺股指群益94購07,,,,,0.00,0.00,0,0,0,0,0,0,0,0,0,0,0,0,0
20200316,049635,臺股指群益94購08,,,,,0.00,0.00,0,0,0,0,0,0,0,0,0,0,0,0,0
20200316,049636,上証反凱基9A購01,0.56,0.66,0.56,0.66,+0.06,10.0,364000,7,224670,0,0,0,0,0,0,105000,254000,-149000,-149000
20200316,049637,元石油凱基94購01,,,,,0.00,0.00,0,0,0,0,0,0,0,0,0,0,0,0,0
20200316,049638,A50反1凱基94購01,,,,,0.00,0.00,0,0,0,0,0,0,0,0,0,0,0,0,0
20200316,049639,力山凱基94購03,,,,,0.00,0.00,0,0,0,0,0,0,0,0,0,0,0,0,0
20200316,04963P,鴻海元大94售25,3.05,4.11,3.05,4.11,+1.31,46.79,228000,24,759520,0,0,0,0,0,0,78000,165000,-87000,-87000
20200316,049640,大成鋼凱基94購02,,,,,0.00,0.00,0,0,0,0,0,0,0,0,0,0,0,0,0
20200316,049641,台達電凱基94購08,0.21,0.21,0.13,0.13,-0.12,-48.0,150000,3,25500,0,0,0,0,0,0,0,150000,-150000,-150000
20200316,049642,鴻海凱基94購16,,,,,0.00,0.00,0,0,0,0,0,0,0,0,0,0,0,0,0
20200316,049643,華泰凱基94購01,,,,,0.00,0.00,0,0,0,0,0,0,0,0,0,0,0,0,0
20200316,049644,台積電凱基94購21,,,,,0.00,0.00,0,0,0,0,0,0,0,0,0,0,0,0,0
20200316,049645,台積電凱基94購22,,,,,0.00,0.00,0,0,0,0,0,0,0,0,0,0,0,0,0
20200316,049646,旺宏凱基94購01,,,,,0.00,0.00,0,0,0,0,0,0,0,0,0,0,0,0,0
20200316,049647,美食凱基94購01,,,,,0.00,0.00,0,0,0,0,0,0,0,0,0,0,0,0,0
20200316,049648,大立光凱基94購08,,,,,0.00,0.00,0,0,0,0,0,0,0,0,0,0,0,0,0
20200316,049649,信邦凱基94購01,0.02,0.02,0.02,0.02,0.00,0.00,280000,2,5600,0,0,0,0,0,0,280000,0,280000,280000
20200316,04964P,鴻海元大94售26,3.06,3.45,3.06,3.45,+0.81,30.68,23000,3,75450,0,0,0,0,0,0,16000,13000,3000,3000
20200316,049650,啟碁凱基94購03,,,,,0.00,0.00,0,0,0,0,0,0,0,0,0,0,0,0,0
20200316,049651,訊芯凱基94購04,,,,,0.00,0.00,0,0,0,0,0,0,0,0,0,0,0,0,0
20200316,049652,GIS凱基94購05,,,,,0.00,0.00,0,0,0,0,0,0,0,0,0,0,0,0,0
20200316,049653,緯穎凱基94購03,4.62,4.62,4.19,4.19,+2.07,97.64,33000,4,144290,0,0,0,0,0,0,23000,10000,13000,13000
20200316,049654,臺股指凱基94購15,,,,,0.00,0.00,0,0,0,0,0,0,0,0,0,0,0,0,0
20200316,049655,臺股指凱基94購16,,,,,0.00,0.00,0,0,0,0,0,0,0,0,0,0,0,0,0
20200316,049656,臺股指凱基94購17,,,,,0.00,0.00,0,0,0,0,0,0,0,0,0,0,0,0,0
20200316,049657,滬深2X台新94購01,,,,,0.00,0.00,0,0,0,0,0,0,0,0,0,0,0,0,0
20200316,049658,國巨台新95購01,,,,,0.00,0.00,0,0,0,0,0,0,0,0,0,0,0,0,0
20200316,049659,旺宏台新95購01,,,,,0.00,0.00,0,0,0,0,0,0,0,0,0,0,0,0,0
20200316,04965P,日月光元大94售02,,,,,0.00,0.00,0,0,0,0,0,0,0,0,0,0,0,0,0
20200316,049660,奇鋐台新94購01,,,,,0.00,0.00,0,0,0,0,0,0,0,0,0,0,0,0,0
20200316,049661,喬山永豐94購01,,,,,0.00,0.00,0,0,0,0,0,0,0,0,0,0,0,0,0
20200316,049662,燿華永豐95購02,,,,,0.00,0.00,0,0,0,0,0,0,0,0,0,0,0,0,0
20200316,049663,正崴永豐94購01,,,,,0.00,0.00,0,0,0,0,0,0,0,0,0,0,0,0,0
20200316,049664,聯發科永豐94購03,,,,,0.00,0.00,0,0,0,0,0,0,0,0,0,0,0,0,0
20200316,049665,TPK永昌95購01,,,,,0.00,0.00,0,0,0,0,0,0,0,0,0,0,0,0,0
20200316,049666,臺股指永昌94購01,,,,,0.00,0.00,0,0,0,0,0,0,0,0,0,0,0,0,0
20200316,049667,大立光國泰96購01,0.37,0.37,0.23,0.24,-0.16,-40.0,37000,11,10620,0,0,0,0,0,0,0,37000,-37000,-37000
20200316,049668,大立光國泰96購02,0.43,0.43,0.26,0.26,-0.24,-48.0,86000,10,24080,0,0,0,0,0,0,1000,85000,-84000,-84000
20200316,049669,訊芯國泰95購01,,,,,0.00,0.00,0,0,0,0,0,0,0,0,0,0,0,0,0
20200316,04966P,台表科元大94售04,1.03,1.38,1.03,1.38,+0.17,14.05,31000,4,38040,0,0,0,0,0,0,11000,20000,-9000,-9000
20200316,049670,鈺齊國泰96購01,,,,,0.00,0.00,0,0,0,0,0,0,0,0,0,0,0,0,0
20200316,049671,上証2X富邦95購01,0.16,0.16,0.16,0.16,0.00,0.00,50000,5,8000,0,0,0,0,0,0,0,50000,-50000,-50000
20200316,049672,臺股指富邦94購01,,,,,0.00,0.00,0,0,0,0,0,0,0,0,0,0,0,0,0
20200316,049673,臺股指富邦94購02,,,,,0.00,0.00,0,0,0,0,0,0,0,0,0,0,0,0,0
20200316,049674,國巨元富94購02,1.36,1.36,1.36,1.36,+0.15,12.4,29000,1,39440,0,0,0,0,0,0,29000,0,29000,29000
20200316,049675,台光電國票95購01,,,,,0.00,0.00,0,0,0,0,0,0,0,0,0,0,0,0,0
20200316,049676,美食國票94購01,,,,,0.00,0.00,0,0,0,0,0,0,0,0,0,0,0,0,0
20200316,049677,臺股指國票94購10,,,,,0.00,0.00,0,0,0,0,0,0,0,0,0,0,0,0,0
20200316,049678,臺股指國票94購11,0.04,0.04,0.04,0.04,0.00,0.00,1000,1,40,0,0,0,0,0,0,1000,0,1000,1000
20200316,049679,臺股指國票94購12,,,,,0.00,0.00,0,0,0,0,0,0,0,0,0,0,0,0,0
20200316,04967P,台表科永豐94售04,,,,,0.00,0.00,0,0,0,0,0,0,0,0,0,0,0,0,0
20200316,049680,臺股指國票94購13,,,,,0.00,0.00,0,0,0,0,0,0,0,0,0,0,0,0,0
20200316,049681,旺宏統一94購04,0.05,0.05,0.05,0.05,0.00,0.00,55000,1,2750,0,0,0,0,0,0,55000,0,55000,55000
20200316,049682,友達統一94購03,,,,,0.00,0.00,0,0,0,0,0,0,0,0,0,0,0,0,0
20200316,049683,美食統一94購01,,,,,0.00,0.00,0,0,0,0,0,0,0,0,0,0,0,0,0
20200316,049684,彩晶統一95購01,,,,,0.00,0.00,0,0,0,0,0,0,0,0,0,0,0,0,0
20200316,049685,T50反1元大94購01,,,,,0.00,0.00,0,0,0,0,0,0,0,0,0,0,0,0,0
20200316,049686,T50反1元大94購02,,,,,0.00,0.00,0,0,0,0,0,0,0,0,0,0,0,0,0
20200316,049687,國巨元大94購09,,,,,0.00,0.00,0,0,0,0,0,0,0,0,0,0,0,0,0
20200316,049688,台光電元大94購04,0.14,0.14,0.14,0.14,-0.01,-6.67,10000,1,1400,0,0,0,0,0,0,0,10000,-10000,-10000
20200316,049689,正崴元大94購02,,,,,0.00,0.00,0,0,0,0,0,0,0,0,0,0,0,0,0
20200316,04968P,台積電富邦94售06,,,,,0.00,0.00,0,0,0,0,0,0,0,0,0,0,0,0,0
20200316,049690,義隆元大95購02,0.10,0.10,0.10,0.10,0.00,0.00,72000,1,7200,0,0,0,0,0,0,72000,0,72000,72000
20200316,049691,可成元大94購06,,,,,0.00,0.00,0,0,0,0,0,0,0,0,0,0,0,0,0
20200316,049692,可成元大94購07,,,,,0.00,0.00,0,0,0,0,0,0,0,0,0,0,0,0,0
20200316,049693,可成元大94購08,,,,,0.00,0.00,0,0,0,0,0,0,0,0,0,0,0,0,0
20200316,049694,華新科元大95購06,0.50,0.50,0.34,0.34,-0.05,-12.82,323000,9,126810,0,0,0,0,0,0,313000,307000,6000,6000
20200316,049695,新光金元大9A購01,,,,,0.00,0.00,0,0,0,0,0,0,0,0,0,0,0,0,0
20200316,049696,欣興元大95購02,,,,,0.00,0.00,0,0,0,0,0,0,0,0,0,0,0,0,0
20200316,049697,群創元大98購01,0.17,0.17,0.17,0.17,0.00,0.00,200000,2,34000,0,0,0,0,0,0,200000,0,200000,200000
20200316,049698,TPK元大95購01,,,,,0.00,0.00,0,0,0,0,0,0,0,0,0,0,0,0,0
20200316,049699,祥碩元大94購01,,,,,0.00,0.00,0,0,0,0,0,0,0,0,0,0,0,0,0
20200316,04969P,道瓊銀統一94售02,,,,,0.00,0.00,0,0,0,0,0,0,0,0,0,0,0,0,0
20200316,049700,瀚宇博元大97購01,0.92,1.00,0.92,1.00,+0.08,8.7,12000,2,11840,0,0,0,0,0,0,12000,0,12000,12000
20200316,049701,聯茂元大94購05,,,,,0.00,0.00,0,0,0,0,0,0,0,0,0,0,0,0,0
20200316,049702,台表科元大95購03,1.70,1.85,1.13,1.13,-0.43,-27.56,93000,10,150660,0,0,0,0,0,0,53000,43000,10000,10000
20200316,049703,訊芯元大95購01,,,,,0.00,0.00,0,0,0,0,0,0,0,0,0,0,0,0,0
20200316,049704,羅麗芬元大95購01,,,,,0.00,0.00,0,0,0,0,0,0,0,0,0,0,0,0,0
20200316,049705,緯穎元大94購05,5.40,5.40,5.40,5.40,+3.13,137.89,10000,1,54000,0,0,0,0,0,0,0,10000,-10000,-10000
20200316,049706,世紀鋼元大95購02,0.90,0.96,0.80,0.80,0.00,0.00,428000,45,389560,0,0,0,0,0,0,253000,133000,120000,120000
20200316,049707,華通麥證94購02,,,,,0.00,0.00,0,0,0,0,0,0,0,0,0,0,0,0,0
20200316,049708,滬深2X凱基94購02,,,,,0.00,0.00,0,0,0,0,0,0,0,0,0,0,0,0,0
20200316,049709,力山凱基94購04,,,,,0.00,0.00,0,0,0,0,0,0,0,0,0,0,0,0,0
20200316,04970P,中環元富94售02,,,,,0.00,0.00,0,0,0,0,0,0,0,0,0,0,0,0,0
20200316,049710,大成鋼凱基94購03,,,,,0.00,0.00,0,0,0,0,0,0,0,0,0,0,0,0,0
20200316,049711,劍麟凱基94購01,,,,,0.00,0.00,0,0,0,0,0,0,0,0,0,0,0,0,0
20200316,049712,為升凱基94購03,,,,,0.00,0.00,0,0,0,0,0,0,0,0,0,0,0,0,0
20200316,049713,鴻海凱基94購17,0.59,0.59,0.59,0.59,-0.09,-13.24,10000,1,5900,0,0,0,0,0,0,10000,0,10000,10000
20200316,049714,國巨凱基94購02,0.32,0.32,0.32,0.32,0.00,0.00,10000,1,3200,0,0,0,0,0,0,10000,0,10000,10000
20200316,049715,華泰凱基94購02,,,,,0.00,0.00,0,0,0,0,0,0,0,0,0,0,0,0,0
20200316,049716,台積電凱基94購24,,,,,0.00,0.00,0,0,0,0,0,0,0,0,0,0,0,0,0
20200316,049717,微星凱基94購01,,,,,0.00,0.00,0,0,0,0,0,0,0,0,0,0,0,0,0
20200316,049718,南亞科凱基94購04,,,,,0.00,0.00,0,0,0,0,0,0,0,0,0,0,0,0,0
20200316,049719,義隆凱基94購03,,,,,0.00,0.00,0,0,0,0,0,0,0,0,0,0,0,0,0
20200316,04971P,矽力元富94售02,0.63,0.80,0.63,0.80,+0.31,63.27,7000,4,4690,0,0,0,0,0,0,5000,0,5000,5000
20200316,049720,欣興凱基94購05,,,,,0.00,0.00,0,0,0,0,0,0,0,0,0,0,0,0,0
20200316,049721,晶技凱基94購02,0.60,0.80,0.48,0.48,+0.03,6.67,315000,36,183730,0,0,0,0,0,0,150000,165000,-15000,-15000
20200316,049722,易華電凱基94購03,,,,,0.00,0.00,0,0,0,0,0,0,0,0,0,0,0,0,0
20200316,049723,緯穎凱基94購04,4.90,4.90,4.82,4.82,+1.82,60.67,26000,3,125710,0,0,0,0,0,0,26000,0,26000,26000
20200316,049724,南電第一94購01,,,,,0.00,0.00,0,0,0,0,0,0,0,0,0,0,0,0,0
20200316,049725,台郡國票94購03,,,,,0.00,0.00,0,0,0,0,0,0,0,0,0,0,0,0,0
20200316,049726,道瓊反中信96購01,2.80,2.82,2.80,2.82,+0.19,7.22,30000,3,84200,0,0,0,0,0,0,0,30000,-30000,-30000
20200316,049727,台積電中信94購02,,,,,0.00,0.00,0,0,0,0,0,0,0,0,0,0,0,0,0
20200316,049728,正崴中信94購01,,,,,0.00,0.00,0,0,0,0,0,0,0,0,0,0,0,0,0
20200316,049729,日月光中信94購01,,,,,0.00,0.00,0,0,0,0,0,0,0,0,0,0,0,0,0
20200316,04972P,緯穎元富94售03,,,,,0.00,0.00,0,0,0,0,0,0,0,0,0,0,0,0,0
20200316,049730,滬深2X群益94購02,,,,,0.00,0.00,0,0,0,0,0,0,0,0,0,0,0,0,0
20200316,049731,A50正2群益94購02,,,,,0.00,0.00,0,0,0,0,0,0,0,0,0,0,0,0,0
20200316,049732,國巨群益94購05,,,,,0.00,0.00,0,0,0,0,0,0,0,0,0,0,0,0,0
20200316,049733,旺宏群益94購03,,,,,0.00,0.00,0,0,0,0,0,0,0,0,0,0,0,0,0
20200316,049734,瑞昱群益94購02,,,,,0.00,0.00,0,0,0,0,0,0,0,0,0,0,0,0,0
20200316,049735,台光電群益94購03,,,,,0.00,0.00,0,0,0,0,0,0,0,0,0,0,0,0,0
20200316,049736,宏達電群益95購03,,,,,0.00,0.00,0,0,0,0,0,0,0,0,0,0,0,0,0
20200316,049737,美食群益94購03,,,,,0.00,0.00,0,0,0,0,0,0,0,0,0,0,0,0,0
20200316,049738,神基群益94購01,0.24,0.24,0.24,0.24,+0.11,84.62,20000,2,4800,0,0,0,0,0,0,0,20000,-20000,-20000
20200316,049739,大立光群益94購05,,,,,0.00,0.00,0,0,0,0,0,0,0,0,0,0,0,0,0
20200316,04973P,台積電凱基94售41,0.88,1.07,0.88,1.07,0.00,0.00,924000,13,889850,0,0,0,0,0,0,450000,924000,-474000,-474000
20200316,049740,禾伸堂群益94購01,,,,,0.00,0.00,0,0,0,0,0,0,0,0,0,0,0,0,0
20200316,049741,創意群益94購02,,,,,0.00,0.00,0,0,0,0,0,0,0,0,0,0,0,0,0
20200316,049742,日月光群益94購02,,,,,0.00,0.00,0,0,0,0,0,0,0,0,0,0,0,0,0
20200316,049743,全新台新94購01,,,,,0.00,0.00,0,0,0,0,0,0,0,0,0,0,0,0,0
20200316,049744,亞德客永豐94購01,,,,,0.00,0.00,0,0,0,0,0,0,0,0,0,0,0,0,0
20200316,049745,國巨永豐94購04,0.07,0.07,0.05,0.05,-0.01,-16.67,171000,13,10650,0,0,0,0,0,0,0,130000,-130000,-130000
20200316,049746,全新永豐95購01,,,,,0.00,0.00,0,0,0,0,0,0,0,0,0,0,0,0,0
20200316,049747,嘉晶永豐94購02,,,,,0.00,0.00,0,0,0,0,0,0,0,0,0,0,0,0,0
20200316,049748,智原永豐94購01,,,,,0.00,0.00,0,0,0,0,0,0,0,0,0,0,0,0,0
20200316,049749,創意永豐94購01,,,,,0.00,0.00,0,0,0,0,0,0,0,0,0,0,0,0,0
20200316,04974P,聯發科凱基96售02,,,,,0.00,0.00,0,0,0,0,0,0,0,0,0,0,0,0,0
20200316,049750,揚明光永豐94購02,,,,,0.00,0.00,0,0,0,0,0,0,0,0,0,0,0,0,0
20200316,049751,牧德永豐95購01,0.50,0.50,0.50,0.50,+0.08,19.05,10000,1,5000,0,0,0,0,0,0,0,10000,-10000,-10000
20200316,049752,上緯控永豐94購02,,,,,0.00,0.00,0,0,0,0,0,0,0,0,0,0,0,0,0
20200316,049753,傳奇永豐94購01,,,,,0.00,0.00,0,0,0,0,0,0,0,0,0,0,0,0,0
20200316,049754,豐祥永豐94購01,,,,,0.00,0.00,0,0,0,0,0,0,0,0,0,0,0,0,0
20200316,049755,中磊永豐94購02,,,,,0.00,0.00,0,0,0,0,0,0,0,0,0,0,0,0,0
20200316,049756,瀚宇博永豐94購01,,,,,0.00,0.00,0,0,0,0,0,0,0,0,0,0,0,0,0
20200316,049757,聯茂永豐94購01,,,,,0.00,0.00,0,0,0,0,0,0,0,0,0,0,0,0,0
20200316,049758,GIS永豐94購01,,,,,0.00,0.00,0,0,0,0,0,0,0,0,0,0,0,0,0
20200316,049759,元黃金富邦9A購01,2.07,2.20,1.95,2.09,-0.07,-3.24,142000,14,296990,0,0,0,0,0,0,60000,81000,-21000,-21000
20200316,04975P,華新科凱基96售02,1.44,1.49,1.44,1.49,-0.39,-20.74,30000,4,43700,0,0,0,0,0,0,0,25000,-25000,-25000
20200316,049760,滬深2X國泰95購02,,,,,0.00,0.00,0,0,0,0,0,0,0,0,0,0,0,0,0
20200316,049761,亞德客國泰95購03,1.40,1.73,1.27,1.27,+0.06,4.96,372000,14,553350,0,0,0,0,0,0,195000,140000,55000,55000
20200316,049762,華邦電國泰95購01,0.11,0.11,0.09,0.09,-0.01,-10.0,180000,4,18400,0,0,0,0,0,0,120000,60000,60000,60000
20200316,049763,美食國泰96購01,0.02,0.02,0.02,0.02,-0.02,-50.0,10000,1,200,0,0,0,0,0,0,0,10000,-10000,-10000
20200316,049764,TPK國泰95購01,,,,,0.00,0.00,0,0,0,0,0,0,0,0,0,0,0,0,0
20200316,049765,上証2X元富94購01,,,,,0.00,0.00,0,0,0,0,0,0,0,0,0,0,0,0,0
20200316,049766,滬深2X元富94購02,0.13,0.13,0.13,0.13,-0.16,-55.17,20000,1,2600,0,0,0,0,0,0,0,0,0,0
20200316,049767,奇力新元富94購01,,,,,0.00,0.00,0,0,0,0,0,0,0,0,0,0,0,0,0
20200316,049768,奇鋐元富94購01,,,,,0.00,0.00,0,0,0,0,0,0,0,0,0,0,0,0,0
20200316,049769,和鑫元富96購01,0.06,0.06,0.06,0.06,0.00,0.00,36000,4,2160,0,0,0,0,0,0,0,36000,-36000,-36000
20200316,04976P,中磊凱基94售01,,,,,0.00,0.00,0,0,0,0,0,0,0,0,0,0,0,0,0
20200316,049770,康控元富95購01,,,,,0.00,0.00,0,0,0,0,0,0,0,0,0,0,0,0,0
20200316,049771,GIS元富94購02,,,,,0.00,0.00,0,0,0,0,0,0,0,0,0,0,0,0,0
20200316,049772,臺股指元富94購01,,,,,0.00,0.00,0,0,0,0,0,0,0,0,0,0,0,0,0
20200316,049773,臺股指元富94購02,,,,,0.00,0.00,0,0,0,0,0,0,0,0,0,0,0,0,0
20200316,049774,元油2X統一94購05,,,,,0.00,0.00,0,0,0,0,0,0,0,0,0,0,0,0,0
20200316,049775,旺宏統一95購02,,,,,0.00,0.00,0,0,0,0,0,0,0,0,0,0,0,0,0
20200316,049776,全新統一95購02,,,,,0.00,0.00,0,0,0,0,0,0,0,0,0,0,0,0,0
20200316,049777,華新科統一94購06,,,,,0.00,0.00,0,0,0,0,0,0,0,0,0,0,0,0,0
20200316,049778,宏達電統一94購02,,,,,0.00,0.00,0,0,0,0,0,0,0,0,0,0,0,0,0
20200316,049779,創意統一95購01,,,,,0.00,0.00,0,0,0,0,0,0,0,0,0,0,0,0,0
20200316,04977P,力成凱基96售01,0.90,1.04,0.83,1.04,+0.16,18.18,637000,20,599950,0,0,0,0,0,0,344000,291000,53000,53000
20200316,049780,智易統一94購02,,,,,0.00,0.00,0,0,0,0,0,0,0,0,0,0,0,0,0
20200316,049781,台表科統一94購01,,,,,0.00,0.00,0,0,0,0,0,0,0,0,0,0,0,0,0
20200316,049782,世紀鋼統一94購01,,,,,0.00,0.00,0,0,0,0,0,0,0,0,0,0,0,0,0
20200316,049783,元油2X兆豐95購01,,,,,0.00,0.00,0,0,0,0,0,0,0,0,0,0,0,0,0
20200316,049784,台積電兆豐94購05,2.38,2.38,1.47,1.47,-0.48,-24.62,42000,5,87170,0,0,0,0,0,0,20000,22000,-2000,-2000
20200316,049785,華新科兆豐95購01,0.04,0.04,0.02,0.02,-0.03,-60.0,95000,8,3100,0,0,0,0,0,0,30000,60000,-30000,-30000
20200316,049786,奇鋐兆豐94購01,,,,,0.00,0.00,0,0,0,0,0,0,0,0,0,0,0,0,0
20200316,049787,麗豐兆豐94購01,,,,,0.00,0.00,0,0,0,0,0,0,0,0,0,0,0,0,0
20200316,049788,智伸科兆豐95購01,,,,,0.00,0.00,0,0,0,0,0,0,0,0,0,0,0,0,0
20200316,049789,世紀鋼兆豐94購01,0.82,0.86,0.67,0.72,-0.02,-2.7,704000,60,558410,0,0,0,0,0,0,412000,130000,282000,282000
20200316,04978P,台表科凱基94售02,1.65,1.66,1.65,1.66,0.00,0.00,13000,2,21520,0,0,0,0,0,0,0,13000,-13000,-13000
20200316,049790,滬深2X元大97購04,,,,,0.00,0.00,0,0,0,0,0,0,0,0,0,0,0,0,0
20200316,049791,元油2X元大94購07,,,,,0.00,0.00,0,0,0,0,0,0,0,0,0,0,0,0,0
20200316,049792,元油2X元大94購08,,,,,0.00,0.00,0,0,0,0,0,0,0,0,0,0,0,0,0
20200316,049793,為升元大94購04,,,,,0.00,0.00,0,0,0,0,0,0,0,0,0,0,0,0,0
20200316,049794,台達電元大94購10,,,,,0.00,0.00,0,0,0,0,0,0,0,0,0,0,0,0,0
20200316,049795,華通元大96購02,0.12,0.12,0.08,0.08,-0.01,-11.11,100000,6,10100,0,0,0,0,0,0,50000,50000,0,0
20200316,049796,國巨元大94購10,0.95,0.95,0.76,0.76,-0.27,-26.21,45000,2,39900,0,0,0,0,0,0,45000,0,45000,45000
20200316,049797,台積電元大94購17,0.31,0.31,0.14,0.14,-0.09,-39.13,850000,25,217800,0,0,0,0,0,0,655000,195000,460000,460000
20200316,049798,台積電元大94購18,0.15,0.15,0.15,0.15,-0.08,-34.78,110000,3,16500,0,0,0,0,0,0,90000,0,90000,90000
20200316,049799,旺宏元大96購01,,,,,0.00,0.00,0,0,0,0,0,0,0,0,0,0,0,0,0
20200316,04979P,臺股指凱基96售07,3.11,3.62,3.11,3.62,-0.95,-20.79,26000,3,88220,0,0,0,0,0,0,26000,0,26000,26000
20200316,049800,瑞昱元大94購05,,,,,0.00,0.00,0,0,0,0,0,0,0,0,0,0,0,0,0
20200316,049801,可成元大94購09,,,,,0.00,0.00,0,0,0,0,0,0,0,0,0,0,0,0,0
20200316,049802,可成元大94購10,,,,,0.00,0.00,0,0,0,0,0,0,0,0,0,0,0,0,0
20200316,049803,華新科元大95購07,0.35,0.40,0.30,0.30,-0.01,-3.23,22000,8,7900,0,0,0,0,0,0,8000,14000,-6000,-6000
20200316,049804,華固元大94購01,0.57,0.65,0.57,0.60,+0.04,7.14,58000,6,35200,0,0,0,0,0,0,10000,48000,-38000,-38000
20200316,049805,美食元大94購02,,,,,0.00,0.00,0,0,0,0,0,0,0,0,0,0,0,0,0
20200316,049806,臺企銀元大94購01,,,,,0.00,0.00,0,0,0,0,0,0,0,0,0,0,0,0,0
20200316,049807,新光金元大96購02,,,,,0.00,0.00,0,0,0,0,0,0,0,0,0,0,0,0,0
20200316,049808,聯詠元大94購03,0.86,1.02,0.86,1.02,0.00,0.00,40000,3,37300,0,0,0,0,0,0,20000,20000,0,0
20200316,049809,聯詠元大94購04,0.92,0.94,0.74,0.74,+0.16,27.59,30000,3,26000,0,0,0,0,0,0,0,30000,-30000,-30000
20200316,04980P,臺股指凱基96售08,2.95,3.79,2.31,3.18,+0.23,7.8,473000,109,1460880,0,0,0,0,0,0,14000,0,14000,14000
20200316,049810,欣興元大95購03,,,,,0.00,0.00,0,0,0,0,0,0,0,0,0,0,0,0,0
20200316,049811,聯鈞元大94購01,1.72,1.96,1.69,1.75,+0.11,6.71,70000,8,127520,0,0,0,0,0,0,69000,1000,68000,68000
20200316,049812,致伸元大94購03,,,,,0.00,0.00,0,0,0,0,0,0,0,0,0,0,0,0,0
20200316,049813,康控元大96購02,,,,,0.00,0.00,0,0,0,0,0,0,0,0,0,0,0,0,0
20200316,049814,超眾元大95購04,,,,,0.00,0.00,0,0,0,0,0,0,0,0,0,0,0,0,0
20200316,049815,緯穎元大94購06,7.85,8.20,7.60,7.60,+3.19,72.34,94000,6,750400,0,0,0,0,0,0,90000,4000,86000,86000
20200316,049816,緯穎元大94購07,,,,,0.00,0.00,0,0,0,0,0,0,0,0,0,0,0,0,0
20200316,049817,南電元大94購07,,,,,0.00,0.00,0,0,0,0,0,0,0,0,0,0,0,0,0
20200316,049818,柏文元大94購01,,,,,0.00,0.00,0,0,0,0,0,0,0,0,0,0,0,0,0
20200316,049819,百和元大94購02,,,,,0.00,0.00,0,0,0,0,0,0,0,0,0,0,0,0,0
20200316,04981P,華新科亞東94售01,,,,,0.00,0.00,0,0,0,0,0,0,0,0,0,0,0,0,0
20200316,049820,世紀鋼元大96購03,1.15,1.15,1.00,1.00,+0.01,1.01,198000,23,220500,0,0,0,0,0,0,161000,37000,124000,124000
20200316,049821,中石化凱基94購02,,,,,0.00,0.00,0,0,0,0,0,0,0,0,0,0,0,0,0
20200316,049822,大成鋼凱基94購04,,,,,0.00,0.00,0,0,0,0,0,0,0,0,0,0,0,0,0
20200316,049823,為升凱基94購04,,,,,0.00,0.00,0,0,0,0,0,0,0,0,0,0,0,0,0
20200316,049824,鴻海凱基94購18,,,,,0.00,0.00,0,0,0,0,0,0,0,0,0,0,0,0,0
20200316,049825,台積電凱基94購26,,,,,0.00,0.00,0,0,0,0,0,0,0,0,0,0,0,0,0
20200316,049826,光磊凱基94購02,,,,,0.00,0.00,0,0,0,0,0,0,0,0,0,0,0,0,0
20200316,049827,正崴凱基94購01,,,,,0.00,0.00,0,0,0,0,0,0,0,0,0,0,0,0,0
20200316,049828,華新科凱基94購06,,,,,0.00,0.00,0,0,0,0,0,0,0,0,0,0,0,0,0
20200316,049829,裕民凱基94購01,0.01,0.01,0.01,0.01,0.00,0.00,79000,1,790,0,0,0,0,0,0,79000,0,79000,79000
20200316,04982P,臺股指中信94售03,,,,,0.00,0.00,0,0,0,0,0,0,0,0,0,0,0,0,0
20200316,049830,智易凱基94購02,,,,,0.00,0.00,0,0,0,0,0,0,0,0,0,0,0,0,0
20200316,049831,日月光凱基94購01,,,,,0.00,0.00,0,0,0,0,0,0,0,0,0,0,0,0,0
20200316,049832,麗豐凱基94購05,,,,,0.00,0.00,0,0,0,0,0,0,0,0,0,0,0,0,0
20200316,049833,正文凱基94購05,,,,,0.00,0.00,0,0,0,0,0,0,0,0,0,0,0,0,0
20200316,049834,康控凱基94購01,,,,,0.00,0.00,0,0,0,0,0,0,0,0,0,0,0,0,0
20200316,049835,緯穎凱基94購05,4.16,4.16,3.44,3.44,+1.09,46.38,172000,22,661820,0,0,0,0,0,0,162000,10000,152000,152000
20200316,049836,矽創凱基94購02,,,,,0.00,0.00,0,0,0,0,0,0,0,0,0,0,0,0,0
20200316,049837,臺股指凱基96購02,0.02,0.02,0.02,0.02,0.00,0.00,50000,2,1000,0,0,0,0,0,0,0,2000,-2000,-2000
20200316,049838,友達亞東94購01,,,,,0.00,0.00,0,0,0,0,0,0,0,0,0,0,0,0,0
20200316,049839,聯發科亞東94購02,,,,,0.00,0.00,0,0,0,0,0,0,0,0,0,0,0,0,0
20200316,04983P,臺股指康和94售03,,,,,0.00,0.00,0,0,0,0,0,0,0,0,0,0,0,0,0
20200316,049840,亞光亞東94購01,,,,,0.00,0.00,0,0,0,0,0,0,0,0,0,0,0,0,0
20200316,049841,國巨第一94購01,,,,,0.00,0.00,0,0,0,0,0,0,0,0,0,0,0,0,0
20200316,049842,道瓊反中信98購01,,,,,0.00,0.00,0,0,0,0,0,0,0,0,0,0,0,0,0
20200316,049843,康友中信95購01,0.28,0.28,0.17,0.17,-0.14,-45.16,50000,7,13020,0,0,0,0,0,0,20000,30000,-10000,-10000
20200316,049844,國巨麥證94購01,,,,,0.00,0.00,0,0,0,0,0,0,0,0,0,0,0,0,0
20200316,049845,台積電麥證94購01,0.30,0.30,0.21,0.23,+0.08,53.33,280000,6,63100,280000,0,280000,0,0,0,280000,0,280000,280000
20200316,049846,台泥群益94購01,,,,,0.00,0.00,0,0,0,0,0,0,0,0,0,0,0,0,0
20200316,049847,旺宏群益94購04,,,,,0.00,0.00,0,0,0,0,0,0,0,0,0,0,0,0,0
20200316,049848,聯發科群益94購06,,,,,0.00,0.00,0,0,0,0,0,0,0,0,0,0,0,0,0
20200316,049849,欣興群益94購04,,,,,0.00,0.00,0,0,0,0,0,0,0,0,0,0,0,0,0
20200316,04984P,臺股指康和94售04,,,,,0.00,0.00,0,0,0,0,0,0,0,0,0,0,0,0,0
20200316,049850,上緯控群益94購01,,,,,0.00,0.00,0,0,0,0,0,0,0,0,0,0,0,0,0
20200316,049851,致伸群益94購03,,,,,0.00,0.00,0,0,0,0,0,0,0,0,0,0,0,0,0
20200316,049852,康控群益94購03,,,,,0.00,0.00,0,0,0,0,0,0,0,0,0,0,0,0,0
20200316,049853,上海銀群益94購02,,,,,0.00,0.00,0,0,0,0,0,0,0,0,0,0,0,0,0
20200316,049854,超眾群益94購02,,,,,0.00,0.00,0,0,0,0,0,0,0,0,0,0,0,0,0
20200316,049855,台表科群益94購01,,,,,0.00,0.00,0,0,0,0,0,0,0,0,0,0,0,0,0
20200316,049856,緯穎群益94購02,6.55,6.55,6.10,6.10,+1.33,27.88,17000,7,107300,0,0,0,0,0,0,17000,0,17000,17000
20200316,049857,緯穎群益94購03,7.25,7.25,6.65,6.65,+3.30,98.51,54000,20,379050,0,0,0,0,0,0,54000,0,54000,54000
20200316,049858,百和群益94購05,,,,,0.00,0.00,0,0,0,0,0,0,0,0,0,0,0,0,0
20200316,049859,味全兆豐95購01,,,,,0.00,0.00,0,0,0,0,0,0,0,0,0,0,0,0,0
20200316,04985P,景碩永豐94售02,,,,,0.00,0.00,0,0,0,0,0,0,0,0,0,0,0,0,0
20200316,049860,亞德客兆豐94購01,0.41,0.44,0.41,0.42,0.00,0.00,159000,4,67930,0,0,0,0,0,0,0,159000,-159000,-159000
20200316,049861,正崴兆豐94購01,,,,,0.00,0.00,0,0,0,0,0,0,0,0,0,0,0,0,0
20200316,049862,南亞科兆豐94購01,0.07,0.07,0.07,0.07,-0.01,-12.5,10000,1,700,0,0,0,0,0,0,10000,0,10000,10000
20200316,049863,京元電兆豐94購01,,,,,0.00,0.00,0,0,0,0,0,0,0,0,0,0,0,0,0
20200316,049864,聯發科兆豐94購01,0.19,0.20,0.16,0.16,-0.03,-15.79,353000,8,65930,0,0,0,0,0,0,340000,213000,127000,127000
20200316,049865,和鑫兆豐95購01,,,,,0.00,0.00,0,0,0,0,0,0,0,0,0,0,0,0,0
20200316,049866,景碩兆豐94購01,0.19,0.19,0.10,0.10,-0.04,-28.57,30000,3,3900,0,0,0,0,0,0,10000,20000,-10000,-10000
20200316,049867,日月光兆豐94購01,,,,,0.00,0.00,0,0,0,0,0,0,0,0,0,0,0,0,0
20200316,049868,傳奇兆豐94購01,,,,,0.00,0.00,0,0,0,0,0,0,0,0,0,0,0,0,0
20200316,049869,訊芯兆豐94購01,,,,,0.00,0.00,0,0,0,0,0,0,0,0,0,0,0,0,0
20200316,04986P,茂林永豐94售05,,,,,0.00,0.00,0,0,0,0,0,0,0,0,0,0,0,0,0
20200316,049870,南電兆豐94購01,0.08,0.08,0.08,0.08,0.00,0.00,65000,1,5200,0,0,0,0,0,0,65000,0,65000,65000
20200316,049871,T50反1台新9A購02,1.14,1.37,1.14,1.25,-0.74,-37.19,61000,4,71350,0,0,0,0,0,0,60000,0,60000,60000
20200316,049872,聯發科台新94購03,0.15,0.15,0.10,0.10,+0.02,25.0,171000,18,23250,0,0,0,0,0,0,171000,171000,0,0
20200316,049873,華新科台新94購02,,,,,0.00,0.00,0,0,0,0,0,0,0,0,0,0,0,0,0
20200316,049874,全新康和94購01,,,,,0.00,0.00,0,0,0,0,0,0,0,0,0,0,0,0,0
20200316,049875,台積電永豐94購04,0.09,0.09,0.04,0.04,-0.05,-55.56,272000,15,14530,0,0,0,0,0,0,0,65000,-65000,-65000
20200316,049876,智邦永豐94購01,,,,,0.00,0.00,0,0,0,0,0,0,0,0,0,0,0,0,0
20200316,049877,南亞科永豐94購01,,,,,0.00,0.00,0,0,0,0,0,0,0,0,0,0,0,0,0
20200316,049878,宏達電永豐94購01,,,,,0.00,0.00,0,0,0,0,0,0,0,0,0,0,0,0,0
20200316,049879,奇鋐永豐94購02,,,,,0.00,0.00,0,0,0,0,0,0,0,0,0,0,0,0,0
20200316,04987P,昇陽半永豐94售04,2.43,2.43,2.43,2.43,0.00,0.00,2000,1,4860,0,0,0,0,0,0,0,2000,-2000,-2000
20200316,049880,健策永豐94購02,,,,,0.00,0.00,0,0,0,0,0,0,0,0,0,0,0,0,0
20200316,049881,TPK永豐94購02,,,,,0.00,0.00,0,0,0,0,0,0,0,0,0,0,0,0,0
20200316,049882,康控永豐94購01,,,,,0.00,0.00,0,0,0,0,0,0,0,0,0,0,0,0,0
20200316,049883,台表科永豐94購02,,,,,0.00,0.00,0,0,0,0,0,0,0,0,0,0,0,0,0
20200316,049884,訊芯永豐94購01,,,,,0.00,0.00,0,0,0,0,0,0,0,0,0,0,0,0,0
20200316,049885,緯穎永豐94購01,1.39,1.62,1.32,1.32,+0.21,18.92,89000,14,135830,0,0,0,0,0,0,58000,1000,57000,57000
20200316,049886,華通永昌95購01,,,,,0.00,0.00,0,0,0,0,0,0,0,0,0,0,0,0,0
20200316,049887,嘉聯益永昌95購01,,,,,0.00,0.00,0,0,0,0,0,0,0,0,0,0,0,0,0
20200316,049888,智邦國泰96購01,0.81,0.81,0.59,0.61,-0.04,-6.15,950000,15,619390,0,0,0,0,0,0,950000,20000,930000,930000
20200316,049889,欣興國泰96購01,,,,,0.00,0.00,0,0,0,0,0,0,0,0,0,0,0,0,0
20200316,04988P,楠梓電元大94售01,,,,,0.00,0.00,0,0,0,0,0,0,0,0,0,0,0,0,0
20200316,049890,嘉澤國泰95購01,,,,,0.00,0.00,0,0,0,0,0,0,0,0,0,0,0,0,0
20200316,049891,T50反1富邦94購02,1.72,1.72,1.72,1.72,-0.13,-7.03,6000,1,10320,0,0,0,0,0,0,6000,0,6000,6000
20200316,049892,國巨富邦96購01,0.65,0.65,0.50,0.50,-0.10,-16.67,4000,3,2300,0,0,0,0,0,0,1000,0,1000,1000
20200316,049893,日月光富邦98購01,0.14,0.14,0.14,0.14,0.00,0.00,10000,1,1400,0,0,0,0,0,0,10000,0,10000,10000
20200316,049894,嘉聯益富邦98購01,0.12,0.12,0.12,0.12,-0.01,-7.69,107000,2,12840,0,0,0,0,0,0,0,107000,-107000,-107000
20200316,049895,國巨統一94購04,,,,,0.00,0.00,0,0,0,0,0,0,0,0,0,0,0,0,0
20200316,049896,聯發科統一94購06,,,,,0.00,0.00,0,0,0,0,0,0,0,0,0,0,0,0,0
20200316,049897,華新科統一94購07,,,,,0.00,0.00,0,0,0,0,0,0,0,0,0,0,0,0,0
20200316,049898,緯穎統一95購01,2.62,2.62,2.62,2.62,+0.04,1.55,3000,1,7860,0,0,0,0,0,0,3000,0,3000,3000
20200316,049899,台積電元富94購05,0.25,0.25,0.22,0.22,-0.23,-51.11,149000,3,32870,0,0,0,0,0,0,0,144000,-144000,-144000
20200316,04989P,國巨元大94售15,0.68,0.68,0.68,0.68,0.00,0.00,20000,2,13600,0,0,0,0,0,0,20000,20000,0,0
20200316,049900,台積電元富94購06,0.11,0.11,0.11,0.11,-0.09,-45.0,10000,1,1100,0,0,0,0,0,0,10000,0,10000,10000
20200316,049901,瑞昱元富94購01,,,,,0.00,0.00,0,0,0,0,0,0,0,0,0,0,0,0,0
20200316,049902,大立光元富94購05,0.05,0.05,0.05,0.05,+0.03,150.0,30000,1,1500,0,0,0,0,0,0,30000,0,30000,30000
20200316,049903,大立光元富94購06,0.13,0.13,0.13,0.13,+0.12,1200.0,8000,1,1040,0,0,0,0,0,0,0,8000,-8000,-8000
20200316,049904,矽力元富94購01,,,,,0.00,0.00,0,0,0,0,0,0,0,0,0,0,0,0,0
20200316,049905,為升元大94購05,,,,,0.00,0.00,0,0,0,0,0,0,0,0,0,0,0,0,0
20200316,049906,光寶科元大94購03,,,,,0.00,0.00,0,0,0,0,0,0,0,0,0,0,0,0,0
20200316,049907,鴻海元大94購07,0.92,0.94,0.50,0.51,0.00,0.00,80000,8,62800,0,0,0,0,0,0,60000,30000,30000,30000
20200316,049908,鴻海元大94購08,0.88,0.89,0.46,0.47,-0.21,-30.88,90000,9,67400,0,0,0,0,0,0,80000,20000,60000,60000
20200316,049909,國巨元大95購01,0.58,0.58,0.48,0.48,-0.12,-20.0,95000,6,51000,0,0,0,0,0,0,20000,15000,5000,5000
20200316,04990P,臻鼎元大94售04,7.20,7.20,7.20,7.20,0.00,0.00,6000,1,43200,0,0,0,0,0,0,6000,0,6000,6000
20200316,049910,智邦元大94購04,,,,,0.00,0.00,0,0,0,0,0,0,0,0,0,0,0,0,0
20200316,049911,智邦元大94購05,,,,,0.00,0.00,0,0,0,0,0,0,0,0,0,0,0,0,0
20200316,049912,燿華元大94購04,,,,,0.00,0.00,0,0,0,0,0,0,0,0,0,0,0,0,0
20200316,049913,微星元大94購01,,,,,0.00,0.00,0,0,0,0,0,0,0,0,0,0,0,0,0
20200316,049914,瑞昱元大94購06,,,,,0.00,0.00,0,0,0,0,0,0,0,0,0,0,0,0,0
20200316,049915,瑞昱元大94購07,,,,,0.00,0.00,0,0,0,0,0,0,0,0,0,0,0,0,0
20200316,049916,台光電元大94購06,0.14,0.14,0.14,0.14,-0.02,-12.5,10000,1,1400,0,0,0,0,0,0,0,10000,-10000,-10000
20200316,049917,華新科元大94購02,,,,,0.00,0.00,0,0,0,0,0,0,0,0,0,0,0,0,0
20200316,049918,宏達電元大94購01,,,,,0.00,0.00,0,0,0,0,0,0,0,0,0,0,0,0,0
20200316,049919,美食元大94購03,,,,,0.00,0.00,0,0,0,0,0,0,0,0,0,0,0,0,0
20200316,04991P,台表科元大94售05,1.27,1.27,1.27,1.27,+0.01,0.79,10000,1,12700,0,0,0,0,0,0,0,10000,-10000,-10000
20200316,049920,大立光元大94購15,,,,,0.00,0.00,0,0,0,0,0,0,0,0,0,0,0,0,0
20200316,049921,大立光元大94購16,0.17,0.17,0.07,0.08,-0.14,-63.64,312000,38,29080,0,0,0,0,0,0,1000,312000,-311000,-311000
20200316,049922,禾伸堂元大95購01,,,,,0.00,0.00,0,0,0,0,0,0,0,0,0,0,0,0,0
20200316,049923,智原元大95購02,,,,,0.00,0.00,0,0,0,0,0,0,0,0,0,0,0,0,0
20200316,049924,欣興元大95購04,,,,,0.00,0.00,0,0,0,0,0,0,0,0,0,0,0,0,0
20200316,049925,創意元大95購02,,,,,0.00,0.00,0,0,0,0,0,0,0,0,0,0,0,0,0
20200316,049926,智易元大95購02,,,,,0.00,0.00,0,0,0,0,0,0,0,0,0,0,0,0,0
20200316,049927,健策元大94購02,1.57,1.58,1.04,1.04,-0.51,-32.9,280000,18,382100,0,0,0,0,0,0,180000,110000,70000,70000
20200316,049928,祥碩元大94購02,,,,,0.00,0.00,0,0,0,0,0,0,0,0,0,0,0,0,0
20200316,049929,祥碩元大94購03,6.70,6.70,6.70,6.70,+0.10,1.52,30000,3,201000,0,0,0,0,0,0,30000,0,30000,30000
20200316,04992P,元油2X富邦97售04,,,,,0.00,0.00,0,0,0,0,0,0,0,0,0,0,0,0,0
20200316,049930,上海銀元大94購02,,,,,0.00,0.00,0,0,0,0,0,0,0,0,0,0,0,0,0
20200316,049931,矽力元大94購01,2.01,2.01,1.36,1.36,-0.78,-36.45,25000,4,41310,0,0,0,0,0,0,10000,15000,-5000,-5000
20200316,049932,GIS元大94購03,,,,,0.00,0.00,0,0,0,0,0,0,0,0,0,0,0,0,0
20200316,049933,GIS元大95購01,,,,,0.00,0.00,0,0,0,0,0,0,0,0,0,0,0,0,0
20200316,049934,緯穎元大94購08,5.65,5.65,3.67,3.67,+1.37,59.57,24000,3,115350,0,0,0,0,0,0,13000,11000,2000,2000
20200316,049935,南電元大94購08,,,,,0.00,0.00,0,0,0,0,0,0,0,0,0,0,0,0,0
20200316,049936,柏文元大94購02,,,,,0.00,0.00,0,0,0,0,0,0,0,0,0,0,0,0,0
20200316,049937,臺股指元大94購18,,,,,0.00,0.00,0,0,0,0,0,0,0,0,0,0,0,0,0
20200316,049938,臺股指元大94購19,,,,,0.00,0.00,0,0,0,0,0,0,0,0,0,0,0,0,0
20200316,049939,臺股指元大94購20,,,,,0.00,0.00,0,0,0,0,0,0,0,0,0,0,0,0,0
20200316,04993P,上銀兆豐96售01,1.24,1.50,1.24,1.50,+0.25,20.0,97000,12,127280,0,0,0,0,0,0,8000,88000,-80000,-80000
20200316,049940,臺股指元大94購21,,,,,0.00,0.00,0,0,0,0,0,0,0,0,0,0,0,0,0
20200316,049941,臺股指元大94購24,,,,,0.00,0.00,0,0,0,0,0,0,0,0,0,0,0,0,0
20200316,049942,奇力新亞東94購01,,,,,0.00,0.00,0,0,0,0,0,0,0,0,0,0,0,0,0
20200316,049943,聯詠第一94購01,,,,,0.00,0.00,0,0,0,0,0,0,0,0,0,0,0,0,0
20200316,049944,日月光第一94購01,,,,,0.00,0.00,0,0,0,0,0,0,0,0,0,0,0,0,0
20200316,049945,樺漢第一94購01,,,,,0.00,0.00,0,0,0,0,0,0,0,0,0,0,0,0,0
20200316,049946,智邦兆豐95購01,0.20,0.20,0.20,0.20,+0.08,66.67,20000,1,4000,0,0,0,0,0,0,20000,0,20000,20000
20200316,049947,S&P反1中信97購01,1.89,1.89,1.83,1.88,+0.08,4.44,21000,3,39080,0,0,0,0,0,0,0,20000,-20000,-20000
20200316,049948,聯發科麥證94購01,,,,,0.00,0.00,0,0,0,0,0,0,0,0,0,0,0,0,0
20200316,049949,燿華群益96購01,,,,,0.00,0.00,0,0,0,0,0,0,0,0,0,0,0,0,0
20200316,04994P,大成鋼凱基95售01,2.32,2.33,2.32,2.33,-0.28,-10.73,20000,2,46500,0,0,0,0,0,0,0,20000,-20000,-20000
20200316,049950,南亞科群益94購02,,,,,0.00,0.00,0,0,0,0,0,0,0,0,0,0,0,0,0
20200316,049951,全新群益94購03,,,,,0.00,0.00,0,0,0,0,0,0,0,0,0,0,0,0,0
20200316,049952,強茂群益94購01,,,,,0.00,0.00,0,0,0,0,0,0,0,0,0,0,0,0,0
20200316,049953,華新科群益94購04,,,,,0.00,0.00,0,0,0,0,0,0,0,0,0,0,0,0,0
20200316,049954,健策群益95購01,0.87,0.87,0.62,0.62,-0.32,-34.04,99000,2,83630,0,0,0,0,0,0,99000,0,99000,99000
20200316,049955,崇越群益95購01,,,,,0.00,0.00,0,0,0,0,0,0,0,0,0,0,0,0,0
20200316,049956,國巨統一94購05,,,,,0.00,0.00,0,0,0,0,0,0,0,0,0,0,0,0,0
20200316,049957,智邦統一94購01,,,,,0.00,0.00,0,0,0,0,0,0,0,0,0,0,0,0,0
20200316,049958,華新科統一94購08,,,,,0.00,0.00,0,0,0,0,0,0,0,0,0,0,0,0,0
20200316,049959,創意統一95購02,,,,,0.00,0.00,0,0,0,0,0,0,0,0,0,0,0,0,0
20200316,04995P,台達電凱基96售03,1.97,2.19,1.88,2.00,-0.05,-2.44,39000,5,78520,0,0,0,0,0,0,30000,39000,-9000,-9000
20200316,049960,嘉聯益統一94購01,,,,,0.00,0.00,0,0,0,0,0,0,0,0,0,0,0,0,0
20200316,049961,GIS統一94購01,,,,,0.00,0.00,0,0,0,0,0,0,0,0,0,0,0,0,0
20200316,049962,台光電元富94購01,,,,,0.00,0.00,0,0,0,0,0,0,0,0,0,0,0,0,0
20200316,049963,聯發科元富94購02,,,,,0.00,0.00,0,0,0,0,0,0,0,0,0,0,0,0,0
20200316,049964,強茂元富94購01,,,,,0.00,0.00,0,0,0,0,0,0,0,0,0,0,0,0,0
20200316,049965,矽創元富94購01,,,,,0.00,0.00,0,0,0,0,0,0,0,0,0,0,0,0,0
20200316,049966,旺宏國票95購02,,,,,0.00,0.00,0,0,0,0,0,0,0,0,0,0,0,0,0
20200316,049967,華新科國票94購07,,,,,0.00,0.00,0,0,0,0,0,0,0,0,0,0,0,0,0
20200316,049968,麗豐國票95購01,,,,,0.00,0.00,0,0,0,0,0,0,0,0,0,0,0,0,0
20200316,049969,泰鼎國票95購01,,,,,0.00,0.00,0,0,0,0,0,0,0,0,0,0,0,0,0
20200316,04996P,台積電凱基95售02,0.77,0.79,0.77,0.79,+0.21,36.21,103000,11,79370,0,0,0,0,0,0,3000,100000,-97000,-97000
20200316,049970,康控國票95購03,,,,,0.00,0.00,0,0,0,0,0,0,0,0,0,0,0,0,0
20200316,049971,台郡國票95購01,1.11,1.11,1.11,1.11,-0.05,-4.31,10000,1,11100,0,0,0,0,0,0,10000,0,10000,10000
20200316,049972,南電國票95購02,0.05,0.05,0.05,0.05,-0.14,-73.68,50000,1,2500,0,0,0,0,0,0,0,0,0,0
20200316,049973,T50反1日盛9A購01,,,,,0.00,0.00,0,0,0,0,0,0,0,0,0,0,0,0,0
20200316,049974,聯發科日盛94購02,,,,,0.00,0.00,0,0,0,0,0,0,0,0,0,0,0,0,0
20200316,049975,力山凱基94購05,,,,,0.00,0.00,0,0,0,0,0,0,0,0,0,0,0,0,0
20200316,049976,台積電凱基94購28,,,,,0.00,0.00,0,0,0,0,0,0,0,0,0,0,0,0,0
20200316,049977,瑞昱凱基94購03,,,,,0.00,0.00,0,0,0,0,0,0,0,0,0,0,0,0,0
20200316,049978,瑞昱凱基94購04,,,,,0.00,0.00,0,0,0,0,0,0,0,0,0,0,0,0,0
20200316,049979,美律凱基94購07,,,,,0.00,0.00,0,0,0,0,0,0,0,0,0,0,0,0,0
20200316,04997P,燿華台新95售02,5.25,5.55,5.25,5.55,+0.15,2.78,14000,2,75900,0,0,0,0,0,0,0,14000,-14000,-14000
20200316,049980,奇力新凱基94購04,0.16,0.17,0.10,0.10,0.00,0.00,12000,3,1330,0,0,0,0,0,0,2000,10000,-8000,-8000
20200316,049981,臺企銀凱基94購01,,,,,0.00,0.00,0,0,0,0,0,0,0,0,0,0,0,0,0
20200316,049982,嘉晶凱基94購01,1.13,1.24,0.74,0.74,-0.28,-27.45,377000,25,427740,0,0,0,0,0,0,116000,262000,-146000,-146000
20200316,049983,智原凱基94購02,,,,,0.00,0.00,0,0,0,0,0,0,0,0,0,0,0,0,0
20200316,049984,揚明光凱基94購04,,,,,0.00,0.00,0,0,0,0,0,0,0,0,0,0,0,0,0
20200316,049985,華擎凱基94購01,0.71,0.89,0.50,0.50,-0.02,-3.85,561000,21,338780,0,0,0,0,0,0,444000,115000,329000,329000
20200316,049986,嘉澤凱基94購02,0.16,0.19,0.15,0.15,-0.04,-21.05,1060000,11,170200,0,0,0,0,0,0,1060000,0,1060000,1060000
20200316,049987,智易凱基94購03,,,,,0.00,0.00,0,0,0,0,0,0,0,0,0,0,0,0,0
20200316,049988,貿聯凱基94購02,,,,,0.00,0.00,0,0,0,0,0,0,0,0,0,0,0,0,0
20200316,049989,臻鼎凱基94購02,,,,,0.00,0.00,0,0,0,0,0,0,0,0,0,0,0,0,0
20200316,04998P,京元電永豐95售01,0.78,0.83,0.75,0.83,-0.21,-20.19,18000,4,13940,0,0,0,0,0,0,6000,12000,-6000,-6000
20200316,049990,志超凱基94購03,,,,,0.00,0.00,0,0,0,0,0,0,0,0,0,0,0,0,0
20200316,049991,臺股指凱基96購04,,,,,0.00,0.00,0,0,0,0,0,0,0,0,0,0,0,0,0
20200316,049992,國巨台新94購02,,,,,0.00,0.00,0,0,0,0,0,0,0,0,0,0,0,0,0
20200316,049993,奇力新台新94購02,,,,,0.00,0.00,0,0,0,0,0,0,0,0,0,0,0,0,0
20200316,049994,聯茂台新94購02,,,,,0.00,0.00,0,0,0,0,0,0,0,0,0,0,0,0,0
20200316,049995,GIS台新94購01,,,,,0.00,0.00,0,0,0,0,0,0,0,0,0,0,0,0,0
20200316,049996,元油2X永豐94購05,,,,,0.00,0.00,0,0,0,0,0,0,0,0,0,0,0,0,0
20200316,049997,聯發科永豐94購04,,,,,0.00,0.00,0,0,0,0,0,0,0,0,0,0,0,0,0
20200316,049998,奇力新永豐94購03,,,,,0.00,0.00,0,0,0,0,0,0,0,0,0,0,0,0,0
20200316,049999,義隆永豐94購01,,,,,0.00,0.00,0,0,0,0,0,0,0,0,0,0,0,0,0
20200316,04999P,南電永豐95售01,,,,,0.00,0.00,0,0,0,0,0,0,0,0,0,0,0,0,0
20200316,050000,盟立永豐94購01,,,,,0.00,0.00,0,0,0,0,0,0,0,0,0,0,0,0,0
20200316,050001,奇鋐永豐94購03,,,,,0.00,0.00,0,0,0,0,0,0,0,0,0,0,0,0,0
20200316,050002,智原永豐94購02,,,,,0.00,0.00,0,0,0,0,0,0,0,0,0,0,0,0,0
20200316,050003,景碩永豐94購01,,,,,0.00,0.00,0,0,0,0,0,0,0,0,0,0,0,0,0
20200316,050004,明泰永豐94購01,,,,,0.00,0.00,0,0,0,0,0,0,0,0,0,0,0,0,0
20200316,050005,京鼎永豐94購01,,,,,0.00,0.00,0,0,0,0,0,0,0,0,0,0,0,0,0
20200316,050006,華擎永豐94購03,0.24,0.28,0.16,0.16,-0.06,-27.27,51000,10,11010,0,0,0,0,0,0,20000,31000,-11000,-11000
20200316,050007,貿聯永豐94購01,0.01,0.01,0.01,0.01,0.00,0.00,90000,27,900,0,0,0,0,0,0,0,90000,-90000,-90000
20200316,050008,超眾永豐94購02,,,,,0.00,0.00,0,0,0,0,0,0,0,0,0,0,0,0,0
20200316,050009,昇陽半永豐94購02,,,,,0.00,0.00,0,0,0,0,0,0,0,0,0,0,0,0,0
20200316,05000P,臺股指永豐95售01,,,,,0.00,0.00,0,0,0,0,0,0,0,0,0,0,0,0,0
20200316,050010,鈺齊永豐94購01,,,,,0.00,0.00,0,0,0,0,0,0,0,0,0,0,0,0,0
20200316,050011,S&P反1國泰95購01,,,,,0.00,0.00,0,0,0,0,0,0,0,0,0,0,0,0,0
20200316,050012,台積電國泰95購03,2.41,2.51,2.39,2.39,+0.56,30.6,87000,12,216530,0,0,0,0,0,0,80000,10000,70000,70000
20200316,050013,淘帝國泰95購01,,,,,0.00,0.00,0,0,0,0,0,0,0,0,0,0,0,0,0
20200316,050014,國巨富邦98購01,1.13,1.13,0.88,0.88,-0.22,-20.0,129000,11,127970,0,0,0,0,0,0,120000,26000,94000,94000
20200316,050015,友達富邦95購01,,,,,0.00,0.00,0,0,0,0,0,0,0,0,0,0,0,0,0
20200316,050016,緯穎富邦95購01,1.23,1.24,1.16,1.16,0.00,0.00,50000,5,60900,0,0,0,0,0,0,0,50000,-50000,-50000
20200316,050017,百和富邦94購01,,,,,0.00,0.00,0,0,0,0,0,0,0,0,0,0,0,0,0
20200316,050018,高股息元大94購02,0.03,0.03,0.03,0.03,0.00,0.00,10000,1,300,0,0,0,0,0,0,0,0,0,0
20200316,050019,T50反1元大94購04,1.31,1.57,1.31,1.57,-0.13,-7.65,2000,2,2880,0,0,0,0,0,0,1000,1000,0,0
20200316,05001P,華通統一95售01,,,,,0.00,0.00,0,0,0,0,0,0,0,0,0,0,0,0,0
20200316,050020,為升元大94購06,,,,,0.00,0.00,0,0,0,0,0,0,0,0,0,0,0,0,0
20200316,050021,鴻海元大94購10,0.73,0.73,0.37,0.38,-0.01,-2.56,40000,3,22100,0,0,0,0,0,0,20000,20000,0,0
20200316,050022,鴻海元大94購11,1.12,1.12,0.62,0.62,-0.26,-29.55,72000,8,61230,0,0,0,0,0,0,70000,52000,18000,18000
20200316,050023,國巨元大94購12,0.74,0.94,0.74,0.94,+0.04,4.44,35000,2,27900,0,0,0,0,0,0,35000,0,35000,35000
20200316,050024,旺宏元大94購09,0.47,0.47,0.47,0.47,0.00,0.00,10000,1,4700,0,0,0,0,0,0,0,10000,-10000,-10000
20200316,050025,燿華元大94購05,,,,,0.00,0.00,0,0,0,0,0,0,0,0,0,0,0,0,0
20200316,050026,友達元大96購01,,,,,0.00,0.00,0,0,0,0,0,0,0,0,0,0,0,0,0
20200316,050027,義隆元大94購03,,,,,0.00,0.00,0,0,0,0,0,0,0,0,0,0,0,0,0
20200316,050028,華新科元大94購03,0.56,0.64,0.34,0.34,-0.16,-32.0,60000,6,32100,0,0,0,0,0,0,30000,50000,-20000,-20000
20200316,050029,美食元大94購04,,,,,0.00,0.00,0,0,0,0,0,0,0,0,0,0,0,0,0
20200316,05002P,台積電統一95售03,1.73,2.70,1.73,2.70,+0.16,6.3,126000,16,228090,0,0,0,0,0,0,123000,110000,13000,13000
20200316,050030,嘉晶元大94購03,0.98,1.05,0.66,0.66,-0.27,-29.03,108000,11,99960,0,0,0,0,0,0,58000,73000,-15000,-15000
20200316,050031,嘉澤元大95購01,0.24,0.24,0.15,0.15,-0.04,-21.05,40000,4,7400,0,0,0,0,0,0,0,40000,-40000,-40000
20200316,050032,TPK元大94購03,,,,,0.00,0.00,0,0,0,0,0,0,0,0,0,0,0,0,0
20200316,050033,日月光元大94購01,,,,,0.00,0.00,0,0,0,0,0,0,0,0,0,0,0,0,0
20200316,050034,智伸科元大94購01,,,,,0.00,0.00,0,0,0,0,0,0,0,0,0,0,0,0,0
20200316,050035,聯茂元大94購07,0.63,0.71,0.37,0.37,-0.19,-33.93,423000,19,218870,0,0,0,0,0,0,283000,163000,120000,120000
20200316,050036,矽格元大94購03,0.81,0.81,0.76,0.76,0.00,0.00,30000,2,23800,0,0,0,0,0,0,20000,10000,10000,10000
20200316,050037,金融類元大94購03,,,,,0.00,0.00,0,0,0,0,0,0,0,0,0,0,0,0,0
20200316,050038,金融類元大94購04,,,,,0.00,0.00,0,0,0,0,0,0,0,0,0,0,0,0,0
20200316,050039,鴻海中信94購03,0.65,0.74,0.49,0.57,-0.25,-30.49,128000,12,79170,0,0,0,0,0,0,103000,25000,78000,78000
20200316,050040,鴻海中信94購04,,,,,0.00,0.00,0,0,0,0,0,0,0,0,0,0,0,0,0
20200316,050041,中石化亞東94購01,,,,,0.00,0.00,0,0,0,0,0,0,0,0,0,0,0,0,0
20200316,050042,台表科亞東94購01,,,,,0.00,0.00,0,0,0,0,0,0,0,0,0,0,0,0,0
20200316,050043,GIS亞東94購01,,,,,0.00,0.00,0,0,0,0,0,0,0,0,0,0,0,0,0
20200316,050044,聯詠兆豐94購02,,,,,0.00,0.00,0,0,0,0,0,0,0,0,0,0,0,0,0
20200316,050045,祥碩兆豐94購01,2.50,2.50,2.50,2.50,-0.20,-7.41,10000,1,25000,0,0,0,0,0,0,10000,0,10000,10000
20200316,050046,矽力兆豐94購01,,,,,0.00,0.00,0,0,0,0,0,0,0,0,0,0,0,0,0
20200316,050047,奇鋐國票95購01,,,,,0.00,0.00,0,0,0,0,0,0,0,0,0,0,0,0,0
20200316,050048,百和國票94購01,,,,,0.00,0.00,0,0,0,0,0,0,0,0,0,0,0,0,0
20200316,050049,華通群益96購01,0.23,0.23,0.13,0.13,-0.09,-40.91,1027000,18,184650,0,0,0,0,0,0,99000,928000,-829000,-829000
20200316,05004P,健策統一95售01,0.65,0.91,0.65,0.85,+0.24,39.34,188000,10,158400,0,0,0,0,0,0,10000,138000,-128000,-128000
20200316,050050,國泰金群益94購02,0.02,0.02,0.02,0.02,0.00,0.00,12000,3,240,0,0,0,0,0,0,0,0,0,0
20200316,050051,智原群益94購01,,,,,0.00,0.00,0,0,0,0,0,0,0,0,0,0,0,0,0
20200316,050052,致伸群益94購04,,,,,0.00,0.00,0,0,0,0,0,0,0,0,0,0,0,0,0
20200316,050053,訊芯群益94購03,,,,,0.00,0.00,0,0,0,0,0,0,0,0,0,0,0,0,0
20200316,050054,緯穎群益94購04,5.20,5.20,5.20,5.20,+1.71,49.0,6000,1,31200,0,0,0,0,0,0,6000,0,6000,6000
20200316,050055,道瓊反凱基95購01,1.51,1.83,1.51,1.81,+0.30,19.87,57000,6,99770,0,0,0,0,0,0,10000,40000,-30000,-30000
20200316,050056,國巨凱基94購04,0.55,0.55,0.30,0.32,-0.23,-41.82,65000,12,33060,0,0,0,0,0,0,0,63000,-63000,-63000
20200316,050057,國巨凱基94購05,0.95,0.95,0.68,0.68,-0.34,-33.33,20000,2,16300,0,0,0,0,0,0,0,20000,-20000,-20000
20200316,050058,國巨凱基94購06,,,,,0.00,0.00,0,0,0,0,0,0,0,0,0,0,0,0,0
20200316,050059,旺宏凱基94購03,,,,,0.00,0.00,0,0,0,0,0,0,0,0,0,0,0,0,0
20200316,05005P,台表科統一95售01,1.81,1.81,1.81,1.81,+0.16,9.7,2000,1,3620,0,0,0,0,0,0,2000,0,2000,2000
20200316,050060,光磊凱基94購03,,,,,0.00,0.00,0,0,0,0,0,0,0,0,0,0,0,0,0
20200316,050061,聯發科凱基94購07,0.24,0.26,0.24,0.24,-0.02,-7.69,150000,3,36200,0,0,0,0,0,0,140000,0,140000,140000
20200316,050062,聯發科凱基94購08,,,,,0.00,0.00,0,0,0,0,0,0,0,0,0,0,0,0,0
20200316,050063,聯發科凱基94購09,,,,,0.00,0.00,0,0,0,0,0,0,0,0,0,0,0,0,0
20200316,050064,華新科凱基94購08,,,,,0.00,0.00,0,0,0,0,0,0,0,0,0,0,0,0,0
20200316,050065,冠德凱基94購01,,,,,0.00,0.00,0,0,0,0,0,0,0,0,0,0,0,0,0
20200316,050066,華固凱基94購01,,,,,0.00,0.00,0,0,0,0,0,0,0,0,0,0,0,0,0
20200316,050067,美食凱基94購02,,,,,0.00,0.00,0,0,0,0,0,0,0,0,0,0,0,0,0
20200316,050068,美食凱基94購03,,,,,0.00,0.00,0,0,0,0,0,0,0,0,0,0,0,0,0
20200316,050069,禾伸堂凱基94購04,,,,,0.00,0.00,0,0,0,0,0,0,0,0,0,0,0,0,0
20200316,05006P,華通元富95售01,2.72,2.84,2.72,2.84,-0.29,-9.27,138000,2,384000,0,0,0,0,0,0,138000,0,138000,138000
20200316,050070,欣興凱基94購07,,,,,0.00,0.00,0,0,0,0,0,0,0,0,0,0,0,0,0
20200316,050071,明泰凱基94購01,,,,,0.00,0.00,0,0,0,0,0,0,0,0,0,0,0,0,0
20200316,050072,京鼎凱基94購02,,,,,0.00,0.00,0,0,0,0,0,0,0,0,0,0,0,0,0
20200316,050073,傳奇凱基94購02,,,,,0.00,0.00,0,0,0,0,0,0,0,0,0,0,0,0,0
20200316,050074,訊芯凱基94購05,,,,,0.00,0.00,0,0,0,0,0,0,0,0,0,0,0,0,0
20200316,050075,南電凱基94購04,,,,,0.00,0.00,0,0,0,0,0,0,0,0,0,0,0,0,0
20200316,050076,百和凱基94購02,,,,,0.00,0.00,0,0,0,0,0,0,0,0,0,0,0,0,0
20200316,050077,臺股指凱基99購02,0.11,0.11,0.05,0.08,-0.33,-80.49,452000,12,33350,0,0,0,0,0,0,0,0,0,0
20200316,050078,臺指反統一97購01,,,,,0.00,0.00,0,0,0,0,0,0,0,0,0,0,0,0,0
20200316,050079,元油2X統一94購06,,,,,0.00,0.00,0,0,0,0,0,0,0,0,0,0,0,0,0
20200316,05007P,旺宏元富95售01,0.74,1.10,0.74,1.10,+0.25,29.41,159000,8,132150,0,0,0,0,0,0,149000,10000,139000,139000
20200316,050080,國巨統一94購06,,,,,0.00,0.00,0,0,0,0,0,0,0,0,0,0,0,0,0
20200316,050081,聯發科統一94購07,0.25,0.25,0.25,0.25,-0.15,-37.5,105000,1,26250,0,0,0,0,0,0,105000,0,105000,105000
20200316,050082,聯發科統一94購08,0.06,0.06,0.06,0.06,0.00,0.00,35000,1,2100,0,0,0,0,0,0,35000,0,35000,35000
20200316,050083,旺宏元富94購01,,,,,0.00,0.00,0,0,0,0,0,0,0,0,0,0,0,0,0
20200316,050084,宏達電元富94購03,,,,,0.00,0.00,0,0,0,0,0,0,0,0,0,0,0,0,0
20200316,050085,國泰金元富94購01,,,,,0.00,0.00,0,0,0,0,0,0,0,0,0,0,0,0,0
20200316,050086,國巨台新94購03,,,,,0.00,0.00,0,0,0,0,0,0,0,0,0,0,0,0,0
20200316,050087,美食台新94購01,,,,,0.00,0.00,0,0,0,0,0,0,0,0,0,0,0,0,0
20200316,050088,禾伸堂台新94購01,,,,,0.00,0.00,0,0,0,0,0,0,0,0,0,0,0,0,0
20200316,050089,臻鼎台新94購01,,,,,0.00,0.00,0,0,0,0,0,0,0,0,0,0,0,0,0
20200316,05008P,大立光元富95售05,2.93,3.03,2.93,3.03,-1.45,-32.37,2000,2,5960,0,0,0,0,0,0,0,2000,-2000,-2000
20200316,050090,鈺齊康和94購01,0.09,0.09,0.09,0.09,0.00,0.00,100000,1,9000,0,0,0,0,0,0,100000,0,100000,100000
20200316,050091,喬山永豐94購02,,,,,0.00,0.00,0,0,0,0,0,0,0,0,0,0,0,0,0
20200316,050092,鴻海永豐94購04,0.09,0.09,0.09,0.09,-0.07,-43.75,20000,2,1800,0,0,0,0,0,0,0,20000,-20000,-20000
20200316,050093,國巨永豐94購05,0.14,0.17,0.04,0.04,0.00,0.00,350000,21,37700,0,0,0,0,0,0,110000,194000,-84000,-84000
20200316,050094,T50反1國泰95購01,,,,,0.00,0.00,0,0,0,0,0,0,0,0,0,0,0,0,0
20200316,050095,國巨國泰95購04,,,,,0.00,0.00,0,0,0,0,0,0,0,0,0,0,0,0,0
20200316,050096,國巨國泰95購05,,,,,0.00,0.00,0,0,0,0,0,0,0,0,0,0,0,0,0
20200316,050097,可成國泰96購02,,,,,0.00,0.00,0,0,0,0,0,0,0,0,0,0,0,0,0
20200316,050098,嘉聯益國泰95購02,,,,,0.00,0.00,0,0,0,0,0,0,0,0,0,0,0,0,0
20200316,050099,台積電永昌96購01,1.50,1.50,1.02,1.04,-0.59,-36.2,408000,34,548590,0,0,0,0,0,0,289000,114000,175000,175000
20200316,05009P,大立光元富95售06,6.00,6.00,6.00,6.00,0.00,0.00,360000,1,2160000,0,0,0,0,0,0,360000,0,360000,360000
20200316,050100,台積電永昌96購02,0.97,0.98,0.51,0.56,-0.53,-48.62,262000,26,217820,0,0,0,0,0,0,119000,43000,76000,76000
20200316,050101,台積電永昌96購03,0.19,0.19,0.11,0.13,-0.10,-43.48,606000,36,81030,0,0,0,0,0,0,140000,266000,-126000,-126000
20200316,050102,鴻海富邦95購04,0.33,0.33,0.23,0.23,0.00,0.00,275000,16,76300,0,0,0,0,0,0,0,275000,-275000,-275000
20200316,050103,群創富邦94購01,,,,,0.00,0.00,0,0,0,0,0,0,0,0,0,0,0,0,0
20200316,050104,元石油元大97購02,,,,,0.00,0.00,0,0,0,0,0,0,0,0,0,0,0,0,0
20200316,050105,力山元大95購02,,,,,0.00,0.00,0,0,0,0,0,0,0,0,0,0,0,0,0
20200316,050106,台達電元大94購11,0.50,0.50,0.35,0.35,-0.08,-18.6,28000,3,11800,0,0,0,0,0,0,0,28000,-28000,-28000
20200316,050107,鴻海元大94購12,0.33,0.37,0.23,0.23,0.00,0.00,50000,5,14900,0,0,0,0,0,0,0,50000,-50000,-50000
20200316,050108,鴻海元大94購13,0.39,0.39,0.26,0.26,-0.35,-57.38,18000,2,5330,0,0,0,0,0,0,18000,0,18000,18000
20200316,050109,國巨元大94購13,1.66,1.66,0.89,0.89,-0.94,-51.37,25000,3,33400,0,0,0,0,0,0,10000,15000,-5000,-5000
20200316,05010P,台郡元富95售01,0.69,0.69,0.69,0.69,-0.11,-13.75,120000,1,82800,0,0,0,0,0,0,120000,0,120000,120000
20200316,050110,京元電元大94購03,,,,,0.00,0.00,0,0,0,0,0,0,0,0,0,0,0,0,0
20200316,050111,全新元大95購02,,,,,0.00,0.00,0,0,0,0,0,0,0,0,0,0,0,0,0
20200316,050112,高鐵元大94購02,,,,,0.00,0.00,0,0,0,0,0,0,0,0,0,0,0,0,0
20200316,050113,欣興元大95購05,,,,,0.00,0.00,0,0,0,0,0,0,0,0,0,0,0,0,0
20200316,050114,群創元大95購01,0.20,0.20,0.14,0.14,-0.06,-30.0,136000,4,22340,0,0,0,0,0,0,136000,10000,126000,126000
20200316,050115,群創元大96購01,0.17,0.17,0.17,0.17,-0.02,-10.53,10000,1,1700,0,0,0,0,0,0,0,10000,-10000,-10000
20200316,050116,嘉澤元大94購03,,,,,0.00,0.00,0,0,0,0,0,0,0,0,0,0,0,0,0
20200316,050117,麗豐元大96購02,0.15,0.15,0.15,0.15,0.00,0.00,10000,1,1500,0,0,0,0,0,0,10000,0,10000,10000
20200316,050118,臻鼎元大94購01,,,,,0.00,0.00,0,0,0,0,0,0,0,0,0,0,0,0,0
20200316,050119,瀚宇博元大95購03,0.15,0.15,0.12,0.12,0.00,0.00,12000,2,1740,0,0,0,0,0,0,0,12000,-12000,-12000
20200316,05011P,南電國泰96售01,1.53,1.85,1.47,1.84,+0.21,12.88,208000,38,345860,0,0,0,0,0,0,141000,58000,83000,83000
20200316,050120,GIS元大95購02,,,,,0.00,0.00,0,0,0,0,0,0,0,0,0,0,0,0,0
20200316,050121,南電元大95購02,0.92,0.92,0.75,0.75,+0.14,22.95,43000,5,37930,0,0,0,0,0,0,32000,11000,21000,21000
20200316,050122,臺指反凱基96購01,0.95,1.40,0.91,1.40,+0.43,44.33,99000,9,108150,0,0,0,0,0,0,79000,40000,39000,39000
20200316,050123,群臺反凱基96購01,1.02,1.37,1.02,1.29,+0.31,31.63,558000,19,612270,0,0,0,0,0,0,165000,333000,-168000,-168000
20200316,050124,元金2X凱基95購01,0.55,0.65,0.52,0.64,-0.35,-35.35,207000,22,114880,0,0,0,0,0,0,0,207000,-207000,-207000
20200316,050125,中環凱基94購01,,,,,0.00,0.00,0,0,0,0,0,0,0,0,0,0,0,0,0
20200316,050126,國巨凱基94購08,,,,,0.00,0.00,0,0,0,0,0,0,0,0,0,0,0,0,0
20200316,050127,台積電凱基94購31,0.19,0.19,0.15,0.15,0.00,0.00,310000,2,56500,0,0,0,0,0,0,0,310000,-310000,-310000
20200316,050128,旺宏凱基94購04,,,,,0.00,0.00,0,0,0,0,0,0,0,0,0,0,0,0,0
20200316,050129,聯發科凱基94購11,,,,,0.00,0.00,0,0,0,0,0,0,0,0,0,0,0,0,0
20200316,05012P,台積電元大95售07,1.07,1.38,0.98,1.38,+0.40,40.82,154000,18,192720,0,0,0,0,0,0,94000,131000,-37000,-37000
20200316,050130,華新科凱基94購09,0.03,0.03,0.02,0.03,0.00,0.00,190000,3,4700,0,0,0,0,0,0,190000,0,190000,190000
20200316,050131,新光金凱基94購01,,,,,0.00,0.00,0,0,0,0,0,0,0,0,0,0,0,0,0
20200316,050132,日電貿凱基94購02,,,,,0.00,0.00,0,0,0,0,0,0,0,0,0,0,0,0,0
20200316,050133,鈺齊凱基94購01,,,,,0.00,0.00,0,0,0,0,0,0,0,0,0,0,0,0,0
20200316,050134,世紀鋼凱基94購04,0.47,0.47,0.47,0.47,+0.08,20.51,3000,1,1410,0,0,0,0,0,0,3000,0,3000,3000
20200316,050135,禾伸堂兆豐95購01,0.39,0.40,0.35,0.35,0.00,0.00,140000,9,54900,0,0,0,0,0,0,0,140000,-140000,-140000
20200316,050136,柏文兆豐94購01,,,,,0.00,0.00,0,0,0,0,0,0,0,0,0,0,0,0,0
20200316,050137,臺指反國票96購01,,,,,0.00,0.00,0,0,0,0,0,0,0,0,0,0,0,0,0
20200316,050138,台表科國票95購02,0.99,1.10,0.95,0.95,+0.10,11.76,105000,4,102050,0,0,0,0,0,0,105000,0,105000,105000
20200316,050139,華通亞東94購01,,,,,0.00,0.00,0,0,0,0,0,0,0,0,0,0,0,0,0
20200316,05013P,台積電元大96售05,1.20,1.61,1.12,1.50,+0.43,40.19,472000,36,600320,0,0,0,0,0,0,312000,381000,-69000,-69000
20200316,050140,台郡第一94購01,,,,,0.00,0.00,0,0,0,0,0,0,0,0,0,0,0,0,0
20200316,050141,國巨統一94購07,,,,,0.00,0.00,0,0,0,0,0,0,0,0,0,0,0,0,0
20200316,050142,聯發科元富9A購01,0.46,0.50,0.33,0.33,-0.21,-38.89,1061000,49,419960,0,0,0,0,0,0,437000,622000,-185000,-185000
20200316,050143,臻鼎元富94購05,,,,,0.00,0.00,0,0,0,0,0,0,0,0,0,0,0,0,0
20200316,050144,宏達電台新95購01,,,,,0.00,0.00,0,0,0,0,0,0,0,0,0,0,0,0,0
20200316,050145,矽創台新94購01,,,,,0.00,0.00,0,0,0,0,0,0,0,0,0,0,0,0,0
20200316,050146,訊芯康和94購02,,,,,0.00,0.00,0,0,0,0,0,0,0,0,0,0,0,0,0
20200316,050147,為升永豐94購01,,,,,0.00,0.00,0,0,0,0,0,0,0,0,0,0,0,0,0
20200316,050148,啟碁永豐94購01,,,,,0.00,0.00,0,0,0,0,0,0,0,0,0,0,0,0,0
20200316,050149,東元群益94購01,,,,,0.00,0.00,0,0,0,0,0,0,0,0,0,0,0,0,0
20200316,05014P,臺股指元大95售05,,,,,0.00,0.00,0,0,0,0,0,0,0,0,0,0,0,0,0
20200316,050150,國巨群益95購01,,,,,0.00,0.00,0,0,0,0,0,0,0,0,0,0,0,0,0
20200316,050151,台積電群益94購12,0.20,0.20,0.19,0.19,+0.01,5.56,30000,2,5900,0,0,0,0,0,0,20000,10000,10000,10000
20200316,050152,聯發科群益94購07,,,,,0.00,0.00,0,0,0,0,0,0,0,0,0,0,0,0,0
20200316,050153,義隆群益94購01,,,,,0.00,0.00,0,0,0,0,0,0,0,0,0,0,0,0,0
20200316,050154,可成群益94購05,,,,,0.00,0.00,0,0,0,0,0,0,0,0,0,0,0,0,0
20200316,050155,華新科群益95購01,0.46,0.50,0.28,0.28,0.00,0.00,281000,16,104310,0,0,0,0,0,0,86000,195000,-109000,-109000
20200316,050156,潤泰全群益94購01,,,,,0.00,0.00,0,0,0,0,0,0,0,0,0,0,0,0,0
20200316,050157,臻鼎群益94購02,,,,,0.00,0.00,0,0,0,0,0,0,0,0,0,0,0,0,0
20200316,050158,上海銀群益96購01,,,,,0.00,0.00,0,0,0,0,0,0,0,0,0,0,0,0,0
20200316,050159,超眾群益94購03,,,,,0.00,0.00,0,0,0,0,0,0,0,0,0,0,0,0,0
20200316,05015P,臺股指元大95售06,,,,,0.00,0.00,0,0,0,0,0,0,0,0,0,0,0,0,0
20200316,050160,中石化國泰95購01,,,,,0.00,0.00,0,0,0,0,0,0,0,0,0,0,0,0,0
20200316,050161,鴻海國泰96購03,,,,,0.00,0.00,0,0,0,0,0,0,0,0,0,0,0,0,0
20200316,050162,中環國泰95購01,,,,,0.00,0.00,0,0,0,0,0,0,0,0,0,0,0,0,0
20200316,050163,群創國泰95購01,0.21,0.21,0.21,0.21,0.00,0.00,10000,1,2100,0,0,0,0,0,0,0,10000,-10000,-10000
20200316,050164,揚明光國泰95購01,,,,,0.00,0.00,0,0,0,0,0,0,0,0,0,0,0,0,0
20200316,050165,泰鼎國泰95購02,1.51,1.51,1.41,1.41,+0.16,12.8,60000,2,87600,0,0,0,0,0,0,60000,0,60000,60000
20200316,050166,彩晶國泰95購01,0.35,0.35,0.21,0.21,-0.12,-36.36,270000,5,89200,0,0,0,0,0,0,250000,20000,230000,230000
20200316,050167,T50反1富邦96購01,,,,,0.00,0.00,0,0,0,0,0,0,0,0,0,0,0,0,0
20200316,050168,緯創富邦95購01,,,,,0.00,0.00,0,0,0,0,0,0,0,0,0,0,0,0,0
20200316,050169,臺指反元大97購01,1.60,1.75,1.60,1.73,+0.21,13.82,569000,16,966200,0,0,0,0,0,0,152000,101000,51000,51000
20200316,05016P,臺股指元大95售07,,,,,0.00,0.00,0,0,0,0,0,0,0,0,0,0,0,0,0
20200316,050170,臺指反元大97購02,,,,,0.00,0.00,0,0,0,0,0,0,0,0,0,0,0,0,0
20200316,050171,臺指反元大97購03,,,,,0.00,0.00,0,0,0,0,0,0,0,0,0,0,0,0,0
20200316,050172,臺指反元大98購02,1.93,2.35,1.93,2.35,+0.45,23.68,119000,14,256710,0,0,0,0,0,0,36000,43000,-7000,-7000
20200316,050173,旺宏元大96購02,0.26,0.26,0.17,0.17,-0.02,-10.53,16000,2,3260,0,0,0,0,0,0,6000,10000,-4000,-4000
20200316,050174,技嘉元大94購01,0.53,0.53,0.38,0.38,-0.15,-28.3,64000,6,27860,0,0,0,0,0,0,30000,34000,-4000,-4000
20200316,050175,台光電元大94購08,,,,,0.00,0.00,0,0,0,0,0,0,0,0,0,0,0,0,0
20200316,050176,正崴元大94購03,,,,,0.00,0.00,0,0,0,0,0,0,0,0,0,0,0,0,0
20200316,050177,聯發科元大94購11,0.07,0.07,0.07,0.07,-0.07,-50.0,10000,1,700,0,0,0,0,0,0,0,10000,-10000,-10000
20200316,050178,聯發科元大94購12,,,,,0.00,0.00,0,0,0,0,0,0,0,0,0,0,0,0,0
20200316,050179,全新元大96購02,,,,,0.00,0.00,0,0,0,0,0,0,0,0,0,0,0,0,0
20200316,05017P,臺股指元大95售08,,,,,0.00,0.00,0,0,0,0,0,0,0,0,0,0,0,0,0
20200316,050180,華新科元大95購08,0.58,0.64,0.37,0.40,-0.04,-9.09,220000,21,116200,0,0,0,0,0,0,50000,190000,-140000,-140000
20200316,050181,富邦金元大94購02,,,,,0.00,0.00,0,0,0,0,0,0,0,0,0,0,0,0,0
20200316,050182,淘帝元大94購01,,,,,0.00,0.00,0,0,0,0,0,0,0,0,0,0,0,0,0
20200316,050183,奇鋐元大96購01,,,,,0.00,0.00,0,0,0,0,0,0,0,0,0,0,0,0,0
20200316,050184,信邦元大94購01,0.41,0.41,0.33,0.33,-0.02,-5.71,24000,2,9040,0,0,0,0,0,0,14000,10000,4000,4000
20200316,050185,和鑫元大95購02,,,,,0.00,0.00,0,0,0,0,0,0,0,0,0,0,0,0,0
20200316,050186,京鼎元大94購01,0.41,0.41,0.41,0.41,+0.03,7.89,189000,2,77490,0,0,0,0,0,0,189000,0,189000,189000
20200316,050187,群創元大94購03,,,,,0.00,0.00,0,0,0,0,0,0,0,0,0,0,0,0,0
20200316,050188,貿聯元大96購01,0.24,0.24,0.18,0.18,-0.03,-14.29,35000,3,7600,0,0,0,0,0,0,30000,5000,25000,25000
20200316,050189,旭富元大94購01,1.87,1.87,1.18,1.18,-0.07,-5.6,39000,5,68160,0,0,0,0,0,0,30000,9000,21000,21000
20200316,05018P,臺股指元大95售09,5.05,5.05,5.05,5.05,-1.65,-24.63,10000,1,50500,0,0,0,0,0,0,0,10000,-10000,-10000
20200316,050190,麗豐元大95購02,,,,,0.00,0.00,0,0,0,0,0,0,0,0,0,0,0,0,0
20200316,050191,和碩元大94購02,0.44,0.46,0.44,0.46,-0.18,-28.12,30000,4,13400,0,0,0,0,0,0,30000,0,30000,30000
20200316,050192,康控元大97購01,0.08,0.08,0.06,0.06,-0.03,-33.33,345000,35,27500,0,0,0,0,0,0,0,345000,-345000,-345000
20200316,050193,臻鼎元大94購02,,,,,0.00,0.00,0,0,0,0,0,0,0,0,0,0,0,0,0
20200316,050194,臻鼎元大94購03,,,,,0.00,0.00,0,0,0,0,0,0,0,0,0,0,0,0,0
20200316,050195,上海銀元大94購03,,,,,0.00,0.00,0,0,0,0,0,0,0,0,0,0,0,0,0
20200316,050196,嘉聯益元大97購01,0.11,0.11,0.07,0.07,-0.03,-30.0,15000,4,1440,0,0,0,0,0,0,0,15000,-15000,-15000
20200316,050197,矽格元大94購04,0.52,0.52,0.49,0.49,0.00,0.00,30000,2,15300,0,0,0,0,0,0,20000,10000,10000,10000
20200316,050198,緯穎元大94購09,8.55,8.55,8.30,8.30,+2.30,38.33,19000,3,158200,0,0,0,0,0,0,19000,0,19000,19000
20200316,050199,南電元大94購09,,,,,0.00,0.00,0,0,0,0,0,0,0,0,0,0,0,0,0
20200316,05019P,喬山中信95售01,,,,,0.00,0.00,0,0,0,0,0,0,0,0,0,0,0,0,0
20200316,050200,致新元大94購01,0.22,0.22,0.22,0.22,+0.06,37.5,7000,1,1540,0,0,0,0,0,0,7000,0,7000,7000
20200316,050201,光磊群益94購01,,,,,0.00,0.00,0,0,0,0,0,0,0,0,0,0,0,0,0
20200316,050202,建準群益95購01,0.55,0.55,0.55,0.55,+0.08,17.02,5000,1,2750,0,0,0,0,0,0,5000,0,5000,5000
20200316,050203,美律群益94購04,,,,,0.00,0.00,0,0,0,0,0,0,0,0,0,0,0,0,0
20200316,050204,華新科群益94購05,0.04,0.04,0.04,0.04,-0.03,-42.86,100000,6,4000,0,0,0,0,0,0,50000,50000,0,0
20200316,050205,牧德群益94購02,0.05,0.05,0.05,0.05,0.00,0.00,200000,2,10000,0,0,0,0,0,0,0,200000,-200000,-200000
20200316,050206,寶成群益94購01,,,,,0.00,0.00,0,0,0,0,0,0,0,0,0,0,0,0,0
20200316,050207,百和群益95購01,,,,,0.00,0.00,0,0,0,0,0,0,0,0,0,0,0,0,0
20200316,050208,燿華兆豐95購02,,,,,0.00,0.00,0,0,0,0,0,0,0,0,0,0,0,0,0
20200316,050209,華通國票95購01,,,,,0.00,0.00,0,0,0,0,0,0,0,0,0,0,0,0,0
20200316,05020P,廣達中信95售01,0.35,0.43,0.34,0.42,+0.09,27.27,170000,7,62850,0,0,0,0,0,0,170000,0,170000,170000
20200316,050210,華新科國票94購08,,,,,0.00,0.00,0,0,0,0,0,0,0,0,0,0,0,0,0
20200316,050211,貿聯國票95購01,,,,,0.00,0.00,0,0,0,0,0,0,0,0,0,0,0,0,0
20200316,050212,瀚宇博國票95購02,,,,,0.00,0.00,0,0,0,0,0,0,0,0,0,0,0,0,0
20200316,050213,華新科台新94購03,0.31,0.31,0.17,0.17,+0.01,6.25,289000,12,80930,0,0,0,0,0,0,0,289000,-289000,-289000
20200316,050214,嘉晶台新94購01,0.34,0.34,0.34,0.34,0.00,0.00,2000,1,680,0,0,0,0,0,0,2000,0,2000,2000
20200316,050215,TPK台新96購01,,,,,0.00,0.00,0,0,0,0,0,0,0,0,0,0,0,0,0
20200316,050216,奇力新永豐94購04,,,,,0.00,0.00,0,0,0,0,0,0,0,0,0,0,0,0,0
20200316,050217,健策永豐94購03,0.39,0.48,0.39,0.43,-0.01,-2.27,117000,23,52640,0,0,0,0,0,0,67000,50000,17000,17000
20200316,050218,世紀鋼統一94購02,2.57,2.65,2.23,2.65,+0.43,19.37,25000,4,61650,0,0,0,0,0,0,5000,10000,-5000,-5000
20200316,050219,台積電元富95購03,0.80,0.80,0.40,0.40,-0.43,-51.81,168000,16,99490,0,0,0,0,0,0,0,128000,-128000,-128000
20200316,05021P,瑞昱凱基95售01,0.60,0.86,0.59,0.86,+0.28,48.28,27000,8,18830,0,0,0,0,0,0,2000,25000,-23000,-23000
20200316,050220,台積電元富96購01,0.24,0.24,0.20,0.20,-0.10,-33.33,60000,3,13600,0,0,0,0,0,0,0,60000,-60000,-60000
20200316,050221,TPK元富94購02,,,,,0.00,0.00,0,0,0,0,0,0,0,0,0,0,0,0,0
20200316,050222,瑞儀元富94購01,,,,,0.00,0.00,0,0,0,0,0,0,0,0,0,0,0,0,0
20200316,050223,聯茂元富94購02,,,,,0.00,0.00,0,0,0,0,0,0,0,0,0,0,0,0,0
20200316,050224,台泥中信94購01,,,,,0.00,0.00,0,0,0,0,0,0,0,0,0,0,0,0,0
20200316,050225,亞泥中信94購01,,,,,0.00,0.00,0,0,0,0,0,0,0,0,0,0,0,0,0
20200316,050226,華新科中信94購01,,,,,0.00,0.00,0,0,0,0,0,0,0,0,0,0,0,0,0
20200316,050227,大立光中信96購01,0.28,0.30,0.20,0.20,-0.14,-41.18,200000,12,54100,0,0,0,0,0,0,100000,100000,0,0
20200316,050228,中磊中信96購01,,,,,0.00,0.00,0,0,0,0,0,0,0,0,0,0,0,0,0
20200316,050229,鴻海麥證94購02,0.34,0.34,0.23,0.23,-0.21,-47.73,56000,22,16040,0,56000,-56000,0,0,0,0,56000,-56000,-56000
20200316,05022P,智易凱基95售01,2.49,2.80,2.49,2.59,-0.05,-1.89,21000,11,54650,0,0,0,0,0,0,12000,9000,3000,3000
20200316,050230,聯發科麥證94購02,0.29,0.31,0.27,0.28,+0.08,40.0,420000,12,118900,80000,340000,-260000,0,0,0,80000,340000,-260000,-260000
20200316,050231,聯發科麥證94購03,,,,,0.00,0.00,0,0,0,0,0,0,0,0,0,0,0,0,0
20200316,050232,奇鋐麥證95購01,,,,,0.00,0.00,0,0,0,0,0,0,0,0,0,0,0,0,0
20200316,050233,香港2X凱基96購01,0.10,0.10,0.10,0.10,+0.03,42.86,2000,1,200,0,0,0,0,0,0,0,2000,-2000,-2000
20200316,050234,國巨凱基94購10,,,,,0.00,0.00,0,0,0,0,0,0,0,0,0,0,0,0,0
20200316,050235,國巨凱基94購11,1.22,1.22,0.59,0.59,0.00,0.00,61000,11,56200,0,0,0,0,0,0,0,61000,-61000,-61000
20200316,050236,旺宏凱基94購06,,,,,0.00,0.00,0,0,0,0,0,0,0,0,0,0,0,0,0
20200316,050237,智邦凱基94購03,,,,,0.00,0.00,0,0,0,0,0,0,0,0,0,0,0,0,0
20200316,050238,瑞昱凱基94購05,,,,,0.00,0.00,0,0,0,0,0,0,0,0,0,0,0,0,0
20200316,050239,廣達凱基94購01,0.41,0.41,0.41,0.41,+0.20,95.24,10000,1,4100,0,0,0,0,0,0,0,10000,-10000,-10000
20200316,05023P,和碩凱基95售01,0.97,1.25,0.97,1.25,+0.14,12.61,74000,6,77720,0,0,0,0,0,0,1000,73000,-72000,-72000
20200316,050240,聯發科凱基94購13,,,,,0.00,0.00,0,0,0,0,0,0,0,0,0,0,0,0,0
20200316,050241,聯發科凱基94購14,,,,,0.00,0.00,0,0,0,0,0,0,0,0,0,0,0,0,0
20200316,050242,義隆凱基94購04,,,,,0.00,0.00,0,0,0,0,0,0,0,0,0,0,0,0,0
20200316,050243,華新科凱基94購10,0.19,0.19,0.19,0.19,+0.05,35.71,30000,3,5700,0,0,0,0,0,0,0,30000,-30000,-30000
20200316,050244,富邦金凱基94購01,,,,,0.00,0.00,0,0,0,0,0,0,0,0,0,0,0,0,0
20200316,050245,大立光凱基94購12,0.53,0.53,0.24,0.27,-0.35,-56.45,202000,13,62220,0,0,0,0,0,0,10000,192000,-182000,-182000
20200316,050246,大立光凱基94購13,,,,,0.00,0.00,0,0,0,0,0,0,0,0,0,0,0,0,0
20200316,050247,智易凱基94購04,,,,,0.00,0.00,0,0,0,0,0,0,0,0,0,0,0,0,0
20200316,050248,臻鼎凱基94購03,,,,,0.00,0.00,0,0,0,0,0,0,0,0,0,0,0,0,0
20200316,050249,瑞儀凱基94購01,,,,,0.00,0.00,0,0,0,0,0,0,0,0,0,0,0,0,0
20200316,05024P,華通國票96售01,,,,,0.00,0.00,0,0,0,0,0,0,0,0,0,0,0,0,0
20200316,050250,台郡凱基94購03,1.57,1.57,1.57,1.57,+0.50,46.73,10000,1,15700,0,0,0,0,0,0,0,10000,-10000,-10000
20200316,050251,樺漢凱基94購02,,,,,0.00,0.00,0,0,0,0,0,0,0,0,0,0,0,0,0
20200316,050252,聯發科國泰95購01,0.85,0.85,0.85,0.85,-0.25,-22.73,1000,1,850,0,0,0,0,0,0,0,1000,-1000,-1000
20200316,050253,百和國泰96購01,0.13,0.13,0.13,0.13,+0.02,18.18,80000,1,10400,0,0,0,0,0,0,80000,0,80000,80000
20200316,050254,大立光富邦96購02,,,,,0.00,0.00,0,0,0,0,0,0,0,0,0,0,0,0,0
20200316,050255,GIS富邦95購01,,,,,0.00,0.00,0,0,0,0,0,0,0,0,0,0,0,0,0
20200316,050256,臺指反元大98購03,1.52,1.66,1.51,1.66,+0.31,22.96,50000,5,78500,0,0,0,0,0,0,10000,40000,-30000,-30000
20200316,050257,為升元大94購07,,,,,0.00,0.00,0,0,0,0,0,0,0,0,0,0,0,0,0
20200316,050258,為升元大94購08,,,,,0.00,0.00,0,0,0,0,0,0,0,0,0,0,0,0,0
20200316,050259,鴻海元大94購14,0.45,0.45,0.45,0.45,+0.09,25.0,10000,1,4500,0,0,0,0,0,0,10000,0,10000,10000
20200316,05025P,聯發科群益95售02,,,,,0.00,0.00,0,0,0,0,0,0,0,0,0,0,0,0,0
20200316,050260,鴻海元大94購15,0.09,0.09,0.09,0.09,0.00,0.00,1000,1,90,0,0,0,0,0,0,1000,1000,0,0
20200316,050261,國巨元大95購04,0.40,0.44,0.33,0.33,-0.10,-23.26,415000,13,176240,0,0,0,0,0,0,388000,10000,378000,378000
20200316,050262,台積電元大94購21,1.18,1.18,0.58,0.58,-0.66,-53.23,255000,12,272100,0,0,0,0,0,0,200000,55000,145000,145000
20200316,050263,旺宏元大94購10,0.29,0.29,0.12,0.12,-0.07,-36.84,66000,5,13220,0,0,0,0,0,0,35000,31000,4000,4000
20200316,050264,聯發科元大94購13,0.27,0.27,0.09,0.09,-0.26,-74.29,187000,22,23990,0,0,0,0,0,0,0,187000,-187000,-187000
20200316,050265,美食元大94購05,,,,,0.00,0.00,0,0,0,0,0,0,0,0,0,0,0,0,0
20200316,050266,兆豐金元大94購01,0.49,0.53,0.49,0.53,+0.08,17.78,163000,6,83150,0,0,0,0,0,0,163000,0,163000,163000
20200316,050267,奇鋐元大94購03,,,,,0.00,0.00,0,0,0,0,0,0,0,0,0,0,0,0,0
20200316,050268,智原元大95購03,,,,,0.00,0.00,0,0,0,0,0,0,0,0,0,0,0,0,0
20200316,050269,欣興元大94購09,,,,,0.00,0.00,0,0,0,0,0,0,0,0,0,0,0,0,0
20200316,05026P,貿聯群益95售01,,,,,0.00,0.00,0,0,0,0,0,0,0,0,0,0,0,0,0
20200316,050270,景碩元大94購01,,,,,0.00,0.00,0,0,0,0,0,0,0,0,0,0,0,0,0
20200316,050271,上緯控元大96購01,0.12,0.12,0.11,0.11,0.00,0.00,20000,2,2300,0,0,0,0,0,0,0,20000,-20000,-20000
20200316,050272,訊芯元大94購03,,,,,0.00,0.00,0,0,0,0,0,0,0,0,0,0,0,0,0
20200316,050273,GIS元大94購04,,,,,0.00,0.00,0,0,0,0,0,0,0,0,0,0,0,0,0
20200316,050274,GIS元大94購05,,,,,0.00,0.00,0,0,0,0,0,0,0,0,0,0,0,0,0
20200316,050275,緯穎元大94購10,6.90,6.90,6.90,6.90,0.00,0.00,4000,1,27600,0,0,0,0,0,0,0,4000,-4000,-4000
20200316,050276,百和元大94購03,,,,,0.00,0.00,0,0,0,0,0,0,0,0,0,0,0,0,0
20200316,050277,上銀亞東94購01,,,,,0.00,0.00,0,0,0,0,0,0,0,0,0,0,0,0,0
20200316,050278,上証2X第一94購01,,,,,0.00,0.00,0,0,0,0,0,0,0,0,0,0,0,0,0
20200316,050279,彩晶第一94購01,,,,,0.00,0.00,0,0,0,0,0,0,0,0,0,0,0,0,0
20200316,05027P,南電群益95售01,,,,,0.00,0.00,0,0,0,0,0,0,0,0,0,0,0,0,0
20200316,050280,國巨日盛94購01,,,,,0.00,0.00,0,0,0,0,0,0,0,0,0,0,0,0,0
20200316,050281,台積電日盛94購03,,,,,0.00,0.00,0,0,0,0,0,0,0,0,0,0,0,0,0
20200316,050282,T50反1凱基97購01,,,,,0.00,0.00,0,0,0,0,0,0,0,0,0,0,0,0,0
20200316,050283,T50反1凱基9A購01,1.38,1.38,1.38,1.38,+0.28,25.45,2000,1,2760,0,0,0,0,0,0,0,2000,-2000,-2000
20200316,050284,台泥凱基94購01,,,,,0.00,0.00,0,0,0,0,0,0,0,0,0,0,0,0,0
20200316,050285,力山凱基94購06,,,,,0.00,0.00,0,0,0,0,0,0,0,0,0,0,0,0,0
20200316,050286,為升凱基94購05,,,,,0.00,0.00,0,0,0,0,0,0,0,0,0,0,0,0,0
20200316,050287,台達電凱基94購10,,,,,0.00,0.00,0,0,0,0,0,0,0,0,0,0,0,0,0
20200316,050288,台積電凱基94購32,,,,,0.00,0.00,0,0,0,0,0,0,0,0,0,0,0,0,0
20200316,050289,光磊凱基94購04,,,,,0.00,0.00,0,0,0,0,0,0,0,0,0,0,0,0,0
20200316,05028P,康控永豐95售02,3.19,3.19,3.19,3.19,+0.52,19.48,2000,1,6380,0,0,0,0,0,0,2000,0,2000,2000
20200316,050290,南亞科凱基94購06,,,,,0.00,0.00,0,0,0,0,0,0,0,0,0,0,0,0,0
20200316,050291,聯發科凱基94購16,,,,,0.00,0.00,0,0,0,0,0,0,0,0,0,0,0,0,0
20200316,050292,可成凱基94購11,,,,,0.00,0.00,0,0,0,0,0,0,0,0,0,0,0,0,0
20200316,050293,強茂凱基94購01,,,,,0.00,0.00,0,0,0,0,0,0,0,0,0,0,0,0,0
20200316,050294,宏達電凱基94購04,,,,,0.00,0.00,0,0,0,0,0,0,0,0,0,0,0,0,0
20200316,050295,大立光凱基94購16,,,,,0.00,0.00,0,0,0,0,0,0,0,0,0,0,0,0,0
20200316,050296,亞光凱基94購03,,,,,0.00,0.00,0,0,0,0,0,0,0,0,0,0,0,0,0
20200316,050297,欣興凱基94購08,,,,,0.00,0.00,0,0,0,0,0,0,0,0,0,0,0,0,0
20200316,050298,智伸科凱基94購02,,,,,0.00,0.00,0,0,0,0,0,0,0,0,0,0,0,0,0
20200316,050299,康普凱基94購01,,,,,0.00,0.00,0,0,0,0,0,0,0,0,0,0,0,0,0
20200316,05029P,鴻海元富95售04,1.70,1.73,1.68,1.68,+0.07,4.35,18000,3,30590,0,0,0,0,0,0,18000,0,18000,18000
20200316,050300,康控凱基94購03,,,,,0.00,0.00,0,0,0,0,0,0,0,0,0,0,0,0,0
20200316,050301,矽創凱基94購03,,,,,0.00,0.00,0,0,0,0,0,0,0,0,0,0,0,0,0
20200316,050302,百和凱基94購03,,,,,0.00,0.00,0,0,0,0,0,0,0,0,0,0,0,0,0
20200316,050303,S&P反1中信96購01,2.47,2.47,2.47,2.47,-0.44,-15.12,10000,1,24700,0,0,0,0,0,0,0,10000,-10000,-10000
20200316,050304,台光電中信94購01,0.02,0.02,0.02,0.02,0.00,0.00,550000,55,11000,0,0,0,0,0,0,0,550000,-550000,-550000
20200316,050305,正崴中信95購01,,,,,0.00,0.00,0,0,0,0,0,0,0,0,0,0,0,0,0
20200316,050306,聯發科中信97購01,0.25,0.25,0.18,0.20,-0.15,-42.86,44000,5,9500,0,0,0,0,0,0,0,44000,-44000,-44000
20200316,050307,欣興中信95購01,,,,,0.00,0.00,0,0,0,0,0,0,0,0,0,0,0,0,0
20200316,050308,矽創中信97購01,,,,,0.00,0.00,0,0,0,0,0,0,0,0,0,0,0,0,0
20200316,050309,亞泥兆豐94購01,0.08,0.08,0.08,0.08,0.00,0.00,40000,4,3200,0,0,0,0,0,0,0,40000,-40000,-40000
20200316,05030P,台積電元富95售04,0.97,1.56,0.97,1.56,+0.77,97.47,42000,11,50340,0,0,0,0,0,0,42000,27000,15000,15000
20200316,050310,卜蜂兆豐94購01,,,,,0.00,0.00,0,0,0,0,0,0,0,0,0,0,0,0,0
20200316,050311,上銀兆豐95購01,0.52,0.52,0.35,0.35,-0.18,-33.96,514000,13,226560,0,0,0,0,0,0,314000,200000,114000,114000
20200316,050312,大立光兆豐94購04,0.08,0.09,0.04,0.04,-0.01,-20.0,120000,7,8340,0,0,0,0,0,0,40000,80000,-40000,-40000
20200316,050313,大立光兆豐94購05,,,,,0.00,0.00,0,0,0,0,0,0,0,0,0,0,0,0,0
20200316,050314,晶技兆豐94購01,,,,,0.00,0.00,0,0,0,0,0,0,0,0,0,0,0,0,0
20200316,050315,和碩兆豐95購01,0.29,0.29,0.19,0.21,-0.11,-34.38,108000,9,26830,0,0,0,0,0,0,68000,40000,28000,28000
20200316,050316,上証2X國票98購01,,,,,0.00,0.00,0,0,0,0,0,0,0,0,0,0,0,0,0
20200316,050317,和鑫國票95購02,,,,,0.00,0.00,0,0,0,0,0,0,0,0,0,0,0,0,0
20200316,050318,景碩國票94購02,,,,,0.00,0.00,0,0,0,0,0,0,0,0,0,0,0,0,0
20200316,050319,康控國票95購04,,,,,0.00,0.00,0,0,0,0,0,0,0,0,0,0,0,0,0
20200316,05031P,台光電元富95售01,,,,,0.00,0.00,0,0,0,0,0,0,0,0,0,0,0,0,0
20200316,050320,台表科國票94購01,0.37,0.37,0.37,0.37,+0.13,54.17,6000,1,2220,0,0,0,0,0,0,6000,0,6000,6000
20200316,050321,GIS國票95購02,,,,,0.00,0.00,0,0,0,0,0,0,0,0,0,0,0,0,0
20200316,050322,世紀鋼國票95購01,2.13,2.13,1.79,1.94,+0.46,31.08,247000,5,477130,0,0,0,0,0,0,237000,10000,227000,227000
20200316,050323,嘉聯益台新94購01,,,,,0.00,0.00,0,0,0,0,0,0,0,0,0,0,0,0,0
20200316,050324,訊芯台新94購01,,,,,0.00,0.00,0,0,0,0,0,0,0,0,0,0,0,0,0
20200316,050325,台積電永豐94購05,0.22,0.22,0.20,0.20,0.00,0.00,49000,2,10580,0,0,0,0,0,0,39000,10000,29000,29000
20200316,050326,正崴永豐94購03,,,,,0.00,0.00,0,0,0,0,0,0,0,0,0,0,0,0,0
20200316,050327,泰鼎永豐94購03,,,,,0.00,0.00,0,0,0,0,0,0,0,0,0,0,0,0,0
20200316,050328,臻鼎永豐94購03,,,,,0.00,0.00,0,0,0,0,0,0,0,0,0,0,0,0,0
20200316,050329,超眾永豐94購03,,,,,0.00,0.00,0,0,0,0,0,0,0,0,0,0,0,0,0
20200316,05032P,台積電國泰96售05,4.20,4.23,4.20,4.23,+0.65,18.16,20000,2,84300,0,0,0,0,0,0,20000,10000,10000,10000
20200316,050330,南電永豐94購01,,,,,0.00,0.00,0,0,0,0,0,0,0,0,0,0,0,0,0
20200316,050331,鈺齊永豐94購02,,,,,0.00,0.00,0,0,0,0,0,0,0,0,0,0,0,0,0
20200316,050332,鴻海國泰96購05,,,,,0.00,0.00,0,0,0,0,0,0,0,0,0,0,0,0,0
20200316,050333,鴻海國泰96購06,0.49,0.49,0.49,0.49,-0.21,-30.0,5000,1,2450,0,0,0,0,0,0,0,0,0,0
20200316,050334,鴻海國泰96購07,0.46,0.46,0.43,0.45,+0.10,28.57,311000,31,136860,0,0,0,0,0,0,11000,300000,-289000,-289000
20200316,050335,正崴國泰96購01,,,,,0.00,0.00,0,0,0,0,0,0,0,0,0,0,0,0,0
20200316,050336,緯穎國泰94購02,7.45,7.45,6.65,6.90,+2.11,44.05,52000,10,368550,0,0,0,0,0,0,47000,0,47000,47000
20200316,050337,南電國泰95購01,0.43,0.43,0.30,0.30,-0.10,-25.0,499000,4,197160,0,0,0,0,0,0,499000,0,499000,499000
20200316,050338,TPK富邦96購01,,,,,0.00,0.00,0,0,0,0,0,0,0,0,0,0,0,0,0
20200316,050339,鴻海統一94購06,,,,,0.00,0.00,0,0,0,0,0,0,0,0,0,0,0,0,0
20200316,05033P,T50反1元大98售01,0.45,0.45,0.45,0.45,-0.05,-10.0,10000,1,4500,0,0,0,0,0,0,0,10000,-10000,-10000
20200316,050340,鴻海統一94購07,,,,,0.00,0.00,0,0,0,0,0,0,0,0,0,0,0,0,0
20200316,050341,光寶科元富94購01,,,,,0.00,0.00,0,0,0,0,0,0,0,0,0,0,0,0,0
20200316,050342,華通元富94購02,,,,,0.00,0.00,0,0,0,0,0,0,0,0,0,0,0,0,0
20200316,050343,鴻海元富94購01,,,,,0.00,0.00,0,0,0,0,0,0,0,0,0,0,0,0,0
20200316,050344,鴻海元富96購01,,,,,0.00,0.00,0,0,0,0,0,0,0,0,0,0,0,0,0
20200316,050345,創意元富94購02,,,,,0.00,0.00,0,0,0,0,0,0,0,0,0,0,0,0,0
20200316,050346,康友元富94購03,,,,,0.00,0.00,0,0,0,0,0,0,0,0,0,0,0,0,0
20200316,050347,上証2X群益98購01,0.17,0.17,0.17,0.17,0.00,0.00,100000,1,17000,0,0,0,0,0,0,0,100000,-100000,-100000
20200316,050348,鴻海群益94購06,0.21,0.21,0.13,0.13,0.00,0.00,100000,4,16200,0,0,0,0,0,0,100000,0,100000,100000
20200316,050349,中環群益94購01,,,,,0.00,0.00,0,0,0,0,0,0,0,0,0,0,0,0,0
20200316,05034P,台積電元大95售08,1.91,2.64,1.91,2.46,+0.40,19.42,574000,55,1282910,0,0,0,0,0,0,456000,455000,1000,1000
20200316,050350,全新群益94購04,,,,,0.00,0.00,0,0,0,0,0,0,0,0,0,0,0,0,0
20200316,050351,華新科群益95購02,,,,,0.00,0.00,0,0,0,0,0,0,0,0,0,0,0,0,0
20200316,050352,欣興群益95購01,,,,,0.00,0.00,0,0,0,0,0,0,0,0,0,0,0,0,0
20200316,050353,華擎群益95購01,,,,,0.00,0.00,0,0,0,0,0,0,0,0,0,0,0,0,0
20200316,050354,瀚宇博群益94購02,,,,,0.00,0.00,0,0,0,0,0,0,0,0,0,0,0,0,0
20200316,050355,瑞儀群益94購01,,,,,0.00,0.00,0,0,0,0,0,0,0,0,0,0,0,0,0
20200316,050356,緯穎群益94購05,4.74,4.74,4.45,4.45,+0.30,7.23,11000,2,51850,0,0,0,0,0,0,1000,10000,-9000,-9000
20200316,050357,南電群益94購02,,,,,0.00,0.00,0,0,0,0,0,0,0,0,0,0,0,0,0
20200316,050358,致新群益94購01,,,,,0.00,0.00,0,0,0,0,0,0,0,0,0,0,0,0,0
20200316,050359,T50反1元大94購05,,,,,0.00,0.00,0,0,0,0,0,0,0,0,0,0,0,0,0
20200316,05035P,聯發科元大95售06,3.18,3.18,3.18,3.18,0.00,0.00,2000,1,6360,0,0,0,0,0,0,2000,0,2000,2000
20200316,050360,T50反1元大94購06,,,,,0.00,0.00,0,0,0,0,0,0,0,0,0,0,0,0,0
20200316,050361,T50反1元大94購07,,,,,0.00,0.00,0,0,0,0,0,0,0,0,0,0,0,0,0
20200316,050362,深中小元大94購04,1.00,1.02,1.00,1.02,0.00,0.00,20000,2,20200,0,0,0,0,0,0,0,20000,-20000,-20000
20200316,050363,臺指反元大98購04,2.05,2.31,2.00,2.29,+0.44,23.78,1417000,30,2971480,0,0,0,0,0,0,391000,50000,341000,341000
20200316,050364,卜蜂元大94購02,0.02,0.02,0.02,0.02,0.00,0.00,100000,1,2000,0,0,0,0,0,0,100000,0,100000,100000
20200316,050365,中石化元大94購02,,,,,0.00,0.00,0,0,0,0,0,0,0,0,0,0,0,0,0
20200316,050366,鴻海元大94購19,0.49,0.55,0.30,0.30,0.00,0.00,96000,5,41400,0,0,0,0,0,0,68000,28000,40000,40000
20200316,050367,鴻海元大94購20,0.11,0.11,0.08,0.08,0.00,0.00,51000,6,4410,0,0,0,0,0,0,1000,51000,-50000,-50000
20200316,050368,國巨元大94購14,0.41,0.43,0.40,0.40,+0.10,33.33,30000,3,12350,0,0,0,0,0,0,20000,10000,10000,10000
20200316,050369,台積電元大94購23,1.42,1.42,0.82,0.82,-0.60,-42.25,240000,24,274830,0,0,0,0,0,0,110000,150000,-40000,-40000
20200316,05036P,義隆元大95售03,,,,,0.00,0.00,0,0,0,0,0,0,0,0,0,0,0,0,0
20200316,050370,台積電元大94購24,0.77,0.77,0.38,0.41,-0.03,-6.82,398000,38,241560,0,0,0,0,0,0,30000,368000,-338000,-338000
20200316,050371,台積電元大94購25,0.98,1.03,0.49,0.59,-0.01,-1.67,113000,12,91370,0,0,0,0,0,0,40000,73000,-33000,-33000
20200316,050372,全新元大96購03,,,,,0.00,0.00,0,0,0,0,0,0,0,0,0,0,0,0,0
20200316,050373,奇鋐元大94購04,,,,,0.00,0.00,0,0,0,0,0,0,0,0,0,0,0,0,0
20200316,050374,上緯控元大95購01,0.07,0.07,0.07,0.07,-0.01,-12.5,5000,1,350,0,0,0,0,0,0,0,5000,-5000,-5000
20200316,050375,矽創元大94購02,,,,,0.00,0.00,0,0,0,0,0,0,0,0,0,0,0,0,0
20200316,050376,百和元大95購01,,,,,0.00,0.00,0,0,0,0,0,0,0,0,0,0,0,0,0
20200316,050377,華通第一94購01,,,,,0.00,0.00,0,0,0,0,0,0,0,0,0,0,0,0,0
20200316,050378,上証2X群益98購02,0.24,0.24,0.19,0.20,-0.10,-33.33,455000,48,89810,0,0,0,0,0,0,245000,287000,-42000,-42000
20200316,050379,易華電群益96購01,,,,,0.00,0.00,0,0,0,0,0,0,0,0,0,0,0,0,0
20200316,05037P,華新科元大95售09,0.77,1.26,0.77,1.26,-0.02,-1.56,232000,22,214020,0,0,0,0,0,0,210000,192000,18000,18000
20200316,050380,台積電亞東94購02,0.42,0.42,0.37,0.40,+0.13,48.15,100000,10,39700,0,0,0,0,0,0,100000,100000,0,0
20200316,050381,鴻海兆豐94購01,,,,,0.00,0.00,0,0,0,0,0,0,0,0,0,0,0,0,0
20200316,050382,TPK兆豐95購02,,,,,0.00,0.00,0,0,0,0,0,0,0,0,0,0,0,0,0
20200316,050383,超眾兆豐95購01,0.43,0.43,0.43,0.43,+0.05,13.16,10000,1,4300,0,0,0,0,0,0,10000,0,10000,10000
20200316,050384,嘉澤國票94購02,,,,,0.00,0.00,0,0,0,0,0,0,0,0,0,0,0,0,0
20200316,050385,貿聯國票95購02,0.20,0.20,0.20,0.20,+0.01,5.26,30000,1,6000,0,0,0,0,0,0,30000,0,30000,30000
20200316,050386,智伸科國票94購01,,,,,0.00,0.00,0,0,0,0,0,0,0,0,0,0,0,0,0
20200316,050387,鴻海統一94購08,,,,,0.00,0.00,0,0,0,0,0,0,0,0,0,0,0,0,0
20200316,050388,鴻海統一94購09,,,,,0.00,0.00,0,0,0,0,0,0,0,0,0,0,0,0,0
20200316,050389,鴻海統一95購04,0.11,0.11,0.11,0.11,0.00,0.00,10000,1,1100,0,0,0,0,0,0,0,10000,-10000,-10000
20200316,05038P,牧德元大95售03,0.81,0.90,0.81,0.90,+0.11,13.92,130000,13,109600,0,0,0,0,0,0,0,130000,-130000,-130000
20200316,050390,聯發科統一94購09,,,,,0.00,0.00,0,0,0,0,0,0,0,0,0,0,0,0,0
20200316,050391,大立光統一94購07,,,,,0.00,0.00,0,0,0,0,0,0,0,0,0,0,0,0,0
20200316,050392,群創統一96購01,,,,,0.00,0.00,0,0,0,0,0,0,0,0,0,0,0,0,0
20200316,050393,樺漢統一94購01,,,,,0.00,0.00,0,0,0,0,0,0,0,0,0,0,0,0,0
20200316,050394,大立光元富94購09,,,,,0.00,0.00,0,0,0,0,0,0,0,0,0,0,0,0,0
20200316,050395,大立光元富94購10,,,,,0.00,0.00,0,0,0,0,0,0,0,0,0,0,0,0,0
20200316,050396,欣興元富94購02,0.01,0.01,0.01,0.01,0.00,0.00,73000,1,730,0,0,0,0,0,0,73000,0,73000,73000
20200316,050397,力成元富94購01,,,,,0.00,0.00,0,0,0,0,0,0,0,0,0,0,0,0,0
20200316,050398,上証2X中信97購01,0.06,0.06,0.06,0.06,-0.02,-25.0,134000,14,8040,0,0,0,0,0,0,0,134000,-134000,-134000
20200316,050399,潤泰全中信95購01,0.08,0.08,0.07,0.07,+0.02,40.0,800000,80,60000,0,0,0,0,0,0,0,800000,-800000,-800000
20200316,05039P,鴻海凱基95售10,1.12,1.37,1.11,1.34,+0.32,31.37,96000,15,120400,0,0,0,0,0,0,86000,30000,56000,56000
20200316,050400,臻鼎中信97購01,0.03,0.03,0.03,0.03,+0.01,50.0,10000,1,300,0,0,0,0,0,0,0,0,0,0
20200316,050401,鎧勝中信94購01,,,,,0.00,0.00,0,0,0,0,0,0,0,0,0,0,0,0,0
20200316,050402,緯穎中信96購01,1.28,1.46,1.28,1.30,+0.34,35.42,374000,43,515590,0,0,0,0,0,0,343000,31000,312000,312000
20200316,050403,台積電麥證94購02,,,,,0.00,0.00,0,0,0,0,0,0,0,0,0,0,0,0,0
20200316,050404,元大金麥證94購01,,,,,0.00,0.00,0,0,0,0,0,0,0,0,0,0,0,0,0
20200316,050405,新光金麥證94購01,,,,,0.00,0.00,0,0,0,0,0,0,0,0,0,0,0,0,0
20200316,050406,台積電台新95購02,0.85,0.88,0.84,0.88,+0.41,87.23,619000,4,527250,0,0,0,0,0,0,549000,619000,-70000,-70000
20200316,050407,聯詠台新94購02,,,,,0.00,0.00,0,0,0,0,0,0,0,0,0,0,0,0,0
20200316,050408,臻鼎台新94購02,,,,,0.00,0.00,0,0,0,0,0,0,0,0,0,0,0,0,0
20200316,050409,華通永豐94購01,,,,,0.00,0.00,0,0,0,0,0,0,0,0,0,0,0,0,0
20200316,05040P,聯發科凱基95售05,1.67,1.99,1.67,1.99,-0.30,-13.1,13000,3,22270,0,0,0,0,0,0,10000,3000,7000,7000
20200316,050410,燿華永豐95購03,,,,,0.00,0.00,0,0,0,0,0,0,0,0,0,0,0,0,0
20200316,050411,聯發科永豐94購05,,,,,0.00,0.00,0,0,0,0,0,0,0,0,0,0,0,0,0
20200316,050412,全新永豐94購04,,,,,0.00,0.00,0,0,0,0,0,0,0,0,0,0,0,0,0
20200316,050413,麗豐永豐94購01,,,,,0.00,0.00,0,0,0,0,0,0,0,0,0,0,0,0,0
20200316,050414,泰鼎永豐94購04,1.47,1.52,1.44,1.44,-0.03,-2.04,25000,12,37020,0,0,0,0,0,0,25000,0,25000,25000
20200316,050415,力成永豐94購01,,,,,0.00,0.00,0,0,0,0,0,0,0,0,0,0,0,0,0
20200316,050416,高股息凱基96購02,0.06,0.06,0.05,0.05,0.00,0.00,180000,5,9600,0,0,0,0,0,0,0,0,0,0
20200316,050417,喬山凱基94購01,,,,,0.00,0.00,0,0,0,0,0,0,0,0,0,0,0,0,0
20200316,050418,為升凱基94購06,,,,,0.00,0.00,0,0,0,0,0,0,0,0,0,0,0,0,0
20200316,050419,鴻海凱基95購02,0.20,0.20,0.20,0.20,-0.13,-39.39,10000,2,2000,0,0,0,0,0,0,0,10000,-10000,-10000
20200316,05041P,大立光凱基95售09,1.37,1.64,1.37,1.64,+0.38,30.16,14000,3,19820,0,0,0,0,0,0,14000,0,14000,14000
20200316,050420,鴻海凱基95購03,,,,,0.00,0.00,0,0,0,0,0,0,0,0,0,0,0,0,0
20200316,050421,鴻海凱基95購04,,,,,0.00,0.00,0,0,0,0,0,0,0,0,0,0,0,0,0
20200316,050422,鴻海凱基96購01,,,,,0.00,0.00,0,0,0,0,0,0,0,0,0,0,0,0,0
20200316,050423,鴻海凱基96購02,,,,,0.00,0.00,0,0,0,0,0,0,0,0,0,0,0,0,0
20200316,050424,鴻海凱基96購03,,,,,0.00,0.00,0,0,0,0,0,0,0,0,0,0,0,0,0
20200316,050425,國巨凱基94購12,0.35,0.35,0.35,0.35,0.00,0.00,20000,2,7000,0,0,0,0,0,0,0,20000,-20000,-20000
20200316,050426,國巨凱基94購14,,,,,0.00,0.00,0,0,0,0,0,0,0,0,0,0,0,0,0
20200316,050427,台積電凱基94購34,0.90,1.30,0.87,0.87,-0.10,-10.31,117000,6,135300,0,0,0,0,0,0,87000,10000,77000,77000
20200316,050428,光磊凱基94購05,,,,,0.00,0.00,0,0,0,0,0,0,0,0,0,0,0,0,0
20200316,050429,漢唐凱基94購04,0.42,0.42,0.36,0.36,+0.06,20.0,88000,2,32880,0,0,0,0,0,0,20000,68000,-48000,-48000
20200316,05042P,GIS凱基95售03,,,,,0.00,0.00,0,0,0,0,0,0,0,0,0,0,0,0,0
20200316,050430,京元電凱基94購03,,,,,0.00,0.00,0,0,0,0,0,0,0,0,0,0,0,0,0
20200316,050431,聯發科凱基94購18,,,,,0.00,0.00,0,0,0,0,0,0,0,0,0,0,0,0,0
20200316,050432,聯發科凱基94購19,,,,,0.00,0.00,0,0,0,0,0,0,0,0,0,0,0,0,0
20200316,050433,華新科凱基94購11,,,,,0.00,0.00,0,0,0,0,0,0,0,0,0,0,0,0,0
20200316,050434,富邦金凱基94購02,,,,,0.00,0.00,0,0,0,0,0,0,0,0,0,0,0,0,0
20200316,050435,大立光凱基94購17,,,,,0.00,0.00,0,0,0,0,0,0,0,0,0,0,0,0,0
20200316,050436,大立光凱基94購18,,,,,0.00,0.00,0,0,0,0,0,0,0,0,0,0,0,0,0
20200316,050437,聯詠凱基94購04,,,,,0.00,0.00,0,0,0,0,0,0,0,0,0,0,0,0,0
20200316,050438,欣興凱基94購09,,,,,0.00,0.00,0,0,0,0,0,0,0,0,0,0,0,0,0
20200316,050439,新日興凱基94購01,0.10,0.10,0.10,0.10,0.00,0.00,9000,1,900,0,0,0,0,0,0,9000,0,9000,9000
20200316,05043P,佳世達元富95售01,,,,,0.00,0.00,0,0,0,0,0,0,0,0,0,0,0,0,0
20200316,050440,揚明光凱基94購05,,,,,0.00,0.00,0,0,0,0,0,0,0,0,0,0,0,0,0
20200316,050441,和碩凱基94購01,,,,,0.00,0.00,0,0,0,0,0,0,0,0,0,0,0,0,0
20200316,050442,復盛凱基94購01,0.04,0.04,0.04,0.04,0.00,0.00,480000,1,19200,0,0,0,0,0,0,480000,0,480000,480000
20200316,050443,復盛凱基94購02,,,,,0.00,0.00,0,0,0,0,0,0,0,0,0,0,0,0,0
20200316,050444,卜蜂元大94購03,,,,,0.00,0.00,0,0,0,0,0,0,0,0,0,0,0,0,0
20200316,050445,鴻海元大94購21,,,,,0.00,0.00,0,0,0,0,0,0,0,0,0,0,0,0,0
20200316,050446,鴻海元大94購22,0.12,0.12,0.12,0.12,0.00,0.00,3000,1,360,0,0,0,0,0,0,0,3000,-3000,-3000
20200316,050447,廣達元大94購01,1.01,1.01,1.01,1.01,-0.17,-14.41,30000,1,30300,0,0,0,0,0,0,30000,0,30000,30000
20200316,050448,義隆元大94購04,,,,,0.00,0.00,0,0,0,0,0,0,0,0,0,0,0,0,0
20200316,050449,宏達電元大95購03,,,,,0.00,0.00,0,0,0,0,0,0,0,0,0,0,0,0,0
20200316,05044P,亞德客永豐95售01,,,,,0.00,0.00,0,0,0,0,0,0,0,0,0,0,0,0,0
20200316,050450,富邦金元大94購03,,,,,0.00,0.00,0,0,0,0,0,0,0,0,0,0,0,0,0
20200316,050451,嘉晶元大95購01,0.99,1.03,0.75,0.82,-0.14,-14.58,644000,45,592710,0,0,0,0,0,0,405000,239000,166000,166000
20200316,050452,智原元大95購04,,,,,0.00,0.00,0,0,0,0,0,0,0,0,0,0,0,0,0
20200316,050453,創意元大95購03,0.03,0.03,0.03,0.03,+0.01,50.0,960000,2,28800,0,0,0,0,0,0,960000,0,960000,960000
20200316,050454,嘉澤元大94購04,,,,,0.00,0.00,0,0,0,0,0,0,0,0,0,0,0,0,0
20200316,050455,貿聯元大94購02,,,,,0.00,0.00,0,0,0,0,0,0,0,0,0,0,0,0,0
20200316,050456,聯茂元大94購09,0.13,0.13,0.13,0.13,+0.05,62.5,1000,1,130,0,0,0,0,0,0,1000,0,1000,1000
20200316,050457,力成元大94購01,,,,,0.00,0.00,0,0,0,0,0,0,0,0,0,0,0,0,0
20200316,050458,台郡元大94購03,1.35,1.55,1.25,1.25,0.00,0.00,23000,3,32750,0,0,0,0,0,0,10000,13000,-3000,-3000
20200316,050459,台表科元大94購03,0.57,0.57,0.49,0.49,+0.03,6.52,30000,2,15500,0,0,0,0,0,0,20000,10000,10000,10000
20200316,05045P,台積電永豐95售01,,,,,0.00,0.00,0,0,0,0,0,0,0,0,0,0,0,0,0
20200316,050460,GIS元大95購03,,,,,0.00,0.00,0,0,0,0,0,0,0,0,0,0,0,0,0
20200316,050461,GIS元大95購04,,,,,0.00,0.00,0,0,0,0,0,0,0,0,0,0,0,0,0
20200316,050462,寶成元大94購01,,,,,0.00,0.00,0,0,0,0,0,0,0,0,0,0,0,0,0
20200316,050463,百和元大94購04,,,,,0.00,0.00,0,0,0,0,0,0,0,0,0,0,0,0,0
20200316,050464,華通國泰95購01,,,,,0.00,0.00,0,0,0,0,0,0,0,0,0,0,0,0,0
20200316,050465,神基中信94購01,,,,,0.00,0.00,0,0,0,0,0,0,0,0,0,0,0,0,0
20200316,050466,瑞儀中信94購01,,,,,0.00,0.00,0,0,0,0,0,0,0,0,0,0,0,0,0
20200316,050467,力成中信94購01,,,,,0.00,0.00,0,0,0,0,0,0,0,0,0,0,0,0,0
20200316,050468,矽格中信94購01,,,,,0.00,0.00,0,0,0,0,0,0,0,0,0,0,0,0,0
20200316,050469,聯電台新94購01,,,,,0.00,0.00,0,0,0,0,0,0,0,0,0,0,0,0,0
20200316,05046P,台光電永豐95售02,,,,,0.00,0.00,0,0,0,0,0,0,0,0,0,0,0,0,0
20200316,050470,智邦台新94購01,,,,,0.00,0.00,0,0,0,0,0,0,0,0,0,0,0,0,0
20200316,050471,國泰金台新94購01,,,,,0.00,0.00,0,0,0,0,0,0,0,0,0,0,0,0,0
20200316,050472,和大永豐94購01,,,,,0.00,0.00,0,0,0,0,0,0,0,0,0,0,0,0,0
20200316,050473,劍麟永豐94購02,,,,,0.00,0.00,0,0,0,0,0,0,0,0,0,0,0,0,0
20200316,050474,鴻海永豐94購05,,,,,0.00,0.00,0,0,0,0,0,0,0,0,0,0,0,0,0
20200316,050475,揚明光永豐95購01,,,,,0.00,0.00,0,0,0,0,0,0,0,0,0,0,0,0,0
20200316,050476,瑞儀永豐94購01,,,,,0.00,0.00,0,0,0,0,0,0,0,0,0,0,0,0,0
20200316,050477,矽力永豐94購01,0.34,0.34,0.16,0.16,-0.18,-52.94,31000,4,5540,0,0,0,0,0,0,0,31000,-31000,-31000
20200316,050478,致新永豐94購02,,,,,0.00,0.00,0,0,0,0,0,0,0,0,0,0,0,0,0
20200316,050479,上証2X國票95購02,,,,,0.00,0.00,0,0,0,0,0,0,0,0,0,0,0,0,0
20200316,05047P,強茂永豐95售02,,,,,0.00,0.00,0,0,0,0,0,0,0,0,0,0,0,0,0
20200316,050480,健策國票95購04,1.06,1.06,1.06,1.06,-0.08,-7.02,40000,2,42400,0,0,0,0,0,0,40000,0,40000,40000
20200316,050481,泰鼎國票96購01,0.97,0.97,0.97,0.97,0.00,0.00,10000,1,9700,0,0,0,0,0,0,10000,0,10000,10000
20200316,050482,台郡國票94購04,1.52,1.52,1.52,1.52,-0.07,-4.4,30000,2,45600,0,0,0,0,0,0,30000,0,30000,30000
20200316,050483,樺漢國票94購01,,,,,0.00,0.00,0,0,0,0,0,0,0,0,0,0,0,0,0
20200316,050484,世紀鋼國票95購02,1.70,1.73,1.69,1.73,+0.22,14.57,51000,5,87380,0,0,0,0,0,0,36000,0,36000,36000
20200316,050485,國巨統一96購01,,,,,0.00,0.00,0,0,0,0,0,0,0,0,0,0,0,0,0
20200316,050486,可成元富94購05,,,,,0.00,0.00,0,0,0,0,0,0,0,0,0,0,0,0,0
20200316,050487,美食元富94購01,,,,,0.00,0.00,0,0,0,0,0,0,0,0,0,0,0,0,0
20200316,050488,美食元富94購02,,,,,0.00,0.00,0,0,0,0,0,0,0,0,0,0,0,0,0
20200316,050489,聯詠元富94購01,0.40,0.40,0.40,0.40,0.00,0.00,1000,1,400,0,0,0,0,0,0,0,1000,-1000,-1000
20200316,05048P,同欣電永豐95售01,,,,,0.00,0.00,0,0,0,0,0,0,0,0,0,0,0,0,0
20200316,050490,上証2X國泰95購01,,,,,0.00,0.00,0,0,0,0,0,0,0,0,0,0,0,0,0
20200316,050491,旺宏國泰96購01,0.63,0.65,0.38,0.38,-0.18,-32.14,591000,20,305550,0,0,0,0,0,0,353000,415000,-62000,-62000
20200316,050492,漢唐國泰96購01,1.16,1.19,0.89,0.89,0.00,0.00,488000,15,534030,0,0,0,0,0,0,441000,47000,394000,394000
20200316,050493,聯發科永昌96購01,0.31,0.31,0.31,0.31,0.00,0.00,10000,1,3100,0,0,0,0,0,0,0,10000,-10000,-10000
20200316,050494,可成永昌96購01,,,,,0.00,0.00,0,0,0,0,0,0,0,0,0,0,0,0,0
20200316,050495,大立光永昌96購01,,,,,0.00,0.00,0,0,0,0,0,0,0,0,0,0,0,0,0
20200316,050496,鴻海富邦96購01,0.09,0.17,0.09,0.17,0.00,0.00,20000,2,2600,0,0,0,0,0,0,10000,10000,0,0
20200316,050497,臺指反凱基96購02,0.96,1.13,0.95,1.12,+0.24,27.27,153000,15,157060,0,0,0,0,0,0,70000,153000,-83000,-83000
20200316,050498,為升凱基94購07,,,,,0.00,0.00,0,0,0,0,0,0,0,0,0,0,0,0,0
20200316,050499,台達電凱基94購11,,,,,0.00,0.00,0,0,0,0,0,0,0,0,0,0,0,0,0
20200316,05049P,矽創永豐95售01,1.50,1.78,1.39,1.78,+0.05,2.89,138000,18,222540,0,0,0,0,0,0,18000,120000,-102000,-102000
20200316,050500,台積電凱基94購36,0.27,0.27,0.27,0.27,+0.22,440.0,2000,1,540,0,0,0,0,0,0,2000,0,2000,2000
20200316,050501,佳世達凱基94購03,,,,,0.00,0.00,0,0,0,0,0,0,0,0,0,0,0,0,0
20200316,050502,聯發科凱基94購21,,,,,0.00,0.00,0,0,0,0,0,0,0,0,0,0,0,0,0
20200316,050503,聯發科凱基94購22,,,,,0.00,0.00,0,0,0,0,0,0,0,0,0,0,0,0,0
20200316,050504,全新凱基94購03,,,,,0.00,0.00,0,0,0,0,0,0,0,0,0,0,0,0,0
20200316,050505,可成凱基94購12,,,,,0.00,0.00,0,0,0,0,0,0,0,0,0,0,0,0,0
20200316,050506,奇鋐凱基94購02,,,,,0.00,0.00,0,0,0,0,0,0,0,0,0,0,0,0,0
20200316,050507,聯詠凱基94購06,,,,,0.00,0.00,0,0,0,0,0,0,0,0,0,0,0,0,0
20200316,050508,上証2X元大97購01,,,,,0.00,0.00,0,0,0,0,0,0,0,0,0,0,0,0,0
20200316,050509,元油2X元大94購09,,,,,0.00,0.00,0,0,0,0,0,0,0,0,0,0,0,0,0
20200316,05050P,華通群益96售02,,,,,0.00,0.00,0,0,0,0,0,0,0,0,0,0,0,0,0
20200316,050510,元油2X元大94購10,,,,,0.00,0.00,0,0,0,0,0,0,0,0,0,0,0,0,0
20200316,050511,元油2X元大94購11,,,,,0.00,0.00,0,0,0,0,0,0,0,0,0,0,0,0,0
20200316,050512,台泥元大94購01,0.62,0.62,0.47,0.47,-0.28,-37.33,340000,33,174300,0,0,0,0,0,0,20000,310000,-290000,-290000
20200316,050513,亞泥元大94購02,,,,,0.00,0.00,0,0,0,0,0,0,0,0,0,0,0,0,0
20200316,050514,聯電元大94購01,0.46,0.46,0.40,0.40,-0.03,-6.98,20000,2,8600,0,0,0,0,0,0,10000,10000,0,0
20200316,050515,聯電元大96購01,0.60,0.62,0.56,0.56,-0.05,-8.2,40000,3,23800,0,0,0,0,0,0,30000,10000,20000,20000
20200316,050516,華通元大95購05,,,,,0.00,0.00,0,0,0,0,0,0,0,0,0,0,0,0,0
20200316,050517,台積電元大94購27,0.13,0.13,0.13,0.13,0.00,0.00,1000,1,130,0,0,0,0,0,0,1000,1000,0,0
20200316,050518,台積電元大94購28,0.21,0.21,0.21,0.21,0.00,0.00,1000,1,210,0,0,0,0,0,0,1000,1000,0,0
20200316,050519,旺宏元大95購03,0.44,0.44,0.40,0.40,-0.01,-2.44,90000,6,37600,0,0,0,0,0,0,40000,50000,-10000,-10000
20200316,05051P,鴻海群益95售05,,,,,0.00,0.00,0,0,0,0,0,0,0,0,0,0,0,0,0
20200316,050520,凌陽元大94購02,,,,,0.00,0.00,0,0,0,0,0,0,0,0,0,0,0,0,0
20200316,050521,聯發科元大94購15,0.07,0.07,0.07,0.07,+0.03,75.0,500000,50,35000,0,0,0,0,0,0,0,500000,-500000,-500000
20200316,050522,聯發科元大95購03,0.69,0.71,0.69,0.69,-0.16,-18.82,82000,7,57080,0,0,0,0,0,0,52000,10000,42000,42000
20200316,050523,義隆元大94購05,,,,,0.00,0.00,0,0,0,0,0,0,0,0,0,0,0,0,0
20200316,050524,宏達電元大95購04,,,,,0.00,0.00,0,0,0,0,0,0,0,0,0,0,0,0,0
20200316,050525,嘉晶元大95購02,0.49,0.53,0.35,0.35,-0.09,-20.45,80000,5,37100,0,0,0,0,0,0,50000,40000,10000,10000
20200316,050526,貿聯元大95購01,,,,,0.00,0.00,0,0,0,0,0,0,0,0,0,0,0,0,0
20200316,050527,嘉聯益元大96購01,0.06,0.06,0.04,0.04,0.00,0.00,20000,2,1000,0,0,0,0,0,0,0,20000,-20000,-20000
20200316,050528,瑞儀元大94購02,,,,,0.00,0.00,0,0,0,0,0,0,0,0,0,0,0,0,0
20200316,050529,矽格元大94購05,0.16,0.16,0.16,0.16,+0.04,33.33,5000,1,800,0,0,0,0,0,0,5000,0,5000,5000
20200316,05052P,友達群益97售01,,,,,0.00,0.00,0,0,0,0,0,0,0,0,0,0,0,0,0
20200316,050530,台表科元大95購04,0.34,0.34,0.34,0.34,0.00,0.00,10000,1,3400,0,0,0,0,0,0,0,10000,-10000,-10000
20200316,050531,訊芯元大95購02,,,,,0.00,0.00,0,0,0,0,0,0,0,0,0,0,0,0,0
20200316,050532,矽創元大94購03,,,,,0.00,0.00,0,0,0,0,0,0,0,0,0,0,0,0,0
20200316,050533,致新元大94購03,,,,,0.00,0.00,0,0,0,0,0,0,0,0,0,0,0,0,0
20200316,050534,臻鼎兆豐94購01,,,,,0.00,0.00,0,0,0,0,0,0,0,0,0,0,0,0,0
20200316,050535,台表科群益94購02,,,,,0.00,0.00,0,0,0,0,0,0,0,0,0,0,0,0,0
20200316,050536,亞泥凱基95購01,,,,,0.00,0.00,0,0,0,0,0,0,0,0,0,0,0,0,0
20200316,050537,鴻海凱基95購05,,,,,0.00,0.00,0,0,0,0,0,0,0,0,0,0,0,0,0
20200316,050538,鴻海凱基95購06,,,,,0.00,0.00,0,0,0,0,0,0,0,0,0,0,0,0,0
20200316,050539,鴻海凱基95購07,,,,,0.00,0.00,0,0,0,0,0,0,0,0,0,0,0,0,0
20200316,05053P,新日興群益95售01,0.80,0.80,0.80,0.80,0.00,0.00,10000,1,8000,0,0,0,0,0,0,10000,0,10000,10000
20200316,050540,台積電凱基94購38,0.33,0.37,0.33,0.37,+0.15,68.18,75000,2,26750,0,0,0,0,0,0,25000,50000,-25000,-25000
20200316,050541,智邦凱基94購04,,,,,0.00,0.00,0,0,0,0,0,0,0,0,0,0,0,0,0
20200316,050542,宏碁凱基95購01,,,,,0.00,0.00,0,0,0,0,0,0,0,0,0,0,0,0,0
20200316,050543,聯發科凱基95購01,0.23,0.24,0.12,0.12,-0.12,-50.0,168000,14,36580,0,0,0,0,0,0,72000,84000,-12000,-12000
20200316,050544,聯發科凱基95購02,,,,,0.00,0.00,0,0,0,0,0,0,0,0,0,0,0,0,0
20200316,050545,奇力新凱基95購01,1.76,1.76,1.76,1.76,0.00,0.00,10000,1,17600,0,0,0,0,0,0,0,10000,-10000,-10000
20200316,050546,可成凱基94購13,,,,,0.00,0.00,0,0,0,0,0,0,0,0,0,0,0,0,0
20200316,050547,華新科凱基95購01,,,,,0.00,0.00,0,0,0,0,0,0,0,0,0,0,0,0,0
20200316,050548,華固凱基95購01,0.88,1.06,0.88,0.98,-0.05,-4.85,421000,26,410190,0,2000,-2000,0,0,0,266000,155000,111000,109000
20200316,050549,慧洋凱基95購01,,,,,0.00,0.00,0,0,0,0,0,0,0,0,0,0,0,0,0
20200316,05054P,臻鼎群益95售02,6.95,6.95,6.95,6.95,0.00,0.00,20000,1,139000,0,0,0,0,0,0,20000,0,20000,20000
20200316,050550,大立光凱基95購04,0.77,0.77,0.71,0.71,-0.16,-18.39,460000,4,327200,0,0,0,0,0,0,460000,450000,10000,10000
20200316,050551,大立光凱基95購05,0.42,0.42,0.32,0.32,+0.01,3.23,320000,4,121400,0,0,0,0,0,0,160000,160000,0,0
20200316,050552,禾伸堂凱基94購05,0.19,0.19,0.19,0.19,0.00,0.00,100000,1,19000,0,0,0,0,0,0,0,100000,-100000,-100000
20200316,050553,緯穎凱基94購06,3.40,4.06,3.40,3.76,+0.36,10.59,68000,7,269790,0,0,0,0,0,0,67000,0,67000,67000
20200316,050554,百和凱基95購01,,,,,0.00,0.00,0,0,0,0,0,0,0,0,0,0,0,0,0
20200316,050555,道瓊銀統一94購01,,,,,0.00,0.00,0,0,0,0,0,0,0,0,0,0,0,0,0
20200316,050556,道瓊銀統一95購01,,,,,0.00,0.00,0,0,0,0,0,0,0,0,0,0,0,0,0
20200316,050557,台積電統一94購13,,,,,0.00,0.00,0,0,0,0,0,0,0,0,0,0,0,0,0
20200316,050558,台積電統一94購14,0.16,0.16,0.13,0.13,-0.09,-40.91,20000,2,2900,0,0,0,0,0,0,0,20000,-20000,-20000
20200316,050559,聯發科統一94購10,,,,,0.00,0.00,0,0,0,0,0,0,0,0,0,0,0,0,0
20200316,05055P,台表科群益95售01,,,,,0.00,0.00,0,0,0,0,0,0,0,0,0,0,0,0,0
20200316,050560,聯詠統一94購02,,,,,0.00,0.00,0,0,0,0,0,0,0,0,0,0,0,0,0
20200316,050561,上証2X元富97購01,,,,,0.00,0.00,0,0,0,0,0,0,0,0,0,0,0,0,0
20200316,050562,瑞昱元富94購02,,,,,0.00,0.00,0,0,0,0,0,0,0,0,0,0,0,0,0
20200316,050563,臻鼎元富94購07,,,,,0.00,0.00,0,0,0,0,0,0,0,0,0,0,0,0,0
20200316,050564,臻鼎元富94購08,,,,,0.00,0.00,0,0,0,0,0,0,0,0,0,0,0,0,0
20200316,050565,矽格元富94購01,,,,,0.00,0.00,0,0,0,0,0,0,0,0,0,0,0,0,0
20200316,050566,高股息中信97購02,0.08,0.14,0.06,0.13,+0.03,30.0,216000,6,22730,0,0,0,0,0,0,20000,116000,-96000,-96000
20200316,050567,道瓊銀中信96購01,,,,,0.00,0.00,0,0,0,0,0,0,0,0,0,0,0,0,0
20200316,050568,為升中信97購01,,,,,0.00,0.00,0,0,0,0,0,0,0,0,0,0,0,0,0
20200316,050569,英業達中信94購01,0.05,0.05,0.05,0.05,0.00,0.00,10000,1,500,0,0,0,0,0,0,10000,0,10000,10000
20200316,05056P,訊芯群益95售01,,,,,0.00,0.00,0,0,0,0,0,0,0,0,0,0,0,0,0
20200316,050570,聯發科中信97購02,,,,,0.00,0.00,0,0,0,0,0,0,0,0,0,0,0,0,0
20200316,050571,美食中信95購01,,,,,0.00,0.00,0,0,0,0,0,0,0,0,0,0,0,0,0
20200316,050572,大立光中信97購01,0.21,0.21,0.09,0.13,-0.11,-45.83,167000,12,26870,0,0,0,0,0,0,136000,26000,110000,110000
20200316,050573,光寶科國票94購01,,,,,0.00,0.00,0,0,0,0,0,0,0,0,0,0,0,0,0
20200316,050574,微星國票94購01,,,,,0.00,0.00,0,0,0,0,0,0,0,0,0,0,0,0,0
20200316,050575,南亞科國票94購01,0.09,0.09,0.09,0.09,+0.01,12.5,300000,1,27000,0,0,0,0,0,0,300000,0,300000,300000
20200316,050576,南亞科國票95購01,,,,,0.00,0.00,0,0,0,0,0,0,0,0,0,0,0,0,0
20200316,050577,美律國票94購03,,,,,0.00,0.00,0,0,0,0,0,0,0,0,0,0,0,0,0
20200316,050578,聯發科國票95購03,0.04,0.04,0.04,0.04,-0.05,-55.56,5000,1,200,0,0,0,0,0,0,0,0,0,0
20200316,050579,聯發科國票95購04,0.36,0.36,0.36,0.36,-0.13,-26.53,100000,1,36000,0,0,0,0,0,0,100000,0,100000,100000
20200316,05057P,鴻海國票96售01,2.99,2.99,2.99,2.99,-0.73,-19.62,10000,1,29900,0,0,0,0,0,0,0,10000,-10000,-10000
20200316,050580,強茂國票95購01,,,,,0.00,0.00,0,0,0,0,0,0,0,0,0,0,0,0,0
20200316,050581,美食國票94購02,,,,,0.00,0.00,0,0,0,0,0,0,0,0,0,0,0,0,0
20200316,050582,傳奇國票94購01,,,,,0.00,0.00,0,0,0,0,0,0,0,0,0,0,0,0,0
20200316,050583,瑞儀國票94購01,,,,,0.00,0.00,0,0,0,0,0,0,0,0,0,0,0,0,0
20200316,050584,瑞儀國票95購01,,,,,0.00,0.00,0,0,0,0,0,0,0,0,0,0,0,0,0
20200316,050585,矽格國票94購01,,,,,0.00,0.00,0,0,0,0,0,0,0,0,0,0,0,0,0
20200316,050586,康友國票94購01,0.86,0.86,0.38,0.38,-0.49,-56.32,30000,2,16200,0,0,0,0,0,0,30000,0,30000,30000
20200316,050587,緯穎國票94購02,4.60,4.60,3.14,3.14,+1.17,59.39,8000,4,34760,0,0,0,0,0,0,8000,0,8000,8000
20200316,050588,矽創國票95購01,,,,,0.00,0.00,0,0,0,0,0,0,0,0,0,0,0,0,0
20200316,050589,昇陽半國票94購02,,,,,0.00,0.00,0,0,0,0,0,0,0,0,0,0,0,0,0
20200316,05058P,燿華國票97售01,,,,,0.00,0.00,0,0,0,0,0,0,0,0,0,0,0,0,0
20200316,050590,晶技永豐95購01,0.88,1.08,0.80,0.80,+0.01,1.27,203000,31,197150,0,0,0,0,0,0,60000,143000,-83000,-83000
20200316,050591,智易永豐94購04,,,,,0.00,0.00,0,0,0,0,0,0,0,0,0,0,0,0,0
20200316,050592,矽格永豐94購02,,,,,0.00,0.00,0,0,0,0,0,0,0,0,0,0,0,0,0
20200316,050593,台表科永豐94購03,,,,,0.00,0.00,0,0,0,0,0,0,0,0,0,0,0,0,0
20200316,050594,康友永豐94購01,0.58,0.58,0.37,0.37,-0.34,-47.89,49000,4,21860,0,0,0,0,0,0,0,49000,-49000,-49000
20200316,050595,緯穎永豐94購03,1.25,1.43,1.25,1.35,+0.79,141.07,67000,17,90880,0,0,0,0,0,0,21000,46000,-25000,-25000
20200316,050596,昇陽半永豐94購03,,,,,0.00,0.00,0,0,0,0,0,0,0,0,0,0,0,0,0
20200316,050597,聯電麥證94購01,0.56,0.56,0.56,0.56,+0.02,3.7,20000,1,11200,20000,0,20000,0,0,0,20000,0,20000,20000
20200316,050598,友達麥證94購01,,,,,0.00,0.00,0,0,0,0,0,0,0,0,0,0,0,0,0
20200316,050599,美食麥證94購01,,,,,0.00,0.00,0,0,0,0,0,0,0,0,0,0,0,0,0
20200316,05059P,大立光國票96售02,,,,,0.00,0.00,0,0,0,0,0,0,0,0,0,0,0,0,0
20200316,050600,瑞儀國泰95購01,,,,,0.00,0.00,0,0,0,0,0,0,0,0,0,0,0,0,0
20200316,050601,台表科國泰96購01,0.26,0.26,0.18,0.18,-0.07,-28.0,50000,2,11400,0,0,0,0,0,0,30000,0,30000,30000
20200316,050602,訊芯國泰96購01,0.04,0.04,0.04,0.04,0.00,0.00,30000,1,1200,0,0,0,0,0,0,30000,0,30000,30000
20200316,050603,致新國泰96購01,0.16,0.16,0.11,0.11,-0.02,-15.38,210000,2,33100,0,0,0,0,0,0,200000,10000,190000,190000
20200316,050604,上証2X永昌94購01,0.15,0.15,0.15,0.15,0.00,0.00,6000,1,900,0,0,0,0,0,0,6000,0,6000,6000
20200316,050605,上証2X元大97購02,,,,,0.00,0.00,0,0,0,0,0,0,0,0,0,0,0,0,0
20200316,050606,劍麟元大94購02,,,,,0.00,0.00,0,0,0,0,0,0,0,0,0,0,0,0,0
20200316,050607,為升元大94購10,,,,,0.00,0.00,0,0,0,0,0,0,0,0,0,0,0,0,0
20200316,050608,台達電元大94購12,,,,,0.00,0.00,0,0,0,0,0,0,0,0,0,0,0,0,0
20200316,050609,鴻海元大94購23,0.47,0.54,0.47,0.54,+0.16,42.11,60000,4,31100,0,0,0,0,0,0,30000,30000,0,0
20200316,05060P,台達電富邦97售02,,,,,0.00,0.00,0,0,0,0,0,0,0,0,0,0,0,0,0
20200316,050610,鴻海元大94購24,0.13,0.13,0.12,0.12,+0.01,9.09,11000,2,1420,0,0,0,0,0,0,1000,11000,-10000,-10000
20200316,050611,鴻海元大95購02,0.08,0.08,0.08,0.08,-0.05,-38.46,200000,1,16000,0,0,0,0,0,0,200000,0,200000,200000
20200316,050612,台積電元大95購06,0.48,0.48,0.45,0.45,-0.05,-10.0,5000,2,2310,0,0,0,0,0,0,0,5000,-5000,-5000
20200316,050613,台光電元大94購09,,,,,0.00,0.00,0,0,0,0,0,0,0,0,0,0,0,0,0
20200316,050614,聯發科元大95購04,0.23,0.23,0.15,0.15,+0.01,7.14,230000,23,36700,0,0,0,0,0,0,10000,220000,-210000,-210000
20200316,050615,奇力新元大95購03,1.51,1.51,1.20,1.20,+0.17,16.5,21000,2,31400,0,0,0,0,0,0,20000,1000,19000,19000
20200316,050616,潤泰全元大94購01,0.14,0.14,0.14,0.14,-0.08,-36.36,69000,1,9660,0,0,0,0,0,0,69000,0,69000,69000
20200316,050617,神基元大94購01,0.36,0.39,0.36,0.38,+0.15,65.22,20000,4,7250,0,0,0,0,0,0,18000,2000,16000,16000
20200316,050618,緯創元大95購01,0.24,0.26,0.23,0.26,+0.09,52.94,10000,4,2450,0,0,0,0,0,0,10000,0,10000,10000
20200316,050619,TPK元大95購02,,,,,0.00,0.00,0,0,0,0,0,0,0,0,0,0,0,0,0
20200316,05061P,鴻海富邦96售03,1.92,1.92,1.92,1.92,+0.32,20.0,7000,1,13440,0,0,0,0,0,0,7000,0,7000,7000
20200316,050620,和碩元大94購04,,,,,0.00,0.00,0,0,0,0,0,0,0,0,0,0,0,0,0
20200316,050621,易華電元大95購01,,,,,0.00,0.00,0,0,0,0,0,0,0,0,0,0,0,0,0
20200316,050622,昇陽半元大94購05,,,,,0.00,0.00,0,0,0,0,0,0,0,0,0,0,0,0,0
20200316,050623,致新元大94購05,,,,,0.00,0.00,0,0,0,0,0,0,0,0,0,0,0,0,0
20200316,050624,鈺齊元大94購01,0.10,0.10,0.10,0.10,+0.03,42.86,2000,1,200,0,0,0,0,0,0,2000,0,2000,2000
20200316,050625,康控第一94購01,,,,,0.00,0.00,0,0,0,0,0,0,0,0,0,0,0,0,0
20200316,050626,A50正2中信96購02,,,,,0.00,0.00,0,0,0,0,0,0,0,0,0,0,0,0,0
20200316,050627,華通中信94購02,,,,,0.00,0.00,0,0,0,0,0,0,0,0,0,0,0,0,0
20200316,050628,美律中信94購02,0.22,0.22,0.18,0.18,0.00,0.00,40000,2,7600,0,0,0,0,0,0,40000,0,40000,40000
20200316,050629,廣宇亞東96購01,0.05,0.05,0.05,0.05,0.00,0.00,5000,1,250,0,0,0,0,0,0,0,5000,-5000,-5000
20200316,05062P,大立光富邦98售03,1.22,1.22,1.22,1.22,+0.22,22.0,1000,1,1220,0,0,0,0,0,0,1000,0,1000,1000
20200316,050630,大立光亞東96購01,0.60,0.60,0.34,0.36,-0.31,-46.27,376000,19,148600,0,0,0,0,0,0,346000,376000,-30000,-30000
20200316,050631,矽創亞東94購01,,,,,0.00,0.00,0,0,0,0,0,0,0,0,0,0,0,0,0
20200316,050632,國巨群益94購07,0.80,0.80,0.80,0.80,0.00,0.00,10000,1,8000,0,0,0,0,0,0,0,0,0,0
20200316,050633,義隆群益96購02,,,,,0.00,0.00,0,0,0,0,0,0,0,0,0,0,0,0,0
20200316,050634,華新科群益96購01,,,,,0.00,0.00,0,0,0,0,0,0,0,0,0,0,0,0,0
20200316,050635,昇陽半群益94購04,,,,,0.00,0.00,0,0,0,0,0,0,0,0,0,0,0,0,0
20200316,050636,上証2X國票94購01,,,,,0.00,0.00,0,0,0,0,0,0,0,0,0,0,0,0,0
20200316,050637,欣興國票94購02,,,,,0.00,0.00,0,0,0,0,0,0,0,0,0,0,0,0,0
20200316,050638,創意國票94購02,,,,,0.00,0.00,0,0,0,0,0,0,0,0,0,0,0,0,0
20200316,050639,GIS國票96購01,,,,,0.00,0.00,0,0,0,0,0,0,0,0,0,0,0,0,0
20200316,05063P,聯電元大96售03,0.94,1.02,0.94,1.02,+0.07,7.37,148000,12,144030,0,0,0,0,0,0,85000,63000,22000,22000
20200316,050640,致新國票94購01,,,,,0.00,0.00,0,0,0,0,0,0,0,0,0,0,0,0,0
20200316,050641,上証反凱基96購01,0.57,0.58,0.57,0.58,+0.02,3.57,50000,2,28800,0,0,0,0,0,0,0,50000,-50000,-50000
20200316,050642,和大凱基94購03,,,,,0.00,0.00,0,0,0,0,0,0,0,0,0,0,0,0,0
20200316,050643,為升凱基94購08,,,,,0.00,0.00,0,0,0,0,0,0,0,0,0,0,0,0,0
20200316,050644,國巨凱基96購01,2.31,2.31,1.65,1.65,-0.19,-10.33,725000,13,1492380,0,0,0,0,0,0,10000,715000,-705000,-705000
20200316,050645,台積電凱基94購39,0.71,0.71,0.38,0.39,-0.41,-51.25,125000,6,68800,0,0,0,0,0,0,70000,55000,15000,15000
20200316,050646,美律凱基96購01,,,,,0.00,0.00,0,0,0,0,0,0,0,0,0,0,0,0,0
20200316,050647,聯發科凱基96購01,0.17,0.17,0.14,0.14,-0.12,-46.15,84000,4,12600,0,0,0,0,0,0,0,0,0,0
20200316,050648,全新凱基96購01,,,,,0.00,0.00,0,0,0,0,0,0,0,0,0,0,0,0,0
20200316,050649,華新科凱基96購01,,,,,0.00,0.00,0,0,0,0,0,0,0,0,0,0,0,0,0
20200316,05064P,台積電元大95售10,0.61,1.17,0.56,1.17,+0.67,134.0,127000,17,97210,0,0,0,0,0,0,56000,70000,-14000,-14000
20200316,050650,大立光凱基96購01,0.85,0.85,0.54,0.55,-0.39,-41.49,17000,11,12540,0,0,0,0,0,0,8000,9000,-1000,-1000
20200316,050651,大立光凱基96購02,,,,,0.00,0.00,0,0,0,0,0,0,0,0,0,0,0,0,0
20200316,050652,大立光凱基96購03,0.33,0.33,0.15,0.16,-0.23,-58.97,706000,11,214450,0,0,0,0,0,0,559000,147000,412000,412000
20200316,050653,聯鈞凱基96購01,1.33,1.42,0.86,0.86,-0.53,-38.13,355000,23,362170,0,0,0,0,0,0,300000,55000,245000,245000
20200316,050654,鎧勝凱基96購01,,,,,0.00,0.00,0,0,0,0,0,0,0,0,0,0,0,0,0
20200316,050655,中磊凱基96購01,,,,,0.00,0.00,0,0,0,0,0,0,0,0,0,0,0,0,0
20200316,050656,瑞儀凱基96購01,,,,,0.00,0.00,0,0,0,0,0,0,0,0,0,0,0,0,0
20200316,050657,宏達電麥證94購01,,,,,0.00,0.00,0,0,0,0,0,0,0,0,0,0,0,0,0
20200316,050658,台郡麥證96購01,,,,,0.00,0.00,0,0,0,0,0,0,0,0,0,0,0,0,0
20200316,050659,宏達電元大96購01,,,,,0.00,0.00,0,0,0,0,0,0,0,0,0,0,0,0,0
20200316,05065P,燿華元大96售03,,,,,0.00,0.00,0,0,0,0,0,0,0,0,0,0,0,0,0
20200316,050660,欣興元大96購02,,,,,0.00,0.00,0,0,0,0,0,0,0,0,0,0,0,0,0
20200316,050661,景碩元大94購02,,,,,0.00,0.00,0,0,0,0,0,0,0,0,0,0,0,0,0
20200316,050662,智易元大96購01,,,,,0.00,0.00,0,0,0,0,0,0,0,0,0,0,0,0,0
20200316,050663,麗豐元大96購03,,,,,0.00,0.00,0,0,0,0,0,0,0,0,0,0,0,0,0
20200316,050664,全新台新94購02,,,,,0.00,0.00,0,0,0,0,0,0,0,0,0,0,0,0,0
20200316,050665,南電台新94購01,0.07,0.07,0.07,0.07,+0.01,16.67,50000,5,3500,0,0,0,0,0,0,0,50000,-50000,-50000
20200316,050666,道瓊銀永豐94購01,,,,,0.00,0.00,0,0,0,0,0,0,0,0,0,0,0,0,0
20200316,050667,國巨永豐94購06,0.89,0.89,0.89,0.89,+0.26,41.27,20000,1,17800,0,0,0,0,0,0,20000,0,20000,20000
20200316,050668,京元電永豐94購01,,,,,0.00,0.00,0,0,0,0,0,0,0,0,0,0,0,0,0
20200316,050669,嘉晶永豐96購01,0.18,0.18,0.15,0.15,-0.03,-16.67,394000,2,70800,0,0,0,0,0,0,390000,4000,386000,386000
20200316,05066P,康控元大95售03,,,,,0.00,0.00,0,0,0,0,0,0,0,0,0,0,0,0,0
20200316,050670,牧德永豐94購03,,,,,0.00,0.00,0,0,0,0,0,0,0,0,0,0,0,0,0
20200316,050671,超眾永豐94購04,,,,,0.00,0.00,0,0,0,0,0,0,0,0,0,0,0,0,0
20200316,050672,上証2X富邦97購01,,,,,0.00,0.00,0,0,0,0,0,0,0,0,0,0,0,0,0
20200316,050673,旺宏富邦96購02,0.42,0.42,0.34,0.34,+0.03,9.68,78000,9,29260,0,0,0,0,0,0,3000,75000,-72000,-72000
20200316,050674,瑞昱富邦94購02,,,,,0.00,0.00,0,0,0,0,0,0,0,0,0,0,0,0,0
20200316,050675,奇鋐富邦96購01,,,,,0.00,0.00,0,0,0,0,0,0,0,0,0,0,0,0,0
20200316,050676,道瓊銀統一96購02,,,,,0.00,0.00,0,0,0,0,0,0,0,0,0,0,0,0,0
20200316,050677,光寶科統一94購01,,,,,0.00,0.00,0,0,0,0,0,0,0,0,0,0,0,0,0
20200316,050678,美律統一94購04,,,,,0.00,0.00,0,0,0,0,0,0,0,0,0,0,0,0,0
20200316,050679,上証2X元富97購02,0.17,0.17,0.17,0.17,0.00,0.00,499000,3,84830,0,0,0,0,0,0,0,499000,-499000,-499000
20200316,05067P,欣興兆豐96售02,,,,,0.00,0.00,0,0,0,0,0,0,0,0,0,0,0,0,0
20200316,050680,上銀元富94購01,0.10,0.10,0.10,0.10,-0.03,-23.08,40000,2,4000,0,0,0,0,0,0,30000,30000,0,0
20200316,050681,南亞科元富94購01,0.14,0.14,0.14,0.14,-0.10,-41.67,10000,1,1400,0,0,0,0,0,0,10000,0,10000,10000
20200316,050682,南亞科元富94購02,,,,,0.00,0.00,0,0,0,0,0,0,0,0,0,0,0,0,0
20200316,050683,智原元富94購02,,,,,0.00,0.00,0,0,0,0,0,0,0,0,0,0,0,0,0
20200316,050684,台郡元富94購02,,,,,0.00,0.00,0,0,0,0,0,0,0,0,0,0,0,0,0
20200316,050685,緯穎元富94購02,1.66,1.86,1.43,1.43,-0.05,-3.38,197000,21,342440,0,0,0,0,0,0,126000,0,126000,126000
20200316,050686,欣興兆豐96購01,0.07,0.08,0.04,0.04,-0.02,-33.33,622000,61,31830,0,0,0,0,0,0,0,622000,-622000,-622000
20200316,050687,上銀日盛94購01,,,,,0.00,0.00,0,0,0,0,0,0,0,0,0,0,0,0,0
20200316,050688,大立光日盛94購03,,,,,0.00,0.00,0,0,0,0,0,0,0,0,0,0,0,0,0
20200316,050689,力山凱基94購07,,,,,0.00,0.00,0,0,0,0,0,0,0,0,0,0,0,0,0
20200316,05068P,鴻海統一95售06,,,,,0.00,0.00,0,0,0,0,0,0,0,0,0,0,0,0,0
20200316,050690,台達電凱基96購01,0.43,0.45,0.41,0.45,+0.10,28.57,88000,3,37080,0,0,0,0,0,0,68000,20000,48000,48000
20200316,050691,楠梓電凱基96購01,,,,,0.00,0.00,0,0,0,0,0,0,0,0,0,0,0,0,0
20200316,050692,鴻海凱基96購04,,,,,0.00,0.00,0,0,0,0,0,0,0,0,0,0,0,0,0
20200316,050693,鴻海凱基96購05,,,,,0.00,0.00,0,0,0,0,0,0,0,0,0,0,0,0,0
20200316,050694,國巨凱基96購03,1.53,1.53,1.19,1.19,-0.43,-26.54,240000,5,328500,0,0,0,0,0,0,200000,40000,160000,160000
20200316,050695,台積電凱基94購40,0.12,0.13,0.08,0.08,+0.01,14.29,762000,5,91760,0,0,0,0,0,0,682000,0,682000,682000
20200316,050696,台光電凱基96購01,,,,,0.00,0.00,0,0,0,0,0,0,0,0,0,0,0,0,0
20200316,050697,冠德凱基96購01,,,,,0.00,0.00,0,0,0,0,0,0,0,0,0,0,0,0,0
20200316,050698,明泰凱基96購01,,,,,0.00,0.00,0,0,0,0,0,0,0,0,0,0,0,0,0
20200316,050699,京鼎凱基96購01,,,,,0.00,0.00,0,0,0,0,0,0,0,0,0,0,0,0,0
20200316,05069P,鴻海統一96售03,,,,,0.00,0.00,0,0,0,0,0,0,0,0,0,0,0,0,0
20200316,050700,健策凱基96購01,,,,,0.00,0.00,0,0,0,0,0,0,0,0,0,0,0,0,0
20200316,050701,上緯控凱基94購04,,,,,0.00,0.00,0,0,0,0,0,0,0,0,0,0,0,0,0
20200316,050702,崇越凱基94購01,,,,,0.00,0.00,0,0,0,0,0,0,0,0,0,0,0,0,0
20200316,050703,矽格凱基94購02,,,,,0.00,0.00,0,0,0,0,0,0,0,0,0,0,0,0,0
20200316,050704,復盛凱基94購03,,,,,0.00,0.00,0,0,0,0,0,0,0,0,0,0,0,0,0
20200316,050705,南電凱基96購01,0.08,0.08,0.07,0.07,-0.03,-30.0,20000,2,1500,0,0,0,0,0,0,20000,0,20000,20000
20200316,050706,柏文凱基94購01,,,,,0.00,0.00,0,0,0,0,0,0,0,0,0,0,0,0,0
20200316,050707,寶成凱基94購02,,,,,0.00,0.00,0,0,0,0,0,0,0,0,0,0,0,0,0
20200316,050708,臺股指凱基96購06,0.06,0.06,0.06,0.06,-0.01,-14.29,70000,3,4200,0,0,0,0,0,0,0,0,0,0
20200316,050709,嘉聯益第一96購01,,,,,0.00,0.00,0,0,0,0,0,0,0,0,0,0,0,0,0
20200316,05070P,鴻海統一96售04,2.82,2.82,2.82,2.82,0.00,0.00,30000,3,84600,0,0,0,0,0,0,30000,30000,0,0
20200316,050710,元黃金中信96購01,0.74,0.74,0.74,0.74,-0.10,-11.9,20000,2,14800,0,0,0,0,0,0,0,20000,-20000,-20000
20200316,050711,TPK中信94購01,,,,,0.00,0.00,0,0,0,0,0,0,0,0,0,0,0,0,0
20200316,050712,和碩中信94購01,,,,,0.00,0.00,0,0,0,0,0,0,0,0,0,0,0,0,0
20200316,050713,矽格麥證94購01,,,,,0.00,0.00,0,0,0,0,0,0,0,0,0,0,0,0,0
20200316,050714,深中小群益98購01,,,,,0.00,0.00,0,0,0,0,0,0,0,0,0,0,0,0,0
20200316,050715,台積電群益96購01,0.12,0.12,0.05,0.12,+0.02,20.0,1358000,75,142240,0,0,0,0,0,0,0,0,0,0
20200316,050716,可成群益96購01,0.07,0.07,0.03,0.03,-0.02,-40.0,15000,2,650,0,0,0,0,0,0,0,10000,-10000,-10000
20200316,050717,京鼎群益96購01,0.27,0.27,0.27,0.27,+0.01,3.85,5000,1,1350,0,0,0,0,0,0,5000,0,5000,5000
20200316,050718,茂林群益94購04,,,,,0.00,0.00,0,0,0,0,0,0,0,0,0,0,0,0,0
20200316,050719,世紀鋼群益96購01,2.05,2.05,1.90,2.00,+0.07,3.63,237000,10,461210,0,0,0,0,0,0,217000,20000,197000,197000
20200316,05071P,鴻海統一96售05,,,,,0.00,0.00,0,0,0,0,0,0,0,0,0,0,0,0,0
20200316,050720,上証2X國票94購02,,,,,0.00,0.00,0,0,0,0,0,0,0,0,0,0,0,0,0
20200316,050721,台泥國票94購01,,,,,0.00,0.00,0,0,0,0,0,0,0,0,0,0,0,0,0
20200316,050722,聯電國票96購01,0.40,0.40,0.35,0.35,-0.11,-23.91,147000,5,56590,0,0,0,0,0,0,137000,5000,132000,132000
20200316,050723,楠梓電國票94購01,,,,,0.00,0.00,0,0,0,0,0,0,0,0,0,0,0,0,0
20200316,050724,國巨國票96購01,,,,,0.00,0.00,0,0,0,0,0,0,0,0,0,0,0,0,0
20200316,050725,光磊國票96購01,,,,,0.00,0.00,0,0,0,0,0,0,0,0,0,0,0,0,0
20200316,050726,可成國票96購01,0.01,0.01,0.01,0.01,0.00,0.00,229000,4,2290,0,0,0,0,0,0,0,0,0,0
20200316,050727,華新科國票94購09,0.70,0.70,0.70,0.70,+0.16,29.63,49000,1,34300,0,0,0,0,0,0,49000,0,49000,49000
20200316,050728,新日興國票94購01,0.25,0.25,0.25,0.25,+0.01,4.17,10000,1,2500,0,0,0,0,0,0,10000,0,10000,10000
20200316,050729,聯鈞國票94購01,1.99,1.99,1.97,1.97,+0.40,25.48,20000,2,39600,0,0,0,0,0,0,20000,0,20000,20000
20200316,05072P,聯電元富95售02,0.46,0.61,0.46,0.53,-0.04,-7.02,119000,13,60440,0,0,0,0,0,0,94000,10000,84000,84000
20200316,050730,復盛國票94購01,,,,,0.00,0.00,0,0,0,0,0,0,0,0,0,0,0,0,0
20200316,050731,昇陽半國票96購01,,,,,0.00,0.00,0,0,0,0,0,0,0,0,0,0,0,0,0
20200316,050732,台虹國票94購01,,,,,0.00,0.00,0,0,0,0,0,0,0,0,0,0,0,0,0
20200316,050733,寶成國票94購01,,,,,0.00,0.00,0,0,0,0,0,0,0,0,0,0,0,0,0
20200316,050734,台積電台新94購02,,,,,0.00,0.00,0,0,0,0,0,0,0,0,0,0,0,0,0
20200316,050735,亞光台新94購01,,,,,0.00,0.00,0,0,0,0,0,0,0,0,0,0,0,0,0
20200316,050736,台積電康和94購01,,,,,0.00,0.00,0,0,0,0,0,0,0,0,0,0,0,0,0
20200316,050737,聯詠康和94購01,,,,,0.00,0.00,0,0,0,0,0,0,0,0,0,0,0,0,0
20200316,050738,臺股指康和94購01,,,,,0.00,0.00,0,0,0,0,0,0,0,0,0,0,0,0,0
20200316,050739,臺股指康和94購02,,,,,0.00,0.00,0,0,0,0,0,0,0,0,0,0,0,0,0
20200316,05073P,臺股指中信95售09,,,,,0.00,0.00,0,0,0,0,0,0,0,0,0,0,0,0,0
20200316,050740,旺宏永豐94購03,,,,,0.00,0.00,0,0,0,0,0,0,0,0,0,0,0,0,0
20200316,050741,奇鋐永豐94購04,,,,,0.00,0.00,0,0,0,0,0,0,0,0,0,0,0,0,0
20200316,050742,新日興永豐94購01,0.09,0.09,0.08,0.08,0.00,0.00,8000,2,680,0,0,0,0,0,0,8000,0,8000,8000
20200316,050743,京鼎永豐94購02,,,,,0.00,0.00,0,0,0,0,0,0,0,0,0,0,0,0,0
20200316,050744,健策永豐94購04,0.12,0.12,0.07,0.07,-0.05,-41.67,150000,9,14000,0,0,0,0,0,0,50000,100000,-50000,-50000
20200316,050745,茂林永豐94購06,0.30,0.38,0.30,0.35,+0.03,9.38,62000,7,20660,0,0,0,0,0,0,22000,40000,-18000,-18000
20200316,050746,矽創永豐94購01,,,,,0.00,0.00,0,0,0,0,0,0,0,0,0,0,0,0,0
20200316,050747,道瓊銀統一94購03,,,,,0.00,0.00,0,0,0,0,0,0,0,0,0,0,0,0,0
20200316,050748,道瓊銀統一94購04,,,,,0.00,0.00,0,0,0,0,0,0,0,0,0,0,0,0,0
20200316,050749,道瓊銀統一96購03,0.26,0.26,0.26,0.26,0.00,0.00,10000,1,2600,0,0,0,0,0,0,10000,10000,0,0
20200316,05074P,鴻海麥證95售01,,,,,0.00,0.00,0,0,0,0,0,0,0,0,0,0,0,0,0
20200316,050750,上銀統一94購02,,,,,0.00,0.00,0,0,0,0,0,0,0,0,0,0,0,0,0
20200316,050751,聯電統一94購05,,,,,0.00,0.00,0,0,0,0,0,0,0,0,0,0,0,0,0
20200316,050752,美律統一94購05,,,,,0.00,0.00,0,0,0,0,0,0,0,0,0,0,0,0,0
20200316,050753,百和統一94購01,,,,,0.00,0.00,0,0,0,0,0,0,0,0,0,0,0,0,0
20200316,050754,元金2X元富9B購01,0.43,0.50,0.40,0.46,-0.09,-16.36,2036000,206,940050,0,0,0,0,0,0,1285000,1941000,-656000,-656000
20200316,050755,和大元富94購01,,,,,0.00,0.00,0,0,0,0,0,0,0,0,0,0,0,0,0
20200316,050756,京元電元富94購03,,,,,0.00,0.00,0,0,0,0,0,0,0,0,0,0,0,0,0
20200316,050757,聯發科元富94購03,,,,,0.00,0.00,0,0,0,0,0,0,0,0,0,0,0,0,0
20200316,050758,聯發科元富9B購01,0.19,0.20,0.16,0.16,-0.08,-33.33,830000,11,156640,0,0,0,0,0,0,739000,91000,648000,648000
20200316,050759,貿聯元富94購02,,,,,0.00,0.00,0,0,0,0,0,0,0,0,0,0,0,0,0
20200316,05075P,台積電麥證95售01,1.37,1.37,1.37,1.37,+0.13,10.48,5000,1,6850,5000,0,5000,0,0,0,5000,0,5000,5000
20200316,050760,矽力元富94購03,1.62,1.62,0.88,0.88,-0.55,-38.46,92000,6,117540,0,0,0,0,0,0,42000,50000,-8000,-8000
20200316,050761,華通元大94購05,,,,,0.00,0.00,0,0,0,0,0,0,0,0,0,0,0,0,0
20200316,050762,楠梓電元大94購02,,,,,0.00,0.00,0,0,0,0,0,0,0,0,0,0,0,0,0
20200316,050763,楠梓電元大94購03,0.07,0.07,0.06,0.06,-0.02,-25.0,90000,6,6100,0,0,0,0,0,0,40000,50000,-10000,-10000
20200316,050764,鴻海元大94購27,,,,,0.00,0.00,0,0,0,0,0,0,0,0,0,0,0,0,0
20200316,050765,鴻海元大96購02,0.15,0.15,0.15,0.15,+0.04,36.36,26000,4,3900,0,0,0,0,0,0,19000,1000,18000,18000
20200316,050766,燿華元大96購02,0.05,0.05,0.03,0.03,0.00,0.00,30000,2,1300,0,0,0,0,0,0,20000,10000,10000,10000
20200316,050767,京元電元大96購01,,,,,0.00,0.00,0,0,0,0,0,0,0,0,0,0,0,0,0
20200316,050768,聯發科元大94購16,,,,,0.00,0.00,0,0,0,0,0,0,0,0,0,0,0,0,0
20200316,050769,聯發科元大94購17,,,,,0.00,0.00,0,0,0,0,0,0,0,0,0,0,0,0,0
20200316,05076P,深中小群益99售02,0.33,0.45,0.33,0.45,+0.04,9.76,120000,2,42000,0,0,0,0,0,0,120000,0,120000,120000
20200316,050770,全新元大94購04,,,,,0.00,0.00,0,0,0,0,0,0,0,0,0,0,0,0,0
20200316,050771,華新科元大94購06,0.32,0.32,0.32,0.32,+0.14,77.78,10000,1,3200,0,0,0,0,0,0,10000,10000,0,0
20200316,050772,美食元大94購06,,,,,0.00,0.00,0,0,0,0,0,0,0,0,0,0,0,0,0
20200316,050773,京鼎元大94購02,,,,,0.00,0.00,0,0,0,0,0,0,0,0,0,0,0,0,0
20200316,050774,健策元大96購02,0.51,0.57,0.38,0.38,-0.11,-22.45,270000,25,128200,0,0,0,0,0,0,50000,230000,-180000,-180000
20200316,050775,TPK元大96購01,,,,,0.00,0.00,0,0,0,0,0,0,0,0,0,0,0,0,0
20200316,050776,康控元大96購03,,,,,0.00,0.00,0,0,0,0,0,0,0,0,0,0,0,0,0
20200316,050777,臻鼎元大94購05,,,,,0.00,0.00,0,0,0,0,0,0,0,0,0,0,0,0,0
20200316,050778,瑞儀元大96購01,0.07,0.09,0.07,0.09,0.00,0.00,71000,2,4990,0,0,0,0,0,0,70000,1000,69000,69000
20200316,050779,超眾元大96購03,0.32,0.32,0.25,0.25,-0.05,-16.67,10000,2,2850,0,0,0,0,0,0,5000,5000,0,0
20200316,05077P,智易群益95售02,,,,,0.00,0.00,0,0,0,0,0,0,0,0,0,0,0,0,0
20200316,050780,台表科元大96購01,0.10,0.10,0.09,0.09,-0.04,-30.77,60000,6,5500,0,0,0,0,0,0,0,60000,-60000,-60000
20200316,050781,昇陽半元大94購06,,,,,0.00,0.00,0,0,0,0,0,0,0,0,0,0,0,0,0
20200316,050782,台積電國泰96購03,2.30,2.51,2.05,2.05,-0.75,-26.79,220000,33,498040,0,0,0,0,0,0,199000,59000,140000,140000
20200316,050783,旺宏國泰96購02,0.57,0.66,0.42,0.42,-0.15,-26.32,481000,12,289610,0,0,0,0,0,0,351000,130000,221000,221000
20200316,050784,美律國泰96購01,0.39,0.39,0.30,0.30,-0.03,-9.09,118000,5,39420,0,0,0,0,0,0,38000,80000,-42000,-42000
20200316,050785,全新國泰96購01,,,,,0.00,0.00,0,0,0,0,0,0,0,0,0,0,0,0,0
20200316,050786,健策國泰96購01,1.24,1.38,0.93,0.93,-0.39,-29.55,472000,43,578780,0,0,0,0,0,0,387000,70000,317000,317000
20200316,050787,致伸國泰96購01,,,,,0.00,0.00,0,0,0,0,0,0,0,0,0,0,0,0,0
20200316,050788,台郡國泰96購01,1.37,1.39,1.24,1.24,+0.21,20.39,136000,4,172340,0,0,0,0,0,0,126000,26000,100000,100000
20200316,050789,矽創國泰96購01,0.18,0.22,0.11,0.11,-0.07,-38.89,618000,9,89410,0,0,0,0,0,0,365000,253000,112000,112000
20200316,05078P,義隆永豐95售01,1.34,1.50,1.34,1.50,-0.07,-4.46,20000,2,28400,0,0,0,0,0,0,20000,10000,10000,10000
20200316,050790,昇陽半國泰96購02,0.09,0.09,0.09,0.09,-0.02,-18.18,20000,1,1800,0,0,0,0,0,0,20000,0,20000,20000
20200316,050791,聯發科富邦96購01,0.09,0.11,0.08,0.08,-0.07,-46.67,391000,12,39220,0,0,0,0,0,0,0,391000,-391000,-391000
20200316,050792,可成富邦96購01,,,,,0.00,0.00,0,0,0,0,0,0,0,0,0,0,0,0,0
20200316,050793,大立光富邦96購03,0.26,0.26,0.22,0.22,-0.06,-21.43,18000,3,4250,0,0,0,0,0,0,18000,0,18000,18000
20200316,050794,大立光富邦96購04,,,,,0.00,0.00,0,0,0,0,0,0,0,0,0,0,0,0,0
20200316,050795,超眾富邦94購01,,,,,0.00,0.00,0,0,0,0,0,0,0,0,0,0,0,0,0
20200316,050796,燿華中信95購01,,,,,0.00,0.00,0,0,0,0,0,0,0,0,0,0,0,0,0
20200316,050797,聯發科中信99購01,0.17,0.20,0.15,0.15,-0.08,-34.78,128000,10,21910,0,0,0,0,0,0,13000,95000,-82000,-82000
20200316,050798,TPK中信96購01,,,,,0.00,0.00,0,0,0,0,0,0,0,0,0,0,0,0,0
20200316,050799,嘉聯益中信98購01,0.05,0.06,0.05,0.06,0.00,0.00,20000,2,1100,0,0,0,0,0,0,0,20000,-20000,-20000
20200316,05079P,可成永豐95售01,2.35,2.35,2.35,2.35,-0.09,-3.69,10000,1,23500,0,0,0,0,0,0,10000,0,10000,10000
20200316,050800,百和中信95購01,,,,,0.00,0.00,0,0,0,0,0,0,0,0,0,0,0,0,0
20200316,050801,元金2X群益98購01,1.00,1.14,0.95,1.14,-0.05,-4.2,45000,5,46750,0,0,0,0,0,0,0,35000,-35000,-35000
20200316,050802,康控群益95購01,,,,,0.00,0.00,0,0,0,0,0,0,0,0,0,0,0,0,0
20200316,050803,康控兆豐96購01,,,,,0.00,0.00,0,0,0,0,0,0,0,0,0,0,0,0,0
20200316,050804,和大日盛95購01,,,,,0.00,0.00,0,0,0,0,0,0,0,0,0,0,0,0,0
20200316,050805,光寶科日盛95購01,,,,,0.00,0.00,0,0,0,0,0,0,0,0,0,0,0,0,0
20200316,050806,華新科日盛95購01,,,,,0.00,0.00,0,0,0,0,0,0,0,0,0,0,0,0,0
20200316,050807,群臺反凱基95購01,1.47,1.71,1.47,1.71,+0.34,24.82,66000,4,98220,0,0,0,0,0,0,41000,10000,31000,31000
20200316,050808,台達電凱基96購02,,,,,0.00,0.00,0,0,0,0,0,0,0,0,0,0,0,0,0
20200316,050809,鴻海凱基95購08,0.22,0.22,0.20,0.20,+0.08,66.67,110000,3,22200,0,0,0,0,0,0,110000,0,110000,110000
20200316,05080P,亞光永豐95售02,,,,,0.00,0.00,0,0,0,0,0,0,0,0,0,0,0,0,0
20200316,050810,鴻海凱基95購09,,,,,0.00,0.00,0,0,0,0,0,0,0,0,0,0,0,0,0
20200316,050811,國巨凱基95購02,0.52,0.52,0.52,0.52,0.00,0.00,10000,1,5200,0,0,0,0,0,0,0,10000,-10000,-10000
20200316,050812,台積電凱基95購01,,,,,0.00,0.00,0,0,0,0,0,0,0,0,0,0,0,0,0
20200316,050813,旺宏凱基96購01,0.74,0.74,0.74,0.74,+0.14,23.33,1000,1,740,0,0,0,0,0,0,1000,0,1000,1000
20200316,050814,微星凱基95購01,,,,,0.00,0.00,0,0,0,0,0,0,0,0,0,0,0,0,0
20200316,050815,南亞科凱基95購01,,,,,0.00,0.00,0,0,0,0,0,0,0,0,0,0,0,0,0
20200316,050816,京元電凱基95購01,,,,,0.00,0.00,0,0,0,0,0,0,0,0,0,0,0,0,0
20200316,050817,可成凱基95購01,,,,,0.00,0.00,0,0,0,0,0,0,0,0,0,0,0,0,0
20200316,050818,華新科凱基95購02,,,,,0.00,0.00,0,0,0,0,0,0,0,0,0,0,0,0,0
20200316,050819,宏達電凱基95購01,,,,,0.00,0.00,0,0,0,0,0,0,0,0,0,0,0,0,0
20200316,05081P,京鼎永豐95售01,1.65,1.65,1.65,1.65,+0.28,20.44,5000,1,8250,0,0,0,0,0,0,5000,0,5000,5000
20200316,050820,美食凱基95購01,,,,,0.00,0.00,0,0,0,0,0,0,0,0,0,0,0,0,0
20200316,050821,國泰金凱基95購01,,,,,0.00,0.00,0,0,0,0,0,0,0,0,0,0,0,0,0
20200316,050822,亞光凱基95購01,,,,,0.00,0.00,0,0,0,0,0,0,0,0,0,0,0,0,0
20200316,050823,信邦凱基95購01,,,,,0.00,0.00,0,0,0,0,0,0,0,0,0,0,0,0,0
20200316,050824,欣興凱基95購01,,,,,0.00,0.00,0,0,0,0,0,0,0,0,0,0,0,0,0
20200316,050825,嘉澤凱基95購01,,,,,0.00,0.00,0,0,0,0,0,0,0,0,0,0,0,0,0
20200316,050826,康普凱基95購01,,,,,0.00,0.00,0,0,0,0,0,0,0,0,0,0,0,0,0
20200316,050827,致伸凱基95購01,,,,,0.00,0.00,0,0,0,0,0,0,0,0,0,0,0,0,0
20200316,050828,康控凱基95購01,,,,,0.00,0.00,0,0,0,0,0,0,0,0,0,0,0,0,0
20200316,050829,臻鼎凱基96購01,,,,,0.00,0.00,0,0,0,0,0,0,0,0,0,0,0,0,0
20200316,05082P,健策永豐95售02,0.87,1.09,0.85,1.09,+0.08,7.92,208000,21,203560,0,0,0,0,0,0,132000,196000,-64000,-64000
20200316,050830,嘉聯益凱基95購01,,,,,0.00,0.00,0,0,0,0,0,0,0,0,0,0,0,0,0
20200316,050831,超眾凱基95購01,,,,,0.00,0.00,0,0,0,0,0,0,0,0,0,0,0,0,0
20200316,050832,力成凱基95購01,,,,,0.00,0.00,0,0,0,0,0,0,0,0,0,0,0,0,0
20200316,050833,台郡凱基95購01,,,,,0.00,0.00,0,0,0,0,0,0,0,0,0,0,0,0,0
20200316,050834,啟碁凱基95購01,,,,,0.00,0.00,0,0,0,0,0,0,0,0,0,0,0,0,0
20200316,050835,GIS凱基96購01,,,,,0.00,0.00,0,0,0,0,0,0,0,0,0,0,0,0,0
20200316,050836,緯穎凱基95購01,1.66,1.69,1.39,1.39,+0.11,8.59,48000,5,76400,0,0,0,0,0,0,48000,48000,0,0
20200316,050837,力山國票95購01,,,,,0.00,0.00,0,0,0,0,0,0,0,0,0,0,0,0,0
20200316,050838,為升國票96購01,,,,,0.00,0.00,0,0,0,0,0,0,0,0,0,0,0,0,0
20200316,050839,楠梓電國票96購01,0.05,0.05,0.05,0.05,+0.01,25.0,20000,1,1000,0,0,0,0,0,0,20000,0,20000,20000
20200316,05083P,麗豐永豐95售02,1.26,1.34,1.26,1.34,-0.18,-11.84,15000,2,19700,0,0,0,0,0,0,15000,0,15000,15000
20200316,050840,中環國票96購01,,,,,0.00,0.00,0,0,0,0,0,0,0,0,0,0,0,0,0
20200316,050841,國巨國票96購02,,,,,0.00,0.00,0,0,0,0,0,0,0,0,0,0,0,0,0
20200316,050842,旺宏國票97購01,1.46,1.46,1.29,1.31,+0.04,3.15,45000,3,62500,0,0,0,0,0,0,45000,0,45000,45000
20200316,050843,富邦金國票96購01,,,,,0.00,0.00,0,0,0,0,0,0,0,0,0,0,0,0,0
20200316,050844,大立光國票96購01,0.09,0.09,0.09,0.09,-0.05,-35.71,10000,1,900,0,0,0,0,0,0,0,10000,-10000,-10000
20200316,050845,奇鋐國票95購02,,,,,0.00,0.00,0,0,0,0,0,0,0,0,0,0,0,0,0
20200316,050846,緯創國票96購01,,,,,0.00,0.00,0,0,0,0,0,0,0,0,0,0,0,0,0
20200316,050847,創意國票96購01,,,,,0.00,0.00,0,0,0,0,0,0,0,0,0,0,0,0,0
20200316,050848,日月光國票95購01,,,,,0.00,0.00,0,0,0,0,0,0,0,0,0,0,0,0,0
20200316,050849,智伸科國票95購01,,,,,0.00,0.00,0,0,0,0,0,0,0,0,0,0,0,0,0
20200316,05084P,嘉聯益永豐95售02,,,,,0.00,0.00,0,0,0,0,0,0,0,0,0,0,0,0,0
20200316,050850,訊連國票96購01,1.85,1.85,1.66,1.66,-0.46,-21.7,12000,2,20870,0,0,0,0,0,0,7000,5000,2000,2000
20200316,050851,羅麗芬國票96購01,,,,,0.00,0.00,0,0,0,0,0,0,0,0,0,0,0,0,0
20200316,050852,矽創國票95購02,,,,,0.00,0.00,0,0,0,0,0,0,0,0,0,0,0,0,0
20200316,050853,南電國票96購01,0.07,0.07,0.05,0.05,0.00,0.00,677000,13,44460,0,0,0,0,0,0,379000,0,379000,379000
20200316,050854,世紀鋼國票97購01,1.90,1.90,1.75,1.75,+0.16,10.06,114000,10,211420,0,0,0,0,0,0,34000,80000,-46000,-46000
20200316,050855,華通台新95購01,,,,,0.00,0.00,0,0,0,0,0,0,0,0,0,0,0,0,0
20200316,050856,智邦台新95購01,,,,,0.00,0.00,0,0,0,0,0,0,0,0,0,0,0,0,0
20200316,050857,義隆台新95購01,,,,,0.00,0.00,0,0,0,0,0,0,0,0,0,0,0,0,0
20200316,050858,欣興台新95購01,,,,,0.00,0.00,0,0,0,0,0,0,0,0,0,0,0,0,0
20200316,050859,訊芯康和95購01,,,,,0.00,0.00,0,0,0,0,0,0,0,0,0,0,0,0,0
20200316,05085P,鴻海日盛95售01,2.24,2.62,2.24,2.62,+1.11,73.51,13000,5,31680,0,0,0,0,0,0,3000,10000,-7000,-7000
20200316,050860,喬山永豐95購01,,,,,0.00,0.00,0,0,0,0,0,0,0,0,0,0,0,0,0
20200316,050861,鴻海永豐95購01,,,,,0.00,0.00,0,0,0,0,0,0,0,0,0,0,0,0,0
20200316,050862,燿華永豐95購04,,,,,0.00,0.00,0,0,0,0,0,0,0,0,0,0,0,0,0
20200316,050863,聯發科永豐95購01,,,,,0.00,0.00,0,0,0,0,0,0,0,0,0,0,0,0,0
20200316,050864,亞光永豐95購01,,,,,0.00,0.00,0,0,0,0,0,0,0,0,0,0,0,0,0
20200316,050865,欣興永豐95購01,,,,,0.00,0.00,0,0,0,0,0,0,0,0,0,0,0,0,0
20200316,050866,景碩永豐95購01,,,,,0.00,0.00,0,0,0,0,0,0,0,0,0,0,0,0,0
20200316,050867,聯鈞永豐95購01,,,,,0.00,0.00,0,0,0,0,0,0,0,0,0,0,0,0,0
20200316,050868,智易永豐95購01,,,,,0.00,0.00,0,0,0,0,0,0,0,0,0,0,0,0,0
20200316,050869,健策永豐95購01,0.09,0.09,0.09,0.09,+0.02,28.57,2000,1,180,0,0,0,0,0,0,2000,0,2000,2000
20200316,05086P,鴻海凱基95售13,1.53,1.64,1.52,1.64,+0.34,26.15,40000,3,63300,0,0,0,0,0,0,20000,40000,-20000,-20000
20200316,050870,旭富永豐95購01,0.11,0.11,0.11,0.11,+0.02,22.22,1000,1,110,0,0,0,0,0,0,1000,0,1000,1000
20200316,050871,麗豐永豐95購01,,,,,0.00,0.00,0,0,0,0,0,0,0,0,0,0,0,0,0
20200316,050872,致伸永豐95購01,,,,,0.00,0.00,0,0,0,0,0,0,0,0,0,0,0,0,0
20200316,050873,新唐永豐95購01,,,,,0.00,0.00,0,0,0,0,0,0,0,0,0,0,0,0,0
20200316,050874,康控永豐95購01,0.01,0.01,0.01,0.01,0.00,0.00,20000,1,200,0,0,0,0,0,0,0,0,0,0
20200316,050875,訊芯永豐95購01,0.03,0.03,0.01,0.01,0.00,0.00,12000,3,140,0,0,0,0,0,0,0,1000,-1000,-1000
20200316,050876,復盛永豐95購01,,,,,0.00,0.00,0,0,0,0,0,0,0,0,0,0,0,0,0
20200316,050877,美律統一95購01,,,,,0.00,0.00,0,0,0,0,0,0,0,0,0,0,0,0,0
20200316,050878,嘉聯益統一95購01,,,,,0.00,0.00,0,0,0,0,0,0,0,0,0,0,0,0,0
20200316,050879,樺漢統一95購02,,,,,0.00,0.00,0,0,0,0,0,0,0,0,0,0,0,0,0
20200316,05087P,GIS國泰96售01,3.93,3.93,3.93,3.93,-0.08,-2.0,10000,1,39300,0,0,0,0,0,0,0,10000,-10000,-10000
20200316,050880,大立光元富95購03,0.75,0.78,0.43,0.43,-0.44,-50.57,180000,13,114180,0,0,0,0,0,0,140000,40000,100000,100000
20200316,050881,大立光元富95購04,,,,,0.00,0.00,0,0,0,0,0,0,0,0,0,0,0,0,0
20200316,050882,華泰國泰96購01,,,,,0.00,0.00,0,0,0,0,0,0,0,0,0,0,0,0,0
20200316,050883,嘉聯益國泰96購01,,,,,0.00,0.00,0,0,0,0,0,0,0,0,0,0,0,0,0
20200316,050884,聯茂國泰96購01,0.28,0.29,0.16,0.16,-0.01,-5.88,74000,3,21080,0,0,0,0,0,0,0,74000,-74000,-74000
20200316,050885,T50反1富邦95購01,,,,,0.00,0.00,0,0,0,0,0,0,0,0,0,0,0,0,0
20200316,050886,台積電富邦95購04,,,,,0.00,0.00,0,0,0,0,0,0,0,0,0,0,0,0,0
20200316,050887,台積電富邦95購05,0.18,0.18,0.16,0.17,0.00,0.00,90000,9,15300,0,0,0,0,0,0,40000,90000,-50000,-50000
20200316,050888,群創富邦95購01,,,,,0.00,0.00,0,0,0,0,0,0,0,0,0,0,0,0,0
20200316,050889,健策富邦95購01,,,,,0.00,0.00,0,0,0,0,0,0,0,0,0,0,0,0,0
20200316,05088P,大立光富邦99售01,1.25,1.40,1.25,1.40,+0.13,10.24,4000,2,5150,0,0,0,0,0,0,1000,3000,-2000,-2000
20200316,050890,南電富邦99購01,0.32,0.33,0.28,0.28,+0.03,12.0,50000,6,14580,0,0,0,0,0,0,2000,48000,-46000,-46000
20200316,050891,喬山元大95購01,,,,,0.00,0.00,0,0,0,0,0,0,0,0,0,0,0,0,0
20200316,050892,聯電元大96購02,0.58,0.60,0.52,0.52,-0.15,-22.39,71000,5,40000,0,0,0,0,0,0,41000,30000,11000,11000
20200316,050893,鴻海元大96購03,0.30,0.30,0.27,0.28,-0.10,-26.32,105000,4,30400,0,0,0,0,0,0,95000,75000,20000,20000
20200316,050894,旺宏元大96購03,0.41,0.42,0.41,0.42,-0.13,-23.64,20000,2,8300,0,0,0,0,0,0,20000,0,20000,20000
20200316,050895,聯發科元大97購01,,,,,0.00,0.00,0,0,0,0,0,0,0,0,0,0,0,0,0
20200316,050896,華新科元大96購02,1.72,1.84,1.22,1.22,-0.20,-14.08,127000,14,192840,0,0,0,0,0,0,97000,106000,-9000,-9000
20200316,050897,嘉晶元大95購03,0.38,0.43,0.24,0.24,-0.14,-36.84,113000,14,44770,0,0,0,0,0,0,32000,81000,-49000,-49000
20200316,050898,智原元大96購01,,,,,0.00,0.00,0,0,0,0,0,0,0,0,0,0,0,0,0
20200316,050899,旭富元大95購01,0.56,0.65,0.37,0.37,-0.11,-22.92,233000,28,123440,0,0,0,0,0,0,20000,193000,-173000,-173000
20200316,05089P,亞德客元大95售01,1.47,1.74,1.45,1.74,-0.20,-10.31,106000,27,177430,0,0,0,0,0,0,13000,103000,-90000,-90000
20200316,050900,台郡元大95購02,0.17,0.17,0.13,0.13,0.00,0.00,105000,2,17650,0,0,0,0,0,0,100000,5000,95000,95000
20200316,050901,樺漢元大95購02,0.07,0.07,0.07,0.07,0.00,0.00,20000,2,1400,0,0,0,0,0,0,0,20000,-20000,-20000
20200316,050902,南電元大96購01,,,,,0.00,0.00,0,0,0,0,0,0,0,0,0,0,0,0,0
20200316,050903,臺股指元大95購10,,,,,0.00,0.00,0,0,0,0,0,0,0,0,0,0,0,0,0
20200316,050904,臺股指元大95購11,,,,,0.00,0.00,0,0,0,0,0,0,0,0,0,0,0,0,0
20200316,050905,臺股指元大95購12,,,,,0.00,0.00,0,0,0,0,0,0,0,0,0,0,0,0,0
20200316,050906,臺股指元大95購13,,,,,0.00,0.00,0,0,0,0,0,0,0,0,0,0,0,0,0
20200316,050907,臺股指元大95購14,,,,,0.00,0.00,0,0,0,0,0,0,0,0,0,0,0,0,0
20200316,050908,TPK亞東95購01,,,,,0.00,0.00,0,0,0,0,0,0,0,0,0,0,0,0,0
20200316,050909,華夏中信95購01,,,,,0.00,0.00,0,0,0,0,0,0,0,0,0,0,0,0,0
20200316,05090P,國巨元大95售05,0.53,0.82,0.52,0.79,+0.24,43.64,426000,33,298770,0,0,0,0,0,0,52000,264000,-212000,-212000
20200316,050910,楠梓電中信95購01,,,,,0.00,0.00,0,0,0,0,0,0,0,0,0,0,0,0,0
20200316,050911,光磊中信98購01,,,,,0.00,0.00,0,0,0,0,0,0,0,0,0,0,0,0,0
20200316,050912,正崴中信95購02,,,,,0.00,0.00,0,0,0,0,0,0,0,0,0,0,0,0,0
20200316,050913,全新中信97購01,,,,,0.00,0.00,0,0,0,0,0,0,0,0,0,0,0,0,0
20200316,050914,健鼎中信95購01,,,,,0.00,0.00,0,0,0,0,0,0,0,0,0,0,0,0,0
20200316,050915,健策中信98購01,0.37,0.37,0.29,0.32,-0.02,-5.88,90000,4,28300,0,0,0,0,0,0,10000,80000,-70000,-70000
20200316,050916,聯茂中信95購01,,,,,0.00,0.00,0,0,0,0,0,0,0,0,0,0,0,0,0
20200316,050917,瀚宇博兆豐96購01,,,,,0.00,0.00,0,0,0,0,0,0,0,0,0,0,0,0,0
20200316,050918,南亞科日盛95購01,,,,,0.00,0.00,0,0,0,0,0,0,0,0,0,0,0,0,0
20200316,050919,台積電凱基95購03,0.19,0.19,0.19,0.19,+0.05,35.71,10000,1,1900,0,0,0,0,0,0,10000,0,10000,10000
20200316,05091P,台積電元大95售11,2.39,3.41,2.28,3.36,+1.29,62.32,682000,57,1987250,0,0,0,0,0,0,549000,391000,158000,158000
20200316,050920,旺宏凱基95購01,0.40,0.45,0.39,0.45,+0.14,45.16,71000,8,29250,0,0,0,0,0,0,71000,0,71000,71000
20200316,050921,旺宏凱基95購02,0.30,0.30,0.25,0.25,+0.05,25.0,50000,5,14000,0,0,0,0,0,0,0,50000,-50000,-50000
20200316,050922,南亞科凱基95購02,,,,,0.00,0.00,0,0,0,0,0,0,0,0,0,0,0,0,0
20200316,050923,南亞科凱基95購03,,,,,0.00,0.00,0,0,0,0,0,0,0,0,0,0,0,0,0
20200316,050924,京元電凱基95購02,,,,,0.00,0.00,0,0,0,0,0,0,0,0,0,0,0,0,0
20200316,050925,可成凱基95購02,,,,,0.00,0.00,0,0,0,0,0,0,0,0,0,0,0,0,0
20200316,050926,禾伸堂凱基95購01,,,,,0.00,0.00,0,0,0,0,0,0,0,0,0,0,0,0,0
20200316,050927,聯詠凱基95購01,0.28,0.28,0.28,0.28,0.00,0.00,105000,2,29400,0,0,0,0,0,0,0,105000,-105000,-105000
20200316,050928,日月光凱基95購01,,,,,0.00,0.00,0,0,0,0,0,0,0,0,0,0,0,0,0
20200316,050929,中磊凱基95購01,,,,,0.00,0.00,0,0,0,0,0,0,0,0,0,0,0,0,0
20200316,05092P,全新元大95售03,,,,,0.00,0.00,0,0,0,0,0,0,0,0,0,0,0,0,0
20200316,050930,矽格凱基95購01,,,,,0.00,0.00,0,0,0,0,0,0,0,0,0,0,0,0,0
20200316,050931,上証2X國票95購03,0.08,0.08,0.08,0.08,0.00,0.00,13000,1,1040,0,0,0,0,0,0,0,13000,-13000,-13000
20200316,050932,台塑國票96購01,,,,,0.00,0.00,0,0,0,0,0,0,0,0,0,0,0,0,0
20200316,050933,南亞國票95購01,,,,,0.00,0.00,0,0,0,0,0,0,0,0,0,0,0,0,0
20200316,050934,喬山國票96購01,0.03,0.03,0.03,0.03,0.00,0.00,100000,1,3000,0,0,0,0,0,0,100000,0,100000,100000
20200316,050935,劍麟國票96購01,,,,,0.00,0.00,0,0,0,0,0,0,0,0,0,0,0,0,0
20200316,050936,國巨國票95購04,,,,,0.00,0.00,0,0,0,0,0,0,0,0,0,0,0,0,0
20200316,050937,可成國票96購02,,,,,0.00,0.00,0,0,0,0,0,0,0,0,0,0,0,0,0
20200316,050938,智原國票96購01,,,,,0.00,0.00,0,0,0,0,0,0,0,0,0,0,0,0,0
20200316,050939,健鼎國票96購01,,,,,0.00,0.00,0,0,0,0,0,0,0,0,0,0,0,0,0
20200316,05093P,可成元大95售03,,,,,0.00,0.00,0,0,0,0,0,0,0,0,0,0,0,0,0
20200316,050940,嘉澤國票95購01,,,,,0.00,0.00,0,0,0,0,0,0,0,0,0,0,0,0,0
20200316,050941,T50反1群益95購01,1.45,1.64,1.45,1.64,-0.06,-3.53,40000,3,60800,0,0,0,0,0,0,30000,10000,20000,20000
20200316,050942,S&P正2群益95購01,0.17,0.17,0.17,0.17,-0.05,-22.73,70000,3,11900,0,0,0,0,0,0,0,0,0,0
20200316,050943,楠梓電群益96購01,,,,,0.00,0.00,0,0,0,0,0,0,0,0,0,0,0,0,0
20200316,050944,智邦群益95購01,,,,,0.00,0.00,0,0,0,0,0,0,0,0,0,0,0,0,0
20200316,050945,致茂群益95購01,,,,,0.00,0.00,0,0,0,0,0,0,0,0,0,0,0,0,0
20200316,050946,瑞昱群益95購01,,,,,0.00,0.00,0,0,0,0,0,0,0,0,0,0,0,0,0
20200316,050947,聯發科群益95購01,,,,,0.00,0.00,0,0,0,0,0,0,0,0,0,0,0,0,0
20200316,050948,華固群益95購01,2.06,2.17,2.06,2.17,-0.31,-12.5,55000,2,117700,0,0,0,0,0,0,40000,15000,25000,25000
20200316,050949,亞光群益96購01,0.04,0.04,0.04,0.04,-0.02,-33.33,100000,1,4000,0,0,0,0,0,0,100000,0,100000,100000
20200316,05094P,大立光元大95售07,1.93,2.68,1.93,2.68,+0.82,44.09,15000,4,31570,0,0,0,0,0,0,14000,1000,13000,13000
20200316,050950,健鼎群益96購01,,,,,0.00,0.00,0,0,0,0,0,0,0,0,0,0,0,0,0
20200316,050951,緯創群益96購01,,,,,0.00,0.00,0,0,0,0,0,0,0,0,0,0,0,0,0
20200316,050952,健策群益96購01,0.92,0.92,0.92,0.92,+0.11,13.58,50000,1,46000,0,0,0,0,0,0,50000,0,50000,50000
20200316,050953,臻鼎群益95購01,,,,,0.00,0.00,0,0,0,0,0,0,0,0,0,0,0,0,0
20200316,050954,樺漢群益95購01,,,,,0.00,0.00,0,0,0,0,0,0,0,0,0,0,0,0,0
20200316,050955,達方群益97購01,0.32,0.32,0.32,0.32,0.00,0.00,10000,1,3200,0,0,0,0,0,0,10000,0,10000,10000
20200316,050956,鈺齊群益95購01,,,,,0.00,0.00,0,0,0,0,0,0,0,0,0,0,0,0,0
20200316,050957,T50反1台新05購01,1.32,1.80,1.29,1.80,+0.58,47.54,81000,10,114370,0,0,0,0,0,0,75000,0,75000,75000
20200316,050958,日月光台新95購01,,,,,0.00,0.00,0,0,0,0,0,0,0,0,0,0,0,0,0
20200316,050959,元金2X永豐95購02,,,,,0.00,0.00,0,0,0,0,0,0,0,0,0,0,0,0,0
20200316,05095P,景碩元大95售01,1.21,1.43,1.21,1.43,+0.15,11.72,93000,10,122130,0,0,0,0,0,0,60000,83000,-23000,-23000
20200316,050960,台光電永豐95購01,,,,,0.00,0.00,0,0,0,0,0,0,0,0,0,0,0,0,0
20200316,050961,美律永豐95購01,,,,,0.00,0.00,0,0,0,0,0,0,0,0,0,0,0,0,0
20200316,050962,聯發科永豐95購02,,,,,0.00,0.00,0,0,0,0,0,0,0,0,0,0,0,0,0
20200316,050963,強茂永豐95購01,,,,,0.00,0.00,0,0,0,0,0,0,0,0,0,0,0,0,0
20200316,050964,晶技永豐95購02,1.79,1.94,1.56,1.60,+0.05,3.23,110000,9,187300,0,0,0,0,0,0,50000,60000,-10000,-10000
20200316,050965,揚明光永豐96購01,,,,,0.00,0.00,0,0,0,0,0,0,0,0,0,0,0,0,0
20200316,050966,日月光永豐95購01,,,,,0.00,0.00,0,0,0,0,0,0,0,0,0,0,0,0,0
20200316,050967,嘉聯益永豐95購01,,,,,0.00,0.00,0,0,0,0,0,0,0,0,0,0,0,0,0
20200316,050968,超眾永豐95購01,,,,,0.00,0.00,0,0,0,0,0,0,0,0,0,0,0,0,0
20200316,050969,台郡永豐95購01,0.06,0.06,0.06,0.06,-0.02,-25.0,30000,1,1800,0,0,0,0,0,0,30000,0,30000,30000
20200316,05096P,台積電日盛95售01,0.49,0.75,0.49,0.75,+0.38,102.7,18000,3,10650,0,0,0,0,0,0,18000,10000,8000,8000
20200316,050970,康舒永豐95購01,,,,,0.00,0.00,0,0,0,0,0,0,0,0,0,0,0,0,0
20200316,050971,緯穎永豐95購01,0.55,0.57,0.40,0.40,0.00,0.00,299000,9,162280,0,0,0,0,0,0,190000,59000,131000,131000
20200316,050972,台虹永豐95購01,,,,,0.00,0.00,0,0,0,0,0,0,0,0,0,0,0,0,0
20200316,050973,S&P反1統一95購01,,,,,0.00,0.00,0,0,0,0,0,0,0,0,0,0,0,0,0
20200316,050974,大成鋼統一95購01,,,,,0.00,0.00,0,0,0,0,0,0,0,0,0,0,0,0,0
20200316,050975,楠梓電統一95購01,,,,,0.00,0.00,0,0,0,0,0,0,0,0,0,0,0,0,0
20200316,050976,台光電統一95購01,,,,,0.00,0.00,0,0,0,0,0,0,0,0,0,0,0,0,0
20200316,050977,聯發科統一95購02,,,,,0.00,0.00,0,0,0,0,0,0,0,0,0,0,0,0,0
20200316,050978,鴻海元富95購03,0.14,0.15,0.14,0.14,+0.07,100.0,60000,6,8600,0,0,0,0,0,0,60000,60000,0,0
20200316,050979,鴻海元富96購02,0.20,0.21,0.13,0.13,-0.10,-43.48,1195000,15,219370,0,0,0,0,0,0,955000,240000,715000,715000
20200316,05097P,聯發科日盛95售01,1.99,1.99,1.88,1.88,-0.34,-15.32,18000,3,35040,0,0,0,0,0,0,0,18000,-18000,-18000
20200316,050980,欣興元富95購02,,,,,0.00,0.00,0,0,0,0,0,0,0,0,0,0,0,0,0
20200316,050981,GIS元富95購01,,,,,0.00,0.00,0,0,0,0,0,0,0,0,0,0,0,0,0
20200316,050982,台積電國泰96購04,2.20,2.54,1.96,2.18,-0.62,-22.14,228000,29,496720,0,0,0,0,0,0,208000,95000,113000,113000
20200316,050983,新光金國泰97購01,,,,,0.00,0.00,0,0,0,0,0,0,0,0,0,0,0,0,0
20200316,050984,大立光國泰97購01,0.86,0.86,0.75,0.75,-0.16,-17.58,42000,5,33150,0,0,0,0,0,0,0,0,0,0
20200316,050985,易華電國泰96購02,,,,,0.00,0.00,0,0,0,0,0,0,0,0,0,0,0,0,0
20200316,050986,上証2X永昌97購01,,,,,0.00,0.00,0,0,0,0,0,0,0,0,0,0,0,0,0
20200316,050987,台泥富邦95購01,,,,,0.00,0.00,0,0,0,0,0,0,0,0,0,0,0,0,0
20200316,050988,廣達富邦95購01,,,,,0.00,0.00,0,0,0,0,0,0,0,0,0,0,0,0,0
20200316,050989,台表科富邦95購01,,,,,0.00,0.00,0,0,0,0,0,0,0,0,0,0,0,0,0
20200316,05098P,鴻海凱基95售15,2.66,2.66,2.66,2.66,0.00,0.00,20000,1,53200,0,0,0,0,0,0,20000,20000,0,0
20200316,050990,T50反1元大95購01,1.53,1.53,1.53,1.53,-0.10,-6.13,4000,1,6120,0,0,0,0,0,0,0,4000,-4000,-4000
20200316,050991,元油2X元大96購04,0.05,0.08,0.05,0.06,+0.02,50.0,460000,15,29300,0,0,0,0,0,0,0,0,0,0
20200316,050992,台積電元大97購01,1.30,1.30,0.80,0.95,-0.15,-13.64,17000,9,15350,0,0,0,0,0,0,0,0,0,0
20200316,050993,聯發科元大95購05,,,,,0.00,0.00,0,0,0,0,0,0,0,0,0,0,0,0,0
20200316,050994,欣興元大96購03,,,,,0.00,0.00,0,0,0,0,0,0,0,0,0,0,0,0,0
20200316,050995,貿聯元大95購02,,,,,0.00,0.00,0,0,0,0,0,0,0,0,0,0,0,0,0
20200316,050996,隆達元大95購01,,,,,0.00,0.00,0,0,0,0,0,0,0,0,0,0,0,0,0
20200316,050997,麗豐元大95購03,,,,,0.00,0.00,0,0,0,0,0,0,0,0,0,0,0,0,0
20200316,050998,訊連元大95購01,0.98,0.98,0.67,0.67,-0.22,-24.72,70000,8,58220,0,0,0,0,0,0,10000,60000,-50000,-50000
20200316,050999,瀚宇博元大95購04,,,,,0.00,0.00,0,0,0,0,0,0,0,0,0,0,0,0,0
20200316,05099P,台積電凱基95售06,1.88,1.88,1.88,1.88,+0.14,8.05,20000,1,37600,0,0,0,0,0,0,20000,0,20000,20000
20200316,051000,台郡元大96購01,0.21,0.21,0.13,0.14,-0.08,-36.36,253000,19,40860,0,0,0,0,0,0,178000,75000,103000,103000
20200316,051001,緯穎元大96購02,1.84,1.95,1.60,1.60,-0.13,-7.51,186000,10,344970,0,0,0,0,0,0,151000,26000,125000,125000
20200316,051002,華邦電亞東96購01,,,,,0.00,0.00,0,0,0,0,0,0,0,0,0,0,0,0,0
20200316,051003,中環中信97購01,0.02,0.02,0.02,0.02,0.00,0.00,287000,10,5740,0,0,0,0,0,0,0,0,0,0
20200316,051004,台新金中信95購02,,,,,0.00,0.00,0,0,0,0,0,0,0,0,0,0,0,0,0
20200316,051005,緯創中信95購02,,,,,0.00,0.00,0,0,0,0,0,0,0,0,0,0,0,0,0
20200316,051006,中磊中信95購01,,,,,0.00,0.00,0,0,0,0,0,0,0,0,0,0,0,0,0
20200316,051007,台光電麥證95購01,,,,,0.00,0.00,0,0,0,0,0,0,0,0,0,0,0,0,0
20200316,051008,大立光麥證95購01,,,,,0.00,0.00,0,0,0,0,0,0,0,0,0,0,0,0,0
20200316,051009,緯創麥證95購01,,,,,0.00,0.00,0,0,0,0,0,0,0,0,0,0,0,0,0
20200316,05100P,智邦凱基95售02,0.68,0.89,0.68,0.89,-0.41,-31.54,92000,4,74250,0,0,0,0,0,0,0,92000,-92000,-92000
20200316,051010,美律日盛95購01,,,,,0.00,0.00,0,0,0,0,0,0,0,0,0,0,0,0,0
20200316,051011,國巨凱基95購03,0.56,0.56,0.56,0.56,0.00,0.00,7000,1,3920,0,0,0,0,0,0,7000,7000,0,0
20200316,051012,台積電凱基95購04,,,,,0.00,0.00,0,0,0,0,0,0,0,0,0,0,0,0,0
20200316,051013,旺宏凱基95購03,,,,,0.00,0.00,0,0,0,0,0,0,0,0,0,0,0,0,0
20200316,051014,智邦凱基95購01,,,,,0.00,0.00,0,0,0,0,0,0,0,0,0,0,0,0,0
20200316,051015,南亞科凱基95購04,,,,,0.00,0.00,0,0,0,0,0,0,0,0,0,0,0,0,0
20200316,051016,京元電凱基95購03,,,,,0.00,0.00,0,0,0,0,0,0,0,0,0,0,0,0,0
20200316,051017,聯發科凱基95購04,,,,,0.00,0.00,0,0,0,0,0,0,0,0,0,0,0,0,0
20200316,051018,可成凱基95購03,,,,,0.00,0.00,0,0,0,0,0,0,0,0,0,0,0,0,0
20200316,051019,大立光凱基95購08,,,,,0.00,0.00,0,0,0,0,0,0,0,0,0,0,0,0,0
20200316,05101P,大立光凱基95售11,1.90,2.28,1.87,2.28,0.00,0.00,277000,10,535070,0,0,0,0,0,0,0,277000,-277000,-277000
20200316,051020,健策凱基96購02,0.39,0.46,0.27,0.27,-0.17,-38.64,496000,37,193620,0,0,0,0,0,0,426000,63000,363000,363000
20200316,051021,啟碁凱基95購02,,,,,0.00,0.00,0,0,0,0,0,0,0,0,0,0,0,0,0
20200316,051022,GIS凱基95購02,,,,,0.00,0.00,0,0,0,0,0,0,0,0,0,0,0,0,0
20200316,051023,S&P反1統一95購02,,,,,0.00,0.00,0,0,0,0,0,0,0,0,0,0,0,0,0
20200316,051024,南亞科統一95購01,,,,,0.00,0.00,0,0,0,0,0,0,0,0,0,0,0,0,0
20200316,051025,晶華統一95購01,,,,,0.00,0.00,0,0,0,0,0,0,0,0,0,0,0,0,0
20200316,051026,健策統一96購01,0.43,0.43,0.43,0.43,0.00,0.00,1000,1,430,0,0,0,0,0,0,1000,0,1000,1000
20200316,051027,楠梓電元富95購01,,,,,0.00,0.00,0,0,0,0,0,0,0,0,0,0,0,0,0
20200316,051028,台光電元富95購02,0.26,0.26,0.26,0.26,-0.04,-13.33,625000,4,162500,0,0,0,0,0,0,625000,0,625000,625000
20200316,051029,緯創元富95購01,,,,,0.00,0.00,0,0,0,0,0,0,0,0,0,0,0,0,0
20200316,05102P,臺股指凱基96售09,,,,,0.00,0.00,0,0,0,0,0,0,0,0,0,0,0,0,0
20200316,051030,康友元富95購01,,,,,0.00,0.00,0,0,0,0,0,0,0,0,0,0,0,0,0
20200316,051031,康友元富95購02,0.23,0.23,0.23,0.23,-0.05,-17.86,100000,10,23000,0,0,0,0,0,0,0,100000,-100000,-100000
20200316,051032,南電元富95購01,,,,,0.00,0.00,0,0,0,0,0,0,0,0,0,0,0,0,0
20200316,051033,台積電兆豐95購03,0.05,0.05,0.05,0.05,0.00,0.00,10000,2,500,0,0,0,0,0,0,0,0,0,0
20200316,051034,正崴兆豐95購01,,,,,0.00,0.00,0,0,0,0,0,0,0,0,0,0,0,0,0
20200316,051035,百和兆豐95購01,,,,,0.00,0.00,0,0,0,0,0,0,0,0,0,0,0,0,0
20200316,051036,喬山台新95購01,,,,,0.00,0.00,0,0,0,0,0,0,0,0,0,0,0,0,0
20200316,051037,大立光台新95購01,,,,,0.00,0.00,0,0,0,0,0,0,0,0,0,0,0,0,0
20200316,051038,健策台新95購01,0.31,0.36,0.21,0.21,-0.09,-30.0,378000,40,106940,0,0,0,0,0,0,90000,198000,-108000,-108000
20200316,051039,台表科康和95購01,0.02,0.02,0.02,0.02,0.00,0.00,200000,1,4000,0,0,0,0,0,0,200000,0,200000,200000
20200316,05103P,臺股指凱基96售10,4.25,4.25,4.25,4.25,-1.75,-29.17,6000,1,25500,0,0,0,0,0,0,6000,0,6000,6000
20200316,051040,漢唐永豐95購01,,,,,0.00,0.00,0,0,0,0,0,0,0,0,0,0,0,0,0
20200316,051041,大立光永豐95購01,,,,,0.00,0.00,0,0,0,0,0,0,0,0,0,0,0,0,0
20200316,051042,中磊永豐95購01,,,,,0.00,0.00,0,0,0,0,0,0,0,0,0,0,0,0,0
20200316,051043,瀚宇博永豐95購01,,,,,0.00,0.00,0,0,0,0,0,0,0,0,0,0,0,0,0
20200316,051044,GIS永豐95購01,,,,,0.00,0.00,0,0,0,0,0,0,0,0,0,0,0,0,0
20200316,051045,南茂永豐95購01,,,,,0.00,0.00,0,0,0,0,0,0,0,0,0,0,0,0,0
20200316,051046,寶成永豐95購01,,,,,0.00,0.00,0,0,0,0,0,0,0,0,0,0,0,0,0
20200316,051047,深中小群益99購01,1.50,1.58,1.50,1.58,+0.23,17.04,12000,2,18160,0,0,0,0,0,0,12000,0,12000,12000
20200316,051048,臺指反群益96購01,1.45,1.45,1.45,1.45,-0.35,-19.44,10000,1,14500,0,0,0,0,0,0,0,10000,-10000,-10000
20200316,051049,亞德客群益95購01,0.44,0.44,0.44,0.44,+0.23,109.52,15000,1,6600,0,0,0,0,0,0,15000,0,15000,15000
20200316,05104P,智邦台新95售02,0.79,0.89,0.72,0.85,+0.04,4.94,108000,5,88950,0,0,0,0,0,0,10000,98000,-88000,-88000
20200316,051050,鴻海群益95購03,0.06,0.06,0.03,0.03,-0.07,-70.0,399000,32,19940,0,0,0,0,0,0,100000,299000,-199000,-199000
20200316,051051,鴻海群益95購04,,,,,0.00,0.00,0,0,0,0,0,0,0,0,0,0,0,0,0
20200316,051052,台積電群益95購01,0.36,0.36,0.14,0.14,-0.26,-65.0,465000,16,109100,0,0,0,0,0,0,100000,355000,-255000,-255000
20200316,051053,台光電群益95購01,0.25,0.25,0.25,0.25,+0.03,13.64,2000,1,500,0,0,0,0,0,0,2000,0,2000,2000
20200316,051054,正崴群益95購01,,,,,0.00,0.00,0,0,0,0,0,0,0,0,0,0,0,0,0
20200316,051055,友達群益98購01,0.59,0.59,0.55,0.55,+0.13,30.95,40000,3,23000,0,0,0,0,0,0,10000,30000,-20000,-20000
20200316,051056,華新科群益95購03,0.11,0.11,0.10,0.10,-0.01,-9.09,30000,2,3100,0,0,0,0,0,0,0,10000,-10000,-10000
20200316,051057,信邦群益95購01,,,,,0.00,0.00,0,0,0,0,0,0,0,0,0,0,0,0,0
20200316,051058,景碩群益96購01,,,,,0.00,0.00,0,0,0,0,0,0,0,0,0,0,0,0,0
20200316,051059,康普群益95購01,,,,,0.00,0.00,0,0,0,0,0,0,0,0,0,0,0,0,0
20200316,05105P,大立光台新95售02,1.29,1.29,1.27,1.27,-0.47,-27.01,3000,3,3840,0,0,0,0,0,0,0,3000,-3000,-3000
20200316,051060,鎧勝群益95購01,,,,,0.00,0.00,0,0,0,0,0,0,0,0,0,0,0,0,0
20200316,051061,中磊群益95購01,,,,,0.00,0.00,0,0,0,0,0,0,0,0,0,0,0,0,0
20200316,051062,超眾群益95購02,0.19,0.19,0.19,0.19,+0.06,46.15,100000,1,19000,0,0,0,0,0,0,100000,0,100000,100000
20200316,051063,台郡群益95購01,0.07,0.07,0.05,0.05,-0.03,-37.5,670000,11,40700,0,0,0,0,0,0,130000,540000,-410000,-410000
20200316,051064,鴻海國票95購01,,,,,0.00,0.00,0,0,0,0,0,0,0,0,0,0,0,0,0
20200316,051065,台積電國票96購01,0.11,0.11,0.11,0.11,-0.18,-62.07,2000,1,220,0,0,0,0,0,0,0,0,0,0
20200316,051066,台積電國票96購02,0.09,0.09,0.07,0.07,-0.02,-22.22,410000,8,32800,0,0,0,0,0,0,0,0,0,0
20200316,051067,台積電國票96購03,1.14,1.14,0.81,0.81,-0.75,-48.08,106000,8,100620,0,0,0,0,0,0,84000,0,84000,84000
20200316,051068,台積電國票97購01,,,,,0.00,0.00,0,0,0,0,0,0,0,0,0,0,0,0,0
20200316,051069,智邦國票96購01,0.38,0.38,0.38,0.38,+0.23,153.33,25000,1,9500,0,0,0,0,0,0,25000,0,25000,25000
20200316,05106P,鴻海永豐95售02,,,,,0.00,0.00,0,0,0,0,0,0,0,0,0,0,0,0,0
20200316,051070,正崴國票96購01,,,,,0.00,0.00,0,0,0,0,0,0,0,0,0,0,0,0,0
20200316,051071,聯發科國票96購01,,,,,0.00,0.00,0,0,0,0,0,0,0,0,0,0,0,0,0
20200316,051072,強茂國票95購02,,,,,0.00,0.00,0,0,0,0,0,0,0,0,0,0,0,0,0
20200316,051073,同欣電國票96購01,0.12,0.12,0.10,0.10,-0.04,-28.57,50000,5,5700,0,0,0,0,0,0,0,50000,-50000,-50000
20200316,051074,矽力國票96購01,2.01,2.01,2.01,2.01,-0.44,-17.96,15000,1,30150,0,0,0,0,0,0,15000,0,15000,15000
20200316,051075,智邦國泰97購01,0.91,0.98,0.78,0.78,-0.15,-16.13,1363000,47,1216920,0,0,0,0,0,0,1318000,95000,1223000,1223000
20200316,051076,緯創國泰96購01,,,,,0.00,0.00,0,0,0,0,0,0,0,0,0,0,0,0,0
20200316,051077,台郡國泰96購02,0.39,0.39,0.39,0.39,-0.03,-7.14,214000,1,83460,0,0,0,0,0,0,214000,0,214000,214000
20200316,051078,力山富邦97購01,,,,,0.00,0.00,0,0,0,0,0,0,0,0,0,0,0,0,0
20200316,051079,鴻海富邦96購02,,,,,0.00,0.00,0,0,0,0,0,0,0,0,0,0,0,0,0
20200316,05107P,鴻海兆豐96售02,2.87,3.03,2.87,3.03,+0.83,37.73,25000,2,72550,0,0,0,0,0,0,25000,20000,5000,5000
20200316,051080,全新富邦96購01,,,,,0.00,0.00,0,0,0,0,0,0,0,0,0,0,0,0,0
20200316,051081,聯茂富邦96購01,0.08,0.08,0.08,0.08,+0.02,33.33,2000,1,160,0,0,0,0,0,0,2000,0,2000,2000
20200316,051082,上証2X元大98購01,0.44,0.44,0.44,0.44,-0.12,-21.43,10000,1,4400,0,0,0,0,0,0,0,10000,-10000,-10000
20200316,051083,A50正2元大98購01,0.42,0.51,0.42,0.51,+0.04,8.51,21000,2,8910,0,0,0,0,0,0,20000,1000,19000,19000
20200316,051084,華通元大95購06,,,,,0.00,0.00,0,0,0,0,0,0,0,0,0,0,0,0,0
20200316,051085,鴻海元大95購03,,,,,0.00,0.00,0,0,0,0,0,0,0,0,0,0,0,0,0
20200316,051086,鴻海元大96購04,0.10,0.10,0.10,0.10,+0.03,42.86,30000,1,3000,0,0,0,0,0,0,30000,0,30000,30000
20200316,051087,國巨元大97購01,1.43,1.56,1.06,1.06,-0.37,-25.87,329000,47,464870,0,0,0,0,0,0,0,162000,-162000,-162000
20200316,051088,台積電元大95購09,0.12,0.12,0.12,0.12,-0.07,-36.84,1000,1,120,0,0,0,0,0,0,1000,1000,0,0
20200316,051089,旺宏元大96購04,0.41,0.48,0.26,0.26,-0.03,-10.34,149000,16,51070,0,0,0,0,0,0,15000,134000,-119000,-119000
20200316,05108P,欣興中信95售02,1.85,1.85,1.79,1.79,+0.24,15.48,6000,6,10920,0,0,0,0,0,0,6000,0,6000,6000
20200316,051090,光磊元大96購01,,,,,0.00,0.00,0,0,0,0,0,0,0,0,0,0,0,0,0
20200316,051091,聯發科元大95購07,,,,,0.00,0.00,0,0,0,0,0,0,0,0,0,0,0,0,0
20200316,051092,禾伸堂元大95購02,0.50,0.50,0.47,0.48,+0.08,20.0,75000,11,36500,0,0,0,0,0,0,75000,0,75000,75000
20200316,051093,聯詠元大95購01,,,,,0.00,0.00,0,0,0,0,0,0,0,0,0,0,0,0,0
20200316,051094,健策元大96購03,1.06,1.16,0.80,0.80,-0.26,-24.53,231000,24,236940,0,0,0,0,0,0,18000,213000,-195000,-195000
20200316,051095,貿聯元大95購03,,,,,0.00,0.00,0,0,0,0,0,0,0,0,0,0,0,0,0
20200316,051096,日月光元大95購01,,,,,0.00,0.00,0,0,0,0,0,0,0,0,0,0,0,0,0
20200316,051097,嘉聯益元大96購02,,,,,0.00,0.00,0,0,0,0,0,0,0,0,0,0,0,0,0
20200316,051098,矽格元大95購01,,,,,0.00,0.00,0,0,0,0,0,0,0,0,0,0,0,0,0
20200316,051099,台郡元大95購03,0.04,0.04,0.04,0.04,-0.04,-50.0,3000,1,120,0,0,0,0,0,0,3000,0,3000,3000
20200316,05109P,臺股指麥證95售01,,,,,0.00,0.00,0,0,0,0,0,0,0,0,0,0,0,0,0
20200316,051100,同欣電元大95購01,0.45,0.51,0.40,0.40,-0.12,-23.08,38000,6,16930,0,0,0,0,0,0,23000,15000,8000,8000
20200316,051101,台表科元大96購02,0.08,0.08,0.08,0.08,-0.05,-38.46,50000,5,4000,0,0,0,0,0,0,0,50000,-50000,-50000
20200316,051102,訊芯元大96購01,,,,,0.00,0.00,0,0,0,0,0,0,0,0,0,0,0,0,0
20200316,051103,緯穎元大96購03,1.97,1.97,1.53,1.53,-0.21,-12.07,154000,16,266540,0,0,0,0,0,0,50000,104000,-54000,-54000
20200316,051104,鈺齊元大96購01,0.15,0.15,0.11,0.11,-0.03,-21.43,40000,4,4800,0,0,0,0,0,0,10000,30000,-20000,-20000
20200316,051105,台光電國票96購01,,,,,0.00,0.00,0,0,0,0,0,0,0,0,0,0,0,0,0
20200316,051106,華通統一95購02,,,,,0.00,0.00,0,0,0,0,0,0,0,0,0,0,0,0,0
20200316,051107,鴻海統一95購05,,,,,0.00,0.00,0,0,0,0,0,0,0,0,0,0,0,0,0
20200316,051108,鴻海統一96購02,,,,,0.00,0.00,0,0,0,0,0,0,0,0,0,0,0,0,0
20200316,051109,美律統一95購02,,,,,0.00,0.00,0,0,0,0,0,0,0,0,0,0,0,0,0
20200316,05110P,上銀統一95售01,,,,,0.00,0.00,0,0,0,0,0,0,0,0,0,0,0,0,0
20200316,051110,可成統一95購01,,,,,0.00,0.00,0,0,0,0,0,0,0,0,0,0,0,0,0
20200316,051111,可成統一95購02,,,,,0.00,0.00,0,0,0,0,0,0,0,0,0,0,0,0,0
20200316,051112,台郡統一95購01,,,,,0.00,0.00,0,0,0,0,0,0,0,0,0,0,0,0,0
20200316,051113,聯電元富95購01,0.15,0.15,0.15,0.15,+0.02,15.38,200000,1,30000,0,0,0,0,0,0,200000,0,200000,200000
20200316,051114,鈺齊中信95購01,,,,,0.00,0.00,0,0,0,0,0,0,0,0,0,0,0,0,0
20200316,051115,華通麥證96購01,,,,,0.00,0.00,0,0,0,0,0,0,0,0,0,0,0,0,0
20200316,051116,可成麥證95購01,,,,,0.00,0.00,0,0,0,0,0,0,0,0,0,0,0,0,0
20200316,051117,臺指反群益95購02,,,,,0.00,0.00,0,0,0,0,0,0,0,0,0,0,0,0,0
20200316,051118,台塑群益95購01,,,,,0.00,0.00,0,0,0,0,0,0,0,0,0,0,0,0,0
20200316,051119,光寶科群益95購01,,,,,0.00,0.00,0,0,0,0,0,0,0,0,0,0,0,0,0
20200316,05111P,台積電統一95售04,1.54,1.95,1.54,1.95,+0.66,51.16,243000,4,427630,0,0,0,0,0,0,243000,0,243000,243000
20200316,051120,南亞科群益95購01,0.12,0.12,0.11,0.11,0.00,0.00,30000,3,3400,0,0,0,0,0,0,0,30000,-30000,-30000
20200316,051121,裕民群益97購01,,,,,0.00,0.00,0,0,0,0,0,0,0,0,0,0,0,0,0
20200316,051122,美食群益95購01,,,,,0.00,0.00,0,0,0,0,0,0,0,0,0,0,0,0,0
20200316,051123,和鑫群益95購01,,,,,0.00,0.00,0,0,0,0,0,0,0,0,0,0,0,0,0
20200316,051124,創意群益95購01,,,,,0.00,0.00,0,0,0,0,0,0,0,0,0,0,0,0,0
20200316,051125,TPK群益95購01,,,,,0.00,0.00,0,0,0,0,0,0,0,0,0,0,0,0,0
20200316,051126,訊連群益95購01,,,,,0.00,0.00,0,0,0,0,0,0,0,0,0,0,0,0,0
20200316,051127,同欣電群益95購01,0.03,0.04,0.03,0.03,-0.01,-25.0,120000,7,3900,0,0,0,0,0,0,60000,60000,0,0
20200316,051128,台表科群益95購02,,,,,0.00,0.00,0,0,0,0,0,0,0,0,0,0,0,0,0
20200316,051129,GIS群益95購01,,,,,0.00,0.00,0,0,0,0,0,0,0,0,0,0,0,0,0
20200316,05112P,燿華統一95售01,,,,,0.00,0.00,0,0,0,0,0,0,0,0,0,0,0,0,0
20200316,051130,百和群益96購01,,,,,0.00,0.00,0,0,0,0,0,0,0,0,0,0,0,0,0
20200316,051131,玉山金台新95購01,0.07,0.07,0.05,0.05,-0.08,-61.54,130000,6,7550,0,0,0,0,0,0,20000,25000,-5000,-5000
20200316,051132,喬山永豐95購02,,,,,0.00,0.00,0,0,0,0,0,0,0,0,0,0,0,0,0
20200316,051133,台積電永豐95購02,0.13,0.17,0.08,0.11,-0.02,-15.38,3411000,118,338960,0,0,0,0,0,0,0,0,0,0
20200316,051134,燿華永豐95購05,,,,,0.00,0.00,0,0,0,0,0,0,0,0,0,0,0,0,0
20200316,051135,建準永豐95購01,,,,,0.00,0.00,0,0,0,0,0,0,0,0,0,0,0,0,0
20200316,051136,可成永豐95購02,,,,,0.00,0.00,0,0,0,0,0,0,0,0,0,0,0,0,0
20200316,051137,聯詠永豐95購01,,,,,0.00,0.00,0,0,0,0,0,0,0,0,0,0,0,0,0
20200316,051138,訊連永豐95購01,,,,,0.00,0.00,0,0,0,0,0,0,0,0,0,0,0,0,0
20200316,051139,康友永豐95購01,0.06,0.06,0.06,0.06,-0.05,-45.45,30000,3,1800,0,0,0,0,0,0,0,30000,-30000,-30000
20200316,05113P,臺股指元富95售01,,,,,0.00,0.00,0,0,0,0,0,0,0,0,0,0,0,0,0
20200316,051140,矽創永豐95購02,,,,,0.00,0.00,0,0,0,0,0,0,0,0,0,0,0,0,0
20200316,051141,鈺齊永豐95購01,,,,,0.00,0.00,0,0,0,0,0,0,0,0,0,0,0,0,0
20200316,051142,臺股指永豐95購02,,,,,0.00,0.00,0,0,0,0,0,0,0,0,0,0,0,0,0
20200316,051143,鴻海凱基95購11,,,,,0.00,0.00,0,0,0,0,0,0,0,0,0,0,0,0,0
20200316,051144,鴻海凱基95購12,,,,,0.00,0.00,0,0,0,0,0,0,0,0,0,0,0,0,0
20200316,051145,台積電凱基95購05,,,,,0.00,0.00,0,0,0,0,0,0,0,0,0,0,0,0,0
20200316,051146,旺宏凱基95購04,0.14,0.14,0.14,0.14,+0.04,40.0,30000,3,4200,0,0,0,0,0,0,0,30000,-30000,-30000
20200316,051147,南亞科凱基95購05,,,,,0.00,0.00,0,0,0,0,0,0,0,0,0,0,0,0,0
20200316,051148,聯發科凱基95購06,,,,,0.00,0.00,0,0,0,0,0,0,0,0,0,0,0,0,0
20200316,051149,可成凱基95購04,,,,,0.00,0.00,0,0,0,0,0,0,0,0,0,0,0,0,0
20200316,05114P,臺股指元富95售02,,,,,0.00,0.00,0,0,0,0,0,0,0,0,0,0,0,0,0
20200316,051150,宏達電凱基95購02,,,,,0.00,0.00,0,0,0,0,0,0,0,0,0,0,0,0,0
20200316,051151,中磊凱基95購02,,,,,0.00,0.00,0,0,0,0,0,0,0,0,0,0,0,0,0
20200316,051152,鴻海國泰97購01,,,,,0.00,0.00,0,0,0,0,0,0,0,0,0,0,0,0,0
20200316,051153,鴻海國泰97購02,,,,,0.00,0.00,0,0,0,0,0,0,0,0,0,0,0,0,0
20200316,051154,國巨國泰96購03,,,,,0.00,0.00,0,0,0,0,0,0,0,0,0,0,0,0,0
20200316,051155,聯發科國泰96購01,,,,,0.00,0.00,0,0,0,0,0,0,0,0,0,0,0,0,0
20200316,051156,鴻海富邦97購01,0.10,0.10,0.10,0.10,-0.04,-28.57,11000,2,1100,0,0,0,0,0,0,0,0,0,0
20200316,051157,華新科富邦98購01,0.28,0.28,0.25,0.25,-0.06,-19.35,298000,10,77580,0,0,0,0,0,0,181000,93000,88000,88000
20200316,051158,嘉晶富邦96購01,0.18,0.18,0.12,0.16,-0.02,-11.11,220000,17,33120,0,0,0,0,0,0,15000,205000,-190000,-190000
20200316,051159,力山元大96購01,,,,,0.00,0.00,0,0,0,0,0,0,0,0,0,0,0,0,0
20200316,05115P,T50反1群益95售02,,,,,0.00,0.00,0,0,0,0,0,0,0,0,0,0,0,0,0
20200316,051160,亞德客元大95購02,0.58,0.74,0.44,0.44,+0.05,12.82,50000,5,30700,0,0,0,0,0,0,30000,20000,10000,10000
20200316,051161,喬山元大95購02,,,,,0.00,0.00,0,0,0,0,0,0,0,0,0,0,0,0,0
20200316,051162,楠梓電元大95購01,,,,,0.00,0.00,0,0,0,0,0,0,0,0,0,0,0,0,0
20200316,051163,鴻海元大95購04,0.02,0.02,0.02,0.02,0.00,0.00,10000,1,200,0,0,0,0,0,0,0,10000,-10000,-10000
20200316,051164,鴻海元大95購05,,,,,0.00,0.00,0,0,0,0,0,0,0,0,0,0,0,0,0
20200316,051165,可成元大95購01,,,,,0.00,0.00,0,0,0,0,0,0,0,0,0,0,0,0,0
20200316,051166,可成元大95購02,,,,,0.00,0.00,0,0,0,0,0,0,0,0,0,0,0,0,0
20200316,051167,京鼎元大95購01,,,,,0.00,0.00,0,0,0,0,0,0,0,0,0,0,0,0,0
20200316,051168,訊連元大95購02,,,,,0.00,0.00,0,0,0,0,0,0,0,0,0,0,0,0,0
20200316,051169,瀚宇博元大95購05,,,,,0.00,0.00,0,0,0,0,0,0,0,0,0,0,0,0,0
20200316,05116P,台積電群益95售03,2.23,2.72,2.23,2.72,-0.10,-3.55,7000,2,18550,0,0,0,0,0,0,0,7000,-7000,-7000
20200316,051170,南電元大95購03,0.17,0.17,0.17,0.17,+0.01,6.25,60000,1,10200,0,0,0,0,0,0,60000,0,60000,60000
20200316,051171,T50反1第一95購01,,,,,0.00,0.00,0,0,0,0,0,0,0,0,0,0,0,0,0
20200316,051172,鴻海第一96購01,,,,,0.00,0.00,0,0,0,0,0,0,0,0,0,0,0,0,0
20200316,051173,元油2X凱基98購01,0.05,0.05,0.05,0.05,0.00,0.00,483000,5,24150,0,0,0,0,0,0,0,0,0,0
20200316,051174,鴻海凱基95購14,,,,,0.00,0.00,0,0,0,0,0,0,0,0,0,0,0,0,0
20200316,051175,國巨凱基95購04,0.24,0.24,0.24,0.24,-0.01,-4.0,200000,20,48000,0,0,0,0,0,0,0,190000,-190000,-190000
20200316,051176,聯發科凱基95購07,,,,,0.00,0.00,0,0,0,0,0,0,0,0,0,0,0,0,0
20200316,051177,可成凱基95購05,,,,,0.00,0.00,0,0,0,0,0,0,0,0,0,0,0,0,0
20200316,051178,大立光凱基95購10,,,,,0.00,0.00,0,0,0,0,0,0,0,0,0,0,0,0,0
20200316,051179,臺股指凱基95購04,0.05,0.05,0.05,0.05,0.00,0.00,20000,2,1000,0,0,0,0,0,0,0,20000,-20000,-20000
20200316,05117P,瑞昱群益95售02,,,,,0.00,0.00,0,0,0,0,0,0,0,0,0,0,0,0,0
20200316,051180,喬山永豐95購03,,,,,0.00,0.00,0,0,0,0,0,0,0,0,0,0,0,0,0
20200316,051181,鴻海永豐95購03,,,,,0.00,0.00,0,0,0,0,0,0,0,0,0,0,0,0,0
20200316,051182,旺宏永豐95購01,,,,,0.00,0.00,0,0,0,0,0,0,0,0,0,0,0,0,0
20200316,051183,建準永豐95購02,,,,,0.00,0.00,0,0,0,0,0,0,0,0,0,0,0,0,0
20200316,051184,聯發科永豐95購03,,,,,0.00,0.00,0,0,0,0,0,0,0,0,0,0,0,0,0
20200316,051185,強茂永豐95購03,,,,,0.00,0.00,0,0,0,0,0,0,0,0,0,0,0,0,0
20200316,051186,創意永豐95購01,,,,,0.00,0.00,0,0,0,0,0,0,0,0,0,0,0,0,0
20200316,051187,晶相光永豐95購01,0.07,0.07,0.07,0.07,-0.02,-22.22,10000,1,700,0,0,0,0,0,0,10000,0,10000,10000
20200316,051188,鴻海兆豐95購01,,,,,0.00,0.00,0,0,0,0,0,0,0,0,0,0,0,0,0
20200316,051189,鴻海兆豐96購01,,,,,0.00,0.00,0,0,0,0,0,0,0,0,0,0,0,0,0
20200316,05118P,超眾元大96售04,0.91,1.17,0.90,1.17,+0.26,28.57,271000,34,280800,0,0,0,0,0,0,15000,256000,-241000,-241000
20200316,051190,可成兆豐95購03,,,,,0.00,0.00,0,0,0,0,0,0,0,0,0,0,0,0,0
20200316,051191,可成兆豐96購01,,,,,0.00,0.00,0,0,0,0,0,0,0,0,0,0,0,0,0
20200316,051192,緯創兆豐96購01,,,,,0.00,0.00,0,0,0,0,0,0,0,0,0,0,0,0,0
20200316,051193,新日興兆豐96購01,0.38,0.38,0.27,0.27,-0.03,-10.0,58000,3,21340,0,0,0,0,0,0,15000,43000,-28000,-28000
20200316,051194,大立光中信96購02,0.02,0.02,0.02,0.02,-0.02,-50.0,30000,3,600,0,0,0,0,0,0,0,30000,-30000,-30000
20200316,051195,台郡中信95購01,,,,,0.00,0.00,0,0,0,0,0,0,0,0,0,0,0,0,0
20200316,051196,喬山麥證95購01,,,,,0.00,0.00,0,0,0,0,0,0,0,0,0,0,0,0,0
20200316,051197,光寶科麥證95購01,,,,,0.00,0.00,0,0,0,0,0,0,0,0,0,0,0,0,0
20200316,051198,鴻海麥證95購02,,,,,0.00,0.00,0,0,0,0,0,0,0,0,0,0,0,0,0
20200316,051199,鴻海麥證95購03,,,,,0.00,0.00,0,0,0,0,0,0,0,0,0,0,0,0,0
20200316,05119P,聯發科國泰96售02,3.31,3.31,3.31,3.31,+0.02,0.61,5000,1,16550,0,0,0,0,0,0,0,5000,-5000,-5000
20200316,051200,國巨麥證95購01,,,,,0.00,0.00,0,0,0,0,0,0,0,0,0,0,0,0,0
20200316,051201,台積電麥證95購02,0.21,0.21,0.21,0.21,-0.12,-36.36,10000,1,2100,0,0,0,0,0,0,0,0,0,0
20200316,051202,智邦麥證95購01,0.48,0.48,0.31,0.31,-0.01,-3.12,28000,3,10740,8000,20000,-12000,0,0,0,8000,20000,-12000,-12000
20200316,051203,微星麥證95購01,,,,,0.00,0.00,0,0,0,0,0,0,0,0,0,0,0,0,0
20200316,051204,正崴麥證95購01,,,,,0.00,0.00,0,0,0,0,0,0,0,0,0,0,0,0,0
20200316,051205,華新科麥證95購02,,,,,0.00,0.00,0,0,0,0,0,0,0,0,0,0,0,0,0
20200316,051206,大立光麥證95購02,0.25,0.27,0.14,0.14,-0.13,-48.15,40000,4,9000,30000,10000,20000,0,0,0,30000,10000,20000,20000
20200316,051207,聯茂麥證95購01,,,,,0.00,0.00,0,0,0,0,0,0,0,0,0,0,0,0,0
20200316,051208,GIS麥證95購01,,,,,0.00,0.00,0,0,0,0,0,0,0,0,0,0,0,0,0
20200316,051209,百和麥證95購01,,,,,0.00,0.00,0,0,0,0,0,0,0,0,0,0,0,0,0
20200316,05120P,聯發科國泰97售01,,,,,0.00,0.00,0,0,0,0,0,0,0,0,0,0,0,0,0
20200316,051210,S&P反1統一97購01,,,,,0.00,0.00,0,0,0,0,0,0,0,0,0,0,0,0,0
20200316,051211,道瓊反統一95購01,,,,,0.00,0.00,0,0,0,0,0,0,0,0,0,0,0,0,0
20200316,051212,國巨統一95購01,,,,,0.00,0.00,0,0,0,0,0,0,0,0,0,0,0,0,0
20200316,051213,華新科統一95購01,,,,,0.00,0.00,0,0,0,0,0,0,0,0,0,0,0,0,0
20200316,051214,大立光統一95購02,,,,,0.00,0.00,0,0,0,0,0,0,0,0,0,0,0,0,0
20200316,051215,大立光統一95購03,,,,,0.00,0.00,0,0,0,0,0,0,0,0,0,0,0,0,0
20200316,051216,為升元富95購01,,,,,0.00,0.00,0,0,0,0,0,0,0,0,0,0,0,0,0
20200316,051217,聯發科元富95購01,,,,,0.00,0.00,0,0,0,0,0,0,0,0,0,0,0,0,0
20200316,051218,聯發科元富9B購02,0.15,0.15,0.11,0.11,-0.08,-42.11,292000,7,42690,0,0,0,0,0,0,0,287000,-287000,-287000
20200316,051219,大立光元富95購07,0.08,0.08,0.08,0.08,+0.01,14.29,100000,1,8000,0,0,0,0,0,0,100000,0,100000,100000
20200316,05121P,創意國泰96售01,,,,,0.00,0.00,0,0,0,0,0,0,0,0,0,0,0,0,0
20200316,051220,大立光元富95購08,,,,,0.00,0.00,0,0,0,0,0,0,0,0,0,0,0,0,0
20200316,051221,嘉聯益元富95購01,,,,,0.00,0.00,0,0,0,0,0,0,0,0,0,0,0,0,0
20200316,051222,世紀鋼元富95購01,1.15,1.47,1.12,1.13,+0.05,4.63,491000,37,612230,0,0,0,0,0,0,332000,113000,219000,219000
20200316,051223,台化群益95購01,,,,,0.00,0.00,0,0,0,0,0,0,0,0,0,0,0,0,0
20200316,051224,華通群益96購03,0.04,0.04,0.04,0.04,0.00,0.00,70000,2,2800,0,0,0,0,0,0,0,70000,-70000,-70000
20200316,051225,台積電群益95購02,0.06,0.10,0.06,0.06,0.00,0.00,175000,9,13000,0,0,0,0,0,0,15000,160000,-145000,-145000
20200316,051226,英業達群益95購01,,,,,0.00,0.00,0,0,0,0,0,0,0,0,0,0,0,0,0
20200316,051227,技嘉群益97購01,0.31,0.31,0.24,0.24,+0.03,14.29,27000,4,7010,0,0,0,0,0,0,12000,15000,-3000,-3000
20200316,051228,聯發科群益95購03,,,,,0.00,0.00,0,0,0,0,0,0,0,0,0,0,0,0,0
20200316,051229,亞光群益95購01,,,,,0.00,0.00,0,0,0,0,0,0,0,0,0,0,0,0,0
20200316,05122P,鴻海永昌96售06,,,,,0.00,0.00,0,0,0,0,0,0,0,0,0,0,0,0,0
20200316,051230,聯詠群益95購01,0.05,0.05,0.05,0.05,0.00,0.00,30000,1,1500,0,0,0,0,0,0,0,30000,-30000,-30000
20200316,051231,健策群益97購01,0.33,0.33,0.23,0.23,-0.05,-17.86,45000,6,13870,0,0,0,0,0,0,0,40000,-40000,-40000
20200316,051232,貿聯群益95購02,,,,,0.00,0.00,0,0,0,0,0,0,0,0,0,0,0,0,0
20200316,051233,力成群益97購01,,,,,0.00,0.00,0,0,0,0,0,0,0,0,0,0,0,0,0
20200316,051234,南電群益95購02,0.08,0.08,0.05,0.05,-0.05,-50.0,352000,4,21620,0,0,0,0,0,0,102000,250000,-148000,-148000
20200316,051235,鴻海元大95購06,,,,,0.00,0.00,0,0,0,0,0,0,0,0,0,0,0,0,0
20200316,051236,鴻海元大96購05,,,,,0.00,0.00,0,0,0,0,0,0,0,0,0,0,0,0,0
20200316,051237,鴻海元大97購01,,,,,0.00,0.00,0,0,0,0,0,0,0,0,0,0,0,0,0
20200316,051238,中環元大96購01,,,,,0.00,0.00,0,0,0,0,0,0,0,0,0,0,0,0,0
20200316,051239,國巨元大96購02,1.97,1.97,1.20,1.20,-0.84,-41.18,38000,4,58580,0,0,0,0,0,0,18000,20000,-2000,-2000
20200316,05123P,鴻海永昌96售07,5.40,6.60,5.40,6.60,-0.55,-7.69,130000,4,771000,0,0,0,0,0,0,130000,0,130000,130000
20200316,051240,台積電元大95購12,0.16,0.16,0.06,0.14,-0.06,-30.0,13000,4,1780,0,0,0,0,0,0,1000,13000,-12000,-12000
20200316,051241,台積電元大95購13,0.03,0.03,0.03,0.03,-0.11,-78.57,1000,1,30,0,0,0,0,0,0,0,1000,-1000,-1000
20200316,051242,台積電元大96購06,0.23,0.24,0.23,0.23,-0.05,-17.86,21000,3,4930,0,0,0,0,0,0,21000,1000,20000,20000
20200316,051243,微星元大95購01,,,,,0.00,0.00,0,0,0,0,0,0,0,0,0,0,0,0,0
20200316,051244,正崴元大95購01,,,,,0.00,0.00,0,0,0,0,0,0,0,0,0,0,0,0,0
20200316,051245,南亞科元大95購01,0.51,0.51,0.38,0.38,-0.05,-11.63,30000,3,14000,0,0,0,0,0,0,20000,10000,10000,10000
20200316,051246,美律元大96購01,,,,,0.00,0.00,0,0,0,0,0,0,0,0,0,0,0,0,0
20200316,051247,可成元大95購04,,,,,0.00,0.00,0,0,0,0,0,0,0,0,0,0,0,0,0
20200316,051248,華固元大95購01,0.83,0.96,0.83,0.91,-0.10,-9.9,210000,17,186480,0,0,0,0,0,0,115000,95000,20000,20000
20200316,051249,潤泰全元大95購01,0.35,0.35,0.35,0.35,+0.02,6.06,10000,1,3500,0,0,0,0,0,0,10000,0,10000,10000
20200316,05124P,華新科富邦97售02,,,,,0.00,0.00,0,0,0,0,0,0,0,0,0,0,0,0,0
20200316,051250,大立光元大98購01,0.53,0.53,0.43,0.43,-0.08,-15.69,115000,7,54000,0,0,0,0,0,0,75000,40000,35000,35000
20200316,051251,信邦元大95購01,0.58,0.58,0.41,0.41,-0.10,-19.61,60000,4,31500,0,0,0,0,0,0,30000,30000,0,0
20200316,051252,健鼎元大95購01,,,,,0.00,0.00,0,0,0,0,0,0,0,0,0,0,0,0,0
20200316,051253,緯創元大95購02,,,,,0.00,0.00,0,0,0,0,0,0,0,0,0,0,0,0,0
20200316,051254,健策元大96購04,0.76,0.82,0.57,0.59,-0.08,-11.94,1264000,53,895840,0,0,0,0,0,0,865000,409000,456000,456000
20200316,051255,康控元大96購04,,,,,0.00,0.00,0,0,0,0,0,0,0,0,0,0,0,0,0
20200316,051256,中磊元大95購01,,,,,0.00,0.00,0,0,0,0,0,0,0,0,0,0,0,0,0
20200316,051257,光寶科國泰96購01,0.27,0.29,0.27,0.29,-0.05,-14.71,70000,2,19300,0,0,0,0,0,0,20000,50000,-30000,-30000
20200316,051258,鈺齊國泰97購01,,,,,0.00,0.00,0,0,0,0,0,0,0,0,0,0,0,0,0
20200316,051259,鴻海永昌96購03,0.11,0.13,0.09,0.11,-0.05,-31.25,370000,13,38250,0,0,0,0,0,0,62000,0,62000,62000
20200316,05125P,鴻海群益95售06,,,,,0.00,0.00,0,0,0,0,0,0,0,0,0,0,0,0,0
20200316,051260,鴻海永昌96購04,,,,,0.00,0.00,0,0,0,0,0,0,0,0,0,0,0,0,0
20200316,051261,鴻海永昌96購05,,,,,0.00,0.00,0,0,0,0,0,0,0,0,0,0,0,0,0
20200316,051262,A50富邦96購01,,,,,0.00,0.00,0,0,0,0,0,0,0,0,0,0,0,0,0
20200316,051263,深中小富邦96購01,,,,,0.00,0.00,0,0,0,0,0,0,0,0,0,0,0,0,0
20200316,051264,道瓊反富邦97購01,,,,,0.00,0.00,0,0,0,0,0,0,0,0,0,0,0,0,0
20200316,051265,鴻海富邦96購04,,,,,0.00,0.00,0,0,0,0,0,0,0,0,0,0,0,0,0
20200316,051266,國巨富邦99購01,0.78,0.95,0.60,0.61,-0.15,-19.74,245000,25,167180,0,0,0,0,0,0,81000,161000,-80000,-80000
20200316,051267,美律富邦96購01,,,,,0.00,0.00,0,0,0,0,0,0,0,0,0,0,0,0,0
20200316,051268,創意富邦97購01,0.16,0.16,0.16,0.16,0.00,0.00,10000,1,1600,0,0,0,0,0,0,0,10000,-10000,-10000
20200316,051269,康友富邦97購01,,,,,0.00,0.00,0,0,0,0,0,0,0,0,0,0,0,0,0
20200316,05126P,牧德群益95售01,,,,,0.00,0.00,0,0,0,0,0,0,0,0,0,0,0,0,0
20200316,051270,百和富邦95購01,,,,,0.00,0.00,0,0,0,0,0,0,0,0,0,0,0,0,0
20200316,051271,華新科群益95購04,,,,,0.00,0.00,0,0,0,0,0,0,0,0,0,0,0,0,0
20200316,051272,嘉晶群益95購01,0.55,0.56,0.40,0.40,-0.07,-14.89,364000,14,196700,0,0,0,0,0,0,348000,6000,342000,342000
20200316,051273,可成亞東95購01,,,,,0.00,0.00,0,0,0,0,0,0,0,0,0,0,0,0,0
20200316,051274,華新科亞東96購01,,,,,0.00,0.00,0,0,0,0,0,0,0,0,0,0,0,0,0
20200316,051275,群創亞東95購01,,,,,0.00,0.00,0,0,0,0,0,0,0,0,0,0,0,0,0
20200316,051276,SGBR2X中信97購01,,,,,0.00,0.00,0,0,0,0,0,0,0,0,0,0,0,0,0
20200316,051277,聯發科中信9A購01,0.07,0.08,0.06,0.07,-0.03,-30.0,640000,26,46550,0,0,0,0,0,0,0,60000,-60000,-60000
20200316,051278,臻鼎中信97購02,,,,,0.00,0.00,0,0,0,0,0,0,0,0,0,0,0,0,0
20200316,051279,喬山兆豐96購01,,,,,0.00,0.00,0,0,0,0,0,0,0,0,0,0,0,0,0
20200316,05127P,鴻海亞東96售01,2.58,2.96,2.58,2.96,0.00,0.00,171000,4,461480,0,0,0,0,0,0,171000,170000,1000,1000
20200316,051280,台積電兆豐95購04,0.03,0.03,0.03,0.03,0.00,0.00,10000,1,300,0,0,0,0,0,0,0,10000,-10000,-10000
20200316,051281,健策兆豐96購01,0.37,0.42,0.27,0.27,-0.12,-30.77,138000,25,46170,0,0,0,0,0,0,78000,60000,18000,18000
20200316,051282,GIS兆豐95購02,,,,,0.00,0.00,0,0,0,0,0,0,0,0,0,0,0,0,0
20200316,051283,亞德客統一95購01,0.68,0.68,0.41,0.41,0.00,0.00,9000,4,4600,0,0,0,0,0,0,0,9000,-9000,-9000
20200316,051284,上銀統一95購02,,,,,0.00,0.00,0,0,0,0,0,0,0,0,0,0,0,0,0
20200316,051285,鴻海統一95購07,,,,,0.00,0.00,0,0,0,0,0,0,0,0,0,0,0,0,0
20200316,051286,國巨統一97購01,1.13,1.13,1.13,1.13,0.00,0.00,10000,1,11300,0,0,0,0,0,0,10000,0,10000,10000
20200316,051287,台積電統一95購05,,,,,0.00,0.00,0,0,0,0,0,0,0,0,0,0,0,0,0
20200316,051288,可成統一95購03,,,,,0.00,0.00,0,0,0,0,0,0,0,0,0,0,0,0,0
20200316,051289,大立光統一96購01,,,,,0.00,0.00,0,0,0,0,0,0,0,0,0,0,0,0,0
20200316,05128P,聯發科中信97售03,2.29,2.36,2.29,2.36,+0.07,3.06,20000,2,46500,0,0,0,0,0,0,0,20000,-20000,-20000
20200316,051290,大立光統一96購02,0.31,0.31,0.30,0.31,+0.07,29.17,18000,6,5560,0,0,0,0,0,0,18000,18000,0,0
20200316,051291,聯詠統一95購01,,,,,0.00,0.00,0,0,0,0,0,0,0,0,0,0,0,0,0
20200316,051292,牧德統一97購01,,,,,0.00,0.00,0,0,0,0,0,0,0,0,0,0,0,0,0
20200316,051293,鴻海元富95購05,,,,,0.00,0.00,0,0,0,0,0,0,0,0,0,0,0,0,0
20200316,051294,鴻海元富95購06,,,,,0.00,0.00,0,0,0,0,0,0,0,0,0,0,0,0,0
20200316,051295,國巨元富95購04,,,,,0.00,0.00,0,0,0,0,0,0,0,0,0,0,0,0,0
20200316,051296,鴻海凱基97購01,,,,,0.00,0.00,0,0,0,0,0,0,0,0,0,0,0,0,0
20200316,051297,台積電凱基95購07,,,,,0.00,0.00,0,0,0,0,0,0,0,0,0,0,0,0,0
20200316,051298,智邦凱基95購03,,,,,0.00,0.00,0,0,0,0,0,0,0,0,0,0,0,0,0
20200316,051299,致茂凱基95購01,,,,,0.00,0.00,0,0,0,0,0,0,0,0,0,0,0,0,0
20200316,05129P,鴻海兆豐95售02,,,,,0.00,0.00,0,0,0,0,0,0,0,0,0,0,0,0,0
20200316,051300,台光電凱基96購02,0.10,0.10,0.10,0.10,0.00,0.00,50000,5,5000,0,0,0,0,0,0,0,50000,-50000,-50000
20200316,051301,聯發科凱基95購08,,,,,0.00,0.00,0,0,0,0,0,0,0,0,0,0,0,0,0
20200316,051302,可成凱基95購06,,,,,0.00,0.00,0,0,0,0,0,0,0,0,0,0,0,0,0
20200316,051303,奇鋐凱基95購01,,,,,0.00,0.00,0,0,0,0,0,0,0,0,0,0,0,0,0
20200316,051304,緯創凱基96購01,0.01,0.01,0.01,0.01,0.00,0.00,300000,3,3000,0,0,0,0,0,0,300000,0,300000,300000
20200316,051305,訊連凱基96購01,0.29,0.31,0.29,0.29,+0.01,3.57,152000,28,45830,0,0,0,0,0,0,120000,26000,94000,94000
20200316,051306,嘉聯益凱基96購01,,,,,0.00,0.00,0,0,0,0,0,0,0,0,0,0,0,0,0
20200316,051307,康舒凱基95購01,0.11,0.11,0.11,0.11,0.00,0.00,25000,1,2750,0,0,0,0,0,0,25000,0,25000,25000
20200316,051308,GIS凱基95購04,,,,,0.00,0.00,0,0,0,0,0,0,0,0,0,0,0,0,0
20200316,051309,卜蜂麥證95購01,,,,,0.00,0.00,0,0,0,0,0,0,0,0,0,0,0,0,0
20200316,05130P,聯發科統一95售03,,,,,0.00,0.00,0,0,0,0,0,0,0,0,0,0,0,0,0
20200316,051310,台達電麥證95購01,,,,,0.00,0.00,0,0,0,0,0,0,0,0,0,0,0,0,0
20200316,051311,瑞昱麥證95購01,,,,,0.00,0.00,0,0,0,0,0,0,0,0,0,0,0,0,0
20200316,051312,國泰金麥證95購01,,,,,0.00,0.00,0,0,0,0,0,0,0,0,0,0,0,0,0
20200316,051313,緯創麥證95購02,,,,,0.00,0.00,0,0,0,0,0,0,0,0,0,0,0,0,0
20200316,051314,嘉聯益麥證96購01,,,,,0.00,0.00,0,0,0,0,0,0,0,0,0,0,0,0,0
20200316,051315,同欣電麥證95購01,0.22,0.22,0.16,0.16,+0.02,14.29,18000,2,3360,0,18000,-18000,0,0,0,0,18000,-18000,-18000
20200316,051316,T50反1國票95購02,,,,,0.00,0.00,0,0,0,0,0,0,0,0,0,0,0,0,0
20200316,051317,亞德客國票96購01,0.45,0.45,0.29,0.29,+0.06,26.09,160000,2,48000,0,0,0,0,0,0,160000,0,160000,160000
20200316,051318,上銀國票96購01,0.19,0.19,0.19,0.19,-0.16,-45.71,10000,1,1900,0,0,0,0,0,0,0,10000,-10000,-10000
20200316,051319,光磊國票96購02,,,,,0.00,0.00,0,0,0,0,0,0,0,0,0,0,0,0,0
20200316,05131P,聯詠統一97售01,,,,,0.00,0.00,0,0,0,0,0,0,0,0,0,0,0,0,0
20200316,051320,燿華國票96購01,,,,,0.00,0.00,0,0,0,0,0,0,0,0,0,0,0,0,0
20200316,051321,建準國票96購01,,,,,0.00,0.00,0,0,0,0,0,0,0,0,0,0,0,0,0
20200316,051322,國泰金國票96購01,,,,,0.00,0.00,0,0,0,0,0,0,0,0,0,0,0,0,0
20200316,051323,康控國票96購01,,,,,0.00,0.00,0,0,0,0,0,0,0,0,0,0,0,0,0
20200316,051324,康友國票96購01,0.45,0.48,0.45,0.48,-0.04,-7.69,77000,2,35760,0,0,0,0,0,0,77000,37000,40000,40000
20200316,051325,台光電台新96購01,,,,,0.00,0.00,0,0,0,0,0,0,0,0,0,0,0,0,0
20200316,051326,聯發科台新95購01,,,,,0.00,0.00,0,0,0,0,0,0,0,0,0,0,0,0,0
20200316,051327,元油2X永豐95購02,,,,,0.00,0.00,0,0,0,0,0,0,0,0,0,0,0,0,0
20200316,051328,力山永豐95購01,,,,,0.00,0.00,0,0,0,0,0,0,0,0,0,0,0,0,0
20200316,051329,智邦永豐95購01,,,,,0.00,0.00,0,0,0,0,0,0,0,0,0,0,0,0,0
20200316,05132P,鴻海元富95售07,,,,,0.00,0.00,0,0,0,0,0,0,0,0,0,0,0,0,0
20200316,051330,宏碁永豐95購01,,,,,0.00,0.00,0,0,0,0,0,0,0,0,0,0,0,0,0
20200316,051331,全新永豐96購01,,,,,0.00,0.00,0,0,0,0,0,0,0,0,0,0,0,0,0
20200316,051332,奇力新永豐95購01,,,,,0.00,0.00,0,0,0,0,0,0,0,0,0,0,0,0,0
20200316,051333,義隆永豐95購02,,,,,0.00,0.00,0,0,0,0,0,0,0,0,0,0,0,0,0
20200316,051334,宏達電永豐95購01,,,,,0.00,0.00,0,0,0,0,0,0,0,0,0,0,0,0,0
20200316,051335,華固永豐95購01,,,,,0.00,0.00,0,0,0,0,0,0,0,0,0,0,0,0,0
20200316,051336,智原永豐95購01,,,,,0.00,0.00,0,0,0,0,0,0,0,0,0,0,0,0,0
20200316,051337,欣興永豐95購02,,,,,0.00,0.00,0,0,0,0,0,0,0,0,0,0,0,0,0
20200316,051338,揚明光永豐95購02,0.08,0.08,0.08,0.08,-0.04,-33.33,40000,1,3200,0,0,0,0,0,0,40000,0,40000,40000
20200316,051339,智易永豐95購02,,,,,0.00,0.00,0,0,0,0,0,0,0,0,0,0,0,0,0
20200316,05133P,臺股指日盛95售01,,,,,0.00,0.00,0,0,0,0,0,0,0,0,0,0,0,0,0
20200316,051340,健策永豐95購03,,,,,0.00,0.00,0,0,0,0,0,0,0,0,0,0,0,0,0
20200316,051341,訊連永豐95購02,,,,,0.00,0.00,0,0,0,0,0,0,0,0,0,0,0,0,0
20200316,051342,光寶科元大95購01,,,,,0.00,0.00,0,0,0,0,0,0,0,0,0,0,0,0,0
20200316,051343,鴻海元大95購07,,,,,0.00,0.00,0,0,0,0,0,0,0,0,0,0,0,0,0
20200316,051344,鴻海元大95購08,,,,,0.00,0.00,0,0,0,0,0,0,0,0,0,0,0,0,0
20200316,051345,鴻海元大95購09,,,,,0.00,0.00,0,0,0,0,0,0,0,0,0,0,0,0,0
20200316,051346,仁寶元大95購01,,,,,0.00,0.00,0,0,0,0,0,0,0,0,0,0,0,0,0
20200316,051347,國巨元大95購06,0.88,0.94,0.50,0.50,-0.46,-47.92,345000,33,271800,0,0,0,0,0,0,30000,315000,-285000,-285000
20200316,051348,國巨元大95購07,1.14,1.14,0.68,0.68,-0.32,-32.0,70000,7,66500,0,0,0,0,0,0,60000,10000,50000,50000
20200316,051349,國巨元大95購08,1.37,1.55,1.27,1.27,+0.18,16.51,120000,12,164200,0,0,0,0,0,0,0,120000,-120000,-120000
20200316,05134P,鴻海凱基96售06,4.91,4.91,4.91,4.91,+1.01,25.9,6000,1,29460,0,0,0,0,0,0,6000,6000,0,0
20200316,051350,台積電元大95購14,0.15,0.15,0.15,0.15,-0.02,-11.76,1000,1,150,0,0,0,0,0,0,1000,1000,0,0
20200316,051351,台積電元大95購15,,,,,0.00,0.00,0,0,0,0,0,0,0,0,0,0,0,0,0
20200316,051352,南亞科元大95購02,0.29,0.29,0.29,0.29,+0.11,61.11,10000,1,2900,0,0,0,0,0,0,10000,0,10000,10000
20200316,051353,聯發科元大95購08,,,,,0.00,0.00,0,0,0,0,0,0,0,0,0,0,0,0,0
20200316,051354,聯發科元大95購09,,,,,0.00,0.00,0,0,0,0,0,0,0,0,0,0,0,0,0
20200316,051355,聯發科元大96購01,,,,,0.00,0.00,0,0,0,0,0,0,0,0,0,0,0,0,0
20200316,051356,全新元大96購04,,,,,0.00,0.00,0,0,0,0,0,0,0,0,0,0,0,0,0
20200316,051357,可成元大95購05,,,,,0.00,0.00,0,0,0,0,0,0,0,0,0,0,0,0,0
20200316,051358,台新金元大95購01,0.13,0.13,0.09,0.09,0.00,0.00,400000,41,47360,0,0,0,0,0,0,0,400000,-400000,-400000
20200316,051359,中信金元大95購01,0.09,0.09,0.07,0.07,-0.02,-22.22,243000,17,19310,0,0,0,0,0,0,128000,115000,13000,13000
20200316,05135P,鴻海凱基96售07,4.31,4.60,4.30,4.47,+0.93,26.27,59000,6,261500,0,0,0,0,0,0,54000,59000,-5000,-5000
20200316,051360,緯創元大95購03,,,,,0.00,0.00,0,0,0,0,0,0,0,0,0,0,0,0,0
20200316,051361,泰鼎元大95購01,3.34,3.34,3.34,3.34,+0.79,30.98,30000,1,100200,0,0,0,0,0,0,30000,0,30000,30000
20200316,051362,台郡元大95購04,,,,,0.00,0.00,0,0,0,0,0,0,0,0,0,0,0,0,0
20200316,051363,矽創元大95購03,0.05,0.05,0.05,0.05,-0.06,-54.55,299000,1,14950,0,0,0,0,0,0,299000,0,299000,299000
20200316,051364,鴻海國泰97購03,,,,,0.00,0.00,0,0,0,0,0,0,0,0,0,0,0,0,0
20200316,051365,瀚宇博國泰97購01,,,,,0.00,0.00,0,0,0,0,0,0,0,0,0,0,0,0,0
20200316,051366,康友國泰97購01,0.81,0.81,0.49,0.49,-0.34,-40.96,146000,5,103440,0,0,0,0,0,0,126000,20000,106000,106000
20200316,051367,可成富邦97購01,0.03,0.03,0.03,0.03,0.00,0.00,50000,1,1500,0,0,0,0,0,0,0,0,0,0
20200316,051368,國泰金富邦97購01,,,,,0.00,0.00,0,0,0,0,0,0,0,0,0,0,0,0,0
20200316,051369,新光金富邦9A購01,,,,,0.00,0.00,0,0,0,0,0,0,0,0,0,0,0,0,0
20200316,05136P,台積電凱基95售08,2.61,3.46,2.61,3.46,+0.26,8.12,203000,12,633690,0,0,0,0,0,0,36000,177000,-141000,-141000
20200316,051370,聯詠富邦97購01,0.10,0.10,0.10,0.10,0.00,0.00,2000,1,200,0,0,0,0,0,0,0,0,0,0
20200316,051371,超眾富邦95購01,,,,,0.00,0.00,0,0,0,0,0,0,0,0,0,0,0,0,0
20200316,051372,樺漢富邦96購01,,,,,0.00,0.00,0,0,0,0,0,0,0,0,0,0,0,0,0
20200316,051373,華新亞東95購01,,,,,0.00,0.00,0,0,0,0,0,0,0,0,0,0,0,0,0
20200316,051374,國泰金亞東95購01,,,,,0.00,0.00,0,0,0,0,0,0,0,0,0,0,0,0,0
20200316,051375,道瓊反群益9A購01,,,,,0.00,0.00,0,0,0,0,0,0,0,0,0,0,0,0,0
20200316,051376,力山群益95購01,,,,,0.00,0.00,0,0,0,0,0,0,0,0,0,0,0,0,0
20200316,051377,鴻海群益95購07,,,,,0.00,0.00,0,0,0,0,0,0,0,0,0,0,0,0,0
20200316,051378,奇力新群益95購01,0.41,0.41,0.22,0.23,0.00,0.00,192000,4,43310,0,0,0,0,0,0,180000,12000,168000,168000
20200316,051379,新光金群益95購01,,,,,0.00,0.00,0,0,0,0,0,0,0,0,0,0,0,0,0
20200316,05137P,華新科凱基96售03,1.04,1.54,1.04,1.54,+0.81,110.96,68000,9,81220,0,0,0,0,0,0,15000,53000,-38000,-38000
20200316,051380,禾伸堂群益95購01,0.46,0.46,0.30,0.30,+0.02,7.14,42000,3,12850,0,0,0,0,0,0,41000,1000,40000,40000
20200316,051381,玉晶光群益98購01,1.37,1.45,1.10,1.10,-0.18,-14.06,326000,25,397650,0,0,0,0,0,0,116000,211000,-95000,-95000
20200316,051382,玉晶光群益98購02,1.75,1.75,1.43,1.43,-0.17,-10.63,162000,13,253900,0,0,0,0,0,0,62000,102000,-40000,-40000
20200316,051383,京鼎群益96購02,,,,,0.00,0.00,0,0,0,0,0,0,0,0,0,0,0,0,0
20200316,051384,康友群益95購01,,,,,0.00,0.00,0,0,0,0,0,0,0,0,0,0,0,0,0
20200316,051385,矽創群益95購01,,,,,0.00,0.00,0,0,0,0,0,0,0,0,0,0,0,0,0
20200316,051386,富邦金麥證96購01,,,,,0.00,0.00,0,0,0,0,0,0,0,0,0,0,0,0,0
20200316,051387,新光金麥證96購01,,,,,0.00,0.00,0,0,0,0,0,0,0,0,0,0,0,0,0
20200316,051388,大立光麥證95購03,0.31,0.31,0.31,0.31,-0.01,-3.12,30000,1,9300,30000,0,30000,0,0,0,30000,0,30000,30000
20200316,051389,台達電兆豐95購01,,,,,0.00,0.00,0,0,0,0,0,0,0,0,0,0,0,0,0
20200316,05138P,嘉聯益凱基96售02,,,,,0.00,0.00,0,0,0,0,0,0,0,0,0,0,0,0,0
20200316,051390,京元電兆豐95購01,0.20,0.26,0.16,0.16,+0.04,33.33,373000,11,87840,0,0,0,0,0,0,50000,323000,-273000,-273000
20200316,051391,聯發科兆豐95購02,,,,,0.00,0.00,0,0,0,0,0,0,0,0,0,0,0,0,0
20200316,051392,玉山金兆豐95購01,0.10,0.10,0.10,0.10,-0.04,-28.57,100000,1,10000,0,0,0,0,0,0,0,0,0,0
20200316,051393,新光金兆豐96購01,,,,,0.00,0.00,0,0,0,0,0,0,0,0,0,0,0,0,0
20200316,051394,奇鋐兆豐95購01,,,,,0.00,0.00,0,0,0,0,0,0,0,0,0,0,0,0,0
20200316,051395,聯詠兆豐95購01,,,,,0.00,0.00,0,0,0,0,0,0,0,0,0,0,0,0,0
20200316,051396,健鼎兆豐95購01,0.06,0.06,0.06,0.06,+0.01,20.0,30000,3,1800,0,0,0,0,0,0,0,30000,-30000,-30000
20200316,051397,聯茂兆豐95購03,0.37,0.38,0.36,0.36,0.00,0.00,126000,3,46080,0,0,0,0,0,0,0,126000,-126000,-126000
20200316,051398,智原台新95購01,,,,,0.00,0.00,0,0,0,0,0,0,0,0,0,0,0,0,0
20200316,051399,玉晶光台新96購01,0.56,0.57,0.35,0.35,-0.27,-43.55,361000,15,148540,0,0,0,0,0,0,16000,345000,-329000,-329000
20200316,05139P,臺股指凱基95售06,,,,,0.00,0.00,0,0,0,0,0,0,0,0,0,0,0,0,0
20200316,051400,國巨永豐95購01,0.28,0.29,0.14,0.14,-0.11,-44.0,151000,14,34420,0,0,0,0,0,0,30000,121000,-91000,-91000
20200316,051401,華新科永豐95購01,0.06,0.06,0.05,0.05,-0.03,-37.5,18000,3,1030,0,0,0,0,0,0,8000,10000,-2000,-2000
20200316,051402,玉晶光永豐95購04,,,,,0.00,0.00,0,0,0,0,0,0,0,0,0,0,0,0,0
20200316,051403,玉晶光永豐95購05,0.93,0.93,0.75,0.75,-0.15,-16.67,84000,5,71680,0,0,0,0,0,0,84000,6000,78000,78000
20200316,051404,牧德永豐96購01,,,,,0.00,0.00,0,0,0,0,0,0,0,0,0,0,0,0,0
20200316,051405,世芯永豐95購01,0.17,0.17,0.10,0.10,-0.20,-66.67,175000,11,23380,0,0,0,0,0,0,150000,0,150000,150000
20200316,051406,泰鼎永豐96購01,0.73,0.80,0.67,0.67,-0.12,-15.19,11000,7,8030,0,0,0,0,0,0,11000,0,11000,11000
20200316,051407,南茂永豐95購02,,,,,0.00,0.00,0,0,0,0,0,0,0,0,0,0,0,0,0
20200316,051408,台積電國票95購03,,,,,0.00,0.00,0,0,0,0,0,0,0,0,0,0,0,0,0
20200316,051409,美律國票96購01,0.32,0.34,0.22,0.22,+0.03,15.79,410000,21,108900,0,0,0,0,0,0,240000,170000,70000,70000
20200316,05140P,台表科國票96售01,2.51,3.04,2.51,3.04,+0.61,25.1,25000,4,68150,0,0,0,0,0,0,15000,10000,5000,5000
20200316,051410,京元電國票96購01,0.05,0.05,0.05,0.05,0.00,0.00,1000,1,50,0,0,0,0,0,0,0,0,0,0
20200316,051411,聯發科國票95購05,,,,,0.00,0.00,0,0,0,0,0,0,0,0,0,0,0,0,0
20200316,051412,奇力新國票96購01,1.36,1.39,0.70,0.70,-0.20,-22.22,73000,11,68950,0,0,0,0,0,0,37000,36000,1000,1000
20200316,051413,富邦金國票96購02,,,,,0.00,0.00,0,0,0,0,0,0,0,0,0,0,0,0,0
20200316,051414,新光金國票95購04,,,,,0.00,0.00,0,0,0,0,0,0,0,0,0,0,0,0,0
20200316,051415,晶技國票96購01,1.52,1.76,1.44,1.53,+0.30,24.39,273000,23,420860,0,0,0,0,0,0,267000,0,267000,267000
20200316,051416,創意國票96購02,0.16,0.16,0.15,0.15,0.00,0.00,42000,5,6620,0,0,0,0,0,0,0,42000,-42000,-42000
20200316,051417,揚明光國票96購01,,,,,0.00,0.00,0,0,0,0,0,0,0,0,0,0,0,0,0
20200316,051418,智易國票97購01,,,,,0.00,0.00,0,0,0,0,0,0,0,0,0,0,0,0,0
20200316,051419,麗豐國票96購01,0.20,0.20,0.20,0.20,0.00,0.00,6000,1,1200,0,0,0,0,0,0,6000,0,6000,6000
20200316,05141P,華通台新96售01,4.08,4.08,4.08,4.08,-0.17,-4.0,10000,1,40800,0,0,0,0,0,0,0,10000,-10000,-10000
20200316,051420,康控國票95購05,,,,,0.00,0.00,0,0,0,0,0,0,0,0,0,0,0,0,0
20200316,051421,彩晶國票95購01,0.18,0.19,0.14,0.14,0.00,0.00,60000,6,10600,0,0,0,0,0,0,0,60000,-60000,-60000
20200316,051422,超眾國票96購01,,,,,0.00,0.00,0,0,0,0,0,0,0,0,0,0,0,0,0
20200316,051423,GIS國票97購01,,,,,0.00,0.00,0,0,0,0,0,0,0,0,0,0,0,0,0
20200316,051424,緯穎國票97購01,9.60,9.60,7.40,7.40,+1.60,27.59,12000,5,110450,0,0,0,0,0,0,9000,3000,6000,6000
20200316,051425,昇陽半國票97購01,,,,,0.00,0.00,0,0,0,0,0,0,0,0,0,0,0,0,0
20200316,051426,道瓊反統一95購02,,,,,0.00,0.00,0,0,0,0,0,0,0,0,0,0,0,0,0
20200316,051427,聯發科統一95購04,,,,,0.00,0.00,0,0,0,0,0,0,0,0,0,0,0,0,0
20200316,051428,玉晶光統一96購01,0.81,0.81,0.81,0.81,-0.16,-16.49,30000,1,24300,0,0,0,0,0,0,30000,0,30000,30000
20200316,051429,智邦元富95購01,0.81,0.81,0.65,0.65,-0.08,-10.96,604000,25,435690,0,0,0,0,0,0,584000,10000,574000,574000
20200316,05142P,華新科台新95售01,0.71,1.12,0.71,1.12,+0.07,6.67,349000,14,283060,0,0,0,0,0,0,95000,289000,-194000,-194000
20200316,051430,瑞昱元富95購02,,,,,0.00,0.00,0,0,0,0,0,0,0,0,0,0,0,0,0
20200316,051431,群創元富99購02,0.22,0.22,0.20,0.20,+0.01,5.26,120000,12,24900,0,0,0,0,0,0,0,120000,-120000,-120000
20200316,051432,群創元富99購03,0.37,0.41,0.30,0.41,+0.03,7.89,226000,17,80810,0,0,0,0,0,0,10000,80000,-70000,-70000
20200316,051433,中磊元富95購01,,,,,0.00,0.00,0,0,0,0,0,0,0,0,0,0,0,0,0
20200316,051434,中磊元富95購02,0.61,0.61,0.59,0.59,+0.02,3.51,20000,2,12000,0,0,0,0,0,0,20000,0,20000,20000
20200316,051435,聯茂元富95購01,0.57,0.58,0.57,0.57,+0.06,11.76,30000,3,17200,0,0,0,0,0,0,30000,0,30000,30000
20200316,051436,訊芯元富95購01,,,,,0.00,0.00,0,0,0,0,0,0,0,0,0,0,0,0,0
20200316,051437,百和元富95購02,,,,,0.00,0.00,0,0,0,0,0,0,0,0,0,0,0,0,0
20200316,051438,喬山元大95購03,,,,,0.00,0.00,0,0,0,0,0,0,0,0,0,0,0,0,0
20200316,051439,川湖元大95購01,0.15,0.15,0.15,0.15,+0.03,25.0,11000,2,1650,0,0,0,0,0,0,1000,10000,-9000,-9000
20200316,05143P,臻鼎台新95售01,,,,,0.00,0.00,0,0,0,0,0,0,0,0,0,0,0,0,0
20200316,051440,鴻海元大95購12,,,,,0.00,0.00,0,0,0,0,0,0,0,0,0,0,0,0,0
20200316,051441,鴻海元大95購13,,,,,0.00,0.00,0,0,0,0,0,0,0,0,0,0,0,0,0
20200316,051442,正崴元大95購02,,,,,0.00,0.00,0,0,0,0,0,0,0,0,0,0,0,0,0
20200316,051443,聯發科元大95購10,,,,,0.00,0.00,0,0,0,0,0,0,0,0,0,0,0,0,0
20200316,051444,聯發科元大95購11,,,,,0.00,0.00,0,0,0,0,0,0,0,0,0,0,0,0,0
20200316,051445,可成元大95購06,,,,,0.00,0.00,0,0,0,0,0,0,0,0,0,0,0,0,0
20200316,051446,中壽元大96購01,,,,,0.00,0.00,0,0,0,0,0,0,0,0,0,0,0,0,0
20200316,051447,新光金元大97購01,,,,,0.00,0.00,0,0,0,0,0,0,0,0,0,0,0,0,0
20200316,051448,聯詠元大95購02,,,,,0.00,0.00,0,0,0,0,0,0,0,0,0,0,0,0,0
20200316,051449,玉晶光元大96購01,0.80,0.90,0.60,0.61,-0.24,-28.24,317000,32,247710,0,0,0,0,0,0,110000,257000,-147000,-147000
20200316,05144P,美律永豐95售02,,,,,0.00,0.00,0,0,0,0,0,0,0,0,0,0,0,0,0
20200316,051450,世芯元大95購02,1.03,1.03,0.61,0.61,-0.47,-43.52,32000,6,29110,0,0,0,0,0,0,17000,15000,2000,2000
20200316,051451,世芯元大95購03,0.92,0.95,0.56,0.60,-0.37,-38.14,168000,17,130210,0,0,0,0,0,0,56000,117000,-61000,-61000
20200316,051452,貿聯元大95購04,0.29,0.29,0.12,0.12,-0.11,-47.83,170000,12,30050,0,0,0,0,0,0,95000,75000,20000,20000
20200316,051453,智伸科元大95購02,,,,,0.00,0.00,0,0,0,0,0,0,0,0,0,0,0,0,0
20200316,051454,致伸元大95購01,,,,,0.00,0.00,0,0,0,0,0,0,0,0,0,0,0,0,0
20200316,051455,樺漢元大96購01,0.09,0.09,0.06,0.06,0.00,0.00,410000,41,31400,0,0,0,0,0,0,0,410000,-410000,-410000
20200316,051456,鈺齊元大95購01,,,,,0.00,0.00,0,0,0,0,0,0,0,0,0,0,0,0,0
20200316,051457,寶成元大95購01,,,,,0.00,0.00,0,0,0,0,0,0,0,0,0,0,0,0,0
20200316,051458,臺股指元大95購18,0.28,0.28,0.28,0.28,0.00,0.00,5000,1,1400,0,0,0,0,0,0,5000,0,5000,5000
20200316,051459,臺股指元大95購19,0.15,0.15,0.15,0.15,0.00,0.00,1000,1,150,0,0,0,0,0,0,1000,0,1000,1000
20200316,05145P,道瓊反元大98售01,0.13,0.17,0.08,0.17,-0.03,-15.0,170000,12,18320,0,0,0,0,0,0,50000,0,50000,50000
20200316,051460,S&P反1國泰97購01,,,,,0.00,0.00,0,0,0,0,0,0,0,0,0,0,0,0,0
20200316,051461,聯詠國泰96購01,0.44,0.47,0.44,0.47,+0.03,6.82,320000,2,148300,0,0,0,0,0,0,70000,250000,-180000,-180000
20200316,051462,世芯國泰97購01,1.16,1.16,1.08,1.08,-0.36,-25.0,10000,2,11200,0,0,0,0,0,0,0,0,0,0
20200316,051463,世芯國泰97購02,,,,,0.00,0.00,0,0,0,0,0,0,0,0,0,0,0,0,0
20200316,051464,彩晶國泰96購01,0.33,0.33,0.27,0.27,-0.05,-15.62,450000,3,135000,0,0,0,0,0,0,0,450000,-450000,-450000
20200316,051465,鴻海富邦97購02,,,,,0.00,0.00,0,0,0,0,0,0,0,0,0,0,0,0,0
20200316,051466,玉晶光富邦97購01,0.30,0.30,0.23,0.23,-0.10,-30.3,261000,4,66100,0,0,0,0,0,0,201000,60000,141000,141000
20200316,051467,GIS富邦96購01,,,,,0.00,0.00,0,0,0,0,0,0,0,0,0,0,0,0,0
20200316,051468,智邦日盛95購01,,,,,0.00,0.00,0,0,0,0,0,0,0,0,0,0,0,0,0
20200316,051469,友達日盛9B購01,0.74,0.74,0.68,0.68,0.00,0.00,30000,3,21600,0,0,0,0,0,0,0,30000,-30000,-30000
20200316,05146P,鴻海元大95售10,,,,,0.00,0.00,0,0,0,0,0,0,0,0,0,0,0,0,0
20200316,051470,玉晶光日盛95購01,,,,,0.00,0.00,0,0,0,0,0,0,0,0,0,0,0,0,0
20200316,051471,國巨凱基97購01,0.70,0.70,0.55,0.55,-0.25,-31.25,23000,3,14700,0,0,0,0,0,0,8000,15000,-7000,-7000
20200316,051472,台積電凱基95購09,0.27,0.28,0.27,0.28,0.00,0.00,75000,8,20700,0,0,0,0,0,0,0,75000,-75000,-75000
20200316,051473,台積電凱基95購10,,,,,0.00,0.00,0,0,0,0,0,0,0,0,0,0,0,0,0
20200316,051474,智邦凱基95購04,,,,,0.00,0.00,0,0,0,0,0,0,0,0,0,0,0,0,0
20200316,051475,宏碁凱基95購02,,,,,0.00,0.00,0,0,0,0,0,0,0,0,0,0,0,0,0
20200316,051476,聯發科凱基95購09,,,,,0.00,0.00,0,0,0,0,0,0,0,0,0,0,0,0,0
20200316,051477,可成凱基95購07,,,,,0.00,0.00,0,0,0,0,0,0,0,0,0,0,0,0,0
20200316,051478,宏達電凱基95購03,,,,,0.00,0.00,0,0,0,0,0,0,0,0,0,0,0,0,0
20200316,051479,兆豐金凱基95購01,0.22,0.22,0.22,0.22,+0.06,37.5,5000,1,1100,0,0,0,0,0,0,0,5000,-5000,-5000
20200316,05147P,鴻海元大95售11,,,,,0.00,0.00,0,0,0,0,0,0,0,0,0,0,0,0,0
20200316,051480,大立光凱基97購01,,,,,0.00,0.00,0,0,0,0,0,0,0,0,0,0,0,0,0
20200316,051481,聯詠凱基95購02,,,,,0.00,0.00,0,0,0,0,0,0,0,0,0,0,0,0,0
20200316,051482,玉晶光凱基96購01,0.50,0.50,0.47,0.47,0.00,0.00,152000,2,71500,0,0,0,0,0,0,152000,0,152000,152000
20200316,051483,玉晶光凱基96購02,0.52,0.52,0.39,0.39,-0.15,-27.78,133000,4,60160,0,0,0,0,0,0,133000,0,133000,133000
20200316,051484,玉晶光凱基97購01,0.55,0.56,0.35,0.35,-0.20,-36.36,353000,9,163180,0,0,0,0,0,0,231000,122000,109000,109000
20200316,051485,玉晶光凱基97購02,0.85,0.93,0.59,0.59,-0.18,-23.38,165000,13,117580,0,0,0,0,0,0,65000,104000,-39000,-39000
20200316,051486,玉晶光凱基97購03,0.50,0.50,0.48,0.48,0.00,0.00,9000,2,4420,0,0,0,0,0,0,9000,0,9000,9000
20200316,051487,健策凱基96購03,0.10,0.10,0.10,0.10,0.00,0.00,109000,11,10900,0,0,0,0,0,0,0,109000,-109000,-109000
20200316,051488,健策凱基96購04,0.06,0.08,0.06,0.08,+0.02,33.33,295000,7,19000,0,0,0,0,0,0,275000,0,275000,275000
20200316,051489,世芯凱基95購01,0.74,0.78,0.39,0.39,-0.36,-48.0,258000,41,167310,0,0,0,0,0,0,163000,109000,54000,54000
20200316,05148P,臻鼎元大95售01,,,,,0.00,0.00,0,0,0,0,0,0,0,0,0,0,0,0,0
20200316,051490,世芯凱基96購01,0.78,0.80,0.37,0.37,-0.53,-58.89,860000,72,512990,0,0,0,0,0,0,355000,448000,-93000,-93000
20200316,051491,貿聯凱基95購01,,,,,0.00,0.00,0,0,0,0,0,0,0,0,0,0,0,0,0
20200316,051492,臻鼎凱基95購01,,,,,0.00,0.00,0,0,0,0,0,0,0,0,0,0,0,0,0
20200316,051493,台郡凱基95購02,,,,,0.00,0.00,0,0,0,0,0,0,0,0,0,0,0,0,0
20200316,051494,中環兆豐95購01,,,,,0.00,0.00,0,0,0,0,0,0,0,0,0,0,0,0,0
20200316,051495,玉晶光第一95購02,,,,,0.00,0.00,0,0,0,0,0,0,0,0,0,0,0,0,0
20200316,051496,義隆亞東95購01,,,,,0.00,0.00,0,0,0,0,0,0,0,0,0,0,0,0,0
20200316,051497,中磊亞東96購01,,,,,0.00,0.00,0,0,0,0,0,0,0,0,0,0,0,0,0
20200316,051498,智易群益96購01,,,,,0.00,0.00,0,0,0,0,0,0,0,0,0,0,0,0,0
20200316,051499,康控群益95購02,,,,,0.00,0.00,0,0,0,0,0,0,0,0,0,0,0,0,0
20200316,05149P,緯穎國泰96售01,0.28,0.35,0.28,0.35,+0.05,16.67,80000,5,24700,0,0,0,0,0,0,0,80000,-80000,-80000
20200316,051500,聯茂群益95購01,0.31,0.40,0.24,0.24,0.00,0.00,193000,11,59340,0,0,0,0,0,0,171000,21000,150000,150000
20200316,051501,康友群益95購02,0.16,0.16,0.10,0.10,-0.14,-58.33,275000,4,37700,0,0,0,0,0,0,0,275000,-275000,-275000
20200316,051502,南茂群益95購01,,,,,0.00,0.00,0,0,0,0,0,0,0,0,0,0,0,0,0
20200316,051503,玉晶光統一97購01,,,,,0.00,0.00,0,0,0,0,0,0,0,0,0,0,0,0,0
20200316,051504,TPK統一95購01,,,,,0.00,0.00,0,0,0,0,0,0,0,0,0,0,0,0,0
20200316,051505,台積電元富95購05,0.50,0.50,0.11,0.13,-0.14,-51.85,234000,26,52620,0,0,0,0,0,0,65000,123000,-58000,-58000
20200316,051506,台積電元富95購06,0.03,0.03,0.03,0.03,-0.09,-75.0,20000,1,600,0,0,0,0,0,0,0,0,0,0
20200316,051507,彩晶元富95購01,,,,,0.00,0.00,0,0,0,0,0,0,0,0,0,0,0,0,0
20200316,051508,元黃金中信97購01,1.20,1.20,1.20,1.20,-0.06,-4.76,1000,1,1200,0,0,0,0,0,0,0,1000,-1000,-1000
20200316,051509,鴻海中信97購01,0.02,0.02,0.02,0.02,0.00,0.00,20000,2,400,0,0,0,0,0,0,0,20000,-20000,-20000
20200316,05150P,玉晶光第一95售01,,,,,0.00,0.00,0,0,0,0,0,0,0,0,0,0,0,0,0
20200316,051510,新光金中信97購01,0.03,0.03,0.03,0.03,0.00,0.00,20000,2,600,0,0,0,0,0,0,0,20000,-20000,-20000
20200316,051511,鈺齊中信97購01,,,,,0.00,0.00,0,0,0,0,0,0,0,0,0,0,0,0,0
20200316,051512,超眾麥證95購01,,,,,0.00,0.00,0,0,0,0,0,0,0,0,0,0,0,0,0
20200316,051513,台積電凱基95購13,,,,,0.00,0.00,0,0,0,0,0,0,0,0,0,0,0,0,0
20200316,051514,智邦凱基95購05,0.10,0.10,0.10,0.10,0.00,0.00,400000,40,40000,0,0,0,0,0,0,0,400000,-400000,-400000
20200316,051515,聯發科凱基95購10,,,,,0.00,0.00,0,0,0,0,0,0,0,0,0,0,0,0,0
20200316,051516,全新凱基96購02,,,,,0.00,0.00,0,0,0,0,0,0,0,0,0,0,0,0,0
20200316,051517,可成凱基95購08,,,,,0.00,0.00,0,0,0,0,0,0,0,0,0,0,0,0,0
20200316,051518,富邦金凱基95購01,,,,,0.00,0.00,0,0,0,0,0,0,0,0,0,0,0,0,0
20200316,051519,國泰金凱基95購02,,,,,0.00,0.00,0,0,0,0,0,0,0,0,0,0,0,0,0
20200316,05151P,台光電群益95售02,,,,,0.00,0.00,0,0,0,0,0,0,0,0,0,0,0,0,0
20200316,051520,新光金凱基97購01,,,,,0.00,0.00,0,0,0,0,0,0,0,0,0,0,0,0,0
20200316,051521,大立光凱基96購07,,,,,0.00,0.00,0,0,0,0,0,0,0,0,0,0,0,0,0
20200316,051522,玉晶光凱基95購05,0.18,0.18,0.13,0.13,-0.03,-18.75,55000,4,8220,0,0,0,0,0,0,7000,48000,-41000,-41000
20200316,051523,牧德凱基95購02,,,,,0.00,0.00,0,0,0,0,0,0,0,0,0,0,0,0,0
20200316,051524,貿聯凱基95購02,,,,,0.00,0.00,0,0,0,0,0,0,0,0,0,0,0,0,0
20200316,051525,日月光凱基95購02,,,,,0.00,0.00,0,0,0,0,0,0,0,0,0,0,0,0,0
20200316,051526,超眾凱基95購02,0.30,0.30,0.20,0.20,+0.01,5.26,25000,2,7000,0,0,0,0,0,0,25000,0,25000,25000
20200316,051527,台郡凱基95購03,,,,,0.00,0.00,0,0,0,0,0,0,0,0,0,0,0,0,0
20200316,051528,亞泥國票96購01,,,,,0.00,0.00,0,0,0,0,0,0,0,0,0,0,0,0,0
20200316,051529,東元國票96購01,0.34,0.34,0.34,0.34,+0.01,3.03,40000,1,13600,0,0,0,0,0,0,40000,0,40000,40000
20200316,05152P,玉晶光群益96售05,1.72,1.72,1.72,1.72,0.00,0.00,1000,1,1720,0,0,0,0,0,0,0,1000,-1000,-1000
20200316,051530,鴻海國票97購01,,,,,0.00,0.00,0,0,0,0,0,0,0,0,0,0,0,0,0
20200316,051531,國巨國票96購04,1.56,1.56,1.56,1.56,+0.20,14.71,50000,2,78000,0,0,0,0,0,0,50000,0,50000,50000
20200316,051532,潤泰全國票96購01,0.25,0.25,0.25,0.25,+0.05,25.0,4000,1,1000,0,0,0,0,0,0,0,4000,-4000,-4000
20200316,051533,健鼎國票96購02,,,,,0.00,0.00,0,0,0,0,0,0,0,0,0,0,0,0,0
20200316,051534,景碩國票97購01,,,,,0.00,0.00,0,0,0,0,0,0,0,0,0,0,0,0,0
20200316,051535,新日興國票96購01,0.13,0.13,0.08,0.08,-0.04,-33.33,70000,10,7100,0,0,0,0,0,0,5000,65000,-60000,-60000
20200316,051536,玉晶光國票97購01,1.18,1.18,0.64,0.64,-0.50,-43.86,66000,6,75120,0,0,0,0,0,0,64000,4000,60000,60000
20200316,051537,牧德國票96購01,1.24,1.24,1.24,1.24,-0.18,-12.68,10000,1,12400,0,0,0,0,0,0,10000,0,10000,10000
20200316,051538,和碩國票96購01,,,,,0.00,0.00,0,0,0,0,0,0,0,0,0,0,0,0,0
20200316,051539,瀚宇博國票97購01,,,,,0.00,0.00,0,0,0,0,0,0,0,0,0,0,0,0,0
20200316,05153P,台表科群益96售01,1.35,1.35,1.33,1.33,-0.17,-11.33,80000,2,107000,0,0,0,0,0,0,80000,0,80000,80000
20200316,051540,力成國票95購01,,,,,0.00,0.00,0,0,0,0,0,0,0,0,0,0,0,0,0
20200316,051541,GIS國票96購02,,,,,0.00,0.00,0,0,0,0,0,0,0,0,0,0,0,0,0
20200316,051542,南茂國票96購01,,,,,0.00,0.00,0,0,0,0,0,0,0,0,0,0,0,0,0
20200316,051543,鈺齊國票96購01,,,,,0.00,0.00,0,0,0,0,0,0,0,0,0,0,0,0,0
20200316,051544,T50反1康和98購01,1.69,1.75,1.67,1.75,+0.14,8.7,39000,5,65780,0,0,0,0,0,0,10000,0,10000,10000
20200316,051545,裕隆康和95購01,,,,,0.00,0.00,0,0,0,0,0,0,0,0,0,0,0,0,0
20200316,051546,慧洋康和95購01,,,,,0.00,0.00,0,0,0,0,0,0,0,0,0,0,0,0,0
20200316,051547,健鼎康和95購01,,,,,0.00,0.00,0,0,0,0,0,0,0,0,0,0,0,0,0
20200316,051548,鈺齊康和95購01,,,,,0.00,0.00,0,0,0,0,0,0,0,0,0,0,0,0,0
20200316,051549,健鼎永豐95購01,,,,,0.00,0.00,0,0,0,0,0,0,0,0,0,0,0,0,0
20200316,05154P,台積電兆豐95售05,1.10,1.76,1.10,1.67,+0.58,53.21,561000,60,741890,0,0,0,0,0,0,258000,506000,-248000,-248000
20200316,051550,日電貿永豐95購01,,,,,0.00,0.00,0,0,0,0,0,0,0,0,0,0,0,0,0
20200316,051551,新日興永豐95購01,,,,,0.00,0.00,0,0,0,0,0,0,0,0,0,0,0,0,0
20200316,051552,牧德永豐95購03,0.89,0.89,0.67,0.67,-0.04,-5.63,173000,6,131570,0,0,0,0,0,0,40000,133000,-93000,-93000
20200316,051553,牧德永豐96購02,,,,,0.00,0.00,0,0,0,0,0,0,0,0,0,0,0,0,0
20200316,051554,鎧勝永豐95購01,,,,,0.00,0.00,0,0,0,0,0,0,0,0,0,0,0,0,0
20200316,051555,聯茂永豐95購01,0.16,0.16,0.15,0.16,0.00,0.00,62000,4,9620,0,0,0,0,0,0,0,62000,-62000,-62000
20200316,051556,台表科永豐96購01,,,,,0.00,0.00,0,0,0,0,0,0,0,0,0,0,0,0,0
20200316,051557,昇陽半永豐96購01,,,,,0.00,0.00,0,0,0,0,0,0,0,0,0,0,0,0,0
20200316,051558,元金2X國泰97購01,,,,,0.00,0.00,0,0,0,0,0,0,0,0,0,0,0,0,0
20200316,051559,宏達電國泰96購01,0.27,0.27,0.13,0.13,-0.15,-53.57,480000,5,93700,0,0,0,0,0,0,0,480000,-480000,-480000
20200316,05155P,聯發科兆豐95售03,,,,,0.00,0.00,0,0,0,0,0,0,0,0,0,0,0,0,0
20200316,051560,玉晶光國泰97購03,0.99,1.11,0.64,0.64,-0.40,-38.46,307000,50,269270,0,0,0,0,0,0,251000,256000,-5000,-5000
20200316,051561,玉晶光國泰97購04,1.02,1.09,0.85,0.85,-0.26,-23.42,596000,23,555420,0,0,0,0,0,0,596000,320000,276000,276000
20200316,051562,玉晶光國泰97購05,0.84,0.92,0.55,0.55,-0.32,-36.78,254000,21,180420,0,0,0,0,0,0,74000,181000,-107000,-107000
20200316,051563,泰鼎國泰96購01,,,,,0.00,0.00,0,0,0,0,0,0,0,0,0,0,0,0,0
20200316,051564,和碩國泰96購01,0.15,0.15,0.14,0.14,-0.12,-46.15,118000,2,16700,0,0,0,0,0,0,118000,0,118000,118000
20200316,051565,玉晶光永昌96購01,,,,,0.00,0.00,0,0,0,0,0,0,0,0,0,0,0,0,0
20200316,051566,鴻海富邦95購05,,,,,0.00,0.00,0,0,0,0,0,0,0,0,0,0,0,0,0
20200316,051567,台積電富邦95購06,0.20,0.20,0.20,0.20,0.00,0.00,10000,1,2000,0,0,0,0,0,0,10000,0,10000,10000
20200316,051568,智邦富邦95購01,,,,,0.00,0.00,0,0,0,0,0,0,0,0,0,0,0,0,0
20200316,051569,緯創富邦95購02,,,,,0.00,0.00,0,0,0,0,0,0,0,0,0,0,0,0,0
20200316,05156P,群創兆豐95售01,0.97,1.03,0.97,1.03,0.00,0.00,100000,2,100000,0,0,0,0,0,0,0,100000,-100000,-100000
20200316,051570,和碩富邦97購01,,,,,0.00,0.00,0,0,0,0,0,0,0,0,0,0,0,0,0
20200316,051571,南茂富邦95購01,,,,,0.00,0.00,0,0,0,0,0,0,0,0,0,0,0,0,0
20200316,051572,上銀元大95購01,0.53,0.53,0.53,0.53,+0.13,32.5,20000,1,10600,0,0,0,0,0,0,20000,0,20000,20000
20200316,051573,鴻海元大95購15,,,,,0.00,0.00,0,0,0,0,0,0,0,0,0,0,0,0,0
20200316,051574,鴻海元大96購06,,,,,0.00,0.00,0,0,0,0,0,0,0,0,0,0,0,0,0
20200316,051575,國巨元大96購03,0.88,0.88,0.60,0.60,-0.26,-30.23,207000,8,163600,0,0,0,0,0,0,150000,47000,103000,103000
20200316,051576,台積電元大97購02,0.73,0.75,0.56,0.57,-0.49,-46.23,52000,11,36310,0,0,0,0,0,0,6000,46000,-40000,-40000
20200316,051577,台積電元大97購03,1.27,1.27,0.83,0.83,-0.50,-37.59,147000,27,154560,0,0,0,0,0,0,28000,81000,-53000,-53000
20200316,051578,智邦元大96購01,0.80,0.95,0.67,0.67,-0.20,-22.99,242000,31,201960,0,0,0,0,0,0,172000,185000,-13000,-13000
20200316,051579,宏碁元大95購01,,,,,0.00,0.00,0,0,0,0,0,0,0,0,0,0,0,0,0
20200316,05157P,全新台新96售01,2.71,2.78,2.71,2.78,-0.43,-13.4,20000,2,54900,0,0,0,0,0,0,10000,10000,0,0
20200316,051580,宏碁元大95購02,,,,,0.00,0.00,0,0,0,0,0,0,0,0,0,0,0,0,0
20200316,051581,聯發科元大95購12,,,,,0.00,0.00,0,0,0,0,0,0,0,0,0,0,0,0,0
20200316,051582,聯發科元大97購02,0.40,0.43,0.37,0.38,-0.12,-24.0,245000,14,97710,0,0,0,0,0,0,136000,61000,75000,75000
20200316,051583,可成元大95購07,,,,,0.00,0.00,0,0,0,0,0,0,0,0,0,0,0,0,0
20200316,051584,可成元大95購08,,,,,0.00,0.00,0,0,0,0,0,0,0,0,0,0,0,0,0
20200316,051585,美食元大95購01,,,,,0.00,0.00,0,0,0,0,0,0,0,0,0,0,0,0,0
20200316,051586,國泰金元大96購01,,,,,0.00,0.00,0,0,0,0,0,0,0,0,0,0,0,0,0
20200316,051587,大立光元大95購08,,,,,0.00,0.00,0,0,0,0,0,0,0,0,0,0,0,0,0
20200316,051588,聯詠元大95購03,0.14,0.14,0.10,0.10,0.00,0.00,40000,4,4800,0,0,0,0,0,0,0,40000,-40000,-40000
20200316,051589,健鼎元大95購02,,,,,0.00,0.00,0,0,0,0,0,0,0,0,0,0,0,0,0
20200316,05158P,華通永豐95售01,1.95,2.13,1.95,2.13,-0.10,-4.48,31000,4,62550,0,0,0,0,0,0,21000,30000,-9000,-9000
20200316,051590,玉晶光元大96購02,1.01,1.03,0.86,0.86,-0.13,-13.13,64000,9,59010,0,0,0,0,0,0,24000,54000,-30000,-30000
20200316,051591,玉晶光元大97購01,0.67,0.72,0.49,0.49,-0.20,-28.99,127000,7,84850,0,0,0,0,0,0,114000,67000,47000,47000
20200316,051592,健策元大96購05,0.22,0.22,0.22,0.22,-0.04,-15.38,18000,1,3960,0,0,0,0,0,0,18000,0,18000,18000
20200316,051593,和碩元大95購01,,,,,0.00,0.00,0,0,0,0,0,0,0,0,0,0,0,0,0
20200316,051594,和碩元大96購01,,,,,0.00,0.00,0,0,0,0,0,0,0,0,0,0,0,0,0
20200316,051595,康控元大95購04,,,,,0.00,0.00,0,0,0,0,0,0,0,0,0,0,0,0,0
20200316,051596,超眾元大95購05,0.45,0.45,0.42,0.42,-0.03,-6.67,20000,2,8700,0,0,0,0,0,0,20000,0,20000,20000
20200316,051597,T50反1中信99購02,3.15,3.20,3.15,3.20,+0.47,17.22,4000,2,12700,0,0,0,0,0,0,4000,0,4000,4000
20200316,051598,瑞昱兆豐95購01,0.15,0.15,0.09,0.09,-0.10,-52.63,120000,7,14500,0,0,0,0,0,0,20000,100000,-80000,-80000
20200316,051599,健鼎兆豐95購02,,,,,0.00,0.00,0,0,0,0,0,0,0,0,0,0,0,0,0
20200316,05159P,聯發科永豐95售04,1.79,2.37,1.79,2.37,-0.63,-21.0,76000,9,147870,0,0,0,0,0,0,0,76000,-76000,-76000
20200316,051600,新日興兆豐96購02,0.41,0.42,0.41,0.42,+0.01,2.44,38000,2,15710,0,0,0,0,0,0,0,38000,-38000,-38000
20200316,051601,群創兆豐95購02,0.18,0.18,0.13,0.16,+0.05,45.45,100000,7,15700,0,0,0,0,0,0,0,100000,-100000,-100000
20200316,051602,南茂兆豐96購01,0.14,0.14,0.10,0.10,0.00,0.00,525000,10,73300,0,0,0,0,0,0,520000,5000,515000,515000
20200316,051603,深中小群益99購03,1.37,1.37,1.24,1.24,-0.08,-6.06,5000,2,6460,0,0,0,0,0,0,2000,3000,-1000,-1000
20200316,051604,喬山群益95購01,,,,,0.00,0.00,0,0,0,0,0,0,0,0,0,0,0,0,0
20200316,051605,奇力新群益95購02,,,,,0.00,0.00,0,0,0,0,0,0,0,0,0,0,0,0,0
20200316,051606,華新科群益95購05,,,,,0.00,0.00,0,0,0,0,0,0,0,0,0,0,0,0,0
20200316,051607,緯創群益96購02,,,,,0.00,0.00,0,0,0,0,0,0,0,0,0,0,0,0,0
20200316,051608,新日興群益96購01,0.81,0.81,0.55,0.55,-0.27,-32.93,9000,2,6250,0,0,0,0,0,0,5000,4000,1000,1000
20200316,051609,貿聯群益95購03,0.07,0.07,0.06,0.06,0.00,0.00,500000,3,31000,0,0,0,0,0,0,0,500000,-500000,-500000
20200316,05160P,國巨國票96售03,2.35,2.35,2.35,2.35,+0.35,17.5,5000,1,11750,0,0,0,0,0,0,5000,0,5000,5000
20200316,051610,GIS群益95購02,0.03,0.03,0.03,0.03,0.00,0.00,50000,1,1500,0,0,0,0,0,0,0,50000,-50000,-50000
20200316,051611,鈺齊群益95購02,,,,,0.00,0.00,0,0,0,0,0,0,0,0,0,0,0,0,0
20200316,051612,緯創日盛95購01,,,,,0.00,0.00,0,0,0,0,0,0,0,0,0,0,0,0,0
20200316,051613,S&P反1凱基96購01,1.53,1.80,1.53,1.72,+0.27,18.62,72000,8,120420,0,0,0,0,0,0,21000,31000,-10000,-10000
20200316,051614,元金2X凱基97購01,0.41,0.99,0.36,0.99,0.00,0.00,73000,8,29120,0,0,0,0,0,0,0,0,0,0
20200316,051615,華通凱基96購01,,,,,0.00,0.00,0,0,0,0,0,0,0,0,0,0,0,0,0
20200316,051616,鴻海凱基96購08,,,,,0.00,0.00,0,0,0,0,0,0,0,0,0,0,0,0,0
20200316,051617,台積電凱基95購14,,,,,0.00,0.00,0,0,0,0,0,0,0,0,0,0,0,0,0
20200316,051618,智邦凱基95購06,0.60,0.63,0.40,0.40,-0.15,-27.27,148000,10,71330,0,0,0,0,0,0,124000,57000,67000,67000
20200316,051619,智邦凱基95購07,0.32,0.32,0.32,0.32,0.00,0.00,2000,1,640,0,0,0,0,0,0,2000,0,2000,2000
20200316,05161P,華新科國票96售01,,,,,0.00,0.00,0,0,0,0,0,0,0,0,0,0,0,0,0
20200316,051620,可成凱基95購10,,,,,0.00,0.00,0,0,0,0,0,0,0,0,0,0,0,0,0
20200316,051621,欣興凱基95購02,,,,,0.00,0.00,0,0,0,0,0,0,0,0,0,0,0,0,0
20200316,051622,和碩凱基96購01,,,,,0.00,0.00,0,0,0,0,0,0,0,0,0,0,0,0,0
20200316,051623,和碩凱基96購02,0.16,0.18,0.12,0.12,-0.09,-42.86,254000,7,37060,0,0,0,0,0,0,10000,244000,-234000,-234000
20200316,051624,智邦麥證95購02,1.08,1.08,0.76,0.76,+0.02,2.7,40000,5,39400,30000,10000,20000,0,0,0,30000,10000,20000,20000
20200316,051625,聯發科麥證95購01,,,,,0.00,0.00,0,0,0,0,0,0,0,0,0,0,0,0,0
20200316,051626,可成麥證95購02,,,,,0.00,0.00,0,0,0,0,0,0,0,0,0,0,0,0,0
20200316,051627,華新科麥證95購03,1.10,1.22,0.75,0.75,-0.26,-25.74,50000,5,52600,40000,10000,30000,0,0,0,40000,10000,30000,30000
20200316,051628,瀚宇博麥證95購01,,,,,0.00,0.00,0,0,0,0,0,0,0,0,0,0,0,0,0
20200316,051629,上証2X國票95購04,,,,,0.00,0.00,0,0,0,0,0,0,0,0,0,0,0,0,0
20200316,05162P,玉晶光國票96售03,1.86,2.90,1.86,2.90,+1.03,55.08,278000,30,634300,0,0,0,0,0,0,5000,272000,-267000,-267000
20200316,051630,力山國票96購01,,,,,0.00,0.00,0,0,0,0,0,0,0,0,0,0,0,0,0
20200316,051631,國巨國票96購06,2.59,2.59,1.52,1.52,-0.64,-29.63,488000,4,1255470,0,0,0,0,0,0,483000,0,483000,483000
20200316,051632,全新國票96購01,,,,,0.00,0.00,0,0,0,0,0,0,0,0,0,0,0,0,0
20200316,051633,可成國票96購03,0.04,0.05,0.04,0.05,+0.02,66.67,102000,2,4100,0,0,0,0,0,0,102000,0,102000,102000
20200316,051634,大立光國票96購03,,,,,0.00,0.00,0,0,0,0,0,0,0,0,0,0,0,0,0
20200316,051635,大立光國票96購04,,,,,0.00,0.00,0,0,0,0,0,0,0,0,0,0,0,0,0
20200316,051636,嘉晶國票95購02,1.24,1.27,0.88,0.88,-0.28,-24.14,103000,4,102410,0,0,0,0,0,0,83000,0,83000,83000
20200316,051637,嘉聯益國票96購01,,,,,0.00,0.00,0,0,0,0,0,0,0,0,0,0,0,0,0
20200316,051638,聯茂國票96購01,0.52,0.55,0.52,0.55,+0.14,34.15,44000,2,23060,0,0,0,0,0,0,44000,6000,38000,38000
20200316,051639,康友國票96購02,0.70,0.70,0.53,0.53,-0.18,-25.35,50000,5,31650,0,0,0,0,0,0,20000,30000,-10000,-10000
20200316,05163P,聯發科統一96售02,2.44,2.76,2.44,2.76,+0.16,6.15,8000,2,21120,0,0,0,0,0,0,8000,0,8000,8000
20200316,051640,GIS國票96購03,,,,,0.00,0.00,0,0,0,0,0,0,0,0,0,0,0,0,0
20200316,051641,矽創國票96購01,,,,,0.00,0.00,0,0,0,0,0,0,0,0,0,0,0,0,0
20200316,051642,鈺齊台新95購01,,,,,0.00,0.00,0,0,0,0,0,0,0,0,0,0,0,0,0
20200316,051643,瑞昱康和95購01,,,,,0.00,0.00,0,0,0,0,0,0,0,0,0,0,0,0,0
20200316,051644,聯茂康和95購01,,,,,0.00,0.00,0,0,0,0,0,0,0,0,0,0,0,0,0
20200316,051645,光寶科永豐95購01,,,,,0.00,0.00,0,0,0,0,0,0,0,0,0,0,0,0,0
20200316,051646,華通永豐96購01,,,,,0.00,0.00,0,0,0,0,0,0,0,0,0,0,0,0,0
20200316,051647,華新科永豐95購02,0.33,0.36,0.23,0.23,-0.03,-11.54,54000,4,15420,0,0,0,0,0,0,34000,54000,-20000,-20000
20200316,051648,TPK永豐95購01,,,,,0.00,0.00,0,0,0,0,0,0,0,0,0,0,0,0,0
20200316,051649,中磊永豐95購02,,,,,0.00,0.00,0,0,0,0,0,0,0,0,0,0,0,0,0
20200316,05164P,南亞科元富95售04,0.36,0.46,0.36,0.46,+0.18,64.29,20000,2,8200,0,0,0,0,0,0,10000,10000,0,0
20200316,051650,矽力永豐95購01,0.30,0.30,0.12,0.12,-0.16,-57.14,378000,23,68690,0,0,0,0,0,0,214000,164000,50000,50000
20200316,051651,易華電永豐95購01,,,,,0.00,0.00,0,0,0,0,0,0,0,0,0,0,0,0,0
20200316,051652,昇陽半永豐96購02,,,,,0.00,0.00,0,0,0,0,0,0,0,0,0,0,0,0,0
20200316,051653,南電永豐95購02,,,,,0.00,0.00,0,0,0,0,0,0,0,0,0,0,0,0,0
20200316,051654,致新永豐95購01,,,,,0.00,0.00,0,0,0,0,0,0,0,0,0,0,0,0,0
20200316,051655,欣興元富95購04,,,,,0.00,0.00,0,0,0,0,0,0,0,0,0,0,0,0,0
20200316,051656,嘉聯益元富95購02,,,,,0.00,0.00,0,0,0,0,0,0,0,0,0,0,0,0,0
20200316,051657,台郡元富98購01,0.24,0.24,0.20,0.20,+0.02,11.11,100000,3,23200,0,0,0,0,0,0,80000,20000,60000,60000
20200316,051658,深中小國泰97購01,,,,,0.00,0.00,0,0,0,0,0,0,0,0,0,0,0,0,0
20200316,051659,力山國泰97購01,,,,,0.00,0.00,0,0,0,0,0,0,0,0,0,0,0,0,0
20200316,05165P,欣興元富95售03,,,,,0.00,0.00,0,0,0,0,0,0,0,0,0,0,0,0,0
20200316,051660,緯穎國泰96購02,5.35,5.35,4.64,4.64,+1.13,32.19,170000,15,852950,0,0,0,0,0,0,170000,0,170000,170000
20200316,051661,華新科永昌96購01,,,,,0.00,0.00,0,0,0,0,0,0,0,0,0,0,0,0,0
20200316,051662,大立光永昌96購03,,,,,0.00,0.00,0,0,0,0,0,0,0,0,0,0,0,0,0
20200316,051663,鴻海元大95購18,,,,,0.00,0.00,0,0,0,0,0,0,0,0,0,0,0,0,0
20200316,051664,鴻海元大96購07,0.08,0.08,0.08,0.08,-0.03,-27.27,50000,1,4000,0,0,0,0,0,0,50000,0,50000,50000
20200316,051665,台積電元大96購07,0.53,0.53,0.50,0.50,+0.05,11.11,6000,2,3150,0,0,0,0,0,0,5000,1000,4000,4000
20200316,051666,旺宏元大96購05,0.80,0.89,0.58,0.59,-0.18,-23.38,227000,18,172930,0,0,0,0,0,0,127000,189000,-62000,-62000
20200316,051667,光磊元大96購02,,,,,0.00,0.00,0,0,0,0,0,0,0,0,0,0,0,0,0
20200316,051668,智邦元大95購02,0.52,0.63,0.50,0.53,+0.03,6.0,145000,14,80920,0,0,0,0,0,0,120000,116000,4000,4000
20200316,051669,建準元大95購01,,,,,0.00,0.00,0,0,0,0,0,0,0,0,0,0,0,0,0
20200316,05166P,中磊元富95售03,0.84,0.84,0.81,0.81,-0.04,-4.71,6000,6,4980,0,0,0,0,0,0,6000,0,6000,6000
20200316,051670,欣興元大95購06,,,,,0.00,0.00,0,0,0,0,0,0,0,0,0,0,0,0,0
20200316,051671,和鑫元大96購02,0.08,0.08,0.08,0.08,0.00,0.00,50000,1,4000,0,0,0,0,0,0,50000,0,50000,50000
20200316,051672,玉晶光元大96購03,1.35,1.40,0.90,0.95,-0.39,-29.1,624000,69,726170,0,0,0,0,0,0,248000,548000,-300000,-300000
20200316,051673,玉晶光元大96購04,0.57,0.58,0.35,0.35,-0.25,-41.67,112000,11,56100,0,0,0,0,0,0,70000,32000,38000,38000
20200316,051674,臻鼎元大95購02,,,,,0.00,0.00,0,0,0,0,0,0,0,0,0,0,0,0,0
20200316,051675,瑞儀元大96購02,,,,,0.00,0.00,0,0,0,0,0,0,0,0,0,0,0,0,0
20200316,051676,康舒元大95購01,,,,,0.00,0.00,0,0,0,0,0,0,0,0,0,0,0,0,0
20200316,051677,達方元大95購01,0.25,0.25,0.16,0.16,-0.04,-20.0,410000,41,84700,0,0,0,0,0,0,0,410000,-410000,-410000
20200316,051678,鈺齊元大95購02,,,,,0.00,0.00,0,0,0,0,0,0,0,0,0,0,0,0,0
20200316,051679,百和元大95購02,,,,,0.00,0.00,0,0,0,0,0,0,0,0,0,0,0,0,0
20200316,05167P,百和元富95售03,1.34,1.89,1.34,1.89,+0.41,27.7,25000,2,44500,0,0,0,0,0,0,25000,0,25000,25000
20200316,051680,國泰金第一95購01,,,,,0.00,0.00,0,0,0,0,0,0,0,0,0,0,0,0,0
20200316,051681,日月光兆豐95購01,,,,,0.00,0.00,0,0,0,0,0,0,0,0,0,0,0,0,0
20200316,051682,元黃金凱基97購01,0.87,0.87,0.87,0.87,-0.26,-23.01,1000,1,870,0,0,0,0,0,0,0,1000,-1000,-1000
20200316,051683,A50正2凱基97購01,0.10,0.10,0.10,0.10,0.00,0.00,50000,5,5000,0,0,0,0,0,0,0,50000,-50000,-50000
20200316,051684,瑞昱凱基95購02,0.28,0.28,0.28,0.28,+0.18,180.0,10000,1,2800,0,0,0,0,0,0,10000,0,10000,10000
20200316,051685,台光電凱基95購01,,,,,0.00,0.00,0,0,0,0,0,0,0,0,0,0,0,0,0
20200316,051686,宏達電凱基95購04,,,,,0.00,0.00,0,0,0,0,0,0,0,0,0,0,0,0,0
20200316,051687,大立光凱基95購12,,,,,0.00,0.00,0,0,0,0,0,0,0,0,0,0,0,0,0
20200316,051688,大立光凱基97購02,0.42,0.43,0.30,0.30,-0.16,-34.78,452000,32,175540,0,0,0,0,0,0,165000,237000,-72000,-72000
20200316,051689,智易凱基95購02,,,,,0.00,0.00,0,0,0,0,0,0,0,0,0,0,0,0,0
20200316,05168P,鴻海元大95售14,,,,,0.00,0.00,0,0,0,0,0,0,0,0,0,0,0,0,0
20200316,051690,超眾凱基95購03,,,,,0.00,0.00,0,0,0,0,0,0,0,0,0,0,0,0,0
20200316,051691,台表科凱基95購01,0.14,0.14,0.10,0.10,0.00,0.00,20000,2,2400,0,0,0,0,0,0,0,20000,-20000,-20000
20200316,051692,深中小統一95購01,,,,,0.00,0.00,0,0,0,0,0,0,0,0,0,0,0,0,0
20200316,051693,華新科統一95購02,1.03,1.03,1.03,1.03,-0.07,-6.36,10000,1,10300,0,0,0,0,0,0,10000,0,10000,10000
20200316,051694,A50正2中信96購03,0.23,0.23,0.19,0.19,-0.08,-29.63,211000,4,40290,0,0,0,0,0,0,0,211000,-211000,-211000
20200316,051695,元金2X中信98購01,0.89,1.01,0.89,0.98,-0.32,-24.62,311000,4,287040,0,0,0,0,0,0,200000,111000,89000,89000
20200316,051696,新日興中信96購01,0.12,0.12,0.10,0.10,-0.02,-16.67,70000,4,7600,0,0,0,0,0,0,20000,50000,-30000,-30000
20200316,051697,康友中信95購02,0.06,0.06,0.06,0.06,0.00,0.00,2000,1,120,0,0,0,0,0,0,0,2000,-2000,-2000
20200316,051698,旺宏麥證95購01,,,,,0.00,0.00,0,0,0,0,0,0,0,0,0,0,0,0,0
20200316,051699,世紀鋼麥證95購01,0.81,0.85,0.75,0.84,+0.10,13.51,755000,28,618450,425000,330000,95000,0,0,0,425000,330000,95000,95000
20200316,05169P,玉晶光元大95售03,1.98,2.56,1.97,2.56,+0.39,17.97,91000,14,199840,0,0,0,0,0,0,61000,90000,-29000,-29000
20200316,051700,深中小群益99購04,,,,,0.00,0.00,0,0,0,0,0,0,0,0,0,0,0,0,0
20200316,051701,華通群益97購01,0.14,0.14,0.07,0.07,-0.05,-41.67,73000,8,8130,0,0,0,0,0,0,11000,62000,-51000,-51000
20200316,051702,鴻海群益95購08,,,,,0.00,0.00,0,0,0,0,0,0,0,0,0,0,0,0,0
20200316,051703,台積電群益95購04,,,,,0.00,0.00,0,0,0,0,0,0,0,0,0,0,0,0,0
20200316,051704,智邦群益95購02,0.45,0.45,0.45,0.45,+0.06,15.38,5000,1,2250,0,0,0,0,0,0,0,5000,-5000,-5000
20200316,051705,富邦金群益97購01,,,,,0.00,0.00,0,0,0,0,0,0,0,0,0,0,0,0,0
20200316,051706,國泰金群益95購01,,,,,0.00,0.00,0,0,0,0,0,0,0,0,0,0,0,0,0
20200316,051707,欣興群益95購02,,,,,0.00,0.00,0,0,0,0,0,0,0,0,0,0,0,0,0
20200316,051708,創意群益95購02,,,,,0.00,0.00,0,0,0,0,0,0,0,0,0,0,0,0,0
20200316,051709,TPK群益95購02,,,,,0.00,0.00,0,0,0,0,0,0,0,0,0,0,0,0,0
20200316,05170P,世芯元大95售01,1.05,1.48,0.97,1.48,+0.51,52.58,1458000,149,1699860,0,0,0,0,0,0,322000,1135000,-813000,-813000
20200316,051710,和碩群益95購01,,,,,0.00,0.00,0,0,0,0,0,0,0,0,0,0,0,0,0
20200316,051711,臻鼎群益95購03,,,,,0.00,0.00,0,0,0,0,0,0,0,0,0,0,0,0,0
20200316,051712,嘉聯益群益95購01,,,,,0.00,0.00,0,0,0,0,0,0,0,0,0,0,0,0,0
20200316,051713,大立光台新95購03,,,,,0.00,0.00,0,0,0,0,0,0,0,0,0,0,0,0,0
20200316,051714,健鼎台新95購01,,,,,0.00,0.00,0,0,0,0,0,0,0,0,0,0,0,0,0
20200316,051715,和碩台新95購01,,,,,0.00,0.00,0,0,0,0,0,0,0,0,0,0,0,0,0
20200316,051716,康控康和95購01,,,,,0.00,0.00,0,0,0,0,0,0,0,0,0,0,0,0,0
20200316,051717,祥碩康和95購01,2.26,2.26,2.26,2.26,-0.16,-6.61,10000,1,22600,0,0,0,0,0,0,10000,0,10000,10000
20200316,051718,上証2X永豐95購01,0.06,0.06,0.06,0.06,0.00,0.00,120000,5,7200,0,0,0,0,0,0,0,0,0,0
20200316,051719,鴻海永豐95購04,,,,,0.00,0.00,0,0,0,0,0,0,0,0,0,0,0,0,0
20200316,05171P,臺股指元大95售15,,,,,0.00,0.00,0,0,0,0,0,0,0,0,0,0,0,0,0
20200316,051720,燿華永豐95購06,,,,,0.00,0.00,0,0,0,0,0,0,0,0,0,0,0,0,0
20200316,051721,玉晶光永豐96購02,1.09,1.09,0.86,0.86,-0.20,-18.87,49000,7,49160,0,0,0,0,0,0,32000,49000,-17000,-17000
20200316,051722,玉晶光永豐97購01,1.10,1.10,0.93,0.93,-0.17,-15.45,66000,10,67260,0,0,0,0,0,0,48000,66000,-18000,-18000
20200316,051723,嘉澤永豐95購01,,,,,0.00,0.00,0,0,0,0,0,0,0,0,0,0,0,0,0
20200316,051724,康控永豐95購03,,,,,0.00,0.00,0,0,0,0,0,0,0,0,0,0,0,0,0
20200316,051725,緯穎永豐95購02,1.93,2.05,1.65,1.65,+0.41,33.06,159000,39,313500,0,0,0,0,0,0,114000,0,114000,114000
20200316,051726,南茂永豐95購03,,,,,0.00,0.00,0,0,0,0,0,0,0,0,0,0,0,0,0
20200316,051727,S&P反1國票97購01,,,,,0.00,0.00,0,0,0,0,0,0,0,0,0,0,0,0,0
20200316,051728,道瓊反國票97購01,2.55,2.55,2.55,2.55,+0.27,11.84,11000,2,28050,0,0,0,0,0,0,11000,0,11000,11000
20200316,051729,華新國票96購01,0.09,0.09,0.09,0.09,-0.02,-18.18,100000,10,9000,0,0,0,0,0,0,0,100000,-100000,-100000
20200316,05172P,臺股指元大95售16,,,,,0.00,0.00,0,0,0,0,0,0,0,0,0,0,0,0,0
20200316,051730,為升國票96購02,,,,,0.00,0.00,0,0,0,0,0,0,0,0,0,0,0,0,0
20200316,051731,聯電國票96購02,0.91,0.91,0.86,0.87,-0.07,-7.45,119000,5,106130,0,0,0,0,0,0,119000,0,119000,119000
20200316,051732,華通國票97購01,0.01,0.02,0.01,0.02,0.00,0.00,56000,2,1060,0,0,0,0,0,0,0,0,0,0
20200316,051733,中環國票96購02,,,,,0.00,0.00,0,0,0,0,0,0,0,0,0,0,0,0,0
20200316,051734,台積電國票95購04,0.02,0.02,0.02,0.02,0.00,0.00,7000,1,140,0,0,0,0,0,0,7000,0,7000,7000
20200316,051735,台積電國票96購06,0.87,0.87,0.45,0.45,-0.47,-51.09,406000,13,257720,0,0,0,0,0,0,345000,56000,289000,289000
20200316,051736,旺宏國票96購01,2.20,2.20,1.47,1.47,-0.55,-27.23,102000,5,188560,0,0,0,0,0,0,92000,10000,82000,82000
20200316,051737,瑞昱國票96購01,,,,,0.00,0.00,0,0,0,0,0,0,0,0,0,0,0,0,0
20200316,051738,全新國票96購02,,,,,0.00,0.00,0,0,0,0,0,0,0,0,0,0,0,0,0
20200316,051739,奇力新國票97購01,1.93,1.93,1.02,1.02,-0.38,-27.14,105000,6,162170,0,0,0,0,0,0,105000,0,105000,105000
20200316,05173P,臺股指元大95售17,7.10,7.45,7.10,7.45,-0.85,-10.24,2000,2,14550,0,0,0,0,0,0,2000,0,2000,2000
20200316,051740,可成國票96購04,,,,,0.00,0.00,0,0,0,0,0,0,0,0,0,0,0,0,0
20200316,051741,可成國票97購01,,,,,0.00,0.00,0,0,0,0,0,0,0,0,0,0,0,0,0
20200316,051742,欣興國票96購01,,,,,0.00,0.00,0,0,0,0,0,0,0,0,0,0,0,0,0
20200316,051743,揚明光國票96購02,,,,,0.00,0.00,0,0,0,0,0,0,0,0,0,0,0,0,0
20200316,051744,嘉聯益國票97購01,,,,,0.00,0.00,0,0,0,0,0,0,0,0,0,0,0,0,0
20200316,051745,玉晶光國泰97購06,1.01,1.01,0.96,0.96,-0.17,-15.04,274000,13,267430,0,0,0,0,0,0,274000,0,274000,274000
20200316,051746,玉晶光國泰97購07,1.29,1.38,0.90,0.90,-0.44,-32.84,1460000,51,1668930,0,0,0,0,0,0,1154000,679000,475000,475000
20200316,051747,貿聯國泰96購01,,,,,0.00,0.00,0,0,0,0,0,0,0,0,0,0,0,0,0
20200316,051748,超眾國泰96購01,0.52,0.55,0.44,0.44,+0.04,10.0,125000,3,57300,0,0,0,0,0,0,100000,125000,-25000,-25000
20200316,051749,矽力國泰97購01,1.13,1.13,0.68,0.68,-0.36,-34.62,105000,11,110780,0,0,0,0,0,0,95000,82000,13000,13000
20200316,05174P,元金2X富邦9B售01,0.98,1.10,0.96,0.96,+0.08,9.09,97000,11,98310,0,0,0,0,0,0,97000,0,97000,97000
20200316,051750,華通富邦96購01,0.03,0.03,0.03,0.03,0.00,0.00,30000,1,900,0,0,0,0,0,0,0,0,0,0
20200316,051751,聯茂富邦95購01,0.13,0.13,0.13,0.13,+0.04,44.44,61000,2,7930,0,0,0,0,0,0,0,61000,-61000,-61000
20200316,051752,緯穎富邦96購01,0.91,0.91,0.85,0.85,0.00,0.00,2000,2,1760,0,0,0,0,0,0,0,2000,-2000,-2000
20200316,051753,華通元大96購03,0.03,0.03,0.03,0.03,0.00,0.00,1000,1,30,0,0,0,0,0,0,0,0,0,0
20200316,051754,廣宇元大95購01,,,,,0.00,0.00,0,0,0,0,0,0,0,0,0,0,0,0,0
20200316,051755,台積電元大96購08,0.73,0.77,0.43,0.45,-0.21,-31.82,1124000,83,654540,0,0,0,0,0,0,759000,650000,109000,109000
20200316,051756,台積電元大97購04,0.70,0.70,0.70,0.70,+0.22,45.83,10000,1,7000,0,0,0,0,0,0,0,10000,-10000,-10000
20200316,051757,佳世達元大95購02,,,,,0.00,0.00,0,0,0,0,0,0,0,0,0,0,0,0,0
20200316,051758,瑞昱元大95購01,,,,,0.00,0.00,0,0,0,0,0,0,0,0,0,0,0,0,0
20200316,051759,全新元大95購04,,,,,0.00,0.00,0,0,0,0,0,0,0,0,0,0,0,0,0
20200316,05175P,TPK富邦99售01,,,,,0.00,0.00,0,0,0,0,0,0,0,0,0,0,0,0,0
20200316,051760,奇力新元大95購04,,,,,0.00,0.00,0,0,0,0,0,0,0,0,0,0,0,0,0
20200316,051761,富邦金元大96購01,,,,,0.00,0.00,0,0,0,0,0,0,0,0,0,0,0,0,0
20200316,051762,國泰金元大95購01,0.10,0.10,0.07,0.07,0.00,0.00,340000,34,28000,0,0,0,0,0,0,0,340000,-340000,-340000
20200316,051763,新光金元大98購01,,,,,0.00,0.00,0,0,0,0,0,0,0,0,0,0,0,0,0
20200316,051764,欣興元大95購07,,,,,0.00,0.00,0,0,0,0,0,0,0,0,0,0,0,0,0
20200316,051765,健鼎元大95購03,,,,,0.00,0.00,0,0,0,0,0,0,0,0,0,0,0,0,0
20200316,051766,泰鼎元大95購02,2.03,2.11,2.03,2.11,+0.35,19.89,30000,3,62500,0,0,0,0,0,0,30000,0,30000,30000
20200316,051767,臻鼎元大95購03,,,,,0.00,0.00,0,0,0,0,0,0,0,0,0,0,0,0,0
20200316,051768,臻鼎元大95購04,,,,,0.00,0.00,0,0,0,0,0,0,0,0,0,0,0,0,0
20200316,051769,矽力元大95購01,1.46,1.46,0.74,0.74,-0.54,-42.19,174000,21,181780,0,0,0,0,0,0,41000,133000,-92000,-92000
20200316,05176P,台積電凱基95售11,1.21,1.51,1.21,1.45,+0.38,35.51,161000,4,241710,0,0,0,0,0,0,161000,0,161000,161000
20200316,051770,南茂元大95購02,,,,,0.00,0.00,0,0,0,0,0,0,0,0,0,0,0,0,0
20200316,051771,上銀中信95購01,0.04,0.05,0.04,0.05,-0.06,-54.55,310000,31,14900,0,0,0,0,0,0,0,310000,-310000,-310000
20200316,051772,玉山金中信95購01,,,,,0.00,0.00,0,0,0,0,0,0,0,0,0,0,0,0,0
20200316,051773,元大金中信95購02,,,,,0.00,0.00,0,0,0,0,0,0,0,0,0,0,0,0,0
20200316,051774,聯茂中信96購01,0.37,0.55,0.37,0.39,-0.14,-26.42,360000,21,174640,0,0,0,0,0,0,166000,194000,-28000,-28000
20200316,051775,旺宏亞東95購01,,,,,0.00,0.00,0,0,0,0,0,0,0,0,0,0,0,0,0
20200316,051776,上証2X群益99購01,0.40,0.42,0.39,0.42,-0.23,-35.38,106000,4,41940,0,0,0,0,0,0,102000,104000,-2000,-2000
20200316,051777,聯發科群益95購04,,,,,0.00,0.00,0,0,0,0,0,0,0,0,0,0,0,0,0
20200316,051778,全新群益95購01,,,,,0.00,0.00,0,0,0,0,0,0,0,0,0,0,0,0,0
20200316,051779,大立光群益95購02,,,,,0.00,0.00,0,0,0,0,0,0,0,0,0,0,0,0,0
20200316,05177P,台積電凱基95售12,0.53,0.79,0.51,0.79,+0.30,61.22,125000,7,86680,0,0,0,0,0,0,120000,105000,15000,15000
20200316,051780,矽力群益95購01,0.84,0.84,0.41,0.41,0.00,0.00,221000,14,135400,0,0,0,0,0,0,0,221000,-221000,-221000
20200316,051781,緯穎群益96購01,,,,,0.00,0.00,0,0,0,0,0,0,0,0,0,0,0,0,0
20200316,051782,昇陽半群益95購01,,,,,0.00,0.00,0,0,0,0,0,0,0,0,0,0,0,0,0
20200316,051783,鴻海兆豐95購03,,,,,0.00,0.00,0,0,0,0,0,0,0,0,0,0,0,0,0
20200316,051784,國巨兆豐95購01,0.60,0.60,0.40,0.40,-0.20,-33.33,74000,9,39490,0,0,0,0,0,0,67000,0,67000,67000
20200316,051785,臻鼎兆豐96購01,,,,,0.00,0.00,0,0,0,0,0,0,0,0,0,0,0,0,0
20200316,051786,A50正2國票95購02,,,,,0.00,0.00,0,0,0,0,0,0,0,0,0,0,0,0,0
20200316,051787,燿華國票96購02,,,,,0.00,0.00,0,0,0,0,0,0,0,0,0,0,0,0,0
20200316,051788,奇力新國票97購02,,,,,0.00,0.00,0,0,0,0,0,0,0,0,0,0,0,0,0
20200316,051789,嘉澤國票96購01,,,,,0.00,0.00,0,0,0,0,0,0,0,0,0,0,0,0,0
20200316,05178P,大立光凱基96售05,2.80,3.30,2.80,3.30,+0.69,26.44,136000,7,405550,0,0,0,0,0,0,21000,115000,-94000,-94000
20200316,051790,貿聯國票95購03,,,,,0.00,0.00,0,0,0,0,0,0,0,0,0,0,0,0,0
20200316,051791,智伸科國票96購01,,,,,0.00,0.00,0,0,0,0,0,0,0,0,0,0,0,0,0
20200316,051792,泰鼎國票96購02,1.84,1.84,1.84,1.84,+0.08,4.55,30000,1,55200,0,0,0,0,0,0,30000,0,30000,30000
20200316,051793,臻鼎國票95購02,,,,,0.00,0.00,0,0,0,0,0,0,0,0,0,0,0,0,0
20200316,051794,臻鼎國票96購02,,,,,0.00,0.00,0,0,0,0,0,0,0,0,0,0,0,0,0
20200316,051795,T50反1台新05購02,,,,,0.00,0.00,0,0,0,0,0,0,0,0,0,0,0,0,0
20200316,051796,和碩康和95購01,,,,,0.00,0.00,0,0,0,0,0,0,0,0,0,0,0,0,0
20200316,051797,卜蜂永豐95購01,,,,,0.00,0.00,0,0,0,0,0,0,0,0,0,0,0,0,0
20200316,051798,國巨永豐95購03,0.45,0.49,0.26,0.26,-0.08,-23.53,120000,12,48200,0,0,0,0,0,0,0,120000,-120000,-120000
20200316,051799,台積電永豐96購01,0.51,0.55,0.39,0.39,-0.29,-42.65,666000,75,296520,0,0,0,0,0,0,10000,616000,-606000,-606000
20200316,05179P,大立光凱基96售06,2.61,3.15,2.61,3.04,0.00,0.00,144000,6,401110,0,0,0,0,0,0,22000,144000,-122000,-122000
20200316,051800,旺宏永豐95購02,1.07,1.10,0.68,0.68,-0.02,-2.86,408000,10,396380,0,0,0,0,0,0,50000,358000,-308000,-308000
20200316,051801,牧德永豐95購04,0.30,0.30,0.26,0.26,-0.26,-50.0,40000,4,11320,0,0,0,0,0,0,20000,20000,0,0
20200316,051802,同欣電永豐95購02,0.08,0.08,0.08,0.08,0.00,0.00,75000,1,6000,0,0,0,0,0,0,75000,0,75000,75000
20200316,051803,矽創永豐95購03,,,,,0.00,0.00,0,0,0,0,0,0,0,0,0,0,0,0,0
20200316,051804,新光金日盛95購01,0.03,0.03,0.03,0.03,-0.03,-50.0,100000,1,3000,0,0,0,0,0,0,0,100000,-100000,-100000
20200316,051805,元黃金凱基97購02,0.88,0.88,0.84,0.84,-0.11,-11.58,2000,2,1720,0,0,0,0,0,0,0,2000,-2000,-2000
20200316,051806,華通凱基96購02,,,,,0.00,0.00,0,0,0,0,0,0,0,0,0,0,0,0,0
20200316,051807,瑞昱凱基95購03,,,,,0.00,0.00,0,0,0,0,0,0,0,0,0,0,0,0,0
20200316,051808,美律凱基96購02,,,,,0.00,0.00,0,0,0,0,0,0,0,0,0,0,0,0,0
20200316,051809,義隆凱基96購01,,,,,0.00,0.00,0,0,0,0,0,0,0,0,0,0,0,0,0
20200316,05180P,玉晶光凱基95售04,0.80,0.81,0.52,0.81,+0.28,52.83,3397000,62,2003110,0,0,0,0,0,0,110000,3138000,-3028000,-3028000
20200316,051810,欣興凱基95購03,,,,,0.00,0.00,0,0,0,0,0,0,0,0,0,0,0,0,0
20200316,051811,致伸凱基95購03,,,,,0.00,0.00,0,0,0,0,0,0,0,0,0,0,0,0,0
20200316,051812,臻鼎凱基95購03,,,,,0.00,0.00,0,0,0,0,0,0,0,0,0,0,0,0,0
20200316,051813,GIS凱基96購02,,,,,0.00,0.00,0,0,0,0,0,0,0,0,0,0,0,0,0
20200316,051814,鈺齊凱基95購01,,,,,0.00,0.00,0,0,0,0,0,0,0,0,0,0,0,0,0
20200316,051815,百和凱基96購01,,,,,0.00,0.00,0,0,0,0,0,0,0,0,0,0,0,0,0
20200316,051816,臺股指凱基95購07,0.11,0.11,0.11,0.11,-0.04,-26.67,90000,1,9900,0,0,0,0,0,0,0,0,0,0
20200316,051817,元金2X統一95購01,,,,,0.00,0.00,0,0,0,0,0,0,0,0,0,0,0,0,0
20200316,051818,國巨統一95購02,,,,,0.00,0.00,0,0,0,0,0,0,0,0,0,0,0,0,0
20200316,051819,燿華統一96購01,,,,,0.00,0.00,0,0,0,0,0,0,0,0,0,0,0,0,0
20200316,05181P,健策凱基95售01,0.75,1.12,0.75,1.12,+0.16,16.67,318000,9,260870,0,0,0,0,0,0,300000,48000,252000,252000
20200316,051820,道瓊反元富95購01,2.53,2.53,2.50,2.50,-0.42,-14.38,40000,4,100600,0,0,0,0,0,0,0,40000,-40000,-40000
20200316,051821,京元電元富95購04,,,,,0.00,0.00,0,0,0,0,0,0,0,0,0,0,0,0,0
20200316,051822,和碩元富95購01,0.03,0.03,0.03,0.03,+0.02,200.0,10000,1,300,0,0,0,0,0,0,10000,0,10000,10000
20200316,051823,矽力元富95購02,0.45,0.45,0.45,0.45,-0.16,-26.23,1000,1,450,0,0,0,0,0,0,0,1000,-1000,-1000
20200316,051824,華通元大95購07,,,,,0.00,0.00,0,0,0,0,0,0,0,0,0,0,0,0,0
20200316,051825,中環元大95購01,0.06,0.06,0.06,0.06,+0.01,20.0,65000,4,3900,0,0,0,0,0,0,0,30000,-30000,-30000
20200316,051826,智邦元大95購03,0.33,0.34,0.30,0.30,+0.04,15.38,250000,15,82200,0,0,0,0,0,0,150000,120000,30000,30000
20200316,051827,智邦元大95購04,0.52,0.52,0.37,0.37,-0.07,-15.91,230000,16,98780,0,0,0,0,0,0,150000,145000,5000,5000
20200316,051828,微星元大95購03,1.24,1.24,1.24,1.24,-0.06,-4.62,40000,2,49600,0,0,0,0,0,0,40000,0,40000,40000
20200316,051829,玉晶光元大98購02,0.99,1.07,0.89,0.90,-0.10,-10.0,667000,72,668380,0,0,0,0,0,0,86000,572000,-486000,-486000
20200316,05182P,嘉晶統一95售03,,,,,0.00,0.00,0,0,0,0,0,0,0,0,0,0,0,0,0
20200316,051830,健策元大97購01,0.47,0.52,0.44,0.44,-0.04,-8.33,206000,9,94040,0,0,0,0,0,0,166000,40000,126000,126000
20200316,051831,緯穎元大96購04,3.12,3.12,3.11,3.11,+1.50,93.17,16000,6,49820,0,0,0,0,0,0,15000,0,15000,15000
20200316,051832,復盛元大95購01,0.45,0.54,0.32,0.32,-0.16,-33.33,150000,4,75200,0,0,0,0,0,0,130000,20000,110000,110000
20200316,051833,昇陽半元大96購01,0.11,0.11,0.07,0.07,-0.04,-36.36,111000,5,8390,0,0,0,0,0,0,106000,5000,101000,101000
20200316,051834,南電元大96購02,0.20,0.21,0.20,0.21,+0.05,31.25,11000,3,2240,0,0,0,0,0,0,11000,0,11000,11000
20200316,051835,百和元大95購03,0.06,0.06,0.06,0.06,-0.01,-14.29,10000,1,600,0,0,0,0,0,0,0,10000,-10000,-10000
20200316,051836,華通國泰95購02,,,,,0.00,0.00,0,0,0,0,0,0,0,0,0,0,0,0,0
20200316,051837,國巨國泰96購04,,,,,0.00,0.00,0,0,0,0,0,0,0,0,0,0,0,0,0
20200316,051838,國巨國泰97購01,,,,,0.00,0.00,0,0,0,0,0,0,0,0,0,0,0,0,0
20200316,051839,和鑫國泰96購01,,,,,0.00,0.00,0,0,0,0,0,0,0,0,0,0,0,0,0
20200316,05183P,台積電元富95售07,2.14,2.36,2.14,2.36,+0.92,63.89,562000,5,1293270,0,0,0,0,0,0,552000,562000,-10000,-10000
20200316,051840,康友國泰97購02,0.58,0.58,0.39,0.40,-0.23,-36.51,93000,11,41130,0,0,0,0,0,0,60000,33000,27000,27000
20200316,051841,南茂國泰96購01,0.21,0.21,0.19,0.19,+0.04,26.67,559000,3,116490,0,0,0,0,0,0,529000,30000,499000,499000
20200316,051842,大成鋼富邦97購01,0.34,0.35,0.34,0.35,+0.12,52.17,256000,4,89500,0,0,0,0,0,0,256000,0,256000,256000
20200316,051843,聯發科富邦99購01,0.26,0.26,0.11,0.11,-0.12,-52.17,260000,22,47470,0,0,0,0,0,0,50000,210000,-160000,-160000
20200316,051844,宏達電富邦96購01,0.10,0.10,0.10,0.10,0.00,0.00,125000,2,12500,0,0,0,0,0,0,25000,100000,-75000,-75000
20200316,051845,世紀鋼富邦96購01,0.66,0.70,0.59,0.60,-0.04,-6.25,1147000,56,747470,0,0,0,0,0,0,736000,408000,328000,328000
20200316,051846,S&P反1中信96購02,3.05,3.05,2.90,2.90,+0.17,6.23,20000,2,59500,0,0,0,0,0,0,10000,10000,0,0
20200316,051847,香港反中信99購01,0.88,1.11,0.87,1.11,+0.19,20.65,185000,11,191650,0,0,0,0,0,0,10000,165000,-155000,-155000
20200316,051848,元金2X中信98購02,0.73,0.80,0.69,0.78,-0.22,-22.0,33000,9,24350,0,0,0,0,0,0,0,33000,-33000,-33000
20200316,051849,旺宏中信98購01,0.49,0.49,0.37,0.37,-0.08,-17.78,294000,8,120060,0,0,0,0,0,0,84000,210000,-126000,-126000
20200316,05184P,緯穎元富95售01,,,,,0.00,0.00,0,0,0,0,0,0,0,0,0,0,0,0,0
20200316,051850,臻鼎中信96購01,,,,,0.00,0.00,0,0,0,0,0,0,0,0,0,0,0,0,0
20200316,051851,TPK群益95購03,,,,,0.00,0.00,0,0,0,0,0,0,0,0,0,0,0,0,0
20200316,051852,啟碁群益95購01,,,,,0.00,0.00,0,0,0,0,0,0,0,0,0,0,0,0,0
20200316,051853,京元電亞東95購01,,,,,0.00,0.00,0,0,0,0,0,0,0,0,0,0,0,0,0
20200316,051854,鴻海麥證95購04,,,,,0.00,0.00,0,0,0,0,0,0,0,0,0,0,0,0,0
20200316,051855,道瓊反凱基97購01,2.31,2.37,2.15,2.20,+0.15,7.32,770000,77,1730680,0,0,0,0,0,0,241000,513000,-272000,-272000
20200316,051856,亞德客凱基95購01,0.24,0.25,0.24,0.25,0.00,0.00,30000,2,7420,0,0,0,0,0,0,22000,8000,14000,14000
20200316,051857,喬山凱基95購01,,,,,0.00,0.00,0,0,0,0,0,0,0,0,0,0,0,0,0
20200316,051858,上銀凱基95購01,,,,,0.00,0.00,0,0,0,0,0,0,0,0,0,0,0,0,0
20200316,051859,劍麟凱基96購01,,,,,0.00,0.00,0,0,0,0,0,0,0,0,0,0,0,0,0
20200316,05185P,鴻海中信95售04,,,,,0.00,0.00,0,0,0,0,0,0,0,0,0,0,0,0,0
20200316,051860,為升凱基95購01,,,,,0.00,0.00,0,0,0,0,0,0,0,0,0,0,0,0,0
20200316,051861,鴻海凱基98購01,0.06,0.06,0.06,0.06,0.00,0.00,29000,5,1740,0,0,0,0,0,0,9000,0,9000,9000
20200316,051862,旺宏凱基95購05,0.16,0.19,0.15,0.15,-0.01,-6.25,220000,21,38100,0,0,0,0,0,0,220000,0,220000,220000
20200316,051863,技嘉凱基95購01,,,,,0.00,0.00,0,0,0,0,0,0,0,0,0,0,0,0,0
20200316,051864,聯發科凱基96購03,,,,,0.00,0.00,0,0,0,0,0,0,0,0,0,0,0,0,0
20200316,051865,聯發科凱基96購04,,,,,0.00,0.00,0,0,0,0,0,0,0,0,0,0,0,0,0
20200316,051866,聯發科凱基96購05,,,,,0.00,0.00,0,0,0,0,0,0,0,0,0,0,0,0,0
20200316,051867,潤泰全凱基95購01,,,,,0.00,0.00,0,0,0,0,0,0,0,0,0,0,0,0,0
20200316,051868,貿聯凱基96購01,,,,,0.00,0.00,0,0,0,0,0,0,0,0,0,0,0,0,0
20200316,051869,康控凱基96購01,,,,,0.00,0.00,0,0,0,0,0,0,0,0,0,0,0,0,0
20200316,05186P,鈺齊中信95售02,1.04,1.39,1.03,1.39,+0.19,15.83,66000,9,69670,0,0,0,0,0,0,64000,2000,62000,62000
20200316,051870,台郡凱基95購04,,,,,0.00,0.00,0,0,0,0,0,0,0,0,0,0,0,0,0
20200316,051871,同欣電凱基95購02,,,,,0.00,0.00,0,0,0,0,0,0,0,0,0,0,0,0,0
20200316,051872,矽力凱基96購01,,,,,0.00,0.00,0,0,0,0,0,0,0,0,0,0,0,0,0
20200316,051873,緯穎凱基95購02,2.34,2.34,2.03,2.12,+0.42,24.71,135000,7,302100,0,0,0,0,0,0,50000,85000,-35000,-35000
20200316,051874,志超凱基95購01,,,,,0.00,0.00,0,0,0,0,0,0,0,0,0,0,0,0,0
20200316,051875,聯發科兆豐95購04,0.08,0.08,0.08,0.08,+0.01,14.29,50000,5,4000,0,0,0,0,0,0,50000,50000,0,0
20200316,051876,宏達電國票96購01,,,,,0.00,0.00,0,0,0,0,0,0,0,0,0,0,0,0,0
20200316,051877,嘉聯益國票97購02,,,,,0.00,0.00,0,0,0,0,0,0,0,0,0,0,0,0,0
20200316,051878,鴻海台新96購01,,,,,0.00,0.00,0,0,0,0,0,0,0,0,0,0,0,0,0
20200316,051879,健策台新96購01,,,,,0.00,0.00,0,0,0,0,0,0,0,0,0,0,0,0,0
20200316,05187P,力山凱基95售01,,,,,0.00,0.00,0,0,0,0,0,0,0,0,0,0,0,0,0
20200316,051880,健策康和95購01,,,,,0.00,0.00,0,0,0,0,0,0,0,0,0,0,0,0,0
20200316,051881,上証2X永豐95購02,,,,,0.00,0.00,0,0,0,0,0,0,0,0,0,0,0,0,0
20200316,051882,潤泰全永豐95購01,0.04,0.04,0.04,0.04,0.00,0.00,20000,2,800,0,0,0,0,0,0,0,20000,-20000,-20000
20200316,051883,智原永豐95購03,,,,,0.00,0.00,0,0,0,0,0,0,0,0,0,0,0,0,0
20200316,051884,樺漢永豐95購01,,,,,0.00,0.00,0,0,0,0,0,0,0,0,0,0,0,0,0
20200316,051885,易華電永豐95購02,,,,,0.00,0.00,0,0,0,0,0,0,0,0,0,0,0,0,0
20200316,051886,道瓊反統一95購03,,,,,0.00,0.00,0,0,0,0,0,0,0,0,0,0,0,0,0
20200316,051887,上証2X元富98購01,,,,,0.00,0.00,0,0,0,0,0,0,0,0,0,0,0,0,0
20200316,051888,國巨元富95購05,0.49,0.80,0.11,0.23,-0.12,-34.29,585000,38,184370,0,0,0,0,0,0,0,494000,-494000,-494000
20200316,051889,智邦元富95購02,0.54,0.54,0.44,0.47,+0.01,2.17,329000,19,156950,0,0,0,0,0,0,329000,20000,309000,309000
20200316,05188P,可成凱基95售09,,,,,0.00,0.00,0,0,0,0,0,0,0,0,0,0,0,0,0
20200316,051890,智邦元富95購03,,,,,0.00,0.00,0,0,0,0,0,0,0,0,0,0,0,0,0
20200316,051891,智邦元富95購04,,,,,0.00,0.00,0,0,0,0,0,0,0,0,0,0,0,0,0
20200316,051892,台光電元富95購03,,,,,0.00,0.00,0,0,0,0,0,0,0,0,0,0,0,0,0
20200316,051893,瀚宇博元富95購01,,,,,0.00,0.00,0,0,0,0,0,0,0,0,0,0,0,0,0
20200316,051894,嘉聯益元富95購03,,,,,0.00,0.00,0,0,0,0,0,0,0,0,0,0,0,0,0
20200316,051895,聯茂元富95購02,,,,,0.00,0.00,0,0,0,0,0,0,0,0,0,0,0,0,0
20200316,051896,柏文元富95購01,,,,,0.00,0.00,0,0,0,0,0,0,0,0,0,0,0,0,0
20200316,051897,台光電國泰97購01,0.58,0.58,0.58,0.58,+0.05,9.43,49000,1,28420,0,0,0,0,0,0,49000,0,49000,49000
20200316,051898,富邦金國泰97購01,0.29,0.29,0.20,0.20,+0.04,25.0,100000,2,24500,0,0,0,0,0,0,0,100000,-100000,-100000
20200316,051899,欣興國泰97購01,0.11,0.11,0.09,0.09,-0.02,-18.18,7000,3,710,0,0,0,0,0,0,0,7000,-7000,-7000
20200316,05189P,新光金凱基97售02,1.33,1.44,1.33,1.44,+0.19,15.2,98000,7,137630,0,0,0,0,0,0,33000,65000,-32000,-32000
20200316,051900,臻鼎富邦95購01,,,,,0.00,0.00,0,0,0,0,0,0,0,0,0,0,0,0,0
20200316,051901,嘉聯益富邦96購01,,,,,0.00,0.00,0,0,0,0,0,0,0,0,0,0,0,0,0
20200316,051902,T50反1元大97購01,1.82,1.84,1.63,1.84,+0.02,1.1,87000,10,152280,0,0,0,0,0,0,27000,60000,-33000,-33000
20200316,051903,T50反1元大97購02,,,,,0.00,0.00,0,0,0,0,0,0,0,0,0,0,0,0,0
20200316,051904,深100元大95購01,0.59,0.60,0.50,0.50,-0.15,-23.08,50000,5,28200,0,0,0,0,0,0,0,50000,-50000,-50000
20200316,051905,道瓊銀元大95購01,,,,,0.00,0.00,0,0,0,0,0,0,0,0,0,0,0,0,0
20200316,051906,國巨元大95購09,1.08,1.08,0.58,0.58,-0.49,-45.79,40000,4,28500,0,0,0,0,0,0,20000,20000,0,0
20200316,051907,台積電元大97購05,0.70,0.81,0.54,0.54,-0.26,-32.5,219000,37,130130,0,0,0,0,0,0,0,210000,-210000,-210000
20200316,051908,國泰金元大96購02,0.13,0.13,0.13,0.13,0.00,0.00,5000,1,650,0,0,0,0,0,0,0,5000,-5000,-5000
20200316,051909,潤泰全元大95購02,,,,,0.00,0.00,0,0,0,0,0,0,0,0,0,0,0,0,0
20200316,05190P,鴻海國票96售02,,,,,0.00,0.00,0,0,0,0,0,0,0,0,0,0,0,0,0
20200316,051910,大立光元大97購01,0.27,0.27,0.15,0.15,-0.16,-51.61,46000,7,8480,0,0,0,0,0,0,4000,42000,-38000,-38000
20200316,051911,大立光元大98購02,0.69,0.69,0.42,0.42,-0.26,-38.24,2502000,272,1381570,66000,0,66000,0,0,0,215000,2279000,-2064000,-1998000
20200316,051912,健鼎元大96購01,0.09,0.09,0.09,0.09,0.00,0.00,13000,1,1170,0,0,0,0,0,0,13000,0,13000,13000
20200316,051913,緯創元大96購01,,,,,0.00,0.00,0,0,0,0,0,0,0,0,0,0,0,0,0
20200316,051914,健策元大96購06,1.06,1.11,1.06,1.11,+0.31,38.75,30000,3,32600,0,0,0,0,0,0,0,30000,-30000,-30000
20200316,051915,日月光元大96購01,,,,,0.00,0.00,0,0,0,0,0,0,0,0,0,0,0,0,0
20200316,051916,和碩元大95購02,0.05,0.05,0.05,0.05,0.00,0.00,15000,1,750,0,0,0,0,0,0,15000,0,15000,15000
20200316,051917,瑞儀元大95購01,,,,,0.00,0.00,0,0,0,0,0,0,0,0,0,0,0,0,0
20200316,051918,聯茂元大95購01,0.64,0.68,0.41,0.45,-0.23,-33.82,113000,12,63860,0,0,0,0,0,0,67000,66000,1000,1000
20200316,051919,台郡元大96購02,0.78,0.78,0.64,0.64,-0.17,-20.99,124000,14,94460,0,0,0,0,0,0,10000,114000,-104000,-104000
20200316,05191P,鴻海台新95售01,,,,,0.00,0.00,0,0,0,0,0,0,0,0,0,0,0,0,0
20200316,051920,南茂元大95購03,0.05,0.05,0.05,0.05,+0.02,66.67,1000,1,50,0,0,0,0,0,0,0,0,0,0
20200316,051921,南茂元大95購04,,,,,0.00,0.00,0,0,0,0,0,0,0,0,0,0,0,0,0
20200316,051922,鴻海亞東96購02,,,,,0.00,0.00,0,0,0,0,0,0,0,0,0,0,0,0,0
20200316,051923,聯發科日盛95購02,,,,,0.00,0.00,0,0,0,0,0,0,0,0,0,0,0,0,0
20200316,051924,聯茂日盛95購01,0.18,0.18,0.18,0.18,+0.02,12.5,10000,1,1800,0,0,0,0,0,0,10000,0,10000,10000
20200316,051925,瀚宇博第一95購01,,,,,0.00,0.00,0,0,0,0,0,0,0,0,0,0,0,0,0
20200316,051926,聯電中信97購01,,,,,0.00,0.00,0,0,0,0,0,0,0,0,0,0,0,0,0
20200316,051927,國巨中信96購01,0.44,0.44,0.40,0.40,+0.02,5.26,20000,3,8600,0,0,0,0,0,0,15000,0,15000,15000
20200316,051928,大立光中信96購03,0.10,0.11,0.08,0.08,-0.08,-50.0,60000,6,5700,0,0,0,0,0,0,0,20000,-20000,-20000
20200316,051929,GIS中信96購01,0.03,0.03,0.03,0.03,0.00,0.00,20000,1,600,0,0,0,0,0,0,20000,0,20000,20000
20200316,05192P,玉晶光台新96售02,1.58,1.99,1.58,1.86,+0.09,5.08,414000,8,752290,0,0,0,0,0,0,210000,404000,-194000,-194000
20200316,051930,國泰金兆豐97購01,,,,,0.00,0.00,0,0,0,0,0,0,0,0,0,0,0,0,0
20200316,051931,美律國票96購02,0.57,0.73,0.47,0.47,-0.11,-18.97,236000,13,150970,0,0,0,0,0,0,195000,40000,155000,155000
20200316,051932,康控國票96購02,,,,,0.00,0.00,0,0,0,0,0,0,0,0,0,0,0,0,0
20200316,051933,嘉聯益國票97購03,,,,,0.00,0.00,0,0,0,0,0,0,0,0,0,0,0,0,0
20200316,051934,緯穎國票96購01,7.50,7.50,6.65,6.65,+0.15,2.31,15000,5,109700,0,0,0,0,0,0,15000,0,15000,15000
20200316,051935,味全群益95購01,,,,,0.00,0.00,0,0,0,0,0,0,0,0,0,0,0,0,0
20200316,051936,力山群益95購02,,,,,0.00,0.00,0,0,0,0,0,0,0,0,0,0,0,0,0
20200316,051937,廣達群益95購01,,,,,0.00,0.00,0,0,0,0,0,0,0,0,0,0,0,0,0
20200316,051938,旭富群益95購01,1.33,1.36,0.83,0.83,-0.24,-22.43,32000,7,34710,0,0,0,0,0,0,32000,0,32000,32000
20200316,051939,同欣電群益97購01,0.99,0.99,0.91,0.91,+0.11,13.75,22000,2,20900,0,0,0,0,0,0,11000,11000,0,0
20200316,05193P,台郡台新95售01,,,,,0.00,0.00,0,0,0,0,0,0,0,0,0,0,0,0,0
20200316,051940,康舒群益95購01,,,,,0.00,0.00,0,0,0,0,0,0,0,0,0,0,0,0,0
20200316,051941,樺漢群益95購02,,,,,0.00,0.00,0,0,0,0,0,0,0,0,0,0,0,0,0
20200316,051942,寶成群益95購01,,,,,0.00,0.00,0,0,0,0,0,0,0,0,0,0,0,0,0
20200316,051943,台積電麥證95購03,0.19,0.19,0.18,0.18,-0.17,-48.57,23000,2,4340,0,23000,-23000,0,0,0,0,23000,-23000,-23000
20200316,051944,智邦統一95購02,,,,,0.00,0.00,0,0,0,0,0,0,0,0,0,0,0,0,0
20200316,051945,智邦統一95購03,,,,,0.00,0.00,0,0,0,0,0,0,0,0,0,0,0,0,0
20200316,051946,健策統一98購01,,,,,0.00,0.00,0,0,0,0,0,0,0,0,0,0,0,0,0
20200316,051947,矽力統一95購01,,,,,0.00,0.00,0,0,0,0,0,0,0,0,0,0,0,0,0
20200316,051948,滬深2X元富9B購01,0.31,0.31,0.31,0.31,-0.02,-6.06,40000,1,12400,0,0,0,0,0,0,40000,0,40000,40000
20200316,051949,鴻海元富95購08,,,,,0.00,0.00,0,0,0,0,0,0,0,0,0,0,0,0,0
20200316,05194P,玉晶光康和95售01,0.70,0.86,0.70,0.86,+0.08,10.26,359000,6,263820,0,0,0,0,0,0,0,359000,-359000,-359000
20200316,051950,旺宏元富95購02,1.32,1.35,1.18,1.35,+0.18,15.38,405000,9,503550,0,0,0,0,0,0,400000,5000,395000,395000
20200316,051951,聯發科元富95購02,,,,,0.00,0.00,0,0,0,0,0,0,0,0,0,0,0,0,0
20200316,051952,聯發科元富95購03,,,,,0.00,0.00,0,0,0,0,0,0,0,0,0,0,0,0,0
20200316,051953,矽力元富95購03,,,,,0.00,0.00,0,0,0,0,0,0,0,0,0,0,0,0,0
20200316,051954,矽力元富95購04,,,,,0.00,0.00,0,0,0,0,0,0,0,0,0,0,0,0,0
20200316,051955,寶成元富95購01,,,,,0.00,0.00,0,0,0,0,0,0,0,0,0,0,0,0,0
20200316,051956,滬深2X台新96購01,,,,,0.00,0.00,0,0,0,0,0,0,0,0,0,0,0,0,0
20200316,051957,旺宏台新95購02,0.92,0.94,0.52,0.52,-0.24,-31.58,1319000,34,864760,0,0,0,0,0,0,622000,797000,-175000,-175000
20200316,051958,貿聯台新95購01,,,,,0.00,0.00,0,0,0,0,0,0,0,0,0,0,0,0,0
20200316,051959,台郡台新95購03,0.11,0.11,0.06,0.06,-0.04,-40.0,34000,5,2180,0,0,0,0,0,0,32000,2000,30000,30000
20200316,05195P,南茂康和95售01,,,,,0.00,0.00,0,0,0,0,0,0,0,0,0,0,0,0,0
20200316,051960,美食永豐95購01,,,,,0.00,0.00,0,0,0,0,0,0,0,0,0,0,0,0,0
20200316,051961,泰碩永豐95購01,0.28,0.28,0.13,0.13,-0.09,-40.91,155000,12,33850,0,0,0,0,0,0,20000,135000,-115000,-115000
20200316,051962,晶相光永豐95購02,,,,,0.00,0.00,0,0,0,0,0,0,0,0,0,0,0,0,0
20200316,051963,利勤永豐95購01,,,,,0.00,0.00,0,0,0,0,0,0,0,0,0,0,0,0,0
20200316,051965,傳奇永豐95購01,,,,,0.00,0.00,0,0,0,0,0,0,0,0,0,0,0,0,0
20200316,051966,台表科永豐95購01,,,,,0.00,0.00,0,0,0,0,0,0,0,0,0,0,0,0,0
20200316,051967,康友永豐95購02,,,,,0.00,0.00,0,0,0,0,0,0,0,0,0,0,0,0,0
20200316,051968,勤誠永豐95購01,,,,,0.00,0.00,0,0,0,0,0,0,0,0,0,0,0,0,0
20200316,051969,世紀鋼永豐95購01,2.16,2.27,2.04,2.20,+0.47,27.17,160000,10,346750,0,0,0,0,0,0,140000,20000,120000,120000
20200316,05196P,台積電永豐95售03,1.17,1.55,1.17,1.55,+0.59,61.46,52000,7,63120,0,0,0,0,0,0,0,52000,-52000,-52000
20200316,051970,元黃金凱基98購01,0.57,0.57,0.38,0.44,-0.09,-16.98,923000,35,379210,0,0,0,0,0,0,92000,813000,-721000,-721000
20200316,051971,元金2X凱基97購02,0.45,0.45,0.28,0.31,-0.19,-38.0,367000,42,116860,0,0,0,0,0,0,0,252000,-252000,-252000
20200316,051972,廣達凱基95購02,,,,,0.00,0.00,0,0,0,0,0,0,0,0,0,0,0,0,0
20200316,051973,華新科凱基96購04,0.56,0.56,0.53,0.53,+0.04,8.16,15000,2,8100,0,0,0,0,0,0,15000,0,15000,15000
20200316,051974,華新科凱基96購05,0.42,0.42,0.27,0.27,+0.03,12.5,64000,7,17880,0,0,0,0,0,0,0,64000,-64000,-64000
20200316,051975,美食凱基95購02,,,,,0.00,0.00,0,0,0,0,0,0,0,0,0,0,0,0,0
20200316,051976,淘帝凱基95購01,,,,,0.00,0.00,0,0,0,0,0,0,0,0,0,0,0,0,0
20200316,051977,泰碩凱基95購01,0.18,0.18,0.06,0.06,0.00,0.00,540000,16,76600,0,0,0,0,0,0,140000,400000,-260000,-260000
20200316,051978,泰碩凱基96購01,0.18,0.22,0.10,0.11,-0.06,-35.29,258000,29,41280,0,0,0,0,0,0,157000,101000,56000,56000
20200316,051979,群創凱基97購01,0.34,0.34,0.25,0.25,-0.09,-26.47,109000,7,31660,0,0,0,0,0,0,104000,105000,-1000,-1000
20200316,05197P,智原永豐95售02,,,,,0.00,0.00,0,0,0,0,0,0,0,0,0,0,0,0,0
20200316,051980,樺漢凱基96購01,,,,,0.00,0.00,0,0,0,0,0,0,0,0,0,0,0,0,0
20200316,051981,南茂凱基96購01,,,,,0.00,0.00,0,0,0,0,0,0,0,0,0,0,0,0,0
20200316,051982,深中小元大95購01,1.48,1.48,1.28,1.29,-0.06,-4.44,30000,3,40500,0,0,0,0,0,0,10000,20000,-10000,-10000
20200316,051983,道瓊反元大95購01,3.17,3.19,3.16,3.19,+0.07,2.24,14000,3,44370,0,0,0,0,0,0,0,14000,-14000,-14000
20200316,051984,台塑元大95購01,,,,,0.00,0.00,0,0,0,0,0,0,0,0,0,0,0,0,0
20200316,051985,智邦元大95購05,0.41,0.51,0.41,0.42,+0.04,10.53,88000,9,39810,0,0,0,0,0,0,88000,78000,10000,10000
20200316,051986,燿華元大96購04,,,,,0.00,0.00,0,0,0,0,0,0,0,0,0,0,0,0,0
20200316,051987,廣達元大95購01,0.85,0.85,0.49,0.53,-0.32,-37.65,272000,24,192270,0,0,0,0,0,0,139000,172000,-33000,-33000
20200316,051988,台光電元大95購01,0.25,0.25,0.22,0.22,+0.03,15.79,15000,2,3600,0,0,0,0,0,0,10000,5000,5000,5000
20200316,051989,華固元大95購02,0.64,0.79,0.64,0.73,-0.13,-15.12,90000,10,64600,0,0,0,0,0,0,40000,50000,-10000,-10000
20200316,05198P,牧德永豐95售02,,,,,0.00,0.00,0,0,0,0,0,0,0,0,0,0,0,0,0
20200316,051990,泰碩元大95購01,0.58,0.58,0.47,0.47,+0.17,56.67,150000,2,76000,0,0,0,0,0,0,150000,0,150000,150000
20200316,051991,泰碩元大95購02,0.76,0.76,0.43,0.44,+0.05,12.82,145000,11,85450,0,0,0,0,0,0,145000,90000,55000,55000
20200316,051993,和碩元大95購03,,,,,0.00,0.00,0,0,0,0,0,0,0,0,0,0,0,0,0
20200316,051994,瀚宇博元大96購01,,,,,0.00,0.00,0,0,0,0,0,0,0,0,0,0,0,0,0
20200316,051995,矽力元大95購03,0.58,0.58,0.28,0.28,-0.25,-47.17,128000,17,49010,0,0,0,0,0,0,0,128000,-128000,-128000
20200316,051996,康友元大95購01,,,,,0.00,0.00,0,0,0,0,0,0,0,0,0,0,0,0,0
20200316,051997,康友元大95購02,,,,,0.00,0.00,0,0,0,0,0,0,0,0,0,0,0,0,0
20200316,051998,昇陽半元大96購02,,,,,0.00,0.00,0,0,0,0,0,0,0,0,0,0,0,0,0
20200316,051999,勤誠元大95購01,0.81,0.85,0.62,0.62,-0.16,-20.51,142000,7,115300,0,0,0,0,0,0,132000,5000,127000,127000
20200316,05199P,訊芯永豐95售02,,,,,0.00,0.00,0,0,0,0,0,0,0,0,0,0,0,0,0
20200316,052000,鈺齊元大95購03,0.02,0.02,0.02,0.02,0.00,0.00,20000,1,400,0,0,0,0,0,0,20000,0,20000,20000
20200316,052001,寶成元大95購02,,,,,0.00,0.00,0,0,0,0,0,0,0,0,0,0,0,0,0
20200316,052002,滬深2X國泰96購01,,,,,0.00,0.00,0,0,0,0,0,0,0,0,0,0,0,0,0
20200316,052003,泰碩國泰97購02,1.06,1.23,0.70,0.70,-0.36,-33.96,2108000,96,2211770,0,0,0,0,0,0,1431000,1307000,124000,124000
20200316,052004,泰碩國泰97購03,0.88,0.98,0.55,0.55,-0.31,-36.05,426000,27,318860,0,0,0,0,0,0,164000,262000,-98000,-98000
20200316,052005,矽力國泰97購02,1.35,1.57,1.35,1.43,+0.08,5.93,342000,6,516040,0,0,0,0,0,0,310000,32000,278000,278000
20200316,052006,康友富邦98購01,0.27,0.27,0.27,0.27,-0.03,-10.0,477000,1,128790,0,0,0,0,0,0,477000,0,477000,477000
20200316,052007,滬深2X第一95購01,,,,,0.00,0.00,0,0,0,0,0,0,0,0,0,0,0,0,0
20200316,052008,創意第一95購01,,,,,0.00,0.00,0,0,0,0,0,0,0,0,0,0,0,0,0
20200316,052009,群創第一95購01,,,,,0.00,0.00,0,0,0,0,0,0,0,0,0,0,0,0,0
20200316,05200P,臺股指永豐95售03,,,,,0.00,0.00,0,0,0,0,0,0,0,0,0,0,0,0,0
20200316,052010,兆豐金中信95購01,0.72,0.75,0.71,0.71,+0.01,1.43,170000,10,121750,0,0,0,0,0,0,165000,5000,160000,160000
20200316,052011,欣興中信96購01,0.01,0.01,0.01,0.01,-0.01,-50.0,550000,4,5500,0,0,0,0,0,0,249000,0,249000,249000
20200316,052012,聯發科台新95購02,,,,,0.00,0.00,0,0,0,0,0,0,0,0,0,0,0,0,0
20200316,052013,台積電永豐95購04,0.10,0.10,0.10,0.10,0.00,0.00,107000,2,10700,0,0,0,0,0,0,0,6000,-6000,-6000
20200316,052014,光罩永豐95購01,,,,,0.00,0.00,0,0,0,0,0,0,0,0,0,0,0,0,0
20200316,052015,漢唐永豐95購02,,,,,0.00,0.00,0,0,0,0,0,0,0,0,0,0,0,0,0
20200316,052016,神基永豐95購01,0.82,0.82,0.82,0.82,+0.21,34.43,68000,4,55760,0,0,0,0,0,0,0,68000,-68000,-68000
20200316,052017,奇鋐永豐95購01,0.10,0.10,0.10,0.10,+0.03,42.86,5000,1,500,0,0,0,0,0,0,5000,0,5000,5000
20200316,052018,京鼎永豐95購02,0.01,0.01,0.01,0.01,0.00,0.00,80000,2,800,0,0,0,0,0,0,80000,0,80000,80000
20200316,052019,創意永豐95購02,,,,,0.00,0.00,0,0,0,0,0,0,0,0,0,0,0,0,0
20200316,05201P,玉晶光國泰97售02,1.11,1.33,1.06,1.33,+0.22,19.82,2766000,66,3153020,0,0,0,0,0,0,1511000,1904000,-393000,-393000
20200316,052020,聯茂永豐95購02,0.48,0.55,0.36,0.36,-0.02,-5.26,149000,11,68210,0,0,0,0,0,0,1000,148000,-147000,-147000
20200316,052021,易華電永豐95購03,,,,,0.00,0.00,0,0,0,0,0,0,0,0,0,0,0,0,0
20200316,052022,南電永豐95購03,,,,,0.00,0.00,0,0,0,0,0,0,0,0,0,0,0,0,0
20200316,052023,鈺齊永豐95購02,,,,,0.00,0.00,0,0,0,0,0,0,0,0,0,0,0,0,0
20200316,052024,臺股指永豐95購04,,,,,0.00,0.00,0,0,0,0,0,0,0,0,0,0,0,0,0
20200316,052025,國巨群益96購01,,,,,0.00,0.00,0,0,0,0,0,0,0,0,0,0,0,0,0
20200316,052026,漢唐群益95購01,0.64,0.64,0.64,0.64,+0.12,23.08,60000,2,38400,0,0,0,0,0,0,60000,0,60000,60000
20200316,052027,智原群益95購01,,,,,0.00,0.00,0,0,0,0,0,0,0,0,0,0,0,0,0
20200316,052028,健策群益95購02,,,,,0.00,0.00,0,0,0,0,0,0,0,0,0,0,0,0,0
20200316,052029,矽力群益95購02,0.41,0.41,0.41,0.41,0.00,0.00,5000,1,2050,0,0,0,0,0,0,0,5000,-5000,-5000
20200316,05202P,鴻海元大95售16,,,,,0.00,0.00,0,0,0,0,0,0,0,0,0,0,0,0,0
20200316,052030,GIS群益95購04,,,,,0.00,0.00,0,0,0,0,0,0,0,0,0,0,0,0,0
20200316,052031,臺股指群益95購04,,,,,0.00,0.00,0,0,0,0,0,0,0,0,0,0,0,0,0
20200316,052032,臺股指群益95購05,,,,,0.00,0.00,0,0,0,0,0,0,0,0,0,0,0,0,0
20200316,052033,臺股指群益95購06,,,,,0.00,0.00,0,0,0,0,0,0,0,0,0,0,0,0,0
20200316,052034,臺股指群益95購07,,,,,0.00,0.00,0,0,0,0,0,0,0,0,0,0,0,0,0
20200316,052035,臺股指群益95購08,,,,,0.00,0.00,0,0,0,0,0,0,0,0,0,0,0,0,0
20200316,052036,臺股指群益95購09,,,,,0.00,0.00,0,0,0,0,0,0,0,0,0,0,0,0,0
20200316,052037,全新國泰96購02,,,,,0.00,0.00,0,0,0,0,0,0,0,0,0,0,0,0,0
20200316,052038,國巨永昌96購01,2.30,2.37,2.30,2.37,+0.27,12.86,10000,2,23350,0,0,0,0,0,0,0,10000,-10000,-10000
20200316,052039,聯詠永昌96購01,,,,,0.00,0.00,0,0,0,0,0,0,0,0,0,0,0,0,0
20200316,05203P,華新科元大95售10,1.02,1.66,1.02,1.66,0.00,0.00,161000,18,185550,0,0,0,0,0,0,159000,161000,-2000,-2000
20200316,052040,臺股指永昌95購01,0.15,0.15,0.15,0.15,0.00,0.00,100000,1,15000,0,0,0,0,0,0,0,100000,-100000,-100000
20200316,052041,鴻海日盛95購02,0.02,0.02,0.02,0.02,+0.01,100.0,70000,2,1400,0,0,0,0,0,0,0,0,0,0
20200316,052042,台積電日盛95購02,0.50,0.51,0.25,0.32,-0.22,-40.74,1328000,38,506620,0,0,0,0,0,0,1198000,104000,1094000,1094000
20200316,052043,瑞昱日盛95購01,,,,,0.00,0.00,0,0,0,0,0,0,0,0,0,0,0,0,0
20200316,052044,華通凱基97購01,,,,,0.00,0.00,0,0,0,0,0,0,0,0,0,0,0,0,0
20200316,052045,瑞昱凱基96購01,,,,,0.00,0.00,0,0,0,0,0,0,0,0,0,0,0,0,0
20200316,052046,漢唐凱基96購01,,,,,0.00,0.00,0,0,0,0,0,0,0,0,0,0,0,0,0
20200316,052047,建準凱基96購01,0.18,0.18,0.18,0.18,0.00,0.00,100000,1,18000,0,0,0,0,0,0,0,100000,-100000,-100000
20200316,052048,景碩凱基95購01,,,,,0.00,0.00,0,0,0,0,0,0,0,0,0,0,0,0,0
20200316,052049,緯創凱基97購01,,,,,0.00,0.00,0,0,0,0,0,0,0,0,0,0,0,0,0
20200316,05204P,TPK元大95售03,1.80,1.80,1.80,1.80,+0.17,10.43,25000,2,45000,0,0,0,0,0,0,25000,0,25000,25000
20200316,052050,明泰凱基95購01,,,,,0.00,0.00,0,0,0,0,0,0,0,0,0,0,0,0,0
20200316,052051,京鼎凱基95購01,,,,,0.00,0.00,0,0,0,0,0,0,0,0,0,0,0,0,0
20200316,052052,嘉澤凱基95購02,,,,,0.00,0.00,0,0,0,0,0,0,0,0,0,0,0,0,0
20200316,052053,泰鼎凱基96購01,0.87,0.89,0.57,0.63,-0.22,-25.88,759000,37,574710,0,0,0,0,0,0,440000,319000,121000,121000
20200316,052054,台表科凱基96購01,,,,,0.00,0.00,0,0,0,0,0,0,0,0,0,0,0,0,0
20200316,052055,緯穎凱基95購03,2.12,2.12,2.12,2.12,+1.17,123.16,1000,1,2120,0,0,0,0,0,0,0,0,0,0
20200316,052056,緯穎凱基95購04,4.45,4.45,3.77,3.77,+0.36,10.56,42000,3,172400,0,0,0,0,0,0,40000,2000,38000,38000
20200316,052057,臺股指凱基95購15,0.04,0.04,0.04,0.04,-0.06,-60.0,60000,1,2400,0,0,0,0,0,0,60000,0,60000,60000
20200316,052058,臺股指凱基95購16,0.14,0.16,0.12,0.12,+0.05,71.43,259000,10,32580,0,0,0,0,0,0,109000,0,109000,109000
20200316,052059,臺股指凱基95購17,0.02,0.02,0.02,0.02,0.00,0.00,100000,10,2000,0,0,0,0,0,0,0,100000,-100000,-100000
20200316,05205P,緯穎元大95售03,0.16,0.20,0.16,0.20,-0.10,-33.33,243000,25,40540,0,0,0,0,0,0,0,243000,-243000,-243000
20200316,052060,旺宏國票96購02,0.74,0.74,0.47,0.47,-0.23,-32.86,22000,4,14660,0,0,0,0,0,0,10000,6000,4000,4000
20200316,052061,樺漢國票96購01,,,,,0.00,0.00,0,0,0,0,0,0,0,0,0,0,0,0,0
20200316,052062,臺股指國票95購09,0.27,0.27,0.27,0.27,-0.06,-18.18,1000,1,270,0,0,0,0,0,0,1000,0,1000,1000
20200316,052063,臺股指國票95購10,,,,,0.00,0.00,0,0,0,0,0,0,0,0,0,0,0,0,0
20200316,052064,臺股指國票95購11,,,,,0.00,0.00,0,0,0,0,0,0,0,0,0,0,0,0,0
20200316,052065,臺股指國票95購12,,,,,0.00,0.00,0,0,0,0,0,0,0,0,0,0,0,0,0
20200316,052066,華邦電兆豐96購01,0.19,0.20,0.09,0.09,-0.08,-47.06,1304000,50,176130,0,0,0,0,0,0,92000,1212000,-1120000,-1120000
20200316,052067,中磊兆豐96購01,0.28,0.29,0.25,0.25,+0.01,4.17,108000,6,30100,0,0,0,0,0,0,8000,53000,-45000,-45000
20200316,052068,瑞儀兆豐96購01,,,,,0.00,0.00,0,0,0,0,0,0,0,0,0,0,0,0,0
20200316,052069,聯茂兆豐96購01,0.39,0.39,0.36,0.36,+0.10,38.46,74000,3,27060,0,0,0,0,0,0,0,74000,-74000,-74000
20200316,05206P,南茂元大95售01,,,,,0.00,0.00,0,0,0,0,0,0,0,0,0,0,0,0,0
20200316,052070,GIS兆豐95購03,,,,,0.00,0.00,0,0,0,0,0,0,0,0,0,0,0,0,0
20200316,052071,臺股指兆豐95購01,,,,,0.00,0.00,0,0,0,0,0,0,0,0,0,0,0,0,0
20200316,052072,健策統一95購02,,,,,0.00,0.00,0,0,0,0,0,0,0,0,0,0,0,0,0
20200316,052073,矽力統一95購03,,,,,0.00,0.00,0,0,0,0,0,0,0,0,0,0,0,0,0
20200316,052074,鴻海元富95購10,0.01,0.01,0.01,0.01,0.00,0.00,998000,2,9980,0,0,0,0,0,0,998000,0,998000,998000
20200316,052075,旺宏元富95購03,0.37,0.41,0.37,0.40,+0.14,53.85,100000,10,39200,0,0,0,0,0,0,100000,0,100000,100000
20200316,052076,可成元富98購01,0.42,0.42,0.42,0.42,+0.11,35.48,10000,1,4200,0,0,0,0,0,0,0,10000,-10000,-10000
20200316,052077,可成元富98購02,,,,,0.00,0.00,0,0,0,0,0,0,0,0,0,0,0,0,0
20200316,052078,大立光元富95購10,0.58,0.58,0.30,0.30,-0.28,-48.28,246000,7,135880,0,0,0,0,0,0,186000,40000,146000,146000
20200316,052079,康友元富98購01,0.95,0.95,0.64,0.64,-0.14,-17.95,63000,7,52670,0,0,0,0,0,0,13000,50000,-37000,-37000
20200316,05207P,高股息中信97售03,2.36,2.36,2.36,2.36,0.00,0.00,5000,1,11800,0,0,0,0,0,0,0,5000,-5000,-5000
20200316,052080,康友元富98購02,0.81,0.81,0.53,0.53,-0.27,-33.75,54000,7,37420,0,0,0,0,0,0,10000,42000,-32000,-32000
20200316,052081,臺股指元富95購03,,,,,0.00,0.00,0,0,0,0,0,0,0,0,0,0,0,0,0
20200316,052082,臺股指元富95購04,,,,,0.00,0.00,0,0,0,0,0,0,0,0,0,0,0,0,0
20200316,052083,S&P反1元大97購02,1.55,1.55,1.55,1.55,+0.25,19.23,1000,1,1550,0,0,0,0,0,0,0,1000,-1000,-1000
20200316,052084,台泥元大95購01,0.60,0.60,0.57,0.57,+0.05,9.62,60000,4,34710,0,0,0,0,0,0,60000,7000,53000,53000
20200316,052085,聯電元大95購01,0.23,0.23,0.23,0.23,-0.03,-11.54,20000,2,4600,0,0,0,0,0,0,20000,0,20000,20000
20200316,052086,鴻海元大96購08,,,,,0.00,0.00,0,0,0,0,0,0,0,0,0,0,0,0,0
20200316,052087,鴻海元大96購09,,,,,0.00,0.00,0,0,0,0,0,0,0,0,0,0,0,0,0
20200316,052088,漢唐元大95購02,,,,,0.00,0.00,0,0,0,0,0,0,0,0,0,0,0,0,0
20200316,052089,聯發科元大96購02,0.15,0.16,0.11,0.11,0.00,0.00,24000,3,3240,0,0,0,0,0,0,4000,20000,-16000,-16000
20200316,05208P,TPK中信95售01,,,,,0.00,0.00,0,0,0,0,0,0,0,0,0,0,0,0,0
20200316,052090,聯發科元大97購03,0.11,0.11,0.09,0.09,-0.02,-18.18,200000,11,19800,0,0,0,0,0,0,100000,100000,0,0
20200316,052091,緯創元大95購04,0.05,0.06,0.05,0.06,+0.02,50.0,30000,2,1600,0,0,0,0,0,0,30000,0,30000,30000
20200316,052092,貿聯元大96購02,,,,,0.00,0.00,0,0,0,0,0,0,0,0,0,0,0,0,0
20200316,052093,麗豐元大96購04,,,,,0.00,0.00,0,0,0,0,0,0,0,0,0,0,0,0,0
20200316,052094,瀚宇博元大96購02,0.15,0.15,0.15,0.15,+0.01,7.14,30000,1,4500,0,0,0,0,0,0,30000,0,30000,30000
20200316,052095,彩晶元大97購01,0.46,0.46,0.40,0.40,-0.06,-13.04,40000,6,17770,0,0,0,0,0,0,10000,30000,-20000,-20000
20200316,052096,力成元大95購01,,,,,0.00,0.00,0,0,0,0,0,0,0,0,0,0,0,0,0
20200316,052097,GIS元大95購05,0.12,0.12,0.08,0.09,+0.01,12.5,484000,7,40770,0,0,0,0,0,0,429000,55000,374000,374000
20200316,052098,臺股指富邦95購01,,,,,0.00,0.00,0,0,0,0,0,0,0,0,0,0,0,0,0
20200316,052099,臺股指富邦95購02,,,,,0.00,0.00,0,0,0,0,0,0,0,0,0,0,0,0,0
20200316,05209P,鴻海凱基96售09,1.44,2.12,1.44,2.12,+0.38,21.84,453000,28,743920,0,0,0,0,0,0,200000,253000,-53000,-53000
20200316,052100,滬深2X永昌96購01,,,,,0.00,0.00,0,0,0,0,0,0,0,0,0,0,0,0,0
20200316,052101,滬深2X兆豐96購01,0.28,0.29,0.21,0.21,-0.12,-36.36,679000,14,186430,0,0,0,0,0,0,0,679000,-679000,-679000
20200316,052102,台泥兆豐96購01,,,,,0.00,0.00,0,0,0,0,0,0,0,0,0,0,0,0,0
20200316,052103,台積電兆豐95購06,,,,,0.00,0.00,0,0,0,0,0,0,0,0,0,0,0,0,0
20200316,052104,英業達兆豐96購01,0.37,0.37,0.32,0.33,-0.07,-17.5,634000,7,214780,0,0,0,0,0,0,288000,346000,-58000,-58000
20200316,052105,南亞科兆豐95購01,0.21,0.21,0.14,0.14,0.00,0.00,500000,8,89000,0,0,0,0,0,0,100000,400000,-300000,-300000
20200316,052106,明泰兆豐95購01,,,,,0.00,0.00,0,0,0,0,0,0,0,0,0,0,0,0,0
20200316,052107,台積電統一95購06,0.40,0.40,0.20,0.20,-0.15,-42.86,72000,3,16400,0,0,0,0,0,0,12000,10000,2000,2000
20200316,052108,鴻海元富95購11,,,,,0.00,0.00,0,0,0,0,0,0,0,0,0,0,0,0,0
20200316,052109,可成元富95購01,,,,,0.00,0.00,0,0,0,0,0,0,0,0,0,0,0,0,0
20200316,05210P,台積電凱基95售15,0.20,0.20,0.20,0.20,0.00,0.00,200000,1,40000,0,0,0,0,0,0,200000,0,200000,200000
20200316,052110,可成元富95購02,,,,,0.00,0.00,0,0,0,0,0,0,0,0,0,0,0,0,0
20200316,052111,智原元富95購01,,,,,0.00,0.00,0,0,0,0,0,0,0,0,0,0,0,0,0
20200316,052112,滬深2X中信99購01,0.17,0.17,0.15,0.15,0.00,0.00,90000,2,14700,0,0,0,0,0,0,0,90000,-90000,-90000
20200316,052113,漢唐中信98購01,0.22,0.22,0.17,0.17,-0.01,-5.56,20000,2,3900,0,0,0,0,0,0,0,20000,-20000,-20000
20200316,052114,華固中信95購01,0.07,0.07,0.06,0.07,-0.01,-12.5,455000,15,31150,0,0,0,0,0,0,255000,200000,55000,55000
20200316,052115,T50反1國票95購03,2.18,2.56,2.18,2.56,+0.38,17.43,21000,3,50880,0,0,0,0,0,0,10000,0,10000,10000
20200316,052116,T50反1國票97購01,,,,,0.00,0.00,0,0,0,0,0,0,0,0,0,0,0,0,0
20200316,052117,鴻海國票96購03,,,,,0.00,0.00,0,0,0,0,0,0,0,0,0,0,0,0,0
20200316,052118,鴻海國票96購04,,,,,0.00,0.00,0,0,0,0,0,0,0,0,0,0,0,0,0
20200316,052119,漢唐國票96購01,0.50,0.50,0.50,0.50,+0.07,16.28,30000,1,15000,0,0,0,0,0,0,30000,0,30000,30000
20200316,05211P,國巨國票96售05,,,,,0.00,0.00,0,0,0,0,0,0,0,0,0,0,0,0,0
20200316,052120,友達國票96購01,0.44,0.44,0.41,0.41,0.00,0.00,170000,12,71800,0,0,0,0,0,0,60000,110000,-50000,-50000
20200316,052121,全新國票96購03,,,,,0.00,0.00,0,0,0,0,0,0,0,0,0,0,0,0,0
20200316,052122,新光金國票96購01,,,,,0.00,0.00,0,0,0,0,0,0,0,0,0,0,0,0,0
20200316,052123,泰碩國票95購01,0.33,0.33,0.09,0.09,-0.18,-66.67,289000,7,73890,0,0,0,0,0,0,279000,10000,269000,269000
20200316,052124,京鼎國票95購01,,,,,0.00,0.00,0,0,0,0,0,0,0,0,0,0,0,0,0
20200316,052125,群創國票95購02,0.25,0.25,0.15,0.15,-0.07,-31.82,120000,12,19600,0,0,0,0,0,0,0,120000,-120000,-120000
20200316,052126,群創國票97購01,0.16,0.16,0.14,0.15,+0.01,7.14,50000,5,7600,0,0,0,0,0,0,0,50000,-50000,-50000
20200316,052127,日月光國票96購01,,,,,0.00,0.00,0,0,0,0,0,0,0,0,0,0,0,0,0
20200316,052128,聯發科日盛95購03,,,,,0.00,0.00,0,0,0,0,0,0,0,0,0,0,0,0,0
20200316,052129,鴻海凱基97購02,,,,,0.00,0.00,0,0,0,0,0,0,0,0,0,0,0,0,0
20200316,05212P,台積電國票96售04,3.15,3.15,3.15,3.15,-0.09,-2.78,1000,1,3150,0,0,0,0,0,0,1000,0,1000,1000
20200316,052130,國巨凱基9B購01,0.98,1.17,0.78,0.78,-0.27,-25.71,286000,49,268180,0,0,0,0,0,0,20000,197000,-177000,-177000
20200316,052131,台積電凱基96購01,,,,,0.00,0.00,0,0,0,0,0,0,0,0,0,0,0,0,0
20200316,052132,旺宏凱基9B購01,0.77,0.77,0.64,0.64,-0.01,-1.54,10000,5,7070,0,0,0,0,0,0,3000,7000,-4000,-4000
20200316,052133,華邦電凱基9B購01,0.32,0.32,0.19,0.19,-0.10,-34.48,167000,16,45710,0,0,0,0,0,0,45000,122000,-77000,-77000
20200316,052134,智邦凱基95購09,0.75,0.85,0.68,0.68,-0.20,-22.73,150000,9,115400,0,0,0,0,0,0,40000,70000,-30000,-30000
20200316,052135,聯發科凱基9B購01,0.33,0.35,0.28,0.28,-0.07,-20.0,183000,15,53800,0,0,0,0,0,0,8000,1000,7000,7000
20200316,052136,瑞儀凱基95購01,,,,,0.00,0.00,0,0,0,0,0,0,0,0,0,0,0,0,0
20200316,052137,台表科凱基96購02,,,,,0.00,0.00,0,0,0,0,0,0,0,0,0,0,0,0,0
20200316,052138,易華電凱基97購01,,,,,0.00,0.00,0,0,0,0,0,0,0,0,0,0,0,0,0
20200316,052139,矽創凱基95購01,,,,,0.00,0.00,0,0,0,0,0,0,0,0,0,0,0,0,0
20200316,05213P,台積電國票96售05,,,,,0.00,0.00,0,0,0,0,0,0,0,0,0,0,0,0,0
20200316,052140,鈺齊凱基95購02,,,,,0.00,0.00,0,0,0,0,0,0,0,0,0,0,0,0,0
20200316,052141,百和凱基95購02,,,,,0.00,0.00,0,0,0,0,0,0,0,0,0,0,0,0,0
20200316,052142,滬深2X群益99購04,0.55,0.55,0.48,0.48,0.00,0.00,22000,2,11750,0,0,0,0,0,0,0,22000,-22000,-22000
20200316,052143,鴻海群益95購09,,,,,0.00,0.00,0,0,0,0,0,0,0,0,0,0,0,0,0
20200316,052144,鴻海群益95購10,,,,,0.00,0.00,0,0,0,0,0,0,0,0,0,0,0,0,0
20200316,052145,京元電群益95購02,,,,,0.00,0.00,0,0,0,0,0,0,0,0,0,0,0,0,0
20200316,052146,泰碩群益95購01,0.62,0.62,0.37,0.37,+0.02,5.71,183000,6,103960,0,0,0,0,0,0,53000,130000,-77000,-77000
20200316,052147,上緯控群益95購01,,,,,0.00,0.00,0,0,0,0,0,0,0,0,0,0,0,0,0
20200316,052148,康友群益95購03,,,,,0.00,0.00,0,0,0,0,0,0,0,0,0,0,0,0,0
20200316,052149,電子類群益95購01,,,,,0.00,0.00,0,0,0,0,0,0,0,0,0,0,0,0,0
20200316,05214P,台積電國票97售02,0.41,0.55,0.41,0.55,+0.20,57.14,44000,4,20140,0,0,0,0,0,0,44000,0,44000,44000
20200316,052150,台積電富邦95購07,0.08,0.08,0.06,0.06,-0.01,-14.29,1373000,40,90510,0,0,0,0,0,0,0,0,0,0
20200316,052151,義隆富邦96購01,,,,,0.00,0.00,0,0,0,0,0,0,0,0,0,0,0,0,0
20200316,052152,創意富邦98購01,0.16,0.16,0.10,0.10,0.00,0.00,395000,7,59700,0,0,0,0,0,0,30000,355000,-325000,-325000
20200316,052153,GIS富邦96購02,,,,,0.00,0.00,0,0,0,0,0,0,0,0,0,0,0,0,0
20200316,052154,緯創台新95購01,,,,,0.00,0.00,0,0,0,0,0,0,0,0,0,0,0,0,0
20200316,052155,百和台新95購01,,,,,0.00,0.00,0,0,0,0,0,0,0,0,0,0,0,0,0
20200316,052156,滬深2X永豐95購03,,,,,0.00,0.00,0,0,0,0,0,0,0,0,0,0,0,0,0
20200316,052157,東元永豐95購01,,,,,0.00,0.00,0,0,0,0,0,0,0,0,0,0,0,0,0
20200316,052158,華泰永豐95購01,,,,,0.00,0.00,0,0,0,0,0,0,0,0,0,0,0,0,0
20200316,052159,瑞昱永豐95購01,0.18,0.18,0.17,0.17,-0.01,-5.56,4000,2,700,0,0,0,0,0,0,4000,0,4000,4000
20200316,05215P,台積電台新95售03,0.92,1.32,0.86,1.32,+0.47,55.29,1613000,18,1872260,0,0,0,0,0,0,1613000,1567000,46000,46000
20200316,052160,美律永豐95購03,,,,,0.00,0.00,0,0,0,0,0,0,0,0,0,0,0,0,0
20200316,052161,義隆永豐95購03,,,,,0.00,0.00,0,0,0,0,0,0,0,0,0,0,0,0,0
20200316,052162,智伸科永豐95購01,,,,,0.00,0.00,0,0,0,0,0,0,0,0,0,0,0,0,0
20200316,052163,康舒永豐95購02,,,,,0.00,0.00,0,0,0,0,0,0,0,0,0,0,0,0,0
20200316,052164,啟碁永豐95購01,,,,,0.00,0.00,0,0,0,0,0,0,0,0,0,0,0,0,0
20200316,052165,訊芯永豐95購03,,,,,0.00,0.00,0,0,0,0,0,0,0,0,0,0,0,0,0
20200316,052166,元油反元大95購01,,,,,0.00,0.00,0,0,0,0,0,0,0,0,0,0,0,0,0
20200316,052167,亞泥元大96購01,0.61,0.62,0.56,0.59,-0.14,-19.18,313000,28,183350,0,0,0,0,0,0,90000,223000,-133000,-133000
20200316,052168,鴻海元大96購10,,,,,0.00,0.00,0,0,0,0,0,0,0,0,0,0,0,0,0
20200316,052169,鴻海元大97購02,,,,,0.00,0.00,0,0,0,0,0,0,0,0,0,0,0,0,0
20200316,05216P,國巨永豐95售02,0.29,0.30,0.29,0.30,+0.12,66.67,25000,3,7450,0,0,0,0,0,0,0,25000,-25000,-25000
20200316,052170,台積電元大95購20,0.15,0.15,0.14,0.14,+0.04,40.0,31000,2,4640,0,0,0,0,0,0,31000,1000,30000,30000
20200316,052171,台積電元大95購21,0.42,0.42,0.19,0.19,-0.31,-62.0,874000,91,265020,0,0,0,0,0,0,31000,824000,-793000,-793000
20200316,052172,致茂元大95購01,0.54,0.54,0.32,0.32,-0.10,-23.81,110000,4,54800,0,0,0,0,0,0,90000,20000,70000,70000
20200316,052173,廣達元大95購02,0.40,0.40,0.24,0.25,-0.20,-44.44,235000,24,78550,0,0,0,0,0,0,10000,225000,-215000,-215000
20200316,052174,聯發科元大95購13,,,,,0.00,0.00,0,0,0,0,0,0,0,0,0,0,0,0,0
20200316,052175,可成元大95購10,,,,,0.00,0.00,0,0,0,0,0,0,0,0,0,0,0,0,0
20200316,052176,景碩元大96購01,0.10,0.10,0.10,0.10,+0.03,42.86,250000,1,25000,0,0,0,0,0,0,250000,0,250000,250000
20200316,052177,京鼎元大95購02,,,,,0.00,0.00,0,0,0,0,0,0,0,0,0,0,0,0,0
20200316,052178,台郡元大96購03,0.12,0.12,0.08,0.10,0.00,0.00,1188000,104,120780,0,0,0,0,0,0,120000,1018000,-898000,-898000
20200316,052179,康友元大95購03,0.18,0.18,0.12,0.12,-0.13,-52.0,271000,22,36120,0,0,0,0,0,0,71000,200000,-129000,-129000
20200316,05217P,鴻海統一95售08,,,,,0.00,0.00,0,0,0,0,0,0,0,0,0,0,0,0,0
20200316,052180,緯穎元大96購05,2.83,2.83,2.48,2.56,+0.25,10.82,22000,7,58290,0,0,0,0,0,0,14000,8000,6000,6000
20200316,052181,南茂元大95購05,0.06,0.06,0.05,0.05,+0.01,25.0,6000,2,310,0,0,0,0,0,0,6000,0,6000,6000
20200316,052182,鴻海群益96購01,0.16,0.16,0.13,0.13,-0.06,-31.58,90000,3,12900,0,0,0,0,0,0,0,90000,-90000,-90000
20200316,052183,華邦電群益95購01,,,,,0.00,0.00,0,0,0,0,0,0,0,0,0,0,0,0,0
20200316,052184,台光電群益95購03,0.53,0.53,0.53,0.53,+0.13,32.5,6000,1,3180,0,0,0,0,0,0,6000,6000,0,0
20200316,052185,奇力新群益95購03,,,,,0.00,0.00,0,0,0,0,0,0,0,0,0,0,0,0,0
20200316,052186,宏達電群益95購04,,,,,0.00,0.00,0,0,0,0,0,0,0,0,0,0,0,0,0
20200316,052187,奇鋐群益95購03,,,,,0.00,0.00,0,0,0,0,0,0,0,0,0,0,0,0,0
20200316,052188,欣興群益95購03,,,,,0.00,0.00,0,0,0,0,0,0,0,0,0,0,0,0,0
20200316,052189,玉晶光群益96購06,,,,,0.00,0.00,0,0,0,0,0,0,0,0,0,0,0,0,0
20200316,05218P,大立光永昌96售04,4.84,4.84,4.84,4.84,-1.51,-23.78,20000,1,96800,0,0,0,0,0,0,20000,0,20000,20000
20200316,052190,創意群益95購03,,,,,0.00,0.00,0,0,0,0,0,0,0,0,0,0,0,0,0
20200316,052191,超眾群益96購01,1.38,1.38,1.38,1.38,+0.09,6.98,6000,1,8280,0,0,0,0,0,0,0,6000,-6000,-6000
20200316,052192,SP黃豆元富95購04,0.15,0.15,0.14,0.14,0.00,0.00,125000,3,18130,0,0,0,0,0,0,63000,62000,1000,1000
20200316,052193,國巨元富95購06,,,,,0.00,0.00,0,0,0,0,0,0,0,0,0,0,0,0,0
20200316,052194,旺宏元富95購04,,,,,0.00,0.00,0,0,0,0,0,0,0,0,0,0,0,0,0
20200316,052195,健策元富95購01,,,,,0.00,0.00,0,0,0,0,0,0,0,0,0,0,0,0,0
20200316,052196,TPK元富95購01,,,,,0.00,0.00,0,0,0,0,0,0,0,0,0,0,0,0,0
20200316,052197,台郡元富95購03,,,,,0.00,0.00,0,0,0,0,0,0,0,0,0,0,0,0,0
20200316,052198,鴻海統一95購10,,,,,0.00,0.00,0,0,0,0,0,0,0,0,0,0,0,0,0
20200316,052199,鴻海統一95購11,,,,,0.00,0.00,0,0,0,0,0,0,0,0,0,0,0,0,0
20200316,05219P,鴻海元大95售17,8.55,8.55,8.55,8.55,+1.35,18.75,17000,1,145350,0,0,0,0,0,0,17000,0,17000,17000
20200316,052200,台光電統一95購02,0.76,0.76,0.76,0.76,0.00,0.00,60000,1,45600,0,0,0,0,0,0,60000,0,60000,60000
20200316,052201,超眾統一96購01,1.35,1.35,1.12,1.12,+0.15,15.46,45000,5,57700,0,0,0,0,0,0,0,45000,-45000,-45000
20200316,052202,矽力統一96購01,0.93,0.93,0.88,0.88,0.00,0.00,2000,2,1810,0,0,0,0,0,0,0,2000,-2000,-2000
20200316,052203,T50反1中信99購03,2.05,2.05,2.05,2.05,-0.03,-1.44,5000,1,10250,0,0,0,0,0,0,5000,0,5000,5000
20200316,052204,台泥中信96購01,,,,,0.00,0.00,0,0,0,0,0,0,0,0,0,0,0,0,0
20200316,052205,台積電中信95購09,0.10,0.10,0.10,0.10,-0.06,-37.5,10000,1,1000,0,0,0,0,0,0,0,10000,-10000,-10000
20200316,052206,燿華中信95購02,0.02,0.02,0.02,0.02,0.00,0.00,125000,13,2500,0,0,0,0,0,0,0,125000,-125000,-125000
20200316,052207,台郡中信95購02,0.10,0.10,0.10,0.10,0.00,0.00,20000,1,2000,0,0,0,0,0,0,0,20000,-20000,-20000
20200316,052208,力成麥證95購01,,,,,0.00,0.00,0,0,0,0,0,0,0,0,0,0,0,0,0
20200316,052209,深中小元大95購02,0.53,0.53,0.53,0.53,-0.20,-27.4,20000,1,10600,0,0,0,0,0,0,20000,0,20000,20000
20200316,05220P,台積電元大95售16,,,,,0.00,0.00,0,0,0,0,0,0,0,0,0,0,0,0,0
20200316,052210,華夏元大95購01,,,,,0.00,0.00,0,0,0,0,0,0,0,0,0,0,0,0,0
20200316,052211,台積電元大95購22,0.11,0.11,0.11,0.11,-0.04,-26.67,11000,2,1210,0,0,0,0,0,0,1000,1000,0,0
20200316,052212,可成元大95購11,,,,,0.00,0.00,0,0,0,0,0,0,0,0,0,0,0,0,0
20200316,052213,富邦金元大95購01,0.11,0.11,0.09,0.09,+0.01,12.5,70000,7,6700,0,0,0,0,0,0,0,70000,-70000,-70000
20200316,052214,智伸科元大96購01,,,,,0.00,0.00,0,0,0,0,0,0,0,0,0,0,0,0,0
20200316,052215,樺漢元大96購02,0.12,0.12,0.12,0.12,0.00,0.00,65000,1,7800,0,0,0,0,0,0,65000,0,65000,65000
20200316,052216,康友元大96購01,0.61,0.65,0.40,0.40,-0.27,-40.3,75000,11,39080,0,0,0,0,0,0,25000,50000,-25000,-25000
20200316,052217,台光電日盛95購01,,,,,0.00,0.00,0,0,0,0,0,0,0,0,0,0,0,0,0
20200316,052218,大立光日盛95購01,0.22,0.22,0.05,0.05,-0.05,-50.0,85000,2,5950,0,0,0,0,0,0,85000,10000,75000,75000
20200316,052219,大立光日盛95購02,,,,,0.00,0.00,0,0,0,0,0,0,0,0,0,0,0,0,0
20200316,05221P,玉晶光元大95售04,0.35,0.56,0.33,0.52,+0.16,44.44,529000,52,235940,0,0,0,0,0,0,122000,406000,-284000,-284000
20200316,052220,T50反1凱基98購01,,,,,0.00,0.00,0,0,0,0,0,0,0,0,0,0,0,0,0
20200316,052221,東元凱基95購01,,,,,0.00,0.00,0,0,0,0,0,0,0,0,0,0,0,0,0
20200316,052222,力山凱基95購02,,,,,0.00,0.00,0,0,0,0,0,0,0,0,0,0,0,0,0
20200316,052223,聯電凱基96購02,0.42,0.43,0.42,0.43,0.00,0.00,78000,5,32860,0,0,0,0,0,0,78000,0,78000,78000
20200316,052224,楠梓電凱基97購01,,,,,0.00,0.00,0,0,0,0,0,0,0,0,0,0,0,0,0
20200316,052225,台積電凱基96購03,0.07,0.07,0.06,0.07,-0.04,-36.36,114000,7,7410,0,0,0,0,0,0,0,0,0,0
20200316,052226,旺宏凱基95購06,0.15,0.15,0.15,0.15,+0.05,50.0,30000,1,4500,0,0,0,0,0,0,30000,0,30000,30000
20200316,052227,瑞昱凱基95購05,0.14,0.14,0.14,0.14,-0.03,-17.65,20000,1,2800,0,0,0,0,0,0,20000,20000,0,0
20200316,052228,聯發科凱基96購06,,,,,0.00,0.00,0,0,0,0,0,0,0,0,0,0,0,0,0
20200316,052229,奇力新凱基96購01,0.63,0.63,0.63,0.63,0.00,0.00,7000,1,4410,0,0,0,0,0,0,7000,0,7000,7000
20200316,05222P,致伸凱基95售02,4.43,4.43,4.43,4.43,-0.44,-9.03,10000,1,44300,0,0,0,0,0,0,0,10000,-10000,-10000
20200316,052230,大立光凱基96購09,0.62,0.62,0.42,0.42,-0.08,-16.0,4000,2,2080,0,0,0,0,0,0,2000,2000,0,0
20200316,052231,景碩凱基96購01,,,,,0.00,0.00,0,0,0,0,0,0,0,0,0,0,0,0,0
20200316,052232,貿聯凱基96購02,,,,,0.00,0.00,0,0,0,0,0,0,0,0,0,0,0,0,0
20200316,052233,台郡凱基96購01,,,,,0.00,0.00,0,0,0,0,0,0,0,0,0,0,0,0,0
20200316,052234,GIS凱基97購01,0.10,0.10,0.10,0.10,0.00,0.00,20000,2,2000,0,0,0,0,0,0,0,20000,-20000,-20000
20200316,052235,聯發科國票96購02,,,,,0.00,0.00,0,0,0,0,0,0,0,0,0,0,0,0,0
20200316,052236,聯發科國票96購03,,,,,0.00,0.00,0,0,0,0,0,0,0,0,0,0,0,0,0
20200316,052237,嘉澤國票96購02,0.56,0.56,0.33,0.33,-0.05,-13.16,13000,3,6670,0,0,0,0,0,0,10000,3000,7000,7000
20200316,052238,智易國票96購01,,,,,0.00,0.00,0,0,0,0,0,0,0,0,0,0,0,0,0
20200316,052239,泰鼎國票97購01,1.28,1.28,1.28,1.28,+0.43,50.59,200000,2,256000,0,0,0,0,0,0,200000,0,200000,200000
20200316,05223P,臻鼎凱基95售02,4.52,4.52,4.52,4.52,0.00,0.00,10000,2,45200,0,0,0,0,0,0,10000,0,10000,10000
20200316,052240,臻鼎國票96購03,,,,,0.00,0.00,0,0,0,0,0,0,0,0,0,0,0,0,0
20200316,052241,台郡國票96購01,,,,,0.00,0.00,0,0,0,0,0,0,0,0,0,0,0,0,0
20200316,052242,台達電台新96購01,,,,,0.00,0.00,0,0,0,0,0,0,0,0,0,0,0,0,0
20200316,052243,致茂康和95購01,,,,,0.00,0.00,0,0,0,0,0,0,0,0,0,0,0,0,0
20200316,052244,廣達康和95購01,,,,,0.00,0.00,0,0,0,0,0,0,0,0,0,0,0,0,0
20200316,052245,緯創康和95購01,,,,,0.00,0.00,0,0,0,0,0,0,0,0,0,0,0,0,0
20200316,052246,超眾康和95購01,,,,,0.00,0.00,0,0,0,0,0,0,0,0,0,0,0,0,0
20200316,052247,深中小永豐95購01,,,,,0.00,0.00,0,0,0,0,0,0,0,0,0,0,0,0,0
20200316,052248,元油反永豐95購01,,,,,0.00,0.00,0,0,0,0,0,0,0,0,0,0,0,0,0
20200316,052249,大成鋼永豐95購01,0.37,0.40,0.37,0.40,-0.02,-4.76,42000,3,16440,0,0,0,0,0,0,42000,0,42000,42000
20200316,05224P,華通統一95售03,4.08,4.66,4.08,4.66,+0.24,5.43,30000,3,130800,0,0,0,0,0,0,10000,20000,-10000,-10000
20200316,052250,光磊永豐95購01,,,,,0.00,0.00,0,0,0,0,0,0,0,0,0,0,0,0,0
20200316,052251,台光電永豐95購03,,,,,0.00,0.00,0,0,0,0,0,0,0,0,0,0,0,0,0
20200316,052252,大立光永豐95購03,0.44,0.44,0.28,0.28,-0.25,-47.17,14000,3,4860,0,0,0,0,0,0,0,14000,-14000,-14000
20200316,052253,康控永豐95購04,,,,,0.00,0.00,0,0,0,0,0,0,0,0,0,0,0,0,0
20200316,052254,康友永豐95購03,,,,,0.00,0.00,0,0,0,0,0,0,0,0,0,0,0,0,0
20200316,052255,T50反1國泰96購01,,,,,0.00,0.00,0,0,0,0,0,0,0,0,0,0,0,0,0
20200316,052256,台泥國泰96購01,1.31,1.31,1.31,1.31,+0.29,28.43,90000,1,117900,0,0,0,0,0,0,90000,0,90000,90000
20200316,052257,燿華國泰96購01,,,,,0.00,0.00,0,0,0,0,0,0,0,0,0,0,0,0,0
20200316,052258,滬深2X富邦96購04,,,,,0.00,0.00,0,0,0,0,0,0,0,0,0,0,0,0,0
20200316,052259,深100富邦95購01,,,,,0.00,0.00,0,0,0,0,0,0,0,0,0,0,0,0,0
20200316,05225P,鴻海統一95售09,,,,,0.00,0.00,0,0,0,0,0,0,0,0,0,0,0,0,0
20200316,052260,為升富邦97購02,,,,,0.00,0.00,0,0,0,0,0,0,0,0,0,0,0,0,0
20200316,052261,台泥第一95購01,,,,,0.00,0.00,0,0,0,0,0,0,0,0,0,0,0,0,0
20200316,052262,華新亞東95購02,,,,,0.00,0.00,0,0,0,0,0,0,0,0,0,0,0,0,0
20200316,052263,聯電亞東95購01,,,,,0.00,0.00,0,0,0,0,0,0,0,0,0,0,0,0,0
20200316,052264,台達電亞東96購01,,,,,0.00,0.00,0,0,0,0,0,0,0,0,0,0,0,0,0
20200316,052265,聯發科亞東95購01,,,,,0.00,0.00,0,0,0,0,0,0,0,0,0,0,0,0,0
20200316,052266,義隆亞東95購02,,,,,0.00,0.00,0,0,0,0,0,0,0,0,0,0,0,0,0
20200316,052267,可成亞東95購02,,,,,0.00,0.00,0,0,0,0,0,0,0,0,0,0,0,0,0
20200316,052268,新光金亞東96購01,,,,,0.00,0.00,0,0,0,0,0,0,0,0,0,0,0,0,0
20200316,052269,T50反1日盛9B購01,1.62,1.80,1.62,1.79,+0.23,14.74,137000,10,235430,0,0,0,0,0,0,5000,132000,-127000,-127000
20200316,05226P,智邦統一95售01,,,,,0.00,0.00,0,0,0,0,0,0,0,0,0,0,0,0,0
20200316,052270,力成日盛95購01,,,,,0.00,0.00,0,0,0,0,0,0,0,0,0,0,0,0,0
20200316,052271,力成日盛95購02,,,,,0.00,0.00,0,0,0,0,0,0,0,0,0,0,0,0,0
20200316,052272,T50反1群益95購03,1.38,1.60,1.38,1.58,+0.25,18.8,138000,15,212130,0,0,0,0,0,0,3000,135000,-132000,-132000
20200316,052273,新光金群益95購02,,,,,0.00,0.00,0,0,0,0,0,0,0,0,0,0,0,0,0
20200316,052274,大立光群益95購03,0.70,0.70,0.70,0.70,+0.35,100.0,10000,1,7000,0,0,0,0,0,0,0,10000,-10000,-10000
20200316,052275,日月光群益95購01,,,,,0.00,0.00,0,0,0,0,0,0,0,0,0,0,0,0,0
20200316,052276,力成群益96購01,,,,,0.00,0.00,0,0,0,0,0,0,0,0,0,0,0,0,0
20200316,052277,台達電凱基97購01,,,,,0.00,0.00,0,0,0,0,0,0,0,0,0,0,0,0,0
20200316,052278,國巨凱基95購06,1.03,1.03,1.03,1.03,-0.29,-21.97,1000,1,1030,0,0,0,0,0,0,1000,0,1000,1000
20200316,052279,旺宏凱基95購07,,,,,0.00,0.00,0,0,0,0,0,0,0,0,0,0,0,0,0
20200316,05227P,大立光統一95售04,,,,,0.00,0.00,0,0,0,0,0,0,0,0,0,0,0,0,0
20200316,052280,聯發科凱基95購11,0.14,0.14,0.14,0.14,0.00,0.00,10000,1,1400,0,0,0,0,0,0,10000,10000,0,0
20200316,052281,全新凱基97購01,,,,,0.00,0.00,0,0,0,0,0,0,0,0,0,0,0,0,0
20200316,052282,宏達電凱基95購05,0.30,0.30,0.30,0.30,+0.05,20.0,11000,1,3300,0,0,0,0,0,0,11000,11000,0,0
20200316,052283,TPK凱基97購01,,,,,0.00,0.00,0,0,0,0,0,0,0,0,0,0,0,0,0
20200316,052284,日月光凱基96購01,,,,,0.00,0.00,0,0,0,0,0,0,0,0,0,0,0,0,0
20200316,052285,康控凱基95購02,,,,,0.00,0.00,0,0,0,0,0,0,0,0,0,0,0,0,0
20200316,052286,力成凱基95購02,,,,,0.00,0.00,0,0,0,0,0,0,0,0,0,0,0,0,0
20200316,052287,臺股指中信95購12,,,,,0.00,0.00,0,0,0,0,0,0,0,0,0,0,0,0,0
20200316,052288,敦南統一95購01,,,,,0.00,0.00,0,0,0,0,0,0,0,0,0,0,0,0,0
20200316,052289,為升元富95購02,,,,,0.00,0.00,0,0,0,0,0,0,0,0,0,0,0,0,0
20200316,05228P,大立光元富95售09,3.35,3.35,3.35,3.35,0.00,0.00,1000,1,3350,0,0,0,0,0,0,1000,0,1000,1000
20200316,052290,鴻海元富97購01,0.11,0.11,0.10,0.10,0.00,0.00,20000,2,2100,0,0,0,0,0,0,10000,10000,0,0
20200316,052291,鴻海元富97購02,,,,,0.00,0.00,0,0,0,0,0,0,0,0,0,0,0,0,0
20200316,052292,緯穎元富95購02,2.02,2.19,1.99,1.99,+0.09,4.74,170000,20,358410,0,0,0,0,0,0,130000,20000,110000,110000
20200316,052293,泰碩國票95購03,0.92,0.96,0.41,0.41,-0.43,-51.19,218000,10,198990,0,0,0,0,0,0,208000,10000,198000,198000
20200316,052294,創意國票96購03,,,,,0.00,0.00,0,0,0,0,0,0,0,0,0,0,0,0,0
20200316,052295,揚明光國票96購03,,,,,0.00,0.00,0,0,0,0,0,0,0,0,0,0,0,0,0
20200316,052296,TPK國票96購01,,,,,0.00,0.00,0,0,0,0,0,0,0,0,0,0,0,0,0
20200316,052297,旭富國票96購01,1.46,1.46,1.15,1.15,+0.12,11.65,170000,16,228270,0,0,0,0,0,0,37000,133000,-96000,-96000
20200316,052298,易華電國票96購01,,,,,0.00,0.00,0,0,0,0,0,0,0,0,0,0,0,0,0
20200316,052299,T50反1台新05購03,,,,,0.00,0.00,0,0,0,0,0,0,0,0,0,0,0,0,0
20200316,05229P,台積電群益95售05,3.08,3.42,3.08,3.42,+0.72,26.67,95000,9,305000,0,0,0,0,0,0,30000,65000,-35000,-35000
20200316,052300,力成台新95購01,0.34,0.34,0.33,0.33,-0.15,-31.25,68000,3,23040,0,0,0,0,0,0,68000,0,68000,68000
20200316,052301,華通康和95購01,,,,,0.00,0.00,0,0,0,0,0,0,0,0,0,0,0,0,0
20200316,052302,鴻海永豐95購06,,,,,0.00,0.00,0,0,0,0,0,0,0,0,0,0,0,0,0
20200316,052303,聯發科永豐95購05,,,,,0.00,0.00,0,0,0,0,0,0,0,0,0,0,0,0,0
20200316,052304,可成永豐95購03,,,,,0.00,0.00,0,0,0,0,0,0,0,0,0,0,0,0,0
20200316,052305,GIS永豐95購03,,,,,0.00,0.00,0,0,0,0,0,0,0,0,0,0,0,0,0
20200316,052306,鴻海國泰97購05,,,,,0.00,0.00,0,0,0,0,0,0,0,0,0,0,0,0,0
20200316,052307,潤泰全國泰96購01,0.47,0.49,0.43,0.48,-0.11,-18.64,418000,9,192780,0,0,0,0,0,0,258000,160000,98000,98000
20200316,052308,大立光國泰97購02,0.46,0.46,0.46,0.46,+0.17,58.62,6000,1,2760,0,0,0,0,0,0,6000,0,6000,6000
20200316,052309,健策國泰97購01,0.52,0.58,0.52,0.54,-0.02,-3.57,147000,19,79330,0,0,0,0,0,0,147000,0,147000,147000
20200316,05230P,京元電群益95售01,3.62,3.62,3.62,3.62,-1.28,-26.12,4000,1,14480,0,0,0,0,0,0,0,4000,-4000,-4000
20200316,052310,聯電富邦95購01,,,,,0.00,0.00,0,0,0,0,0,0,0,0,0,0,0,0,0
20200316,052311,台積電富邦95購09,0.14,0.21,0.10,0.16,-0.08,-33.33,38000,6,5900,0,0,0,0,0,0,23000,20000,3000,3000
20200316,052312,美律富邦96購02,0.15,0.15,0.11,0.11,+0.02,22.22,60000,2,8200,0,0,0,0,0,0,60000,0,60000,60000
20200316,052313,聯電元大98購01,0.58,0.59,0.54,0.54,-0.03,-5.26,189000,8,110010,0,0,0,0,0,0,174000,15000,159000,159000
20200316,052314,鴻海元大96購11,,,,,0.00,0.00,0,0,0,0,0,0,0,0,0,0,0,0,0
20200316,052315,廣宇元大95購02,,,,,0.00,0.00,0,0,0,0,0,0,0,0,0,0,0,0,0
20200316,052316,台積電元大96購10,0.35,0.38,0.27,0.28,-0.08,-22.22,62000,10,19650,0,0,0,0,0,0,0,32000,-32000,-32000
20200316,052317,台積電元大96購11,0.36,0.36,0.35,0.35,-0.15,-30.0,12000,2,4220,0,0,0,0,0,0,0,10000,-10000,-10000
20200316,052318,友達元大98購01,,,,,0.00,0.00,0,0,0,0,0,0,0,0,0,0,0,0,0
20200316,052319,可成元大95購12,,,,,0.00,0.00,0,0,0,0,0,0,0,0,0,0,0,0,0
20200316,05231P,GIS群益95售03,,,,,0.00,0.00,0,0,0,0,0,0,0,0,0,0,0,0,0
20200316,052320,緯創元大95購05,,,,,0.00,0.00,0,0,0,0,0,0,0,0,0,0,0,0,0
20200316,052321,華擎元大95購01,2.74,3.07,2.29,2.29,+0.14,6.51,61000,10,170310,0,0,0,0,0,0,0,60000,-60000,-60000
20200316,052322,力成元大96購01,,,,,0.00,0.00,0,0,0,0,0,0,0,0,0,0,0,0,0
20200316,052323,矽力元大95購04,0.97,0.97,0.61,0.61,-0.41,-40.2,45000,5,33900,0,0,0,0,0,0,0,45000,-45000,-45000
20200316,052324,康友元大96購02,0.65,0.65,0.39,0.39,-0.28,-41.79,87000,11,42590,0,0,0,0,0,0,5000,83000,-78000,-78000
20200316,052325,高股息中信99購01,1.12,1.15,0.89,0.89,-0.23,-20.54,979000,54,992750,0,0,0,0,0,0,596000,381000,215000,215000
20200316,052326,滬深反中信99購01,1.04,1.13,1.01,1.12,+0.14,14.29,967000,18,1044810,0,0,0,0,0,0,431000,536000,-105000,-105000
20200316,052327,聯詠中信95購03,,,,,0.00,0.00,0,0,0,0,0,0,0,0,0,0,0,0,0
20200316,052328,台表科中信99購01,0.13,0.13,0.12,0.12,+0.02,20.0,110000,2,14200,0,0,0,0,0,0,110000,0,110000,110000
20200316,052329,台積電亞東96購01,0.59,0.63,0.46,0.63,+0.01,1.61,165000,11,96600,0,0,0,0,0,0,165000,160000,5000,5000
20200316,05232P,緯穎群益95售01,,,,,0.00,0.00,0,0,0,0,0,0,0,0,0,0,0,0,0
20200316,052330,燿華亞東95購01,,,,,0.00,0.00,0,0,0,0,0,0,0,0,0,0,0,0,0
20200316,052331,漢唐亞東97購01,,,,,0.00,0.00,0,0,0,0,0,0,0,0,0,0,0,0,0
20200316,052332,美律亞東96購01,,,,,0.00,0.00,0,0,0,0,0,0,0,0,0,0,0,0,0
20200316,052333,嘉聯益兆豐96購01,,,,,0.00,0.00,0,0,0,0,0,0,0,0,0,0,0,0,0
20200316,052334,大成鋼日盛95購01,0.17,0.20,0.14,0.14,+0.02,16.67,42000,3,6600,0,0,0,0,0,0,40000,0,40000,40000
20200316,052335,新光金日盛95購02,,,,,0.00,0.00,0,0,0,0,0,0,0,0,0,0,0,0,0
20200316,052336,矽力日盛95購01,,,,,0.00,0.00,0,0,0,0,0,0,0,0,0,0,0,0,0
20200316,052337,臺股指日盛95購02,,,,,0.00,0.00,0,0,0,0,0,0,0,0,0,0,0,0,0
20200316,052338,道瓊反凱基97購02,2.98,2.99,2.82,2.82,-0.12,-4.08,40000,6,115190,0,0,0,0,0,0,9000,40000,-31000,-31000
20200316,052339,光寶科凱基95購01,,,,,0.00,0.00,0,0,0,0,0,0,0,0,0,0,0,0,0
20200316,05233P,台郡台新95售02,,,,,0.00,0.00,0,0,0,0,0,0,0,0,0,0,0,0,0
20200316,052340,燿華凱基96購01,,,,,0.00,0.00,0,0,0,0,0,0,0,0,0,0,0,0,0
20200316,052341,泰鼎凱基96購02,1.27,1.29,1.07,1.07,-0.19,-15.08,123000,14,149950,0,0,0,0,0,0,123000,0,123000,123000
20200316,052342,茂林凱基96購01,0.40,0.40,0.30,0.30,-0.10,-25.0,81000,28,27910,0,0,0,0,0,0,50000,24000,26000,26000
20200316,052343,同欣電凱基95購03,0.16,0.18,0.09,0.09,-0.09,-50.0,337000,17,44210,0,0,0,0,0,0,332000,5000,327000,327000
20200316,052344,台表科凱基98購01,0.05,0.05,0.05,0.05,0.00,0.00,20000,1,1000,0,0,0,0,0,0,20000,0,20000,20000
20200316,052345,矽力凱基95購01,1.39,1.46,1.03,1.03,-0.23,-18.25,247000,13,283280,0,0,0,0,0,0,220000,27000,193000,193000
20200316,052346,訊芯凱基95購01,,,,,0.00,0.00,0,0,0,0,0,0,0,0,0,0,0,0,0
20200316,052347,GIS凱基95購05,,,,,0.00,0.00,0,0,0,0,0,0,0,0,0,0,0,0,0
20200316,052348,台光電富邦95購01,,,,,0.00,0.00,0,0,0,0,0,0,0,0,0,0,0,0,0
20200316,052349,鴻海統一95購15,,,,,0.00,0.00,0,0,0,0,0,0,0,0,0,0,0,0,0
20200316,05234P,美食康和95售01,2.00,2.13,2.00,2.13,+0.33,18.33,25000,7,50830,0,0,0,0,0,0,22000,1000,21000,21000
20200316,052350,鴻海統一96購06,,,,,0.00,0.00,0,0,0,0,0,0,0,0,0,0,0,0,0
20200316,052351,中環元富95購01,,,,,0.00,0.00,0,0,0,0,0,0,0,0,0,0,0,0,0
20200316,052352,力成元富95購01,,,,,0.00,0.00,0,0,0,0,0,0,0,0,0,0,0,0,0
20200316,052353,高鐵群益97購01,,,,,0.00,0.00,0,0,0,0,0,0,0,0,0,0,0,0,0
20200316,052354,健策群益96購02,0.34,0.34,0.34,0.34,+0.07,25.93,9000,1,3060,0,0,0,0,0,0,9000,9000,0,0
20200316,052355,為升永豐95購02,,,,,0.00,0.00,0,0,0,0,0,0,0,0,0,0,0,0,0
20200316,052356,聯詠永豐95購03,,,,,0.00,0.00,0,0,0,0,0,0,0,0,0,0,0,0,0
20200316,052357,揚明光永豐95購03,,,,,0.00,0.00,0,0,0,0,0,0,0,0,0,0,0,0,0
20200316,052358,台表科永豐95購02,,,,,0.00,0.00,0,0,0,0,0,0,0,0,0,0,0,0,0
20200316,052359,百和永豐95購01,,,,,0.00,0.00,0,0,0,0,0,0,0,0,0,0,0,0,0
20200316,05235P,健鼎康和95售02,,,,,0.00,0.00,0,0,0,0,0,0,0,0,0,0,0,0,0
20200316,052360,FB上証國票96購01,,,,,0.00,0.00,0,0,0,0,0,0,0,0,0,0,0,0,0
20200316,052361,大成鋼國票96購01,,,,,0.00,0.00,0,0,0,0,0,0,0,0,0,0,0,0,0
20200316,052362,瑞昱國票96購02,0.14,0.14,0.13,0.13,-0.13,-50.0,605000,3,78770,0,0,0,0,0,0,605000,0,605000,605000
20200316,052363,廣達國票96購01,,,,,0.00,0.00,0,0,0,0,0,0,0,0,0,0,0,0,0
20200316,052364,全新國票95購02,,,,,0.00,0.00,0,0,0,0,0,0,0,0,0,0,0,0,0
20200316,052365,聯詠國票95購02,,,,,0.00,0.00,0,0,0,0,0,0,0,0,0,0,0,0,0
20200316,052366,聯詠國票96購01,,,,,0.00,0.00,0,0,0,0,0,0,0,0,0,0,0,0,0
20200316,052367,聯茂國票96購02,0.87,0.87,0.87,0.87,+0.10,12.99,38000,1,33060,0,0,0,0,0,0,38000,0,38000,38000
20200316,052368,力成國票96購01,0.15,0.15,0.15,0.15,+0.01,7.14,199000,20,29850,0,0,0,0,0,0,0,199000,-199000,-199000
20200316,052369,矽力國票96購02,,,,,0.00,0.00,0,0,0,0,0,0,0,0,0,0,0,0,0
20200316,05236P,緯穎康和95售01,,,,,0.00,0.00,0,0,0,0,0,0,0,0,0,0,0,0,0
20200316,052370,滬深2X元大95購04,,,,,0.00,0.00,0,0,0,0,0,0,0,0,0,0,0,0,0
20200316,052371,元金2X元大95購01,0.28,0.40,0.27,0.40,-0.05,-11.11,46000,11,15210,0,0,0,0,0,0,0,43000,-43000,-43000
20200316,052372,台泥元大95購02,,,,,0.00,0.00,0,0,0,0,0,0,0,0,0,0,0,0,0
20200316,052373,鴻海元大95購22,0.11,0.11,0.11,0.11,0.00,0.00,5000,1,550,0,0,0,0,0,0,5000,0,5000,5000
20200316,052374,瑞昱元大95購02,0.30,0.34,0.21,0.21,-0.22,-51.16,69000,6,20450,0,0,0,0,0,0,59000,59000,0,0
20200316,052375,奇力新元大96購02,0.52,0.57,0.33,0.33,+0.02,6.45,21000,5,9690,0,0,0,0,0,0,8000,13000,-5000,-5000
20200316,052376,聯詠元大95購04,,,,,0.00,0.00,0,0,0,0,0,0,0,0,0,0,0,0,0
20200316,052377,景碩元大96購02,,,,,0.00,0.00,0,0,0,0,0,0,0,0,0,0,0,0,0
20200316,052378,矽力元大96購01,2.36,2.36,1.43,1.43,-0.80,-35.87,72000,7,124150,0,0,0,0,0,0,46000,26000,20000,20000
20200316,052379,鈺齊元大95購04,,,,,0.00,0.00,0,0,0,0,0,0,0,0,0,0,0,0,0
20200316,05237P,為升永豐95售01,2.94,3.71,2.94,3.71,+0.84,29.27,78000,15,246600,0,0,0,0,0,0,21000,53000,-32000,-32000
20200316,052380,臺股指元大95購21,,,,,0.00,0.00,0,0,0,0,0,0,0,0,0,0,0,0,0
20200316,052381,臺股指元大95購22,,,,,0.00,0.00,0,0,0,0,0,0,0,0,0,0,0,0,0
20200316,052382,臺股指元大95購23,0.41,0.41,0.30,0.30,0.00,0.00,10000,2,3550,0,0,0,0,0,0,10000,0,10000,10000
20200316,052383,臺股指元大95購29,,,,,0.00,0.00,0,0,0,0,0,0,0,0,0,0,0,0,0
20200316,052384,臺股指元大95購30,,,,,0.00,0.00,0,0,0,0,0,0,0,0,0,0,0,0,0
20200316,052385,滬深2X群益99購05,0.83,0.86,0.69,0.69,+0.02,2.99,50000,8,40800,0,0,0,0,0,0,25000,45000,-20000,-20000
20200316,052386,鴻海群益96購02,0.24,0.25,0.24,0.25,-0.05,-16.67,140000,2,34000,0,0,0,0,0,0,40000,100000,-60000,-60000
20200316,052387,台積電群益95購08,1.13,1.13,0.70,0.72,-0.58,-44.62,371000,45,355320,0,0,0,0,0,0,0,371000,-371000,-371000
20200316,052388,旺宏群益96購05,1.02,1.02,0.71,0.71,+0.07,10.94,30000,3,24500,0,0,0,0,0,0,10000,20000,-10000,-10000
20200316,052389,聯發科群益95購05,,,,,0.00,0.00,0,0,0,0,0,0,0,0,0,0,0,0,0
20200316,05238P,禾伸堂永豐95售01,1.17,1.42,1.17,1.42,-0.03,-2.07,70000,9,89360,0,0,0,0,0,0,30000,40000,-10000,-10000
20200316,052390,聯詠群益95購03,,,,,0.00,0.00,0,0,0,0,0,0,0,0,0,0,0,0,0
20200316,052391,瑞儀群益95購01,,,,,0.00,0.00,0,0,0,0,0,0,0,0,0,0,0,0,0
20200316,052392,台表科群益96購02,,,,,0.00,0.00,0,0,0,0,0,0,0,0,0,0,0,0,0
20200316,052393,康友群益95購05,,,,,0.00,0.00,0,0,0,0,0,0,0,0,0,0,0,0,0
20200316,052394,滬深2X日盛95購01,,,,,0.00,0.00,0,0,0,0,0,0,0,0,0,0,0,0,0
20200316,052395,上証2X凱基97購01,,,,,0.00,0.00,0,0,0,0,0,0,0,0,0,0,0,0,0
20200316,052396,台積電凱基97購01,0.61,0.62,0.41,0.42,-0.34,-44.74,80000,12,41230,0,0,0,0,0,0,0,71000,-71000,-71000
20200316,052397,燿華凱基96購02,,,,,0.00,0.00,0,0,0,0,0,0,0,0,0,0,0,0,0
20200316,052398,瑞昱凱基95購06,,,,,0.00,0.00,0,0,0,0,0,0,0,0,0,0,0,0,0
20200316,052399,台光電凱基95購03,0.17,0.17,0.17,0.17,-0.01,-5.56,10000,2,1700,0,0,0,0,0,0,10000,0,10000,10000
20200316,05239P,欣興永豐95售03,4.04,4.38,3.77,4.38,+0.20,4.78,90000,9,362100,0,0,0,0,0,0,10000,80000,-70000,-70000
20200316,052400,聯詠凱基97購01,0.10,0.15,0.10,0.15,+0.02,15.38,11000,2,1150,0,0,0,0,0,0,0,10000,-10000,-10000
20200316,052401,智原凱基95購01,,,,,0.00,0.00,0,0,0,0,0,0,0,0,0,0,0,0,0
20200316,052402,健策凱基97購01,0.28,0.28,0.18,0.18,-0.07,-28.0,100000,9,22400,0,0,0,0,0,0,40000,50000,-10000,-10000
20200316,052403,麗豐凱基96購01,,,,,0.00,0.00,0,0,0,0,0,0,0,0,0,0,0,0,0
20200316,052404,臻鼎凱基95購05,,,,,0.00,0.00,0,0,0,0,0,0,0,0,0,0,0,0,0
20200316,052405,聯茂凱基95購01,0.11,0.11,0.11,0.11,0.00,0.00,90000,1,9900,0,0,0,0,0,0,90000,0,90000,90000
20200316,052406,力成凱基95購03,,,,,0.00,0.00,0,0,0,0,0,0,0,0,0,0,0,0,0
20200316,052407,樺漢凱基95購01,,,,,0.00,0.00,0,0,0,0,0,0,0,0,0,0,0,0,0
20200316,052408,羅麗芬凱基95購01,,,,,0.00,0.00,0,0,0,0,0,0,0,0,0,0,0,0,0
20200316,052409,國巨亞東95購01,0.68,0.68,0.58,0.58,0.00,0.00,300000,3,193000,0,0,0,0,0,0,300000,300000,0,0
20200316,05240P,玉晶光永豐96售01,1.20,1.20,1.20,1.20,+0.18,17.65,40000,2,48000,0,0,0,0,0,0,40000,0,40000,40000
20200316,052410,智邦亞東96購01,,,,,0.00,0.00,0,0,0,0,0,0,0,0,0,0,0,0,0
20200316,052411,嘉聯益亞東95購02,,,,,0.00,0.00,0,0,0,0,0,0,0,0,0,0,0,0,0
20200316,052412,上証2X中信98購01,,,,,0.00,0.00,0,0,0,0,0,0,0,0,0,0,0,0,0
20200316,052413,上証反中信97購01,1.16,1.24,1.16,1.24,+0.05,4.2,160000,5,193800,0,0,0,0,0,0,85000,75000,10000,10000
20200316,052414,聯電麥證95購01,,,,,0.00,0.00,0,0,0,0,0,0,0,0,0,0,0,0,0
20200316,052415,台表科麥證95購02,,,,,0.00,0.00,0,0,0,0,0,0,0,0,0,0,0,0,0
20200316,052416,滬深2X兆豐96購02,0.22,0.22,0.18,0.18,+0.03,20.0,400000,9,79000,0,0,0,0,0,0,0,400000,-400000,-400000
20200316,052417,聯發科兆豐9B購01,0.37,0.39,0.28,0.28,-0.13,-31.71,1413000,16,500390,0,0,0,0,0,0,915000,498000,417000,417000
20200316,052418,玉晶光兆豐96購01,0.98,0.98,0.72,0.72,-0.18,-20.0,11000,2,10520,0,0,0,0,0,0,10000,1000,9000,9000
20200316,052419,上証2X國票96購02,,,,,0.00,0.00,0,0,0,0,0,0,0,0,0,0,0,0,0
20200316,05241P,鴻海國泰97售04,3.33,3.74,3.33,3.72,+0.27,7.83,212000,23,754560,0,0,0,0,0,0,212000,212000,0,0
20200316,052420,道瓊反國票9B購01,2.27,2.68,2.27,2.68,+0.28,11.67,25000,3,60400,0,0,0,0,0,0,20000,5000,15000,15000
20200316,052421,元油反國票9B購01,4.56,4.56,4.45,4.45,+0.47,11.81,18000,5,81270,0,0,0,0,0,0,18000,0,18000,18000
20200316,052422,聯電國票96購03,0.43,0.43,0.43,0.43,-0.02,-4.44,68000,1,29240,0,0,0,0,0,0,68000,0,68000,68000
20200316,052423,宏達電國票96購02,0.76,0.76,0.76,0.76,+0.15,24.59,225000,2,171000,0,0,0,0,0,0,225000,0,225000,225000
20200316,052424,泰碩國票97購01,1.40,1.40,1.40,1.40,+0.07,5.26,30000,1,42000,0,0,0,0,0,0,30000,0,30000,30000
20200316,052425,華通台新95購02,,,,,0.00,0.00,0,0,0,0,0,0,0,0,0,0,0,0,0
20200316,052426,國巨台新96購01,,,,,0.00,0.00,0,0,0,0,0,0,0,0,0,0,0,0,0
20200316,052427,上証2X永豐96購01,,,,,0.00,0.00,0,0,0,0,0,0,0,0,0,0,0,0,0
20200316,052428,嘉晶永豐95購01,1.00,1.15,0.89,0.89,-0.11,-11.0,100000,11,106850,0,0,0,0,0,0,20000,89000,-69000,-69000
20200316,052429,禾伸堂永豐95購02,0.30,0.33,0.28,0.28,+0.03,12.0,14000,9,4110,0,0,0,0,0,0,7000,7000,0,0
20200316,05242P,群創國泰97售01,0.70,0.85,0.70,0.85,+0.02,2.41,67000,4,52950,0,0,0,0,0,0,55000,12000,43000,43000
20200316,052430,泰碩永豐95購02,,,,,0.00,0.00,0,0,0,0,0,0,0,0,0,0,0,0,0
20200316,052431,茂林永豐95購03,,,,,0.00,0.00,0,0,0,0,0,0,0,0,0,0,0,0,0
20200316,052432,康友永豐95購04,,,,,0.00,0.00,0,0,0,0,0,0,0,0,0,0,0,0,0
20200316,052433,滬深2X國泰96購02,,,,,0.00,0.00,0,0,0,0,0,0,0,0,0,0,0,0,0
20200316,052434,茂林國泰97購01,0.67,0.69,0.45,0.48,-0.18,-27.27,1036000,43,650580,0,0,0,0,0,0,891000,81000,810000,810000
20200316,052435,滬深2X富邦96購05,,,,,0.00,0.00,0,0,0,0,0,0,0,0,0,0,0,0,0
20200316,052436,正崴富邦95購01,,,,,0.00,0.00,0,0,0,0,0,0,0,0,0,0,0,0,0
20200316,052437,聯發科富邦99購02,0.24,0.24,0.24,0.24,+0.06,33.33,40000,1,9600,0,0,0,0,0,0,0,40000,-40000,-40000
20200316,052438,瑞儀富邦95購01,,,,,0.00,0.00,0,0,0,0,0,0,0,0,0,0,0,0,0
20200316,052439,寶成富邦97購01,,,,,0.00,0.00,0,0,0,0,0,0,0,0,0,0,0,0,0
20200316,05243P,鴻海元大95售19,,,,,0.00,0.00,0,0,0,0,0,0,0,0,0,0,0,0,0
20200316,052440,上証2X元大95購02,,,,,0.00,0.00,0,0,0,0,0,0,0,0,0,0,0,0,0
20200316,052441,亞泥元大95購01,0.24,0.25,0.22,0.24,-0.11,-31.43,253000,26,58720,0,0,0,0,0,0,0,253000,-253000,-253000
20200316,052442,中環元大95購02,,,,,0.00,0.00,0,0,0,0,0,0,0,0,0,0,0,0,0
20200316,052443,台積電元大95購23,0.64,0.69,0.58,0.69,-0.07,-9.21,228000,14,149410,0,0,0,0,0,0,21000,30000,-9000,-9000
20200316,052444,友訊元大95購01,0.13,0.13,0.13,0.13,+0.03,30.0,10000,1,1300,0,0,0,0,0,0,0,10000,-10000,-10000
20200316,052445,南亞科元大95購05,0.40,0.40,0.21,0.21,-0.05,-19.23,1680000,100,465420,0,0,0,0,0,0,710000,970000,-260000,-260000
20200316,052446,聯發科元大96購03,0.13,0.13,0.13,0.13,0.00,0.00,20000,3,2600,0,0,0,0,0,0,0,20000,-20000,-20000
20200316,052447,聯發科元大96購04,,,,,0.00,0.00,0,0,0,0,0,0,0,0,0,0,0,0,0
20200316,052448,新光金元大96購03,,,,,0.00,0.00,0,0,0,0,0,0,0,0,0,0,0,0,0
20200316,052449,創意元大95購04,,,,,0.00,0.00,0,0,0,0,0,0,0,0,0,0,0,0,0
20200316,05244P,台積電元大95售17,2.60,3.71,2.60,3.70,+1.51,68.95,104000,13,347920,0,0,0,0,0,0,80000,94000,-14000,-14000
20200316,052450,嘉澤元大95購03,0.08,0.08,0.06,0.06,0.00,0.00,50000,4,3600,0,0,0,0,0,0,30000,20000,10000,10000
20200316,052451,旭富元大95購02,0.98,0.98,0.45,0.47,-0.12,-20.34,314000,42,183290,0,0,0,0,0,0,37000,277000,-240000,-240000
20200316,052452,茂林元大95購03,0.76,0.76,0.47,0.47,-0.29,-38.16,72000,5,37500,0,0,0,0,0,0,66000,62000,4000,4000
20200316,052453,崇越元大95購01,0.42,0.42,0.35,0.35,-0.09,-20.45,64000,3,24680,0,0,0,0,0,0,54000,10000,44000,44000
20200316,052454,力成元大95購02,0.73,0.74,0.58,0.58,-0.18,-23.68,140000,14,90750,0,0,0,0,0,0,55000,85000,-30000,-30000
20200316,052455,樺漢元大96購03,,,,,0.00,0.00,0,0,0,0,0,0,0,0,0,0,0,0,0
20200316,052456,滬深2X元富9B購03,0.38,0.38,0.35,0.35,-0.09,-20.45,172000,20,62540,0,0,0,0,0,0,0,108000,-108000,-108000
20200316,052457,日月光元富95購01,,,,,0.00,0.00,0,0,0,0,0,0,0,0,0,0,0,0,0
20200316,052458,T50反1統一97購01,,,,,0.00,0.00,0,0,0,0,0,0,0,0,0,0,0,0,0
20200316,052459,道瓊反統一95購04,3.12,3.12,3.12,3.12,0.00,0.00,50000,1,156000,0,0,0,0,0,0,50000,0,50000,50000
20200316,05245P,台積電元大95售18,2.26,3.41,2.11,3.36,+1.40,71.43,393000,51,1211350,0,0,0,0,0,0,307000,346000,-39000,-39000
20200316,052460,元油反統一95購01,,,,,0.00,0.00,0,0,0,0,0,0,0,0,0,0,0,0,0
20200316,052461,和大統一95購01,,,,,0.00,0.00,0,0,0,0,0,0,0,0,0,0,0,0,0
20200316,052462,上銀統一95購03,,,,,0.00,0.00,0,0,0,0,0,0,0,0,0,0,0,0,0
20200316,052463,聯電統一96購01,0.36,0.36,0.36,0.36,+0.03,9.09,62000,1,22320,0,0,0,0,0,0,62000,0,62000,62000
20200316,052464,大立光統一95購05,,,,,0.00,0.00,0,0,0,0,0,0,0,0,0,0,0,0,0
20200316,052465,聯詠統一95購02,,,,,0.00,0.00,0,0,0,0,0,0,0,0,0,0,0,0,0
20200316,052466,聯詠統一95購03,,,,,0.00,0.00,0,0,0,0,0,0,0,0,0,0,0,0,0
20200316,052467,嘉聯益統一96購01,,,,,0.00,0.00,0,0,0,0,0,0,0,0,0,0,0,0,0
20200316,052468,超眾統一96購02,,,,,0.00,0.00,0,0,0,0,0,0,0,0,0,0,0,0,0
20200316,052469,宏碁亞東95購01,,,,,0.00,0.00,0,0,0,0,0,0,0,0,0,0,0,0,0
20200316,05246P,南電元大95售04,2.03,2.62,2.03,2.62,+0.22,9.17,157000,14,369630,0,0,0,0,0,0,50000,107000,-57000,-57000
20200316,052470,華新科亞東97購01,,,,,0.00,0.00,0,0,0,0,0,0,0,0,0,0,0,0,0
20200316,052471,華固亞東95購01,,,,,0.00,0.00,0,0,0,0,0,0,0,0,0,0,0,0,0
20200316,052472,和碩亞東95購01,,,,,0.00,0.00,0,0,0,0,0,0,0,0,0,0,0,0,0
20200316,052473,臻鼎亞東95購01,,,,,0.00,0.00,0,0,0,0,0,0,0,0,0,0,0,0,0
20200316,052474,T50反1群益95購04,,,,,0.00,0.00,0,0,0,0,0,0,0,0,0,0,0,0,0
20200316,052475,滬深2X群益99購06,0.24,0.24,0.20,0.20,-0.06,-23.08,25000,2,5600,0,0,0,0,0,0,15000,10000,5000,5000
20200316,052476,台光電群益98購01,0.36,0.36,0.32,0.32,-0.04,-11.11,43000,3,14590,0,0,0,0,0,0,3000,40000,-37000,-37000
20200316,052477,美律群益98購01,,,,,0.00,0.00,0,0,0,0,0,0,0,0,0,0,0,0,0
20200316,052478,大立光群益95購05,0.70,0.70,0.39,0.39,-0.34,-46.58,65000,8,41550,0,0,0,0,0,0,0,50000,-50000,-50000
20200316,052479,TPK群益95購04,,,,,0.00,0.00,0,0,0,0,0,0,0,0,0,0,0,0,0
20200316,05247P,上銀群益95售01,,,,,0.00,0.00,0,0,0,0,0,0,0,0,0,0,0,0,0
20200316,052480,麗豐群益95購01,,,,,0.00,0.00,0,0,0,0,0,0,0,0,0,0,0,0,0
20200316,052481,利勤群益95購01,,,,,0.00,0.00,0,0,0,0,0,0,0,0,0,0,0,0,0
20200316,052482,茂林群益95購01,0.60,0.60,0.42,0.42,-0.24,-36.36,92000,17,45070,0,0,0,0,0,0,12000,60000,-48000,-48000
20200316,052483,超眾群益95購03,0.19,0.19,0.19,0.19,+0.02,11.76,60000,1,11400,0,0,0,0,0,0,60000,60000,0,0
20200316,052484,矽創群益95購02,,,,,0.00,0.00,0,0,0,0,0,0,0,0,0,0,0,0,0
20200316,052485,深中小國票96購01,,,,,0.00,0.00,0,0,0,0,0,0,0,0,0,0,0,0,0
20200316,052486,元油反國票96購01,,,,,0.00,0.00,0,0,0,0,0,0,0,0,0,0,0,0,0
20200316,052487,國巨國票96購07,,,,,0.00,0.00,0,0,0,0,0,0,0,0,0,0,0,0,0
20200316,052488,旺宏國票96購03,1.08,1.08,0.71,0.71,-0.29,-29.0,76000,5,66220,0,0,0,0,0,0,72000,0,72000,72000
20200316,052489,義隆國票96購02,,,,,0.00,0.00,0,0,0,0,0,0,0,0,0,0,0,0,0
20200316,05248P,矽創群益96售01,,,,,0.00,0.00,0,0,0,0,0,0,0,0,0,0,0,0,0
20200316,052490,禾伸堂國票95購01,,,,,0.00,0.00,0,0,0,0,0,0,0,0,0,0,0,0,0
20200316,052491,泰碩國票99購01,0.91,0.91,0.72,0.72,-0.36,-33.33,21000,2,15310,0,0,0,0,0,0,20000,0,20000,20000
20200316,052492,易華電國票96購02,,,,,0.00,0.00,0,0,0,0,0,0,0,0,0,0,0,0,0
20200316,052493,上証2X中信97購02,0.57,0.57,0.57,0.57,0.00,0.00,17000,1,9690,0,0,0,0,0,0,0,17000,-17000,-17000
20200316,052494,百和中信95購02,,,,,0.00,0.00,0,0,0,0,0,0,0,0,0,0,0,0,0
20200316,052495,滬深2X台新95購01,,,,,0.00,0.00,0,0,0,0,0,0,0,0,0,0,0,0,0
20200316,052496,華通台新96購02,,,,,0.00,0.00,0,0,0,0,0,0,0,0,0,0,0,0,0
20200316,052497,楠梓電永豐96購01,,,,,0.00,0.00,0,0,0,0,0,0,0,0,0,0,0,0,0
20200316,052498,台積電永豐95購06,0.19,0.19,0.13,0.13,-0.15,-53.57,100000,11,17800,0,0,0,0,0,0,0,100000,-100000,-100000
20200316,052499,合勤控永豐95購01,,,,,0.00,0.00,0,0,0,0,0,0,0,0,0,0,0,0,0
20200316,05249P,臻鼎國票95售01,,,,,0.00,0.00,0,0,0,0,0,0,0,0,0,0,0,0,0
20200316,052500,元翎永豐95購01,,,,,0.00,0.00,0,0,0,0,0,0,0,0,0,0,0,0,0
20200316,052501,茂林永豐95購04,,,,,0.00,0.00,0,0,0,0,0,0,0,0,0,0,0,0,0
20200316,052502,瀚宇博永豐95購02,,,,,0.00,0.00,0,0,0,0,0,0,0,0,0,0,0,0,0
20200316,052503,大成鋼日盛95購02,,,,,0.00,0.00,0,0,0,0,0,0,0,0,0,0,0,0,0
20200316,052504,鴻海日盛95購03,,,,,0.00,0.00,0,0,0,0,0,0,0,0,0,0,0,0,0
20200316,052505,友達日盛9B購02,,,,,0.00,0.00,0,0,0,0,0,0,0,0,0,0,0,0,0
20200316,052506,日月光日盛95購01,,,,,0.00,0.00,0,0,0,0,0,0,0,0,0,0,0,0,0
20200316,052507,日月光日盛95購02,,,,,0.00,0.00,0,0,0,0,0,0,0,0,0,0,0,0,0
20200316,052508,矽力日盛95購02,,,,,0.00,0.00,0,0,0,0,0,0,0,0,0,0,0,0,0
20200316,052509,鴻海凱基96購10,,,,,0.00,0.00,0,0,0,0,0,0,0,0,0,0,0,0,0
20200316,05250P,臻鼎國票96售01,8.15,8.20,8.15,8.20,+0.45,5.81,28000,2,229100,0,0,0,0,0,0,28000,0,28000,28000
20200316,052510,聯發科凱基95購13,,,,,0.00,0.00,0,0,0,0,0,0,0,0,0,0,0,0,0
20200316,052511,聯發科凱基95購14,,,,,0.00,0.00,0,0,0,0,0,0,0,0,0,0,0,0,0
20200316,052512,全新凱基96購03,,,,,0.00,0.00,0,0,0,0,0,0,0,0,0,0,0,0,0
20200316,052513,大立光凱基95購13,,,,,0.00,0.00,0,0,0,0,0,0,0,0,0,0,0,0,0
20200316,052514,嘉澤凱基96購01,,,,,0.00,0.00,0,0,0,0,0,0,0,0,0,0,0,0,0
20200316,052515,矽力凱基95購02,0.85,0.85,0.85,0.85,0.00,0.00,2000,1,1700,0,0,0,0,0,0,2000,0,2000,2000
20200316,052516,臺股指凱基95購20,0.15,0.15,0.12,0.12,-0.02,-14.29,198000,3,26760,0,0,0,0,0,0,98000,0,98000,98000
20200316,052517,滬深2X元大95購05,,,,,0.00,0.00,0,0,0,0,0,0,0,0,0,0,0,0,0
20200316,052518,道瓊反元大95購02,1.16,1.30,1.16,1.30,+0.05,4.0,174000,15,218600,0,0,0,0,0,0,2000,122000,-120000,-120000
20200316,052519,旺宏元大95購05,0.92,1.05,0.62,0.64,-0.22,-25.58,79000,9,69760,0,0,0,0,0,0,59000,48000,11000,11000
20200316,05251P,喬山台新95售02,,,,,0.00,0.00,0,0,0,0,0,0,0,0,0,0,0,0,0
20200316,052520,南亞科元大95購06,0.91,0.97,0.49,0.51,-0.38,-42.7,520000,42,350600,0,0,0,0,0,0,254000,272000,-18000,-18000
20200316,052521,友達元大9B購01,0.85,0.92,0.81,0.82,+0.07,9.33,301000,10,256030,0,0,0,0,0,0,281000,151000,130000,130000
20200316,052522,聯發科元大96購05,,,,,0.00,0.00,0,0,0,0,0,0,0,0,0,0,0,0,0
20200316,052523,奇力新元大97購01,0.62,0.64,0.43,0.43,-0.06,-12.24,248000,19,134970,0,0,0,0,0,0,120000,128000,-8000,-8000
20200316,052524,新光金元大9B購01,0.11,0.11,0.09,0.09,-0.01,-10.0,206000,17,20550,0,0,0,0,0,0,100000,106000,-6000,-6000
20200316,052525,聯詠元大95購06,,,,,0.00,0.00,0,0,0,0,0,0,0,0,0,0,0,0,0
20200316,052526,智伸科元大96購02,,,,,0.00,0.00,0,0,0,0,0,0,0,0,0,0,0,0,0
20200316,052527,泰鼎元大96購02,1.21,1.21,0.86,0.86,0.00,0.00,130000,4,150200,0,0,0,0,0,0,120000,30000,90000,90000
20200316,052528,茂林元大95購05,0.42,0.42,0.25,0.25,-0.18,-41.86,109000,13,38700,0,0,0,0,0,0,50000,59000,-9000,-9000
20200316,052529,力成元大95購03,0.57,0.57,0.51,0.51,0.00,0.00,10000,2,5400,0,0,0,0,0,0,0,10000,-10000,-10000
20200316,05252P,華通凱基95售01,1.99,1.99,1.99,1.99,-0.25,-11.16,57000,1,113430,0,0,0,0,0,0,57000,0,57000,57000
20200316,052530,台郡元大96購04,0.43,0.43,0.32,0.32,+0.01,3.23,5000,2,1710,0,0,0,0,0,0,0,5000,-5000,-5000
20200316,052531,台積電國泰96購06,0.54,0.59,0.47,0.47,+0.12,34.29,335000,28,190350,0,0,0,0,0,0,325000,122000,203000,203000
20200316,052532,台積電國泰96購07,0.64,0.76,0.46,0.46,-0.44,-48.89,876000,64,538800,0,0,0,0,0,0,846000,275000,571000,571000
20200316,052533,聯發科國泰96購03,,,,,0.00,0.00,0,0,0,0,0,0,0,0,0,0,0,0,0
20200316,052534,貿聯國泰96購02,,,,,0.00,0.00,0,0,0,0,0,0,0,0,0,0,0,0,0
20200316,052535,日月光國泰96購01,0.10,0.10,0.06,0.06,-0.02,-25.0,50000,2,3200,0,0,0,0,0,0,45000,5000,40000,40000
20200316,052536,聯茂國泰97購01,,,,,0.00,0.00,0,0,0,0,0,0,0,0,0,0,0,0,0
20200316,052537,力成富邦95購01,,,,,0.00,0.00,0,0,0,0,0,0,0,0,0,0,0,0,0
20200316,052538,和大統一95購02,,,,,0.00,0.00,0,0,0,0,0,0,0,0,0,0,0,0,0
20200316,052539,華邦電統一95購01,,,,,0.00,0.00,0,0,0,0,0,0,0,0,0,0,0,0,0
20200316,05253P,智邦凱基95售08,,,,,0.00,0.00,0,0,0,0,0,0,0,0,0,0,0,0,0
20200316,052540,華新科統一95購03,,,,,0.00,0.00,0,0,0,0,0,0,0,0,0,0,0,0,0
20200316,052541,大立光統一95購06,0.55,0.58,0.55,0.58,-0.19,-24.68,17000,2,9410,0,0,0,0,0,0,17000,0,17000,17000
20200316,052542,友達元富98購01,,,,,0.00,0.00,0,0,0,0,0,0,0,0,0,0,0,0,0
20200316,052543,聯詠元富95購01,0.18,0.18,0.17,0.17,-0.02,-10.53,70000,2,12300,0,0,0,0,0,0,70000,0,70000,70000
20200316,052544,牧德元富95購01,1.10,1.10,0.92,0.92,-0.17,-15.6,28000,3,28700,0,0,0,0,0,0,18000,12000,6000,6000
20200316,052545,康控元富95購02,,,,,0.00,0.00,0,0,0,0,0,0,0,0,0,0,0,0,0
20200316,052546,友達中信98購01,0.45,0.52,0.39,0.39,-0.03,-7.14,328000,12,158960,0,0,0,0,0,0,223000,105000,118000,118000
20200316,052547,光磊兆豐96購01,,,,,0.00,0.00,0,0,0,0,0,0,0,0,0,0,0,0,0
20200316,052548,旺宏亞東96購01,,,,,0.00,0.00,0,0,0,0,0,0,0,0,0,0,0,0,0
20200316,052549,喬山國票97購01,,,,,0.00,0.00,0,0,0,0,0,0,0,0,0,0,0,0,0
20200316,05254P,瑞昱凱基95售04,0.31,0.41,0.31,0.40,0.00,0.00,30000,3,11200,0,0,0,0,0,0,0,30000,-30000,-30000
20200316,052550,鴻海國票97購02,0.01,0.01,0.01,0.01,0.00,0.00,20000,1,200,0,0,0,0,0,0,0,0,0,0
20200316,052551,台積電國票97購03,,,,,0.00,0.00,0,0,0,0,0,0,0,0,0,0,0,0,0
20200316,052552,智邦國票97購01,2.02,2.02,1.95,1.95,+0.48,32.65,75000,4,150100,0,0,0,0,0,0,75000,0,75000,75000
20200316,052553,技嘉國票96購01,0.23,0.23,0.23,0.23,+0.05,27.78,10000,1,2300,0,0,0,0,0,0,0,10000,-10000,-10000
20200316,052554,正崴國票97購01,,,,,0.00,0.00,0,0,0,0,0,0,0,0,0,0,0,0,0
20200316,052555,漢唐國票97購01,0.72,0.72,0.72,0.72,+0.29,67.44,20000,1,14400,0,0,0,0,0,0,20000,0,20000,20000
20200316,052556,聯發科國票97購01,,,,,0.00,0.00,0,0,0,0,0,0,0,0,0,0,0,0,0
20200316,052557,群創國票97購02,,,,,0.00,0.00,0,0,0,0,0,0,0,0,0,0,0,0,0
20200316,052558,新唐國票97購01,,,,,0.00,0.00,0,0,0,0,0,0,0,0,0,0,0,0,0
20200316,052559,茂林國票97購01,,,,,0.00,0.00,0,0,0,0,0,0,0,0,0,0,0,0,0
20200316,05255P,義隆凱基95售01,0.83,0.99,0.81,0.99,-0.01,-1.0,216000,8,211500,0,0,0,0,0,0,0,216000,-216000,-216000
20200316,052560,康舒國票97購01,,,,,0.00,0.00,0,0,0,0,0,0,0,0,0,0,0,0,0
20200316,052561,矽創國票97購01,0.21,0.21,0.21,0.21,-0.01,-4.55,12000,1,2520,0,0,0,0,0,0,12000,0,12000,12000
20200316,052562,南亞科日盛96購01,,,,,0.00,0.00,0,0,0,0,0,0,0,0,0,0,0,0,0
20200316,052563,京元電日盛96購01,0.16,0.16,0.16,0.16,0.00,0.00,1000,1,160,0,0,0,0,0,0,0,1000,-1000,-1000
20200316,052564,美食日盛96購01,,,,,0.00,0.00,0,0,0,0,0,0,0,0,0,0,0,0,0
20200316,052565,上銀凱基96購01,0.32,0.32,0.22,0.25,-0.07,-21.88,66000,5,19050,0,0,0,0,0,0,65000,21000,44000,44000
20200316,052566,國巨凱基96購04,,,,,0.00,0.00,0,0,0,0,0,0,0,0,0,0,0,0,0
20200316,052567,台積電凱基96購05,,,,,0.00,0.00,0,0,0,0,0,0,0,0,0,0,0,0,0
20200316,052568,漢唐凱基96購02,0.25,0.26,0.25,0.26,-0.01,-3.7,498000,3,124510,0,0,0,0,0,0,0,498000,-498000,-498000
20200316,052569,聯發科凱基96購08,,,,,0.00,0.00,0,0,0,0,0,0,0,0,0,0,0,0,0
20200316,05256P,義隆凱基95售02,0.20,0.24,0.20,0.24,-0.01,-4.0,73000,8,15360,0,0,0,0,0,0,0,73000,-73000,-73000
20200316,052570,華新科凱基96購06,0.63,0.63,0.54,0.54,-0.04,-6.9,20000,2,11700,0,0,0,0,0,0,0,20000,-20000,-20000
20200316,052571,新光金凱基98購02,,,,,0.00,0.00,0,0,0,0,0,0,0,0,0,0,0,0,0
20200316,052572,群創凱基99購01,,,,,0.00,0.00,0,0,0,0,0,0,0,0,0,0,0,0,0
20200316,052573,智伸科凱基97購01,,,,,0.00,0.00,0,0,0,0,0,0,0,0,0,0,0,0,0
20200316,052574,茂林凱基96購02,,,,,0.00,0.00,0,0,0,0,0,0,0,0,0,0,0,0,0
20200316,052575,茂林凱基96購04,0.29,0.29,0.29,0.29,-0.03,-9.38,150000,1,43500,0,0,0,0,0,0,150000,0,150000,150000
20200316,052576,聯茂凱基96購01,0.35,0.35,0.18,0.18,-0.05,-21.74,288000,14,85690,0,0,0,0,0,0,189000,99000,90000,90000
20200316,052577,台積電統一96購01,,,,,0.00,0.00,0,0,0,0,0,0,0,0,0,0,0,0,0
20200316,052578,大立光統一97購01,,,,,0.00,0.00,0,0,0,0,0,0,0,0,0,0,0,0,0
20200316,052579,亞泥元富96購01,1.54,1.54,1.40,1.42,0.00,0.00,128000,11,192090,0,0,0,0,0,0,114000,14000,100000,100000
20200316,05257P,欣興凱基95售04,3.61,3.99,3.61,3.97,+0.48,13.75,29000,4,111810,0,0,0,0,0,0,19000,29000,-10000,-10000
20200316,052580,高鐵元富96購01,1.41,1.46,1.38,1.38,+0.14,11.29,247000,15,353580,0,0,0,0,0,0,157000,90000,67000,67000
20200316,052581,訊芯元富98購01,0.44,0.44,0.44,0.44,+0.10,29.41,10000,1,4400,0,0,0,0,0,0,0,10000,-10000,-10000
20200316,052582,喬山台新96購01,,,,,0.00,0.00,0,0,0,0,0,0,0,0,0,0,0,0,0
20200316,052583,友達台新96購02,,,,,0.00,0.00,0,0,0,0,0,0,0,0,0,0,0,0,0
20200316,052584,喬山永豐96購01,,,,,0.00,0.00,0,0,0,0,0,0,0,0,0,0,0,0,0
20200316,052585,友達永豐97購01,,,,,0.00,0.00,0,0,0,0,0,0,0,0,0,0,0,0,0
20200316,052586,晶豪科永豐96購01,0.25,0.25,0.18,0.18,-0.03,-14.29,22000,3,4100,0,0,0,0,0,0,21000,1000,20000,20000
20200316,052587,景碩永豐97購01,0.08,0.08,0.08,0.08,0.00,0.00,170000,9,13600,0,0,0,0,0,0,0,170000,-170000,-170000
20200316,052588,玉晶光永豐98購01,0.97,0.97,0.66,0.66,-0.18,-21.43,76000,15,64580,0,0,0,0,0,0,49000,39000,10000,10000
20200316,052589,群創永豐97購01,,,,,0.00,0.00,0,0,0,0,0,0,0,0,0,0,0,0,0
20200316,05258P,臺股指凱基96售11,4.34,5.30,4.34,5.00,+0.39,8.46,28000,5,139120,0,0,0,0,0,0,28000,20000,8000,8000
20200316,052590,祥碩永豐96購01,1.47,1.65,1.20,1.20,-0.27,-18.37,347000,45,531880,0,0,0,0,0,0,300000,119000,181000,181000
20200316,052591,康友永豐97購01,0.16,0.16,0.10,0.10,-0.08,-44.44,315000,27,42410,0,0,0,0,0,0,0,315000,-315000,-315000
20200316,052592,華通群益98購01,0.05,0.05,0.03,0.03,-0.01,-25.0,250000,4,8100,0,0,0,0,0,0,0,250000,-250000,-250000
20200316,052593,台積電群益96購02,0.06,0.06,0.04,0.04,-0.02,-33.33,319000,5,13160,0,0,0,0,0,0,124000,0,124000,124000
20200316,052594,友訊群益98購01,0.25,0.25,0.22,0.22,-0.01,-4.35,24000,2,5400,0,0,0,0,0,0,4000,20000,-16000,-16000
20200316,052595,奇力新群益96購01,0.12,0.12,0.05,0.05,-0.01,-16.67,162000,16,16040,0,0,0,0,0,0,20000,142000,-122000,-122000
20200316,052596,群創群益98購05,,,,,0.00,0.00,0,0,0,0,0,0,0,0,0,0,0,0,0
20200316,052597,茂林群益96購01,0.42,0.42,0.42,0.42,-0.14,-25.0,30000,1,12600,0,0,0,0,0,0,30000,0,30000,30000
20200316,052598,滬深2X元大96購05,0.30,0.30,0.30,0.30,0.00,0.00,25000,2,7500,0,0,0,0,0,0,21000,0,21000,21000
20200316,052599,S&P反1元大96購01,,,,,0.00,0.00,0,0,0,0,0,0,0,0,0,0,0,0,0
20200316,05259P,臺股指凱基96售12,4.43,6.65,4.43,6.05,+1.62,36.57,50000,5,296300,0,0,0,0,0,0,50000,40000,10000,10000
20200316,052600,力山元大97購01,,,,,0.00,0.00,0,0,0,0,0,0,0,0,0,0,0,0,0
20200316,052601,大成鋼元大96購01,0.84,0.87,0.74,0.77,-0.12,-13.48,292000,13,234090,0,0,0,0,0,0,221000,157000,64000,64000
20200316,052602,聯電元大97購01,0.25,0.25,0.22,0.23,0.00,0.00,71000,8,16430,0,0,0,0,0,0,40000,31000,9000,9000
20200316,052603,鴻海元大96購15,,,,,0.00,0.00,0,0,0,0,0,0,0,0,0,0,0,0,0
20200316,052604,建準元大97購01,0.34,0.34,0.33,0.33,+0.09,37.5,17000,2,5710,0,0,0,0,0,0,17000,0,17000,17000
20200316,052605,聯發科元大96購06,,,,,0.00,0.00,0,0,0,0,0,0,0,0,0,0,0,0,0
20200316,052606,聯發科元大97購04,0.21,0.21,0.12,0.12,-0.13,-52.0,422000,43,59940,0,0,0,0,0,0,70000,352000,-282000,-282000
20200316,052607,大立光元大96購03,0.42,0.45,0.23,0.23,-0.23,-50.0,140000,15,44190,0,0,0,0,0,0,100000,120000,-20000,-20000
20200316,052608,欣興元大97購01,0.05,0.05,0.04,0.04,0.00,0.00,20000,2,900,0,0,0,0,0,0,0,10000,-10000,-10000
20200316,052609,智易元大97購01,,,,,0.00,0.00,0,0,0,0,0,0,0,0,0,0,0,0,0
20200316,05260P,和碩元富95售02,1.76,2.07,1.76,2.04,+0.36,21.43,32000,11,64000,0,0,0,0,0,0,32000,0,32000,32000
20200316,052610,貿聯元大97購01,0.07,0.07,0.07,0.07,-0.05,-41.67,220000,3,15400,0,0,0,0,0,0,210000,10000,200000,200000
20200316,052611,力成元大96購02,0.46,0.46,0.46,0.46,0.00,0.00,10000,1,4600,0,0,0,0,0,0,10000,0,10000,10000
20200316,052612,康舒元大97購01,0.35,0.35,0.35,0.35,+0.01,2.94,10000,1,3500,0,0,0,0,0,0,10000,0,10000,10000
20200316,052613,易華電元大96購01,,,,,0.00,0.00,0,0,0,0,0,0,0,0,0,0,0,0,0
20200316,052614,聯電國泰97購01,0.45,0.45,0.40,0.42,-0.10,-19.23,1168000,21,479330,0,0,0,0,0,0,1039000,25000,1014000,1014000
20200316,052615,鴻海國泰98購01,0.10,0.10,0.10,0.10,-0.01,-9.09,13000,2,1300,0,0,0,0,0,0,0,0,0,0
20200316,052616,鴻海國泰98購02,,,,,0.00,0.00,0,0,0,0,0,0,0,0,0,0,0,0,0
20200316,052617,景碩國泰98購01,0.62,0.62,0.43,0.43,0.00,0.00,248000,4,151890,0,0,0,0,0,0,231000,17000,214000,214000
20200316,052618,群創國泰98購01,,,,,0.00,0.00,0,0,0,0,0,0,0,0,0,0,0,0,0
20200316,052619,茂林國泰99購01,0.52,0.52,0.52,0.52,+0.08,18.18,25000,1,13000,0,0,0,0,0,0,25000,0,25000,25000
20200316,05261P,鴻海元大95售20,3.19,4.43,3.19,4.43,+1.50,51.19,672000,41,2577710,0,0,0,0,0,0,565000,547000,18000,18000
20200316,052620,上証2X富邦97購02,,,,,0.00,0.00,0,0,0,0,0,0,0,0,0,0,0,0,0
20200316,052621,台郡富邦97購01,0.16,0.16,0.16,0.16,-0.02,-11.11,10000,1,1600,0,0,0,0,0,0,0,10000,-10000,-10000
20200316,052622,貿聯兆豐97購01,0.08,0.08,0.08,0.08,0.00,0.00,10000,1,800,0,0,0,0,0,0,0,10000,-10000,-10000
20200316,052623,台郡兆豐96購01,,,,,0.00,0.00,0,0,0,0,0,0,0,0,0,0,0,0,0
20200316,052624,微星亞東97購01,,,,,0.00,0.00,0,0,0,0,0,0,0,0,0,0,0,0,0
20200316,052625,南電亞東97購01,,,,,0.00,0.00,0,0,0,0,0,0,0,0,0,0,0,0,0
20200316,052626,上証2X中信9A購01,0.27,0.27,0.24,0.24,0.00,0.00,380000,4,95200,0,0,0,0,0,0,180000,200000,-20000,-20000
20200316,052627,中壽中信98購01,0.02,0.02,0.02,0.02,0.00,0.00,20000,2,400,0,0,0,0,0,0,0,20000,-20000,-20000
20200316,052628,樺漢中信96購01,,,,,0.00,0.00,0,0,0,0,0,0,0,0,0,0,0,0,0
20200316,052629,訊芯中信99購01,,,,,0.00,0.00,0,0,0,0,0,0,0,0,0,0,0,0,0
20200316,05262P,台積電元大95售19,0.92,1.64,0.80,1.64,+0.90,121.62,220000,20,268800,0,0,0,0,0,0,80000,140000,-60000,-60000
20200316,052630,滬深2X日盛96購01,0.18,0.18,0.18,0.18,+0.06,50.0,12000,1,2160,0,0,0,0,0,0,12000,0,12000,12000
20200316,052631,T50反1凱基98購02,1.71,1.73,1.71,1.73,+0.23,15.33,23000,3,39590,0,0,0,0,0,0,0,23000,-23000,-23000
20200316,052632,喬山凱基96購01,,,,,0.00,0.00,0,0,0,0,0,0,0,0,0,0,0,0,0
20200316,052633,國巨凱基96購05,,,,,0.00,0.00,0,0,0,0,0,0,0,0,0,0,0,0,0
20200316,052634,華邦電凱基96購01,,,,,0.00,0.00,0,0,0,0,0,0,0,0,0,0,0,0,0
20200316,052635,奇力新凱基98購01,0.25,0.25,0.21,0.21,+0.03,16.67,100000,10,23000,0,0,0,0,0,0,0,100000,-100000,-100000
20200316,052636,大立光凱基96購10,,,,,0.00,0.00,0,0,0,0,0,0,0,0,0,0,0,0,0
20200316,052637,欣興凱基97購01,,,,,0.00,0.00,0,0,0,0,0,0,0,0,0,0,0,0,0
20200316,052638,緯創凱基96購02,,,,,0.00,0.00,0,0,0,0,0,0,0,0,0,0,0,0,0
20200316,052639,康控凱基96購02,,,,,0.00,0.00,0,0,0,0,0,0,0,0,0,0,0,0,0
20200316,05263P,台積電元大96售09,1.47,1.91,1.42,1.88,+0.44,30.56,1535000,121,2473290,0,0,0,0,0,0,1229000,1282000,-53000,-53000
20200316,052640,台表科凱基97購01,0.03,0.03,0.03,0.03,0.00,0.00,10000,1,300,0,0,0,0,0,0,10000,0,10000,10000
20200316,052641,聯詠台新96購01,,,,,0.00,0.00,0,0,0,0,0,0,0,0,0,0,0,0,0
20200316,052642,滬深2X永豐96購03,,,,,0.00,0.00,0,0,0,0,0,0,0,0,0,0,0,0,0
20200316,052643,華通永豐96購02,,,,,0.00,0.00,0,0,0,0,0,0,0,0,0,0,0,0,0
20200316,052644,聯發科永豐96購01,0.06,0.06,0.06,0.06,-0.03,-33.33,70000,2,4200,0,0,0,0,0,0,0,70000,-70000,-70000
20200316,052645,美食永豐96購01,,,,,0.00,0.00,0,0,0,0,0,0,0,0,0,0,0,0,0
20200316,052646,淘帝永豐96購01,,,,,0.00,0.00,0,0,0,0,0,0,0,0,0,0,0,0,0
20200316,052647,晶技永豐97購01,1.20,1.42,1.20,1.27,+0.64,101.59,69000,11,90960,0,0,0,0,0,0,10000,69000,-59000,-59000
20200316,052648,茂林永豐96購01,,,,,0.00,0.00,0,0,0,0,0,0,0,0,0,0,0,0,0
20200316,052649,康控永豐96購01,,,,,0.00,0.00,0,0,0,0,0,0,0,0,0,0,0,0,0
20200316,05264P,微星元大95售02,1.84,1.98,1.80,1.80,+0.01,0.56,32000,4,60160,0,0,0,0,0,0,0,32000,-32000,-32000
20200316,052650,台郡永豐96購01,0.12,0.12,0.12,0.12,0.00,0.00,30000,1,3600,0,0,0,0,0,0,30000,0,30000,30000
20200316,052651,台表科永豐96購02,,,,,0.00,0.00,0,0,0,0,0,0,0,0,0,0,0,0,0
20200316,052652,台虹永豐96購01,0.28,0.28,0.26,0.26,+0.06,30.0,25000,2,6700,0,0,0,0,0,0,25000,0,25000,25000
20200316,052653,臺股指永豐97購01,,,,,0.00,0.00,0,0,0,0,0,0,0,0,0,0,0,0,0
20200316,052654,友達統一97購01,,,,,0.00,0.00,0,0,0,0,0,0,0,0,0,0,0,0,0
20200316,052655,群創統一97購01,,,,,0.00,0.00,0,0,0,0,0,0,0,0,0,0,0,0,0
20200316,052656,力山元富96購01,,,,,0.00,0.00,0,0,0,0,0,0,0,0,0,0,0,0,0
20200316,052657,友達元富96購01,0.39,0.39,0.39,0.39,+0.03,8.33,20000,1,7800,0,0,0,0,0,0,20000,0,20000,20000
20200316,052658,友達元富9C購01,0.61,0.61,0.55,0.56,+0.02,3.7,278000,5,160600,0,0,0,0,0,0,278000,0,278000,278000
20200316,052659,上証2X國票99購01,,,,,0.00,0.00,0,0,0,0,0,0,0,0,0,0,0,0,0
20200316,05265P,正崴元大95售03,,,,,0.00,0.00,0,0,0,0,0,0,0,0,0,0,0,0,0
20200316,052660,京元電國票97購01,,,,,0.00,0.00,0,0,0,0,0,0,0,0,0,0,0,0,0
20200316,052661,奇力新國票97購03,0.14,0.14,0.13,0.13,-0.02,-13.33,60000,6,8100,0,0,0,0,0,0,0,60000,-60000,-60000
20200316,052662,華新科國票97購01,1.44,1.44,0.75,0.75,-0.43,-36.44,22000,4,19940,0,0,0,0,0,0,1000,10000,-9000,-9000
20200316,052663,奇鋐國票97購01,0.25,0.25,0.22,0.22,+0.02,10.0,13000,2,3160,0,0,0,0,0,0,13000,0,13000,13000
20200316,052664,麗豐國票96購02,,,,,0.00,0.00,0,0,0,0,0,0,0,0,0,0,0,0,0
20200316,052665,緯穎國票96購03,2.21,2.21,2.21,2.21,+0.89,67.42,95000,2,209950,0,0,0,0,0,0,95000,0,95000,95000
20200316,052666,瑞昱群益96購01,,,,,0.00,0.00,0,0,0,0,0,0,0,0,0,0,0,0,0
20200316,052667,漢唐群益96購01,0.30,0.30,0.30,0.30,+0.06,25.0,11000,1,3300,0,0,0,0,0,0,0,11000,-11000,-11000
20200316,052668,聯發科群益97購01,,,,,0.00,0.00,0,0,0,0,0,0,0,0,0,0,0,0,0
20200316,052669,群創群益98購06,0.06,0.06,0.06,0.06,+0.01,20.0,12000,1,720,0,0,0,0,0,0,12000,0,12000,12000
20200316,05266P,華新科元大95售11,0.59,0.90,0.59,0.90,+0.10,12.5,210000,20,169160,0,0,0,0,0,0,161000,129000,32000,32000
20200316,052670,茂林群益96購02,0.19,0.19,0.14,0.14,-0.06,-30.0,256000,6,39470,0,0,0,0,0,0,256000,0,256000,256000
20200316,052671,祥碩群益96購01,4.44,4.51,4.33,4.33,-0.56,-11.45,13000,3,58200,0,0,0,0,0,0,10000,2000,8000,8000
20200316,052672,世紀鋼群益96購02,1.75,1.75,1.44,1.46,+0.14,10.61,52000,6,81120,0,0,0,0,0,0,12000,30000,-18000,-18000
20200316,052673,T50反1國泰97購01,,,,,0.00,0.00,0,0,0,0,0,0,0,0,0,0,0,0,0
20200316,052674,智邦國泰98購01,1.52,1.65,1.31,1.39,-0.13,-8.55,317000,38,485640,0,0,0,0,0,0,268000,140000,128000,128000
20200316,052675,新光金國泰98購01,0.10,0.10,0.10,0.10,-0.06,-37.5,20000,1,2000,0,0,0,0,0,0,0,20000,-20000,-20000
20200316,052676,聯發科永昌98購01,0.50,0.50,0.50,0.50,-0.08,-13.79,3000,1,1500,0,0,0,0,0,0,0,3000,-3000,-3000
20200316,052677,景碩富邦97購01,,,,,0.00,0.00,0,0,0,0,0,0,0,0,0,0,0,0,0
20200316,052678,群創富邦96購01,,,,,0.00,0.00,0,0,0,0,0,0,0,0,0,0,0,0,0
20200316,052679,致伸富邦98購01,0.10,0.10,0.10,0.10,0.00,0.00,10000,1,1000,0,0,0,0,0,0,0,10000,-10000,-10000
20200316,05267P,欣興元大95售08,,,,,0.00,0.00,0,0,0,0,0,0,0,0,0,0,0,0,0
20200316,052680,T50反1元大96購04,,,,,0.00,0.00,0,0,0,0,0,0,0,0,0,0,0,0,0
20200316,052681,T50反1元大98購02,2.12,2.12,2.12,2.12,+0.69,48.25,10000,1,21200,0,0,0,0,0,0,10000,0,10000,10000
20200316,052682,上銀元大97購01,1.06,1.10,0.59,0.59,-0.46,-43.81,281000,22,230550,0,0,0,0,0,0,120000,224000,-104000,-104000
20200316,052683,鴻海元大97購03,,,,,0.00,0.00,0,0,0,0,0,0,0,0,0,0,0,0,0
20200316,052684,旺宏元大98購01,0.38,0.38,0.27,0.27,-0.11,-28.95,176000,15,52780,0,0,0,0,0,0,36000,140000,-104000,-104000
20200316,052685,技嘉元大96購01,0.70,0.70,0.62,0.62,-0.03,-4.62,142000,13,94430,0,0,0,0,0,0,37000,105000,-68000,-68000
20200316,052686,華新科元大96購03,0.92,0.96,0.60,0.61,-0.22,-26.51,492000,15,391570,0,0,0,0,0,0,430000,102000,328000,328000
20200316,052687,國泰金元大96購03,0.19,0.19,0.15,0.15,-0.04,-21.05,782000,23,119280,0,0,0,0,0,0,707000,163000,544000,544000
20200316,052688,新日興元大96購01,0.48,0.53,0.33,0.33,-0.15,-31.25,664000,67,240820,0,0,0,0,0,0,10000,654000,-644000,-644000
20200316,052689,玉晶光元大98購03,0.99,1.04,0.72,0.72,-0.22,-23.4,833000,81,660250,0,0,0,0,0,0,172000,726000,-554000,-554000
20200316,05268P,玉晶光元大98售01,1.09,1.30,1.06,1.30,+0.21,19.27,1347000,97,1571010,0,0,0,0,0,0,894000,413000,481000,481000
20200316,052690,台表科元大97購01,0.12,0.13,0.06,0.06,-0.04,-40.0,119000,13,12880,0,0,0,0,0,0,30000,79000,-49000,-49000
20200316,052691,GIS元大96購01,0.10,0.14,0.10,0.10,0.00,0.00,352000,32,38380,0,0,0,0,0,0,62000,290000,-228000,-228000
20200316,052692,滬深2X中信99購02,0.33,0.34,0.33,0.34,-0.06,-15.0,35000,4,11650,0,0,0,0,0,0,35000,0,35000,35000
20200316,052693,微星中信96購01,0.58,0.58,0.55,0.55,0.00,0.00,5000,3,2830,0,0,0,0,0,0,5000,0,5000,5000
20200316,052694,開發金中信98購01,,,,,0.00,0.00,0,0,0,0,0,0,0,0,0,0,0,0,0
20200316,052695,台表科中信98購01,0.02,0.02,0.02,0.02,0.00,0.00,60000,3,1200,0,0,0,0,0,0,0,0,0,0
20200316,052696,玉晶光麥證97購01,2.03,2.04,1.77,1.81,-0.28,-13.4,70000,10,134760,40000,30000,10000,0,0,0,40000,30000,10000,10000
20200316,052697,滬深2X國票98購01,,,,,0.00,0.00,0,0,0,0,0,0,0,0,0,0,0,0,0
20200316,052698,深中小國票99購01,,,,,0.00,0.00,0,0,0,0,0,0,0,0,0,0,0,0,0
20200316,052699,友達國票97購01,,,,,0.00,0.00,0,0,0,0,0,0,0,0,0,0,0,0,0
20200316,05269P,臻鼎元大95售05,,,,,0.00,0.00,0,0,0,0,0,0,0,0,0,0,0,0,0
20200316,052700,奇鋐國票97購02,,,,,0.00,0.00,0,0,0,0,0,0,0,0,0,0,0,0,0
20200316,052701,群創國票96購01,,,,,0.00,0.00,0,0,0,0,0,0,0,0,0,0,0,0,0
20200316,052702,群創國票97購03,,,,,0.00,0.00,0,0,0,0,0,0,0,0,0,0,0,0,0
20200316,052703,貿聯國票97購01,,,,,0.00,0.00,0,0,0,0,0,0,0,0,0,0,0,0,0
20200316,052704,TPK國票97購01,,,,,0.00,0.00,0,0,0,0,0,0,0,0,0,0,0,0,0
20200316,052705,超眾國票97購01,0.71,0.75,0.71,0.75,+0.05,7.14,20000,2,14600,0,0,0,0,0,0,20000,0,20000,20000
20200316,052706,台虹國票97購01,1.10,1.10,0.93,0.93,+0.09,10.71,131000,2,130500,0,0,0,0,0,0,131000,0,131000,131000
20200316,052707,景碩台新96購01,0.12,0.12,0.05,0.06,-0.05,-45.45,99000,9,6950,0,0,0,0,0,0,14000,65000,-51000,-51000
20200316,052708,楠梓電永豐97購01,,,,,0.00,0.00,0,0,0,0,0,0,0,0,0,0,0,0,0
20200316,052709,光寶科日盛96購01,,,,,0.00,0.00,0,0,0,0,0,0,0,0,0,0,0,0,0
20200316,05270P,台表科元大95售05,1.18,1.18,1.18,1.18,-0.02,-1.67,10000,1,11800,0,0,0,0,0,0,0,10000,-10000,-10000
20200316,052710,玉晶光日盛96購01,,,,,0.00,0.00,0,0,0,0,0,0,0,0,0,0,0,0,0
20200316,052711,滬深2X凱基97購01,,,,,0.00,0.00,0,0,0,0,0,0,0,0,0,0,0,0,0
20200316,052712,旺宏凱基96購02,,,,,0.00,0.00,0,0,0,0,0,0,0,0,0,0,0,0,0
20200316,052713,智邦凱基96購01,0.54,0.54,0.54,0.54,-0.02,-3.57,20000,2,10800,0,0,0,0,0,0,0,20000,-20000,-20000
20200316,052714,義隆凱基96購02,,,,,0.00,0.00,0,0,0,0,0,0,0,0,0,0,0,0,0
20200316,052715,可成凱基96購01,,,,,0.00,0.00,0,0,0,0,0,0,0,0,0,0,0,0,0
20200316,052716,欣興凱基96購01,,,,,0.00,0.00,0,0,0,0,0,0,0,0,0,0,0,0,0
20200316,052717,正文凱基96購01,,,,,0.00,0.00,0,0,0,0,0,0,0,0,0,0,0,0,0
20200316,052718,新唐凱基96購01,0.10,0.10,0.10,0.10,0.00,0.00,10000,1,1000,0,0,0,0,0,0,0,10000,-10000,-10000
20200316,052719,致新凱基96購01,0.11,0.11,0.10,0.10,0.00,0.00,31000,2,3310,0,0,0,0,0,0,31000,0,31000,31000
20200316,05271P,國巨富邦97售01,0.75,0.75,0.75,0.75,+0.13,20.97,2000,1,1500,0,0,0,0,0,0,0,0,0,0
20200316,052720,鴻海統一96購07,,,,,0.00,0.00,0,0,0,0,0,0,0,0,0,0,0,0,0
20200316,052721,友達統一96購01,0.13,0.13,0.13,0.13,0.00,0.00,185000,2,24050,0,0,0,0,0,0,185000,0,185000,185000
20200316,052722,群創統一97購02,,,,,0.00,0.00,0,0,0,0,0,0,0,0,0,0,0,0,0
20200316,052723,新唐統一97購01,0.25,0.25,0.25,0.25,+0.01,4.17,5000,1,1250,0,0,0,0,0,0,5000,0,5000,5000
20200316,052724,力成統一97購01,0.82,0.82,0.82,0.82,0.00,0.00,3000,1,2460,0,0,0,0,0,0,0,3000,-3000,-3000
20200316,052725,為升元富96購01,,,,,0.00,0.00,0,0,0,0,0,0,0,0,0,0,0,0,0
20200316,052726,鴻海元富96購03,,,,,0.00,0.00,0,0,0,0,0,0,0,0,0,0,0,0,0
20200316,052727,仁寶元富96購01,0.44,0.44,0.38,0.38,-0.05,-11.63,161000,9,68820,0,0,0,0,0,0,121000,40000,81000,81000
20200316,052728,上証2X國泰97購01,,,,,0.00,0.00,0,0,0,0,0,0,0,0,0,0,0,0,0
20200316,052729,國巨國泰97購03,,,,,0.00,0.00,0,0,0,0,0,0,0,0,0,0,0,0,0
20200316,05272P,臻鼎中信97售03,1.40,1.46,1.20,1.46,+0.16,12.31,158000,22,210110,0,0,0,0,0,0,53000,105000,-52000,-52000
20200316,052730,華新科國泰98購01,,,,,0.00,0.00,0,0,0,0,0,0,0,0,0,0,0,0,0
20200316,052731,宏達電國泰98購01,0.52,0.52,0.47,0.47,+0.04,9.3,10000,3,4840,0,0,0,0,0,0,6000,0,6000,6000
20200316,052732,新唐國泰97購01,,,,,0.00,0.00,0,0,0,0,0,0,0,0,0,0,0,0,0
20200316,052733,台郡國泰97購01,0.52,0.52,0.45,0.45,-0.11,-19.64,15000,2,7660,0,0,0,0,0,0,13000,13000,0,0
20200316,052734,台表科國泰98購02,0.10,0.10,0.10,0.10,0.00,0.00,2000,1,200,0,0,0,0,0,0,2000,0,2000,2000
20200316,052735,燿華富邦98購01,,,,,0.00,0.00,0,0,0,0,0,0,0,0,0,0,0,0,0
20200316,052736,T50反1元大96購05,1.76,2.24,1.76,2.24,+0.46,25.84,22000,4,43060,0,0,0,0,0,0,9000,13000,-4000,-4000
20200316,052737,滬深2X元大96購06,,,,,0.00,0.00,0,0,0,0,0,0,0,0,0,0,0,0,0
20200316,052738,聯電元大98購02,0.52,0.52,0.46,0.46,-0.07,-13.21,321000,25,155320,0,0,0,0,0,0,216000,105000,111000,111000
20200316,052739,國巨元大96購04,0.88,0.88,0.88,0.88,-0.02,-2.22,40000,1,35200,0,0,0,0,0,0,40000,0,40000,40000
20200316,05273P,國巨群益95售02,,,,,0.00,0.00,0,0,0,0,0,0,0,0,0,0,0,0,0
20200316,052740,聯發科元大96購07,0.06,0.06,0.05,0.05,-0.06,-54.55,60000,6,3500,0,0,0,0,0,0,0,60000,-60000,-60000
20200316,052741,聯發科元大96購08,0.10,0.10,0.10,0.10,0.00,0.00,10000,1,1000,0,0,0,0,0,0,0,10000,-10000,-10000
20200316,052742,可成元大96購01,0.17,0.21,0.17,0.21,+0.03,16.67,450000,23,84000,0,0,0,0,0,0,450000,200000,250000,250000
20200316,052743,華新科元大97購01,1.08,1.23,0.84,0.88,-0.22,-20.0,299000,37,313140,0,0,0,0,0,0,73000,266000,-193000,-193000
20200316,052744,聯詠元大97購01,0.22,0.22,0.22,0.22,+0.05,29.41,5000,1,1100,0,0,0,0,0,0,5000,0,5000,5000
20200316,052745,欣興元大96購04,0.07,0.07,0.07,0.07,0.00,0.00,44000,2,3080,0,0,0,0,0,0,44000,0,44000,44000
20200316,052746,泰碩元大97購01,0.60,0.61,0.32,0.32,-0.18,-36.0,338000,14,201820,0,0,0,0,0,0,318000,20000,298000,298000
20200316,052747,京鼎元大97購01,0.26,0.29,0.16,0.17,-0.08,-32.0,468000,21,114110,0,0,0,0,0,0,328000,140000,188000,188000
20200316,052748,群創元大9A購02,,,,,0.00,0.00,0,0,0,0,0,0,0,0,0,0,0,0,0
20200316,052749,日月光元大96購02,,,,,0.00,0.00,0,0,0,0,0,0,0,0,0,0,0,0,0
20200316,05274P,嘉聯益亞東95售01,1.52,1.52,1.52,1.52,-0.17,-10.06,50000,1,76000,0,0,0,0,0,0,50000,0,50000,50000
20200316,052750,臺股指元大96購04,0.13,0.19,0.13,0.16,-0.03,-15.79,443000,29,71770,0,0,0,0,0,0,14000,82000,-68000,-68000
20200316,052751,臺股指元大96購05,0.08,0.11,0.06,0.11,-0.04,-26.67,132000,5,9820,0,0,0,0,0,0,130000,0,130000,130000
20200316,052752,臺股指元大96購06,,,,,0.00,0.00,0,0,0,0,0,0,0,0,0,0,0,0,0
20200316,052753,電子類元大96購02,0.24,0.24,0.12,0.20,-0.08,-28.57,102000,6,14940,0,0,0,0,0,0,50000,22000,28000,28000
20200316,052754,上証2X群益9A購01,0.87,0.87,0.74,0.79,+0.10,14.49,22000,3,18080,0,0,0,0,0,0,20000,12000,8000,8000
20200316,052755,滬深2X群益9A購01,0.30,0.32,0.30,0.31,0.00,0.00,651000,14,202800,0,0,0,0,0,0,0,651000,-651000,-651000
20200316,052756,國巨群益96購02,1.10,1.10,0.91,0.91,0.00,0.00,90000,3,92000,0,0,0,0,0,0,0,90000,-90000,-90000
20200316,052757,華邦電群益96購01,,,,,0.00,0.00,0,0,0,0,0,0,0,0,0,0,0,0,0
20200316,052758,友達群益99購01,,,,,0.00,0.00,0,0,0,0,0,0,0,0,0,0,0,0,0
20200316,052759,京元電群益96購01,0.36,0.36,0.34,0.34,+0.17,100.0,4000,2,1400,0,0,0,0,0,0,2000,2000,0,0
20200316,05275P,國巨凱基95售05,0.90,1.30,0.79,1.30,+0.41,46.07,324000,11,277420,0,0,0,0,0,0,266000,20000,246000,246000
20200316,052760,盟立群益96購01,0.10,0.10,0.09,0.09,0.00,0.00,80000,3,7500,0,0,0,0,0,0,0,80000,-80000,-80000
20200316,052761,可成群益96購02,,,,,0.00,0.00,0,0,0,0,0,0,0,0,0,0,0,0,0
20200316,052762,欣興群益96購01,,,,,0.00,0.00,0,0,0,0,0,0,0,0,0,0,0,0,0
20200316,052763,晶技群益97購01,1.74,1.74,1.35,1.35,+0.06,4.65,30000,2,48300,0,0,0,0,0,0,30000,0,30000,30000
20200316,052764,景碩群益98購01,0.24,0.24,0.16,0.16,-0.06,-27.27,30000,2,5600,0,0,0,0,0,0,30000,0,30000,30000
20200316,052765,新日興群益97購01,0.43,0.43,0.37,0.37,-0.22,-37.29,30000,2,11700,0,0,0,0,0,0,30000,0,30000,30000
20200316,052766,玉晶光群益9A購01,3.16,3.16,2.87,2.87,-0.01,-0.35,156000,4,448380,0,0,0,0,0,0,156000,3000,153000,153000
20200316,052767,智伸科群益98購01,,,,,0.00,0.00,0,0,0,0,0,0,0,0,0,0,0,0,0
20200316,052768,泰鼎群益96購01,,,,,0.00,0.00,0,0,0,0,0,0,0,0,0,0,0,0,0
20200316,052769,達興群益96購01,,,,,0.00,0.00,0,0,0,0,0,0,0,0,0,0,0,0,0
20200316,05276P,GIS永豐95售02,2.00,2.00,1.99,1.99,-0.13,-6.13,3000,2,5990,0,0,0,0,0,0,0,3000,-3000,-3000
20200316,052770,聯茂群益96購02,0.76,0.76,0.68,0.68,-0.11,-13.92,10000,2,7200,0,0,0,0,0,0,5000,10000,-5000,-5000
20200316,052771,GIS群益96購01,0.20,0.21,0.15,0.15,+0.01,7.14,134000,6,25300,0,0,0,0,0,0,40000,94000,-54000,-54000
20200316,052772,台虹群益96購01,,,,,0.00,0.00,0,0,0,0,0,0,0,0,0,0,0,0,0
20200316,052773,大成鋼亞東97購01,,,,,0.00,0.00,0,0,0,0,0,0,0,0,0,0,0,0,0
20200316,052774,京元電亞東96購01,,,,,0.00,0.00,0,0,0,0,0,0,0,0,0,0,0,0,0
20200316,052775,滬深2X國票99購02,,,,,0.00,0.00,0,0,0,0,0,0,0,0,0,0,0,0,0
20200316,052776,力山國票97購01,0.06,0.06,0.06,0.06,0.00,0.00,10000,1,600,0,0,0,0,0,0,0,0,0,0
20200316,052777,燿華國票98購01,,,,,0.00,0.00,0,0,0,0,0,0,0,0,0,0,0,0,0
20200316,052778,智原國票97購01,,,,,0.00,0.00,0,0,0,0,0,0,0,0,0,0,0,0,0
20200316,052779,欣興國票97購01,,,,,0.00,0.00,0,0,0,0,0,0,0,0,0,0,0,0,0
20200316,05277P,深中小統一95售02,,,,,0.00,0.00,0,0,0,0,0,0,0,0,0,0,0,0,0
20200316,052780,玉晶光國票96購04,1.98,1.98,1.23,1.23,-0.72,-36.92,101000,11,163880,0,0,0,0,0,0,85000,69000,16000,16000
20200316,052781,瀚宇博國票97購03,,,,,0.00,0.00,0,0,0,0,0,0,0,0,0,0,0,0,0
20200316,052782,超眾國票96購02,0.82,0.82,0.82,0.82,+0.22,36.67,10000,1,8200,0,0,0,0,0,0,10000,0,10000,10000
20200316,052783,台郡國票97購01,0.20,0.20,0.20,0.20,+0.09,81.82,20000,1,4000,0,0,0,0,0,0,20000,0,20000,20000
20200316,052784,緯穎國票97購02,5.20,5.20,5.20,5.20,0.00,0.00,4000,1,20800,0,0,0,0,0,0,4000,0,4000,4000
20200316,052785,滬深2X中信99購03,0.79,0.79,0.66,0.66,+0.03,4.76,91000,9,65980,0,0,0,0,0,0,53000,38000,15000,15000
20200316,052786,S&P500中信96購01,0.02,0.07,0.02,0.07,+0.01,16.67,359000,6,11080,0,0,0,0,0,0,0,10000,-10000,-10000
20200316,052787,國巨中信96購02,0.27,0.27,0.24,0.24,-0.05,-17.24,145000,2,37800,0,0,0,0,0,0,145000,0,145000,145000
20200316,052788,開發金中信98購02,,,,,0.00,0.00,0,0,0,0,0,0,0,0,0,0,0,0,0
20200316,052789,台積電麥證96購01,1.35,1.35,0.75,0.84,-0.72,-46.15,1198000,46,1108100,788000,275000,513000,0,0,0,788000,275000,513000,513000
20200316,05278P,台郡元富95售02,1.35,1.68,1.31,1.68,+0.06,3.7,201000,13,295690,0,0,0,0,0,0,166000,35000,131000,131000
20200316,052790,智邦兆豐97購01,1.41,1.41,1.14,1.15,-0.08,-6.5,90000,10,117050,0,0,0,0,0,0,45000,55000,-10000,-10000
20200316,052791,友達兆豐97購01,,,,,0.00,0.00,0,0,0,0,0,0,0,0,0,0,0,0,0
20200316,052792,大立光兆豐96購01,0.32,0.32,0.32,0.32,+0.17,113.33,100000,1,32000,0,0,0,0,0,0,100000,0,100000,100000
20200316,052793,健鼎兆豐96購01,,,,,0.00,0.00,0,0,0,0,0,0,0,0,0,0,0,0,0
20200316,052794,群創兆豐97購01,0.14,0.14,0.13,0.13,+0.03,30.0,100000,2,13600,0,0,0,0,0,0,0,100000,-100000,-100000
20200316,052795,健策兆豐97購01,0.36,0.36,0.36,0.36,-0.04,-10.0,10000,1,3600,0,0,0,0,0,0,10000,0,10000,10000
20200316,052796,和碩兆豐96購01,0.13,0.13,0.13,0.13,0.00,0.00,15000,1,1950,0,0,0,0,0,0,15000,0,15000,15000
20200316,052797,樺漢兆豐96購01,,,,,0.00,0.00,0,0,0,0,0,0,0,0,0,0,0,0,0
20200316,052798,滬深2X元大96購07,0.34,0.34,0.34,0.34,-0.27,-44.26,180000,3,61200,0,0,0,0,0,0,180000,0,180000,180000
20200316,052799,上銀元大96購01,0.90,0.92,0.75,0.75,-0.34,-31.19,18000,3,15800,0,0,0,0,0,0,14000,4000,10000,10000
20200316,05279P,上銀元大95售02,1.37,1.76,1.37,1.76,+0.17,10.69,17000,7,25200,0,0,0,0,0,0,0,17000,-17000,-17000
20200316,052800,國巨元大96購05,1.90,1.90,1.80,1.80,0.00,0.00,100000,10,185000,0,0,0,0,0,0,0,100000,-100000,-100000
20200316,052801,友達元大9A購01,0.65,0.65,0.60,0.60,0.00,0.00,21000,3,13200,0,0,0,0,0,0,11000,21000,-10000,-10000
20200316,052802,華新科元大97購02,1.09,1.23,0.86,0.89,-0.16,-15.24,420000,42,434800,0,0,0,0,0,0,70000,410000,-340000,-340000
20200316,052803,冠德元大96購01,,,,,0.00,0.00,0,0,0,0,0,0,0,0,0,0,0,0,0
20200316,052804,淘帝元大96購01,,,,,0.00,0.00,0,0,0,0,0,0,0,0,0,0,0,0,0
20200316,052805,晶技元大97購01,0.83,0.92,0.76,0.76,+0.05,7.04,97000,13,85180,0,0,0,0,0,0,66000,8000,58000,58000
20200316,052806,玉晶光元大98購04,2.25,2.29,1.51,1.51,-0.68,-31.05,173000,24,340620,0,0,0,0,0,0,134000,165000,-31000,-31000
20200316,052807,貿聯元大98購01,0.25,0.25,0.25,0.25,+0.04,19.05,40000,4,10000,0,0,0,0,0,0,0,40000,-40000,-40000
20200316,052808,矽力元大96購02,,,,,0.00,0.00,0,0,0,0,0,0,0,0,0,0,0,0,0
20200316,052809,訊芯元大97購01,0.33,0.35,0.22,0.22,-0.08,-26.67,478000,41,146530,0,0,0,0,0,0,110000,368000,-258000,-258000
20200316,05280P,華通元大95售08,,,,,0.00,0.00,0,0,0,0,0,0,0,0,0,0,0,0,0
20200316,052810,易華電元大96購02,,,,,0.00,0.00,0,0,0,0,0,0,0,0,0,0,0,0,0
20200316,052811,玉晶光台新96購03,0.99,1.08,0.65,0.65,-0.43,-39.81,380000,36,347480,0,0,0,0,0,0,308000,139000,169000,169000
20200316,052812,致伸康和96購01,,,,,0.00,0.00,0,0,0,0,0,0,0,0,0,0,0,0,0
20200316,052813,T50正2永豐96購01,0.14,0.14,0.08,0.08,-0.06,-42.86,242000,23,20680,0,0,0,0,0,0,0,186000,-186000,-186000
20200316,052814,上証2X永豐96購02,0.41,0.41,0.40,0.40,-0.25,-38.46,60000,3,24100,0,0,0,0,0,0,0,0,0,0
20200316,052815,滬深2X永豐97購01,0.21,0.21,0.21,0.21,-0.04,-16.0,5000,1,1050,0,0,0,0,0,0,5000,0,5000,5000
20200316,052816,上銀永豐96購01,0.35,0.38,0.35,0.38,+0.05,15.15,60000,2,22500,0,0,0,0,0,0,50000,10000,40000,40000
20200316,052817,楠梓電永豐96購02,,,,,0.00,0.00,0,0,0,0,0,0,0,0,0,0,0,0,0
20200316,052818,智邦永豐96購01,0.57,0.58,0.57,0.58,+0.16,38.1,126000,2,72500,0,0,0,0,0,0,68000,58000,10000,10000
20200316,052819,義隆永豐96購01,,,,,0.00,0.00,0,0,0,0,0,0,0,0,0,0,0,0,0
20200316,05281P,南亞科元大95售03,2.53,2.71,2.50,2.71,0.00,0.00,28000,3,71980,0,0,0,0,0,0,0,28000,-28000,-28000
20200316,052820,宏達電永豐96購01,,,,,0.00,0.00,0,0,0,0,0,0,0,0,0,0,0,0,0
20200316,052821,晶技永豐96購01,0.29,0.41,0.27,0.29,-0.01,-3.33,246000,25,75610,0,0,0,0,0,0,50000,196000,-146000,-146000
20200316,052822,泰碩永豐97購01,0.15,0.58,0.15,0.31,-0.27,-46.55,99000,5,42040,0,0,0,0,0,0,53000,25000,28000,28000
20200316,052823,創意永豐96購02,,,,,0.00,0.00,0,0,0,0,0,0,0,0,0,0,0,0,0
20200316,052824,揚明光永豐96購02,,,,,0.00,0.00,0,0,0,0,0,0,0,0,0,0,0,0,0
20200316,052825,TPK永豐96購01,,,,,0.00,0.00,0,0,0,0,0,0,0,0,0,0,0,0,0
20200316,052826,嘉聯益永豐96購01,0.18,0.18,0.18,0.18,0.00,0.00,20000,1,3600,0,0,0,0,0,0,0,20000,-20000,-20000
20200316,052827,昇陽半永豐97購01,,,,,0.00,0.00,0,0,0,0,0,0,0,0,0,0,0,0,0
20200316,052828,滬深2X群益9A購02,0.20,0.20,0.17,0.17,-0.05,-22.73,40000,2,7100,0,0,0,0,0,0,40000,0,40000,40000
20200316,052829,上銀群益96購01,0.61,0.61,0.61,0.61,+0.17,38.64,10000,1,6100,0,0,0,0,0,0,10000,0,10000,10000
20200316,05282P,可成元大95售09,3.31,3.34,3.31,3.34,+0.02,0.6,2000,2,6650,0,0,0,0,0,0,2000,0,2000,2000
20200316,052830,台光電群益96購01,0.34,0.34,0.32,0.32,0.00,0.00,41000,2,13340,0,0,0,0,0,0,41000,0,41000,41000
20200316,052831,華固群益96購01,1.19,1.19,1.08,1.17,+0.04,3.54,748000,10,851940,0,0,0,0,0,0,299000,449000,-150000,-150000
20200316,052832,益航群益96購01,0.17,0.17,0.13,0.14,-0.01,-6.67,87000,6,11980,0,0,0,0,0,0,25000,62000,-37000,-37000
20200316,052833,康控群益96購01,,,,,0.00,0.00,0,0,0,0,0,0,0,0,0,0,0,0,0
20200316,052834,彩晶群益96購01,0.26,0.26,0.26,0.26,+0.07,36.84,122000,3,31720,0,0,0,0,0,0,122000,0,122000,122000
20200316,052835,滬深2X國泰98購01,,,,,0.00,0.00,0,0,0,0,0,0,0,0,0,0,0,0,0
20200316,052836,旺宏國泰98購01,0.56,0.56,0.56,0.56,+0.05,9.8,34000,2,19040,0,0,0,0,0,0,34000,0,34000,34000
20200316,052837,友達國泰97購01,,,,,0.00,0.00,0,0,0,0,0,0,0,0,0,0,0,0,0
20200316,052838,新唐國泰98購01,0.33,0.33,0.29,0.29,-0.05,-14.71,80000,8,25500,0,0,0,0,0,0,0,80000,-80000,-80000
20200316,052839,上海銀國泰97購01,0.21,0.21,0.14,0.14,-0.06,-30.0,32000,2,4620,0,0,0,0,0,0,2000,0,2000,2000
20200316,05283P,健鼎元大95售04,2.12,2.28,2.11,2.28,+0.04,1.79,26000,5,55320,0,0,0,0,0,0,5000,21000,-16000,-16000
20200316,052840,友達富邦96購01,,,,,0.00,0.00,0,0,0,0,0,0,0,0,0,0,0,0,0
20200316,052841,群創富邦96購02,,,,,0.00,0.00,0,0,0,0,0,0,0,0,0,0,0,0,0
20200316,052842,滬深2X統一96購01,,,,,0.00,0.00,0,0,0,0,0,0,0,0,0,0,0,0,0
20200316,052843,鴻海統一96購09,,,,,0.00,0.00,0,0,0,0,0,0,0,0,0,0,0,0,0
20200316,052844,台積電統一96購02,0.49,0.49,0.37,0.40,-0.30,-42.86,1078000,6,411590,0,0,0,0,0,0,1078000,0,1078000,1078000
20200316,052845,旺宏統一97購01,,,,,0.00,0.00,0,0,0,0,0,0,0,0,0,0,0,0,0
20200316,052846,智邦統一97購01,,,,,0.00,0.00,0,0,0,0,0,0,0,0,0,0,0,0,0
20200316,052847,漢唐統一99購01,,,,,0.00,0.00,0,0,0,0,0,0,0,0,0,0,0,0,0
20200316,052848,聯發科統一96購03,0.13,0.13,0.13,0.13,0.00,0.00,10000,1,1300,0,0,0,0,0,0,0,10000,-10000,-10000
20200316,052849,可成統一97購01,0.19,0.19,0.19,0.19,0.00,0.00,1000,1,190,0,0,0,0,0,0,0,1000,-1000,-1000
20200316,05284P,鴻海兆豐95售04,3.09,3.09,3.09,3.09,-0.13,-4.04,20000,1,61800,0,0,0,0,0,0,20000,20000,0,0
20200316,052850,華新科統一96購02,,,,,0.00,0.00,0,0,0,0,0,0,0,0,0,0,0,0,0
20200316,052851,滬深2X元富96購02,0.34,0.46,0.30,0.30,-0.24,-44.44,653000,18,227220,0,0,0,0,0,0,458000,91000,367000,367000
20200316,052852,國巨元富96購02,0.24,0.24,0.12,0.18,-0.06,-25.0,722000,32,128680,0,0,0,0,0,0,0,0,0,0
20200316,052853,友達日盛99購01,,,,,0.00,0.00,0,0,0,0,0,0,0,0,0,0,0,0,0
20200316,052854,聯詠日盛96購01,,,,,0.00,0.00,0,0,0,0,0,0,0,0,0,0,0,0,0
20200316,052855,群創日盛99購01,,,,,0.00,0.00,0,0,0,0,0,0,0,0,0,0,0,0,0
20200316,052856,滬深2X凱基98購01,,,,,0.00,0.00,0,0,0,0,0,0,0,0,0,0,0,0,0
20200316,052857,大成鋼凱基96購01,0.50,0.50,0.44,0.44,-0.04,-8.33,299000,6,147700,0,0,0,0,0,0,30000,269000,-239000,-239000
20200316,052858,華通凱基97購02,0.02,0.02,0.02,0.02,0.00,0.00,100000,1,2000,0,0,0,0,0,0,100000,0,100000,100000
20200316,052859,國巨凱基96購07,0.31,0.31,0.31,0.31,+0.09,40.91,55000,6,17050,0,0,0,0,0,0,0,55000,-55000,-55000
20200316,05285P,同欣電群益95售02,,,,,0.00,0.00,0,0,0,0,0,0,0,0,0,0,0,0,0
20200316,052860,旺宏凱基96購03,0.46,0.46,0.35,0.35,0.00,0.00,400000,2,173000,0,0,0,0,0,0,0,400000,-400000,-400000
20200316,052861,台光電凱基96購03,0.29,0.29,0.29,0.29,+0.04,16.0,50000,1,14500,0,0,0,0,0,0,50000,0,50000,50000
20200316,052862,正崴凱基96購01,,,,,0.00,0.00,0,0,0,0,0,0,0,0,0,0,0,0,0
20200316,052863,友達凱基98購02,0.41,0.41,0.41,0.41,0.00,0.00,1000,1,410,0,0,0,0,0,0,0,1000,-1000,-1000
20200316,052864,奇力新凱基96購02,,,,,0.00,0.00,0,0,0,0,0,0,0,0,0,0,0,0,0
20200316,052865,大立光凱基96購11,0.25,0.25,0.15,0.16,0.00,0.00,261000,6,56260,0,0,0,0,0,0,0,261000,-261000,-261000
20200316,052866,大立光凱基96購12,0.35,0.35,0.18,0.18,-0.19,-51.35,284000,7,64610,0,0,0,0,0,0,195000,10000,185000,185000
20200316,052867,晶技凱基96購01,0.79,0.93,0.79,0.84,+0.07,9.09,74000,13,65690,0,0,0,0,0,0,43000,34000,9000,9000
20200316,052868,緯創凱基96購03,,,,,0.00,0.00,0,0,0,0,0,0,0,0,0,0,0,0,0
20200316,052869,新日興凱基96購01,0.26,0.26,0.26,0.26,-0.02,-7.14,100000,1,26000,0,0,0,0,0,0,100000,0,100000,100000
20200316,05286P,矽力統一95售02,1.11,1.30,1.10,1.30,+0.26,25.0,59000,10,70810,0,0,0,0,0,0,22000,30000,-8000,-8000
20200316,052870,玉晶光凱基96購03,0.59,0.59,0.33,0.33,-0.25,-43.1,373000,7,202830,0,0,0,0,0,0,353000,20000,333000,333000
20200316,052871,群創凱基98購07,0.07,0.07,0.07,0.07,+0.01,16.67,25000,1,1750,0,0,0,0,0,0,25000,0,25000,25000
20200316,052872,智易凱基96購01,,,,,0.00,0.00,0,0,0,0,0,0,0,0,0,0,0,0,0
20200316,052873,新唐凱基96購02,,,,,0.00,0.00,0,0,0,0,0,0,0,0,0,0,0,0,0
20200316,052874,超眾凱基96購01,,,,,0.00,0.00,0,0,0,0,0,0,0,0,0,0,0,0,0
20200316,052875,樺漢凱基96購02,,,,,0.00,0.00,0,0,0,0,0,0,0,0,0,0,0,0,0
20200316,052876,GIS凱基96購03,,,,,0.00,0.00,0,0,0,0,0,0,0,0,0,0,0,0,0
20200316,052877,矽創凱基96購01,0.16,0.16,0.09,0.09,-0.04,-30.77,598000,2,74750,0,0,0,0,0,0,299000,299000,0,0
20200316,052878,台虹凱基96購01,0.42,0.42,0.39,0.39,-0.01,-2.5,90000,2,36300,0,0,0,0,0,0,90000,0,90000,90000
20200316,052879,滬深2X凱基97購02,,,,,0.00,0.00,0,0,0,0,0,0,0,0,0,0,0,0,0
20200316,05287P,鴻海元富95售09,,,,,0.00,0.00,0,0,0,0,0,0,0,0,0,0,0,0,0
20200316,052880,台積電凱基96購06,,,,,0.00,0.00,0,0,0,0,0,0,0,0,0,0,0,0,0
20200316,052881,康控凱基97購01,,,,,0.00,0.00,0,0,0,0,0,0,0,0,0,0,0,0,0
20200316,052882,南電凱基96購02,0.39,0.39,0.26,0.26,-0.20,-43.48,545000,12,151450,0,0,0,0,0,0,518000,22000,496000,496000
20200316,052883,百和亞東97購01,0.05,0.05,0.05,0.05,-0.01,-16.67,12000,1,600,0,0,0,0,0,0,0,12000,-12000,-12000
20200316,052884,台積電兆豐96購01,0.35,0.39,0.19,0.19,-0.17,-47.22,379000,15,108100,0,0,0,0,0,0,317000,30000,287000,287000
20200316,052885,高鐵兆豐98購01,0.25,0.27,0.25,0.26,+0.03,13.04,353000,15,93490,0,0,0,0,0,0,100000,253000,-153000,-153000
20200316,052886,世紀鋼兆豐96購01,1.88,1.95,1.74,1.74,+0.44,33.85,588000,42,1086830,0,0,0,0,0,0,588000,0,588000,588000
20200316,052887,華通中信96購01,,,,,0.00,0.00,0,0,0,0,0,0,0,0,0,0,0,0,0
20200316,052888,台表科中信9A購01,0.05,0.05,0.05,0.05,-0.03,-37.5,30000,1,1500,0,0,0,0,0,0,0,0,0,0
20200316,052889,致伸麥證97購01,0.05,0.05,0.05,0.05,-0.03,-37.5,20000,1,1000,20000,0,20000,0,0,0,20000,0,20000,20000
20200316,05288P,寶成元富95售02,3.64,3.75,3.64,3.75,+0.33,9.65,69000,3,258060,0,0,0,0,0,0,69000,0,69000,69000
20200316,052890,FB上証群益9B購01,,,,,0.00,0.00,0,0,0,0,0,0,0,0,0,0,0,0,0
20200316,052891,台泥群益96購01,,,,,0.00,0.00,0,0,0,0,0,0,0,0,0,0,0,0,0
20200316,052892,大成鋼群益96購01,0.63,0.63,0.63,0.63,-0.20,-24.1,5000,1,3150,0,0,0,0,0,0,5000,0,5000,5000
20200316,052893,聯電群益98購01,,,,,0.00,0.00,0,0,0,0,0,0,0,0,0,0,0,0,0
20200316,052894,國巨群益96購03,,,,,0.00,0.00,0,0,0,0,0,0,0,0,0,0,0,0,0
20200316,052895,台積電群益96購04,1.65,1.65,1.21,1.21,-0.78,-39.2,17000,6,22550,0,0,0,0,0,0,0,17000,-17000,-17000
20200316,052896,宏達電群益96購01,0.53,0.53,0.53,0.53,-0.03,-5.36,1000,1,530,0,0,0,0,0,0,1000,1000,0,0
20200316,052897,緯創群益96購03,,,,,0.00,0.00,0,0,0,0,0,0,0,0,0,0,0,0,0
20200316,052898,樺漢群益96購01,,,,,0.00,0.00,0,0,0,0,0,0,0,0,0,0,0,0,0
20200316,052899,和大國票97購01,0.14,0.14,0.11,0.11,0.00,0.00,838000,7,115820,0,0,0,0,0,0,838000,0,838000,838000
20200316,05289P,鴻海永豐95售05,2.53,3.30,2.53,3.30,+0.80,32.0,80000,7,244200,0,0,0,0,0,0,40000,40000,0,0
20200316,052900,大成鋼國票97購01,,,,,0.00,0.00,0,0,0,0,0,0,0,0,0,0,0,0,0
20200316,052901,台達電國票97購01,,,,,0.00,0.00,0,0,0,0,0,0,0,0,0,0,0,0,0
20200316,052902,鴻海國票97購04,,,,,0.00,0.00,0,0,0,0,0,0,0,0,0,0,0,0,0
20200316,052903,致茂國票97購01,0.69,0.69,0.35,0.35,-0.10,-22.22,45000,8,23750,0,0,0,0,0,0,10000,35000,-25000,-25000
20200316,052904,冠德國票97購01,,,,,0.00,0.00,0,0,0,0,0,0,0,0,0,0,0,0,0
20200316,052905,潤泰全國票97購01,0.14,0.14,0.14,0.14,+0.06,75.0,1000,1,140,0,0,0,0,0,0,0,0,0,0
20200316,052906,緯創國票97購01,,,,,0.00,0.00,0,0,0,0,0,0,0,0,0,0,0,0,0
20200316,052907,嘉澤國票97購01,,,,,0.00,0.00,0,0,0,0,0,0,0,0,0,0,0,0,0
20200316,052908,大成鋼統一96購01,,,,,0.00,0.00,0,0,0,0,0,0,0,0,0,0,0,0,0
20200316,052909,上銀統一96購01,,,,,0.00,0.00,0,0,0,0,0,0,0,0,0,0,0,0,0
20200316,05290P,國巨永豐95售04,0.88,0.88,0.88,0.88,+0.21,31.34,3000,1,2640,0,0,0,0,0,0,3000,0,3000,3000
20200316,052910,鴻海統一96購10,0.03,0.12,0.03,0.12,+0.11,1100.0,5000,2,240,0,0,0,0,0,0,4000,1000,3000,3000
20200316,052911,友達統一97購02,,,,,0.00,0.00,0,0,0,0,0,0,0,0,0,0,0,0,0
20200316,052912,日月光統一96購01,0.07,0.08,0.07,0.08,-0.01,-11.11,2000,2,150,0,0,0,0,0,0,2000,0,2000,2000
20200316,052913,鴻海元富96購05,,,,,0.00,0.00,0,0,0,0,0,0,0,0,0,0,0,0,0
20200316,052914,奇力新元富96購01,0.10,0.10,0.08,0.08,+0.01,14.29,50000,3,4500,0,0,0,0,0,0,50000,0,50000,50000
20200316,052915,創意元富96購01,0.18,0.18,0.18,0.18,0.00,0.00,10000,2,1800,0,0,0,0,0,0,0,10000,-10000,-10000
20200316,052916,華新科富邦96購01,0.86,0.90,0.67,0.67,-0.01,-1.47,90000,9,67000,0,0,0,0,0,0,10000,80000,-70000,-70000
20200316,052917,大立光富邦99購02,0.34,0.40,0.32,0.32,-0.05,-13.51,867000,37,300380,0,0,0,0,0,0,541000,164000,377000,377000
20200316,052918,智易富邦97購02,,,,,0.00,0.00,0,0,0,0,0,0,0,0,0,0,0,0,0
20200316,052919,鈺齊富邦98購01,,,,,0.00,0.00,0,0,0,0,0,0,0,0,0,0,0,0,0
20200316,05291P,鴻海凱基95售16,1.52,2.21,1.52,2.18,+0.79,56.83,146000,22,287300,0,0,0,0,0,0,101000,125000,-24000,-24000
20200316,052920,景碩台新96購02,0.12,0.13,0.09,0.09,0.00,0.00,112000,13,13090,0,0,0,0,0,0,0,112000,-112000,-112000
20200316,052921,大成鋼永豐96購01,,,,,0.00,0.00,0,0,0,0,0,0,0,0,0,0,0,0,0
20200316,052922,國巨永豐96購01,0.13,0.13,0.07,0.07,-0.06,-46.15,217000,10,19720,0,0,0,0,0,0,0,217000,-217000,-217000
20200316,052923,台積電永豐96購02,0.29,0.29,0.29,0.29,-0.07,-19.44,2000,1,580,0,0,0,0,0,0,0,2000,-2000,-2000
20200316,052924,旺宏永豐96購01,,,,,0.00,0.00,0,0,0,0,0,0,0,0,0,0,0,0,0
20200316,052925,日電貿永豐96購01,0.10,0.10,0.07,0.07,-0.01,-12.5,77000,4,6830,0,0,0,0,0,0,20000,57000,-37000,-37000
20200316,052926,旺宏元大98購02,0.35,0.39,0.24,0.24,-0.09,-27.27,187000,17,59960,0,0,0,0,0,0,30000,157000,-127000,-127000
20200316,052927,友達元大98購02,0.72,0.77,0.65,0.66,-0.04,-5.71,492000,51,357390,0,0,0,0,0,0,30000,472000,-442000,-442000
20200316,052928,美律元大98購01,,,,,0.00,0.00,0,0,0,0,0,0,0,0,0,0,0,0,0
20200316,052929,可成元大96購02,,,,,0.00,0.00,0,0,0,0,0,0,0,0,0,0,0,0,0
20200316,05292P,台積電凱基95售16,,,,,0.00,0.00,0,0,0,0,0,0,0,0,0,0,0,0,0
20200316,052930,華新科元大97購03,0.85,0.97,0.65,0.70,-0.14,-16.67,248000,22,208920,0,0,0,0,0,0,168000,120000,48000,48000
20200316,052931,麗豐元大97購01,,,,,0.00,0.00,0,0,0,0,0,0,0,0,0,0,0,0,0
20200316,052932,正文元大97購01,0.36,0.36,0.36,0.36,-0.01,-2.7,20000,1,7200,0,0,0,0,0,0,20000,0,20000,20000
20200316,052933,祥碩元大96購01,4.17,4.17,3.88,3.92,-0.04,-1.01,60000,19,242240,0,0,0,0,0,0,60000,40000,20000,20000
20200316,052934,中磊元大96購01,0.52,0.53,0.49,0.53,+0.05,10.42,90000,7,45600,0,0,0,0,0,0,40000,50000,-10000,-10000
20200316,052935,康友元大96購03,0.39,0.42,0.27,0.27,-0.15,-35.71,105000,9,37610,0,0,0,0,0,0,62000,85000,-23000,-23000
20200316,052936,華通兆豐98購01,0.08,0.10,0.05,0.05,-0.03,-37.5,355000,8,25500,0,0,0,0,0,0,200000,0,200000,200000
20200316,052937,國巨兆豐97購01,0.18,0.18,0.18,0.18,-0.08,-30.77,151000,5,27180,0,0,0,0,0,0,15000,0,15000,15000
20200316,052938,華新科兆豐96購01,0.61,0.71,0.41,0.41,0.00,0.00,107000,5,65990,0,0,0,0,0,0,107000,0,107000,107000
20200316,052939,富邦金兆豐96購01,0.28,0.28,0.18,0.18,-0.05,-21.74,890000,9,207800,0,0,0,0,0,0,620000,270000,350000,350000
20200316,05293P,廣達凱基95售01,0.15,0.19,0.15,0.19,-0.08,-29.63,330000,3,50100,0,0,0,0,0,0,0,330000,-330000,-330000
20200316,052940,玉晶光兆豐97購01,1.04,1.05,0.76,0.76,-0.26,-25.49,62000,10,57640,0,0,0,0,0,0,32000,62000,-30000,-30000
20200316,052941,康控兆豐97購01,0.11,0.11,0.11,0.11,-0.01,-8.33,200000,2,22000,0,0,0,0,0,0,200000,0,200000,200000
20200316,052942,聯發科中信97購04,0.06,0.06,0.05,0.05,-0.05,-50.0,291000,31,15060,0,0,0,0,0,0,0,290000,-290000,-290000
20200316,052943,奇力新國票96購02,0.11,0.11,0.11,0.11,+0.04,57.14,5000,1,550,0,0,0,0,0,0,5000,0,5000,5000
20200316,052944,宏達電國票97購01,,,,,0.00,0.00,0,0,0,0,0,0,0,0,0,0,0,0,0
20200316,052945,嘉晶國票97購01,1.51,1.51,1.50,1.50,+0.52,53.06,80000,2,120100,0,0,0,0,0,0,80000,0,80000,80000
20200316,052946,智原國票97購02,,,,,0.00,0.00,0,0,0,0,0,0,0,0,0,0,0,0,0
20200316,052947,晶技國票97購01,1.47,1.67,1.33,1.33,-0.05,-3.62,555000,19,845800,0,0,0,0,0,0,550000,0,550000,550000
20200316,052948,景碩國票97購02,0.48,0.49,0.25,0.25,-0.18,-41.86,190000,11,69900,0,0,0,0,0,0,100000,90000,10000,10000
20200316,052949,智易國票97購02,,,,,0.00,0.00,0,0,0,0,0,0,0,0,0,0,0,0,0
20200316,05294P,亞光凱基95售02,0.56,0.61,0.56,0.61,-0.03,-4.69,141000,2,83960,0,0,0,0,0,0,0,141000,-141000,-141000
20200316,052950,超眾國票98購01,0.25,0.25,0.25,0.25,-0.06,-19.35,5000,1,1250,0,0,0,0,0,0,5000,0,5000,5000
20200316,052951,GIS國票97購02,,,,,0.00,0.00,0,0,0,0,0,0,0,0,0,0,0,0,0
20200316,052952,矽創國票97購02,0.25,0.25,0.25,0.25,+0.02,8.7,10000,1,2500,0,0,0,0,0,0,10000,0,10000,10000
20200316,052953,百和國票97購01,,,,,0.00,0.00,0,0,0,0,0,0,0,0,0,0,0,0,0
20200316,052954,大成鋼日盛96購01,,,,,0.00,0.00,0,0,0,0,0,0,0,0,0,0,0,0,0
20200316,052955,國巨日盛96購01,0.17,0.17,0.16,0.16,+0.02,14.29,17000,2,2820,0,0,0,0,0,0,17000,0,17000,17000
20200316,052956,聯發科日盛96購01,,,,,0.00,0.00,0,0,0,0,0,0,0,0,0,0,0,0,0
20200316,052957,T50反1凱基99購01,1.65,1.72,1.65,1.72,0.00,0.00,213000,9,355960,0,0,0,0,0,0,10000,203000,-193000,-193000
20200316,052958,T50反1凱基99購02,1.33,1.34,1.33,1.33,+0.14,11.76,510000,16,678340,0,0,0,0,0,0,0,510000,-510000,-510000
20200316,052959,聯電凱基97購01,,,,,0.00,0.00,0,0,0,0,0,0,0,0,0,0,0,0,0
20200316,05295P,緯創凱基95售01,0.77,1.00,0.71,0.94,+0.20,27.03,146000,12,127190,0,0,0,0,0,0,17000,133000,-116000,-116000
20200316,052960,中環凱基96購01,,,,,0.00,0.00,0,0,0,0,0,0,0,0,0,0,0,0,0
20200316,052961,國巨凱基97購02,0.18,0.18,0.18,0.18,-0.06,-25.0,185000,2,33300,0,0,0,0,0,0,185000,0,185000,185000
20200316,052962,台積電凱基97購03,0.23,0.35,0.20,0.21,0.00,0.00,88000,13,18440,0,0,0,0,0,0,10000,66000,-56000,-56000
20200316,052963,智邦凱基96購02,,,,,0.00,0.00,0,0,0,0,0,0,0,0,0,0,0,0,0
20200316,052964,台表科凱基96購03,,,,,0.00,0.00,0,0,0,0,0,0,0,0,0,0,0,0,0
20200316,052965,廣宇群益97購01,,,,,0.00,0.00,0,0,0,0,0,0,0,0,0,0,0,0,0
20200316,052966,光磊群益96購01,,,,,0.00,0.00,0,0,0,0,0,0,0,0,0,0,0,0,0
20200316,052967,智邦群益96購01,1.07,1.07,0.84,0.84,-0.16,-16.0,18000,5,18080,0,0,0,0,0,0,12000,6000,6000,6000
20200316,052968,燿華群益98購01,,,,,0.00,0.00,0,0,0,0,0,0,0,0,0,0,0,0,0
20200316,052969,建準群益97購01,0.32,0.35,0.32,0.35,+0.09,34.62,26000,2,8770,0,0,0,0,0,0,26000,0,26000,26000
20200316,05296P,牧德凱基96售01,0.31,0.39,0.31,0.39,+0.13,50.0,245000,6,83370,0,0,0,0,0,0,130000,115000,15000,15000
20200316,052970,美律群益96購01,0.12,0.12,0.12,0.12,0.00,0.00,21000,1,2520,0,0,0,0,0,0,21000,0,21000,21000
20200316,052971,京元電群益98購01,0.22,0.22,0.12,0.12,-0.02,-14.29,616000,16,105820,0,0,0,0,0,0,5000,611000,-606000,-606000
20200316,052972,義隆群益96購04,,,,,0.00,0.00,0,0,0,0,0,0,0,0,0,0,0,0,0
20200316,052973,冠德群益96購01,,,,,0.00,0.00,0,0,0,0,0,0,0,0,0,0,0,0,0
20200316,052974,瀚宇博群益96購01,,,,,0.00,0.00,0,0,0,0,0,0,0,0,0,0,0,0,0
20200316,052975,嘉聯益群益96購01,0.18,0.18,0.18,0.18,0.00,0.00,6000,1,1080,0,0,0,0,0,0,0,6000,-6000,-6000
20200316,052976,台表科群益96購03,,,,,0.00,0.00,0,0,0,0,0,0,0,0,0,0,0,0,0
20200316,052977,奇力新麥證97購01,0.27,0.30,0.13,0.13,-0.03,-18.75,231000,21,53900,120000,111000,9000,0,0,0,120000,111000,9000,9000
20200316,052978,貿聯麥證97購01,,,,,0.00,0.00,0,0,0,0,0,0,0,0,0,0,0,0,0
20200316,052979,上銀元大96購02,0.44,0.44,0.21,0.21,-0.19,-47.5,23000,4,7240,0,0,0,0,0,0,20000,13000,7000,7000
20200316,05297P,臻鼎凱基95售04,,,,,0.00,0.00,0,0,0,0,0,0,0,0,0,0,0,0,0
20200316,052980,上銀元大96購03,0.61,0.61,0.28,0.28,-0.33,-54.1,280000,22,113100,0,0,0,0,0,0,155000,110000,45000,45000
20200316,052981,鴻海元大97購05,0.16,0.16,0.16,0.16,-0.06,-27.27,10000,1,1600,0,0,0,0,0,0,10000,0,10000,10000
20200316,052982,鴻海元大97購06,,,,,0.00,0.00,0,0,0,0,0,0,0,0,0,0,0,0,0
20200316,052983,國巨元大96購07,0.44,0.47,0.44,0.45,+0.08,21.62,20000,4,9000,0,0,0,0,0,0,15000,2000,13000,13000
20200316,052984,漢唐元大96購01,0.95,0.95,0.77,0.77,-0.01,-1.28,145000,11,127360,0,0,0,0,0,0,94000,51000,43000,43000
20200316,052985,美律元大96購02,0.09,0.09,0.09,0.09,+0.04,80.0,5000,1,450,0,0,0,0,0,0,5000,0,5000,5000
20200316,052986,聯發科元大97購05,0.18,0.18,0.15,0.18,0.00,0.00,585000,26,100300,0,0,0,0,0,0,0,0,0,0
20200316,052987,華新科元大99購01,1.10,1.26,0.83,0.83,-0.10,-10.75,67000,3,61320,0,0,0,0,0,0,60000,7000,53000,53000
20200316,052988,智易元大96購02,,,,,0.00,0.00,0,0,0,0,0,0,0,0,0,0,0,0,0
20200316,052989,麗豐元大98購01,0.30,0.30,0.30,0.30,0.00,0.00,8000,1,2400,0,0,0,0,0,0,0,8000,-8000,-8000
20200316,05298P,上銀元大95售03,2.19,2.33,2.19,2.33,+0.01,0.43,6000,3,13720,0,0,0,0,0,0,5000,1000,4000,4000
20200316,052990,超眾元大97購01,0.69,0.69,0.45,0.45,-0.11,-19.64,37000,4,20850,0,0,0,0,0,0,0,37000,-37000,-37000
20200316,052991,台積電台新96購01,0.30,0.30,0.22,0.22,-0.08,-26.67,209000,5,55700,0,0,0,0,0,0,200000,9000,191000,191000
20200316,052992,冠德台新96購01,,,,,0.00,0.00,0,0,0,0,0,0,0,0,0,0,0,0,0
20200316,052993,欣興台新97購01,,,,,0.00,0.00,0,0,0,0,0,0,0,0,0,0,0,0,0
20200316,052994,群創台新99購01,0.24,0.24,0.17,0.18,-0.01,-5.26,425000,6,91700,0,0,0,0,0,0,40000,385000,-345000,-345000
20200316,052995,上銀康和96購01,,,,,0.00,0.00,0,0,0,0,0,0,0,0,0,0,0,0,0
20200316,052996,聯電康和96購01,,,,,0.00,0.00,0,0,0,0,0,0,0,0,0,0,0,0,0
20200316,052997,國巨康和96購01,,,,,0.00,0.00,0,0,0,0,0,0,0,0,0,0,0,0,0
20200316,052998,拓凱康和96購01,,,,,0.00,0.00,0,0,0,0,0,0,0,0,0,0,0,0,0
20200316,052999,臺股指康和96購01,0.01,0.03,0.01,0.03,-0.06,-66.67,604000,13,16930,0,0,0,0,0,0,0,0,0,0
20200316,05299P,旺宏元大95售04,,,,,0.00,0.00,0,0,0,0,0,0,0,0,0,0,0,0,0
20200316,053000,臺股指康和96購02,0.04,0.04,0.04,0.04,0.00,0.00,33000,1,1320,0,0,0,0,0,0,33000,0,33000,33000
20200316,053001,力山永豐96購01,,,,,0.00,0.00,0,0,0,0,0,0,0,0,0,0,0,0,0
20200316,053002,鴻海永豐96購01,,,,,0.00,0.00,0,0,0,0,0,0,0,0,0,0,0,0,0
20200316,053003,國巨永豐96購02,0.12,0.12,0.12,0.12,-0.03,-20.0,1000,1,120,0,0,0,0,0,0,0,1000,-1000,-1000
20200316,053004,燿華永豐96購01,,,,,0.00,0.00,0,0,0,0,0,0,0,0,0,0,0,0,0
20200316,053005,微星永豐96購01,0.23,0.26,0.23,0.26,+0.06,30.0,372000,4,88380,0,0,0,0,0,0,362000,10000,352000,352000
20200316,053006,玉晶光永豐96購03,0.87,0.87,0.69,0.69,-0.03,-4.17,102000,7,75650,0,0,0,0,0,0,24000,84000,-60000,-60000
20200316,053007,致伸永豐96購01,,,,,0.00,0.00,0,0,0,0,0,0,0,0,0,0,0,0,0
20200316,053008,達方永豐96購01,,,,,0.00,0.00,0,0,0,0,0,0,0,0,0,0,0,0,0
20200316,053009,大成鋼統一96購02,,,,,0.00,0.00,0,0,0,0,0,0,0,0,0,0,0,0,0
20200316,05300P,健策元大95售02,1.38,1.71,1.33,1.71,+0.12,7.55,204000,22,310500,0,0,0,0,0,0,130000,184000,-54000,-54000
20200316,053010,鴻海統一96購11,,,,,0.00,0.00,0,0,0,0,0,0,0,0,0,0,0,0,0
20200316,053011,鴻海統一98購01,,,,,0.00,0.00,0,0,0,0,0,0,0,0,0,0,0,0,0
20200316,053012,國巨統一96購03,,,,,0.00,0.00,0,0,0,0,0,0,0,0,0,0,0,0,0
20200316,053013,台積電統一97購01,0.31,0.32,0.23,0.23,-0.02,-8.0,70000,8,21160,0,0,0,0,0,0,64000,50000,14000,14000
20200316,053014,旺宏統一97購02,,,,,0.00,0.00,0,0,0,0,0,0,0,0,0,0,0,0,0
20200316,053015,緯創統一96購01,,,,,0.00,0.00,0,0,0,0,0,0,0,0,0,0,0,0,0
20200316,053016,鈺齊統一96購01,,,,,0.00,0.00,0,0,0,0,0,0,0,0,0,0,0,0,0
20200316,053017,世紀鋼統一96購02,,,,,0.00,0.00,0,0,0,0,0,0,0,0,0,0,0,0,0
20200316,053018,旺宏元富96購02,,,,,0.00,0.00,0,0,0,0,0,0,0,0,0,0,0,0,0
20200316,053019,禾伸堂元富96購01,0.44,0.47,0.42,0.43,+0.03,7.5,241000,30,107380,0,0,0,0,0,0,176000,50000,126000,126000
20200316,05301P,矽力元大95售02,1.03,1.46,1.03,1.44,+0.29,25.22,545000,64,700460,0,0,0,0,0,0,130000,545000,-415000,-415000
20200316,053020,貿聯元富96購01,,,,,0.00,0.00,0,0,0,0,0,0,0,0,0,0,0,0,0
20200316,053021,國巨國泰97購04,,,,,0.00,0.00,0,0,0,0,0,0,0,0,0,0,0,0,0
20200316,053022,欣興國泰98購01,0.20,0.20,0.19,0.19,-0.04,-17.39,11000,2,2100,0,0,0,0,0,0,1000,11000,-10000,-10000
20200316,053023,泰鼎國泰97購01,,,,,0.00,0.00,0,0,0,0,0,0,0,0,0,0,0,0,0
20200316,053024,國巨富邦97購02,0.29,0.29,0.29,0.29,0.00,0.00,6000,2,1740,0,0,0,0,0,0,0,6000,-6000,-6000
20200316,053025,燿華富邦98購02,,,,,0.00,0.00,0,0,0,0,0,0,0,0,0,0,0,0,0
20200316,053026,奇力新富邦98購01,0.22,0.23,0.16,0.16,0.00,0.00,40000,4,6980,0,0,0,0,0,0,6000,34000,-28000,-28000
20200316,053027,玉晶光富邦98購01,0.56,0.57,0.41,0.41,-0.18,-30.51,661000,19,297160,0,0,0,0,0,0,10000,651000,-641000,-641000
20200316,053028,康控富邦98購01,0.12,0.12,0.10,0.10,-0.02,-16.67,97000,2,9900,0,0,0,0,0,0,87000,10000,77000,77000
20200316,053029,國巨第一96購01,0.17,0.17,0.11,0.11,-0.12,-52.17,106000,12,14000,0,0,0,0,0,0,0,2000,-2000,-2000
20200316,05302P,華通國泰96售01,,,,,0.00,0.00,0,0,0,0,0,0,0,0,0,0,0,0,0
20200316,053030,南亞科第一96購01,,,,,0.00,0.00,0,0,0,0,0,0,0,0,0,0,0,0,0
20200316,053031,華新科第一96購01,0.11,0.11,0.11,0.11,0.00,0.00,10000,1,1100,0,0,0,0,0,0,10000,0,10000,10000
20200316,053032,國巨兆豐97購02,,,,,0.00,0.00,0,0,0,0,0,0,0,0,0,0,0,0,0
20200316,053033,智易兆豐97購01,,,,,0.00,0.00,0,0,0,0,0,0,0,0,0,0,0,0,0
20200316,053034,上海銀兆豐96購01,0.05,0.05,0.05,0.05,-0.01,-16.67,80000,1,4000,0,0,0,0,0,0,80000,0,80000,80000
20200316,053035,台表科兆豐97購01,,,,,0.00,0.00,0,0,0,0,0,0,0,0,0,0,0,0,0
20200316,053036,聯電凱基98購01,0.13,0.13,0.13,0.13,0.00,0.00,130000,4,16900,0,0,0,0,0,0,20000,110000,-90000,-90000
20200316,053037,國巨凱基96購08,0.26,0.26,0.26,0.26,-0.07,-21.21,10000,1,2600,0,0,0,0,0,0,10000,0,10000,10000
20200316,053038,華邦電凱基97購01,,,,,0.00,0.00,0,0,0,0,0,0,0,0,0,0,0,0,0
20200316,053039,聯發科凱基96購11,,,,,0.00,0.00,0,0,0,0,0,0,0,0,0,0,0,0,0
20200316,05303P,華通國泰97售01,,,,,0.00,0.00,0,0,0,0,0,0,0,0,0,0,0,0,0
20200316,053040,全新凱基98購01,,,,,0.00,0.00,0,0,0,0,0,0,0,0,0,0,0,0,0
20200316,053041,可成凱基96購02,,,,,0.00,0.00,0,0,0,0,0,0,0,0,0,0,0,0,0
20200316,053042,大立光凱基97購03,,,,,0.00,0.00,0,0,0,0,0,0,0,0,0,0,0,0,0
20200316,053043,嘉晶凱基96購01,0.68,0.74,0.48,0.48,-0.19,-28.36,227000,23,152290,0,0,0,0,0,0,141000,86000,55000,55000
20200316,053044,南茂凱基96購02,0.09,0.09,0.09,0.09,0.00,0.00,998000,2,89820,0,0,0,0,0,0,998000,0,998000,998000
20200316,053045,國巨中信97購01,0.18,0.18,0.18,0.18,+0.03,20.0,44000,2,7920,0,0,0,0,0,0,0,0,0,0
20200316,053046,智易中信96購01,,,,,0.00,0.00,0,0,0,0,0,0,0,0,0,0,0,0,0
20200316,053047,寶成中信97購01,0.02,0.02,0.02,0.02,0.00,0.00,60000,7,1200,0,0,0,0,0,0,0,60000,-60000,-60000
20200316,053048,同欣電麥證96購01,,,,,0.00,0.00,0,0,0,0,0,0,0,0,0,0,0,0,0
20200316,053049,T50反1國票98購01,1.92,1.92,1.92,1.92,-0.34,-15.04,40000,1,76800,0,0,0,0,0,0,40000,0,40000,40000
20200316,05304P,國巨國泰97售02,1.73,1.97,1.73,1.97,+0.22,12.57,12000,3,22000,0,0,0,0,0,0,0,0,0,0
20200316,053050,華通國票97購02,,,,,0.00,0.00,0,0,0,0,0,0,0,0,0,0,0,0,0
20200316,053051,楠梓電國票97購01,0.28,0.28,0.28,0.28,+0.09,47.37,10000,1,2800,0,0,0,0,0,0,0,10000,-10000,-10000
20200316,053052,旺宏國票97購02,0.06,0.06,0.06,0.06,+0.01,20.0,30000,1,1800,0,0,0,0,0,0,30000,0,30000,30000
20200316,053053,京元電國票97購02,0.18,0.23,0.18,0.23,+0.11,91.67,4000,4,800,0,0,0,0,0,0,0,4000,-4000,-4000
20200316,053054,禾伸堂國票97購01,0.33,0.33,0.33,0.33,0.00,0.00,10000,1,3300,0,0,0,0,0,0,10000,0,10000,10000
20200316,053055,聯詠國票97購01,,,,,0.00,0.00,0,0,0,0,0,0,0,0,0,0,0,0,0
20200316,053056,同欣電國票97購01,0.32,0.32,0.18,0.18,-0.07,-28.0,508000,10,159710,0,0,0,0,0,0,496000,12000,484000,484000
20200316,053057,聯電國泰97購02,0.22,0.24,0.21,0.23,0.00,0.00,594000,10,135220,0,0,0,0,0,0,20000,574000,-554000,-554000
20200316,053058,台光電永昌99購01,,,,,0.00,0.00,0,0,0,0,0,0,0,0,0,0,0,0,0
20200316,053059,聯發科永昌99購01,,,,,0.00,0.00,0,0,0,0,0,0,0,0,0,0,0,0,0
20200316,05305P,華新科國泰97售01,1.19,1.40,1.16,1.40,+0.05,3.7,2149000,32,2805750,0,0,0,0,0,0,1682000,1756000,-74000,-74000
20200316,053060,大立光永昌96購05,,,,,0.00,0.00,0,0,0,0,0,0,0,0,0,0,0,0,0
20200316,053061,GIS富邦97購01,,,,,0.00,0.00,0,0,0,0,0,0,0,0,0,0,0,0,0
20200316,053062,緯穎富邦97購01,1.33,1.33,1.02,1.02,-0.05,-4.67,100000,14,125330,0,0,0,0,0,0,80000,20000,60000,60000
20200316,053063,力山群益98購01,,,,,0.00,0.00,0,0,0,0,0,0,0,0,0,0,0,0,0
20200316,053064,國巨群益96購04,,,,,0.00,0.00,0,0,0,0,0,0,0,0,0,0,0,0,0
20200316,053065,大立光群益96購01,0.25,0.25,0.20,0.20,-0.15,-42.86,180000,18,40500,0,0,0,0,0,0,0,180000,-180000,-180000
20200316,053066,欣興群益96購02,,,,,0.00,0.00,0,0,0,0,0,0,0,0,0,0,0,0,0
20200316,053067,牧德群益96購01,,,,,0.00,0.00,0,0,0,0,0,0,0,0,0,0,0,0,0
20200316,053068,智伸科群益96購01,0.09,0.09,0.09,0.09,0.00,0.00,340000,1,30600,0,0,0,0,0,0,340000,0,340000,340000
20200316,053069,同欣電群益98購01,0.20,0.20,0.15,0.15,-0.07,-31.82,80000,4,13500,0,0,0,0,0,0,40000,40000,0,0
20200316,05306P,泰碩國泰97售01,1.32,1.69,1.23,1.69,+0.32,23.36,1633000,120,2268600,0,0,0,0,0,0,247000,1246000,-999000,-999000
20200316,053070,訊芯群益96購01,,,,,0.00,0.00,0,0,0,0,0,0,0,0,0,0,0,0,0
20200316,053071,南電群益96購01,0.46,0.46,0.26,0.26,-0.05,-16.13,42000,4,12920,0,0,0,0,0,0,40000,2000,38000,38000
20200316,053072,國巨台新97購01,,,,,0.00,0.00,0,0,0,0,0,0,0,0,0,0,0,0,0
20200316,053073,技嘉康和96購01,,,,,0.00,0.00,0,0,0,0,0,0,0,0,0,0,0,0,0
20200316,053074,嘉晶永豐96購02,0.91,0.97,0.69,0.69,-0.14,-16.87,564000,25,483540,0,0,0,0,0,0,129000,430000,-301000,-301000
20200316,053075,欣興永豐96購01,,,,,0.00,0.00,0,0,0,0,0,0,0,0,0,0,0,0,0
20200316,053076,貿聯永豐96購01,,,,,0.00,0.00,0,0,0,0,0,0,0,0,0,0,0,0,0
20200316,053077,同欣電永豐96購01,,,,,0.00,0.00,0,0,0,0,0,0,0,0,0,0,0,0,0
20200316,053078,昇陽半永豐97購02,0.05,0.05,0.05,0.05,0.00,0.00,20000,1,1000,0,0,0,0,0,0,20000,0,20000,20000
20200316,053079,世紀鋼永豐96購01,1.82,1.82,1.58,1.60,+0.14,9.59,268000,29,460340,0,0,0,0,0,0,254000,10000,244000,244000
20200316,05307P,光寶科中信95售01,1.04,1.09,0.96,1.09,+0.08,7.92,536000,11,543000,0,0,0,0,0,0,526000,10000,516000,516000
20200316,053080,力山元大96購02,0.06,0.06,0.06,0.06,0.00,0.00,5000,1,300,0,0,0,0,0,0,0,5000,-5000,-5000
20200316,053081,上銀元大97購02,1.02,1.02,0.82,0.82,+0.06,7.89,23000,3,20160,0,0,0,0,0,0,13000,20000,-7000,-7000
20200316,053082,聯電元大98購03,,,,,0.00,0.00,0,0,0,0,0,0,0,0,0,0,0,0,0
20200316,053083,中環元大99購01,0.16,0.16,0.13,0.14,0.00,0.00,802000,23,119100,0,0,0,0,0,0,652000,150000,502000,502000
20200316,053084,國巨元大98購01,1.45,1.45,0.89,0.89,-0.24,-21.24,30000,2,37900,0,0,0,0,0,0,20000,10000,10000,10000
20200316,053085,華新科元大97購04,1.50,1.61,1.04,1.10,-0.31,-21.99,120000,11,166600,0,0,0,0,0,0,70000,90000,-20000,-20000
20200316,053086,宏達電元大97購01,0.54,0.54,0.26,0.28,-0.26,-48.15,260000,27,80420,0,0,0,0,0,0,42000,220000,-178000,-178000
20200316,053087,冠德元大96購02,,,,,0.00,0.00,0,0,0,0,0,0,0,0,0,0,0,0,0
20200316,053088,奇鋐元大98購01,,,,,0.00,0.00,0,0,0,0,0,0,0,0,0,0,0,0,0
20200316,053089,貿聯元大97購02,0.15,0.15,0.08,0.08,-0.05,-38.46,26000,5,2440,0,0,0,0,0,0,2000,24000,-22000,-22000
20200316,05308P,台積電中信95售08,,,,,0.00,0.00,0,0,0,0,0,0,0,0,0,0,0,0,0
20200316,053090,新唐元大96購01,0.21,0.21,0.18,0.18,0.00,0.00,175000,18,36000,0,0,0,0,0,0,0,175000,-175000,-175000
20200316,053091,同欣電元大96購01,0.53,0.59,0.35,0.35,-0.14,-28.57,120000,8,64100,0,0,0,0,0,0,90000,30000,60000,60000
20200316,053092,台表科元大97購02,0.32,0.32,0.32,0.32,0.00,0.00,10000,1,3200,0,0,0,0,0,0,0,10000,-10000,-10000
20200316,053093,緯穎元大96購06,3.16,3.16,2.48,2.48,+0.39,18.66,123000,14,355450,0,0,0,0,0,0,60000,72000,-12000,-12000
20200316,053094,聯電統一97購02,,,,,0.00,0.00,0,0,0,0,0,0,0,0,0,0,0,0,0
20200316,053095,台光電統一98購01,,,,,0.00,0.00,0,0,0,0,0,0,0,0,0,0,0,0,0
20200316,053096,康控統一96購01,,,,,0.00,0.00,0,0,0,0,0,0,0,0,0,0,0,0,0
20200316,053097,超眾統一96購03,,,,,0.00,0.00,0,0,0,0,0,0,0,0,0,0,0,0,0
20200316,053098,國巨元富96購04,0.34,0.34,0.34,0.34,+0.05,17.24,210000,4,71400,0,0,0,0,0,0,210000,0,210000,210000
20200316,053099,正崴元富96購01,,,,,0.00,0.00,0,0,0,0,0,0,0,0,0,0,0,0,0
20200316,05309P,康友中信95售03,0.82,0.82,0.82,0.82,+0.13,18.84,10000,1,8200,0,0,0,0,0,0,0,10000,-10000,-10000
20200316,053100,美律元富96購01,,,,,0.00,0.00,0,0,0,0,0,0,0,0,0,0,0,0,0
20200316,053101,創意元富96購03,0.30,0.32,0.30,0.32,0.00,0.00,39000,9,11940,0,0,0,0,0,0,0,39000,-39000,-39000
20200316,053102,祥碩元富96購01,2.82,2.84,2.63,2.67,-0.13,-4.64,37000,12,101250,0,0,0,0,0,0,26000,11000,15000,15000
20200316,053103,瀚宇博元富96購01,0.18,0.18,0.18,0.18,-0.07,-28.0,40000,1,7200,0,0,0,0,0,0,40000,0,40000,40000
20200316,053104,台表科元富96購02,,,,,0.00,0.00,0,0,0,0,0,0,0,0,0,0,0,0,0
20200316,053105,鴻海兆豐97購01,,,,,0.00,0.00,0,0,0,0,0,0,0,0,0,0,0,0,0
20200316,053106,鴻海兆豐98購01,,,,,0.00,0.00,0,0,0,0,0,0,0,0,0,0,0,0,0
20200316,053107,旺宏兆豐97購01,,,,,0.00,0.00,0,0,0,0,0,0,0,0,0,0,0,0,0
20200316,053108,南亞科兆豐96購01,,,,,0.00,0.00,0,0,0,0,0,0,0,0,0,0,0,0,0
20200316,053109,聯發科兆豐96購01,,,,,0.00,0.00,0,0,0,0,0,0,0,0,0,0,0,0,0
20200316,05310P,智原永豐95售04,3.42,3.42,3.42,3.42,0.00,0.00,10000,1,34200,0,0,0,0,0,0,10000,0,10000,10000
20200316,053110,大立光兆豐97購01,0.22,0.22,0.20,0.20,-0.04,-16.67,200000,2,42000,0,0,0,0,0,0,100000,100000,0,0
20200316,053111,緯創兆豐97購01,,,,,0.00,0.00,0,0,0,0,0,0,0,0,0,0,0,0,0
20200316,053112,中磊兆豐97購01,0.26,0.26,0.26,0.26,0.00,0.00,20000,1,5200,0,0,0,0,0,0,20000,0,20000,20000
20200316,053113,瀚宇博兆豐97購01,,,,,0.00,0.00,0,0,0,0,0,0,0,0,0,0,0,0,0
20200316,053114,聯茂兆豐97購01,0.44,0.45,0.35,0.35,-0.06,-14.63,173000,7,70670,0,0,0,0,0,0,5000,168000,-163000,-163000
20200316,053115,滬深2X中信97購01,0.42,0.45,0.34,0.34,+0.03,9.68,170000,21,64870,0,0,0,0,0,0,14000,156000,-142000,-142000
20200316,053116,華新科中信96購01,,,,,0.00,0.00,0,0,0,0,0,0,0,0,0,0,0,0,0
20200316,053117,大立光中信9A購02,,,,,0.00,0.00,0,0,0,0,0,0,0,0,0,0,0,0,0
20200316,053118,大立光中信9C購01,0.48,0.49,0.34,0.36,-0.14,-28.0,1274000,32,526800,0,0,0,0,0,0,278000,976000,-698000,-698000
20200316,053119,日月光中信97購01,,,,,0.00,0.00,0,0,0,0,0,0,0,0,0,0,0,0,0
20200316,05311P,臺股指群益95售10,,,,,0.00,0.00,0,0,0,0,0,0,0,0,0,0,0,0,0
20200316,053120,復盛中信9A購01,0.22,0.22,0.18,0.18,-0.06,-25.0,176000,11,33960,0,0,0,0,0,0,36000,140000,-104000,-104000
20200316,053121,上証2X凱基9C購01,1.12,1.19,1.09,1.10,-0.20,-15.38,222000,11,250370,0,0,0,0,0,0,154000,68000,86000,86000
20200316,053122,美律凱基98購01,,,,,0.00,0.00,0,0,0,0,0,0,0,0,0,0,0,0,0
20200316,053123,京元電凱基96購01,0.38,0.42,0.38,0.42,0.00,0.00,329000,10,130190,0,0,0,0,0,0,0,329000,-329000,-329000
20200316,053124,聯發科凱基96購12,,,,,0.00,0.00,0,0,0,0,0,0,0,0,0,0,0,0,0
20200316,053125,宏達電凱基96購01,,,,,0.00,0.00,0,0,0,0,0,0,0,0,0,0,0,0,0
20200316,053126,健策凱基97購02,0.22,0.24,0.18,0.18,+0.01,5.88,110000,9,24400,0,0,0,0,0,0,60000,50000,10000,10000
20200316,053127,貿聯凱基97購01,,,,,0.00,0.00,0,0,0,0,0,0,0,0,0,0,0,0,0
20200316,053128,瀚宇博凱基96購01,,,,,0.00,0.00,0,0,0,0,0,0,0,0,0,0,0,0,0
20200316,053129,緯穎凱基96購01,2.41,2.41,2.41,2.41,+1.35,127.36,8000,1,19280,0,0,0,0,0,0,8000,8000,0,0
20200316,05312P,臺股指群益95售11,,,,,0.00,0.00,0,0,0,0,0,0,0,0,0,0,0,0,0
20200316,053130,聯發科麥證96購01,0.20,0.20,0.11,0.12,-0.01,-7.69,100000,5,13300,0,100000,-100000,0,0,0,0,100000,-100000,-100000
20200316,053131,華通國票97購03,,,,,0.00,0.00,0,0,0,0,0,0,0,0,0,0,0,0,0
20200316,053132,國巨國票97購02,,,,,0.00,0.00,0,0,0,0,0,0,0,0,0,0,0,0,0
20200316,053133,華邦電國票97購01,,,,,0.00,0.00,0,0,0,0,0,0,0,0,0,0,0,0,0
20200316,053134,南亞科國票97購01,,,,,0.00,0.00,0,0,0,0,0,0,0,0,0,0,0,0,0
20200316,053135,信邦國票96購01,,,,,0.00,0.00,0,0,0,0,0,0,0,0,0,0,0,0,0
20200316,053136,彩晶國票97購01,,,,,0.00,0.00,0,0,0,0,0,0,0,0,0,0,0,0,0
20200316,053137,旺宏富邦98購01,0.24,0.24,0.17,0.17,+0.05,41.67,3000,2,580,0,0,0,0,0,0,2000,1000,1000,1000
20200316,053138,華邦電富邦96購01,,,,,0.00,0.00,0,0,0,0,0,0,0,0,0,0,0,0,0
20200316,053139,滬深2X永豐98購01,,,,,0.00,0.00,0,0,0,0,0,0,0,0,0,0,0,0,0
20200316,05313P,臺股指群益95售12,,,,,0.00,0.00,0,0,0,0,0,0,0,0,0,0,0,0,0
20200316,053140,燿華永豐96購02,,,,,0.00,0.00,0,0,0,0,0,0,0,0,0,0,0,0,0
20200316,053141,景碩永豐96購02,,,,,0.00,0.00,0,0,0,0,0,0,0,0,0,0,0,0,0
20200316,053142,緯穎永豐96購01,1.34,1.56,1.21,1.27,-0.05,-3.79,277000,36,401190,0,0,0,0,0,0,176000,101000,75000,75000
20200316,053143,昇陽半永豐96購03,,,,,0.00,0.00,0,0,0,0,0,0,0,0,0,0,0,0,0
20200316,053144,上証2X元大96購01,,,,,0.00,0.00,0,0,0,0,0,0,0,0,0,0,0,0,0
20200316,053145,元黃金元大96購02,0.30,0.44,0.30,0.44,-0.01,-2.22,130000,3,47600,0,0,0,0,0,0,80000,50000,30000,30000
20200316,053146,滬深2X元大96購08,0.31,0.31,0.25,0.25,0.00,0.00,40000,4,11200,0,0,0,0,0,0,0,40000,-40000,-40000
20200316,053147,楠梓電元大98購01,,,,,0.00,0.00,0,0,0,0,0,0,0,0,0,0,0,0,0
20200316,053148,華邦電元大96購01,0.06,0.06,0.05,0.06,-0.01,-14.29,260000,24,15300,0,0,0,0,0,0,30000,230000,-200000,-200000
20200316,053149,京元電元大96購02,0.41,0.41,0.34,0.34,-0.10,-22.73,76000,2,30810,0,0,0,0,0,0,71000,5000,66000,66000
20200316,05314P,臺股指群益95售13,,,,,0.00,0.00,0,0,0,0,0,0,0,0,0,0,0,0,0
20200316,053150,聯發科元大96購11,,,,,0.00,0.00,0,0,0,0,0,0,0,0,0,0,0,0,0
20200316,053151,華新科元大96購04,1.86,1.86,1.86,1.86,-0.05,-2.62,10000,1,18600,0,0,0,0,0,0,10000,10000,0,0
20200316,053152,大立光元大99購01,0.60,0.60,0.36,0.38,-0.24,-38.71,401000,46,185450,0,0,0,0,0,0,120000,341000,-221000,-221000
20200316,053153,大立光元大99購02,0.69,0.69,0.44,0.47,-0.27,-36.49,285000,24,166250,0,0,0,0,0,0,190000,185000,5000,5000
20200316,053154,聯詠元大96購01,0.28,0.28,0.24,0.25,0.00,0.00,145000,3,36150,0,0,0,0,0,0,145000,0,145000,145000
20200316,053155,晶技元大97購02,0.78,0.83,0.74,0.81,+0.12,17.39,43000,5,33980,0,0,0,0,0,0,23000,20000,3000,3000
20200316,053156,緯創元大96購02,,,,,0.00,0.00,0,0,0,0,0,0,0,0,0,0,0,0,0
20200316,053157,日月光元大96購03,,,,,0.00,0.00,0,0,0,0,0,0,0,0,0,0,0,0,0
20200316,053158,茂林元大96購01,0.46,0.46,0.46,0.46,-0.04,-8.0,20000,1,9200,0,0,0,0,0,0,20000,0,20000,20000
20200316,053159,同欣電元大96購02,,,,,0.00,0.00,0,0,0,0,0,0,0,0,0,0,0,0,0
20200316,05315P,鴻海永昌96售08,4.68,4.68,4.68,4.68,-0.16,-3.31,190000,1,889200,0,0,0,0,0,0,190000,0,190000,190000
20200316,053160,台表科元大96購03,,,,,0.00,0.00,0,0,0,0,0,0,0,0,0,0,0,0,0
20200316,053161,康友元大96購04,0.11,0.11,0.11,0.11,+0.10,1000.0,70000,1,7700,0,0,0,0,0,0,70000,0,70000,70000
20200316,053162,緯穎元大97購01,1.99,1.99,1.71,1.71,-0.06,-3.39,159000,10,291440,0,0,0,0,0,0,149000,35000,114000,114000
20200316,053163,上証2X群益9A購02,0.91,0.91,0.82,0.82,-0.14,-14.58,478000,52,412990,0,0,0,0,0,0,469000,417000,52000,52000
20200316,053164,台光電群益96購02,,,,,0.00,0.00,0,0,0,0,0,0,0,0,0,0,0,0,0
20200316,053165,大立光群益96購03,,,,,0.00,0.00,0,0,0,0,0,0,0,0,0,0,0,0,0
20200316,053166,聯詠群益96購02,,,,,0.00,0.00,0,0,0,0,0,0,0,0,0,0,0,0,0
20200316,053167,欣興群益96購03,0.13,0.13,0.12,0.12,+0.11,1100.0,9000,3,1100,0,0,0,0,0,0,9000,7000,2000,2000
20200316,053168,晶技群益98購01,1.55,1.56,1.43,1.43,+0.16,12.6,21000,3,32210,0,0,0,0,0,0,21000,18000,3000,3000
20200316,053169,貿聯群益97購01,,,,,0.00,0.00,0,0,0,0,0,0,0,0,0,0,0,0,0
20200316,05316P,台積電永昌96售06,,,,,0.00,0.00,0,0,0,0,0,0,0,0,0,0,0,0,0
20200316,053170,茂林群益96購04,0.45,0.45,0.45,0.45,-0.32,-41.56,100000,5,45000,0,0,0,0,0,0,0,0,0,0
20200316,053171,中磊群益96購01,,,,,0.00,0.00,0,0,0,0,0,0,0,0,0,0,0,0,0
20200316,053172,瑞儀群益97購01,0.04,0.25,0.04,0.22,-0.01,-4.35,166000,35,9670,0,0,0,0,0,0,0,143000,-143000,-143000
20200316,053173,矽格群益97購01,0.80,0.80,0.61,0.61,-0.24,-28.24,58000,3,40450,0,0,0,0,0,0,50000,8000,42000,42000
20200316,053174,同欣電群益98購02,0.84,0.84,0.57,0.57,-0.29,-33.72,70000,8,50700,0,0,0,0,0,0,15000,55000,-40000,-40000
20200316,053175,矽力群益96購01,1.32,1.32,0.68,0.68,0.00,0.00,110000,7,104710,0,0,0,0,0,0,0,100000,-100000,-100000
20200316,053176,矽力群益96購02,1.02,1.02,0.63,0.63,-0.56,-47.06,72000,9,65150,0,0,0,0,0,0,31000,41000,-10000,-10000
20200316,053177,華邦電統一96購01,,,,,0.00,0.00,0,0,0,0,0,0,0,0,0,0,0,0,0
20200316,053178,南亞科統一98購01,,,,,0.00,0.00,0,0,0,0,0,0,0,0,0,0,0,0,0
20200316,053179,大立光統一96購04,0.04,0.04,0.04,0.04,-0.02,-33.33,5000,1,200,0,0,0,0,0,0,0,0,0,0
20200316,05317P,臺股指永昌95售02,,,,,0.00,0.00,0,0,0,0,0,0,0,0,0,0,0,0,0
20200316,053180,同欣電統一96購01,,,,,0.00,0.00,0,0,0,0,0,0,0,0,0,0,0,0,0
20200316,053181,滬深2X元富99購02,0.72,0.72,0.66,0.66,-0.19,-22.35,25000,9,17570,0,0,0,0,0,0,8000,15000,-7000,-7000
20200316,053182,大立光元富96購02,,,,,0.00,0.00,0,0,0,0,0,0,0,0,0,0,0,0,0
20200316,053183,大立光元富96購03,0.32,0.32,0.16,0.16,+0.04,33.33,350000,11,96000,0,0,0,0,0,0,250000,100000,150000,150000
20200316,053184,世紀鋼元富96購01,3.08,3.30,2.62,2.62,+0.17,6.94,1116000,51,3371880,0,0,0,0,0,0,886000,72000,814000,814000
20200316,053185,友達中信99購01,,,,,0.00,0.00,0,0,0,0,0,0,0,0,0,0,0,0,0
20200316,053186,健策中信9C購01,0.33,0.33,0.33,0.33,+0.02,6.45,400000,5,132000,0,0,0,0,0,0,250000,150000,100000,100000
20200316,053187,國巨統一96購05,,,,,0.00,0.00,0,0,0,0,0,0,0,0,0,0,0,0,0
20200316,053188,旺宏統一97購03,,,,,0.00,0.00,0,0,0,0,0,0,0,0,0,0,0,0,0
20200316,053189,聯發科統一96購05,0.14,0.14,0.14,0.14,+0.02,16.67,20000,1,2800,0,0,0,0,0,0,20000,0,20000,20000
20200316,05318P,臺股指永昌95售03,,,,,0.00,0.00,0,0,0,0,0,0,0,0,0,0,0,0,0
20200316,053190,聯發科統一99購01,,,,,0.00,0.00,0,0,0,0,0,0,0,0,0,0,0,0,0
20200316,053191,奇鋐統一96購01,0.12,0.12,0.11,0.11,0.00,0.00,55000,2,6250,0,0,0,0,0,0,55000,0,55000,55000
20200316,053192,創意統一96購01,0.26,0.26,0.26,0.26,+0.08,44.44,10000,1,2600,0,0,0,0,0,0,0,10000,-10000,-10000
20200316,053193,超眾統一97購01,0.96,0.96,0.68,0.68,-0.27,-28.42,30000,4,27150,0,0,0,0,0,0,20000,8000,12000,12000
20200316,053194,緯穎統一99購01,1.77,1.77,1.47,1.47,+0.36,32.43,39000,8,65660,0,0,0,0,0,0,10000,29000,-19000,-19000
20200316,053195,玉晶光元富96購02,5.35,5.35,5.35,5.35,0.00,0.00,10000,1,53500,0,0,0,0,0,0,0,10000,-10000,-10000
20200316,053196,康控元富96購01,,,,,0.00,0.00,0,0,0,0,0,0,0,0,0,0,0,0,0
20200316,053197,超眾元富96購02,0.36,0.39,0.36,0.39,+0.04,11.43,60000,3,21630,0,0,0,0,0,0,60000,0,60000,60000
20200316,053198,亞德客日盛96購01,,,,,0.00,0.00,0,0,0,0,0,0,0,0,0,0,0,0,0
20200316,053199,旺宏日盛96購01,,,,,0.00,0.00,0,0,0,0,0,0,0,0,0,0,0,0,0
20200316,05319P,上銀凱基95售02,,,,,0.00,0.00,0,0,0,0,0,0,0,0,0,0,0,0,0
20200316,053200,華邦電日盛96購01,,,,,0.00,0.00,0,0,0,0,0,0,0,0,0,0,0,0,0
20200316,053201,美律日盛96購01,,,,,0.00,0.00,0,0,0,0,0,0,0,0,0,0,0,0,0
20200316,053202,聯發科日盛96購02,,,,,0.00,0.00,0,0,0,0,0,0,0,0,0,0,0,0,0
20200316,053203,智易日盛96購01,,,,,0.00,0.00,0,0,0,0,0,0,0,0,0,0,0,0,0
20200316,053204,旺宏麥證96購01,0.30,0.30,0.29,0.29,-0.03,-9.38,60000,4,17800,0,60000,-60000,0,0,0,0,60000,-60000,-60000
20200316,053205,台光電麥證96購01,0.57,0.57,0.50,0.50,-0.10,-16.67,214000,3,108000,20000,194000,-174000,0,0,0,20000,194000,-174000,-174000
20200316,053206,聯發科麥證96購02,,,,,0.00,0.00,0,0,0,0,0,0,0,0,0,0,0,0,0
20200316,053207,SP黃豆凱基96購01,0.23,0.23,0.21,0.21,0.00,0.00,41000,2,8630,0,0,0,0,0,0,41000,0,41000,41000
20200316,053208,鴻海凱基96購13,,,,,0.00,0.00,0,0,0,0,0,0,0,0,0,0,0,0,0
20200316,053209,台積電凱基96購07,0.45,0.45,0.32,0.32,+0.08,33.33,599000,4,240490,0,0,0,0,0,0,30000,569000,-539000,-539000
20200316,05320P,華通凱基96售03,2.52,2.53,2.52,2.53,+0.05,2.02,15000,2,37900,0,0,0,0,0,0,0,15000,-15000,-15000
20200316,053210,華邦電凱基97購02,,,,,0.00,0.00,0,0,0,0,0,0,0,0,0,0,0,0,0
20200316,053211,漢唐凱基96購03,,,,,0.00,0.00,0,0,0,0,0,0,0,0,0,0,0,0,0
20200316,053212,友達凱基99購04,,,,,0.00,0.00,0,0,0,0,0,0,0,0,0,0,0,0,0
20200316,053213,建準凱基96購02,,,,,0.00,0.00,0,0,0,0,0,0,0,0,0,0,0,0,0
20200316,053214,冠德凱基96購02,,,,,0.00,0.00,0,0,0,0,0,0,0,0,0,0,0,0,0
20200316,053215,禾伸堂凱基96購01,0.39,0.40,0.39,0.40,+0.04,11.11,15000,2,5950,0,0,0,0,0,0,5000,10000,-5000,-5000
20200316,053216,京鼎凱基96購02,,,,,0.00,0.00,0,0,0,0,0,0,0,0,0,0,0,0,0
20200316,053217,群創凱基99購02,,,,,0.00,0.00,0,0,0,0,0,0,0,0,0,0,0,0,0
20200316,053218,TPK凱基96購01,,,,,0.00,0.00,0,0,0,0,0,0,0,0,0,0,0,0,0
20200316,053219,祥碩凱基96購01,1.76,1.79,1.22,1.27,-0.58,-31.35,463000,34,611940,0,0,0,0,0,0,434000,81000,353000,353000
20200316,05321P,鴻海凱基95售17,1.59,1.64,1.59,1.64,0.00,0.00,21000,2,34390,0,0,0,0,0,0,21000,21000,0,0
20200316,053220,瀚宇博凱基98購01,0.12,0.12,0.12,0.12,+0.01,9.09,200000,20,24000,0,0,0,0,0,0,0,200000,-200000,-200000
20200316,053221,彩晶凱基98購01,0.22,0.23,0.21,0.23,+0.06,35.29,105000,10,23470,0,0,0,0,0,0,105000,0,105000,105000
20200316,053222,聯茂凱基96購03,0.16,0.18,0.16,0.18,+0.06,50.0,601000,3,108160,0,0,0,0,0,0,601000,0,601000,601000
20200316,053223,台郡凱基96購02,,,,,0.00,0.00,0,0,0,0,0,0,0,0,0,0,0,0,0
20200316,053224,矽力凱基96購02,0.84,0.84,0.44,0.44,-0.28,-38.89,355000,5,181550,0,0,0,0,0,0,355000,45000,310000,310000
20200316,053225,昇陽半凱基96購01,,,,,0.00,0.00,0,0,0,0,0,0,0,0,0,0,0,0,0
20200316,053226,國巨台新97購02,,,,,0.00,0.00,0,0,0,0,0,0,0,0,0,0,0,0,0
20200316,053227,晶技台新96購01,0.66,0.66,0.66,0.66,+0.09,15.79,1000,1,660,0,0,0,0,0,0,1000,0,1000,1000
20200316,053228,康友台新97購01,0.30,0.31,0.19,0.19,-0.15,-44.12,65000,4,18050,0,0,0,0,0,0,50000,15000,35000,35000
20200316,053229,南電台新97購01,0.72,0.76,0.57,0.57,-0.01,-1.72,116000,13,82930,0,0,0,0,0,0,91000,20000,71000,71000
20200316,05322P,台積電凱基95售17,0.13,0.43,0.13,0.43,+0.22,104.76,395000,22,124910,0,0,0,0,0,0,110000,80000,30000,30000
20200316,053230,達方台新97購01,0.30,0.30,0.23,0.23,-0.02,-8.0,317000,9,83600,0,0,0,0,0,0,150000,167000,-17000,-17000
20200316,053231,奇力新康和96購01,,,,,0.00,0.00,0,0,0,0,0,0,0,0,0,0,0,0,0
20200316,053232,友達永豐97購02,,,,,0.00,0.00,0,0,0,0,0,0,0,0,0,0,0,0,0
20200316,053233,大立光永豐96購01,,,,,0.00,0.00,0,0,0,0,0,0,0,0,0,0,0,0,0
20200316,053234,奇鋐永豐96購01,,,,,0.00,0.00,0,0,0,0,0,0,0,0,0,0,0,0,0
20200316,053235,智原永豐96購01,,,,,0.00,0.00,0,0,0,0,0,0,0,0,0,0,0,0,0
20200316,053236,群創永豐97購02,0.05,0.06,0.05,0.06,0.00,0.00,280000,2,15000,0,0,0,0,0,0,280000,0,280000,280000
20200316,053237,揚明光永豐96購03,,,,,0.00,0.00,0,0,0,0,0,0,0,0,0,0,0,0,0
20200316,053238,麗豐永豐96購01,,,,,0.00,0.00,0,0,0,0,0,0,0,0,0,0,0,0,0
20200316,053239,崇越永豐96購01,,,,,0.00,0.00,0,0,0,0,0,0,0,0,0,0,0,0,0
20200316,05323P,瑞昱凱基96售02,1.85,2.15,1.82,2.06,+0.30,17.05,131000,21,261250,0,0,0,0,0,0,35000,116000,-81000,-81000
20200316,053240,巨路永豐96購01,,,,,0.00,0.00,0,0,0,0,0,0,0,0,0,0,0,0,0
20200316,053241,元油反國票9A購01,,,,,0.00,0.00,0,0,0,0,0,0,0,0,0,0,0,0,0
20200316,053242,聯電國票96購04,0.23,0.23,0.23,0.23,+0.02,9.52,100000,1,23000,0,0,0,0,0,0,100000,0,100000,100000
20200316,053243,楠梓電國票97購02,0.36,0.39,0.36,0.39,0.00,0.00,30000,3,11200,0,0,0,0,0,0,0,30000,-30000,-30000
20200316,053244,光磊國票97購01,,,,,0.00,0.00,0,0,0,0,0,0,0,0,0,0,0,0,0
20200316,053245,全新國票97購01,,,,,0.00,0.00,0,0,0,0,0,0,0,0,0,0,0,0,0
20200316,053246,聯詠國票97購02,,,,,0.00,0.00,0,0,0,0,0,0,0,0,0,0,0,0,0
20200316,053247,麗豐國票97購01,,,,,0.00,0.00,0,0,0,0,0,0,0,0,0,0,0,0,0
20200316,053248,智伸科國票97購01,,,,,0.00,0.00,0,0,0,0,0,0,0,0,0,0,0,0,0
20200316,053249,致伸國票97購02,,,,,0.00,0.00,0,0,0,0,0,0,0,0,0,0,0,0,0
20200316,05324P,臺股指凱基95售08,,,,,0.00,0.00,0,0,0,0,0,0,0,0,0,0,0,0,0
20200316,053250,百和國票97購02,0.37,0.37,0.22,0.22,-0.13,-37.14,70000,4,21900,0,0,0,0,0,0,40000,30000,10000,10000
20200316,053251,世紀鋼國票97購02,2.69,2.78,2.61,2.78,+0.28,11.2,95000,3,249600,0,0,0,0,0,0,95000,0,95000,95000
20200316,053252,華邦電國泰98購01,0.10,0.10,0.10,0.10,0.00,0.00,10000,1,1000,0,0,0,0,0,0,10000,0,10000,10000
20200316,053253,友達國泰97購02,,,,,0.00,0.00,0,0,0,0,0,0,0,0,0,0,0,0,0
20200316,053254,群創國泰98購02,,,,,0.00,0.00,0,0,0,0,0,0,0,0,0,0,0,0,0
20200316,053255,貿聯國泰97購01,0.39,0.40,0.24,0.25,-0.12,-32.43,1038000,12,332000,0,0,0,0,0,0,908000,140000,768000,768000
20200316,053256,上銀富邦98購01,0.33,0.35,0.26,0.26,-0.10,-27.78,61000,7,18270,0,0,0,0,0,0,5000,56000,-51000,-51000
20200316,053257,華通富邦97購01,0.04,0.04,0.04,0.04,-0.01,-20.0,10000,1,400,0,0,0,0,0,0,0,0,0,0
20200316,053258,上証2X群益9A購03,0.90,0.90,0.75,0.75,-0.27,-26.47,325000,30,263450,0,0,0,0,0,0,300000,265000,35000,35000
20200316,053259,卜蜂群益97購01,,,,,0.00,0.00,0,0,0,0,0,0,0,0,0,0,0,0,0
20200316,05325P,臺股指凱基95售09,,,,,0.00,0.00,0,0,0,0,0,0,0,0,0,0,0,0,0
20200316,053260,喬山群益96購01,,,,,0.00,0.00,0,0,0,0,0,0,0,0,0,0,0,0,0
20200316,053261,國巨群益96購05,,,,,0.00,0.00,0,0,0,0,0,0,0,0,0,0,0,0,0
20200316,053262,華邦電群益96購02,0.06,0.06,0.06,0.06,0.00,0.00,6000,1,360,0,0,0,0,0,0,6000,6000,0,0
20200316,053263,華邦電群益96購03,,,,,0.00,0.00,0,0,0,0,0,0,0,0,0,0,0,0,0
20200316,053264,南亞科群益96購01,,,,,0.00,0.00,0,0,0,0,0,0,0,0,0,0,0,0,0
20200316,053265,南亞科群益96購02,0.02,0.02,0.02,0.02,0.00,0.00,74000,4,1480,0,0,0,0,0,0,21000,0,21000,21000
20200316,053266,全新群益98購01,0.15,0.15,0.15,0.15,0.00,0.00,30000,1,4500,0,0,0,0,0,0,0,30000,-30000,-30000
20200316,053267,華新科群益96購02,,,,,0.00,0.00,0,0,0,0,0,0,0,0,0,0,0,0,0
20200316,053268,日月光群益96購01,0.09,0.09,0.09,0.09,0.00,0.00,10000,1,900,0,0,0,0,0,0,0,10000,-10000,-10000
20200316,053269,同欣電群益96購01,0.20,0.21,0.18,0.18,-0.05,-21.74,20000,3,3850,0,0,0,0,0,0,10000,10000,0,0
20200316,05326P,臺股指凱基95售10,,,,,0.00,0.00,0,0,0,0,0,0,0,0,0,0,0,0,0
20200316,053270,台塑元大96購01,0.21,0.22,0.15,0.15,-0.13,-46.43,601000,22,111850,0,0,0,0,0,0,401000,200000,201000,201000
20200316,053271,喬山元大97購01,0.11,0.11,0.01,0.10,-0.01,-9.09,33000,4,2600,0,0,0,0,0,0,0,33000,-33000,-33000
20200316,053272,鴻海元大96購17,,,,,0.00,0.00,0,0,0,0,0,0,0,0,0,0,0,0,0
20200316,053273,國巨元大96購08,0.46,0.49,0.25,0.25,-0.23,-47.92,292000,10,136420,0,0,0,0,0,0,271000,5000,266000,266000
20200316,053274,旺宏元大98購03,0.68,0.70,0.68,0.70,+0.27,62.79,20000,2,13800,0,0,0,0,0,0,0,20000,-20000,-20000
20200316,053275,燿華元大97購01,,,,,0.00,0.00,0,0,0,0,0,0,0,0,0,0,0,0,0
20200316,053276,友達元大9C購01,0.98,1.04,0.97,0.97,+0.02,2.11,90000,10,90450,0,0,0,0,0,0,0,90000,-90000,-90000
20200316,053277,大立光元大96購04,0.14,0.15,0.09,0.09,-0.09,-50.0,90000,9,11500,0,0,0,0,0,0,0,90000,-90000,-90000
20200316,053278,禾伸堂元大96購01,0.64,0.69,0.54,0.58,+0.08,16.0,29000,5,17060,0,0,0,0,0,0,29000,11000,18000,18000
20200316,053279,景碩元大97購01,0.38,0.38,0.29,0.29,0.00,0.00,117000,14,42720,0,0,0,0,0,0,5000,112000,-107000,-107000
20200316,05327P,臺股指凱基95售11,,,,,0.00,0.00,0,0,0,0,0,0,0,0,0,0,0,0,0
20200316,053280,群創元大9C購01,0.45,0.48,0.37,0.37,-0.08,-17.78,101000,9,45190,0,0,0,0,0,0,90000,41000,49000,49000
20200316,053281,茂林元大96購02,0.57,0.57,0.38,0.38,-0.18,-32.14,431000,25,212480,0,0,0,0,0,0,288000,138000,150000,150000
20200316,053282,彩晶元大9C購01,0.66,0.66,0.51,0.51,-0.11,-17.74,137000,14,87690,0,0,0,0,0,0,15000,122000,-107000,-107000
20200316,053283,同欣電元大96購03,0.33,0.33,0.23,0.23,-0.16,-41.03,24000,3,6520,0,0,0,0,0,0,4000,24000,-20000,-20000
20200316,053284,樺漢元大97購01,,,,,0.00,0.00,0,0,0,0,0,0,0,0,0,0,0,0,0
20200316,053285,臺股指元大96購08,,,,,0.00,0.00,0,0,0,0,0,0,0,0,0,0,0,0,0
20200316,053286,臺股指元大96購14,0.10,0.15,0.10,0.15,+0.02,15.38,30000,3,3500,0,0,0,0,0,0,0,0,0,0
20200316,053287,臺股指元大96購15,,,,,0.00,0.00,0,0,0,0,0,0,0,0,0,0,0,0,0
20200316,053288,臺股指元大96購16,0.61,0.61,0.61,0.61,0.00,0.00,2000,1,1220,0,0,0,0,0,0,2000,0,2000,2000
20200316,053289,臺股指元大96購17,0.97,0.97,0.97,0.97,0.00,0.00,1000,1,970,0,0,0,0,0,0,1000,0,1000,1000
20200316,05328P,臺股指凱基95售12,,,,,0.00,0.00,0,0,0,0,0,0,0,0,0,0,0,0,0
20200316,053290,元油反中信97購01,,,,,0.00,0.00,0,0,0,0,0,0,0,0,0,0,0,0,0
20200316,053291,旺宏中信9A購01,0.15,0.15,0.11,0.11,-0.06,-35.29,251000,10,30160,0,0,0,0,0,0,1000,250000,-249000,-249000
20200316,053292,美律中信98購01,0.57,0.57,0.52,0.52,-0.02,-3.7,40000,2,21800,0,0,0,0,0,0,40000,0,40000,40000
20200316,053293,聯發科中信9B購01,0.15,0.17,0.14,0.16,+0.01,6.67,145000,14,21850,0,0,0,0,0,0,105000,40000,65000,65000
20200316,053294,聯發科中信9C購01,0.20,0.20,0.15,0.15,-0.05,-25.0,134000,7,24080,0,0,0,0,0,0,22000,112000,-90000,-90000
20200316,053295,奇力新中信96購01,0.24,0.24,0.19,0.19,+0.05,35.71,100000,6,21500,0,0,0,0,0,0,50000,50000,0,0
20200316,053296,貿聯中信98購01,0.17,0.17,0.17,0.17,0.00,0.00,290000,9,49300,0,0,0,0,0,0,0,290000,-290000,-290000
20200316,053297,鎧勝中信98購01,0.06,0.06,0.06,0.06,-0.03,-33.33,40000,1,2400,0,0,0,0,0,0,40000,0,40000,40000
20200316,053298,SP黃豆凱基99購01,0.33,0.38,0.33,0.35,0.00,0.00,310000,9,110400,0,0,0,0,0,0,200000,110000,90000,90000
20200316,053299,台泥凱基96購01,0.25,0.25,0.24,0.25,-0.06,-19.35,151000,3,37250,0,0,0,0,0,0,1000,151000,-150000,-150000
20200316,05329P,臺股指凱基95售13,,,,,0.00,0.00,0,0,0,0,0,0,0,0,0,0,0,0,0
20200316,053300,大成鋼凱基96購02,0.34,0.34,0.34,0.34,-0.04,-10.53,321000,3,109140,0,0,0,0,0,0,0,321000,-321000,-321000
20200316,053301,華通凱基96購04,,,,,0.00,0.00,0,0,0,0,0,0,0,0,0,0,0,0,0
20200316,053302,國巨凱基96購10,0.20,0.25,0.20,0.20,+0.03,17.65,30000,4,6500,0,0,0,0,0,0,8000,10000,-2000,-2000
20200316,053303,建準凱基96購03,,,,,0.00,0.00,0,0,0,0,0,0,0,0,0,0,0,0,0
20200316,053304,可成凱基96購03,,,,,0.00,0.00,0,0,0,0,0,0,0,0,0,0,0,0,0
20200316,053305,聯詠凱基96購02,0.24,0.24,0.24,0.24,0.00,0.00,60000,1,14400,0,0,0,0,0,0,0,60000,-60000,-60000
20200316,053306,晶技凱基97購01,0.34,0.34,0.31,0.31,-0.06,-16.22,98000,12,30700,0,0,0,0,0,0,0,66000,-66000,-66000
20200316,053307,泰碩凱基97購01,0.71,0.72,0.33,0.33,-0.28,-45.9,298000,29,159120,0,0,0,0,0,0,91000,207000,-116000,-116000
20200316,053308,智易凱基96購02,,,,,0.00,0.00,0,0,0,0,0,0,0,0,0,0,0,0,0
20200316,053309,泰鼎凱基96購03,2.14,2.17,1.62,1.62,-0.52,-24.3,143000,27,296760,0,0,0,0,0,0,113000,30000,83000,83000
20200316,05330P,臺股指凱基95售14,,,,,0.00,0.00,0,0,0,0,0,0,0,0,0,0,0,0,0
20200316,053310,彩晶凱基98購02,0.09,0.09,0.09,0.09,0.00,0.00,25000,1,2250,0,0,0,0,0,0,25000,0,25000,25000
20200316,053311,同欣電凱基96購01,,,,,0.00,0.00,0,0,0,0,0,0,0,0,0,0,0,0,0
20200316,053312,緯穎凱基96購02,1.87,1.96,1.87,1.96,+0.19,10.73,164000,3,320990,0,0,0,0,0,0,164000,0,164000,164000
20200316,053313,世紀鋼凱基96購01,1.96,2.04,1.23,1.81,+0.13,7.74,877000,44,1602080,0,0,0,0,0,0,514000,355000,159000,159000
20200316,053314,A50正2群益9A購01,0.71,0.71,0.57,0.59,-0.18,-23.38,2703000,38,1636800,0,0,0,0,0,0,2390000,311000,2079000,2079000
20200316,053315,漢唐群益96購02,,,,,0.00,0.00,0,0,0,0,0,0,0,0,0,0,0,0,0
20200316,053316,友達群益9A購01,0.49,0.52,0.42,0.42,+0.04,10.53,763000,14,369660,0,0,0,0,0,0,60000,703000,-643000,-643000
20200316,053317,友達群益9A購02,,,,,0.00,0.00,0,0,0,0,0,0,0,0,0,0,0,0,0
20200316,053318,全新群益99購01,0.26,0.26,0.25,0.25,-0.06,-19.35,734000,5,190800,0,0,0,0,0,0,730000,4000,726000,726000
20200316,053319,可成群益96購04,,,,,0.00,0.00,0,0,0,0,0,0,0,0,0,0,0,0,0
20200316,05331P,上証2X國票96售01,,,,,0.00,0.00,0,0,0,0,0,0,0,0,0,0,0,0,0
20200316,053320,華新科群益97購01,,,,,0.00,0.00,0,0,0,0,0,0,0,0,0,0,0,0,0
20200316,053321,智原群益96購02,,,,,0.00,0.00,0,0,0,0,0,0,0,0,0,0,0,0,0
20200316,053322,京鼎群益97購01,0.28,0.30,0.19,0.19,-0.05,-20.83,70000,3,19700,0,0,0,0,0,0,0,70000,-70000,-70000
20200316,053323,群創群益98購07,0.10,0.10,0.10,0.10,-0.03,-23.08,170000,1,17000,0,0,0,0,0,0,170000,0,170000,170000
20200316,053324,康舒群益96購01,,,,,0.00,0.00,0,0,0,0,0,0,0,0,0,0,0,0,0
20200316,053325,GIS群益96購02,,,,,0.00,0.00,0,0,0,0,0,0,0,0,0,0,0,0,0
20200316,053326,瀚宇博台新96購01,,,,,0.00,0.00,0,0,0,0,0,0,0,0,0,0,0,0,0
20200316,053327,彩晶台新97購01,,,,,0.00,0.00,0,0,0,0,0,0,0,0,0,0,0,0,0
20200316,053328,滬深2X永豐99購01,,,,,0.00,0.00,0,0,0,0,0,0,0,0,0,0,0,0,0
20200316,053329,元油反永豐97購01,,,,,0.00,0.00,0,0,0,0,0,0,0,0,0,0,0,0,0
20200316,05332P,臺股指國票95售01,12.50,12.50,12.50,12.50,0.00,0.00,10000,1,125000,0,0,0,0,0,0,10000,0,10000,10000
20200316,053330,燿華永豐96購03,,,,,0.00,0.00,0,0,0,0,0,0,0,0,0,0,0,0,0
20200316,053331,玉晶光永豐97購02,0.65,0.67,0.46,0.46,-0.22,-32.35,60000,7,32750,0,0,0,0,0,0,10000,50000,-40000,-40000
20200316,053332,創意永豐96購03,0.31,0.31,0.30,0.30,+0.02,7.14,34000,3,10470,0,0,0,0,0,0,7000,34000,-27000,-27000
20200316,053333,新唐永豐96購01,0.20,0.23,0.20,0.23,0.00,0.00,50000,5,11200,0,0,0,0,0,0,0,50000,-50000,-50000
20200316,053334,訊芯永豐96購01,,,,,0.00,0.00,0,0,0,0,0,0,0,0,0,0,0,0,0
20200316,053335,易華電永豐96購01,,,,,0.00,0.00,0,0,0,0,0,0,0,0,0,0,0,0,0
20200316,053336,元油反國票9B購02,,,,,0.00,0.00,0,0,0,0,0,0,0,0,0,0,0,0,0
20200316,053337,聯電國票97購01,0.29,0.29,0.29,0.29,-0.02,-6.45,10000,1,2900,0,0,0,0,0,0,10000,0,10000,10000
20200316,053338,台光電國票97購01,,,,,0.00,0.00,0,0,0,0,0,0,0,0,0,0,0,0,0
20200316,053339,友達國票97購02,0.18,0.18,0.18,0.18,+0.06,50.0,25000,1,4500,0,0,0,0,0,0,25000,0,25000,25000
20200316,05333P,臺股指國票95售02,,,,,0.00,0.00,0,0,0,0,0,0,0,0,0,0,0,0,0
20200316,053340,建準國票97購01,,,,,0.00,0.00,0,0,0,0,0,0,0,0,0,0,0,0,0
20200316,053341,聯發科國票97購03,,,,,0.00,0.00,0,0,0,0,0,0,0,0,0,0,0,0,0
20200316,053342,全新國票99購01,0.20,0.20,0.13,0.13,-0.01,-7.14,790000,4,103400,0,0,0,0,0,0,790000,0,790000,790000
20200316,053343,宏達電國票97購02,0.33,0.33,0.32,0.32,+0.02,6.67,75000,2,24010,0,0,0,0,0,0,75000,0,75000,75000
20200316,053344,嘉晶國票97購02,1.32,1.35,0.88,0.88,-0.37,-29.6,135000,6,173810,0,0,0,0,0,0,135000,0,135000,135000
20200316,053345,欣興國票97購02,0.24,0.24,0.20,0.20,-0.03,-13.04,20000,2,4400,0,0,0,0,0,0,0,20000,-20000,-20000
20200316,053346,群創國票97購04,,,,,0.00,0.00,0,0,0,0,0,0,0,0,0,0,0,0,0
20200316,053347,茂林國票98購01,0.91,0.91,0.68,0.68,-0.34,-33.33,58000,6,48870,0,0,0,0,0,0,44000,14000,30000,30000
20200316,053348,彩晶國票97購02,,,,,0.00,0.00,0,0,0,0,0,0,0,0,0,0,0,0,0
20200316,053349,台郡國票97購02,0.86,0.86,0.66,0.66,+0.03,4.76,212000,22,151120,0,0,0,0,0,0,10000,202000,-192000,-192000
20200316,05334P,臺股指國票95售03,,,,,0.00,0.00,0,0,0,0,0,0,0,0,0,0,0,0,0
20200316,053350,台表科國票97購02,,,,,0.00,0.00,0,0,0,0,0,0,0,0,0,0,0,0,0
20200316,053351,A50正2兆豐97購01,0.51,0.51,0.42,0.42,-0.20,-32.26,37000,2,17070,0,0,0,0,0,0,0,37000,-37000,-37000
20200316,053352,義隆兆豐96購01,0.61,0.63,0.61,0.63,+0.08,14.55,163000,2,100950,0,0,0,0,0,0,87000,76000,11000,11000
20200316,053353,玉晶光兆豐97購03,0.73,0.73,0.42,0.44,-0.32,-42.11,97000,9,56440,0,0,0,0,0,0,10000,87000,-77000,-77000
20200316,053354,康控兆豐97購02,,,,,0.00,0.00,0,0,0,0,0,0,0,0,0,0,0,0,0
20200316,053355,超眾兆豐97購01,0.43,0.43,0.29,0.29,-0.03,-9.38,4000,3,1360,0,0,0,0,0,0,0,4000,-4000,-4000
20200316,053356,聯發科統一96購07,0.26,0.26,0.26,0.26,-0.03,-10.34,50000,1,13000,0,0,0,0,0,0,50000,0,50000,50000
20200316,053357,可成統一96購02,0.07,0.07,0.07,0.07,-0.01,-12.5,30000,1,2100,0,0,0,0,0,0,0,0,0,0
20200316,053358,晶技統一98購01,0.37,0.37,0.34,0.34,+0.10,41.67,48000,2,16770,0,0,0,0,0,0,33000,0,33000,33000
20200316,053359,矽力統一96購02,,,,,0.00,0.00,0,0,0,0,0,0,0,0,0,0,0,0,0
20200316,05335P,臺股指國票95售04,,,,,0.00,0.00,0,0,0,0,0,0,0,0,0,0,0,0,0
20200316,053360,上証2X元富96購01,,,,,0.00,0.00,0,0,0,0,0,0,0,0,0,0,0,0,0
20200316,053361,友達元富99購01,0.37,0.41,0.37,0.41,+0.10,32.26,110000,3,42100,0,0,0,0,0,0,110000,0,110000,110000
20200316,053362,元油反國泰98購01,,,,,0.00,0.00,0,0,0,0,0,0,0,0,0,0,0,0,0
20200316,053363,旺宏國泰98購02,0.41,0.41,0.25,0.26,-0.08,-23.53,1060000,18,329800,0,0,0,0,0,0,410000,950000,-540000,-540000
20200316,053364,友達國泰98購01,,,,,0.00,0.00,0,0,0,0,0,0,0,0,0,0,0,0,0
20200316,053365,彩晶國泰98購01,,,,,0.00,0.00,0,0,0,0,0,0,0,0,0,0,0,0,0
20200316,053366,樺漢國泰98購01,0.08,0.08,0.08,0.08,-0.04,-33.33,50000,1,4000,0,0,0,0,0,0,50000,0,50000,50000
20200316,053367,元油反富邦97購01,,,,,0.00,0.00,0,0,0,0,0,0,0,0,0,0,0,0,0
20200316,053368,京元電富邦98購01,,,,,0.00,0.00,0,0,0,0,0,0,0,0,0,0,0,0,0
20200316,053369,T50反1元大96購06,1.95,2.05,1.95,2.05,-0.05,-2.38,20000,2,40000,0,0,0,0,0,0,0,20000,-20000,-20000
20200316,05336P,臺股指國票95售05,,,,,0.00,0.00,0,0,0,0,0,0,0,0,0,0,0,0,0
20200316,053370,上証2X元大97購03,,,,,0.00,0.00,0,0,0,0,0,0,0,0,0,0,0,0,0
20200316,053371,滬深2X元大99購01,0.54,0.54,0.47,0.47,-0.17,-26.56,35000,5,16800,0,0,0,0,0,0,10000,0,10000,10000
20200316,053372,元油反元大98購01,5.65,5.65,5.65,5.65,+0.99,21.24,15000,1,84750,0,0,0,0,0,0,15000,0,15000,15000
20200316,053373,台泥元大96購01,0.63,0.63,0.55,0.55,+0.01,1.85,12000,3,7450,0,0,0,0,0,0,10000,2000,8000,8000
20200316,053374,台達電元大96購03,,,,,0.00,0.00,0,0,0,0,0,0,0,0,0,0,0,0,0
20200316,053375,鴻海元大96購18,,,,,0.00,0.00,0,0,0,0,0,0,0,0,0,0,0,0,0
20200316,053376,鴻海元大96購19,0.19,0.19,0.19,0.19,+0.06,46.15,1000,1,190,0,0,0,0,0,0,1000,1000,0,0
20200316,053377,台積電元大98購01,0.44,1.00,0.44,1.00,0.00,0.00,21000,4,19540,0,0,0,0,0,0,0,1000,-1000,-1000
20200316,053378,台積電元大98購02,1.08,1.08,0.78,0.82,-0.42,-33.87,42000,16,41090,0,0,0,0,0,0,0,41000,-41000,-41000
20200316,053379,南亞科元大96購01,0.24,0.24,0.21,0.22,-0.02,-8.33,185000,19,40700,0,0,0,0,0,0,0,185000,-185000,-185000
20200316,05337P,臺股指國票95售06,,,,,0.00,0.00,0,0,0,0,0,0,0,0,0,0,0,0,0
20200316,053380,南亞科元大97購01,0.39,0.41,0.25,0.26,-0.01,-3.7,150000,15,48900,0,0,0,0,0,0,60000,90000,-30000,-30000
20200316,053381,友達元大9A購02,0.80,0.80,0.80,0.80,0.00,0.00,10000,1,8000,0,0,0,0,0,0,10000,10000,0,0
20200316,053382,友達元大9C購02,0.63,0.63,0.58,0.58,0.00,0.00,30000,3,18400,0,0,0,0,0,0,0,30000,-30000,-30000
20200316,053383,京元電元大97購01,0.75,0.96,0.69,0.69,-0.07,-9.21,146000,11,111030,0,0,0,0,0,0,109000,57000,52000,52000
20200316,053384,聯發科元大96購13,,,,,0.00,0.00,0,0,0,0,0,0,0,0,0,0,0,0,0
20200316,053385,聯詠元大96購02,0.29,0.29,0.23,0.23,-0.11,-32.35,70000,6,17300,0,0,0,0,0,0,20000,50000,-30000,-30000
20200316,053386,聯詠元大96購03,,,,,0.00,0.00,0,0,0,0,0,0,0,0,0,0,0,0,0
20200316,053387,緯創元大97購01,0.08,0.08,0.08,0.08,-0.06,-42.86,20000,2,1600,0,0,0,0,0,0,0,20000,-20000,-20000
20200316,053388,群創元大9C購02,0.28,0.28,0.28,0.28,+0.12,75.0,1000,1,280,0,0,0,0,0,0,0,0,0,0
20200316,053389,彩晶元大98購01,0.19,0.19,0.15,0.15,-0.01,-6.25,170000,17,29700,0,0,0,0,0,0,0,170000,-170000,-170000
20200316,05338P,臺股指國票95售07,,,,,0.00,0.00,0,0,0,0,0,0,0,0,0,0,0,0,0
20200316,053390,彩晶元大9A購01,,,,,0.00,0.00,0,0,0,0,0,0,0,0,0,0,0,0,0
20200316,053391,嘉聯益元大99購01,0.23,0.23,0.20,0.20,0.00,0.00,40000,4,8700,0,0,0,0,0,0,20000,20000,0,0
20200316,053392,致新元大96購01,0.33,0.33,0.26,0.26,-0.10,-27.78,280000,23,85100,0,0,0,0,0,0,70000,210000,-140000,-140000
20200316,053393,元油反中信98購01,,,,,0.00,0.00,0,0,0,0,0,0,0,0,0,0,0,0,0
20200316,053394,鴻海中信9A購01,,,,,0.00,0.00,0,0,0,0,0,0,0,0,0,0,0,0,0
20200316,053395,致茂中信96購01,,,,,0.00,0.00,0,0,0,0,0,0,0,0,0,0,0,0,0
20200316,053396,漢唐中信9A購01,,,,,0.00,0.00,0,0,0,0,0,0,0,0,0,0,0,0,0
20200316,053397,國泰金中信96購01,,,,,0.00,0.00,0,0,0,0,0,0,0,0,0,0,0,0,0
20200316,053398,和鑫中信99購01,0.11,0.11,0.09,0.09,0.00,0.00,105000,3,10510,0,0,0,0,0,0,0,105000,-105000,-105000
20200316,053399,創意中信96購01,,,,,0.00,0.00,0,0,0,0,0,0,0,0,0,0,0,0,0
20200316,053400,緯穎中信9A購01,1.03,1.11,0.95,0.95,-0.05,-5.0,102000,29,105590,0,0,0,0,0,0,82000,0,82000,82000
20200316,053401,臺股指中信99購01,0.15,0.15,0.11,0.11,-0.03,-21.43,720000,26,88590,0,0,0,0,0,0,0,10000,-10000,-10000
20200316,053402,A50正2群益9A購02,0.45,0.48,0.38,0.38,-0.15,-28.3,121000,8,50240,0,0,0,0,0,0,84000,37000,47000,47000
20200316,053403,彩晶群益98購01,,,,,0.00,0.00,0,0,0,0,0,0,0,0,0,0,0,0,0
20200316,053404,致新群益96購01,0.46,0.47,0.46,0.47,+0.03,6.82,40000,2,18600,0,0,0,0,0,0,20000,20000,0,0
20200316,053405,台達電兆豐96購01,1.34,1.34,1.06,1.06,-0.09,-7.83,187000,5,238420,0,0,0,0,0,0,149000,38000,111000,111000
20200316,053406,國巨兆豐96購02,0.35,0.35,0.22,0.22,-0.12,-35.29,90000,5,24500,0,0,0,0,0,0,90000,0,90000,90000
20200316,053407,台積電兆豐96購02,1.22,1.48,0.76,0.79,-0.43,-35.25,1933000,133,2069020,20000,0,20000,0,0,0,1247000,554000,693000,713000
20200316,053408,友達兆豐98購01,0.25,0.25,0.23,0.23,0.00,0.00,30000,2,7300,0,0,0,0,0,0,0,30000,-30000,-30000
20200316,053409,和碩兆豐96購02,,,,,0.00,0.00,0,0,0,0,0,0,0,0,0,0,0,0,0
20200316,05340P,臺股指國票95售08,,,,,0.00,0.00,0,0,0,0,0,0,0,0,0,0,0,0,0
20200316,053410,啟碁兆豐96購01,,,,,0.00,0.00,0,0,0,0,0,0,0,0,0,0,0,0,0
20200316,053411,深中小國票9B購01,,,,,0.00,0.00,0,0,0,0,0,0,0,0,0,0,0,0,0
20200316,053412,台達電國票97購02,0.23,0.23,0.17,0.17,+0.06,54.55,183000,19,32360,0,0,0,0,0,0,160000,183000,-23000,-23000
20200316,053413,台積電國票99購01,0.22,0.24,0.14,0.17,-0.05,-22.73,518000,41,85940,0,0,0,0,0,0,0,40000,-40000,-40000
20200316,053414,臻鼎國票97購01,0.05,0.05,0.05,0.05,0.00,0.00,133000,2,6650,0,0,0,0,0,0,133000,0,133000,133000
20200316,053415,聯茂國票97購01,0.34,0.34,0.17,0.17,-0.03,-15.0,65000,8,15850,0,0,0,0,0,0,45000,0,45000,45000
20200316,053416,光磊台新97購01,,,,,0.00,0.00,0,0,0,0,0,0,0,0,0,0,0,0,0
20200316,053417,上銀永豐96購02,0.08,0.08,0.08,0.08,-0.07,-46.67,10000,1,800,0,0,0,0,0,0,10000,10000,0,0
20200316,053418,旺宏永豐96購02,0.03,0.03,0.03,0.03,-0.02,-40.0,50000,2,1500,0,0,0,0,0,0,0,0,0,0
20200316,053419,光罩永豐96購01,,,,,0.00,0.00,0,0,0,0,0,0,0,0,0,0,0,0,0
20200316,05341P,臺股指兆豐95售02,8.60,8.60,8.60,8.60,0.00,0.00,12000,1,103200,0,0,0,0,0,0,12000,12000,0,0
20200316,053420,華邦電永豐96購01,,,,,0.00,0.00,0,0,0,0,0,0,0,0,0,0,0,0,0
20200316,053421,南亞科永豐96購01,0.06,0.06,0.04,0.04,-0.02,-33.33,90000,6,4400,0,0,0,0,0,0,40000,50000,-10000,-10000
20200316,053422,可成永豐96購01,,,,,0.00,0.00,0,0,0,0,0,0,0,0,0,0,0,0,0
20200316,053423,亞光永豐96購01,0.26,0.26,0.26,0.26,-0.07,-21.21,20000,2,5200,0,0,0,0,0,0,0,20000,-20000,-20000
20200316,053424,欣興永豐96購02,,,,,0.00,0.00,0,0,0,0,0,0,0,0,0,0,0,0,0
20200316,053425,京鼎永豐96購01,,,,,0.00,0.00,0,0,0,0,0,0,0,0,0,0,0,0,0
20200316,053426,創意永豐96購04,,,,,0.00,0.00,0,0,0,0,0,0,0,0,0,0,0,0,0
20200316,053427,鎧勝永豐96購02,0.12,0.12,0.10,0.10,0.00,0.00,150000,9,16000,0,0,0,0,0,0,50000,100000,-50000,-50000
20200316,053428,中磊永豐96購02,,,,,0.00,0.00,0,0,0,0,0,0,0,0,0,0,0,0,0
20200316,053429,彩晶永豐96購01,,,,,0.00,0.00,0,0,0,0,0,0,0,0,0,0,0,0,0
20200316,05342P,臺股指兆豐95售03,,,,,0.00,0.00,0,0,0,0,0,0,0,0,0,0,0,0,0
20200316,053430,樺漢永豐96購01,,,,,0.00,0.00,0,0,0,0,0,0,0,0,0,0,0,0,0
20200316,053431,志超永豐96購01,,,,,0.00,0.00,0,0,0,0,0,0,0,0,0,0,0,0,0
20200316,053432,世紀鋼永豐96購02,2.68,2.75,2.48,2.48,+0.03,1.22,282000,23,740190,0,0,0,0,0,0,282000,0,282000,282000
20200316,053433,友達日盛99購06,0.10,0.10,0.10,0.10,+0.01,11.11,20000,1,2000,0,0,0,0,0,0,20000,0,20000,20000
20200316,053434,國泰金日盛96購01,,,,,0.00,0.00,0,0,0,0,0,0,0,0,0,0,0,0,0
20200316,053435,新光金日盛96購01,,,,,0.00,0.00,0,0,0,0,0,0,0,0,0,0,0,0,0
20200316,053436,聯茂日盛96購01,,,,,0.00,0.00,0,0,0,0,0,0,0,0,0,0,0,0,0
20200316,053437,啟碁日盛96購01,,,,,0.00,0.00,0,0,0,0,0,0,0,0,0,0,0,0,0
20200316,053438,玉晶光麥證97購02,0.25,0.25,0.17,0.17,-0.11,-39.29,361000,14,79470,160000,201000,-41000,0,0,0,160000,201000,-41000,-41000
20200316,053439,台積電凱基96購11,0.34,0.35,0.29,0.29,-0.14,-32.56,25000,10,7910,0,0,0,0,0,0,0,25000,-25000,-25000
20200316,05343P,臺股指統一95售03,,,,,0.00,0.00,0,0,0,0,0,0,0,0,0,0,0,0,0
20200316,053440,台積電凱基96購12,0.14,0.14,0.14,0.14,-0.08,-36.36,20000,1,2800,0,0,0,0,0,0,0,0,0,0
20200316,053441,旺宏凱基98購01,0.14,0.16,0.09,0.10,-0.03,-23.08,61000,5,6910,0,0,0,0,0,0,25000,16000,9000,9000
20200316,053442,光罩凱基96購01,0.20,0.20,0.20,0.20,0.00,0.00,5000,1,1000,0,0,0,0,0,0,5000,0,5000,5000
20200316,053443,智邦凱基97購01,1.01,1.06,0.84,0.84,+0.13,18.31,210000,21,194500,0,0,0,0,0,0,41000,169000,-128000,-128000
20200316,053444,奇力新凱基96購03,0.09,0.09,0.09,0.09,-0.01,-10.0,66000,1,5940,0,0,0,0,0,0,0,0,0,0
20200316,053445,可成凱基96購04,,,,,0.00,0.00,0,0,0,0,0,0,0,0,0,0,0,0,0
20200316,053446,欣興凱基96購02,,,,,0.00,0.00,0,0,0,0,0,0,0,0,0,0,0,0,0
20200316,053447,京鼎凱基96購03,,,,,0.00,0.00,0,0,0,0,0,0,0,0,0,0,0,0,0
20200316,053448,智易凱基96購03,,,,,0.00,0.00,0,0,0,0,0,0,0,0,0,0,0,0,0
20200316,053449,超眾凱基98購01,0.26,0.26,0.26,0.26,-0.02,-7.14,35000,1,9100,0,0,0,0,0,0,35000,0,35000,35000
20200316,05344P,臺股指統一95售04,,,,,0.00,0.00,0,0,0,0,0,0,0,0,0,0,0,0,0
20200316,053450,同欣電凱基96購02,0.13,0.13,0.13,0.13,0.00,0.00,200000,3,26000,0,0,0,0,0,0,116000,0,116000,116000
20200316,053451,致新凱基96購02,,,,,0.00,0.00,0,0,0,0,0,0,0,0,0,0,0,0,0
20200316,053452,臺股指凱基97購01,0.01,0.05,0.01,0.05,0.00,0.00,256000,5,2600,0,0,0,0,0,0,0,0,0,0
20200316,053453,新光金統一98購01,,,,,0.00,0.00,0,0,0,0,0,0,0,0,0,0,0,0,0
20200316,053454,創意統一96購02,,,,,0.00,0.00,0,0,0,0,0,0,0,0,0,0,0,0,0
20200316,053455,台光電元富96購02,,,,,0.00,0.00,0,0,0,0,0,0,0,0,0,0,0,0,0
20200316,053456,大立光元富96購04,0.52,0.55,0.46,0.46,-0.14,-23.33,292000,5,154040,0,0,0,0,0,0,292000,0,292000,292000
20200316,053457,旺宏國泰98購03,0.28,0.29,0.28,0.29,-0.05,-14.71,216000,2,61640,0,0,0,0,0,0,216000,0,216000,216000
20200316,053458,聯詠國泰97購01,0.18,0.18,0.17,0.17,-0.05,-22.73,1074000,8,182680,0,0,0,0,0,0,1054000,20000,1034000,1034000
20200316,053459,康控國泰97購01,,,,,0.00,0.00,0,0,0,0,0,0,0,0,0,0,0,0,0
20200316,05345P,臺股指統一95售05,,,,,0.00,0.00,0,0,0,0,0,0,0,0,0,0,0,0,0
20200316,053460,緯穎國泰97購01,2.14,2.35,1.94,1.94,-0.20,-9.35,1302000,37,2867360,0,0,0,0,0,0,1172000,181000,991000,991000
20200316,053461,台郡永昌99購01,,,,,0.00,0.00,0,0,0,0,0,0,0,0,0,0,0,0,0
20200316,053462,元油反富邦97購02,,,,,0.00,0.00,0,0,0,0,0,0,0,0,0,0,0,0,0
20200316,053463,可成富邦98購01,0.14,0.14,0.14,0.14,+0.03,27.27,1000,1,140,0,0,0,0,0,0,0,1000,-1000,-1000
20200316,053464,喬山元大96購01,0.06,0.06,0.05,0.05,0.00,0.00,206000,2,12300,0,0,0,0,0,0,206000,0,206000,206000
20200316,053465,聯電元大96購05,0.08,0.08,0.08,0.08,-0.03,-27.27,30000,5,2400,0,0,0,0,0,0,0,30000,-30000,-30000
20200316,053466,華通元大98購01,,,,,0.00,0.00,0,0,0,0,0,0,0,0,0,0,0,0,0
20200316,053467,鴻海元大96購20,0.13,0.13,0.08,0.08,-0.09,-52.94,350000,12,37700,0,0,0,0,0,0,270000,80000,190000,190000
20200316,053468,鴻海元大98購01,0.15,0.19,0.12,0.19,+0.01,5.56,16000,3,2290,0,0,0,0,0,0,0,1000,-1000,-1000
20200316,053469,光磊元大97購01,,,,,0.00,0.00,0,0,0,0,0,0,0,0,0,0,0,0,0
20200316,05346P,臺股指統一95售06,,,,,0.00,0.00,0,0,0,0,0,0,0,0,0,0,0,0,0
20200316,053470,華邦電元大96購02,,,,,0.00,0.00,0,0,0,0,0,0,0,0,0,0,0,0,0
20200316,053471,正崴元大96購01,,,,,0.00,0.00,0,0,0,0,0,0,0,0,0,0,0,0,0
20200316,053472,漢唐元大96購02,,,,,0.00,0.00,0,0,0,0,0,0,0,0,0,0,0,0,0
20200316,053473,聯發科元大96購15,,,,,0.00,0.00,0,0,0,0,0,0,0,0,0,0,0,0,0
20200316,053474,聯發科元大97購06,0.17,0.20,0.12,0.12,-0.11,-47.83,95000,10,15250,0,0,0,0,0,0,30000,65000,-35000,-35000
20200316,053475,華新科元大96購05,,,,,0.00,0.00,0,0,0,0,0,0,0,0,0,0,0,0,0
20200316,053476,冠德元大96購03,0.02,0.02,0.02,0.02,+0.01,100.0,5000,1,100,0,0,0,0,0,0,5000,0,5000,5000
20200316,053477,大立光元大97購03,0.71,0.71,0.38,0.40,-0.37,-48.05,440000,31,256920,0,0,0,0,0,0,298000,150000,148000,148000
20200316,053478,京鼎元大96購01,0.16,0.16,0.16,0.16,-0.01,-5.88,58000,1,9280,0,0,0,0,0,0,58000,0,58000,58000
20200316,053479,達興元大96購01,,,,,0.00,0.00,0,0,0,0,0,0,0,0,0,0,0,0,0
20200316,05347P,滬深2X元富9B售02,2.00,2.27,2.00,2.16,+0.16,8.0,172000,7,359750,0,0,0,0,0,0,161000,10000,151000,151000
20200316,053480,祥碩元大96購02,4.39,4.47,3.67,3.67,-0.11,-2.91,73000,24,312240,0,0,0,0,0,0,73000,63000,10000,10000
20200316,053481,同欣電元大97購01,0.52,0.52,0.27,0.27,-0.15,-35.71,142000,11,49340,0,0,0,0,0,0,95000,45000,50000,50000
20200316,053482,矽力元大96購03,1.30,1.30,0.76,0.76,-0.39,-33.91,502000,35,541460,0,0,0,0,0,0,192000,297000,-105000,-105000
20200316,053483,嘉澤第一96購01,,,,,0.00,0.00,0,0,0,0,0,0,0,0,0,0,0,0,0
20200316,053484,國巨國票97購03,0.17,0.17,0.17,0.17,-0.13,-43.33,2000,1,340,0,0,0,0,0,0,0,2000,-2000,-2000
20200316,053485,矽創國票97購04,,,,,0.00,0.00,0,0,0,0,0,0,0,0,0,0,0,0,0
20200316,053486,T50反1兆豐96購01,,,,,0.00,0.00,0,0,0,0,0,0,0,0,0,0,0,0,0
20200316,053487,台泥兆豐97購01,1.98,1.98,1.95,1.95,-0.13,-6.25,43000,2,84750,0,0,0,0,0,0,43000,0,43000,43000
20200316,053488,中石化兆豐97購01,,,,,0.00,0.00,0,0,0,0,0,0,0,0,0,0,0,0,0
20200316,053489,上銀兆豐97購01,1.14,1.25,0.76,0.76,-0.49,-39.2,30000,3,31500,0,0,0,0,0,0,10000,20000,-10000,-10000
20200316,05348P,美律元富98售01,1.34,1.43,1.33,1.43,-0.04,-2.72,115000,12,159180,0,0,0,0,0,0,35000,80000,-45000,-45000
20200316,053490,為升兆豐97購01,0.10,0.10,0.10,0.10,-0.16,-61.54,15000,2,1500,0,0,0,0,0,0,0,0,0,0
20200316,053491,鴻海兆豐97購02,,,,,0.00,0.00,0,0,0,0,0,0,0,0,0,0,0,0,0
20200316,053492,華邦電兆豐97購01,,,,,0.00,0.00,0,0,0,0,0,0,0,0,0,0,0,0,0
20200316,053493,智邦兆豐97購02,2.32,2.32,2.32,2.32,+0.36,18.37,18000,3,41760,0,0,0,0,0,0,18000,0,18000,18000
20200316,053494,南亞科兆豐96購02,,,,,0.00,0.00,0,0,0,0,0,0,0,0,0,0,0,0,0
20200316,053495,聯發科兆豐96購02,0.24,0.25,0.13,0.13,-0.17,-56.67,380000,16,76200,0,0,0,0,0,0,50000,330000,-280000,-280000
20200316,053496,義隆兆豐96購02,1.35,1.35,1.27,1.31,0.00,0.00,62000,3,81980,0,0,0,0,0,0,0,62000,-62000,-62000
20200316,053497,新光金兆豐97購01,,,,,0.00,0.00,0,0,0,0,0,0,0,0,0,0,0,0,0
20200316,053498,大立光兆豐96購03,0.21,0.21,0.21,0.21,-0.10,-32.26,26000,3,5460,0,0,0,0,0,0,26000,0,26000,26000
20200316,053499,禾伸堂兆豐96購01,1.51,1.56,1.42,1.45,+0.02,1.4,86000,9,130300,0,0,0,0,0,0,66000,20000,46000,46000
20200316,05349P,可成元富98售03,,,,,0.00,0.00,0,0,0,0,0,0,0,0,0,0,0,0,0
20200316,053500,新日興兆豐97購01,1.51,1.51,1.28,1.28,-0.07,-5.19,80000,3,117500,0,0,0,0,0,0,70000,10000,60000,60000
20200316,053501,明泰兆豐96購01,0.60,0.60,0.60,0.60,+0.09,17.65,50000,1,30000,0,0,0,0,0,0,0,50000,-50000,-50000
20200316,053502,智伸科兆豐97購01,0.61,0.64,0.61,0.63,+0.10,18.87,16000,4,10100,0,0,0,0,0,0,16000,0,16000,16000
20200316,053503,臻鼎兆豐97購01,0.47,0.59,0.42,0.44,+0.12,37.5,694000,42,351610,0,0,0,0,0,0,35000,659000,-624000,-624000
20200316,053504,祥碩兆豐96購01,4.27,4.27,3.94,3.94,-0.01,-0.25,32000,4,130980,0,0,0,0,0,0,32000,0,32000,32000
20200316,053505,瑞儀兆豐97購01,0.30,0.31,0.30,0.31,0.00,0.00,82000,5,24700,0,0,0,0,0,0,0,82000,-82000,-82000
20200316,053506,南茂兆豐97購01,0.95,0.95,0.89,0.89,+0.15,20.27,62000,3,57880,0,0,0,0,0,0,30000,32000,-2000,-2000
20200316,053507,百和兆豐96購01,0.70,0.70,0.67,0.67,+0.03,4.69,25000,2,17260,0,0,0,0,0,0,0,25000,-25000,-25000
20200316,053508,元油反群益9A購01,,,,,0.00,0.00,0,0,0,0,0,0,0,0,0,0,0,0,0
20200316,053509,華新群益98購01,,,,,0.00,0.00,0,0,0,0,0,0,0,0,0,0,0,0,0
20200316,05350P,可成元富98售04,4.17,4.30,4.17,4.30,-0.26,-5.7,21000,4,88440,0,0,0,0,0,0,0,21000,-21000,-21000
20200316,053510,聯電群益97購01,0.10,0.10,0.09,0.09,-0.02,-18.18,70000,4,6500,0,0,0,0,0,0,10000,60000,-50000,-50000
20200316,053511,鴻海群益96購04,,,,,0.00,0.00,0,0,0,0,0,0,0,0,0,0,0,0,0
20200316,053512,台積電群益96購06,0.02,0.03,0.02,0.03,0.00,0.00,505000,16,12200,0,0,0,0,0,0,0,20000,-20000,-20000
20200316,053513,義隆群益96購05,0.24,0.24,0.24,0.24,0.00,0.00,20000,1,4800,0,0,0,0,0,0,20000,0,20000,20000
20200316,053514,麗豐群益96購01,,,,,0.00,0.00,0,0,0,0,0,0,0,0,0,0,0,0,0
20200316,053515,致伸群益96購02,,,,,0.00,0.00,0,0,0,0,0,0,0,0,0,0,0,0,0
20200316,053516,茂林群益96購05,0.68,0.68,0.68,0.68,+0.27,65.85,47000,2,31960,0,0,0,0,0,0,47000,0,47000,47000
20200316,053517,崇越群益97購01,,,,,0.00,0.00,0,0,0,0,0,0,0,0,0,0,0,0,0
20200316,053518,聯茂群益96購03,,,,,0.00,0.00,0,0,0,0,0,0,0,0,0,0,0,0,0
20200316,053519,力成群益96購02,,,,,0.00,0.00,0,0,0,0,0,0,0,0,0,0,0,0,0
20200316,05351P,臺股指元富95售05,,,,,0.00,0.00,0,0,0,0,0,0,0,0,0,0,0,0,0
20200316,053520,康友群益96購01,0.16,0.16,0.16,0.16,-0.10,-38.46,10000,1,1600,0,0,0,0,0,0,0,10000,-10000,-10000
20200316,053521,緯穎群益96購02,3.75,3.89,3.52,3.78,+0.08,2.16,15000,9,56080,0,0,0,0,0,0,6000,9000,-3000,-3000
20200316,053522,臺股指群益99購01,0.20,0.20,0.20,0.20,0.00,0.00,30000,1,6000,0,0,0,0,0,0,0,0,0,0
20200316,053523,T50反1中信9A購01,2.54,2.75,2.54,2.75,+0.01,0.36,5000,2,13330,0,0,0,0,0,0,5000,0,5000,5000
20200316,053524,聯電中信97購02,,,,,0.00,0.00,0,0,0,0,0,0,0,0,0,0,0,0,0
20200316,053525,台積電中信96購04,0.18,0.18,0.06,0.06,-0.08,-57.14,35000,7,3150,0,0,0,0,0,0,20000,6000,14000,14000
20200316,053526,正崴中信96購01,,,,,0.00,0.00,0,0,0,0,0,0,0,0,0,0,0,0,0
20200316,053527,創意中信97購01,,,,,0.00,0.00,0,0,0,0,0,0,0,0,0,0,0,0,0
20200316,053528,南電中信9A購01,0.36,0.36,0.32,0.32,-0.02,-5.88,153000,5,53860,0,0,0,0,0,0,123000,0,123000,123000
20200316,053529,國巨麥證96購01,0.36,0.36,0.31,0.31,+0.01,3.33,60000,2,19100,0,60000,-60000,0,0,0,0,60000,-60000,-60000
20200316,05352P,臺股指元富95售06,,,,,0.00,0.00,0,0,0,0,0,0,0,0,0,0,0,0,0
20200316,053530,聯發科康和96購01,,,,,0.00,0.00,0,0,0,0,0,0,0,0,0,0,0,0,0
20200316,053531,國泰金康和96購01,,,,,0.00,0.00,0,0,0,0,0,0,0,0,0,0,0,0,0
20200316,053532,台積電永豐96購03,0.07,0.07,0.07,0.07,-0.06,-46.15,105000,4,7350,0,0,0,0,0,0,95000,0,95000,95000
20200316,053533,光罩永豐96購03,,,,,0.00,0.00,0,0,0,0,0,0,0,0,0,0,0,0,0
20200316,053534,微星永豐96購02,0.73,0.76,0.66,0.66,-0.08,-10.81,107000,4,75380,0,0,0,0,0,0,36000,71000,-35000,-35000
20200316,053535,宏達電永豐96購02,0.26,0.26,0.26,0.26,+0.04,18.18,1000,1,260,0,0,0,0,0,0,1000,1000,0,0
20200316,053536,明泰永豐96購01,,,,,0.00,0.00,0,0,0,0,0,0,0,0,0,0,0,0,0
20200316,053537,玉晶光永豐98購02,0.33,0.34,0.24,0.25,0.00,0.00,135000,10,39650,0,0,0,0,0,0,30000,105000,-75000,-75000
20200316,053538,京鼎永豐96購03,,,,,0.00,0.00,0,0,0,0,0,0,0,0,0,0,0,0,0
20200316,053539,智易永豐96購01,,,,,0.00,0.00,0,0,0,0,0,0,0,0,0,0,0,0,0
20200316,05353P,臺股指元富95售07,,,,,0.00,0.00,0,0,0,0,0,0,0,0,0,0,0,0,0
20200316,053540,健策永豐96購01,0.10,0.10,0.07,0.07,-0.02,-22.22,62000,3,4940,0,0,0,0,0,0,20000,42000,-22000,-22000
20200316,053541,泰鼎永豐96購02,,,,,0.00,0.00,0,0,0,0,0,0,0,0,0,0,0,0,0
20200316,053542,超眾永豐96購01,0.32,0.32,0.32,0.32,-0.02,-5.88,15000,1,4800,0,0,0,0,0,0,15000,0,15000,15000
20200316,053543,臺股指永豐96購02,,,,,0.00,0.00,0,0,0,0,0,0,0,0,0,0,0,0,0
20200316,053544,華新凱基96購01,,,,,0.00,0.00,0,0,0,0,0,0,0,0,0,0,0,0,0
20200316,053545,上銀凱基96購03,0.12,0.12,0.09,0.09,-0.11,-55.0,88000,3,8520,0,0,0,0,0,0,35000,20000,15000,15000
20200316,053546,台積電凱基96購13,0.12,0.12,0.09,0.09,-0.03,-25.0,125000,2,14250,0,0,0,0,0,0,25000,0,25000,25000
20200316,053547,台積電凱基96購14,,,,,0.00,0.00,0,0,0,0,0,0,0,0,0,0,0,0,0
20200316,053548,旺宏凱基96購04,0.12,0.12,0.12,0.12,-0.05,-29.41,75000,1,9000,0,0,0,0,0,0,75000,0,75000,75000
20200316,053549,南亞科凱基96購02,,,,,0.00,0.00,0,0,0,0,0,0,0,0,0,0,0,0,0
20200316,05354P,臺股指元富95售08,,,,,0.00,0.00,0,0,0,0,0,0,0,0,0,0,0,0,0
20200316,053550,聯發科凱基96購15,,,,,0.00,0.00,0,0,0,0,0,0,0,0,0,0,0,0,0
20200316,053551,可成凱基96購05,,,,,0.00,0.00,0,0,0,0,0,0,0,0,0,0,0,0,0
20200316,053552,華新科凱基96購08,,,,,0.00,0.00,0,0,0,0,0,0,0,0,0,0,0,0,0
20200316,053553,聯詠凱基96購03,,,,,0.00,0.00,0,0,0,0,0,0,0,0,0,0,0,0,0
20200316,053554,欣興凱基97購02,,,,,0.00,0.00,0,0,0,0,0,0,0,0,0,0,0,0,0
20200316,053555,日月光凱基97購01,,,,,0.00,0.00,0,0,0,0,0,0,0,0,0,0,0,0,0
20200316,053556,康控凱基97購02,,,,,0.00,0.00,0,0,0,0,0,0,0,0,0,0,0,0,0
20200316,053557,聯茂凱基96購04,0.75,0.75,0.62,0.62,-0.02,-3.12,112000,5,77100,0,0,0,0,0,0,94000,18000,76000,76000
20200316,053558,訊芯凱基96購02,,,,,0.00,0.00,0,0,0,0,0,0,0,0,0,0,0,0,0
20200316,053559,台積電國泰98購01,0.39,0.39,0.24,0.24,-0.18,-42.86,377000,22,114590,0,0,0,0,0,0,0,0,0,0
20200316,05355P,臺股指元富95售09,,,,,0.00,0.00,0,0,0,0,0,0,0,0,0,0,0,0,0
20200316,053560,漢唐國泰98購01,0.64,0.67,0.54,0.54,-0.06,-10.0,335000,9,204950,0,0,0,0,0,0,315000,55000,260000,260000
20200316,053561,玉晶光國泰98購01,0.69,0.76,0.44,0.44,-0.37,-45.68,1582000,32,1052770,0,0,0,0,0,0,1194000,388000,806000,806000
20200316,053562,玉晶光國泰98購02,0.83,0.89,0.54,0.54,-0.42,-43.75,2379000,52,1918900,0,0,0,0,0,0,1675000,676000,999000,999000
20200316,053563,台積電富邦97購01,0.10,0.10,0.08,0.08,-0.03,-27.27,458000,10,39590,0,0,0,0,0,0,0,0,0,0
20200316,053564,台積電富邦99購01,0.16,0.16,0.12,0.12,-0.04,-25.0,9606000,394,1267220,0,9000,-9000,0,0,0,0,406000,-406000,-415000
20200316,053565,台光電富邦98購01,0.22,0.26,0.22,0.26,+0.01,4.0,120000,2,30400,0,0,0,0,0,0,20000,100000,-80000,-80000
20200316,053566,大立光富邦99購03,0.17,0.17,0.13,0.13,-0.14,-51.85,110000,2,14700,0,0,0,0,0,0,10000,0,10000,10000
20200316,053567,群創富邦97購01,,,,,0.00,0.00,0,0,0,0,0,0,0,0,0,0,0,0,0
20200316,053568,智伸科富邦98購01,,,,,0.00,0.00,0,0,0,0,0,0,0,0,0,0,0,0,0
20200316,053569,漢唐統一98購01,,,,,0.00,0.00,0,0,0,0,0,0,0,0,0,0,0,0,0
20200316,05356P,臺股指元富95售10,,,,,0.00,0.00,0,0,0,0,0,0,0,0,0,0,0,0,0
20200316,053570,京元電統一96購01,,,,,0.00,0.00,0,0,0,0,0,0,0,0,0,0,0,0,0
20200316,053571,奇鋐統一96購02,,,,,0.00,0.00,0,0,0,0,0,0,0,0,0,0,0,0,0
20200316,053572,彩晶統一96購01,,,,,0.00,0.00,0,0,0,0,0,0,0,0,0,0,0,0,0
20200316,053573,臺股指統一99購01,,,,,0.00,0.00,0,0,0,0,0,0,0,0,0,0,0,0,0
20200316,053574,奇力新元富99購01,0.21,0.21,0.17,0.17,-0.05,-22.73,30000,3,5600,0,0,0,0,0,0,0,30000,-30000,-30000
20200316,053575,聯詠元富96購01,,,,,0.00,0.00,0,0,0,0,0,0,0,0,0,0,0,0,0
20200316,053576,智原元富96購01,,,,,0.00,0.00,0,0,0,0,0,0,0,0,0,0,0,0,0
20200316,053577,上証2X元大96購02,0.41,0.43,0.38,0.38,-0.13,-25.49,340000,32,131700,0,0,0,0,0,0,0,340000,-340000,-340000
20200316,053578,華新元大98購01,,,,,0.00,0.00,0,0,0,0,0,0,0,0,0,0,0,0,0
20200316,053579,華通元大97購01,,,,,0.00,0.00,0,0,0,0,0,0,0,0,0,0,0,0,0
20200316,05357P,臺股指元富95售11,,,,,0.00,0.00,0,0,0,0,0,0,0,0,0,0,0,0,0
20200316,053580,國巨元大96購10,0.79,0.79,0.79,0.79,+0.10,14.49,26000,2,20540,0,0,0,0,0,0,26000,0,26000,26000
20200316,053581,台積電元大96購14,0.11,0.11,0.11,0.11,-0.05,-31.25,1000,1,110,0,0,0,0,0,0,1000,1000,0,0
20200316,053582,英業達元大97購01,0.97,0.97,0.83,0.83,+0.16,23.88,25000,3,22300,0,0,0,0,0,0,10000,15000,-5000,-5000
20200316,053583,漢唐元大96購03,,,,,0.00,0.00,0,0,0,0,0,0,0,0,0,0,0,0,0
20200316,053584,友達元大9B購02,0.83,0.83,0.75,0.75,-0.02,-2.6,30000,3,23800,0,0,0,0,0,0,20000,20000,0,0
20200316,053585,友達元大9C購03,,,,,0.00,0.00,0,0,0,0,0,0,0,0,0,0,0,0,0
20200316,053586,建準元大96購01,0.28,0.28,0.27,0.27,0.00,0.00,12000,3,3340,0,0,0,0,0,0,0,12000,-12000,-12000
20200316,053587,京元電元大98購01,0.45,0.59,0.40,0.45,-0.06,-11.76,339000,24,159990,0,0,0,0,0,0,159000,180000,-21000,-21000
20200316,053588,聯發科元大97購07,,,,,0.00,0.00,0,0,0,0,0,0,0,0,0,0,0,0,0
20200316,053589,宏達電元大97購02,,,,,0.00,0.00,0,0,0,0,0,0,0,0,0,0,0,0,0
20200316,05358P,大立光元大95售09,2.90,4.23,2.90,4.10,+0.91,28.53,488000,51,1943430,0,0,0,0,0,0,470000,468000,2000,2000
20200316,053590,新光金元大9A購02,0.15,0.15,0.15,0.15,-0.01,-6.25,120000,3,18000,0,0,0,0,0,0,100000,20000,80000,80000
20200316,053591,大立光元大99購03,0.38,0.39,0.23,0.23,-0.20,-46.51,60000,8,20100,0,0,0,0,0,0,10000,50000,-40000,-40000
20200316,053592,亞光元大96購01,0.43,0.45,0.20,0.20,-0.18,-47.37,84000,4,19190,0,0,0,0,0,0,84000,0,84000,84000
20200316,053593,晶技元大98購01,0.45,0.49,0.43,0.44,+0.06,15.79,150000,6,69460,0,0,0,0,0,0,149000,0,149000,149000
20200316,053594,京鼎元大96購02,,,,,0.00,0.00,0,0,0,0,0,0,0,0,0,0,0,0,0
20200316,053595,創意元大96購02,,,,,0.00,0.00,0,0,0,0,0,0,0,0,0,0,0,0,0
20200316,053596,嘉澤元大96購01,0.24,0.24,0.24,0.24,0.00,0.00,5000,1,1200,0,0,0,0,0,0,0,5000,-5000,-5000
20200316,053597,牧德元大99購01,0.74,0.74,0.57,0.57,-0.25,-30.49,286000,28,184800,0,0,0,0,0,0,99000,286000,-187000,-187000
20200316,053598,日月光元大96購04,,,,,0.00,0.00,0,0,0,0,0,0,0,0,0,0,0,0,0
20200316,053599,崇越元大96購01,0.33,0.33,0.33,0.33,-0.07,-17.5,10000,1,3300,0,0,0,0,0,0,0,10000,-10000,-10000
20200316,05359P,嘉澤元大95售02,1.92,2.34,1.92,2.34,+0.32,15.84,318000,4,655720,0,0,0,0,0,0,303000,15000,288000,288000
20200316,053600,同欣電元大96購04,0.07,0.07,0.06,0.06,-0.05,-45.45,45000,4,2850,0,0,0,0,0,0,20000,25000,-5000,-5000
20200316,053601,台表科元大98購01,0.15,0.15,0.15,0.15,+0.02,15.38,50000,5,7500,0,0,0,0,0,0,0,50000,-50000,-50000
20200316,053602,台虹元大96購01,0.84,0.97,0.64,0.69,-0.20,-22.47,281000,23,233820,0,0,0,0,0,0,134000,147000,-13000,-13000
20200316,053603,臺股指元大96購20,,,,,0.00,0.00,0,0,0,0,0,0,0,0,0,0,0,0,0
20200316,053604,臺股指元大96購21,,,,,0.00,0.00,0,0,0,0,0,0,0,0,0,0,0,0,0
20200316,053605,臺股指永昌96購01,,,,,0.00,0.00,0,0,0,0,0,0,0,0,0,0,0,0,0
20200316,053606,臺股指永昌96購02,,,,,0.00,0.00,0,0,0,0,0,0,0,0,0,0,0,0,0
20200316,053607,大立光第一96購01,,,,,0.00,0.00,0,0,0,0,0,0,0,0,0,0,0,0,0
20200316,053608,彩晶第一96購01,,,,,0.00,0.00,0,0,0,0,0,0,0,0,0,0,0,0,0
20200316,053609,華新中信9A購01,,,,,0.00,0.00,0,0,0,0,0,0,0,0,0,0,0,0,0
20200316,05360P,健策元大95售03,1.60,1.90,1.54,1.90,+0.08,4.4,124000,17,222040,0,0,0,0,0,0,120000,94000,26000,26000
20200316,053610,矽力中信98購01,0.50,0.50,0.28,0.28,-0.20,-41.67,807000,39,296750,0,0,0,0,0,0,303000,493000,-190000,-190000
20200316,053611,聯茂麥證96購01,0.52,0.66,0.46,0.48,-0.21,-30.43,1280000,9,688000,30000,1250000,-1220000,0,0,0,30000,1250000,-1220000,-1220000
20200316,053612,T50反1群益96購01,1.99,1.99,1.99,1.99,+0.36,22.09,5000,1,9950,0,0,0,0,0,0,5000,0,5000,5000
20200316,053613,元油反群益9A購02,,,,,0.00,0.00,0,0,0,0,0,0,0,0,0,0,0,0,0
20200316,053614,台積電群益96購08,,,,,0.00,0.00,0,0,0,0,0,0,0,0,0,0,0,0,0
20200316,053615,光罩群益96購01,0.04,0.05,0.03,0.03,0.00,0.00,55000,6,2400,0,0,0,0,0,0,0,40000,-40000,-40000
20200316,053616,奇力新群益97購01,,,,,0.00,0.00,0,0,0,0,0,0,0,0,0,0,0,0,0
20200316,053617,宏達電群益96購02,,,,,0.00,0.00,0,0,0,0,0,0,0,0,0,0,0,0,0
20200316,053618,新唐群益96購01,,,,,0.00,0.00,0,0,0,0,0,0,0,0,0,0,0,0,0
20200316,053619,和碩群益96購01,,,,,0.00,0.00,0,0,0,0,0,0,0,0,0,0,0,0,0
20200316,05361P,聯發科富邦97售01,1.72,1.74,1.72,1.74,+0.14,8.75,65000,2,112900,0,0,0,0,0,0,65000,0,65000,65000
20200316,053620,臺股指群益96購06,,,,,0.00,0.00,0,0,0,0,0,0,0,0,0,0,0,0,0
20200316,053621,臺股指群益96購07,,,,,0.00,0.00,0,0,0,0,0,0,0,0,0,0,0,0,0
20200316,053622,臺股指群益96購08,,,,,0.00,0.00,0,0,0,0,0,0,0,0,0,0,0,0,0
20200316,053623,臺股指群益96購09,0.06,0.06,0.06,0.06,+0.01,20.0,180000,1,10800,0,0,0,0,0,0,0,0,0,0
20200316,053624,A50正2兆豐97購02,0.44,0.45,0.37,0.38,-0.03,-7.32,540000,13,221300,0,0,0,0,0,0,310000,230000,80000,80000
20200316,053625,國巨兆豐96購03,0.17,0.21,0.14,0.14,-0.03,-17.65,205000,12,34250,0,0,0,0,0,0,75000,0,75000,75000
20200316,053626,台積電兆豐96購03,,,,,0.00,0.00,0,0,0,0,0,0,0,0,0,0,0,0,0
20200316,053627,宏碁兆豐97購01,0.25,0.25,0.22,0.22,-0.03,-12.0,822000,13,181860,0,0,0,0,0,0,822000,0,822000,822000
20200316,053628,微星兆豐96購01,1.56,1.56,1.47,1.47,-0.35,-19.23,30000,2,45000,0,0,0,0,0,0,30000,0,30000,30000
20200316,053629,玉山金兆豐96購01,0.77,0.78,0.61,0.61,-0.14,-18.67,334000,8,242370,0,0,0,0,0,0,329000,5000,324000,324000
20200316,05362P,可成富邦97售02,2.28,2.32,2.28,2.32,+0.04,1.75,2000,2,4600,0,0,0,0,0,0,1000,1000,0,0
20200316,053630,奇鋐兆豐97購01,0.60,0.66,0.46,0.46,-0.13,-22.03,366000,12,229350,0,0,0,0,0,0,86000,280000,-194000,-194000
20200316,053631,欣興兆豐97購01,,,,,0.00,0.00,0,0,0,0,0,0,0,0,0,0,0,0,0
20200316,053632,新唐兆豐96購01,0.48,0.48,0.32,0.32,-0.14,-30.43,450000,4,180500,0,0,0,0,0,0,200000,250000,-50000,-50000
20200316,053633,臺股指兆豐96購01,,,,,0.00,0.00,0,0,0,0,0,0,0,0,0,0,0,0,0
20200316,053634,劍麟永豐96購01,,,,,0.00,0.00,0,0,0,0,0,0,0,0,0,0,0,0,0
20200316,053635,技嘉永豐96購01,,,,,0.00,0.00,0,0,0,0,0,0,0,0,0,0,0,0,0
20200316,053636,全新永豐96購02,,,,,0.00,0.00,0,0,0,0,0,0,0,0,0,0,0,0,0
20200316,053637,強茂永豐96購01,0.21,0.21,0.21,0.21,0.00,0.00,1000,1,210,0,0,0,0,0,0,1000,0,1000,1000
20200316,053638,信邦永豐96購01,,,,,0.00,0.00,0,0,0,0,0,0,0,0,0,0,0,0,0
20200316,053639,禾伸堂永豐96購01,0.95,1.03,0.72,0.72,-0.22,-23.4,361000,36,335020,0,0,0,0,0,0,306000,59000,247000,247000
20200316,05363P,臺股指富邦95售03,,,,,0.00,0.00,0,0,0,0,0,0,0,0,0,0,0,0,0
20200316,053640,上緯控永豐96購01,,,,,0.00,0.00,0,0,0,0,0,0,0,0,0,0,0,0,0
20200316,053641,正文永豐96購01,,,,,0.00,0.00,0,0,0,0,0,0,0,0,0,0,0,0,0
20200316,053642,瀚宇博永豐96購01,,,,,0.00,0.00,0,0,0,0,0,0,0,0,0,0,0,0,0
20200316,053643,漢唐國票97購02,,,,,0.00,0.00,0,0,0,0,0,0,0,0,0,0,0,0,0
20200316,053644,台表科國票97購03,,,,,0.00,0.00,0,0,0,0,0,0,0,0,0,0,0,0,0
20200316,053645,臺股指國票96購08,,,,,0.00,0.00,0,0,0,0,0,0,0,0,0,0,0,0,0
20200316,053646,臺股指國票96購09,0.39,0.39,0.39,0.39,0.00,0.00,2000,1,780,0,0,0,0,0,0,0,0,0,0
20200316,053647,臺股指國票96購10,,,,,0.00,0.00,0,0,0,0,0,0,0,0,0,0,0,0,0
20200316,053648,台積電凱基97購04,0.64,0.64,0.64,0.64,+0.31,93.94,10000,1,6400,0,0,0,0,0,0,10000,0,10000,10000
20200316,053649,台積電凱基97購05,0.30,0.30,0.15,0.15,-0.10,-40.0,53000,5,8350,0,0,0,0,0,0,0,0,0,0
20200316,05364P,臺股指富邦95售04,,,,,0.00,0.00,0,0,0,0,0,0,0,0,0,0,0,0,0
20200316,053650,華邦電凱基98購01,,,,,0.00,0.00,0,0,0,0,0,0,0,0,0,0,0,0,0
20200316,053651,台光電凱基98購01,0.36,0.39,0.31,0.31,0.00,0.00,138000,5,49960,0,0,0,0,0,0,126000,12000,114000,114000
20200316,053652,友達凱基98購04,0.23,0.23,0.23,0.23,+0.06,35.29,50000,1,11500,0,0,0,0,0,0,50000,0,50000,50000
20200316,053653,京元電凱基96購02,0.22,0.23,0.15,0.15,0.00,0.00,296000,7,65770,0,0,0,0,0,0,0,296000,-296000,-296000
20200316,053654,聯發科凱基98購01,0.07,0.07,0.07,0.07,-0.04,-36.36,143000,1,10010,0,0,0,0,0,0,143000,0,143000,143000
20200316,053655,全新凱基98購02,0.12,0.12,0.12,0.12,+0.02,20.0,210000,21,25200,0,0,0,0,0,0,10000,200000,-190000,-190000
20200316,053656,可成凱基96購06,,,,,0.00,0.00,0,0,0,0,0,0,0,0,0,0,0,0,0
20200316,053657,元大金凱基96購01,0.04,0.07,0.04,0.07,-0.08,-53.33,2096000,5,86840,0,0,0,0,0,0,1996000,0,1996000,1996000
20200316,053658,亞光凱基96購01,0.50,0.50,0.43,0.43,+0.08,22.86,57000,3,27310,0,0,0,0,0,0,57000,0,57000,57000
20200316,053659,智原凱基97購01,,,,,0.00,0.00,0,0,0,0,0,0,0,0,0,0,0,0,0
20200316,05365P,臺股指富邦95售05,3.30,3.30,3.30,3.30,0.00,0.00,1000,1,3300,0,0,0,0,0,0,1000,0,1000,1000
20200316,053660,群創凱基98購08,,,,,0.00,0.00,0,0,0,0,0,0,0,0,0,0,0,0,0
20200316,053661,嘉澤凱基97購01,,,,,0.00,0.00,0,0,0,0,0,0,0,0,0,0,0,0,0
20200316,053662,矽力凱基97購01,1.23,1.23,1.02,1.02,0.00,0.00,11000,2,13320,0,0,0,0,0,0,0,11000,-11000,-11000
20200316,053663,臺股指凱基96購24,,,,,0.00,0.00,0,0,0,0,0,0,0,0,0,0,0,0,0
20200316,053664,臺股指凱基96購25,,,,,0.00,0.00,0,0,0,0,0,0,0,0,0,0,0,0,0
20200316,053665,臺股指凱基96購26,0.10,0.10,0.10,0.10,0.00,0.00,80000,8,8000,0,0,0,0,0,0,0,80000,-80000,-80000
20200316,053666,臺股指凱基96購29,,,,,0.00,0.00,0,0,0,0,0,0,0,0,0,0,0,0,0
20200316,053667,鴻海統一96購12,,,,,0.00,0.00,0,0,0,0,0,0,0,0,0,0,0,0,0
20200316,053668,鴻海統一97購01,,,,,0.00,0.00,0,0,0,0,0,0,0,0,0,0,0,0,0
20200316,053669,台積電統一96購08,,,,,0.00,0.00,0,0,0,0,0,0,0,0,0,0,0,0,0
20200316,05366P,鴻海元富95售12,5.10,5.85,5.10,5.85,+0.98,20.12,183000,14,1010050,0,0,0,0,0,0,62000,118000,-56000,-56000
20200316,053670,台積電統一96購09,,,,,0.00,0.00,0,0,0,0,0,0,0,0,0,0,0,0,0
20200316,053671,可成統一96購03,,,,,0.00,0.00,0,0,0,0,0,0,0,0,0,0,0,0,0
20200316,053672,嘉澤元富96購02,,,,,0.00,0.00,0,0,0,0,0,0,0,0,0,0,0,0,0
20200316,053673,超眾元富96購03,0.82,0.92,0.54,0.54,-0.30,-35.71,134000,21,112730,0,0,0,0,0,0,110000,24000,86000,86000
20200316,053674,臺股指元富96購01,,,,,0.00,0.00,0,0,0,0,0,0,0,0,0,0,0,0,0
20200316,053675,臺股指元富96購02,,,,,0.00,0.00,0,0,0,0,0,0,0,0,0,0,0,0,0
20200316,053676,新光金國泰98購02,0.05,0.05,0.05,0.05,0.00,0.00,10000,1,500,0,0,0,0,0,0,0,10000,-10000,-10000
20200316,053677,同欣電國泰97購01,0.38,0.41,0.24,0.24,-0.21,-46.67,823000,12,290380,0,0,0,0,0,0,431000,392000,39000,39000
20200316,053678,南亞科富邦97購01,,,,,0.00,0.00,0,0,0,0,0,0,0,0,0,0,0,0,0
20200316,053679,緯創富邦96購01,,,,,0.00,0.00,0,0,0,0,0,0,0,0,0,0,0,0,0
20200316,05367P,鴻海元富95售13,4.19,4.38,4.10,4.38,+0.02,0.46,85000,13,362200,0,0,0,0,0,0,0,85000,-85000,-85000
20200316,053680,臺股指富邦96購01,,,,,0.00,0.00,0,0,0,0,0,0,0,0,0,0,0,0,0
20200316,053681,臺股指富邦96購02,,,,,0.00,0.00,0,0,0,0,0,0,0,0,0,0,0,0,0
20200316,053682,臺股指富邦96購03,,,,,0.00,0.00,0,0,0,0,0,0,0,0,0,0,0,0,0
20200316,053683,上証2X元大96購03,,,,,0.00,0.00,0,0,0,0,0,0,0,0,0,0,0,0,0
20200316,053684,台積電元大96購17,0.20,0.20,0.06,0.06,+0.01,20.0,21000,3,3560,0,0,0,0,0,0,0,1000,-1000,-1000
20200316,053685,台積電元大96購18,0.06,0.06,0.06,0.06,+0.02,50.0,11000,2,660,0,0,0,0,0,0,0,1000,-1000,-1000
20200316,053686,台積電元大97購08,0.24,0.24,0.13,0.13,-0.09,-40.91,23000,4,5190,0,0,0,0,0,0,0,20000,-20000,-20000
20200316,053687,智邦元大96購02,1.23,1.41,1.10,1.11,-0.20,-15.27,173000,28,219550,0,0,0,0,0,0,166000,133000,33000,33000
20200316,053688,燿華元大96購05,0.06,0.06,0.06,0.06,-0.07,-53.85,10000,1,600,0,0,0,0,0,0,0,10000,-10000,-10000
20200316,053689,台光電元大96購01,0.30,0.30,0.30,0.30,+0.07,30.43,10000,1,3000,0,0,0,0,0,0,0,10000,-10000,-10000
20200316,05368P,可成元富95售03,4.96,5.15,4.96,5.15,-0.60,-10.43,39000,5,197070,0,0,0,0,0,0,12000,27000,-15000,-15000
20200316,053690,南亞科元大96購02,0.26,0.27,0.14,0.14,-0.11,-44.0,483000,20,115170,0,0,0,0,0,0,308000,125000,183000,183000
20200316,053691,聯發科元大96購16,0.05,0.05,0.05,0.05,0.00,0.00,6000,3,300,0,0,0,0,0,0,0,6000,-6000,-6000
20200316,053692,聯詠元大96購04,,,,,0.00,0.00,0,0,0,0,0,0,0,0,0,0,0,0,0
20200316,053693,欣興元大96購05,0.10,0.10,0.10,0.10,0.00,0.00,30000,1,3000,0,0,0,0,0,0,0,0,0,0
20200316,053694,創意元大96購03,,,,,0.00,0.00,0,0,0,0,0,0,0,0,0,0,0,0,0
20200316,053695,智易元大97購02,0.09,0.09,0.09,0.09,0.00,0.00,10000,1,900,0,0,0,0,0,0,0,10000,-10000,-10000
20200316,053696,日月光元大96購05,,,,,0.00,0.00,0,0,0,0,0,0,0,0,0,0,0,0,0
20200316,053697,臻鼎元大96購02,0.04,0.08,0.04,0.04,-0.02,-33.33,374000,28,23860,0,0,0,0,0,0,120000,254000,-134000,-134000
20200316,053698,中磊元大96購02,,,,,0.00,0.00,0,0,0,0,0,0,0,0,0,0,0,0,0
20200316,053699,臺股指元大96購22,,,,,0.00,0.00,0,0,0,0,0,0,0,0,0,0,0,0,0
20200316,05369P,可成元富95售04,4.52,4.95,4.52,4.95,-0.45,-8.33,111000,9,517020,0,0,0,0,0,0,46000,65000,-19000,-19000
20200316,053700,臺股指元大96購23,,,,,0.00,0.00,0,0,0,0,0,0,0,0,0,0,0,0,0
20200316,053701,台積電兆豐96購05,0.22,0.23,0.08,0.08,-0.15,-65.22,1256000,33,185540,0,0,0,0,0,0,399000,45000,354000,354000
20200316,053702,智易兆豐97購02,,,,,0.00,0.00,0,0,0,0,0,0,0,0,0,0,0,0,0
20200316,053703,緯穎兆豐96購01,2.66,2.72,2.60,2.64,+0.67,34.01,70000,17,188100,0,0,0,0,0,0,70000,0,70000,70000
20200316,053704,國巨群益96購06,,,,,0.00,0.00,0,0,0,0,0,0,0,0,0,0,0,0,0
20200316,053705,滬深2X凱基99購01,0.46,0.46,0.37,0.38,-0.18,-32.14,370000,9,144150,0,0,0,0,0,0,245000,80000,165000,165000
20200316,053706,S&P反1凱基99購01,1.90,1.90,1.64,1.85,+0.28,17.83,1191000,31,2058120,0,0,0,0,0,0,30000,1161000,-1131000,-1131000
20200316,053707,A50正2凱基99購02,0.35,0.35,0.26,0.26,-0.05,-16.13,189000,13,53240,0,0,0,0,0,0,0,189000,-189000,-189000
20200316,053708,道瓊反凱基98購01,3.28,3.42,3.23,3.42,+0.39,12.87,127000,16,424880,0,0,0,0,0,0,3000,59000,-56000,-56000
20200316,053709,台達電凱基96購04,,,,,0.00,0.00,0,0,0,0,0,0,0,0,0,0,0,0,0
20200316,05370P,矽創元富95售01,1.73,2.02,1.73,2.02,-0.01,-0.49,137000,17,257060,0,0,0,0,0,0,59000,58000,1000,1000
20200316,053710,華通凱基96購05,,,,,0.00,0.00,0,0,0,0,0,0,0,0,0,0,0,0,0
20200316,053711,鴻海凱基96購14,,,,,0.00,0.00,0,0,0,0,0,0,0,0,0,0,0,0,0
20200316,053712,台光電凱基96購04,,,,,0.00,0.00,0,0,0,0,0,0,0,0,0,0,0,0,0
20200316,053713,漢唐凱基96購04,,,,,0.00,0.00,0,0,0,0,0,0,0,0,0,0,0,0,0
20200316,053714,南亞科凱基96購03,,,,,0.00,0.00,0,0,0,0,0,0,0,0,0,0,0,0,0
20200316,053715,美律凱基96購04,,,,,0.00,0.00,0,0,0,0,0,0,0,0,0,0,0,0,0
20200316,053716,京元電凱基97購01,,,,,0.00,0.00,0,0,0,0,0,0,0,0,0,0,0,0,0
20200316,053717,聯發科凱基96購17,,,,,0.00,0.00,0,0,0,0,0,0,0,0,0,0,0,0,0
20200316,053718,全新凱基97購02,0.09,0.09,0.09,0.09,+0.01,12.5,20000,1,1800,0,0,0,0,0,0,20000,0,20000,20000
20200316,053719,可成凱基96購08,0.21,0.21,0.21,0.21,0.00,0.00,60000,1,12600,0,0,0,0,0,0,0,60000,-60000,-60000
20200316,05371P,臺股指中信95售10,,,,,0.00,0.00,0,0,0,0,0,0,0,0,0,0,0,0,0
20200316,053720,宏達電凱基97購01,,,,,0.00,0.00,0,0,0,0,0,0,0,0,0,0,0,0,0
20200316,053721,國泰金凱基97購01,,,,,0.00,0.00,0,0,0,0,0,0,0,0,0,0,0,0,0
20200316,053722,新光金凱基9C購01,,,,,0.00,0.00,0,0,0,0,0,0,0,0,0,0,0,0,0
20200316,053723,奇鋐凱基98購01,,,,,0.00,0.00,0,0,0,0,0,0,0,0,0,0,0,0,0
20200316,053724,聯詠凱基96購04,0.25,0.25,0.25,0.25,-0.01,-3.85,168000,4,42000,0,0,0,0,0,0,0,168000,-168000,-168000
20200316,053725,晶相光凱基96購01,0.57,0.60,0.57,0.57,0.00,0.00,96000,7,55400,0,0,0,0,0,0,96000,0,96000,96000
20200316,053726,TPK凱基96購02,,,,,0.00,0.00,0,0,0,0,0,0,0,0,0,0,0,0,0
20200316,053727,麗豐凱基97購01,,,,,0.00,0.00,0,0,0,0,0,0,0,0,0,0,0,0,0
20200316,053728,茂林凱基97購01,1.79,1.79,1.54,1.54,-0.15,-8.88,28000,5,49620,0,0,0,0,0,0,26000,2000,24000,24000
20200316,053729,聯茂凱基96購05,1.34,1.51,1.11,1.11,-0.30,-21.28,30000,5,40640,0,0,0,0,0,0,10000,20000,-10000,-10000
20200316,053730,樺漢凱基98購01,,,,,0.00,0.00,0,0,0,0,0,0,0,0,0,0,0,0,0
20200316,053731,矽創凱基96購03,,,,,0.00,0.00,0,0,0,0,0,0,0,0,0,0,0,0,0
20200316,053732,S&P反1中信9C購01,2.48,2.50,2.48,2.50,-0.33,-11.66,15000,2,37300,0,0,0,0,0,0,0,15000,-15000,-15000
20200316,053733,華邦電中信98購01,0.06,0.06,0.06,0.06,0.00,0.00,20000,1,1200,0,0,0,0,0,0,0,0,0,0
20200316,053734,友達中信98購02,0.17,0.17,0.12,0.12,+0.02,20.0,15000,2,2050,0,0,0,0,0,0,5000,10000,-5000,-5000
20200316,053735,矽力中信97購01,0.50,0.50,0.45,0.45,-0.18,-28.57,43000,5,20950,0,0,0,0,0,0,0,43000,-43000,-43000
20200316,053736,友達麥證96購01,0.13,0.13,0.13,0.13,+0.05,62.5,20000,2,2600,0,10000,-10000,0,0,0,0,10000,-10000,-10000
20200316,053737,華新科麥證96購01,,,,,0.00,0.00,0,0,0,0,0,0,0,0,0,0,0,0,0
20200316,053738,群創麥證96購01,,,,,0.00,0.00,0,0,0,0,0,0,0,0,0,0,0,0,0
20200316,053739,A50正2國票9A購01,,,,,0.00,0.00,0,0,0,0,0,0,0,0,0,0,0,0,0
20200316,05373P,臺股指中信95售11,,,,,0.00,0.00,0,0,0,0,0,0,0,0,0,0,0,0,0
20200316,053740,元油反國票99購01,,,,,0.00,0.00,0,0,0,0,0,0,0,0,0,0,0,0,0
20200316,053741,漢唐國票97購03,,,,,0.00,0.00,0,0,0,0,0,0,0,0,0,0,0,0,0
20200316,053742,創意國票97購01,0.32,0.33,0.21,0.21,-0.02,-8.7,319000,12,100340,0,0,0,0,0,0,239000,20000,219000,219000
20200316,053743,康控國票97購02,,,,,0.00,0.00,0,0,0,0,0,0,0,0,0,0,0,0,0
20200316,053744,台郡國票97購03,0.18,0.20,0.16,0.18,+0.01,5.88,90000,9,16200,0,0,0,0,0,0,0,90000,-90000,-90000
20200316,053745,康友國票97購01,0.77,0.77,0.77,0.77,0.00,0.00,5000,1,3850,0,0,0,0,0,0,0,5000,-5000,-5000
20200316,053746,彰銀康和96購01,0.79,0.79,0.63,0.63,-0.08,-11.27,89000,13,69080,0,0,0,0,0,0,75000,14000,61000,61000
20200316,053747,滬深2X永豐96購05,,,,,0.00,0.00,0,0,0,0,0,0,0,0,0,0,0,0,0
20200316,053748,燿華永豐96購04,,,,,0.00,0.00,0,0,0,0,0,0,0,0,0,0,0,0,0
20200316,053749,揚明光永豐97購01,0.20,0.20,0.12,0.12,-0.07,-36.84,48000,5,7400,0,0,0,0,0,0,35000,13000,22000,22000
20200316,05374P,台積電國票96售07,2.70,2.70,2.70,2.70,-0.41,-13.18,9000,1,24300,0,0,0,0,0,0,9000,0,9000,9000
20200316,053750,致伸永豐96購02,,,,,0.00,0.00,0,0,0,0,0,0,0,0,0,0,0,0,0
20200316,053751,康控永豐96購02,,,,,0.00,0.00,0,0,0,0,0,0,0,0,0,0,0,0,0
20200316,053752,超眾永豐96購02,,,,,0.00,0.00,0,0,0,0,0,0,0,0,0,0,0,0,0
20200316,053753,啟碁永豐96購01,0.13,0.13,0.13,0.13,-0.09,-40.91,5000,1,650,0,0,0,0,0,0,5000,0,5000,5000
20200316,053754,英業達元富96購02,0.43,0.43,0.36,0.36,-0.18,-33.33,197000,10,79030,0,0,0,0,0,0,137000,60000,77000,77000
20200316,053755,亞光元富96購01,0.44,0.44,0.25,0.25,-0.11,-30.56,183000,13,69620,0,0,0,0,0,0,103000,103000,0,0
20200316,053756,亞光元富96購02,,,,,0.00,0.00,0,0,0,0,0,0,0,0,0,0,0,0,0
20200316,053757,聯發科國泰96購04,,,,,0.00,0.00,0,0,0,0,0,0,0,0,0,0,0,0,0
20200316,053758,華新科國泰97購02,,,,,0.00,0.00,0,0,0,0,0,0,0,0,0,0,0,0,0
20200316,053759,晶相光國泰98購01,0.79,0.87,0.65,0.65,-0.17,-20.73,118000,11,79840,0,0,0,0,0,0,111000,7000,104000,104000
20200316,05375P,健策國票96售02,1.05,1.35,1.05,1.35,+0.14,11.57,68000,6,82950,0,0,0,0,0,0,38000,10000,28000,28000
20200316,053760,牧德國泰98購01,0.97,1.03,0.70,0.70,-0.37,-34.58,627000,15,543700,0,0,0,0,0,0,210000,487000,-277000,-277000
20200316,053761,健策國泰98購01,0.22,0.22,0.20,0.20,+0.02,11.11,57000,5,11880,0,0,0,0,0,0,15000,0,15000,15000
20200316,053762,T50反1富邦97購01,,,,,0.00,0.00,0,0,0,0,0,0,0,0,0,0,0,0,0
20200316,053763,T50反1富邦98購01,,,,,0.00,0.00,0,0,0,0,0,0,0,0,0,0,0,0,0
20200316,053764,A50正2富邦99購01,,,,,0.00,0.00,0,0,0,0,0,0,0,0,0,0,0,0,0
20200316,053765,智邦富邦96購01,0.42,0.42,0.40,0.40,+0.07,21.21,2000,2,820,0,0,0,0,0,0,2000,0,2000,2000
20200316,053766,友達富邦97購01,0.06,0.06,0.06,0.06,+0.01,20.0,45000,1,2700,0,0,0,0,0,0,0,0,0,0
20200316,053767,臻鼎富邦97購02,,,,,0.00,0.00,0,0,0,0,0,0,0,0,0,0,0,0,0
20200316,053768,S&P反1元大99購01,2.08,2.08,2.08,2.08,+0.19,10.05,10000,1,20800,0,0,0,0,0,0,0,10000,-10000,-10000
20200316,053769,香港反元大99購01,1.09,1.39,1.09,1.39,+0.10,7.75,35000,3,45650,0,0,0,0,0,0,35000,0,35000,35000
20200316,05376P,聯發科日盛95售04,1.71,1.71,1.71,1.71,-0.04,-2.29,150000,2,256500,0,0,0,0,0,0,150000,150000,0,0
20200316,053770,元金2X元大98購01,0.96,1.10,0.87,1.04,-0.46,-30.67,742000,71,717150,0,0,0,0,0,0,140000,358000,-218000,-218000
20200316,053771,華新元大97購01,0.10,0.10,0.10,0.10,-0.04,-28.57,20000,2,2000,0,0,0,0,0,0,0,20000,-20000,-20000
20200316,053772,大成鋼元大96購02,0.16,0.16,0.16,0.16,-0.01,-5.88,10000,2,1600,0,0,0,0,0,0,10000,0,10000,10000
20200316,053773,上銀元大96購04,1.03,1.03,0.93,0.93,+0.08,9.41,20000,2,19600,0,0,0,0,0,0,20000,0,20000,20000
20200316,053774,台達電元大96購04,,,,,0.00,0.00,0,0,0,0,0,0,0,0,0,0,0,0,0
20200316,053775,鴻海元大96購21,,,,,0.00,0.00,0,0,0,0,0,0,0,0,0,0,0,0,0
20200316,053776,台積電元大96購19,0.15,0.15,0.15,0.15,0.00,0.00,3000,1,450,0,0,0,0,0,0,0,0,0,0
20200316,053777,台積電元大96購20,0.27,0.27,0.09,0.09,-0.14,-60.87,252000,15,34740,0,0,0,0,0,0,99000,2000,97000,97000
20200316,053778,旺宏元大97購03,0.28,0.29,0.25,0.25,+0.09,56.25,30000,3,8200,0,0,0,0,0,0,0,30000,-30000,-30000
20200316,053779,台光電元大96購02,,,,,0.00,0.00,0,0,0,0,0,0,0,0,0,0,0,0,0
20200316,05377P,鴻海凱基95售18,2.40,2.41,2.40,2.41,0.00,0.00,30000,2,72200,0,0,0,0,0,0,30000,30000,0,0
20200316,053780,南亞科元大96購03,,,,,0.00,0.00,0,0,0,0,0,0,0,0,0,0,0,0,0
20200316,053781,友達元大9B購03,,,,,0.00,0.00,0,0,0,0,0,0,0,0,0,0,0,0,0
20200316,053782,京元電元大98購02,,,,,0.00,0.00,0,0,0,0,0,0,0,0,0,0,0,0,0
20200316,053783,聯發科元大96購17,,,,,0.00,0.00,0,0,0,0,0,0,0,0,0,0,0,0,0
20200316,053784,奇力新元大97購02,0.82,0.87,0.57,0.57,-0.13,-18.57,268000,20,196840,0,0,0,0,0,0,100000,148000,-48000,-48000
20200316,053785,聯詠元大96購05,,,,,0.00,0.00,0,0,0,0,0,0,0,0,0,0,0,0,0
20200316,053786,新日興元大96購02,0.83,0.87,0.54,0.54,-0.17,-23.94,62000,8,44850,0,0,0,0,0,0,22000,50000,-28000,-28000
20200316,053787,健策元大97購02,0.45,0.48,0.37,0.37,-0.13,-26.0,115000,10,51800,0,0,0,0,0,0,85000,30000,55000,55000
20200316,053788,泰鼎元大97購01,1.93,1.93,1.93,1.93,0.00,0.00,50000,1,96500,0,0,0,0,0,0,50000,0,50000,50000
20200316,053789,彩晶元大9C購02,,,,,0.00,0.00,0,0,0,0,0,0,0,0,0,0,0,0,0
20200316,05378P,台積電凱基96售02,2.21,2.35,2.21,2.33,-0.15,-6.05,43000,4,99630,0,0,0,0,0,0,33000,10000,23000,23000
20200316,053790,嘉聯益元大99購02,,,,,0.00,0.00,0,0,0,0,0,0,0,0,0,0,0,0,0
20200316,053791,同欣電元大96購05,0.52,0.52,0.52,0.52,+0.23,79.31,4000,1,2080,0,0,0,0,0,0,4000,0,4000,4000
20200316,053792,百和元大96購01,0.20,0.20,0.11,0.11,-0.11,-50.0,68000,6,9380,0,0,0,0,0,0,20000,48000,-28000,-28000
20200316,053793,致伸兆豐96購01,,,,,0.00,0.00,0,0,0,0,0,0,0,0,0,0,0,0,0
20200316,053794,燿華亞東96購01,,,,,0.00,0.00,0,0,0,0,0,0,0,0,0,0,0,0,0
20200316,053795,群創亞東96購01,,,,,0.00,0.00,0,0,0,0,0,0,0,0,0,0,0,0,0
20200316,053796,華通中信96購02,,,,,0.00,0.00,0,0,0,0,0,0,0,0,0,0,0,0,0
20200316,053797,台積電中信98購01,0.15,0.15,0.10,0.10,-0.19,-65.52,60000,3,6500,0,0,0,0,0,0,0,60000,-60000,-60000
20200316,053798,台積電中信98購02,0.11,0.11,0.11,0.11,-0.13,-54.17,20000,2,2200,0,0,0,0,0,0,0,20000,-20000,-20000
20200316,053799,矽創中信9A購01,0.17,0.17,0.12,0.12,-0.02,-14.29,85000,5,11950,0,0,0,0,0,0,35000,50000,-15000,-15000
20200316,05379P,可成凱基95售11,2.91,3.25,2.91,2.98,-1.12,-27.32,44000,3,131500,0,0,0,0,0,0,14000,30000,-16000,-16000
20200316,053800,華通凱基97購03,,,,,0.00,0.00,0,0,0,0,0,0,0,0,0,0,0,0,0
20200316,053801,台積電凱基96購18,,,,,0.00,0.00,0,0,0,0,0,0,0,0,0,0,0,0,0
20200316,053802,南亞科凱基96購04,,,,,0.00,0.00,0,0,0,0,0,0,0,0,0,0,0,0,0
20200316,053803,聯發科凱基96購18,,,,,0.00,0.00,0,0,0,0,0,0,0,0,0,0,0,0,0
20200316,053804,富邦金凱基96購01,,,,,0.00,0.00,0,0,0,0,0,0,0,0,0,0,0,0,0
20200316,053805,奇鋐凱基98購02,,,,,0.00,0.00,0,0,0,0,0,0,0,0,0,0,0,0,0
20200316,053806,鎧勝凱基96購02,,,,,0.00,0.00,0,0,0,0,0,0,0,0,0,0,0,0,0
20200316,053807,T50反1群益96購02,2.17,2.17,2.17,2.17,0.00,0.00,1000,1,2170,0,0,0,0,0,0,1000,0,1000,1000
20200316,053808,大成鋼群益97購01,,,,,0.00,0.00,0,0,0,0,0,0,0,0,0,0,0,0,0
20200316,053809,上銀群益96購02,0.28,0.32,0.26,0.26,-0.11,-29.73,107000,4,29360,0,0,0,0,0,0,98000,29000,69000,69000
20200316,05380P,鴻海群益95售11,,,,,0.00,0.00,0,0,0,0,0,0,0,0,0,0,0,0,0
20200316,053810,台達電群益96購01,,,,,0.00,0.00,0,0,0,0,0,0,0,0,0,0,0,0,0
20200316,053811,國巨群益98購02,,,,,0.00,0.00,0,0,0,0,0,0,0,0,0,0,0,0,0
20200316,053812,台積電群益96購09,,,,,0.00,0.00,0,0,0,0,0,0,0,0,0,0,0,0,0
20200316,053813,友達群益9A購03,0.22,0.22,0.22,0.22,+0.06,37.5,32000,1,7040,0,0,0,0,0,0,32000,0,32000,32000
20200316,053814,美律群益97購02,0.11,0.11,0.11,0.11,0.00,0.00,5000,1,550,0,0,0,0,0,0,0,5000,-5000,-5000
20200316,053815,聯發科群益96購01,0.07,0.07,0.05,0.05,-0.05,-50.0,600000,6,36000,0,0,0,0,0,0,0,600000,-600000,-600000
20200316,053816,聯發科群益96購02,,,,,0.00,0.00,0,0,0,0,0,0,0,0,0,0,0,0,0
20200316,053817,華新科群益97購02,2.70,2.70,1.68,1.71,-0.59,-25.65,440000,16,959540,0,0,0,0,0,0,68000,372000,-304000,-304000
20200316,053818,富邦金群益98購01,0.33,0.33,0.33,0.33,-0.16,-32.65,20000,1,6600,0,0,0,0,0,0,20000,0,20000,20000
20200316,053819,大立光群益96購04,,,,,0.00,0.00,0,0,0,0,0,0,0,0,0,0,0,0,0
20200316,05381P,聯詠群益95售02,,,,,0.00,0.00,0,0,0,0,0,0,0,0,0,0,0,0,0
20200316,053820,大立光群益96購05,0.03,0.03,0.03,0.03,0.00,0.00,10000,1,300,0,0,0,0,0,0,0,0,0,0
20200316,053821,群創群益98購08,,,,,0.00,0.00,0,0,0,0,0,0,0,0,0,0,0,0,0
20200316,053822,正文群益97購01,0.07,0.07,0.07,0.07,-0.03,-30.0,10000,1,700,0,0,0,0,0,0,0,10000,-10000,-10000
20200316,053823,茂林群益96購06,0.64,0.64,0.43,0.43,-0.02,-4.44,16000,4,9400,0,0,0,0,0,0,0,16000,-16000,-16000
20200316,053824,樺漢群益96購02,,,,,0.00,0.00,0,0,0,0,0,0,0,0,0,0,0,0,0
20200316,053825,南電群益96購02,0.67,0.67,0.54,0.54,+0.04,8.0,25000,2,14800,0,0,0,0,0,0,10000,15000,-5000,-5000
20200316,053826,光磊麥證97購01,,,,,0.00,0.00,0,0,0,0,0,0,0,0,0,0,0,0,0
20200316,053827,漢唐麥證9A購01,0.49,0.49,0.38,0.38,-0.05,-11.63,230000,6,104500,112000,20000,92000,0,0,0,112000,20000,92000,92000
20200316,053828,貿聯麥證96購01,,,,,0.00,0.00,0,0,0,0,0,0,0,0,0,0,0,0,0
20200316,053829,力成麥證96購01,,,,,0.00,0.00,0,0,0,0,0,0,0,0,0,0,0,0,0
20200316,05382P,電子類群益95售02,7.00,7.00,6.90,6.90,-0.60,-8.0,20000,2,139000,0,0,0,0,0,0,0,20000,-20000,-20000
20200316,053830,台積電台新96購02,0.06,0.06,0.06,0.06,+0.01,20.0,60000,1,3600,0,0,0,0,0,0,60000,0,60000,60000
20200316,053831,台積電台新97購02,,,,,0.00,0.00,0,0,0,0,0,0,0,0,0,0,0,0,0
20200316,053832,聯發科台新96購01,,,,,0.00,0.00,0,0,0,0,0,0,0,0,0,0,0,0,0
20200316,053833,彩晶台新97購02,,,,,0.00,0.00,0,0,0,0,0,0,0,0,0,0,0,0,0
20200316,053834,卜蜂永豐96購01,,,,,0.00,0.00,0,0,0,0,0,0,0,0,0,0,0,0,0
20200316,053835,南亞科永豐96購02,,,,,0.00,0.00,0,0,0,0,0,0,0,0,0,0,0,0,0
20200316,053836,亞光永豐96購02,,,,,0.00,0.00,0,0,0,0,0,0,0,0,0,0,0,0,0
20200316,053837,貿聯永豐96購02,,,,,0.00,0.00,0,0,0,0,0,0,0,0,0,0,0,0,0
20200316,053838,正文永豐96購02,,,,,0.00,0.00,0,0,0,0,0,0,0,0,0,0,0,0,0
20200316,053839,華通統一96購01,,,,,0.00,0.00,0,0,0,0,0,0,0,0,0,0,0,0,0
20200316,05383P,鴻海富邦95售06,,,,,0.00,0.00,0,0,0,0,0,0,0,0,0,0,0,0,0
20200316,053840,燿華統一96購02,,,,,0.00,0.00,0,0,0,0,0,0,0,0,0,0,0,0,0
20200316,053841,美律統一96購01,,,,,0.00,0.00,0,0,0,0,0,0,0,0,0,0,0,0,0
20200316,053842,聯發科統一96購08,,,,,0.00,0.00,0,0,0,0,0,0,0,0,0,0,0,0,0
20200316,053843,訊芯統一96購01,,,,,0.00,0.00,0,0,0,0,0,0,0,0,0,0,0,0,0
20200316,053844,GIS統一96購01,,,,,0.00,0.00,0,0,0,0,0,0,0,0,0,0,0,0,0
20200316,053845,和大元富96購01,,,,,0.00,0.00,0,0,0,0,0,0,0,0,0,0,0,0,0
20200316,053846,友達元富99購02,,,,,0.00,0.00,0,0,0,0,0,0,0,0,0,0,0,0,0
20200316,053847,美律元富96購02,,,,,0.00,0.00,0,0,0,0,0,0,0,0,0,0,0,0,0
20200316,053848,聯發科元富96購03,,,,,0.00,0.00,0,0,0,0,0,0,0,0,0,0,0,0,0
20200316,053849,聯發科元富96購04,,,,,0.00,0.00,0,0,0,0,0,0,0,0,0,0,0,0,0
20200316,05384P,大立光永豐95售02,,,,,0.00,0.00,0,0,0,0,0,0,0,0,0,0,0,0,0
20200316,053850,嘉澤元富96購03,0.31,0.31,0.18,0.18,-0.05,-21.74,45000,5,12400,0,0,0,0,0,0,10000,35000,-25000,-25000
20200316,053851,鴻海國泰98購03,,,,,0.00,0.00,0,0,0,0,0,0,0,0,0,0,0,0,0
20200316,053852,南亞科國泰98購01,,,,,0.00,0.00,0,0,0,0,0,0,0,0,0,0,0,0,0
20200316,053853,康控國泰97購02,,,,,0.00,0.00,0,0,0,0,0,0,0,0,0,0,0,0,0
20200316,053854,聯茂國泰97購02,,,,,0.00,0.00,0,0,0,0,0,0,0,0,0,0,0,0,0
20200316,053855,康友國泰98購01,0.62,0.62,0.40,0.40,-0.26,-39.39,561000,13,294500,0,0,0,0,0,0,10000,551000,-541000,-541000
20200316,053856,台積電富邦98購01,0.07,0.07,0.06,0.06,0.00,0.00,2092000,51,130970,0,0,0,0,0,0,0,0,0,0
20200316,053857,宏達電富邦97購02,,,,,0.00,0.00,0,0,0,0,0,0,0,0,0,0,0,0,0
20200316,053858,台達電元大96購05,0.15,0.15,0.15,0.15,0.00,0.00,299000,1,44850,0,0,0,0,0,0,299000,0,299000,299000
20200316,053859,台積電元大97購09,0.40,0.40,0.22,0.23,-0.22,-48.89,240000,28,73020,0,0,0,0,0,0,31000,210000,-179000,-179000
20200316,053860,台積電元大98購03,0.42,0.42,0.29,0.29,-0.13,-30.95,445000,65,141910,0,0,0,0,0,0,0,295000,-295000,-295000
20200316,053861,台光電元大98購01,0.60,0.64,0.60,0.64,+0.14,28.0,12000,3,7280,0,0,0,0,0,0,10000,2000,8000,8000
20200316,053862,南亞科元大97購02,,,,,0.00,0.00,0,0,0,0,0,0,0,0,0,0,0,0,0
20200316,053863,聯發科元大96購18,,,,,0.00,0.00,0,0,0,0,0,0,0,0,0,0,0,0,0
20200316,053864,義隆元大96購01,0.49,0.54,0.45,0.47,+0.01,2.17,104000,8,51900,0,0,0,0,0,0,60000,44000,16000,16000
20200316,053865,欣興元大97購02,0.30,0.30,0.20,0.20,-0.03,-13.04,100000,10,24100,0,0,0,0,0,0,0,100000,-100000,-100000
20200316,053866,景碩元大97購02,0.29,0.29,0.22,0.22,0.00,0.00,80000,8,20400,0,0,0,0,0,0,0,80000,-80000,-80000
20200316,053867,創意元大96購04,0.59,0.60,0.55,0.60,0.00,0.00,21000,3,12450,0,0,0,0,0,0,20000,21000,-1000,-1000
20200316,053868,群創元大99購02,0.12,0.12,0.12,0.12,+0.02,20.0,50000,5,6000,0,0,0,0,0,0,0,50000,-50000,-50000
20200316,053869,嘉澤元大96購02,0.21,0.21,0.21,0.21,+0.05,31.25,5000,1,1050,0,0,0,0,0,0,5000,0,5000,5000
20200316,05386P,臺股指永豐95售05,,,,,0.00,0.00,0,0,0,0,0,0,0,0,0,0,0,0,0
20200316,053870,正文元大96購01,,,,,0.00,0.00,0,0,0,0,0,0,0,0,0,0,0,0,0
20200316,053871,臻鼎元大96購03,,,,,0.00,0.00,0,0,0,0,0,0,0,0,0,0,0,0,0
20200316,053872,臻鼎元大96購04,0.05,0.05,0.05,0.05,+0.01,25.0,20000,1,1000,0,0,0,0,0,0,20000,0,20000,20000
20200316,053873,力成元大96購03,,,,,0.00,0.00,0,0,0,0,0,0,0,0,0,0,0,0,0
20200316,053874,台表科元大96購05,,,,,0.00,0.00,0,0,0,0,0,0,0,0,0,0,0,0,0
20200316,053875,GIS元大97購01,0.08,0.08,0.07,0.08,0.00,0.00,150000,15,11200,0,0,0,0,0,0,0,150000,-150000,-150000
20200316,053876,可成永昌98購01,,,,,0.00,0.00,0,0,0,0,0,0,0,0,0,0,0,0,0
20200316,053877,奇力新亞東96購01,,,,,0.00,0.00,0,0,0,0,0,0,0,0,0,0,0,0,0
20200316,053878,台表科亞東96購01,,,,,0.00,0.00,0,0,0,0,0,0,0,0,0,0,0,0,0
20200316,053879,元油反中信98購02,,,,,0.00,0.00,0,0,0,0,0,0,0,0,0,0,0,0,0
20200316,05387P,鴻海元大95售21,5.20,5.20,5.15,5.15,+0.29,5.97,28000,3,145550,0,0,0,0,0,0,28000,0,28000,28000
20200316,053880,智邦中信96購01,0.69,0.69,0.62,0.62,+0.25,67.57,45000,5,30100,0,0,0,0,0,0,30000,15000,15000,15000
20200316,053881,南亞科中信97購01,0.02,0.02,0.02,0.02,-0.02,-50.0,7000,1,140,0,0,0,0,0,0,0,7000,-7000,-7000
20200316,053882,聯發科中信98購02,0.06,0.06,0.06,0.06,0.00,0.00,11000,4,660,0,0,0,0,0,0,0,0,0,0
20200316,053883,大立光中信98購02,0.04,0.04,0.04,0.04,-0.03,-42.86,114000,13,4560,0,0,0,0,0,0,0,114000,-114000,-114000
20200316,053884,緯穎第一96購01,,,,,0.00,0.00,0,0,0,0,0,0,0,0,0,0,0,0,0
20200316,053885,全新兆豐96購01,0.04,0.04,0.03,0.03,-0.02,-40.0,110000,11,4300,0,0,0,0,0,0,0,110000,-110000,-110000
20200316,053886,亞光兆豐96購01,,,,,0.00,0.00,0,0,0,0,0,0,0,0,0,0,0,0,0
20200316,053887,聯茂兆豐97購02,0.70,0.77,0.50,0.51,-0.19,-27.14,491000,18,336750,0,0,0,0,0,0,320000,161000,159000,159000
20200316,053888,和大群益97購01,0.27,0.27,0.23,0.23,-0.06,-20.69,113000,6,27560,0,0,0,0,0,0,33000,80000,-47000,-47000
20200316,053889,致茂群益97購01,0.95,0.95,0.95,0.95,+0.19,25.0,11000,1,10450,0,0,0,0,0,0,11000,0,11000,11000
20200316,05388P,南亞科元大95售04,3.13,3.76,3.13,3.71,+0.79,27.05,19000,6,66250,0,0,0,0,0,0,5000,14000,-9000,-9000
20200316,053890,華新科群益98購01,0.21,0.21,0.21,0.21,-0.03,-12.5,10000,1,2100,0,0,0,0,0,0,0,10000,-10000,-10000
20200316,053891,欣興群益98購01,0.11,0.11,0.05,0.05,-0.04,-44.44,420000,8,43200,0,0,0,0,0,0,350000,70000,280000,280000
20200316,053892,景碩群益96購02,,,,,0.00,0.00,0,0,0,0,0,0,0,0,0,0,0,0,0
20200316,053893,京鼎群益97購02,,,,,0.00,0.00,0,0,0,0,0,0,0,0,0,0,0,0,0
20200316,053894,創意群益96購01,,,,,0.00,0.00,0,0,0,0,0,0,0,0,0,0,0,0,0
20200316,053895,智易群益96購02,,,,,0.00,0.00,0,0,0,0,0,0,0,0,0,0,0,0,0
20200316,053896,麗豐群益97購01,0.39,0.43,0.39,0.43,+0.20,86.96,18000,3,7300,0,0,0,0,0,0,18000,0,18000,18000
20200316,053897,台郡群益96購01,0.05,0.13,0.05,0.13,+0.06,85.71,151000,2,7630,0,0,0,0,0,0,150000,0,150000,150000
20200316,053898,康友群益97購01,0.61,0.61,0.46,0.46,-0.19,-29.23,80000,4,42100,0,0,0,0,0,0,40000,40000,0,0
20200316,053899,矽創群益96購02,,,,,0.00,0.00,0,0,0,0,0,0,0,0,0,0,0,0,0
20200316,053900,T50反1日盛99購01,1.55,1.84,1.55,1.83,+0.33,22.0,161000,14,265970,0,0,0,0,0,0,42000,114000,-72000,-72000
20200316,053901,T50反1凱基99購03,,,,,0.00,0.00,0,0,0,0,0,0,0,0,0,0,0,0,0
20200316,053902,S&P反1凱基97購01,2.00,2.23,2.00,2.23,+0.37,19.89,11000,2,22230,0,0,0,0,0,0,0,11000,-11000,-11000
20200316,053903,燿華凱基97購01,,,,,0.00,0.00,0,0,0,0,0,0,0,0,0,0,0,0,0
20200316,053904,漢唐凱基97購01,0.41,0.45,0.40,0.40,-0.01,-2.44,166000,11,69060,0,0,0,0,0,0,166000,0,166000,166000
20200316,053905,華新科凱基96購10,0.32,0.32,0.32,0.32,+0.11,52.38,30000,1,9600,0,0,0,0,0,0,30000,0,30000,30000
20200316,053906,宏達電凱基96購02,,,,,0.00,0.00,0,0,0,0,0,0,0,0,0,0,0,0,0
20200316,053907,揚明光凱基96購01,,,,,0.00,0.00,0,0,0,0,0,0,0,0,0,0,0,0,0
20200316,053908,貿聯凱基98購01,0.06,0.06,0.06,0.06,0.00,0.00,20000,1,1200,0,0,0,0,0,0,20000,0,20000,20000
20200316,053909,致伸凱基97購01,,,,,0.00,0.00,0,0,0,0,0,0,0,0,0,0,0,0,0
20200316,05390P,康友群益95售04,,,,,0.00,0.00,0,0,0,0,0,0,0,0,0,0,0,0,0
20200316,053910,嘉聯益凱基98購01,,,,,0.00,0.00,0,0,0,0,0,0,0,0,0,0,0,0,0
20200316,053911,臺股指凱基96購31,0.05,0.05,0.05,0.05,0.00,0.00,10000,1,500,0,0,0,0,0,0,0,10000,-10000,-10000
20200316,053912,T50反1國票97購02,,,,,0.00,0.00,0,0,0,0,0,0,0,0,0,0,0,0,0
20200316,053913,華新國票97購01,,,,,0.00,0.00,0,0,0,0,0,0,0,0,0,0,0,0,0
20200316,053914,國巨國票96購08,,,,,0.00,0.00,0,0,0,0,0,0,0,0,0,0,0,0,0
20200316,053915,光罩國票96購02,,,,,0.00,0.00,0,0,0,0,0,0,0,0,0,0,0,0,0
20200316,053916,漢唐國票97購04,1.23,1.23,0.85,0.85,-0.25,-22.73,149000,3,141250,0,0,0,0,0,0,149000,109000,40000,40000
20200316,053917,友達國票97購03,0.07,0.07,0.05,0.06,-0.01,-14.29,220000,4,12590,0,0,0,0,0,0,209000,1000,208000,208000
20200316,053918,美律國票97購01,0.14,0.15,0.14,0.14,0.00,0.00,160000,16,22900,0,0,0,0,0,0,0,160000,-160000,-160000
20200316,053919,可成國票97購02,0.28,0.28,0.28,0.28,+0.09,47.37,77000,2,21560,0,0,0,0,0,0,77000,0,77000,77000
20200316,05391P,鴻海統一95售12,,,,,0.00,0.00,0,0,0,0,0,0,0,0,0,0,0,0,0
20200316,053920,新光金國票98購01,,,,,0.00,0.00,0,0,0,0,0,0,0,0,0,0,0,0,0
20200316,053921,嘉晶國票97購03,1.75,1.81,1.67,1.75,+0.09,5.42,140000,6,243900,0,0,0,0,0,0,140000,0,140000,140000
20200316,053922,亞光國票96購01,,,,,0.00,0.00,0,0,0,0,0,0,0,0,0,0,0,0,0
20200316,053923,亞光國票97購01,,,,,0.00,0.00,0,0,0,0,0,0,0,0,0,0,0,0,0
20200316,053924,京鼎國票97購01,,,,,0.00,0.00,0,0,0,0,0,0,0,0,0,0,0,0,0
20200316,053925,群創國票98購01,0.08,0.08,0.08,0.08,-0.02,-20.0,2000,1,160,0,0,0,0,0,0,0,0,0,0
20200316,053926,晶相光國票97購01,,,,,0.00,0.00,0,0,0,0,0,0,0,0,0,0,0,0,0
20200316,053927,牧德國票97購01,,,,,0.00,0.00,0,0,0,0,0,0,0,0,0,0,0,0,0
20200316,053928,智易國票97購03,,,,,0.00,0.00,0,0,0,0,0,0,0,0,0,0,0,0,0
20200316,053929,正文國票97購01,,,,,0.00,0.00,0,0,0,0,0,0,0,0,0,0,0,0,0
20200316,05392P,鴻海統一95售13,,,,,0.00,0.00,0,0,0,0,0,0,0,0,0,0,0,0,0
20200316,053930,S&P反1統一98購01,,,,,0.00,0.00,0,0,0,0,0,0,0,0,0,0,0,0,0
20200316,053931,楠梓電統一96購01,,,,,0.00,0.00,0,0,0,0,0,0,0,0,0,0,0,0,0
20200316,053932,華新科統一96購03,,,,,0.00,0.00,0,0,0,0,0,0,0,0,0,0,0,0,0
20200316,053933,大立光統一96購06,,,,,0.00,0.00,0,0,0,0,0,0,0,0,0,0,0,0,0
20200316,053934,A50正2元富96購02,0.12,0.13,0.09,0.09,-0.06,-40.0,225000,9,23750,0,0,0,0,0,0,105000,120000,-15000,-15000
20200316,053935,華通元富96購02,,,,,0.00,0.00,0,0,0,0,0,0,0,0,0,0,0,0,0
20200316,053936,旺宏元富96購04,0.06,0.06,0.04,0.04,0.00,0.00,870000,5,46200,0,0,0,0,0,0,0,870000,-870000,-870000
20200316,053937,光磊元富96購01,,,,,0.00,0.00,0,0,0,0,0,0,0,0,0,0,0,0,0
20200316,053938,彩晶元富96購01,0.06,0.06,0.04,0.04,0.00,0.00,72000,8,3520,0,0,0,0,0,0,0,72000,-72000,-72000
20200316,053939,台表科元富96購03,,,,,0.00,0.00,0,0,0,0,0,0,0,0,0,0,0,0,0
20200316,05393P,鴻海統一95售14,,,,,0.00,0.00,0,0,0,0,0,0,0,0,0,0,0,0,0
20200316,053940,康友元富96購01,0.51,0.54,0.51,0.54,-0.01,-1.82,12000,2,6180,0,0,0,0,0,0,10000,2000,8000,8000
20200316,053941,國巨國泰96購05,,,,,0.00,0.00,0,0,0,0,0,0,0,0,0,0,0,0,0
20200316,053942,超眾國泰96購02,,,,,0.00,0.00,0,0,0,0,0,0,0,0,0,0,0,0,0
20200316,053943,元油反富邦97購03,,,,,0.00,0.00,0,0,0,0,0,0,0,0,0,0,0,0,0
20200316,053944,亞泥富邦97購01,0.19,0.19,0.19,0.19,0.00,0.00,1000,1,190,0,0,0,0,0,0,0,0,0,0
20200316,053945,國巨富邦98購02,0.25,0.25,0.19,0.20,-0.05,-20.0,320000,16,65840,0,0,0,0,0,0,8000,0,8000,8000
20200316,053946,全新富邦97購02,,,,,0.00,0.00,0,0,0,0,0,0,0,0,0,0,0,0,0
20200316,053947,義隆富邦97購01,0.32,0.36,0.31,0.31,+0.07,29.17,133000,11,43960,0,0,0,0,0,0,73000,60000,13000,13000
20200316,053948,大立光富邦99購04,0.07,0.07,0.06,0.07,-0.04,-36.36,47000,5,2950,0,0,0,0,0,0,0,0,0,0
20200316,053949,康控富邦9A購01,0.10,0.10,0.09,0.10,-0.02,-16.67,31000,3,3000,0,0,0,0,0,0,0,21000,-21000,-21000
20200316,05394P,聯詠中信95售02,,,,,0.00,0.00,0,0,0,0,0,0,0,0,0,0,0,0,0
20200316,053950,緯穎富邦97購02,0.86,0.86,0.86,0.86,+0.51,145.71,10000,1,8600,0,0,0,0,0,0,10000,0,10000,10000
20200316,053951,T50反1台新06購02,1.70,2.00,1.70,2.00,+0.30,17.65,85000,10,164900,0,0,0,0,0,0,65000,0,65000,65000
20200316,053952,南亞科台新96購01,,,,,0.00,0.00,0,0,0,0,0,0,0,0,0,0,0,0,0
20200316,053953,群創台新97購01,,,,,0.00,0.00,0,0,0,0,0,0,0,0,0,0,0,0,0
20200316,053954,貿聯康和96購01,,,,,0.00,0.00,0,0,0,0,0,0,0,0,0,0,0,0,0
20200316,053955,華通永豐96購04,,,,,0.00,0.00,0,0,0,0,0,0,0,0,0,0,0,0,0
20200316,053956,旺宏永豐96購04,,,,,0.00,0.00,0,0,0,0,0,0,0,0,0,0,0,0,0
20200316,053957,瑞昱永豐96購01,0.10,0.10,0.10,0.10,0.00,0.00,90000,7,9000,0,0,0,0,0,0,0,90000,-90000,-90000
20200316,053958,京元電永豐96購01,,,,,0.00,0.00,0,0,0,0,0,0,0,0,0,0,0,0,0
20200316,053959,晶豪科永豐96購02,0.10,0.10,0.10,0.10,+0.02,25.0,50000,1,5000,0,0,0,0,0,0,50000,0,50000,50000
20200316,05395P,旺宏元大96售06,2.37,2.74,2.33,2.73,-0.06,-2.15,85000,13,209960,0,0,0,0,0,0,43000,85000,-42000,-42000
20200316,053960,晶技永豐96購02,0.37,0.38,0.27,0.28,-0.01,-3.45,405000,43,124970,0,0,0,0,0,0,32000,373000,-341000,-341000
20200316,053961,揚明光永豐96購04,,,,,0.00,0.00,0,0,0,0,0,0,0,0,0,0,0,0,0
20200316,053962,聯茂永豐96購01,0.53,0.54,0.40,0.40,+0.02,5.26,121000,8,55580,0,0,0,0,0,0,0,121000,-121000,-121000
20200316,053963,百和永豐96購01,,,,,0.00,0.00,0,0,0,0,0,0,0,0,0,0,0,0,0
20200316,053964,上銀元大96購05,0.52,0.52,0.21,0.21,-0.23,-52.27,30000,2,12500,0,0,0,0,0,0,30000,10000,20000,20000
20200316,053965,聯電元大98購04,0.16,0.16,0.16,0.16,0.00,0.00,20000,2,3200,0,0,0,0,0,0,0,20000,-20000,-20000
20200316,053966,旺宏元大96購08,0.45,0.47,0.39,0.40,+0.02,5.26,110000,11,45800,0,0,0,0,0,0,40000,70000,-30000,-30000
20200316,053967,華邦電元大96購03,0.05,0.05,0.04,0.04,-0.01,-20.0,922000,8,37080,0,0,0,0,0,0,922000,0,922000,922000
20200316,053968,華邦電元大97購01,,,,,0.00,0.00,0,0,0,0,0,0,0,0,0,0,0,0,0
20200316,053969,瑞昱元大97購01,0.20,0.20,0.15,0.15,-0.11,-42.31,91000,12,16950,0,0,0,0,0,0,4000,87000,-83000,-83000
20200316,05396P,台郡元大95售05,2.17,2.26,2.17,2.26,+0.05,2.26,16000,5,35570,0,0,0,0,0,0,16000,0,16000,16000
20200316,053970,聯發科元大97購08,,,,,0.00,0.00,0,0,0,0,0,0,0,0,0,0,0,0,0
20200316,053971,聯發科元大97購09,0.06,0.06,0.03,0.03,-0.05,-62.5,211000,22,12630,0,0,0,0,0,0,10000,211000,-201000,-201000
20200316,053972,華新科元大96購06,1.57,1.67,1.02,1.02,-0.21,-17.07,81000,9,106010,0,0,0,0,0,0,61000,71000,-10000,-10000
20200316,053973,晶豪科元大96購01,0.49,0.49,0.34,0.34,-0.02,-5.56,26000,4,10570,0,0,0,0,0,0,16000,10000,6000,6000
20200316,053974,大立光元大96購10,0.07,0.08,0.06,0.06,-0.01,-14.29,260000,22,17500,0,0,0,0,0,0,60000,200000,-140000,-140000
20200316,053975,大立光元大98購04,0.30,0.30,0.17,0.17,-0.13,-43.33,28000,5,6180,0,0,0,0,0,0,4000,25000,-21000,-21000
20200316,053976,亞光元大96購02,0.15,0.15,0.06,0.06,-0.03,-33.33,107000,7,13660,0,0,0,0,0,0,100000,7000,93000,93000
20200316,053977,新日興元大96購03,1.21,1.21,0.72,0.72,-0.57,-44.19,1040000,9,1186570,0,0,0,0,0,0,1010000,30000,980000,980000
20200316,053978,創意元大96購05,0.33,0.33,0.25,0.25,-0.09,-26.47,420000,23,110600,0,0,0,0,0,0,210000,220000,-10000,-10000
20200316,053979,健策元大98購01,1.08,1.17,0.81,0.81,-0.26,-24.3,108000,15,113410,0,0,0,0,0,0,59000,43000,16000,16000
20200316,05397P,大立光凱基96售08,0.40,0.72,0.32,0.65,+0.28,75.68,1025000,116,429950,0,0,0,0,0,0,70000,810000,-740000,-740000
20200316,053980,泰鼎元大97購02,,,,,0.00,0.00,0,0,0,0,0,0,0,0,0,0,0,0,0
20200316,053981,康控元大96購05,,,,,0.00,0.00,0,0,0,0,0,0,0,0,0,0,0,0,0
20200316,053982,臻鼎元大96購05,,,,,0.00,0.00,0,0,0,0,0,0,0,0,0,0,0,0,0
20200316,053983,樺漢元大97購02,0.15,0.15,0.15,0.15,-0.09,-37.5,40000,4,6000,0,0,0,0,0,0,0,40000,-40000,-40000
20200316,053984,康友元大96購05,0.88,0.88,0.88,0.88,-0.03,-3.3,10000,1,8800,0,0,0,0,0,0,0,10000,-10000,-10000
20200316,053985,矽創元大96購02,0.32,0.32,0.17,0.19,-0.12,-38.71,294000,27,66870,0,0,0,0,0,0,69000,290000,-221000,-221000
20200316,053986,矽創第一96購01,,,,,0.00,0.00,0,0,0,0,0,0,0,0,0,0,0,0,0
20200316,053987,宏碁亞東96購01,,,,,0.00,0.00,0,0,0,0,0,0,0,0,0,0,0,0,0
20200316,053988,友達亞東96購01,,,,,0.00,0.00,0,0,0,0,0,0,0,0,0,0,0,0,0
20200316,053989,奇力新兆豐97購01,0.35,0.39,0.20,0.22,+0.02,10.0,732000,29,224740,0,0,0,0,0,0,382000,141000,241000,241000
20200316,05398P,康控國票96售03,,,,,0.00,0.00,0,0,0,0,0,0,0,0,0,0,0,0,0
20200316,053990,晶技兆豐96購01,0.94,0.94,0.94,0.94,+0.29,44.62,1000,1,940,0,0,0,0,0,0,1000,0,1000,1000
20200316,053991,鴻海群益96購05,,,,,0.00,0.00,0,0,0,0,0,0,0,0,0,0,0,0,0
20200316,053992,中環群益96購01,0.05,0.05,0.04,0.04,0.00,0.00,69000,3,2960,0,0,0,0,0,0,0,69000,-69000,-69000
20200316,053993,旺宏群益98購02,0.79,0.79,0.55,0.55,-0.01,-1.79,11000,2,6770,0,0,0,0,0,0,3000,8000,-5000,-5000
20200316,053994,微星群益96購01,,,,,0.00,0.00,0,0,0,0,0,0,0,0,0,0,0,0,0
20200316,053995,奇力新群益97購02,0.36,0.36,0.25,0.25,-0.03,-10.71,9000,3,2830,0,0,0,0,0,0,4000,3000,1000,1000
20200316,053996,晶相光群益97購01,0.59,0.60,0.42,0.42,-0.18,-30.0,326000,6,191020,0,0,0,0,0,0,306000,0,306000,306000
20200316,053997,健策群益97購02,,,,,0.00,0.00,0,0,0,0,0,0,0,0,0,0,0,0,0
20200316,053998,泰鼎群益98購01,,,,,0.00,0.00,0,0,0,0,0,0,0,0,0,0,0,0,0
20200316,053999,台表科群益96購06,,,,,0.00,0.00,0,0,0,0,0,0,0,0,0,0,0,0,0
20200316,05399P,GIS國票95售03,,,,,0.00,0.00,0,0,0,0,0,0,0,0,0,0,0,0,0
20200316,054000,訊芯群益96購02,,,,,0.00,0.00,0,0,0,0,0,0,0,0,0,0,0,0,0
20200316,054001,康友群益96購02,0.44,0.44,0.44,0.44,-0.36,-45.0,11000,1,4840,0,0,0,0,0,0,0,11000,-11000,-11000
20200316,054002,GIS群益96購03,,,,,0.00,0.00,0,0,0,0,0,0,0,0,0,0,0,0,0
20200316,054003,鴻海統一96購13,,,,,0.00,0.00,0,0,0,0,0,0,0,0,0,0,0,0,0
20200316,054004,鴻海統一96購14,,,,,0.00,0.00,0,0,0,0,0,0,0,0,0,0,0,0,0
20200316,054005,旺宏統一97購04,,,,,0.00,0.00,0,0,0,0,0,0,0,0,0,0,0,0,0
20200316,054006,智易統一97購01,,,,,0.00,0.00,0,0,0,0,0,0,0,0,0,0,0,0,0
20200316,054007,貿聯統一96購01,,,,,0.00,0.00,0,0,0,0,0,0,0,0,0,0,0,0,0
20200316,054008,大立光元富96購06,,,,,0.00,0.00,0,0,0,0,0,0,0,0,0,0,0,0,0
20200316,054009,欣興元富96購03,0.01,0.01,0.01,0.01,0.00,0.00,410000,1,4100,0,0,0,0,0,0,410000,0,410000,410000
20200316,05400P,台積電永豐95售05,2.18,2.60,2.18,2.60,+0.19,7.88,28000,4,69890,0,0,0,0,0,0,8000,0,8000,8000
20200316,054010,致伸元富96購01,,,,,0.00,0.00,0,0,0,0,0,0,0,0,0,0,0,0,0
20200316,054011,旺宏永豐96購05,0.06,0.06,0.06,0.06,0.00,0.00,50000,1,3000,0,0,0,0,0,0,0,50000,-50000,-50000
20200316,054012,廣達永豐96購01,0.14,0.14,0.14,0.14,0.00,0.00,100000,1,14000,0,0,0,0,0,0,0,100000,-100000,-100000
20200316,054013,聯發科永豐96購02,,,,,0.00,0.00,0,0,0,0,0,0,0,0,0,0,0,0,0
20200316,054014,宏達電永豐96購04,0.06,0.06,0.05,0.05,0.00,0.00,250000,25,13000,0,0,0,0,0,0,0,250000,-250000,-250000
20200316,054015,晶豪科永豐96購03,,,,,0.00,0.00,0,0,0,0,0,0,0,0,0,0,0,0,0
20200316,054016,嘉晶永豐96購04,0.54,0.57,0.52,0.52,+0.01,1.96,150000,8,81150,0,0,0,0,0,0,0,150000,-150000,-150000
20200316,054017,茂林永豐96購02,0.35,0.35,0.24,0.24,-0.08,-25.0,60000,3,18700,0,0,0,0,0,0,20000,40000,-20000,-20000
20200316,054018,華新台新96購01,,,,,0.00,0.00,0,0,0,0,0,0,0,0,0,0,0,0,0
20200316,054019,燿華台新96購01,,,,,0.00,0.00,0,0,0,0,0,0,0,0,0,0,0,0,0
20200316,05401P,聯茂永豐95售03,0.64,0.79,0.63,0.79,+0.05,6.76,188000,8,123920,0,0,0,0,0,0,160000,28000,132000,132000
20200316,054020,技嘉台新97購01,0.53,0.53,0.53,0.53,+0.09,20.45,38000,1,20140,0,0,0,0,0,0,0,38000,-38000,-38000
20200316,054021,義隆台新96購01,0.28,0.28,0.28,0.28,0.00,0.00,30000,1,8400,0,0,0,0,0,0,30000,0,30000,30000
20200316,054022,南亞康和96購01,,,,,0.00,0.00,0,0,0,0,0,0,0,0,0,0,0,0,0
20200316,054023,和大康和96購01,,,,,0.00,0.00,0,0,0,0,0,0,0,0,0,0,0,0,0
20200316,054024,中鋼康和96購01,,,,,0.00,0.00,0,0,0,0,0,0,0,0,0,0,0,0,0
20200316,054025,鴻海凱基96購17,0.27,0.27,0.19,0.19,+0.02,11.76,104000,9,24520,0,0,0,0,0,0,25000,79000,-54000,-54000
20200316,054026,台積電凱基97購08,0.14,0.14,0.13,0.13,-0.02,-13.33,110000,10,15100,0,0,0,0,0,0,0,90000,-90000,-90000
20200316,054027,欣興凱基96購04,,,,,0.00,0.00,0,0,0,0,0,0,0,0,0,0,0,0,0
20200316,054028,臻鼎凱基96購03,0.12,0.16,0.12,0.12,0.00,0.00,340000,34,45600,0,0,0,0,0,0,0,330000,-330000,-330000
20200316,054029,瀚宇博凱基96購02,,,,,0.00,0.00,0,0,0,0,0,0,0,0,0,0,0,0,0
20200316,05402P,台郡永豐95售02,0.85,0.85,0.85,0.85,-0.18,-17.48,15000,1,12750,0,0,0,0,0,0,15000,0,15000,15000
20200316,054030,台苯中信98購01,,,,,0.00,0.00,0,0,0,0,0,0,0,0,0,0,0,0,0
20200316,054031,中鋼中信98購01,0.12,0.12,0.12,0.12,+0.01,9.09,30000,1,3600,0,0,0,0,0,0,0,30000,-30000,-30000
20200316,054032,上銀中信96購01,,,,,0.00,0.00,0,0,0,0,0,0,0,0,0,0,0,0,0
20200316,054033,欣興中信96購02,,,,,0.00,0.00,0,0,0,0,0,0,0,0,0,0,0,0,0
20200316,054034,景碩中信96購01,,,,,0.00,0.00,0,0,0,0,0,0,0,0,0,0,0,0,0
20200316,054035,聯詠麥證96購01,,,,,0.00,0.00,0,0,0,0,0,0,0,0,0,0,0,0,0
20200316,054036,T50反1元大96購08,,,,,0.00,0.00,0,0,0,0,0,0,0,0,0,0,0,0,0
20200316,054037,T50反1元大96購09,2.35,2.35,2.35,2.35,-0.07,-2.89,10000,1,23500,0,0,0,0,0,0,10000,0,10000,10000
20200316,054038,T50反1元大98購04,,,,,0.00,0.00,0,0,0,0,0,0,0,0,0,0,0,0,0
20200316,054039,元油反元大96購08,4.57,4.57,4.36,4.45,+0.74,19.95,85000,11,378500,0,0,0,0,0,0,15000,70000,-55000,-55000
20200316,05403P,台積電富邦95售08,0.89,1.05,0.89,1.05,+0.12,12.9,22000,4,20840,0,0,0,0,0,0,11000,11000,0,0
20200316,054040,中石化元大9C購01,0.16,0.16,0.15,0.15,-0.01,-6.25,101000,2,16150,0,0,0,0,0,0,101000,0,101000,101000
20200316,054041,鴻海元大96購22,0.13,0.13,0.13,0.13,0.00,0.00,15000,2,1950,0,0,0,0,0,0,0,15000,-15000,-15000
20200316,054042,華泰元大96購01,,,,,0.00,0.00,0,0,0,0,0,0,0,0,0,0,0,0,0
20200316,054043,漢唐元大97購01,0.78,0.78,0.74,0.74,+0.09,13.85,210000,2,155800,0,0,0,0,0,0,210000,0,210000,210000
20200316,054044,京元電元大96購03,,,,,0.00,0.00,0,0,0,0,0,0,0,0,0,0,0,0,0
20200316,054045,奇力新元大97購03,,,,,0.00,0.00,0,0,0,0,0,0,0,0,0,0,0,0,0
20200316,054046,義隆元大96購02,0.46,0.50,0.36,0.36,-0.08,-18.18,630000,40,261790,0,0,0,0,0,0,313000,335000,-22000,-22000
20200316,054047,富邦金元大97購01,0.24,0.24,0.18,0.18,-0.05,-21.74,90000,3,20400,0,0,0,0,0,0,70000,20000,50000,50000
20200316,054048,國泰金元大96購04,,,,,0.00,0.00,0,0,0,0,0,0,0,0,0,0,0,0,0
20200316,054049,亞光元大96購03,0.29,0.29,0.18,0.18,-0.07,-28.0,30000,2,6500,0,0,0,0,0,0,20000,10000,10000,10000
20200316,05404P,台積電群益95售06,,,,,0.00,0.00,0,0,0,0,0,0,0,0,0,0,0,0,0
20200316,054050,創意元大96購06,,,,,0.00,0.00,0,0,0,0,0,0,0,0,0,0,0,0,0
20200316,054051,貿聯元大97購03,0.48,0.48,0.31,0.31,-0.15,-32.61,20000,2,7900,0,0,0,0,0,0,10000,10000,0,0
20200316,054052,日月光元大96購06,,,,,0.00,0.00,0,0,0,0,0,0,0,0,0,0,0,0,0
20200316,054053,聯茂元大96購01,1.19,1.30,0.87,0.87,-0.35,-28.69,188000,19,204440,0,0,0,0,0,0,108000,100000,8000,8000
20200316,054054,光磊國票97購02,,,,,0.00,0.00,0,0,0,0,0,0,0,0,0,0,0,0,0
20200316,054055,全新國票99購02,0.15,0.15,0.14,0.14,0.00,0.00,740000,3,110800,0,0,0,0,0,0,740000,0,740000,740000
20200316,054056,華新科國票96購02,0.76,0.97,0.40,0.40,-0.24,-37.5,80000,5,65260,0,0,0,0,0,0,71000,9000,62000,62000
20200316,054057,晶豪科國票97購01,,,,,0.00,0.00,0,0,0,0,0,0,0,0,0,0,0,0,0
20200316,054058,晶豪科國票98購01,,,,,0.00,0.00,0,0,0,0,0,0,0,0,0,0,0,0,0
20200316,054059,欣興國票97購03,0.09,0.09,0.07,0.08,0.00,0.00,30000,3,2400,0,0,0,0,0,0,0,30000,-30000,-30000
20200316,05405P,大立光群益95售04,0.43,0.77,0.43,0.77,-0.07,-8.33,68000,4,40430,0,0,0,0,0,0,20000,48000,-28000,-28000
20200316,054060,晶技國票97購02,0.44,0.44,0.41,0.41,+0.02,5.13,100000,2,43400,0,0,0,0,0,0,100000,0,100000,100000
20200316,054061,晶技國票97購03,0.98,1.17,0.97,1.17,+0.24,25.81,653000,13,688610,0,0,0,0,0,0,634000,0,634000,634000
20200316,054062,TPK國票96購02,,,,,0.00,0.00,0,0,0,0,0,0,0,0,0,0,0,0,0
20200316,054063,聯茂國票97購02,1.92,1.96,1.92,1.96,-0.13,-6.22,68000,2,132080,0,0,0,0,0,0,68000,0,68000,68000
20200316,054064,台郡國票97購04,,,,,0.00,0.00,0,0,0,0,0,0,0,0,0,0,0,0,0
20200316,054065,樺漢國票97購01,,,,,0.00,0.00,0,0,0,0,0,0,0,0,0,0,0,0,0
20200316,054066,緯穎國票97購03,5.20,5.20,4.41,4.41,+1.91,76.4,79000,3,391050,0,0,0,0,0,0,79000,0,79000,79000
20200316,054067,百和國票97購03,0.15,0.15,0.05,0.05,-0.07,-58.33,1958000,82,107200,0,0,0,0,0,0,1808000,130000,1678000,1678000
20200316,054068,華通國泰96購02,,,,,0.00,0.00,0,0,0,0,0,0,0,0,0,0,0,0,0
20200316,054069,亞光國泰98購01,0.27,0.27,0.15,0.15,-0.09,-37.5,110000,7,21900,0,0,0,0,0,0,30000,80000,-50000,-50000
20200316,05406P,台光電凱基95售02,0.56,0.56,0.56,0.56,+0.16,40.0,80000,1,44800,0,0,0,0,0,0,0,80000,-80000,-80000
20200316,054070,創意國泰96購02,0.18,0.19,0.14,0.14,+0.02,16.67,381000,10,68440,0,0,0,0,0,0,80000,301000,-221000,-221000
20200316,054071,泰鼎國泰97購02,,,,,0.00,0.00,0,0,0,0,0,0,0,0,0,0,0,0,0
20200316,054072,台積電富邦98購02,0.22,0.22,0.13,0.16,-0.05,-23.81,2276000,76,363640,0,0,0,0,0,0,0,0,0,0
20200316,054073,群創富邦96購03,0.09,0.09,0.08,0.08,-0.01,-11.11,500000,8,42800,0,0,0,0,0,0,0,200000,-200000,-200000
20200316,054074,健策富邦98購01,0.20,0.20,0.20,0.20,+0.04,25.0,2000,1,400,0,0,0,0,0,0,0,2000,-2000,-2000
20200316,054075,GIS富邦97購02,,,,,0.00,0.00,0,0,0,0,0,0,0,0,0,0,0,0,0
20200316,054076,義隆第一96購01,,,,,0.00,0.00,0,0,0,0,0,0,0,0,0,0,0,0,0
20200316,054077,中石化中信98購01,,,,,0.00,0.00,0,0,0,0,0,0,0,0,0,0,0,0,0
20200316,054078,鴻海中信98購01,,,,,0.00,0.00,0,0,0,0,0,0,0,0,0,0,0,0,0
20200316,054079,鴻海中信98購02,0.13,0.13,0.13,0.13,-0.07,-35.0,30000,2,3900,0,0,0,0,0,0,0,30000,-30000,-30000
20200316,05407P,超眾凱基95售04,,,,,0.00,0.00,0,0,0,0,0,0,0,0,0,0,0,0,0
20200316,054080,微星中信98購01,,,,,0.00,0.00,0,0,0,0,0,0,0,0,0,0,0,0,0
20200316,054081,聯電元富96購01,0.08,0.08,0.07,0.07,-0.01,-12.5,21000,2,1480,0,0,0,0,0,0,21000,0,21000,21000
20200316,054082,楠梓電元富96購01,0.31,0.31,0.24,0.24,+0.02,9.09,36000,6,10740,0,0,0,0,0,0,0,36000,-36000,-36000
20200316,054083,智伸科元富96購01,0.06,0.06,0.06,0.06,-0.01,-14.29,400000,1,24000,0,0,0,0,0,0,400000,0,400000,400000
20200316,054084,旺宏統一97購05,,,,,0.00,0.00,0,0,0,0,0,0,0,0,0,0,0,0,0
20200316,054085,華新科統一96購04,0.15,0.15,0.15,0.15,0.00,0.00,15000,1,2250,0,0,0,0,0,0,15000,0,15000,15000
20200316,054086,日月光亞東98購01,,,,,0.00,0.00,0,0,0,0,0,0,0,0,0,0,0,0,0
20200316,054087,矽創亞東96購01,,,,,0.00,0.00,0,0,0,0,0,0,0,0,0,0,0,0,0
20200316,054088,華新群益98購02,,,,,0.00,0.00,0,0,0,0,0,0,0,0,0,0,0,0,0
20200316,054089,台積電群益96購11,0.11,0.11,0.10,0.10,0.00,0.00,30000,4,3150,0,0,0,0,0,0,30000,0,30000,30000
20200316,05408P,臺股指中信95售13,,,,,0.00,0.00,0,0,0,0,0,0,0,0,0,0,0,0,0
20200316,054090,瑞昱群益97購01,,,,,0.00,0.00,0,0,0,0,0,0,0,0,0,0,0,0,0
20200316,054091,晶豪科群益96購01,,,,,0.00,0.00,0,0,0,0,0,0,0,0,0,0,0,0,0
20200316,054092,大立光群益97購01,0.22,0.22,0.19,0.21,0.00,0.00,230000,23,46700,0,0,0,0,0,0,230000,230000,0,0
20200316,054093,智原群益97購01,,,,,0.00,0.00,0,0,0,0,0,0,0,0,0,0,0,0,0
20200316,054094,創意群益96購02,0.23,0.23,0.23,0.23,0.00,0.00,10000,1,2300,0,0,0,0,0,0,10000,0,10000,10000
20200316,054095,同欣電群益98購03,,,,,0.00,0.00,0,0,0,0,0,0,0,0,0,0,0,0,0
20200316,054096,佳世達國票97購01,0.12,0.12,0.12,0.12,+0.04,50.0,60000,2,7200,0,0,0,0,0,0,50000,10000,40000,40000
20200316,054097,淘帝國票97購01,,,,,0.00,0.00,0,0,0,0,0,0,0,0,0,0,0,0,0
20200316,054098,嘉晶國票97購04,1.57,1.60,1.48,1.50,+0.49,48.51,19000,4,29880,0,0,0,0,0,0,19000,0,19000,19000
20200316,054099,TPK國票98購01,,,,,0.00,0.00,0,0,0,0,0,0,0,0,0,0,0,0,0
20200316,05409P,京元電元富95售05,1.97,2.18,1.79,2.03,+0.10,5.18,82000,36,162760,0,0,0,0,0,0,56000,26000,30000,30000
20200316,054100,致伸國票97購03,0.16,0.16,0.16,0.16,+0.05,45.45,91000,1,14560,0,0,0,0,0,0,91000,0,91000,91000
20200316,054101,茂林國票97購04,0.40,0.40,0.38,0.38,-0.09,-19.15,200000,2,78000,0,0,0,0,0,0,200000,0,200000,200000
20200316,054102,百和國票97購04,0.18,0.18,0.07,0.07,-0.11,-61.11,2750000,67,212290,0,0,0,0,0,0,2600000,145000,2455000,2455000
20200316,054103,T50反1凱基99購04,3.00,3.00,3.00,3.00,0.00,0.00,10000,1,30000,0,0,0,0,0,0,0,10000,-10000,-10000
20200316,054104,T50反1凱基9A購02,,,,,0.00,0.00,0,0,0,0,0,0,0,0,0,0,0,0,0
20200316,054105,元油反凱基9A購01,,,,,0.00,0.00,0,0,0,0,0,0,0,0,0,0,0,0,0
20200316,054106,元油反凱基9C購01,6.25,6.25,6.25,6.25,+0.35,5.93,2000,1,12500,0,0,0,0,0,0,2000,0,2000,2000
20200316,054107,上銀凱基97購01,0.29,0.29,0.16,0.16,-0.16,-50.0,55000,5,14000,0,0,0,0,0,0,0,55000,-55000,-55000
20200316,054108,台積電凱基96購22,,,,,0.00,0.00,0,0,0,0,0,0,0,0,0,0,0,0,0
20200316,054109,南亞科凱基96購05,,,,,0.00,0.00,0,0,0,0,0,0,0,0,0,0,0,0,0
20200316,05410P,聯發科元富95售04,2.73,2.73,2.73,2.73,-0.64,-18.99,50000,1,136500,0,0,0,0,0,0,0,50000,-50000,-50000
20200316,054110,群創凱基98購09,,,,,0.00,0.00,0,0,0,0,0,0,0,0,0,0,0,0,0
20200316,054111,緯穎凱基97購01,2.14,2.14,2.14,2.14,+0.89,71.2,20000,1,42800,0,0,0,0,0,0,20000,0,20000,20000
20200316,054112,台積電麥證96購02,0.05,0.06,0.03,0.04,-0.07,-63.64,1101000,17,43120,931000,0,931000,0,0,0,931000,600000,331000,331000
20200316,054113,奇力新台新97購01,0.36,0.36,0.27,0.27,+0.01,3.85,143000,4,49410,0,0,0,0,0,0,130000,3000,127000,127000
20200316,054114,新光金台新97購01,,,,,0.00,0.00,0,0,0,0,0,0,0,0,0,0,0,0,0
20200316,054115,台塑康和96購01,,,,,0.00,0.00,0,0,0,0,0,0,0,0,0,0,0,0,0
20200316,054116,順德康和96購01,,,,,0.00,0.00,0,0,0,0,0,0,0,0,0,0,0,0,0
20200316,054117,宏全康和96購01,0.16,0.16,0.14,0.14,-0.02,-12.5,700000,3,102000,0,0,0,0,0,0,400000,300000,100000,100000
20200316,054118,國巨永豐96購04,0.10,0.10,0.06,0.06,-0.01,-14.29,30000,4,2350,0,0,0,0,0,0,0,30000,-30000,-30000
20200316,054119,燿華永豐96購05,,,,,0.00,0.00,0,0,0,0,0,0,0,0,0,0,0,0,0
20200316,05411P,台積電國票96售08,1.94,2.53,1.94,2.53,+0.92,57.14,120000,12,262200,0,0,0,0,0,0,0,120000,-120000,-120000
20200316,054120,奇力新永豐96購01,,,,,0.00,0.00,0,0,0,0,0,0,0,0,0,0,0,0,0
20200316,054121,奇鋐永豐96購02,0.21,0.27,0.17,0.17,-0.03,-15.0,60000,5,13800,0,0,0,0,0,0,30000,30000,0,0
20200316,054122,康友永豐96購01,0.08,0.11,0.08,0.08,-0.08,-50.0,106000,8,8960,0,0,0,0,0,0,0,106000,-106000,-106000
20200316,054123,易華電永豐96購03,,,,,0.00,0.00,0,0,0,0,0,0,0,0,0,0,0,0,0
20200316,054124,達方永豐96購02,,,,,0.00,0.00,0,0,0,0,0,0,0,0,0,0,0,0,0
20200316,054125,元油反元大96購09,,,,,0.00,0.00,0,0,0,0,0,0,0,0,0,0,0,0,0
20200316,054126,和大元大96購02,,,,,0.00,0.00,0,0,0,0,0,0,0,0,0,0,0,0,0
20200316,054127,台積電元大96購21,0.36,0.70,0.36,0.70,+0.10,16.67,11000,3,7260,0,0,0,0,0,0,1000,1000,0,0
20200316,054128,台積電元大97購10,0.48,0.50,0.36,0.41,-0.14,-25.45,46000,7,19060,0,0,0,0,0,0,1000,35000,-34000,-34000
20200316,054129,技嘉元大96購02,0.52,0.54,0.43,0.44,+0.04,10.0,169000,9,78110,0,0,0,0,0,0,105000,64000,41000,41000
20200316,05412P,泰碩國票95售02,1.02,1.68,1.00,1.68,+0.31,22.63,108000,10,143310,0,0,0,0,0,0,67000,1000,66000,66000
20200316,054130,漢唐元大97購02,0.52,0.54,0.41,0.41,-0.09,-18.0,60000,7,29400,0,0,0,0,0,0,30000,30000,0,0
20200316,054131,南亞科元大96購04,0.20,0.20,0.10,0.11,-0.08,-42.11,245000,25,35200,0,0,0,0,0,0,10000,235000,-225000,-225000
20200316,054132,聯發科元大97購10,0.12,0.13,0.10,0.10,+0.03,42.86,170000,15,18650,0,0,0,0,0,0,55000,115000,-60000,-60000
20200316,054133,奇力新元大97購04,0.66,0.66,0.43,0.43,0.00,0.00,771000,54,436610,0,0,0,0,0,0,250000,521000,-271000,-271000
20200316,054134,強茂元大96購01,,,,,0.00,0.00,0,0,0,0,0,0,0,0,0,0,0,0,0
20200316,054135,大立光元大97購04,0.71,0.71,0.71,0.71,0.00,0.00,1000,1,710,0,0,0,0,0,0,1000,1000,0,0
20200316,054136,亞光元大96購04,,,,,0.00,0.00,0,0,0,0,0,0,0,0,0,0,0,0,0
20200316,054137,聯詠元大97購02,0.59,0.66,0.47,0.47,-0.17,-26.56,706000,52,415730,0,0,0,0,0,0,338000,358000,-20000,-20000
20200316,054138,晶技元大98購02,0.52,0.62,0.52,0.62,+0.16,34.78,46000,6,26100,0,0,0,0,0,0,46000,0,46000,46000
20200316,054139,揚明光元大96購01,,,,,0.00,0.00,0,0,0,0,0,0,0,0,0,0,0,0,0
20200316,05413P,台郡國票96售02,0.97,1.09,0.97,1.09,-0.01,-0.91,33000,2,35610,0,0,0,0,0,0,33000,0,33000,33000
20200316,054140,智易元大97購03,,,,,0.00,0.00,0,0,0,0,0,0,0,0,0,0,0,0,0
20200316,054141,TPK元大96購02,,,,,0.00,0.00,0,0,0,0,0,0,0,0,0,0,0,0,0
20200316,054142,致伸元大97購01,0.09,0.09,0.09,0.09,+0.02,28.57,51000,6,4590,0,0,0,0,0,0,0,51000,-51000,-51000
20200316,054143,茂林元大96購04,1.35,1.35,0.91,0.91,-0.53,-36.81,120000,8,147150,0,0,0,0,0,0,110000,20000,90000,90000
20200316,054144,康控元大97購02,,,,,0.00,0.00,0,0,0,0,0,0,0,0,0,0,0,0,0
20200316,054145,嘉聯益元大98購01,,,,,0.00,0.00,0,0,0,0,0,0,0,0,0,0,0,0,0
20200316,054146,康友元大96購06,0.43,0.43,0.43,0.43,-0.37,-46.25,10000,1,4300,0,0,0,0,0,0,0,10000,-10000,-10000
20200316,054147,GIS元大96購02,,,,,0.00,0.00,0,0,0,0,0,0,0,0,0,0,0,0,0
20200316,054148,矽創元大96購03,0.38,0.38,0.33,0.33,-0.04,-10.81,60000,4,21560,0,0,0,0,0,0,50000,50000,0,0
20200316,054149,達方元大96購01,0.15,0.16,0.15,0.16,+0.02,14.29,10000,3,1530,0,0,0,0,0,0,10000,0,10000,10000
20200316,05414P,台表科國票96售02,,,,,0.00,0.00,0,0,0,0,0,0,0,0,0,0,0,0,0
20200316,054150,國巨國泰97購05,,,,,0.00,0.00,0,0,0,0,0,0,0,0,0,0,0,0,0
20200316,054151,瑞昱國泰97購01,,,,,0.00,0.00,0,0,0,0,0,0,0,0,0,0,0,0,0
20200316,054152,漢唐國泰98購02,0.42,0.42,0.31,0.31,-0.08,-20.51,701000,16,269340,0,0,0,0,0,0,500000,261000,239000,239000
20200316,054153,宏達電國泰97購01,0.23,0.23,0.23,0.23,+0.03,15.0,4000,1,920,0,0,0,0,0,0,4000,4000,0,0
20200316,054154,智易國泰97購01,,,,,0.00,0.00,0,0,0,0,0,0,0,0,0,0,0,0,0
20200316,054155,美律第一96購01,0.05,0.05,0.05,0.05,0.00,0.00,370000,1,18500,0,0,0,0,0,0,370000,0,370000,370000
20200316,054156,聯電亞東98購01,,,,,0.00,0.00,0,0,0,0,0,0,0,0,0,0,0,0,0
20200316,054157,國巨亞東96購01,,,,,0.00,0.00,0,0,0,0,0,0,0,0,0,0,0,0,0
20200316,054158,國巨日盛99購01,0.41,0.41,0.27,0.27,-0.11,-28.95,83000,6,26590,0,0,0,0,0,0,10000,73000,-63000,-63000
20200316,054159,T50正2凱基99購01,0.25,0.25,0.17,0.17,-0.07,-29.17,297000,20,63910,0,0,0,0,0,0,0,227000,-227000,-227000
20200316,05415P,台積電台新95售04,1.21,1.29,1.21,1.29,0.00,0.00,1568000,13,2006680,0,0,0,0,0,0,1568000,1568000,0,0
20200316,054160,華泰凱基98購01,,,,,0.00,0.00,0,0,0,0,0,0,0,0,0,0,0,0,0
20200316,054161,友訊凱基98購01,0.38,0.38,0.38,0.38,+0.03,8.57,20000,1,7600,0,0,0,0,0,0,20000,0,20000,20000
20200316,054162,光罩凱基98購01,0.27,0.32,0.24,0.24,+0.02,9.09,322000,26,94010,0,0,0,0,0,0,287000,35000,252000,252000
20200316,054163,燿華凱基97購02,,,,,0.00,0.00,0,0,0,0,0,0,0,0,0,0,0,0,0
20200316,054164,強茂凱基98購01,0.40,0.40,0.40,0.40,+0.05,14.29,68000,1,27200,0,0,0,0,0,0,68000,0,68000,68000
20200316,054165,亞光凱基96購02,,,,,0.00,0.00,0,0,0,0,0,0,0,0,0,0,0,0,0
20200316,054166,日電貿凱基98購01,0.36,0.36,0.27,0.27,0.00,0.00,31000,4,10800,0,0,0,0,0,0,0,31000,-31000,-31000
20200316,054167,揚明光凱基98購01,,,,,0.00,0.00,0,0,0,0,0,0,0,0,0,0,0,0,0
20200316,054168,貿聯凱基97購02,,,,,0.00,0.00,0,0,0,0,0,0,0,0,0,0,0,0,0
20200316,054169,上緯控凱基98購01,0.44,0.45,0.35,0.35,-0.09,-20.45,6000,3,2380,0,0,0,0,0,0,0,6000,-6000,-6000
20200316,05416P,喬山永豐95售04,3.53,3.53,3.53,3.53,+0.25,7.62,2000,1,7060,0,0,0,0,0,0,0,2000,-2000,-2000
20200316,054170,泰鼎凱基98購01,1.68,1.68,1.68,1.68,+0.59,54.13,5000,2,8400,0,0,0,0,0,0,5000,0,5000,5000
20200316,054171,台郡凱基97購01,,,,,0.00,0.00,0,0,0,0,0,0,0,0,0,0,0,0,0
20200316,054172,易華電凱基98購01,0.22,0.22,0.12,0.12,-0.07,-36.84,28000,4,4640,0,0,0,0,0,0,10000,18000,-8000,-8000
20200316,054173,奇力新台新97購02,0.11,0.11,0.11,0.11,-0.03,-21.43,50000,1,5500,0,0,0,0,0,0,0,50000,-50000,-50000
20200316,054174,宏達電台新97購01,,,,,0.00,0.00,0,0,0,0,0,0,0,0,0,0,0,0,0
20200316,054175,高鐵台新97購01,,,,,0.00,0.00,0,0,0,0,0,0,0,0,0,0,0,0,0
20200316,054176,亞光台新96購01,,,,,0.00,0.00,0,0,0,0,0,0,0,0,0,0,0,0,0
20200316,054177,牧德台新97購01,0.91,0.91,0.68,0.68,-0.45,-39.82,420000,8,333170,0,0,0,0,0,0,121000,299000,-178000,-178000
20200316,054178,中磊台新97購01,0.35,0.35,0.31,0.31,+0.02,6.9,17000,2,5670,0,0,0,0,0,0,0,17000,-17000,-17000
20200316,054179,上海銀台新97購01,,,,,0.00,0.00,0,0,0,0,0,0,0,0,0,0,0,0,0
20200316,05417P,燿華永豐95售07,,,,,0.00,0.00,0,0,0,0,0,0,0,0,0,0,0,0,0
20200316,054180,亞泥康和96購01,,,,,0.00,0.00,0,0,0,0,0,0,0,0,0,0,0,0,0
20200316,054181,華新康和96購01,,,,,0.00,0.00,0,0,0,0,0,0,0,0,0,0,0,0,0
20200316,054182,台積電康和96購01,,,,,0.00,0.00,0,0,0,0,0,0,0,0,0,0,0,0,0
20200316,054183,亞光康和96購01,,,,,0.00,0.00,0,0,0,0,0,0,0,0,0,0,0,0,0
20200316,054184,A50正2永豐96購01,,,,,0.00,0.00,0,0,0,0,0,0,0,0,0,0,0,0,0
20200316,054185,喬山永豐96購02,,,,,0.00,0.00,0,0,0,0,0,0,0,0,0,0,0,0,0
20200316,054186,高鐵永豐96購01,,,,,0.00,0.00,0,0,0,0,0,0,0,0,0,0,0,0,0
20200316,054187,亞光永豐96購03,,,,,0.00,0.00,0,0,0,0,0,0,0,0,0,0,0,0,0
20200316,054188,欣興永豐96購03,0.21,0.25,0.19,0.19,-0.04,-17.39,83000,8,18160,0,0,0,0,0,0,47000,36000,11000,11000
20200316,054189,貿聯永豐96購03,,,,,0.00,0.00,0,0,0,0,0,0,0,0,0,0,0,0,0
20200316,05418P,瑞昱永豐95售02,,,,,0.00,0.00,0,0,0,0,0,0,0,0,0,0,0,0,0
20200316,054190,矽創永豐96購01,,,,,0.00,0.00,0,0,0,0,0,0,0,0,0,0,0,0,0
20200316,054191,香港2X中信98購01,0.04,0.04,0.04,0.04,0.00,0.00,70000,2,2800,0,0,0,0,0,0,70000,0,70000,70000
20200316,054192,國巨中信98購01,0.19,0.19,0.17,0.17,-0.01,-5.56,310000,9,58200,0,0,0,0,0,0,274000,0,274000,274000
20200316,054193,鴻海麥證96購02,,,,,0.00,0.00,0,0,0,0,0,0,0,0,0,0,0,0,0
20200316,054194,國巨麥證96購02,0.53,0.53,0.26,0.26,-0.13,-33.33,1225000,8,416000,126000,1099000,-973000,0,0,0,1126000,1099000,27000,27000
20200316,054195,亞泥國泰98購01,0.53,0.53,0.48,0.50,-0.11,-18.03,336000,11,167450,0,0,0,0,0,0,117000,219000,-102000,-102000
20200316,054196,台光電國泰97購02,,,,,0.00,0.00,0,0,0,0,0,0,0,0,0,0,0,0,0
20200316,054197,台積電永昌96購07,0.17,0.25,0.16,0.16,-0.09,-36.0,685000,20,134650,0,0,0,0,0,0,102000,112000,-10000,-10000
20200316,054198,台積電永昌96購08,0.04,0.04,0.04,0.04,-0.05,-55.56,20000,1,800,0,0,0,0,0,0,0,0,0,0
20200316,054199,大立光永昌96購07,0.09,0.09,0.09,0.09,+0.05,125.0,100000,1,9000,0,0,0,0,0,0,0,0,0,0
20200316,05419P,矽力永豐95售02,,,,,0.00,0.00,0,0,0,0,0,0,0,0,0,0,0,0,0
20200316,054200,美律富邦97購02,0.09,0.09,0.09,0.09,0.00,0.00,1000,1,90,0,0,0,0,0,0,0,1000,-1000,-1000
20200316,054201,聯詠富邦97購02,0.27,0.30,0.23,0.23,0.00,0.00,575000,22,165790,0,0,0,0,0,0,511000,64000,447000,447000
20200316,054202,樺漢富邦97購01,0.05,0.05,0.05,0.05,0.00,0.00,20000,1,1000,0,0,0,0,0,0,20000,0,20000,20000
20200316,054203,滬深2X國票96購03,,,,,0.00,0.00,0,0,0,0,0,0,0,0,0,0,0,0,0
20200316,054204,元金2X國票9B購02,0.51,0.55,0.51,0.55,-0.33,-37.5,64000,9,34170,0,0,0,0,0,0,0,0,0,0
20200316,054205,華新國票97購02,,,,,0.00,0.00,0,0,0,0,0,0,0,0,0,0,0,0,0
20200316,054206,鴻海國票99購01,0.04,0.07,0.04,0.07,0.00,0.00,101000,3,4070,0,0,0,0,0,0,0,0,0,0
20200316,054207,國巨國票98購01,,,,,0.00,0.00,0,0,0,0,0,0,0,0,0,0,0,0,0
20200316,054208,台積電國票97購07,0.28,0.28,0.22,0.28,-0.14,-33.33,142000,5,37760,0,0,0,0,0,0,0,0,0,0
20200316,054209,台積電國票97購08,0.09,0.09,0.07,0.07,0.00,0.00,399000,3,34010,0,0,0,0,0,0,399000,0,399000,399000
20200316,05420P,大立光國泰97售03,1.63,2.09,1.62,2.04,+0.49,31.61,1247000,36,2344990,0,0,0,0,0,0,1172000,933000,239000,239000
20200316,054210,台光電國票97購03,1.42,1.42,1.42,1.42,+0.36,33.96,78000,2,110760,0,0,0,0,0,0,78000,0,78000,78000
20200316,054211,奇鋐國票97購03,,,,,0.00,0.00,0,0,0,0,0,0,0,0,0,0,0,0,0
20200316,054212,聯詠國票97購03,,,,,0.00,0.00,0,0,0,0,0,0,0,0,0,0,0,0,0
20200316,054213,欣興國票97購04,0.39,0.39,0.33,0.33,-0.02,-5.71,40000,3,14400,0,0,0,0,0,0,20000,20000,0,0
20200316,054214,京鼎國票97購02,,,,,0.00,0.00,0,0,0,0,0,0,0,0,0,0,0,0,0
20200316,054215,創意國票97購02,0.42,0.42,0.42,0.42,0.00,0.00,10000,1,4200,0,0,0,0,0,0,10000,0,10000,10000
20200316,054216,聯茂國票97購03,2.34,2.34,2.34,2.34,-0.28,-10.69,50000,2,117000,0,0,0,0,0,0,50000,0,50000,50000
20200316,054217,台表科國票97購05,,,,,0.00,0.00,0,0,0,0,0,0,0,0,0,0,0,0,0
20200316,054218,S&P反1統一98購02,,,,,0.00,0.00,0,0,0,0,0,0,0,0,0,0,0,0,0
20200316,054219,楠梓電統一97購01,0.36,0.36,0.36,0.36,0.00,0.00,100000,1,36000,0,0,0,0,0,0,100000,0,100000,100000
20200316,05421P,鴻海元大96售12,7.50,8.80,7.50,8.80,+1.95,28.47,714000,83,5667700,0,0,0,0,0,0,242000,532000,-290000,-290000
20200316,054220,國巨統一97購02,0.30,0.30,0.20,0.20,-0.10,-33.33,19000,4,4900,0,0,0,0,0,0,0,0,0,0
20200316,054221,華新科統一96購05,,,,,0.00,0.00,0,0,0,0,0,0,0,0,0,0,0,0,0
20200316,054222,大立光統一98購03,,,,,0.00,0.00,0,0,0,0,0,0,0,0,0,0,0,0,0
20200316,054223,大立光統一98購04,,,,,0.00,0.00,0,0,0,0,0,0,0,0,0,0,0,0,0
20200316,054224,亞光統一98購01,,,,,0.00,0.00,0,0,0,0,0,0,0,0,0,0,0,0,0
20200316,054225,華新元富96購01,,,,,0.00,0.00,0,0,0,0,0,0,0,0,0,0,0,0,0
20200316,054226,燿華元富96購02,,,,,0.00,0.00,0,0,0,0,0,0,0,0,0,0,0,0,0
20200316,054227,宏達電元富96購02,,,,,0.00,0.00,0,0,0,0,0,0,0,0,0,0,0,0,0
20200316,054228,貿聯元富96購03,0.18,0.18,0.13,0.13,-0.02,-13.33,210000,2,37300,0,0,0,0,0,0,210000,0,210000,210000
20200316,054229,超眾元富96購05,0.38,0.39,0.31,0.31,-0.03,-8.82,302000,4,100340,0,0,0,0,0,0,302000,0,302000,302000
20200316,05422P,大立光中信97售02,0.73,0.96,0.73,0.96,+0.21,28.0,119000,14,93410,0,0,0,0,0,0,60000,109000,-49000,-49000
20200316,054230,上銀群益96購03,,,,,0.00,0.00,0,0,0,0,0,0,0,0,0,0,0,0,0
20200316,054231,國巨群益98購03,1.55,1.55,1.32,1.32,-0.21,-13.73,55000,2,84100,0,0,0,0,0,0,55000,0,55000,55000
20200316,054232,台積電群益96購12,0.05,0.05,0.05,0.05,-0.03,-37.5,4000,1,200,0,0,0,0,0,0,4000,0,4000,4000
20200316,054233,聯發科群益96購04,,,,,0.00,0.00,0,0,0,0,0,0,0,0,0,0,0,0,0
20200316,054234,可成群益96購05,0.13,0.13,0.10,0.10,+0.03,42.86,320000,7,37450,5000,0,5000,0,0,0,0,320000,-320000,-315000
20200316,054235,欣興群益96購06,,,,,0.00,0.00,0,0,0,0,0,0,0,0,0,0,0,0,0
20200316,054236,貿聯群益96購01,0.07,0.07,0.05,0.05,-0.03,-37.5,450000,5,28500,0,0,0,0,0,0,0,450000,-450000,-450000
20200316,054237,茂林群益97購01,0.48,0.48,0.48,0.48,0.00,0.00,60000,1,28800,0,0,0,0,0,0,60000,0,60000,60000
20200316,054238,聯茂群益96購04,2.33,2.33,2.33,2.33,-0.16,-6.43,10000,1,23300,0,0,0,0,0,0,10000,0,10000,10000
20200316,054239,台郡群益96購02,,,,,0.00,0.00,0,0,0,0,0,0,0,0,0,0,0,0,0
20200316,05423P,聯電亞東95售02,,,,,0.00,0.00,0,0,0,0,0,0,0,0,0,0,0,0,0
20200316,054240,訊芯群益96購03,,,,,0.00,0.00,0,0,0,0,0,0,0,0,0,0,0,0,0
20200316,054241,深中小元大98購01,1.15,1.15,1.01,1.02,-0.16,-13.56,88000,11,91020,0,0,0,0,0,0,20000,68000,-48000,-48000
20200316,054242,元油反元大98購02,,,,,0.00,0.00,0,0,0,0,0,0,0,0,0,0,0,0,0
20200316,054243,國喬元大96購01,,,,,0.00,0.00,0,0,0,0,0,0,0,0,0,0,0,0,0
20200316,054244,華新元大96購01,,,,,0.00,0.00,0,0,0,0,0,0,0,0,0,0,0,0,0
20200316,054245,鴻海元大96購23,,,,,0.00,0.00,0,0,0,0,0,0,0,0,0,0,0,0,0
20200316,054246,國巨元大96購12,0.78,0.79,0.50,0.50,-0.09,-15.25,71000,9,49700,0,0,0,0,0,0,0,36000,-36000,-36000
20200316,054247,華邦電元大96購04,0.11,0.11,0.01,0.01,-0.02,-66.67,20000,2,1200,0,0,0,0,0,0,10000,10000,0,0
20200316,054248,燿華元大97購02,0.24,0.24,0.18,0.18,-0.04,-18.18,17000,2,3660,0,0,0,0,0,0,0,17000,-17000,-17000
20200316,054249,技嘉元大96購03,,,,,0.00,0.00,0,0,0,0,0,0,0,0,0,0,0,0,0
20200316,05424P,台達電亞東96售02,,,,,0.00,0.00,0,0,0,0,0,0,0,0,0,0,0,0,0
20200316,054250,漢唐元大96購04,,,,,0.00,0.00,0,0,0,0,0,0,0,0,0,0,0,0,0
20200316,054251,聯發科元大96購21,,,,,0.00,0.00,0,0,0,0,0,0,0,0,0,0,0,0,0
20200316,054252,奇力新元大96購04,,,,,0.00,0.00,0,0,0,0,0,0,0,0,0,0,0,0,0
20200316,054253,宏達電元大97購03,0.18,0.18,0.17,0.18,-0.02,-10.0,100000,10,17900,0,0,0,0,0,0,0,100000,-100000,-100000
20200316,054254,晶豪科元大96購02,0.32,0.32,0.31,0.31,-0.04,-11.43,20000,2,6300,0,0,0,0,0,0,10000,10000,0,0
20200316,054255,亞光元大96購05,,,,,0.00,0.00,0,0,0,0,0,0,0,0,0,0,0,0,0
20200316,054256,創意元大96購07,,,,,0.00,0.00,0,0,0,0,0,0,0,0,0,0,0,0,0
20200316,054257,揚明光元大96購02,,,,,0.00,0.00,0,0,0,0,0,0,0,0,0,0,0,0,0
20200316,054258,牧德元大97購01,1.37,1.42,0.94,0.94,-0.19,-16.81,40000,4,48800,0,0,0,0,0,0,10000,30000,-20000,-20000
20200316,054259,健策元大97購03,0.46,0.52,0.36,0.37,-0.08,-17.78,640000,37,286320,0,0,0,0,0,0,330000,310000,20000,20000
20200316,05425P,華邦電亞東96售02,,,,,0.00,0.00,0,0,0,0,0,0,0,0,0,0,0,0,0
20200316,054260,貿聯元大96購03,,,,,0.00,0.00,0,0,0,0,0,0,0,0,0,0,0,0,0
20200316,054261,智伸科元大96購03,,,,,0.00,0.00,0,0,0,0,0,0,0,0,0,0,0,0,0
20200316,054262,瀚宇博元大96購03,0.42,0.42,0.34,0.34,-0.16,-32.0,14000,4,5060,0,0,0,0,0,0,8000,14000,-6000,-6000
20200316,054263,聯茂元大96購02,2.40,2.40,1.77,1.77,+0.38,27.34,31000,4,64400,0,0,0,0,0,0,11000,20000,-9000,-9000
20200316,054264,超眾元大97購02,,,,,0.00,0.00,0,0,0,0,0,0,0,0,0,0,0,0,0
20200316,054265,GIS元大96購03,,,,,0.00,0.00,0,0,0,0,0,0,0,0,0,0,0,0,0
20200316,054266,緯穎元大96購07,3.55,3.84,2.96,2.96,+0.08,2.78,88000,13,318480,0,0,0,0,0,0,86000,24000,62000,62000
20200316,054267,上銀第一96購01,0.12,0.12,0.12,0.12,-0.04,-25.0,3000,1,360,0,0,0,0,0,0,0,3000,-3000,-3000
20200316,054268,健策第一96購01,,,,,0.00,0.00,0,0,0,0,0,0,0,0,0,0,0,0,0
20200316,054269,台光電亞東98購01,,,,,0.00,0.00,0,0,0,0,0,0,0,0,0,0,0,0,0
20200316,05426P,聯發科凱基95售12,,,,,0.00,0.00,0,0,0,0,0,0,0,0,0,0,0,0,0
20200316,054270,寶滬深中信98購01,,,,,0.00,0.00,0,0,0,0,0,0,0,0,0,0,0,0,0
20200316,054271,中石化中信99購01,0.09,0.09,0.09,0.09,+0.01,12.5,1000,1,90,0,0,0,0,0,0,1000,0,1000,1000
20200316,054272,華通中信98購01,0.15,0.15,0.13,0.13,-0.04,-23.53,2000,2,280,0,0,0,0,0,0,0,2000,-2000,-2000
20200316,054273,宏達電中信98購01,,,,,0.00,0.00,0,0,0,0,0,0,0,0,0,0,0,0,0
20200316,054274,智易中信96購02,,,,,0.00,0.00,0,0,0,0,0,0,0,0,0,0,0,0,0
20200316,054275,華通群益97購03,0.05,0.05,0.05,0.05,0.00,0.00,50000,1,2500,0,0,0,0,0,0,50000,0,50000,50000
20200316,054276,國巨群益96購07,,,,,0.00,0.00,0,0,0,0,0,0,0,0,0,0,0,0,0
20200316,054277,亞光群益97購01,0.20,0.20,0.15,0.15,-0.01,-6.25,95000,2,18950,0,0,0,0,0,0,1000,94000,-93000,-93000
20200316,054278,晶技群益97購02,,,,,0.00,0.00,0,0,0,0,0,0,0,0,0,0,0,0,0
20200316,054279,揚明光群益98購01,,,,,0.00,0.00,0,0,0,0,0,0,0,0,0,0,0,0,0
20200316,05427P,聯發科凱基96售07,3.07,3.07,3.07,3.07,+0.31,11.23,25000,1,76750,0,0,0,0,0,0,25000,0,25000,25000
20200316,054280,牧德群益98購01,1.31,1.31,0.98,0.98,-0.53,-35.1,15000,2,16350,0,0,0,0,0,0,15000,0,15000,15000
20200316,054281,世芯群益97購01,0.68,0.68,0.68,0.68,-0.50,-42.37,20000,1,13600,0,0,0,0,0,0,20000,0,20000,20000
20200316,054282,泰鼎群益98購02,0.97,0.97,0.97,0.97,+0.25,34.72,15000,1,14550,0,0,0,0,0,0,15000,0,15000,15000
20200316,054283,元油反元大99購02,,,,,0.00,0.00,0,0,0,0,0,0,0,0,0,0,0,0,0
20200316,054284,和大元大96購03,,,,,0.00,0.00,0,0,0,0,0,0,0,0,0,0,0,0,0
20200316,054285,國巨元大98購02,0.72,0.78,0.64,0.64,-0.07,-9.86,20000,3,14720,0,0,0,0,0,0,15000,5000,10000,10000
20200316,054286,台積電元大96購22,0.06,0.14,0.06,0.14,+0.10,250.0,21000,3,2060,0,0,0,0,0,0,11000,11000,0,0
20200316,054287,台積電元大97購11,,,,,0.00,0.00,0,0,0,0,0,0,0,0,0,0,0,0,0
20200316,054288,華邦電元大96購05,0.11,0.11,0.11,0.11,-0.02,-15.38,10000,1,1100,0,0,0,0,0,0,0,10000,-10000,-10000
20200316,054289,聯發科元大97購11,,,,,0.00,0.00,0,0,0,0,0,0,0,0,0,0,0,0,0
20200316,05428P,滬深2X統一95售01,,,,,0.00,0.00,0,0,0,0,0,0,0,0,0,0,0,0,0
20200316,054290,奇力新元大96購05,0.11,0.11,0.11,0.11,-0.02,-15.38,1000,1,110,0,0,0,0,0,0,0,1000,-1000,-1000
20200316,054291,高鐵元大97購01,0.16,0.17,0.16,0.16,-0.01,-5.88,440000,25,72700,0,0,0,0,0,0,200000,240000,-40000,-40000
20200316,054292,欣興元大96購06,0.30,0.30,0.18,0.18,-0.09,-33.33,45000,6,12570,0,0,0,0,0,0,11000,45000,-34000,-34000
20200316,054293,健策元大98購02,0.71,0.76,0.58,0.58,-0.18,-23.68,172000,5,108860,0,0,0,0,0,0,112000,20000,92000,92000
20200316,054294,世芯元大96購02,0.81,0.81,0.46,0.46,-0.33,-41.77,214000,22,169260,0,0,0,0,0,0,4000,193000,-189000,-189000
20200316,054295,世芯元大96購03,0.69,0.77,0.42,0.42,-0.43,-50.59,699000,44,470780,0,0,0,0,0,0,384000,313000,71000,71000
20200316,054296,世芯元大97購01,0.89,0.99,0.59,0.59,-0.40,-40.4,65000,7,55800,0,0,0,0,0,0,55000,15000,40000,40000
20200316,054297,台郡元大98購01,0.95,0.95,0.66,0.66,-0.37,-35.92,130000,8,94100,0,0,0,0,0,0,60000,70000,-10000,-10000
20200316,054298,台表科元大97購03,0.35,0.35,0.35,0.35,0.00,0.00,10000,1,3500,0,0,0,0,0,0,0,10000,-10000,-10000
20200316,054299,南電元大96購03,1.62,1.64,1.34,1.34,0.00,0.00,40000,6,59140,0,0,0,0,0,0,40000,0,40000,40000
20200316,05429P,鴻海統一95售16,,,,,0.00,0.00,0,0,0,0,0,0,0,0,0,0,0,0,0
20200316,054300,華通凱基96購07,0.31,0.31,0.31,0.31,+0.05,19.23,130000,1,40300,0,0,0,0,0,0,130000,0,130000,130000
20200316,054301,楠梓電凱基98購01,0.52,0.52,0.52,0.52,+0.14,36.84,2000,1,1040,0,0,0,0,0,0,2000,0,2000,2000
20200316,054302,鴻海凱基96購18,,,,,0.00,0.00,0,0,0,0,0,0,0,0,0,0,0,0,0
20200316,054303,國巨凱基96購15,0.29,0.32,0.17,0.17,-0.11,-39.29,371000,19,80780,0,0,0,0,0,0,0,150000,-150000,-150000
20200316,054304,台積電凱基96購23,,,,,0.00,0.00,0,0,0,0,0,0,0,0,0,0,0,0,0
20200316,054305,光磊凱基98購01,0.10,0.10,0.10,0.10,0.00,0.00,10000,1,1000,0,0,0,0,0,0,0,10000,-10000,-10000
20200316,054306,聯發科凱基96購23,,,,,0.00,0.00,0,0,0,0,0,0,0,0,0,0,0,0,0
20200316,054307,高鐵凱基98購01,,,,,0.00,0.00,0,0,0,0,0,0,0,0,0,0,0,0,0
20200316,054308,嘉晶凱基98購01,1.10,1.19,0.88,0.93,-0.07,-7.0,334000,32,358960,0,0,0,0,0,0,169000,70000,99000,99000
20200316,054309,禾伸堂凱基98購01,1.45,1.45,1.45,1.45,0.00,0.00,10000,1,14500,0,0,0,0,0,0,0,10000,-10000,-10000
20200316,05430P,台積電統一95售07,,,,,0.00,0.00,0,0,0,0,0,0,0,0,0,0,0,0,0
20200316,054310,牧德凱基98購01,0.67,0.67,0.48,0.48,-0.18,-27.27,19000,3,9980,0,0,0,0,0,0,0,15000,-15000,-15000
20200316,054311,世芯凱基96購02,0.49,0.52,0.27,0.27,-0.22,-44.9,2097000,31,835130,0,0,0,0,0,0,934000,1103000,-169000,-169000
20200316,054312,TPK凱基98購01,0.17,0.17,0.17,0.17,0.00,0.00,20000,2,3400,0,0,0,0,0,0,0,20000,-20000,-20000
20200316,054313,麗豐凱基96購02,0.11,0.11,0.11,0.11,0.00,0.00,50000,1,5500,0,0,0,0,0,0,0,50000,-50000,-50000
20200316,054314,嘉聯益凱基97購01,,,,,0.00,0.00,0,0,0,0,0,0,0,0,0,0,0,0,0
20200316,054315,訊芯凱基98購01,,,,,0.00,0.00,0,0,0,0,0,0,0,0,0,0,0,0,0
20200316,054316,矽創凱基97購01,0.42,0.44,0.25,0.25,-0.15,-37.5,206000,8,66070,0,0,0,0,0,0,56000,150000,-94000,-94000
20200316,054317,昇陽半凱基98購01,0.24,0.24,0.21,0.21,+0.09,75.0,102000,2,24420,0,0,0,0,0,0,2000,100000,-98000,-98000
20200316,054318,台虹凱基98購01,1.08,1.11,0.89,0.89,-0.15,-14.42,136000,10,141270,0,0,0,0,0,0,26000,121000,-95000,-95000
20200316,054319,世紀鋼凱基96購02,1.78,1.85,1.45,1.51,-0.02,-1.31,767000,53,1283890,0,0,0,0,0,0,380000,461000,-81000,-81000
20200316,05431P,台光電統一97售01,1.17,1.17,1.17,1.17,+0.04,3.54,1000,1,1170,0,0,0,0,0,0,0,0,0,0
20200316,054320,國喬台新96購01,0.09,0.11,0.09,0.11,+0.01,10.0,201000,2,18110,0,0,0,0,0,0,0,201000,-201000,-201000
20200316,054321,上銀台新96購01,,,,,0.00,0.00,0,0,0,0,0,0,0,0,0,0,0,0,0
20200316,054322,國巨台新96購02,,,,,0.00,0.00,0,0,0,0,0,0,0,0,0,0,0,0,0
20200316,054323,旺宏台新96購02,,,,,0.00,0.00,0,0,0,0,0,0,0,0,0,0,0,0,0
20200316,054324,美律台新97購01,,,,,0.00,0.00,0,0,0,0,0,0,0,0,0,0,0,0,0
20200316,054325,奇力新台新97購03,0.14,0.14,0.14,0.14,+0.01,7.69,100000,1,14000,0,0,0,0,0,0,0,100000,-100000,-100000
20200316,054326,宏達電台新97購02,,,,,0.00,0.00,0,0,0,0,0,0,0,0,0,0,0,0,0
20200316,054327,亞光台新96購02,,,,,0.00,0.00,0,0,0,0,0,0,0,0,0,0,0,0,0
20200316,054328,台化康和96購01,,,,,0.00,0.00,0,0,0,0,0,0,0,0,0,0,0,0,0
20200316,054329,華新科永豐96購02,,,,,0.00,0.00,0,0,0,0,0,0,0,0,0,0,0,0,0
20200316,05432P,國巨元富95售07,0.56,0.87,0.56,0.87,+0.23,35.94,48000,2,29980,0,0,0,0,0,0,48000,0,48000,48000
20200316,054330,世芯永豐96購02,,,,,0.00,0.00,0,0,0,0,0,0,0,0,0,0,0,0,0
20200316,054331,世芯永豐96購03,0.39,0.40,0.39,0.40,-0.12,-23.08,52000,4,20780,0,0,0,0,0,0,2000,0,2000,2000
20200316,054332,世芯永豐97購01,0.23,0.23,0.23,0.23,-0.08,-25.81,3000,1,690,0,0,0,0,0,0,3000,0,3000,3000
20200316,054333,茂林永豐96購03,,,,,0.00,0.00,0,0,0,0,0,0,0,0,0,0,0,0,0
20200316,054334,超眾永豐96購04,,,,,0.00,0.00,0,0,0,0,0,0,0,0,0,0,0,0,0
20200316,054335,緯穎永豐96購02,1.06,1.20,1.06,1.07,+0.08,8.08,75000,18,84620,0,0,0,0,0,0,65000,0,65000,65000
20200316,054336,台積電統一96購11,0.17,0.25,0.13,0.13,0.00,0.00,260000,3,35400,0,0,0,0,0,0,250000,10000,240000,240000
20200316,054337,智邦統一96購01,,,,,0.00,0.00,0,0,0,0,0,0,0,0,0,0,0,0,0
20200316,054338,全新統一96購01,0.10,0.10,0.10,0.10,0.00,0.00,2000,1,200,0,0,0,0,0,0,0,2000,-2000,-2000
20200316,054339,聯詠統一96購02,,,,,0.00,0.00,0,0,0,0,0,0,0,0,0,0,0,0,0
20200316,05433P,智原元富95售02,3.74,3.74,3.74,3.74,0.00,0.00,11000,2,41140,0,0,0,0,0,0,10000,1000,9000,9000
20200316,054340,大成鋼元富96購01,0.61,0.64,0.61,0.62,+0.09,16.98,215000,8,135610,0,0,0,0,0,0,20000,195000,-175000,-175000
20200316,054341,燿華元富96購03,,,,,0.00,0.00,0,0,0,0,0,0,0,0,0,0,0,0,0
20200316,054342,亞光元富99購01,,,,,0.00,0.00,0,0,0,0,0,0,0,0,0,0,0,0,0
20200316,054343,世紀鋼元富96購02,2.10,2.23,1.88,2.14,+0.30,16.3,351000,20,732350,0,0,0,0,0,0,343000,8000,335000,335000
20200316,054344,景碩國票97購04,0.10,0.10,0.05,0.05,-0.02,-28.57,910000,14,80300,0,0,0,0,0,0,820000,90000,730000,730000
20200316,054345,世芯國票96購02,0.51,0.51,0.38,0.38,-0.15,-28.3,238000,4,115120,0,0,0,0,0,0,238000,0,238000,238000
20200316,054346,世芯國票97購01,0.84,0.84,0.84,0.84,0.00,0.00,10000,1,8400,0,0,0,0,0,0,10000,0,10000,10000
20200316,054347,上緯控國票96購02,0.23,0.23,0.19,0.19,-0.04,-17.39,101000,2,22830,0,0,0,0,0,0,91000,10000,81000,81000
20200316,054348,康控國票97購03,0.05,0.05,0.05,0.05,-0.01,-16.67,50000,1,2500,0,0,0,0,0,0,50000,0,50000,50000
20200316,054349,同欣電國票97購02,0.32,0.32,0.21,0.21,-0.01,-4.55,14000,3,4060,0,0,0,0,0,0,10000,4000,6000,6000
20200316,05434P,世紀鋼元富95售02,0.37,0.46,0.37,0.46,+0.01,2.22,628000,80,256560,0,0,0,0,0,0,64000,558000,-494000,-494000
20200316,054350,美律國泰98購01,0.17,0.17,0.17,0.17,+0.04,30.77,3000,1,510,0,0,0,0,0,0,3000,0,3000,3000
20200316,054351,華新科國泰97購03,0.72,0.72,0.72,0.72,0.00,0.00,4000,1,2880,0,0,0,0,0,0,4000,0,4000,4000
20200316,054352,世芯國泰98購01,,,,,0.00,0.00,0,0,0,0,0,0,0,0,0,0,0,0,0
20200316,054353,世紀鋼國泰98購01,3.05,3.09,2.64,2.70,+0.06,2.27,754000,66,2187680,0,0,0,0,0,0,504000,166000,338000,338000
20200316,054354,技嘉富邦97購01,0.45,0.45,0.45,0.45,0.00,0.00,2000,1,900,0,0,0,0,0,0,0,2000,-2000,-2000
20200316,054355,上海銀富邦98購01,,,,,0.00,0.00,0,0,0,0,0,0,0,0,0,0,0,0,0
20200316,054356,可成兆豐97購01,0.40,0.41,0.40,0.41,+0.14,51.85,72000,4,29040,0,0,0,0,0,0,10000,62000,-52000,-52000
20200316,054357,可成兆豐97購02,0.35,0.35,0.35,0.35,+0.05,16.67,11000,2,3850,0,0,0,0,0,0,0,11000,-11000,-11000
20200316,054358,矽創兆豐96購01,0.41,0.42,0.38,0.38,+0.07,22.58,60000,11,24380,0,0,0,0,0,0,60000,0,60000,60000
20200316,054359,南亞科日盛96購02,,,,,0.00,0.00,0,0,0,0,0,0,0,0,0,0,0,0,0
20200316,05435P,鴻海群益95售12,,,,,0.00,0.00,0,0,0,0,0,0,0,0,0,0,0,0,0
20200316,054360,智邦凱基96購03,,,,,0.00,0.00,0,0,0,0,0,0,0,0,0,0,0,0,0
20200316,054361,技嘉凱基96購01,0.34,0.34,0.27,0.27,-0.07,-20.59,285000,11,84300,0,0,0,0,0,0,100000,185000,-85000,-85000
20200316,054362,亞光凱基96購03,,,,,0.00,0.00,0,0,0,0,0,0,0,0,0,0,0,0,0
20200316,054363,世芯凱基97購01,1.41,1.42,0.90,0.90,-0.68,-43.04,162000,18,204770,0,0,0,0,0,0,62000,113000,-51000,-51000
20200316,054364,智伸科凱基96購01,,,,,0.00,0.00,0,0,0,0,0,0,0,0,0,0,0,0,0
20200316,054365,遠東新中信96購01,,,,,0.00,0.00,0,0,0,0,0,0,0,0,0,0,0,0,0
20200316,054366,和大中信98購01,0.16,0.16,0.15,0.15,0.00,0.00,290000,9,44500,0,0,0,0,0,0,0,290000,-290000,-290000
20200316,054367,鴻海中信98購03,0.05,0.05,0.05,0.05,0.00,0.00,6000,1,300,0,0,0,0,0,0,0,6000,-6000,-6000
20200316,054368,鴻海中信9A購02,0.05,0.05,0.05,0.05,0.00,0.00,20000,2,1000,0,0,0,0,0,0,0,20000,-20000,-20000
20200316,054369,鴻海中信9C購01,0.10,0.10,0.06,0.06,-0.02,-25.0,1645000,39,119160,0,0,0,0,0,0,0,20000,-20000,-20000
20200316,05436P,台積電群益95售07,1.96,2.38,1.96,2.38,+0.49,25.93,18000,5,40560,0,0,0,0,0,0,6000,12000,-6000,-6000
20200316,054370,台積電中信9A購01,0.37,0.37,0.33,0.33,-0.07,-17.5,30000,4,10760,0,0,0,0,0,0,10000,11000,-1000,-1000
20200316,054371,台積電中信9C購01,0.44,0.44,0.32,0.32,-0.06,-15.79,166000,24,56060,0,0,0,0,0,0,10000,60000,-50000,-50000
20200316,054372,南亞科中信96購01,0.02,0.02,0.02,0.02,0.00,0.00,5000,1,100,0,0,0,0,0,0,5000,0,5000,5000
20200316,054373,富邦金中信97購01,,,,,0.00,0.00,0,0,0,0,0,0,0,0,0,0,0,0,0
20200316,054374,信邦中信96購01,,,,,0.00,0.00,0,0,0,0,0,0,0,0,0,0,0,0,0
20200316,054375,貿聯中信99購01,,,,,0.00,0.00,0,0,0,0,0,0,0,0,0,0,0,0,0
20200316,054376,聯茂中信97購01,0.39,0.59,0.36,0.38,-0.20,-34.48,381000,22,180260,0,0,0,0,0,0,68000,313000,-245000,-245000
20200316,054377,臺股指中信99購09,0.13,0.13,0.09,0.11,-0.03,-21.43,5068000,172,537420,0,0,0,0,0,0,0,44000,-44000,-44000
20200316,054378,楠梓電群益98購01,,,,,0.00,0.00,0,0,0,0,0,0,0,0,0,0,0,0,0
20200316,054379,光磊群益98購01,,,,,0.00,0.00,0,0,0,0,0,0,0,0,0,0,0,0,0
20200316,05437P,聯詠永豐95售02,1.38,1.64,1.28,1.64,+0.31,23.31,92000,10,136580,0,0,0,0,0,0,12000,80000,-68000,-68000
20200316,054380,世芯群益97購02,1.30,1.30,1.30,1.30,-0.05,-3.7,3000,1,3900,0,0,0,0,0,0,3000,0,3000,3000
20200316,054381,世芯群益98購01,0.98,1.04,0.89,0.89,-0.02,-2.2,19000,4,18660,0,0,0,0,0,0,14000,5000,9000,9000
20200316,054382,康控群益96購03,,,,,0.00,0.00,0,0,0,0,0,0,0,0,0,0,0,0,0
20200316,054383,傳奇群益97購01,0.23,0.23,0.23,0.23,+0.04,21.05,5000,1,1150,0,0,0,0,0,0,0,5000,-5000,-5000
20200316,054384,瀚宇博群益96購02,,,,,0.00,0.00,0,0,0,0,0,0,0,0,0,0,0,0,0
20200316,054385,矽創群益98購01,0.59,0.62,0.59,0.62,-0.05,-7.46,13000,4,7810,0,0,0,0,0,0,13000,0,13000,13000
20200316,054386,鴻海統一98購03,0.17,0.17,0.15,0.15,-0.07,-31.82,20000,2,3200,0,0,0,0,0,0,0,20000,-20000,-20000
20200316,054387,台積電統一98購02,,,,,0.00,0.00,0,0,0,0,0,0,0,0,0,0,0,0,0
20200316,054388,漢唐統一97購02,,,,,0.00,0.00,0,0,0,0,0,0,0,0,0,0,0,0,0
20200316,054389,為升元富96購02,0.02,0.02,0.01,0.01,-0.03,-75.0,150000,4,2000,0,0,0,0,0,0,100000,0,100000,100000
20200316,05438P,康控永豐95售05,,,,,0.00,0.00,0,0,0,0,0,0,0,0,0,0,0,0,0
20200316,054390,智邦元富96購03,1.48,1.48,1.10,1.10,+0.03,2.8,331000,24,444850,0,0,0,0,0,0,270000,64000,206000,206000
20200316,054391,宏達電元富96購04,0.21,0.21,0.21,0.21,0.00,0.00,9000,1,1890,0,0,0,0,0,0,9000,0,9000,9000
20200316,054392,華通永豐96購05,,,,,0.00,0.00,0,0,0,0,0,0,0,0,0,0,0,0,0
20200316,054393,漢唐永豐96購01,,,,,0.00,0.00,0,0,0,0,0,0,0,0,0,0,0,0,0
20200316,054394,奇力新永豐96購03,0.05,0.05,0.05,0.05,0.00,0.00,10000,1,500,0,0,0,0,0,0,10000,0,10000,10000
20200316,054395,華新科永豐96購03,0.03,0.07,0.03,0.07,-0.01,-12.5,140000,4,5800,0,0,0,0,0,0,0,27000,-27000,-27000
20200316,054396,日電貿永豐96購02,,,,,0.00,0.00,0,0,0,0,0,0,0,0,0,0,0,0,0
20200316,054397,創意永豐96購05,0.04,0.04,0.04,0.04,+0.02,100.0,100000,1,4000,0,0,0,0,0,0,100000,0,100000,100000
20200316,054398,牧德永豐96購03,0.08,0.08,0.08,0.08,-0.08,-50.0,76000,2,6080,0,0,0,0,0,0,0,76000,-76000,-76000
20200316,054399,智易永豐96購03,,,,,0.00,0.00,0,0,0,0,0,0,0,0,0,0,0,0,0
20200316,05439P,聯發科國票95售06,,,,,0.00,0.00,0,0,0,0,0,0,0,0,0,0,0,0,0
20200316,054400,健策永豐96購02,0.45,0.45,0.03,0.03,-0.02,-40.0,6000,2,2280,0,0,0,0,0,0,0,0,0,0
20200316,054401,康普永豐96購01,,,,,0.00,0.00,0,0,0,0,0,0,0,0,0,0,0,0,0
20200316,054402,康控永豐96購03,,,,,0.00,0.00,0,0,0,0,0,0,0,0,0,0,0,0,0
20200316,054403,同欣電永豐96購02,0.07,0.07,0.07,0.07,0.00,0.00,250000,1,17500,0,0,0,0,0,0,250000,0,250000,250000
20200316,054404,新日興康和96購01,,,,,0.00,0.00,0,0,0,0,0,0,0,0,0,0,0,0,0
20200316,054405,樺漢康和96購01,0.68,0.68,0.68,0.68,-0.04,-5.56,32000,1,21760,0,0,0,0,0,0,32000,0,32000,32000
20200316,054406,旺宏國票98購01,0.39,0.39,0.39,0.39,+0.15,62.5,15000,1,5850,0,0,0,0,0,0,15000,0,15000,15000
20200316,054407,美律國票97購02,,,,,0.00,0.00,0,0,0,0,0,0,0,0,0,0,0,0,0
20200316,054408,義隆國票98購01,,,,,0.00,0.00,0,0,0,0,0,0,0,0,0,0,0,0,0
20200316,054409,亞光國票97購02,,,,,0.00,0.00,0,0,0,0,0,0,0,0,0,0,0,0,0
20200316,05440P,緯穎國票96售02,,,,,0.00,0.00,0,0,0,0,0,0,0,0,0,0,0,0,0
20200316,054410,國巨元大96購14,0.58,0.65,0.58,0.59,+0.06,11.32,45000,5,27800,0,0,0,0,0,0,5000,30000,-25000,-25000
20200316,054411,光磊元大97購02,,,,,0.00,0.00,0,0,0,0,0,0,0,0,0,0,0,0,0
20200316,054412,智邦元大96購03,1.86,2.11,1.68,1.68,-0.30,-15.15,118000,28,224890,0,0,0,0,0,0,107000,90000,17000,17000
20200316,054413,台光電元大96購03,0.75,0.79,0.75,0.79,+0.07,9.72,8000,2,6040,0,0,0,0,0,0,8000,1000,7000,7000
20200316,054414,全新元大97購02,,,,,0.00,0.00,0,0,0,0,0,0,0,0,0,0,0,0,0
20200316,054415,奇力新元大96購06,,,,,0.00,0.00,0,0,0,0,0,0,0,0,0,0,0,0,0
20200316,054416,禾伸堂元大97購01,0.85,0.90,0.80,0.80,+0.07,9.59,45000,5,37700,0,0,0,0,0,0,35000,35000,0,0
20200316,054417,牧德元大96購01,0.98,1.02,0.65,0.65,-0.47,-41.96,115000,13,88300,0,0,0,0,0,0,20000,105000,-85000,-85000
20200316,054418,茂林元大97購01,1.27,1.27,0.83,0.83,-0.56,-40.29,21000,3,26030,0,0,0,0,0,0,20000,1000,19000,19000
20200316,054419,嘉聯益元大98購02,0.56,0.56,0.42,0.42,-0.26,-38.24,120000,3,54700,0,0,0,0,0,0,120000,0,120000,120000
20200316,05441P,華通元大95售09,,,,,0.00,0.00,0,0,0,0,0,0,0,0,0,0,0,0,0
20200316,054420,緯穎元大96購08,2.93,3.00,2.40,2.40,-0.14,-5.51,52000,8,152610,0,0,0,0,0,0,52000,49000,3000,3000
20200316,054421,臺股指元大99購03,0.47,0.48,0.38,0.38,-0.14,-26.92,796000,47,349890,0,0,0,0,0,0,441000,355000,86000,86000
20200316,054422,T50反1富邦9A購01,,,,,0.00,0.00,0,0,0,0,0,0,0,0,0,0,0,0,0
20200316,054423,華新富邦96購01,,,,,0.00,0.00,0,0,0,0,0,0,0,0,0,0,0,0,0
20200316,054424,大成鋼富邦97購02,0.17,0.17,0.16,0.16,-0.01,-5.88,180000,3,29400,0,0,0,0,0,0,180000,180000,0,0
20200316,054425,聯發科富邦99購03,0.15,0.16,0.12,0.12,-0.06,-33.33,1011000,26,141700,0,0,0,0,0,0,80000,931000,-851000,-851000
20200316,054426,國泰金富邦97購02,,,,,0.00,0.00,0,0,0,0,0,0,0,0,0,0,0,0,0
20200316,054427,潤泰全富邦97購01,0.58,0.58,0.52,0.56,-0.06,-9.68,270000,17,152500,0,0,0,0,0,0,1000,229000,-228000,-228000
20200316,054428,禾伸堂富邦98購01,0.28,0.28,0.22,0.22,-0.01,-4.35,18000,3,4240,0,0,0,0,0,0,4000,14000,-10000,-10000
20200316,054429,中石化台新97購01,,,,,0.00,0.00,0,0,0,0,0,0,0,0,0,0,0,0,0
20200316,05442P,鴻海元大96售13,6.90,7.60,6.85,7.60,+1.80,31.03,144000,17,1063150,0,0,0,0,0,0,108000,136000,-28000,-28000
20200316,054430,上銀台新96購02,,,,,0.00,0.00,0,0,0,0,0,0,0,0,0,0,0,0,0
20200316,054431,鴻海台新96購03,,,,,0.00,0.00,0,0,0,0,0,0,0,0,0,0,0,0,0
20200316,054432,台積電台新96購05,,,,,0.00,0.00,0,0,0,0,0,0,0,0,0,0,0,0,0
20200316,054433,南亞科台新96購02,,,,,0.00,0.00,0,0,0,0,0,0,0,0,0,0,0,0,0
20200316,054434,友達台新96購03,,,,,0.00,0.00,0,0,0,0,0,0,0,0,0,0,0,0,0
20200316,054435,華新科台新97購02,,,,,0.00,0.00,0,0,0,0,0,0,0,0,0,0,0,0,0
20200316,054436,高鐵台新97購02,0.09,0.09,0.09,0.09,0.00,0.00,100000,1,9000,0,0,0,0,0,0,100000,0,100000,100000
20200316,054437,欣興台新97購02,0.22,0.22,0.11,0.11,-0.04,-26.67,15000,3,2250,0,0,0,0,0,0,0,15000,-15000,-15000
20200316,054438,群創台新96購01,,,,,0.00,0.00,0,0,0,0,0,0,0,0,0,0,0,0,0
20200316,054439,健策台新96購03,0.17,0.17,0.17,0.17,-0.03,-15.0,20000,1,3400,0,0,0,0,0,0,0,20000,-20000,-20000
20200316,05443P,宏達電元大95售05,1.53,2.10,1.53,2.06,+0.46,28.75,142000,20,251050,0,0,0,0,0,0,0,142000,-142000,-142000
20200316,054440,TPK台新98購01,,,,,0.00,0.00,0,0,0,0,0,0,0,0,0,0,0,0,0
20200316,054441,力成台新96購01,,,,,0.00,0.00,0,0,0,0,0,0,0,0,0,0,0,0,0
20200316,054442,啟碁台新96購01,,,,,0.00,0.00,0,0,0,0,0,0,0,0,0,0,0,0,0
20200316,054443,樺漢台新96購02,,,,,0.00,0.00,0,0,0,0,0,0,0,0,0,0,0,0,0
20200316,054444,緯穎台新97購01,2.31,2.37,2.31,2.31,+0.96,71.11,187000,7,436650,0,0,0,0,0,0,164000,23000,141000,141000
20200316,054445,技嘉兆豐96購01,0.90,0.90,0.90,0.90,0.00,0.00,176000,3,158400,0,0,0,0,0,0,176000,0,176000,176000
20200316,054446,美食兆豐97購01,,,,,0.00,0.00,0,0,0,0,0,0,0,0,0,0,0,0,0
20200316,054447,國泰金兆豐96購01,,,,,0.00,0.00,0,0,0,0,0,0,0,0,0,0,0,0,0
20200316,054448,矽力兆豐96購01,2.40,2.40,1.70,1.70,-0.66,-27.97,52000,3,123600,0,0,0,0,0,0,50000,2000,48000,48000
20200316,054449,中環第一96購01,,,,,0.00,0.00,0,0,0,0,0,0,0,0,0,0,0,0,0
20200316,05444P,大立光元大95售10,0.92,1.26,0.92,1.22,+0.25,25.77,611000,61,736800,0,0,0,0,0,0,550000,561000,-11000,-11000
20200316,054450,聯茂第一96購01,,,,,0.00,0.00,0,0,0,0,0,0,0,0,0,0,0,0,0
20200316,054451,上銀亞東98購01,,,,,0.00,0.00,0,0,0,0,0,0,0,0,0,0,0,0,0
20200316,054452,華通亞東96購01,,,,,0.00,0.00,0,0,0,0,0,0,0,0,0,0,0,0,0
20200316,054453,上海銀亞東96購01,,,,,0.00,0.00,0,0,0,0,0,0,0,0,0,0,0,0,0
20200316,054454,滬深2X群益96購04,,,,,0.00,0.00,0,0,0,0,0,0,0,0,0,0,0,0,0
20200316,054455,楠梓電群益98購02,,,,,0.00,0.00,0,0,0,0,0,0,0,0,0,0,0,0,0
20200316,054456,華泰群益99購01,0.11,0.11,0.11,0.11,0.00,0.00,200000,1,22000,0,0,0,0,0,0,0,200000,-200000,-200000
20200316,054457,強茂群益96購01,,,,,0.00,0.00,0,0,0,0,0,0,0,0,0,0,0,0,0
20200316,054458,復盛群益96購01,0.54,0.54,0.52,0.52,-0.18,-25.71,4000,2,2140,0,0,0,0,0,0,4000,0,4000,4000
20200316,054459,鈺齊群益96購01,,,,,0.00,0.00,0,0,0,0,0,0,0,0,0,0,0,0,0
20200316,05445P,聯詠元大95售05,3.81,3.84,3.81,3.84,-0.65,-14.48,15000,2,57300,0,0,0,0,0,0,0,15000,-15000,-15000
20200316,054460,和大凱基97購01,,,,,0.00,0.00,0,0,0,0,0,0,0,0,0,0,0,0,0
20200316,054461,台積電凱基97購09,0.43,0.43,0.37,0.37,-0.73,-66.36,32000,4,12780,0,0,0,0,0,0,0,32000,-32000,-32000
20200316,054462,旺宏凱基96購08,0.18,0.21,0.13,0.13,-0.04,-23.53,300000,30,56200,0,0,0,0,0,0,200000,100000,100000,100000
20200316,054463,瑞昱凱基97購01,,,,,0.00,0.00,0,0,0,0,0,0,0,0,0,0,0,0,0
20200316,054464,奇力新凱基98購02,,,,,0.00,0.00,0,0,0,0,0,0,0,0,0,0,0,0,0
20200316,054465,亞光凱基97購01,0.08,0.10,0.03,0.10,0.00,0.00,70000,4,3300,0,0,0,0,0,0,0,10000,-10000,-10000
20200316,054466,欣興凱基97購03,,,,,0.00,0.00,0,0,0,0,0,0,0,0,0,0,0,0,0
20200316,054467,隆達凱基97購01,0.10,0.10,0.10,0.10,0.00,0.00,10000,1,1000,0,0,0,0,0,0,0,10000,-10000,-10000
20200316,054468,台郡凱基98購01,,,,,0.00,0.00,0,0,0,0,0,0,0,0,0,0,0,0,0
20200316,054469,同欣電凱基97購01,0.06,0.06,0.05,0.06,-0.04,-40.0,27000,3,1550,0,0,0,0,0,0,27000,0,27000,27000
20200316,05446P,緯穎元大95售04,0.31,0.31,0.31,0.31,-0.24,-43.64,10000,1,3100,0,0,0,0,0,0,0,10000,-10000,-10000
20200316,054470,緯穎國票97購04,5.05,5.05,4.11,4.11,-0.14,-3.29,62000,5,305020,0,0,0,0,0,0,62000,0,62000,62000
20200316,054471,T50反1中信9C購01,,,,,0.00,0.00,0,0,0,0,0,0,0,0,0,0,0,0,0
20200316,054472,道瓊反中信9A購01,,,,,0.00,0.00,0,0,0,0,0,0,0,0,0,0,0,0,0
20200316,054473,鴻海中信96購02,,,,,0.00,0.00,0,0,0,0,0,0,0,0,0,0,0,0,0
20200316,054474,鴻海中信96購03,,,,,0.00,0.00,0,0,0,0,0,0,0,0,0,0,0,0,0
20200316,054475,鴻海中信96購04,,,,,0.00,0.00,0,0,0,0,0,0,0,0,0,0,0,0,0
20200316,054476,聯發科中信96購03,,,,,0.00,0.00,0,0,0,0,0,0,0,0,0,0,0,0,0
20200316,054477,聯發科中信9C購02,0.12,0.12,0.08,0.08,-0.05,-38.46,276000,23,29080,0,0,0,0,0,0,0,82000,-82000,-82000
20200316,054478,可成中信97購01,0.06,0.06,0.06,0.06,0.00,0.00,2000,1,120,0,0,0,0,0,0,0,2000,-2000,-2000
20200316,054479,緯創中信98購01,,,,,0.00,0.00,0,0,0,0,0,0,0,0,0,0,0,0,0
20200316,05447P,臺股指元大95售24,6.50,6.50,6.50,6.50,+0.10,1.56,5000,1,32500,0,0,0,0,0,0,0,5000,-5000,-5000
20200316,054480,和碩中信98購01,0.06,0.06,0.06,0.06,-0.04,-40.0,25000,1,1500,0,0,0,0,0,0,25000,0,25000,25000
20200316,054481,鎧勝中信96購01,0.11,0.11,0.11,0.11,0.00,0.00,30000,3,3300,0,0,0,0,0,0,0,30000,-30000,-30000
20200316,054482,大成鋼台新96購01,,,,,0.00,0.00,0,0,0,0,0,0,0,0,0,0,0,0,0
20200316,054483,聯電台新96購01,,,,,0.00,0.00,0,0,0,0,0,0,0,0,0,0,0,0,0
20200316,054484,仁寶台新96購01,0.30,0.30,0.30,0.30,0.00,0.00,499000,50,149700,0,0,0,0,0,0,0,499000,-499000,-499000
20200316,054485,華邦電台新96購01,,,,,0.00,0.00,0,0,0,0,0,0,0,0,0,0,0,0,0
20200316,054486,漢唐台新96購01,,,,,0.00,0.00,0,0,0,0,0,0,0,0,0,0,0,0,0
20200316,054487,京元電台新97購01,,,,,0.00,0.00,0,0,0,0,0,0,0,0,0,0,0,0,0
20200316,054488,禾伸堂台新96購01,,,,,0.00,0.00,0,0,0,0,0,0,0,0,0,0,0,0,0
20200316,054489,牧德台新97購02,0.43,0.44,0.32,0.32,-0.22,-40.74,681000,7,260140,0,0,0,0,0,0,221000,460000,-239000,-239000
20200316,05448P,臺股指元大95售25,,,,,0.00,0.00,0,0,0,0,0,0,0,0,0,0,0,0,0
20200316,054490,臻鼎台新96購02,,,,,0.00,0.00,0,0,0,0,0,0,0,0,0,0,0,0,0
20200316,054491,瀚宇博台新96購02,,,,,0.00,0.00,0,0,0,0,0,0,0,0,0,0,0,0,0
20200316,054492,嘉聯益台新96購01,,,,,0.00,0.00,0,0,0,0,0,0,0,0,0,0,0,0,0
20200316,054493,同欣電台新96購01,,,,,0.00,0.00,0,0,0,0,0,0,0,0,0,0,0,0,0
20200316,054494,訊芯台新96購01,,,,,0.00,0.00,0,0,0,0,0,0,0,0,0,0,0,0,0
20200316,054495,滬深2X永豐97購02,,,,,0.00,0.00,0,0,0,0,0,0,0,0,0,0,0,0,0
20200316,054496,為升永豐96購01,,,,,0.00,0.00,0,0,0,0,0,0,0,0,0,0,0,0,0
20200316,054497,國巨永豐96購05,0.07,0.08,0.03,0.03,-0.06,-66.67,213000,12,13130,0,0,0,0,0,0,0,149000,-149000,-149000
20200316,054498,燿華永豐96購06,,,,,0.00,0.00,0,0,0,0,0,0,0,0,0,0,0,0,0
20200316,054499,台光電永豐96購02,,,,,0.00,0.00,0,0,0,0,0,0,0,0,0,0,0,0,0
20200316,05449P,臺股指元大95售26,,,,,0.00,0.00,0,0,0,0,0,0,0,0,0,0,0,0,0
20200316,054500,美律永豐96購02,,,,,0.00,0.00,0,0,0,0,0,0,0,0,0,0,0,0,0
20200316,054501,強茂永豐96購02,,,,,0.00,0.00,0,0,0,0,0,0,0,0,0,0,0,0,0
20200316,054502,泰碩永豐96購01,,,,,0.00,0.00,0,0,0,0,0,0,0,0,0,0,0,0,0
20200316,054503,京鼎永豐96購04,,,,,0.00,0.00,0,0,0,0,0,0,0,0,0,0,0,0,0
20200316,054504,聯鈞永豐96購01,0.82,0.82,0.77,0.77,+0.16,26.23,12000,2,9340,0,0,0,0,0,0,2000,10000,-8000,-8000
20200316,054505,揚明光永豐97購02,,,,,0.00,0.00,0,0,0,0,0,0,0,0,0,0,0,0,0
20200316,054506,矽格永豐96購01,0.26,0.26,0.20,0.21,-0.01,-4.55,279000,6,64540,0,0,0,0,0,0,129000,150000,-21000,-21000
20200316,054507,鈺齊永豐96購01,,,,,0.00,0.00,0,0,0,0,0,0,0,0,0,0,0,0,0
20200316,054508,臺股指永豐96購04,,,,,0.00,0.00,0,0,0,0,0,0,0,0,0,0,0,0,0
20200316,054509,上証反元大99購01,0.82,0.82,0.82,0.82,+0.11,15.49,20000,1,16400,0,0,0,0,0,0,0,0,0,0
20200316,05450P,臺股指元大95售27,,,,,0.00,0.00,0,0,0,0,0,0,0,0,0,0,0,0,0
20200316,054510,S&P反1元大98購01,3.00,3.17,3.00,3.14,+0.28,9.79,60000,15,188030,0,0,0,0,0,0,0,60000,-60000,-60000
20200316,054511,香港反元大98購01,,,,,0.00,0.00,0,0,0,0,0,0,0,0,0,0,0,0,0
20200316,054512,元油反元大99購03,,,,,0.00,0.00,0,0,0,0,0,0,0,0,0,0,0,0,0
20200316,054513,元金2X元大96購01,1.49,1.49,1.49,1.49,-0.11,-6.87,1000,1,1490,0,0,0,0,0,0,0,1000,-1000,-1000
20200316,054514,道瓊銀元大98購01,,,,,0.00,0.00,0,0,0,0,0,0,0,0,0,0,0,0,0
20200316,054515,華通元大98購02,0.47,0.47,0.26,0.26,-0.10,-27.78,72000,6,27520,0,0,0,0,0,0,30000,42000,-12000,-12000
20200316,054516,國巨元大97購02,0.35,0.48,0.35,0.48,+0.18,60.0,33000,4,15250,0,0,0,0,0,0,3000,20000,-17000,-17000
20200316,054517,高鐵元大96購01,,,,,0.00,0.00,0,0,0,0,0,0,0,0,0,0,0,0,0
20200316,054518,亞光元大97購01,0.07,0.07,0.03,0.03,-0.01,-25.0,130000,8,5900,0,0,0,0,0,0,0,70000,-70000,-70000
20200316,054519,禾伸堂元大97購02,0.58,0.61,0.47,0.48,-0.07,-12.73,136000,8,75370,0,0,0,0,0,0,103000,43000,60000,60000
20200316,05451P,臺股指元大95售28,,,,,0.00,0.00,0,0,0,0,0,0,0,0,0,0,0,0,0
20200316,054520,健鼎元大96購02,,,,,0.00,0.00,0,0,0,0,0,0,0,0,0,0,0,0,0
20200316,054521,TPK元大96購03,,,,,0.00,0.00,0,0,0,0,0,0,0,0,0,0,0,0,0
20200316,054522,康友元大96購07,0.94,0.95,0.91,0.91,-0.07,-7.14,17000,3,15960,0,0,0,0,0,0,3000,14000,-11000,-11000
20200316,054523,GIS元大96購05,,,,,0.00,0.00,0,0,0,0,0,0,0,0,0,0,0,0,0
20200316,054524,華通元富96購03,,,,,0.00,0.00,0,0,0,0,0,0,0,0,0,0,0,0,0
20200316,054525,奇鋐元富96購01,,,,,0.00,0.00,0,0,0,0,0,0,0,0,0,0,0,0,0
20200316,054526,道瓊反統一98購01,,,,,0.00,0.00,0,0,0,0,0,0,0,0,0,0,0,0,0
20200316,054527,國巨統一97購03,,,,,0.00,0.00,0,0,0,0,0,0,0,0,0,0,0,0,0
20200316,054528,台光電統一96購02,,,,,0.00,0.00,0,0,0,0,0,0,0,0,0,0,0,0,0
20200316,054529,T50反1國泰97購02,,,,,0.00,0.00,0,0,0,0,0,0,0,0,0,0,0,0,0
20200316,05452P,亞德客群益95售02,1.76,2.15,1.76,2.15,-0.35,-14.0,20000,2,39100,0,0,0,0,0,0,10000,0,10000,10000
20200316,054530,台光電國泰97購03,,,,,0.00,0.00,0,0,0,0,0,0,0,0,0,0,0,0,0
20200316,054531,聯發科國泰97購02,,,,,0.00,0.00,0,0,0,0,0,0,0,0,0,0,0,0,0
20200316,054532,強茂國泰98購01,0.25,0.27,0.15,0.15,-0.08,-34.78,1837000,29,366070,0,0,0,0,0,0,1000,1836000,-1835000,-1835000
20200316,054533,泰碩國泰98購01,,,,,0.00,0.00,0,0,0,0,0,0,0,0,0,0,0,0,0
20200316,054534,台積電富邦98購03,0.08,0.13,0.08,0.08,-0.03,-27.27,479000,17,51320,0,0,0,0,0,0,0,22000,-22000,-22000
20200316,054535,旺宏富邦97購02,0.35,0.35,0.22,0.22,-0.01,-4.35,57000,2,19040,0,0,0,0,0,0,7000,50000,-43000,-43000
20200316,054536,宏達電富邦97購03,,,,,0.00,0.00,0,0,0,0,0,0,0,0,0,0,0,0,0
20200316,054537,南亞科亞東97購01,,,,,0.00,0.00,0,0,0,0,0,0,0,0,0,0,0,0,0
20200316,054538,台光電國票98購01,,,,,0.00,0.00,0,0,0,0,0,0,0,0,0,0,0,0,0
20200316,054539,欣興國票98購01,0.07,0.08,0.05,0.05,-0.02,-28.57,874000,14,57400,0,0,0,0,0,0,350000,0,350000,350000
20200316,05453P,智邦群益95售03,,,,,0.00,0.00,0,0,0,0,0,0,0,0,0,0,0,0,0
20200316,054540,泰鼎國票99購01,0.75,0.75,0.75,0.75,+0.18,31.58,100000,1,75000,0,0,0,0,0,0,100000,0,100000,100000
20200316,054541,康控國票98購01,,,,,0.00,0.00,0,0,0,0,0,0,0,0,0,0,0,0,0
20200316,054542,台表科國票98購01,0.11,0.11,0.08,0.08,0.00,0.00,390000,6,39700,0,0,0,0,0,0,290000,0,290000,290000
20200316,054543,元金2X中信01購01,0.74,0.78,0.67,0.78,-0.10,-11.36,19000,3,12910,0,0,0,0,0,0,1000,18000,-17000,-17000
20200316,054544,統一中信97購01,0.11,0.11,0.09,0.09,-0.01,-10.0,221000,9,22330,0,0,0,0,0,0,121000,100000,21000,21000
20200316,054545,奇力新中信98購01,,,,,0.00,0.00,0,0,0,0,0,0,0,0,0,0,0,0,0
20200316,054546,玉晶光中信9B購01,0.17,0.18,0.11,0.12,-0.06,-33.33,691000,35,105750,0,0,0,0,0,0,247000,274000,-27000,-27000
20200316,054547,鴻海凱基98購02,,,,,0.00,0.00,0,0,0,0,0,0,0,0,0,0,0,0,0
20200316,054548,鴻海凱基98購03,0.15,0.15,0.08,0.10,-0.01,-9.09,381000,13,45490,0,0,0,0,0,0,298000,60000,238000,238000
20200316,054549,台積電凱基98購01,0.11,0.11,0.11,0.11,-0.17,-60.71,20000,1,2200,0,0,0,0,0,0,20000,0,20000,20000
20200316,05454P,奇鋐群益95售04,2.37,2.66,2.37,2.66,+0.24,9.92,4000,4,9950,0,0,0,0,0,0,3000,1000,2000,2000
20200316,054550,旺宏凱基98購02,0.28,0.28,0.28,0.28,-0.01,-3.45,200000,1,56000,0,0,0,0,0,0,200000,0,200000,200000
20200316,054551,聯發科凱基98購02,0.14,0.14,0.14,0.14,-0.05,-26.32,2000,1,280,0,0,0,0,0,0,0,2000,-2000,-2000
20200316,054552,聯發科凱基98購03,,,,,0.00,0.00,0,0,0,0,0,0,0,0,0,0,0,0,0
20200316,054553,宏達電凱基99購01,0.12,0.12,0.10,0.10,-0.09,-47.37,410000,43,46350,0,0,0,0,0,0,0,410000,-410000,-410000
20200316,054554,大立光凱基98購02,0.74,0.74,0.61,0.65,0.00,0.00,85000,7,56230,0,0,0,0,0,0,0,85000,-85000,-85000
20200316,054555,欣興凱基98購01,,,,,0.00,0.00,0,0,0,0,0,0,0,0,0,0,0,0,0
20200316,054556,世芯凱基99購01,0.20,0.20,0.11,0.11,-0.09,-45.0,589000,56,92580,0,0,0,0,0,0,279000,289000,-10000,-10000
20200316,054557,臻鼎凱基98購01,,,,,0.00,0.00,0,0,0,0,0,0,0,0,0,0,0,0,0
20200316,054558,劍麟群益99購01,,,,,0.00,0.00,0,0,0,0,0,0,0,0,0,0,0,0,0
20200316,054559,台光電群益99購01,0.34,0.34,0.31,0.31,+0.06,24.0,20000,2,6500,0,0,0,0,0,0,10000,10000,0,0
20200316,05455P,聯詠日盛95售01,1.42,1.42,1.42,1.42,-0.27,-15.98,42000,2,59640,0,0,0,0,0,0,42000,0,42000,42000
20200316,054560,全新群益98購03,,,,,0.00,0.00,0,0,0,0,0,0,0,0,0,0,0,0,0
20200316,054561,奇力新群益97購03,,,,,0.00,0.00,0,0,0,0,0,0,0,0,0,0,0,0,0
20200316,054562,亞光群益98購01,,,,,0.00,0.00,0,0,0,0,0,0,0,0,0,0,0,0,0
20200316,054563,泰碩群益99購01,1.00,1.00,0.58,0.58,-0.32,-35.56,323000,12,278640,0,0,0,0,0,0,190000,133000,57000,57000
20200316,054564,玉晶光群益99購01,0.62,0.62,0.41,0.41,-0.23,-35.94,78000,8,35110,0,0,0,0,0,0,18000,60000,-42000,-42000
20200316,054565,玉晶光群益99購02,0.88,0.88,0.48,0.48,-0.38,-44.19,42000,12,23800,0,0,0,0,0,0,1000,42000,-41000,-41000
20200316,054566,貿聯群益97購02,,,,,0.00,0.00,0,0,0,0,0,0,0,0,0,0,0,0,0
20200316,054567,拓凱群益98購01,0.31,0.31,0.31,0.31,+0.01,3.33,200000,2,62000,0,0,0,0,0,0,200000,0,200000,200000
20200316,054568,訊芯群益97購01,0.05,0.05,0.04,0.04,0.00,0.00,58000,5,2800,0,0,0,0,0,0,58000,0,58000,58000
20200316,054569,GIS群益98購01,,,,,0.00,0.00,0,0,0,0,0,0,0,0,0,0,0,0,0
20200316,05456P,鴻海凱基95售19,2.60,3.29,2.60,3.25,+0.43,15.25,67000,8,213080,0,0,0,0,0,0,60000,67000,-7000,-7000
20200316,054570,易華電群益98購01,,,,,0.00,0.00,0,0,0,0,0,0,0,0,0,0,0,0,0
20200316,054571,楠梓電元大99購01,0.60,0.60,0.54,0.54,+0.06,12.5,5000,2,2940,0,0,0,0,0,0,0,5000,-5000,-5000
20200316,054572,國巨元大98購03,0.52,0.52,0.42,0.42,-0.04,-8.7,60000,10,27820,0,0,0,0,0,0,10000,42000,-32000,-32000
20200316,054573,漢唐元大98購01,0.33,0.34,0.26,0.26,+0.01,4.0,235000,5,76850,0,0,0,0,0,0,205000,30000,175000,175000
20200316,054574,美律元大99購01,0.20,0.20,0.17,0.18,0.00,0.00,40000,3,7650,0,0,0,0,0,0,25000,15000,10000,10000
20200316,054575,聯鈞元大97購01,1.56,1.75,1.20,1.20,-0.39,-24.53,105000,7,165050,0,0,0,0,0,0,100000,25000,75000,75000
20200316,054576,健策元大98購03,0.21,0.21,0.20,0.20,-0.02,-9.09,59000,6,11890,0,0,0,0,0,0,0,59000,-59000,-59000
20200316,054577,世芯元大98購01,0.44,0.44,0.44,0.44,+0.10,29.41,1000,1,440,0,0,0,0,0,0,1000,0,1000,1000
20200316,054578,世芯元大99購01,0.54,0.54,0.38,0.38,-0.21,-35.59,94000,8,46660,0,0,0,0,0,0,60000,34000,26000,26000
20200316,054579,聯茂元大97購01,,,,,0.00,0.00,0,0,0,0,0,0,0,0,0,0,0,0,0
20200316,05457P,鴻海凱基95售20,3.84,4.27,3.84,4.25,+0.97,29.57,62000,6,253480,0,0,0,0,0,0,26000,62000,-36000,-36000
20200316,054580,樺漢元大98購01,0.08,0.08,0.06,0.06,-0.03,-33.33,60000,6,4400,0,0,0,0,0,0,0,60000,-60000,-60000
20200316,054581,訊芯元大97購02,0.15,0.16,0.15,0.16,0.00,0.00,20000,2,3100,0,0,0,0,0,0,0,20000,-20000,-20000
20200316,054582,致新元大97購01,,,,,0.00,0.00,0,0,0,0,0,0,0,0,0,0,0,0,0
20200316,054583,玉晶光統一97購02,,,,,0.00,0.00,0,0,0,0,0,0,0,0,0,0,0,0,0
20200316,054584,貿聯元富97購01,0.12,0.12,0.12,0.12,0.00,0.00,10000,1,1200,0,0,0,0,0,0,10000,0,10000,10000
20200316,054585,禾伸堂國泰99購01,0.49,0.53,0.49,0.53,+0.07,15.22,743000,8,380070,0,0,0,0,0,0,198000,545000,-347000,-347000
20200316,054586,健鼎國泰99購01,0.20,0.20,0.20,0.20,-0.07,-25.93,10000,1,2000,0,0,0,0,0,0,0,10000,-10000,-10000
20200316,054587,玉晶光國泰99購01,,,,,0.00,0.00,0,0,0,0,0,0,0,0,0,0,0,0,0
20200316,054588,玉晶光國泰99購02,0.42,0.42,0.37,0.37,-0.02,-5.13,28000,3,10760,0,0,0,0,0,0,24000,4000,20000,20000
20200316,054589,聯鈞國泰99購01,1.35,1.37,1.17,1.19,-0.18,-13.14,309000,9,389930,0,0,0,0,0,0,309000,40000,269000,269000
20200316,05458P,台積電凱基97售02,1.84,2.38,1.82,2.38,+0.71,42.51,177000,22,362310,0,0,0,0,0,0,87000,72000,15000,15000
20200316,054590,嘉聯益國泰98購01,,,,,0.00,0.00,0,0,0,0,0,0,0,0,0,0,0,0,0
20200316,054591,GIS國泰98購01,,,,,0.00,0.00,0,0,0,0,0,0,0,0,0,0,0,0,0
20200316,054592,美律永昌9A購01,,,,,0.00,0.00,0,0,0,0,0,0,0,0,0,0,0,0,0
20200316,054593,滬深2X永昌9A購01,1.18,1.18,1.07,1.07,+0.05,4.9,63000,8,70140,0,0,0,0,0,0,6000,53000,-47000,-47000
20200316,054594,國巨麥證97購01,0.20,0.20,0.11,0.11,-0.14,-56.0,226000,14,39000,51000,165000,-114000,0,0,0,51000,165000,-114000,-114000
20200316,054595,正崴麥證97購01,,,,,0.00,0.00,0,0,0,0,0,0,0,0,0,0,0,0,0
20200316,054596,聯發科麥證97購01,,,,,0.00,0.00,0,0,0,0,0,0,0,0,0,0,0,0,0
20200316,054597,南亞台新97購01,,,,,0.00,0.00,0,0,0,0,0,0,0,0,0,0,0,0,0
20200316,054598,鴻海台新98購01,,,,,0.00,0.00,0,0,0,0,0,0,0,0,0,0,0,0,0
20200316,054599,正崴台新97購01,,,,,0.00,0.00,0,0,0,0,0,0,0,0,0,0,0,0,0
20200316,05459P,聯詠凱基95售03,,,,,0.00,0.00,0,0,0,0,0,0,0,0,0,0,0,0,0
20200316,054600,中壽台新97購01,0.06,0.06,0.02,0.02,-0.02,-50.0,83000,4,2480,0,0,0,0,0,0,0,0,0,0
20200316,054601,奇鋐台新98購01,,,,,0.00,0.00,0,0,0,0,0,0,0,0,0,0,0,0,0
20200316,054602,聯詠台新97購01,,,,,0.00,0.00,0,0,0,0,0,0,0,0,0,0,0,0,0
20200316,054603,智易台新98購01,,,,,0.00,0.00,0,0,0,0,0,0,0,0,0,0,0,0,0
20200316,054604,麗豐台新98購01,0.16,0.16,0.16,0.16,0.00,0.00,10000,1,1600,0,0,0,0,0,0,10000,0,10000,10000
20200316,054605,鴻海永豐97購01,0.06,0.06,0.06,0.06,-0.02,-25.0,50000,4,3000,0,0,0,0,0,0,0,50000,-50000,-50000
20200316,054606,台積電永豐97購02,,,,,0.00,0.00,0,0,0,0,0,0,0,0,0,0,0,0,0
20200316,054607,台積電永豐97購03,0.14,0.17,0.14,0.16,-0.07,-30.43,300000,24,47000,0,0,0,0,0,0,0,200000,-200000,-200000
20200316,054608,致茂永豐97購01,0.18,0.18,0.15,0.15,0.00,0.00,15000,2,2550,0,0,0,0,0,0,0,15000,-15000,-15000
20200316,054609,正崴永豐97購01,,,,,0.00,0.00,0,0,0,0,0,0,0,0,0,0,0,0,0
20200316,05460P,台郡凱基95售05,0.46,0.52,0.46,0.52,-0.03,-5.45,134000,18,67000,0,0,0,0,0,0,1000,133000,-132000,-132000
20200316,054610,聯發科永豐97購01,,,,,0.00,0.00,0,0,0,0,0,0,0,0,0,0,0,0,0
20200316,054611,全新永豐97購01,,,,,0.00,0.00,0,0,0,0,0,0,0,0,0,0,0,0,0
20200316,054612,慧洋永豐97購01,0.15,0.15,0.13,0.13,-0.01,-7.14,126000,2,18700,0,0,0,0,0,0,116000,10000,106000,106000
20200316,054613,大立光永豐97購02,,,,,0.00,0.00,0,0,0,0,0,0,0,0,0,0,0,0,0
20200316,054614,玉晶光永豐97購03,0.09,0.09,0.05,0.08,+0.01,14.29,230000,12,18200,0,0,0,0,0,0,130000,100000,30000,30000
20200316,054615,牧德永豐98購01,0.13,0.13,0.11,0.11,-0.02,-15.38,80000,3,9800,0,0,0,0,0,0,0,80000,-80000,-80000
20200316,054616,智伸科永豐97購01,,,,,0.00,0.00,0,0,0,0,0,0,0,0,0,0,0,0,0
20200316,054617,超眾永豐97購01,0.04,0.04,0.04,0.04,-0.04,-50.0,32000,2,1280,0,0,0,0,0,0,0,32000,-32000,-32000
20200316,054618,訊芯永豐97購01,,,,,0.00,0.00,0,0,0,0,0,0,0,0,0,0,0,0,0
20200316,054619,昇陽半永豐97購03,0.02,0.02,0.02,0.02,0.00,0.00,50000,5,1000,0,0,0,0,0,0,0,50000,-50000,-50000
20200316,05461P,台積電亞東97售01,1.32,1.74,1.30,1.74,+0.39,28.89,439000,45,670150,0,0,0,0,0,0,385000,434000,-49000,-49000
20200316,054620,南茂永豐97購01,0.08,0.08,0.08,0.08,+0.01,14.29,499000,4,39920,0,0,0,0,0,0,499000,0,499000,499000
20200316,054621,華新科兆豐98購01,0.12,0.12,0.08,0.08,-0.02,-20.0,270000,6,30600,0,0,0,0,0,0,0,200000,-200000,-200000
20200316,054622,漢唐第一97購01,,,,,0.00,0.00,0,0,0,0,0,0,0,0,0,0,0,0,0
20200316,054623,華新科第一97購01,0.16,0.16,0.07,0.07,-0.09,-56.25,160000,10,17100,0,0,0,0,0,0,0,20000,-20000,-20000
20200316,054624,台積電凱基98購03,0.34,0.34,0.27,0.27,-0.08,-22.86,89000,7,26900,0,0,0,0,0,0,0,10000,-10000,-10000
20200316,054625,旺宏凱基98購03,0.56,0.56,0.54,0.54,0.00,0.00,1000000,4,553000,0,0,0,0,0,0,0,1000000,-1000000,-1000000
20200316,054626,建準凱基98購01,,,,,0.00,0.00,0,0,0,0,0,0,0,0,0,0,0,0,0
20200316,054627,義隆凱基98購01,,,,,0.00,0.00,0,0,0,0,0,0,0,0,0,0,0,0,0
20200316,054628,可成凱基98購01,0.39,0.39,0.35,0.35,-0.02,-5.41,80000,5,29400,0,0,0,0,0,0,60000,20000,40000,40000
20200316,054629,華新科凱基98購01,0.09,0.09,0.08,0.08,0.00,0.00,70000,2,6100,0,0,0,0,0,0,0,0,0,0
20200316,05462P,美律亞東97售01,1.61,1.61,1.61,1.61,-0.16,-9.04,100000,1,161000,0,0,0,0,0,0,0,100000,-100000,-100000
20200316,054630,聯鈞凱基98購01,0.78,0.84,0.56,0.56,-0.35,-38.46,395000,9,281910,0,0,0,0,0,0,390000,5000,385000,385000
20200316,054631,台郡凱基98購02,,,,,0.00,0.00,0,0,0,0,0,0,0,0,0,0,0,0,0
20200316,054632,緯穎凱基9A購01,0.78,0.82,0.74,0.74,0.00,0.00,49000,11,39200,0,0,0,0,0,0,0,41000,-41000,-41000
20200316,054633,臺股指凱基9A購02,0.12,0.15,0.10,0.12,-0.01,-7.69,918000,37,107810,0,0,0,0,0,0,0,0,0,0
20200316,054634,FB上証中信99購01,,,,,0.00,0.00,0,0,0,0,0,0,0,0,0,0,0,0,0
20200316,054635,台達電中信98購01,,,,,0.00,0.00,0,0,0,0,0,0,0,0,0,0,0,0,0
20200316,054636,華通中信97購01,0.05,0.05,0.04,0.04,0.00,0.00,20000,2,900,0,0,0,0,0,0,0,20000,-20000,-20000
20200316,054637,智邦中信98購01,0.89,0.94,0.89,0.94,+0.40,74.07,34000,3,30860,0,0,0,0,0,0,30000,4000,26000,26000
20200316,054638,國泰金中信99購01,,,,,0.00,0.00,0,0,0,0,0,0,0,0,0,0,0,0,0
20200316,054639,台新金中信99購01,,,,,0.00,0.00,0,0,0,0,0,0,0,0,0,0,0,0,0
20200316,05463P,創意國票96售04,,,,,0.00,0.00,0,0,0,0,0,0,0,0,0,0,0,0,0
20200316,054640,健策中信9B購01,0.15,0.15,0.12,0.12,-0.03,-20.0,255000,7,36100,0,0,0,0,0,0,125000,130000,-5000,-5000
20200316,054641,祥碩中信98購01,,,,,0.00,0.00,0,0,0,0,0,0,0,0,0,0,0,0,0
20200316,054642,訊芯中信9A購01,,,,,0.00,0.00,0,0,0,0,0,0,0,0,0,0,0,0,0
20200316,054643,上証2X群益9B購01,0.52,0.52,0.52,0.52,+0.03,6.12,10000,1,5200,0,0,0,0,0,0,10000,10000,0,0
20200316,054644,A50正2群益9B購01,0.29,0.29,0.20,0.21,-0.09,-30.0,426000,9,96600,0,0,0,0,0,0,100000,326000,-226000,-226000
20200316,054645,奇力新群益97購04,,,,,0.00,0.00,0,0,0,0,0,0,0,0,0,0,0,0,0
20200316,054646,華新科群益97購03,,,,,0.00,0.00,0,0,0,0,0,0,0,0,0,0,0,0,0
20200316,054647,禾伸堂群益99購01,0.47,0.47,0.32,0.32,0.00,0.00,620000,6,259800,0,0,0,0,0,0,450000,170000,280000,280000
20200316,054648,智原群益98購01,,,,,0.00,0.00,0,0,0,0,0,0,0,0,0,0,0,0,0
20200316,054649,聯茂群益97購01,1.87,1.87,1.87,1.87,+0.17,10.0,10000,1,18700,0,0,0,0,0,0,10000,0,10000,10000
20200316,05464P,華通康和95售02,1.51,1.90,1.51,1.88,+0.17,9.94,123000,8,205920,0,0,0,0,0,0,40000,123000,-83000,-83000
20200316,054650,南亞麥證97購01,,,,,0.00,0.00,0,0,0,0,0,0,0,0,0,0,0,0,0
20200316,054651,台化麥證97購01,,,,,0.00,0.00,0,0,0,0,0,0,0,0,0,0,0,0,0
20200316,054652,裕隆麥證97購01,0.35,0.36,0.35,0.36,+0.05,16.13,20000,2,7100,20000,0,20000,0,0,0,20000,0,20000,20000
20200316,054653,聯發科麥證97購02,,,,,0.00,0.00,0,0,0,0,0,0,0,0,0,0,0,0,0
20200316,054654,全新麥證99購01,,,,,0.00,0.00,0,0,0,0,0,0,0,0,0,0,0,0,0
20200316,054655,貿聯麥證98購01,,,,,0.00,0.00,0,0,0,0,0,0,0,0,0,0,0,0,0
20200316,054656,深中小元大97購01,1.59,1.59,1.35,1.36,+0.14,11.48,60000,6,84400,0,0,0,0,0,0,10000,50000,-40000,-40000
20200316,054657,道瓊銀元大97購01,,,,,0.00,0.00,0,0,0,0,0,0,0,0,0,0,0,0,0
20200316,054658,道瓊銀元大9A購01,,,,,0.00,0.00,0,0,0,0,0,0,0,0,0,0,0,0,0
20200316,054659,亞光元大97購02,,,,,0.00,0.00,0,0,0,0,0,0,0,0,0,0,0,0,0
20200316,05465P,台表科永豐95售03,,,,,0.00,0.00,0,0,0,0,0,0,0,0,0,0,0,0,0
20200316,054660,禾伸堂元大97購03,,,,,0.00,0.00,0,0,0,0,0,0,0,0,0,0,0,0,0
20200316,054661,嘉聯益元大97購03,0.39,0.39,0.39,0.39,-0.18,-31.58,10000,1,3900,0,0,0,0,0,0,10000,0,10000,10000
20200316,054662,同欣電元大97購02,0.06,0.06,0.06,0.06,0.00,0.00,400000,40,24000,0,0,0,0,0,0,0,400000,-400000,-400000
20200316,054663,同欣電元大97購03,,,,,0.00,0.00,0,0,0,0,0,0,0,0,0,0,0,0,0
20200316,054664,台表科元大97購04,,,,,0.00,0.00,0,0,0,0,0,0,0,0,0,0,0,0,0
20200316,054665,華通元富97購02,0.22,0.24,0.12,0.12,-0.09,-42.86,420000,14,85000,0,0,0,0,0,0,330000,60000,270000,270000
20200316,054666,強茂元富97購01,,,,,0.00,0.00,0,0,0,0,0,0,0,0,0,0,0,0,0
20200316,054667,神基元富97購01,1.17,1.23,1.10,1.16,-0.04,-3.33,327000,14,369080,0,0,0,0,0,0,275000,52000,223000,223000
20200316,054668,傳奇元富97購03,,,,,0.00,0.00,0,0,0,0,0,0,0,0,0,0,0,0,0
20200316,054669,凌華元富97購01,3.06,3.46,3.03,3.23,+0.10,3.19,283000,31,925730,0,0,0,0,0,0,112000,171000,-59000,-59000
20200316,05466P,旺宏富邦97售01,1.10,1.10,1.10,1.10,+0.10,10.0,1000,1,1100,0,0,0,0,0,0,1000,0,1000,1000
20200316,054670,康友元富97購01,0.46,0.46,0.43,0.45,-0.09,-16.67,30000,3,13400,0,0,0,0,0,0,10000,20000,-10000,-10000
20200316,054671,國巨國泰98購01,,,,,0.00,0.00,0,0,0,0,0,0,0,0,0,0,0,0,0
20200316,054672,華新科國泰99購01,,,,,0.00,0.00,0,0,0,0,0,0,0,0,0,0,0,0,0
20200316,054673,京鼎國泰98購01,,,,,0.00,0.00,0,0,0,0,0,0,0,0,0,0,0,0,0
20200316,054674,台光電台新97購01,,,,,0.00,0.00,0,0,0,0,0,0,0,0,0,0,0,0,0
20200316,054675,美律台新98購01,,,,,0.00,0.00,0,0,0,0,0,0,0,0,0,0,0,0,0
20200316,054676,牧德台新98購01,0.29,0.29,0.19,0.19,-0.15,-44.12,445000,9,98150,0,0,0,0,0,0,90000,355000,-265000,-265000
20200316,054677,智易台新98購02,0.13,0.13,0.13,0.13,+0.01,8.33,40000,2,5200,0,0,0,0,0,0,20000,20000,0,0
20200316,054678,麗豐台新98購02,0.16,0.16,0.16,0.16,0.00,0.00,10000,1,1600,0,0,0,0,0,0,0,10000,-10000,-10000
20200316,054679,台積電康和99購01,,,,,0.00,0.00,0,0,0,0,0,0,0,0,0,0,0,0,0
20200316,05467P,聯電元大95售02,1.52,1.65,1.52,1.65,+0.11,7.14,70000,3,107700,0,0,0,0,0,0,60000,10000,50000,50000
20200316,054680,華新科康和97購02,0.16,0.16,0.11,0.11,-0.02,-15.38,33000,4,4260,0,0,0,0,0,0,0,33000,-33000,-33000
20200316,054681,味全永豐97購01,,,,,0.00,0.00,0,0,0,0,0,0,0,0,0,0,0,0,0
20200316,054682,東元永豐97購01,,,,,0.00,0.00,0,0,0,0,0,0,0,0,0,0,0,0,0
20200316,054683,川湖永豐97購01,,,,,0.00,0.00,0,0,0,0,0,0,0,0,0,0,0,0,0
20200316,054684,裕隆永豐97購01,0.42,0.42,0.31,0.31,-0.07,-18.42,273000,15,99110,0,0,0,0,0,0,71000,202000,-131000,-131000
20200316,054685,國巨永豐97購02,0.09,0.09,0.04,0.05,-0.04,-44.44,4037000,112,250130,0,0,0,0,0,0,0,0,0,0
20200316,054686,順德永豐97購01,,,,,0.00,0.00,0,0,0,0,0,0,0,0,0,0,0,0,0
20200316,054687,建準永豐97購02,0.07,0.07,0.03,0.03,-0.05,-62.5,368000,5,11980,0,0,0,0,0,0,277000,1000,276000,276000
20200316,054688,兆赫永豐97購01,0.08,0.08,0.07,0.07,-0.03,-30.0,180000,2,14100,0,0,0,0,0,0,180000,0,180000,180000
20200316,054689,華新科永豐97購01,0.07,0.14,0.07,0.07,0.00,0.00,112000,7,8440,0,0,0,0,0,0,0,0,0,0
20200316,05468P,鴻海元大96售14,4.02,5.15,4.01,4.99,+1.02,25.69,314000,29,1473600,0,0,0,0,0,0,302000,202000,100000,100000
20200316,054690,新興永豐97購01,0.14,0.14,0.13,0.13,0.00,0.00,21000,2,2930,0,0,0,0,0,0,1000,20000,-19000,-19000
20200316,054691,裕民永豐97購01,,,,,0.00,0.00,0,0,0,0,0,0,0,0,0,0,0,0,0
20200316,054692,台航永豐97購01,,,,,0.00,0.00,0,0,0,0,0,0,0,0,0,0,0,0,0
20200316,054693,神基永豐97購01,0.62,0.66,0.60,0.60,+0.01,1.69,21000,3,12860,0,0,0,0,0,0,10000,11000,-1000,-1000
20200316,054694,聯鈞永豐97購01,,,,,0.00,0.00,0,0,0,0,0,0,0,0,0,0,0,0,0
20200316,054695,世芯永豐98購01,,,,,0.00,0.00,0,0,0,0,0,0,0,0,0,0,0,0,0
20200316,054696,嘉聯益永豐97購01,,,,,0.00,0.00,0,0,0,0,0,0,0,0,0,0,0,0,0
20200316,054697,凌華永豐97購01,,,,,0.00,0.00,0,0,0,0,0,0,0,0,0,0,0,0,0
20200316,054698,同欣電永豐97購01,,,,,0.00,0.00,0,0,0,0,0,0,0,0,0,0,0,0,0
20200316,054699,復盛永豐97購01,,,,,0.00,0.00,0,0,0,0,0,0,0,0,0,0,0,0,0
20200316,05469P,台積電元大95售24,3.59,4.60,3.59,4.60,+0.38,9.0,125000,14,516310,0,0,0,0,0,0,100000,75000,25000,25000
20200316,054700,致新永豐97購01,,,,,0.00,0.00,0,0,0,0,0,0,0,0,0,0,0,0,0
20200316,054701,宏全永豐97購01,0.08,0.08,0.08,0.08,-0.03,-27.27,10000,1,800,0,0,0,0,0,0,0,10000,-10000,-10000
20200316,054702,智邦第一97購01,0.34,0.34,0.34,0.34,+0.04,13.33,30000,1,10200,0,0,0,0,0,0,0,30000,-30000,-30000
20200316,054703,聯發科第一97購01,,,,,0.00,0.00,0,0,0,0,0,0,0,0,0,0,0,0,0
20200316,054704,玉晶光第一97購01,,,,,0.00,0.00,0,0,0,0,0,0,0,0,0,0,0,0,0
20200316,054705,欣興亞東97購01,,,,,0.00,0.00,0,0,0,0,0,0,0,0,0,0,0,0,0
20200316,054706,TPK亞東97購01,,,,,0.00,0.00,0,0,0,0,0,0,0,0,0,0,0,0,0
20200316,054707,聯茂亞東97購01,1.21,1.21,1.21,1.21,-0.14,-10.37,10000,1,12100,0,0,0,0,0,0,10000,0,10000,10000
20200316,054708,華通統一97購02,0.12,0.15,0.12,0.15,+0.14,1400.0,4000,3,550,0,0,0,0,0,0,0,3000,-3000,-3000
20200316,054709,宏達電統一97購01,,,,,0.00,0.00,0,0,0,0,0,0,0,0,0,0,0,0,0
20200316,05470P,康控元大95售05,3.34,4.17,3.34,4.17,+0.64,18.13,78000,9,297310,0,0,0,0,0,0,10000,68000,-58000,-58000
20200316,054710,東元元富97購01,1.01,1.17,0.99,1.07,-0.09,-7.76,518000,30,557440,0,0,0,0,0,0,340000,178000,162000,162000
20200316,054711,禾伸堂元富97購01,0.23,0.23,0.20,0.20,-0.02,-9.09,108000,3,21780,0,0,0,0,0,0,8000,100000,-92000,-92000
20200316,054712,上証2X中信98購02,0.26,0.26,0.20,0.20,0.00,0.00,102000,5,21040,0,0,0,0,0,0,0,102000,-102000,-102000
20200316,054713,國巨中信9B購01,0.25,0.31,0.19,0.22,-0.09,-29.03,2071000,142,473720,0,0,0,0,0,0,0,0,0,0
20200316,054714,和鑫台新98購01,0.13,0.13,0.12,0.12,+0.01,9.09,200000,3,25950,0,0,0,0,0,0,5000,195000,-190000,-190000
20200316,054715,中橡康和97購01,,,,,0.00,0.00,0,0,0,0,0,0,0,0,0,0,0,0,0
20200316,054716,緯穎康和97購01,1.25,1.28,1.20,1.20,+0.04,3.45,134000,12,168110,0,0,0,0,0,0,123000,11000,112000,112000
20200316,054717,亞德客永豐97購01,,,,,0.00,0.00,0,0,0,0,0,0,0,0,0,0,0,0,0
20200316,054718,可成永豐97購01,,,,,0.00,0.00,0,0,0,0,0,0,0,0,0,0,0,0,0
20200316,054719,亞光永豐97購01,,,,,0.00,0.00,0,0,0,0,0,0,0,0,0,0,0,0,0
20200316,05471P,聯電統一95售01,1.29,1.40,1.29,1.40,+0.08,6.06,19000,6,26260,0,0,0,0,0,0,16000,0,16000,16000
20200316,054720,禾伸堂永豐97購01,0.18,0.18,0.14,0.14,0.00,0.00,90000,3,15200,0,0,0,0,0,0,40000,50000,-10000,-10000
20200316,054721,揚明光永豐97購03,,,,,0.00,0.00,0,0,0,0,0,0,0,0,0,0,0,0,0
20200316,054722,傳奇永豐97購01,,,,,0.00,0.00,0,0,0,0,0,0,0,0,0,0,0,0,0
20200316,054723,鴻海日盛97購01,0.02,0.02,0.02,0.02,0.00,0.00,845000,10,16900,0,0,0,0,0,0,845000,0,845000,845000
20200316,054724,鴻海日盛97購02,,,,,0.00,0.00,0,0,0,0,0,0,0,0,0,0,0,0,0
20200316,054725,國巨日盛97購01,,,,,0.00,0.00,0,0,0,0,0,0,0,0,0,0,0,0,0
20200316,054726,台積電日盛97購01,,,,,0.00,0.00,0,0,0,0,0,0,0,0,0,0,0,0,0
20200316,054727,台積電日盛97購02,0.14,0.14,0.03,0.11,+0.01,10.0,282000,12,16300,0,0,0,0,0,0,188000,74000,114000,114000
20200316,054728,聯發科日盛97購01,,,,,0.00,0.00,0,0,0,0,0,0,0,0,0,0,0,0,0
20200316,054729,聯發科日盛97購02,,,,,0.00,0.00,0,0,0,0,0,0,0,0,0,0,0,0,0
20200316,05472P,國巨統一96售02,1.18,1.80,1.18,1.68,+0.40,31.25,133000,22,196240,0,0,0,0,0,0,55000,64000,-9000,-9000
20200316,054730,上証2X凱基98購02,0.43,0.44,0.35,0.35,+0.03,9.38,29000,5,11770,0,0,0,0,0,0,27000,2000,25000,25000
20200316,054731,S&P反1凱基98購01,2.04,2.04,1.97,1.97,+0.17,9.44,32000,3,64730,0,0,0,0,0,0,0,32000,-32000,-32000
20200316,054732,台化凱基98購01,,,,,0.00,0.00,0,0,0,0,0,0,0,0,0,0,0,0,0
20200316,054733,鴻海凱基98購04,0.16,0.16,0.12,0.12,-0.07,-36.84,95000,10,12000,0,0,0,0,0,0,0,95000,-95000,-95000
20200316,054734,燿華凱基97購03,,,,,0.00,0.00,0,0,0,0,0,0,0,0,0,0,0,0,0
20200316,054735,漢唐凱基98購01,,,,,0.00,0.00,0,0,0,0,0,0,0,0,0,0,0,0,0
20200316,054736,南亞科凱基98購01,,,,,0.00,0.00,0,0,0,0,0,0,0,0,0,0,0,0,0
20200316,054737,京元電凱基99購01,0.14,0.15,0.10,0.10,-0.05,-33.33,64000,11,7690,0,0,0,0,0,0,0,64000,-64000,-64000
20200316,054738,聯發科凱基97購01,,,,,0.00,0.00,0,0,0,0,0,0,0,0,0,0,0,0,0
20200316,054739,義隆凱基98購02,0.23,0.23,0.17,0.17,+0.02,13.33,49000,9,10000,0,0,0,0,0,0,26000,18000,8000,8000
20200316,05473P,聯詠統一97售02,2.83,3.09,2.83,3.09,-0.10,-3.13,15000,2,43750,0,0,0,0,0,0,15000,0,15000,15000
20200316,054740,強茂凱基99購01,0.14,0.14,0.14,0.14,-0.06,-30.0,50000,1,7000,0,0,0,0,0,0,0,50000,-50000,-50000
20200316,054741,亞光凱基99購01,,,,,0.00,0.00,0,0,0,0,0,0,0,0,0,0,0,0,0
20200316,054742,京鼎凱基99購01,0.25,0.25,0.25,0.25,0.00,0.00,200000,1,50000,0,0,0,0,0,0,200000,0,200000,200000
20200316,054743,聯鈞凱基99購01,0.56,0.57,0.39,0.39,-0.20,-33.9,2234000,38,1140650,0,0,0,0,0,0,1988000,95000,1893000,1893000
20200316,054744,晶相光凱基99購01,0.70,0.70,0.46,0.46,-0.08,-14.81,22000,3,12660,0,0,0,0,0,0,2000,20000,-18000,-18000
20200316,054745,智易凱基97購01,,,,,0.00,0.00,0,0,0,0,0,0,0,0,0,0,0,0,0
20200316,054746,貿聯凱基98購02,,,,,0.00,0.00,0,0,0,0,0,0,0,0,0,0,0,0,0
20200316,054747,麗豐凱基98購01,,,,,0.00,0.00,0,0,0,0,0,0,0,0,0,0,0,0,0
20200316,054748,正文凱基98購01,0.10,0.10,0.10,0.10,-0.07,-41.18,10000,1,1000,0,0,0,0,0,0,0,10000,-10000,-10000
20200316,054749,聯茂凱基98購01,1.37,1.56,1.15,1.15,-0.28,-19.58,65000,9,89130,0,0,0,0,0,0,20000,45000,-25000,-25000
20200316,05474P,智邦亞東95售01,0.87,0.87,0.87,0.87,-0.17,-16.35,60000,1,52200,0,0,0,0,0,0,0,60000,-60000,-60000
20200316,054750,聯茂凱基98購02,,,,,0.00,0.00,0,0,0,0,0,0,0,0,0,0,0,0,0
20200316,054751,GIS凱基98購01,0.10,0.10,0.10,0.10,0.00,0.00,70000,8,7000,0,0,0,0,0,0,0,70000,-70000,-70000
20200316,054752,易華電凱基97購02,,,,,0.00,0.00,0,0,0,0,0,0,0,0,0,0,0,0,0
20200316,054753,復盛凱基98購01,0.50,0.50,0.35,0.35,-0.14,-28.57,637000,9,241760,0,0,0,0,0,0,537000,100000,437000,437000
20200316,054754,昇陽半凱基98購02,,,,,0.00,0.00,0,0,0,0,0,0,0,0,0,0,0,0,0
20200316,054755,世紀鋼凱基98購01,2.20,2.42,1.56,2.14,+0.06,2.88,544000,46,1209940,0,0,0,0,0,0,443000,130000,313000,313000
20200316,054756,世紀鋼凱基99購01,1.68,2.00,1.50,1.74,+0.05,2.96,1243000,80,2228930,0,0,0,0,0,0,776000,272000,504000,504000
20200316,054757,南亞國票98購01,,,,,0.00,0.00,0,0,0,0,0,0,0,0,0,0,0,0,0
20200316,054758,南亞國票9A購01,,,,,0.00,0.00,0,0,0,0,0,0,0,0,0,0,0,0,0
20200316,054759,台化國票98購01,0.28,0.28,0.23,0.23,-0.09,-28.12,25000,3,6300,0,0,0,0,0,0,0,25000,-25000,-25000
20200316,05475P,聯茂亞東95售01,,,,,0.00,0.00,0,0,0,0,0,0,0,0,0,0,0,0,0
20200316,054760,台化國票9A購01,,,,,0.00,0.00,0,0,0,0,0,0,0,0,0,0,0,0,0
20200316,054761,台光電國票98購02,0.42,0.42,0.39,0.39,-0.07,-15.22,23000,2,9270,0,0,0,0,0,0,23000,0,23000,23000
20200316,054762,奇力新國票99購01,,,,,0.00,0.00,0,0,0,0,0,0,0,0,0,0,0,0,0
20200316,054763,宏達電國票99購01,0.36,0.36,0.30,0.30,-0.22,-42.31,519000,3,168300,0,0,0,0,0,0,519000,0,519000,519000
20200316,054764,亞光國票98購01,,,,,0.00,0.00,0,0,0,0,0,0,0,0,0,0,0,0,0
20200316,054765,亞光國票98購02,,,,,0.00,0.00,0,0,0,0,0,0,0,0,0,0,0,0,0
20200316,054766,智原國票98購01,,,,,0.00,0.00,0,0,0,0,0,0,0,0,0,0,0,0,0
20200316,054767,日電貿國票98購01,0.45,0.45,0.44,0.44,+0.03,7.32,35000,2,15650,0,0,0,0,0,0,35000,0,35000,35000
20200316,054768,泰碩國票99購02,1.35,1.43,0.88,0.88,-0.40,-31.25,385000,13,500750,0,0,0,0,0,0,378000,9000,369000,369000
20200316,054769,創意國票98購01,0.19,0.19,0.19,0.19,+0.04,26.67,20000,2,3800,0,0,0,0,0,0,20000,0,20000,20000
20200316,05476P,聯發科群益95售06,,,,,0.00,0.00,0,0,0,0,0,0,0,0,0,0,0,0,0
20200316,054770,健策國票98購01,0.09,0.10,0.06,0.06,-0.01,-14.29,648000,12,56630,0,0,0,0,0,0,618000,0,618000,618000
20200316,054771,茂林國票98購02,,,,,0.00,0.00,0,0,0,0,0,0,0,0,0,0,0,0,0
20200316,054772,康控國票98購02,,,,,0.00,0.00,0,0,0,0,0,0,0,0,0,0,0,0,0
20200316,054773,台郡國票98購01,,,,,0.00,0.00,0,0,0,0,0,0,0,0,0,0,0,0,0
20200316,054774,同欣電國票98購01,,,,,0.00,0.00,0,0,0,0,0,0,0,0,0,0,0,0,0
20200316,054775,復盛國票98購01,0.25,0.25,0.22,0.22,-0.15,-40.54,241000,2,56260,0,0,0,0,0,0,241000,0,241000,241000
20200316,054776,矽創國票98購01,,,,,0.00,0.00,0,0,0,0,0,0,0,0,0,0,0,0,0
20200316,054777,昇陽半國票98購01,,,,,0.00,0.00,0,0,0,0,0,0,0,0,0,0,0,0,0
20200316,054778,世紀鋼國票99購01,5.10,5.25,4.41,4.45,-0.13,-2.84,156000,29,744100,0,0,0,0,0,0,96000,46000,50000,50000
20200316,054779,台塑群益98購01,0.11,0.11,0.09,0.09,-0.01,-10.0,825000,5,74650,0,0,0,0,0,0,20000,805000,-785000,-785000
20200316,05477P,華新科群益95售06,0.81,1.30,0.81,1.30,+0.36,38.3,147000,9,178320,0,0,0,0,0,0,0,97000,-97000,-97000
20200316,054780,中石化群益99購01,0.08,0.08,0.08,0.08,+0.02,33.33,48000,1,3840,0,0,0,0,0,0,48000,0,48000,48000
20200316,054781,台化群益99購01,0.12,0.12,0.10,0.10,-0.03,-23.08,343000,4,34900,0,0,0,0,0,0,8000,335000,-327000,-327000
20200316,054782,國巨群益97購01,,,,,0.00,0.00,0,0,0,0,0,0,0,0,0,0,0,0,0
20200316,054783,國巨群益98購04,,,,,0.00,0.00,0,0,0,0,0,0,0,0,0,0,0,0,0
20200316,054784,順德群益9A購01,0.51,0.51,0.42,0.44,0.00,0.00,690000,33,340000,0,0,0,0,0,0,0,690000,-690000,-690000
20200316,054785,建準群益98購01,,,,,0.00,0.00,0,0,0,0,0,0,0,0,0,0,0,0,0
20200316,054786,全新群益99購02,,,,,0.00,0.00,0,0,0,0,0,0,0,0,0,0,0,0,0
20200316,054787,華新科群益97購04,,,,,0.00,0.00,0,0,0,0,0,0,0,0,0,0,0,0,0
20200316,054788,華新科群益98購02,,,,,0.00,0.00,0,0,0,0,0,0,0,0,0,0,0,0,0
20200316,054789,高鐵群益98購01,,,,,0.00,0.00,0,0,0,0,0,0,0,0,0,0,0,0,0
20200316,05478P,智伸科國票96售02,,,,,0.00,0.00,0,0,0,0,0,0,0,0,0,0,0,0,0
20200316,054790,禾伸堂群益98購01,0.37,0.37,0.37,0.37,0.00,0.00,48000,1,17760,0,0,0,0,0,0,48000,0,48000,48000
20200316,054791,泰碩群益99購02,1.18,1.30,0.76,0.76,-0.41,-35.04,756000,19,809920,0,0,0,0,0,0,443000,313000,130000,130000
20200316,054792,揚明光群益97購01,,,,,0.00,0.00,0,0,0,0,0,0,0,0,0,0,0,0,0
20200316,054793,牧德群益9A購01,0.43,0.43,0.32,0.34,0.00,0.00,261000,8,91520,0,0,0,0,0,0,0,261000,-261000,-261000
20200316,054794,貿聯群益98購01,0.16,0.16,0.15,0.15,0.00,0.00,155000,8,24200,0,0,0,0,0,0,0,155000,-155000,-155000
20200316,054795,合勤控群益98購01,0.12,0.12,0.12,0.12,0.00,0.00,6000,1,720,0,0,0,0,0,0,6000,0,6000,6000
20200316,054796,康普群益98購01,0.05,0.05,0.05,0.05,-0.01,-16.67,50000,2,2500,0,0,0,0,0,0,0,50000,-50000,-50000
20200316,054797,臻鼎群益97購01,0.03,0.03,0.03,0.03,0.00,0.00,28000,2,840,0,0,0,0,0,0,0,0,0,0
20200316,054798,超眾群益97購01,0.10,0.10,0.10,0.10,-0.06,-37.5,100000,1,10000,0,0,0,0,0,0,0,100000,-100000,-100000
20200316,054799,超眾群益98購01,,,,,0.00,0.00,0,0,0,0,0,0,0,0,0,0,0,0,0
20200316,05479P,華新科台新96售01,0.91,1.21,0.88,1.21,+0.28,30.11,769000,57,842570,0,0,0,0,0,0,501000,648000,-147000,-147000
20200316,054800,訊芯群益99購01,,,,,0.00,0.00,0,0,0,0,0,0,0,0,0,0,0,0,0
20200316,054801,康友群益97購02,0.62,0.62,0.43,0.43,-0.34,-44.16,61000,2,26420,0,0,0,0,0,0,60000,0,60000,60000
20200316,054802,高股息元大97購01,0.15,0.15,0.12,0.12,-0.09,-42.86,95000,10,12800,0,0,0,0,0,0,0,95000,-95000,-95000
20200316,054803,味全元大9A購01,,,,,0.00,0.00,0,0,0,0,0,0,0,0,0,0,0,0,0
20200316,054804,南亞元大9A購01,,,,,0.00,0.00,0,0,0,0,0,0,0,0,0,0,0,0,0
20200316,054805,台苯元大9A購01,,,,,0.00,0.00,0,0,0,0,0,0,0,0,0,0,0,0,0
20200316,054806,台化元大9A購01,0.59,0.59,0.56,0.56,-0.06,-9.68,100000,5,58400,0,0,0,0,0,0,100000,0,100000,100000
20200316,054807,台化元大9A購02,0.36,0.36,0.36,0.36,+0.01,2.86,10000,1,3600,0,0,0,0,0,0,10000,0,10000,10000
20200316,054808,東元元大9A購01,1.00,1.08,0.98,1.07,-0.01,-0.93,336000,27,349580,0,0,0,0,0,0,208000,128000,80000,80000
20200316,054809,大成鋼元大97購01,0.43,0.45,0.43,0.45,+0.10,28.57,50000,4,21900,0,0,0,0,0,0,30000,20000,10000,10000
20200316,05480P,滬深2X凱基96售05,2.94,3.32,2.94,3.32,0.00,0.00,115000,5,349000,0,0,0,0,0,0,0,115000,-115000,-115000
20200316,054810,中橡元大9A購01,0.25,0.25,0.25,0.25,-0.01,-3.85,40000,4,10000,0,0,0,0,0,0,0,40000,-40000,-40000
20200316,054811,裕隆元大9A購01,0.89,0.90,0.72,0.72,-0.07,-8.86,125000,9,106350,0,0,0,0,0,0,70000,55000,15000,15000
20200316,054812,鴻海元大97購08,0.24,0.24,0.17,0.18,-0.12,-40.0,31000,3,6680,0,0,0,0,0,0,31000,21000,10000,10000
20200316,054813,鴻海元大97購09,0.13,0.13,0.13,0.13,0.00,0.00,1000,1,130,0,0,0,0,0,0,1000,1000,0,0
20200316,054814,台積電元大97購13,0.35,0.35,0.19,0.19,-0.23,-54.76,311000,35,89790,0,0,0,0,0,0,1000,311000,-310000,-310000
20200316,054815,台積電元大97購14,,,,,0.00,0.00,0,0,0,0,0,0,0,0,0,0,0,0,0
20200316,054816,聯發科元大97購12,,,,,0.00,0.00,0,0,0,0,0,0,0,0,0,0,0,0,0
20200316,054817,聯發科元大97購13,,,,,0.00,0.00,0,0,0,0,0,0,0,0,0,0,0,0,0
20200316,054818,奇力新元大97購05,0.10,0.10,0.05,0.05,0.00,0.00,205000,22,18100,0,0,0,0,0,0,0,205000,-205000,-205000
20200316,054819,裕民元大9A購01,0.85,0.87,0.84,0.87,-0.04,-4.4,126000,3,106190,0,0,0,0,0,0,121000,5000,116000,116000
20200316,05481P,鴻海凱基95售21,3.63,4.17,3.63,4.17,+0.54,14.88,30000,2,119700,0,0,0,0,0,0,30000,20000,10000,10000
20200316,054820,新日興元大97購01,1.00,1.00,0.62,0.62,-0.45,-42.06,11000,2,10620,0,0,0,0,0,0,10000,1000,9000,9000
20200316,054821,貿聯元大9A購01,0.19,0.20,0.19,0.19,0.00,0.00,61000,4,11840,0,0,0,0,0,0,61000,0,61000,61000
20200316,054822,祥碩元大97購01,4.28,4.28,3.46,3.46,-1.08,-23.79,103000,27,420920,0,0,0,0,0,0,77000,88000,-11000,-11000
20200316,054823,祥碩元大97購02,,,,,0.00,0.00,0,0,0,0,0,0,0,0,0,0,0,0,0
20200316,054824,同欣電元大97購04,0.21,0.21,0.13,0.13,-0.04,-23.53,20000,2,3400,0,0,0,0,0,0,10000,10000,0,0
20200316,054825,康友元大97購01,0.52,0.52,0.52,0.52,-0.15,-22.39,10000,1,5200,0,0,0,0,0,0,0,10000,-10000,-10000
20200316,054826,復盛元大9A購01,1.23,1.23,1.23,1.23,+0.13,11.82,20000,3,24600,0,0,0,0,0,0,10000,10000,0,0
20200316,054827,宏全元大9A購01,0.67,0.67,0.55,0.55,-0.04,-6.78,52000,6,31710,0,0,0,0,0,0,20000,32000,-12000,-12000
20200316,054828,正崴國泰99購01,,,,,0.00,0.00,0,0,0,0,0,0,0,0,0,0,0,0,0
20200316,054829,亞光國泰99購01,0.14,0.14,0.14,0.14,0.00,0.00,10000,1,1400,0,0,0,0,0,0,0,10000,-10000,-10000
20200316,05482P,鴻海凱基95售22,3.65,3.65,3.65,3.65,0.00,0.00,20000,1,73000,0,0,0,0,0,0,20000,20000,0,0
20200316,054830,世芯國泰99購01,,,,,0.00,0.00,0,0,0,0,0,0,0,0,0,0,0,0,0
20200316,054831,緯穎國泰98購01,3.40,3.41,3.22,3.31,+0.47,16.55,121000,32,404850,0,0,0,0,0,0,121000,0,121000,121000
20200316,054832,興勤中信97購01,,,,,0.00,0.00,0,0,0,0,0,0,0,0,0,0,0,0,0
20200316,054833,京鼎中信97購01,,,,,0.00,0.00,0,0,0,0,0,0,0,0,0,0,0,0,0
20200316,054834,帆宣中信97購01,0.03,0.03,0.03,0.03,0.00,0.00,140000,14,4200,0,0,0,0,0,0,0,140000,-140000,-140000
20200316,054835,致新中信97購01,,,,,0.00,0.00,0,0,0,0,0,0,0,0,0,0,0,0,0
20200316,054836,勤誠中信97購01,0.22,0.22,0.21,0.22,0.00,0.00,320000,4,68400,0,0,0,0,0,0,0,320000,-320000,-320000
20200316,054837,欣興第一97購01,,,,,0.00,0.00,0,0,0,0,0,0,0,0,0,0,0,0,0
20200316,054838,京鼎第一97購01,,,,,0.00,0.00,0,0,0,0,0,0,0,0,0,0,0,0,0
20200316,054839,中石化亞東98購01,,,,,0.00,0.00,0,0,0,0,0,0,0,0,0,0,0,0,0
20200316,05483P,國巨凱基95售07,0.55,0.83,0.50,0.83,+0.29,53.7,1302000,45,729970,0,0,0,0,0,0,0,1301000,-1301000,-1301000
20200316,054840,T50反1兆豐98購01,,,,,0.00,0.00,0,0,0,0,0,0,0,0,0,0,0,0,0
20200316,054841,亞德客兆豐97購01,0.93,1.04,0.75,0.75,+0.02,2.74,636000,25,616570,0,0,0,0,0,0,198000,588000,-390000,-390000
20200316,054842,台達電兆豐98購01,0.89,0.89,0.70,0.70,-0.06,-7.89,22000,3,17580,0,0,0,0,0,0,10000,12000,-2000,-2000
20200316,054843,中環兆豐97購01,0.13,0.13,0.07,0.07,-0.02,-22.22,428000,7,45580,0,0,0,0,0,0,100000,150000,-50000,-50000
20200316,054844,華邦電兆豐98購01,,,,,0.00,0.00,0,0,0,0,0,0,0,0,0,0,0,0,0
20200316,054845,智邦兆豐98購01,1.04,1.09,0.86,0.86,-0.15,-14.85,806000,36,795850,0,0,0,0,0,0,257000,548000,-291000,-291000
20200316,054846,瑞昱兆豐97購01,0.44,0.44,0.42,0.42,0.00,0.00,38000,2,16460,0,0,0,0,0,0,0,38000,-38000,-38000
20200316,054847,創意兆豐97購01,0.11,0.12,0.11,0.12,+0.04,50.0,115000,2,13100,0,0,0,0,0,0,115000,0,115000,115000
20200316,054848,群創兆豐98購01,0.07,0.07,0.05,0.05,-0.01,-16.67,155000,12,9900,0,0,0,0,0,0,0,155000,-155000,-155000
20200316,054849,日月光兆豐97購01,,,,,0.00,0.00,0,0,0,0,0,0,0,0,0,0,0,0,0
20200316,05484P,台積電凱基95售18,0.77,1.12,0.77,1.12,+0.61,119.61,61000,3,64590,0,0,0,0,0,0,60000,1000,59000,59000
20200316,054850,上海銀兆豐97購01,0.10,0.10,0.07,0.07,-0.04,-36.36,100000,8,8700,0,0,0,0,0,0,10000,90000,-80000,-80000
20200316,054851,樺漢兆豐97購01,0.18,0.18,0.18,0.18,0.00,0.00,10000,1,1800,0,0,0,0,0,0,0,10000,-10000,-10000
20200316,054852,奇鋐國票98購01,,,,,0.00,0.00,0,0,0,0,0,0,0,0,0,0,0,0,0
20200316,054853,TPK國票98購02,,,,,0.00,0.00,0,0,0,0,0,0,0,0,0,0,0,0,0
20200316,054854,台積電麥證97購01,0.14,0.14,0.12,0.12,+0.01,9.09,350000,2,48000,350000,0,350000,0,0,0,350000,0,350000,350000
20200316,054855,得力群益98購01,,,,,0.00,0.00,0,0,0,0,0,0,0,0,0,0,0,0,0
20200316,054856,得力群益99購01,0.34,0.36,0.33,0.36,+0.06,20.0,100000,5,34940,0,0,0,0,0,0,100000,0,100000,100000
20200316,054857,信錦群益97購01,,,,,0.00,0.00,0,0,0,0,0,0,0,0,0,0,0,0,0
20200316,054858,台肥群益97購01,,,,,0.00,0.00,0,0,0,0,0,0,0,0,0,0,0,0,0
20200316,054859,鴻海群益97購02,,,,,0.00,0.00,0,0,0,0,0,0,0,0,0,0,0,0,0
20200316,05485P,旺宏凱基95售08,1.12,1.37,1.12,1.33,-0.08,-5.67,144000,9,174960,0,0,0,0,0,0,49000,95000,-46000,-46000
20200316,054860,台積電群益98購01,0.15,0.15,0.07,0.11,-0.05,-31.25,670000,23,63710,0,0,0,0,0,0,189000,1000,188000,188000
20200316,054861,智邦群益97購01,,,,,0.00,0.00,0,0,0,0,0,0,0,0,0,0,0,0,0
20200316,054862,群光群益97購01,,,,,0.00,0.00,0,0,0,0,0,0,0,0,0,0,0,0,0
20200316,054863,億光群益97購01,,,,,0.00,0.00,0,0,0,0,0,0,0,0,0,0,0,0,0
20200316,054864,聯發科群益97購02,,,,,0.00,0.00,0,0,0,0,0,0,0,0,0,0,0,0,0
20200316,054865,可成群益97購01,0.24,0.24,0.24,0.24,0.00,0.00,10000,2,2400,0,0,0,0,0,0,10000,0,10000,10000
20200316,054866,宏盛群益98購01,,,,,0.00,0.00,0,0,0,0,0,0,0,0,0,0,0,0,0
20200316,054867,華航群益99購01,0.19,0.19,0.19,0.19,-0.03,-13.64,270000,5,51300,0,0,0,0,0,0,150000,120000,30000,30000
20200316,054868,國泰金群益9A購01,0.13,0.13,0.12,0.12,-0.05,-29.41,834000,18,101660,0,0,0,0,0,0,61000,809000,-748000,-748000
20200316,054869,新光金群益97購01,,,,,0.00,0.00,0,0,0,0,0,0,0,0,0,0,0,0,0
20200316,05486P,大立光凱基95售14,3.77,4.64,3.77,4.60,0.00,0.00,201000,11,843700,0,0,0,0,0,0,150000,201000,-51000,-51000
20200316,054870,新日興群益98購01,,,,,0.00,0.00,0,0,0,0,0,0,0,0,0,0,0,0,0
20200316,054871,明泰群益98購01,,,,,0.00,0.00,0,0,0,0,0,0,0,0,0,0,0,0,0
20200316,054872,瀚宇博群益98購01,,,,,0.00,0.00,0,0,0,0,0,0,0,0,0,0,0,0,0
20200316,054873,帆宣群益99購01,,,,,0.00,0.00,0,0,0,0,0,0,0,0,0,0,0,0,0
20200316,054874,帆宣群益99購02,0.31,0.32,0.30,0.30,+0.10,50.0,1200000,5,363000,0,0,0,0,0,0,1200000,0,1200000,1200000
20200316,054875,群電群益97購01,,,,,0.00,0.00,0,0,0,0,0,0,0,0,0,0,0,0,0
20200316,054876,群電群益97購02,0.30,0.32,0.29,0.32,+0.02,6.67,176000,8,53060,0,0,0,0,0,0,114000,62000,52000,52000
20200316,054877,百和群益98購01,0.17,0.17,0.07,0.08,-0.08,-50.0,3143000,55,288160,0,0,0,0,0,0,1923000,1035000,888000,888000
20200316,054878,和大統一97購02,,,,,0.00,0.00,0,0,0,0,0,0,0,0,0,0,0,0,0
20200316,054879,大成鋼統一97購01,,,,,0.00,0.00,0,0,0,0,0,0,0,0,0,0,0,0,0
20200316,05487P,台表科凱基95售02,,,,,0.00,0.00,0,0,0,0,0,0,0,0,0,0,0,0,0
20200316,054880,華泰統一97購01,0.09,0.09,0.09,0.09,0.00,0.00,10000,1,900,0,0,0,0,0,0,10000,0,10000,10000
20200316,054881,光罩統一97購01,,,,,0.00,0.00,0,0,0,0,0,0,0,0,0,0,0,0,0
20200316,054882,台光電統一97購02,,,,,0.00,0.00,0,0,0,0,0,0,0,0,0,0,0,0,0
20200316,054883,億光統一97購01,,,,,0.00,0.00,0,0,0,0,0,0,0,0,0,0,0,0,0
20200316,054884,友達統一99購01,0.07,0.07,0.07,0.07,0.00,0.00,320000,1,22400,0,0,0,0,0,0,320000,0,320000,320000
20200316,054885,建準統一98購01,,,,,0.00,0.00,0,0,0,0,0,0,0,0,0,0,0,0,0
20200316,054886,大毅統一97購01,,,,,0.00,0.00,0,0,0,0,0,0,0,0,0,0,0,0,0
20200316,054887,大毅統一98購01,2.37,2.38,2.37,2.38,+0.17,7.69,17000,2,40360,0,0,0,0,0,0,17000,0,17000,17000
20200316,054888,泰碩統一97購01,0.38,0.51,0.38,0.50,+0.13,35.14,35000,4,15200,0,0,0,0,0,0,20000,15000,5000,5000
20200316,054889,京鼎統一99購01,,,,,0.00,0.00,0,0,0,0,0,0,0,0,0,0,0,0,0
20200316,05488P,臺股指凱基95售21,,,,,0.00,0.00,0,0,0,0,0,0,0,0,0,0,0,0,0
20200316,054890,聯鈞統一99購01,,,,,0.00,0.00,0,0,0,0,0,0,0,0,0,0,0,0,0
20200316,054891,聯鈞統一99購02,0.30,0.33,0.30,0.33,-0.03,-8.33,7000,2,2160,0,0,0,0,0,0,5000,2000,3000,3000
20200316,054892,彩晶統一99購01,,,,,0.00,0.00,0,0,0,0,0,0,0,0,0,0,0,0,0
20200316,054893,帆宣統一99購01,,,,,0.00,0.00,0,0,0,0,0,0,0,0,0,0,0,0,0
20200316,054894,GIS統一97購01,,,,,0.00,0.00,0,0,0,0,0,0,0,0,0,0,0,0,0
20200316,054895,南電統一97購01,,,,,0.00,0.00,0,0,0,0,0,0,0,0,0,0,0,0,0
20200316,054896,聯茂日盛97購01,0.92,0.92,0.69,0.69,-0.26,-27.37,114000,4,102280,0,0,0,0,0,0,110000,4000,106000,106000
20200316,054897,信錦康和97購01,,,,,0.00,0.00,0,0,0,0,0,0,0,0,0,0,0,0,0
20200316,054898,台肥康和97購01,,,,,0.00,0.00,0,0,0,0,0,0,0,0,0,0,0,0,0
20200316,054899,南港康和97購01,0.50,0.50,0.50,0.50,0.00,0.00,2000,2,1000,0,0,0,0,0,0,0,2000,-2000,-2000
20200316,05489P,臺股指凱基95售22,,,,,0.00,0.00,0,0,0,0,0,0,0,0,0,0,0,0,0
20200316,054900,金寶康和97購01,0.24,0.24,0.24,0.24,-0.02,-7.69,15000,3,3600,0,0,0,0,0,0,0,15000,-15000,-15000
20200316,054901,群光康和97購01,,,,,0.00,0.00,0,0,0,0,0,0,0,0,0,0,0,0,0
20200316,054902,億光康和97購01,,,,,0.00,0.00,0,0,0,0,0,0,0,0,0,0,0,0,0
20200316,054903,億光康和97購02,,,,,0.00,0.00,0,0,0,0,0,0,0,0,0,0,0,0,0
20200316,054904,興勤康和97購01,,,,,0.00,0.00,0,0,0,0,0,0,0,0,0,0,0,0,0
20200316,054905,國揚康和97購01,0.44,0.44,0.30,0.30,0.00,0.00,315000,13,111500,0,0,0,0,0,0,185000,130000,55000,55000
20200316,054906,神達康和97購01,0.69,0.70,0.54,0.55,-0.17,-23.61,130000,9,86550,0,0,0,0,0,0,25000,105000,-80000,-80000
20200316,054907,帆宣康和97購01,,,,,0.00,0.00,0,0,0,0,0,0,0,0,0,0,0,0,0
20200316,054908,群電康和97購01,,,,,0.00,0.00,0,0,0,0,0,0,0,0,0,0,0,0,0
20200316,054909,福懋科康和97購01,,,,,0.00,0.00,0,0,0,0,0,0,0,0,0,0,0,0,0
20200316,05490P,鴻海元大95售23,,,,,0.00,0.00,0,0,0,0,0,0,0,0,0,0,0,0,0
20200316,054910,信錦凱基97購01,0.34,0.34,0.31,0.31,0.00,0.00,88000,2,27880,0,0,0,0,0,0,0,88000,-88000,-88000
20200316,054911,敬鵬凱基97購01,,,,,0.00,0.00,0,0,0,0,0,0,0,0,0,0,0,0,0
20200316,054912,群光凱基97購01,0.53,0.53,0.53,0.53,-0.07,-11.67,6000,1,3180,0,0,0,0,0,0,6000,0,6000,6000
20200316,054913,億光凱基97購01,,,,,0.00,0.00,0,0,0,0,0,0,0,0,0,0,0,0,0
20200316,054914,億光凱基98購01,,,,,0.00,0.00,0,0,0,0,0,0,0,0,0,0,0,0,0
20200316,054915,興勤凱基97購01,,,,,0.00,0.00,0,0,0,0,0,0,0,0,0,0,0,0,0
20200316,054916,聯發科凱基98購04,0.35,0.35,0.30,0.30,+0.02,7.14,21000,2,7300,0,0,0,0,0,0,21000,0,21000,21000
20200316,054917,聯發科凱基98購05,0.13,0.27,0.13,0.27,+0.17,170.0,55000,2,7850,0,0,0,0,0,0,55000,0,55000,55000
20200316,054918,華新科凱基98購02,0.17,0.17,0.17,0.17,+0.02,13.33,20000,2,3400,0,0,0,0,0,0,0,20000,-20000,-20000
20200316,054919,興富發凱基97購01,0.27,0.27,0.26,0.26,+0.07,36.84,100000,5,26200,0,0,0,0,0,0,100000,0,100000,100000
20200316,05491P,茂林元大95售04,,,,,0.00,0.00,0,0,0,0,0,0,0,0,0,0,0,0,0
20200316,054920,智原凱基98購01,,,,,0.00,0.00,0,0,0,0,0,0,0,0,0,0,0,0,0
20200316,054921,文曄凱基97購01,0.65,0.65,0.53,0.53,-0.09,-14.52,233000,7,126790,0,0,0,0,0,0,232000,1000,231000,231000
20200316,054922,文曄凱基98購01,0.96,0.97,0.83,0.83,-0.11,-11.7,160000,7,151360,0,0,0,0,0,0,50000,110000,-60000,-60000
20200316,054923,晶技凱基98購01,,,,,0.00,0.00,0,0,0,0,0,0,0,0,0,0,0,0,0
20200316,054924,景碩凱基98購01,,,,,0.00,0.00,0,0,0,0,0,0,0,0,0,0,0,0,0
20200316,054925,神達凱基97購01,0.83,0.92,0.68,0.68,-0.19,-21.84,880000,28,701870,0,0,0,0,0,0,360000,528000,-168000,-168000
20200316,054926,神達凱基98購01,0.85,0.95,0.71,0.71,-0.22,-23.66,345000,18,299300,0,0,0,0,0,0,293000,55000,238000,238000
20200316,054927,帆宣凱基97購01,,,,,0.00,0.00,0,0,0,0,0,0,0,0,0,0,0,0,0
20200316,054928,帆宣凱基98購01,,,,,0.00,0.00,0,0,0,0,0,0,0,0,0,0,0,0,0
20200316,054929,群電凱基97購01,0.29,0.29,0.29,0.29,0.00,0.00,12000,1,3480,0,0,0,0,0,0,0,12000,-12000,-12000
20200316,05492P,聯茂元大95售02,,,,,0.00,0.00,0,0,0,0,0,0,0,0,0,0,0,0,0
20200316,054930,群電凱基98購01,,,,,0.00,0.00,0,0,0,0,0,0,0,0,0,0,0,0,0
20200316,054931,緯穎凱基98購01,1.05,1.05,0.86,0.86,-0.13,-13.13,27000,4,25370,0,0,0,0,0,0,11000,16000,-5000,-5000
20200316,054932,台肥元大97購01,0.65,0.65,0.58,0.60,+0.04,7.14,326000,20,204880,0,0,0,0,0,0,230000,86000,144000,144000
20200316,054933,南港元大97購01,0.45,0.45,0.45,0.45,+0.27,150.0,1000,1,450,0,0,0,0,0,0,1000,0,1000,1000
20200316,054934,金寶元大97購01,0.54,0.54,0.44,0.44,-0.02,-4.35,30000,3,15000,0,0,0,0,0,0,30000,0,30000,30000
20200316,054935,華通元大98購03,0.34,0.34,0.34,0.34,0.00,0.00,10000,1,3400,0,0,0,0,0,0,0,10000,-10000,-10000
20200316,054936,鴻海元大97購10,,,,,0.00,0.00,0,0,0,0,0,0,0,0,0,0,0,0,0
20200316,054937,國巨元大97購03,0.21,0.25,0.17,0.20,+0.02,11.11,28000,5,5190,0,0,0,0,0,0,9000,5000,4000,4000
20200316,054938,國巨元大97購04,0.21,0.21,0.20,0.20,+0.03,17.65,62000,4,13010,0,0,0,0,0,0,51000,1000,50000,50000
20200316,054939,台積電元大97購15,0.39,0.41,0.20,0.21,-0.27,-56.25,386000,35,112880,0,0,0,0,0,0,91000,296000,-205000,-205000
20200316,05493P,華新科富邦99售02,0.68,0.73,0.68,0.72,+0.05,7.46,70000,6,50000,0,0,0,0,0,0,20000,50000,-30000,-30000
20200316,054940,台積電元大97購16,0.45,0.45,0.23,0.27,-0.25,-48.08,231000,16,82170,0,0,0,0,0,0,111000,101000,10000,10000
20200316,054941,凱美元大97購01,0.18,0.20,0.18,0.18,+0.04,28.57,86000,5,16150,0,0,0,0,0,0,65000,76000,-11000,-11000
20200316,054942,凱美元大97購02,0.10,0.10,0.09,0.09,+0.02,28.57,115000,2,10400,0,0,0,0,0,0,110000,115000,-5000,-5000
20200316,054943,群光元大97購01,0.95,1.00,0.94,1.00,-0.13,-11.5,132000,6,130300,0,0,0,0,0,0,112000,20000,92000,92000
20200316,054944,精元元大97購01,0.82,0.82,0.46,0.46,-0.26,-36.11,170000,17,100700,0,0,0,0,0,0,30000,140000,-110000,-110000
20200316,054945,正崴元大97購01,,,,,0.00,0.00,0,0,0,0,0,0,0,0,0,0,0,0,0
20200316,054946,億光元大97購01,0.41,0.41,0.41,0.41,0.00,0.00,10000,1,4100,0,0,0,0,0,0,0,10000,-10000,-10000
20200316,054947,興勤元大97購01,0.19,0.19,0.19,0.19,0.00,0.00,25000,1,4750,0,0,0,0,0,0,25000,25000,0,0
20200316,054948,聯發科元大97購14,0.10,0.10,0.10,0.10,0.00,0.00,20000,2,2000,0,0,0,0,0,0,0,20000,-20000,-20000
20200316,054949,奇力新元大98購01,0.08,0.08,0.08,0.08,-0.10,-55.56,10000,1,800,0,0,0,0,0,0,10000,0,10000,10000
20200316,05494P,華邦電統一95售02,3.76,3.80,3.68,3.68,+0.08,2.22,12000,12,44960,0,0,0,0,0,0,12000,0,12000,12000
20200316,054950,奇力新元大98購02,0.14,0.14,0.14,0.14,0.00,0.00,20000,1,2800,0,0,0,0,0,0,20000,0,20000,20000
20200316,054951,大毅元大97購01,1.98,1.98,1.61,1.61,-0.34,-17.44,95000,5,181020,0,0,0,0,0,0,75000,20000,55000,55000
20200316,054952,大毅元大97購02,1.91,1.91,1.82,1.82,+0.06,3.41,41000,4,77000,0,0,0,0,0,0,31000,10000,21000,21000
20200316,054953,華新科元大97購05,,,,,0.00,0.00,0,0,0,0,0,0,0,0,0,0,0,0,0
20200316,054954,華新科元大97購06,,,,,0.00,0.00,0,0,0,0,0,0,0,0,0,0,0,0,0
20200316,054955,宏達電元大98購01,0.34,0.37,0.33,0.33,-0.05,-13.16,21000,5,7130,0,0,0,0,0,0,21000,1000,20000,20000
20200316,054956,宏盛元大97購01,,,,,0.00,0.00,0,0,0,0,0,0,0,0,0,0,0,0,0
20200316,054957,興富發元大97購01,0.86,0.86,0.83,0.84,+0.16,23.53,111000,8,94020,0,0,0,0,0,0,78000,33000,45000,45000
20200316,054958,亞光元大97購03,0.04,0.04,0.04,0.04,+0.01,33.33,70000,1,2800,0,0,0,0,0,0,70000,0,70000,70000
20200316,054959,禾伸堂元大98購01,0.48,0.48,0.45,0.45,0.00,0.00,20000,2,9300,0,0,0,0,0,0,0,20000,-20000,-20000
20200316,05495P,大立光統一95售07,,,,,0.00,0.00,0,0,0,0,0,0,0,0,0,0,0,0,0
20200316,054960,新日興元大97購02,0.39,0.42,0.30,0.30,-0.04,-11.76,191000,20,75160,0,0,0,0,0,0,21000,161000,-140000,-140000
20200316,054961,玉晶光元大99購01,0.29,0.30,0.19,0.19,-0.07,-26.92,318000,30,75390,0,0,0,0,0,0,134000,184000,-50000,-50000
20200316,054962,玉晶光元大99購02,,,,,0.00,0.00,0,0,0,0,0,0,0,0,0,0,0,0,0
20200316,054963,牧德元大97購02,0.13,0.14,0.12,0.12,-0.07,-36.84,290000,10,37400,0,0,0,0,0,0,220000,70000,150000,150000
20200316,054964,智易元大99購01,,,,,0.00,0.00,0,0,0,0,0,0,0,0,0,0,0,0,0
20200316,054965,健策元大98購04,0.18,0.18,0.17,0.18,0.00,0.00,460000,12,81300,0,0,0,0,0,0,410000,50000,360000,360000
20200316,054966,貿聯元大98購02,0.11,0.11,0.11,0.11,+0.02,22.22,5000,1,550,0,0,0,0,0,0,0,5000,-5000,-5000
20200316,054967,神達元大97購01,1.98,2.28,1.69,1.69,-0.59,-25.88,268000,33,513090,0,0,0,0,0,0,105000,170000,-65000,-65000
20200316,054968,佐登元大97購01,0.09,0.09,0.09,0.09,-0.01,-10.0,290000,1,26100,0,0,0,0,0,0,290000,0,290000,290000
20200316,054969,亞翔元大97購01,,,,,0.00,0.00,0,0,0,0,0,0,0,0,0,0,0,0,0
20200316,05496P,聯詠統一95售04,,,,,0.00,0.00,0,0,0,0,0,0,0,0,0,0,0,0,0
20200316,054970,帆宣元大97購01,,,,,0.00,0.00,0,0,0,0,0,0,0,0,0,0,0,0,0
20200316,054971,帆宣元大97購02,0.37,0.37,0.31,0.31,-0.04,-11.43,78000,5,25100,0,0,0,0,0,0,62000,16000,46000,46000
20200316,054972,聯茂元大97購02,0.91,1.00,0.72,0.72,-0.19,-20.88,87000,9,81840,0,0,0,0,0,0,35000,62000,-27000,-27000
20200316,054973,台郡元大98購02,,,,,0.00,0.00,0,0,0,0,0,0,0,0,0,0,0,0,0
20200316,054974,台表科元大98購02,0.45,0.45,0.45,0.45,0.00,0.00,10000,1,4500,0,0,0,0,0,0,0,10000,-10000,-10000
20200316,054975,福懋科元大97購01,1.11,1.11,0.80,0.82,-0.29,-26.13,105000,9,101800,0,0,0,0,0,0,30000,75000,-45000,-45000
20200316,054976,上証2X元富9A購01,0.64,0.64,0.56,0.56,-0.11,-16.42,180000,7,109000,0,0,0,0,0,0,0,180000,-180000,-180000
20200316,054977,SP黃豆元富9B購01,0.44,0.45,0.44,0.44,0.00,0.00,104000,4,46200,0,0,0,0,0,0,0,104000,-104000,-104000
20200316,054978,堤維西元富97購01,0.10,0.10,0.10,0.10,-0.02,-16.67,100000,2,10000,0,0,0,0,0,0,100000,0,100000,100000
20200316,054979,南港元富97購01,0.13,0.22,0.13,0.22,0.00,0.00,162000,18,22600,0,0,0,0,0,0,0,162000,-162000,-162000
20200316,05497P,聯詠統一96售01,2.38,2.38,2.38,2.38,0.00,0.00,2000,1,4760,0,0,0,0,0,0,2000,0,2000,2000
20200316,054980,國巨元富97購01,0.12,0.14,0.06,0.11,-0.01,-8.33,1474000,50,147890,0,0,0,0,0,0,0,0,0,0
20200316,054981,國巨元富97購02,0.07,0.07,0.05,0.05,-0.02,-28.57,159000,8,11030,0,0,0,0,0,0,0,0,0,0
20200316,054982,國巨元富97購03,0.05,0.05,0.04,0.04,-0.01,-20.0,570000,20,24400,0,0,0,0,0,0,0,0,0,0
20200316,054983,國巨元富97購04,0.09,0.10,0.07,0.07,-0.02,-22.22,1393000,40,116010,0,0,0,0,0,0,0,0,0,0
20200316,054984,華泰元富97購01,0.05,0.05,0.04,0.04,-0.02,-33.33,90000,9,3900,0,0,0,0,0,0,0,90000,-90000,-90000
20200316,054985,光罩元富97購01,0.43,0.46,0.38,0.38,+0.06,18.75,80000,6,34200,0,0,0,0,0,0,40000,40000,0,0
20200316,054986,藍天元富97購01,,,,,0.00,0.00,0,0,0,0,0,0,0,0,0,0,0,0,0
20200316,054987,凱美元富97購01,0.03,0.04,0.03,0.04,0.00,0.00,80000,3,2800,0,0,0,0,0,0,40000,0,40000,40000
20200316,054988,凱美元富97購02,,,,,0.00,0.00,0,0,0,0,0,0,0,0,0,0,0,0,0
20200316,054989,精元元富97購01,,,,,0.00,0.00,0,0,0,0,0,0,0,0,0,0,0,0,0
20200316,05498P,友達元富95售02,,,,,0.00,0.00,0,0,0,0,0,0,0,0,0,0,0,0,0
20200316,054990,凌陽元富97購01,,,,,0.00,0.00,0,0,0,0,0,0,0,0,0,0,0,0,0
20200316,054991,南亞科元富97購01,0.12,0.12,0.12,0.12,0.00,0.00,299000,1,35880,0,0,0,0,0,0,299000,0,299000,299000
20200316,054992,南亞科元富97購02,0.04,0.04,0.04,0.04,-0.02,-33.33,5000,1,200,0,0,0,0,0,0,5000,0,5000,5000
20200316,054993,南亞科元富97購03,,,,,0.00,0.00,0,0,0,0,0,0,0,0,0,0,0,0,0
20200316,054994,建準元富97購01,,,,,0.00,0.00,0,0,0,0,0,0,0,0,0,0,0,0,0
20200316,054995,宏盛元富97購01,,,,,0.00,0.00,0,0,0,0,0,0,0,0,0,0,0,0,0
20200316,054996,聯陽元富97購01,1.01,1.01,0.79,0.79,-0.23,-22.55,106000,3,84960,0,0,0,0,0,0,100000,6000,94000,94000
20200316,054997,文曄元富97購01,,,,,0.00,0.00,0,0,0,0,0,0,0,0,0,0,0,0,0
20200316,054998,玉晶光元富97購02,0.28,0.28,0.26,0.27,+0.05,22.73,360000,4,97200,0,0,0,0,0,0,0,360000,-360000,-360000
20200316,054999,玉晶光元富97購03,0.24,0.24,0.14,0.20,-0.04,-16.67,1992000,22,390060,0,0,0,0,0,0,2000,1940000,-1938000,-1938000
20200316,05499P,聯詠元富95售02,1.37,1.52,1.37,1.52,-0.05,-3.18,131000,8,184730,0,0,0,0,0,0,76000,55000,21000,21000
20200316,055000,玉晶光元富97購04,0.17,0.17,0.16,0.16,+0.03,23.08,315000,2,52050,0,0,0,0,0,0,315000,0,315000,315000
20200316,055001,京鼎元富97購01,,,,,0.00,0.00,0,0,0,0,0,0,0,0,0,0,0,0,0
20200316,055002,群創元富99購04,,,,,0.00,0.00,0,0,0,0,0,0,0,0,0,0,0,0,0
20200316,055003,群創元富99購05,0.13,0.13,0.09,0.09,-0.03,-25.0,615000,7,64350,0,0,0,0,0,0,200000,415000,-215000,-215000
20200316,055004,群創元富99購06,0.07,0.07,0.07,0.07,0.00,0.00,105000,2,7350,0,0,0,0,0,0,60000,45000,15000,15000
20200316,055005,晶相光元富97購01,0.75,0.77,0.46,0.46,-0.25,-35.21,182000,24,132070,0,0,0,0,0,0,155000,27000,128000,128000
20200316,055006,晶相光元富9A購01,0.69,0.69,0.69,0.69,+0.06,9.52,20000,1,13800,0,0,0,0,0,0,20000,0,20000,20000
20200316,055007,晶相光元富9A購02,0.55,0.55,0.36,0.36,-0.17,-32.08,73000,9,35930,0,0,0,0,0,0,32000,41000,-9000,-9000
20200316,055008,隆達元富97購01,0.16,0.16,0.16,0.16,-0.02,-11.11,7000,1,1120,0,0,0,0,0,0,7000,0,7000,7000
20200316,055009,合勤控元富97購01,,,,,0.00,0.00,0,0,0,0,0,0,0,0,0,0,0,0,0
20200316,05500P,臺股指中信96售04,5.45,6.70,5.45,6.70,-0.95,-12.42,7000,3,41150,0,0,0,0,0,0,7000,0,7000,7000
20200316,055010,佐登元富97購01,0.10,0.10,0.10,0.10,+0.01,11.11,100000,1,10000,0,0,0,0,0,0,0,100000,-100000,-100000
20200316,055011,元翎元富97購01,0.11,0.12,0.10,0.10,+0.02,25.0,349000,7,35010,0,0,0,0,0,0,331000,18000,313000,313000
20200316,055012,茂林元富97購01,0.32,0.34,0.20,0.20,-0.12,-37.5,507000,39,144140,0,0,0,0,0,0,237000,250000,-13000,-13000
20200316,055013,訊連元富97購01,0.73,0.82,0.54,0.54,-0.23,-29.87,694000,51,463420,0,0,0,0,0,0,266000,353000,-87000,-87000
20200316,055014,達興元富97購01,0.51,0.51,0.50,0.50,-0.03,-5.66,65000,2,33000,0,0,0,0,0,0,15000,50000,-35000,-35000
20200316,055015,帆宣元富97購01,0.38,0.38,0.38,0.38,0.00,0.00,30000,1,11400,0,0,0,0,0,0,0,30000,-30000,-30000
20200316,055016,群電元富97購01,,,,,0.00,0.00,0,0,0,0,0,0,0,0,0,0,0,0,0
20200316,055017,緯穎元富97購01,1.25,1.37,1.13,1.13,+0.03,2.73,164000,27,211460,0,0,0,0,0,0,85000,44000,41000,41000
20200316,055018,緯穎元富97購02,0.82,0.90,0.65,0.65,-0.20,-23.53,550000,26,406770,0,0,0,0,0,0,391000,74000,317000,317000
20200316,055019,福懋科元富97購01,1.34,1.34,0.95,0.95,-0.38,-28.57,142000,8,166380,0,0,0,0,0,0,97000,45000,52000,52000
20200316,05501P,健策國票97售01,1.28,1.54,1.22,1.54,+0.07,4.76,20000,4,27900,0,0,0,0,0,0,20000,0,20000,20000
20200316,055020,上証2X國泰98購01,,,,,0.00,0.00,0,0,0,0,0,0,0,0,0,0,0,0,0
20200316,055021,亞德客國泰98購01,1.17,1.32,0.98,0.98,-0.03,-2.97,322000,18,392430,0,0,0,0,0,0,104000,199000,-95000,-95000
20200316,055022,精元國泰99購01,0.69,0.71,0.44,0.44,-0.20,-31.25,412000,26,225670,0,0,0,0,0,0,147000,265000,-118000,-118000
20200316,055023,億光國泰98購01,0.35,0.35,0.30,0.30,+0.07,30.43,42000,4,13800,0,0,0,0,0,0,13000,29000,-16000,-16000
20200316,055024,興勤國泰98購01,0.20,0.20,0.14,0.14,-0.07,-33.33,550000,5,86000,0,0,0,0,0,0,250000,300000,-50000,-50000
20200316,055025,華新科國泰98購02,,,,,0.00,0.00,0,0,0,0,0,0,0,0,0,0,0,0,0
20200316,055026,健和興國泰98購01,,,,,0.00,0.00,0,0,0,0,0,0,0,0,0,0,0,0,0
20200316,055027,牧德國泰99購01,0.42,0.44,0.28,0.28,-0.19,-40.43,705000,16,279120,0,0,0,0,0,0,408000,297000,111000,111000
20200316,055028,佐登國泰98購01,0.33,0.34,0.33,0.33,+0.02,6.45,111000,3,36730,0,0,0,0,0,0,0,111000,-111000,-111000
20200316,055029,帆宣國泰99購01,0.42,0.42,0.40,0.40,+0.03,8.11,498000,8,207450,0,0,0,0,0,0,401000,97000,304000,304000
20200316,05502P,台表科國票97售01,,,,,0.00,0.00,0,0,0,0,0,0,0,0,0,0,0,0,0
20200316,055030,帆宣國泰99購02,0.42,0.43,0.42,0.43,+0.07,19.44,459000,2,194870,0,0,0,0,0,0,250000,209000,41000,41000
20200316,055031,南港富邦99購01,0.16,0.16,0.16,0.16,+0.06,60.0,30000,1,4800,0,0,0,0,0,0,30000,0,30000,30000
20200316,055032,億光富邦99購01,0.24,0.24,0.19,0.19,-0.07,-26.92,58000,2,13770,0,0,0,0,0,0,58000,0,58000,58000
20200316,055033,漢唐富邦98購01,,,,,0.00,0.00,0,0,0,0,0,0,0,0,0,0,0,0,0
20200316,055034,建準富邦99購01,,,,,0.00,0.00,0,0,0,0,0,0,0,0,0,0,0,0,0
20200316,055035,興勤富邦98購01,,,,,0.00,0.00,0,0,0,0,0,0,0,0,0,0,0,0,0
20200316,055036,中工富邦9B購01,0.37,0.37,0.37,0.37,+0.04,12.12,60000,3,22200,0,0,0,0,0,0,60000,0,60000,60000
20200316,055037,宏盛富邦99購01,,,,,0.00,0.00,0,0,0,0,0,0,0,0,0,0,0,0,0
20200316,055038,華航富邦99購01,0.24,0.24,0.24,0.24,-0.07,-22.58,15000,2,3600,0,0,0,0,0,0,0,0,0,0
20200316,055039,神達富邦99購01,0.82,0.82,0.82,0.82,+0.05,6.49,2000,1,1640,0,0,0,0,0,0,2000,0,2000,2000
20200316,05503P,智邦日盛96售01,0.66,0.74,0.66,0.74,-0.06,-7.5,23000,2,16620,0,0,0,0,0,0,23000,0,23000,23000
20200316,055040,台虹富邦99購01,,,,,0.00,0.00,0,0,0,0,0,0,0,0,0,0,0,0,0
20200316,055041,致新富邦97購01,,,,,0.00,0.00,0,0,0,0,0,0,0,0,0,0,0,0,0
20200316,055042,得力永豐97購01,,,,,0.00,0.00,0,0,0,0,0,0,0,0,0,0,0,0,0
20200316,055043,中砂永豐97購01,,,,,0.00,0.00,0,0,0,0,0,0,0,0,0,0,0,0,0
20200316,055044,信錦永豐97購01,,,,,0.00,0.00,0,0,0,0,0,0,0,0,0,0,0,0,0
20200316,055045,台肥永豐97購01,,,,,0.00,0.00,0,0,0,0,0,0,0,0,0,0,0,0,0
20200316,055046,上銀永豐97購01,,,,,0.00,0.00,0,0,0,0,0,0,0,0,0,0,0,0,0
20200316,055047,南港永豐97購01,,,,,0.00,0.00,0,0,0,0,0,0,0,0,0,0,0,0,0
20200316,055048,台積電永豐97購04,,,,,0.00,0.00,0,0,0,0,0,0,0,0,0,0,0,0,0
20200316,055049,智邦永豐97購01,0.38,0.38,0.34,0.34,-0.03,-8.11,80000,4,28110,0,0,0,0,0,0,5000,75000,-70000,-70000
20200316,05504P,台積電凱基96售04,1.98,2.46,1.98,2.39,+1.73,262.12,1500000,15,3525920,0,0,0,0,0,0,1377000,1500000,-123000,-123000
20200316,055050,敬鵬永豐97購01,,,,,0.00,0.00,0,0,0,0,0,0,0,0,0,0,0,0,0
20200316,055051,藍天永豐97購01,,,,,0.00,0.00,0,0,0,0,0,0,0,0,0,0,0,0,0
20200316,055052,凱美永豐97購01,,,,,0.00,0.00,0,0,0,0,0,0,0,0,0,0,0,0,0
20200316,055053,瑞昱永豐97購01,0.06,0.06,0.06,0.06,0.00,0.00,10000,1,600,0,0,0,0,0,0,0,10000,-10000,-10000
20200316,055054,群光永豐97購01,0.30,0.30,0.30,0.30,-0.06,-16.67,6000,1,1800,0,0,0,0,0,0,6000,0,6000,6000
20200316,055055,精元永豐97購01,0.33,0.33,0.25,0.25,+0.03,13.64,1000000,23,281000,0,0,0,0,0,0,0,1000000,-1000000,-1000000
20200316,055056,億光永豐97購01,,,,,0.00,0.00,0,0,0,0,0,0,0,0,0,0,0,0,0
20200316,055057,興勤永豐97購01,,,,,0.00,0.00,0,0,0,0,0,0,0,0,0,0,0,0,0
20200316,055058,大毅永豐97購01,,,,,0.00,0.00,0,0,0,0,0,0,0,0,0,0,0,0,0
20200316,055059,健和興永豐97購01,,,,,0.00,0.00,0,0,0,0,0,0,0,0,0,0,0,0,0
20200316,05505P,聯發科凱基96售09,2.94,4.50,2.61,4.32,+2.02,87.83,114000,16,378130,0,0,0,0,0,0,42000,72000,-30000,-30000
20200316,055060,聯陽永豐97購01,0.58,0.60,0.46,0.47,-0.15,-24.19,166000,12,92650,0,0,0,0,0,0,151000,10000,141000,141000
20200316,055061,聯詠永豐97購01,,,,,0.00,0.00,0,0,0,0,0,0,0,0,0,0,0,0,0
20200316,055062,文曄永豐97購01,,,,,0.00,0.00,0,0,0,0,0,0,0,0,0,0,0,0,0
20200316,055063,玉晶光永豐99購01,0.17,0.17,0.12,0.13,-0.07,-35.0,587000,19,83100,0,0,0,0,0,0,308000,269000,39000,39000
20200316,055064,碩天永豐97購01,0.15,0.15,0.15,0.15,0.00,0.00,70000,7,10500,0,0,0,0,0,0,0,70000,-70000,-70000
20200316,055065,神達永豐97購01,0.39,0.42,0.31,0.31,-0.08,-20.51,314000,9,111290,0,0,0,0,0,0,242000,72000,170000,170000
20200316,055066,佐登永豐97購01,,,,,0.00,0.00,0,0,0,0,0,0,0,0,0,0,0,0,0
20200316,055067,禾聯碩永豐97購01,0.32,0.32,0.31,0.31,+0.03,10.71,440000,9,136600,0,0,0,0,0,0,440000,0,440000,440000
20200316,055068,亞翔永豐97購01,,,,,0.00,0.00,0,0,0,0,0,0,0,0,0,0,0,0,0
20200316,055069,帆宣永豐97購01,,,,,0.00,0.00,0,0,0,0,0,0,0,0,0,0,0,0,0
20200316,05506P,茂林凱基96售03,0.85,1.40,0.85,1.40,+0.55,64.71,378000,13,337040,0,0,0,0,0,0,20000,347000,-327000,-327000
20200316,055070,聯茂永豐97購01,,,,,0.00,0.00,0,0,0,0,0,0,0,0,0,0,0,0,0
20200316,055071,群電永豐97購01,,,,,0.00,0.00,0,0,0,0,0,0,0,0,0,0,0,0,0
20200316,055072,康友永豐97購02,0.08,0.08,0.08,0.08,-0.03,-27.27,5000,1,400,0,0,0,0,0,0,0,5000,-5000,-5000
20200316,055073,易華電永豐97購01,,,,,0.00,0.00,0,0,0,0,0,0,0,0,0,0,0,0,0
20200316,055074,台虹永豐97購01,,,,,0.00,0.00,0,0,0,0,0,0,0,0,0,0,0,0,0
20200316,055075,南電永豐97購01,1.17,1.17,1.17,1.17,0.00,0.00,10000,1,11700,0,0,0,0,0,0,0,10000,-10000,-10000
20200316,055076,福懋科永豐97購01,0.46,0.46,0.35,0.35,-0.08,-18.6,22000,2,9900,0,0,0,0,0,0,22000,0,22000,22000
20200316,055077,臺股指永豐97購02,,,,,0.00,0.00,0,0,0,0,0,0,0,0,0,0,0,0,0
20200316,055078,亞泥中信98購01,0.13,0.13,0.13,0.13,0.00,0.00,60000,3,7800,0,0,0,0,0,0,0,60000,-60000,-60000
20200316,055079,台光電中信97購01,0.05,0.05,0.05,0.05,0.00,0.00,420000,6,21000,0,0,0,0,0,0,150000,240000,-90000,-90000
20200316,05507P,聯茂凱基96售02,0.86,1.23,0.85,1.23,+0.19,18.27,449000,14,422300,0,0,0,0,0,0,184000,265000,-81000,-81000
20200316,055080,正崴中信99購01,0.03,0.04,0.03,0.04,+0.01,33.33,20000,2,700,0,0,0,0,0,0,0,20000,-20000,-20000
20200316,055081,健鼎中信97購01,0.13,0.45,0.13,0.45,+0.42,1400.0,15000,2,3550,0,0,0,0,0,0,0,10000,-10000,-10000
20200316,055082,台郡中信97購01,0.03,0.03,0.02,0.02,-0.02,-50.0,311000,7,8220,0,0,0,0,0,0,200000,20000,180000,180000
20200316,055083,康友中信97購01,0.09,0.10,0.05,0.05,-0.05,-50.0,34000,4,2760,0,0,0,0,0,0,0,34000,-34000,-34000
20200316,055084,國巨第一97購01,,,,,0.00,0.00,0,0,0,0,0,0,0,0,0,0,0,0,0
20200316,055085,大毅國票97購01,1.78,2.10,1.52,1.52,-0.11,-6.75,70000,5,136240,0,0,0,0,0,0,70000,0,70000,70000
20200316,055086,華邦電亞東98購01,,,,,0.00,0.00,0,0,0,0,0,0,0,0,0,0,0,0,0
20200316,055087,瑞昱亞東97購01,,,,,0.00,0.00,0,0,0,0,0,0,0,0,0,0,0,0,0
20200316,055088,聯詠亞東97購01,,,,,0.00,0.00,0,0,0,0,0,0,0,0,0,0,0,0,0
20200316,055089,金寶群益98購01,0.42,0.42,0.42,0.42,-0.03,-6.67,50000,1,21000,0,0,0,0,0,0,0,50000,-50000,-50000
20200316,05508P,華通統一97售01,,,,,0.00,0.00,0,0,0,0,0,0,0,0,0,0,0,0,0
20200316,055090,國巨群益97購03,,,,,0.00,0.00,0,0,0,0,0,0,0,0,0,0,0,0,0
20200316,055091,微星群益97購01,,,,,0.00,0.00,0,0,0,0,0,0,0,0,0,0,0,0,0
20200316,055092,開發金群益9B購01,0.30,0.30,0.26,0.26,-0.03,-10.34,32000,3,9200,0,0,0,0,0,0,32000,0,32000,32000
20200316,055093,京鼎群益98購01,,,,,0.00,0.00,0,0,0,0,0,0,0,0,0,0,0,0,0
20200316,055094,智易群益98購01,0.11,0.11,0.10,0.10,0.00,0.00,1210000,7,123990,0,0,0,0,0,0,0,1210000,-1210000,-1210000
20200316,055095,啟碁群益98購01,0.19,0.19,0.19,0.19,+0.05,35.71,5000,1,950,0,0,0,0,0,0,5000,0,5000,5000
20200316,055096,緯穎群益97購01,1.21,1.21,1.19,1.19,+0.70,142.86,20000,2,24000,0,0,0,0,0,0,20000,0,20000,20000
20200316,055097,福懋科群益97購01,0.55,0.55,0.55,0.55,0.00,0.00,4000,1,2200,0,0,0,0,0,0,4000,0,4000,4000
20200316,055098,臺股指群益97購01,,,,,0.00,0.00,0,0,0,0,0,0,0,0,0,0,0,0,0
20200316,055099,可成日盛97購01,0.18,0.18,0.18,0.18,-0.01,-5.26,100000,1,18000,0,0,0,0,0,0,100000,0,100000,100000
20200316,05509P,智邦元富96售02,0.83,1.00,0.79,1.00,-0.19,-15.97,469000,10,434060,0,0,0,0,0,0,286000,183000,103000,103000
20200316,055100,得力凱基97購01,0.06,0.06,0.06,0.06,0.00,0.00,40000,1,2400,0,0,0,0,0,0,40000,0,40000,40000
20200316,055101,台肥凱基97購01,0.16,0.16,0.15,0.15,0.00,0.00,65000,3,9850,0,0,0,0,0,0,0,65000,-65000,-65000
20200316,055102,上銀凱基98購01,0.42,0.42,0.24,0.24,-0.36,-60.0,1083000,16,363970,0,0,0,0,0,0,1058000,40000,1018000,1018000
20200316,055103,南港凱基97購01,0.14,0.15,0.13,0.15,0.00,0.00,13000,3,1730,0,0,0,0,0,0,1000,12000,-11000,-11000
20200316,055104,台達電凱基98購01,0.18,0.18,0.17,0.17,+0.02,13.33,53000,3,9520,0,0,0,0,0,0,50000,3000,47000,47000
20200316,055105,鴻海凱基98購05,0.25,0.25,0.21,0.21,-0.12,-36.36,40000,4,9200,0,0,0,0,0,0,0,40000,-40000,-40000
20200316,055106,台積電凱基98購05,0.27,0.27,0.19,0.19,-0.06,-24.0,65000,5,13600,0,0,0,0,0,0,20000,0,20000,20000
20200316,055107,旺宏凱基98購04,0.17,0.17,0.12,0.12,-0.02,-14.29,70000,3,11200,0,0,0,0,0,0,50000,20000,30000,30000
20200316,055108,智邦凱基98購01,,,,,0.00,0.00,0,0,0,0,0,0,0,0,0,0,0,0,0
20200316,055109,正崴凱基98購01,,,,,0.00,0.00,0,0,0,0,0,0,0,0,0,0,0,0,0
20200316,05510P,燿華元富96售01,2.00,2.00,2.00,2.00,+0.24,13.64,10000,1,20000,0,0,0,0,0,0,10000,0,10000,10000
20200316,055110,美律凱基98購02,0.22,0.23,0.22,0.23,+0.03,15.0,120000,3,27400,0,0,0,0,0,0,20000,100000,-80000,-80000
20200316,055111,宏盛凱基97購01,,,,,0.00,0.00,0,0,0,0,0,0,0,0,0,0,0,0,0
20200316,055112,晶豪科凱基98購01,0.28,0.28,0.28,0.28,-0.01,-3.45,30000,3,8400,0,0,0,0,0,0,0,30000,-30000,-30000
20200316,055113,大立光凱基98購06,0.17,0.17,0.17,0.17,+0.02,13.33,4000,1,680,0,0,0,0,0,0,0,4000,-4000,-4000
20200316,055114,新日興凱基98購01,,,,,0.00,0.00,0,0,0,0,0,0,0,0,0,0,0,0,0
20200316,055115,日月光凱基98購01,0.07,0.10,0.07,0.10,0.00,0.00,8000,4,740,0,0,0,0,0,0,8000,8000,0,0
20200316,055116,康控凱基98購01,,,,,0.00,0.00,0,0,0,0,0,0,0,0,0,0,0,0,0
20200316,055117,臻鼎凱基98購02,0.08,0.08,0.08,0.08,-0.02,-20.0,60000,1,4800,0,0,0,0,0,0,60000,0,60000,60000
20200316,055118,嘉聯益凱基98購02,0.19,0.19,0.17,0.17,0.00,0.00,8000,2,1460,0,0,0,0,0,0,0,8000,-8000,-8000
20200316,055119,力成凱基98購01,0.30,0.30,0.30,0.30,-0.04,-11.76,30000,3,9000,0,0,0,0,0,0,0,30000,-30000,-30000
20200316,05511P,T50反1台新06售01,0.31,0.31,0.31,0.31,-0.01,-3.12,5000,1,1550,0,0,0,0,0,0,0,0,0,0
20200316,055120,南港兆豐97購01,0.75,0.75,0.30,0.40,+0.14,53.85,467000,21,153100,0,0,0,0,0,0,106000,356000,-250000,-250000
20200316,055121,鴻海兆豐97購03,0.15,0.15,0.15,0.15,0.00,0.00,20000,1,3000,0,0,0,0,0,0,0,20000,-20000,-20000
20200316,055122,國巨兆豐98購01,0.15,0.15,0.14,0.14,0.00,0.00,135000,5,19250,0,0,0,0,0,0,100000,0,100000,100000
20200316,055123,億光兆豐97購01,,,,,0.00,0.00,0,0,0,0,0,0,0,0,0,0,0,0,0
20200316,055124,建準兆豐97購01,0.36,0.36,0.36,0.36,0.00,0.00,50000,1,18000,0,0,0,0,0,0,0,50000,-50000,-50000
20200316,055125,智原兆豐97購01,,,,,0.00,0.00,0,0,0,0,0,0,0,0,0,0,0,0,0
20200316,055126,嘉澤兆豐97購01,0.10,0.10,0.08,0.08,-0.03,-27.27,40000,5,3750,0,0,0,0,0,0,0,40000,-40000,-40000
20200316,055127,台虹兆豐97購01,,,,,0.00,0.00,0,0,0,0,0,0,0,0,0,0,0,0,0
20200316,055128,致新兆豐97購01,,,,,0.00,0.00,0,0,0,0,0,0,0,0,0,0,0,0,0
20200316,055129,鈺齊兆豐97購01,0.13,0.13,0.13,0.13,+0.01,8.33,3000,1,390,0,0,0,0,0,0,3000,0,3000,3000
20200316,05512P,華新科台新97售01,0.80,1.05,0.75,1.05,+0.10,10.53,747000,13,686540,0,0,0,0,0,0,462000,685000,-223000,-223000
20200316,055130,京鼎康和97購01,,,,,0.00,0.00,0,0,0,0,0,0,0,0,0,0,0,0,0
20200316,055131,茂林康和97購01,0.28,0.28,0.19,0.19,-0.10,-34.48,94000,20,25090,0,0,0,0,0,0,80000,14000,66000,66000
20200316,055132,台虹康和97購01,0.53,0.53,0.43,0.43,-0.06,-12.24,48000,2,25340,0,0,0,0,0,0,47000,1000,46000,46000
20200316,055133,致新康和97購01,0.37,0.37,0.37,0.37,0.00,0.00,130000,2,48100,0,0,0,0,0,0,0,130000,-130000,-130000
20200316,055134,元油反國泰99購01,,,,,0.00,0.00,0,0,0,0,0,0,0,0,0,0,0,0,0
20200316,055135,聯發科富邦99購05,,,,,0.00,0.00,0,0,0,0,0,0,0,0,0,0,0,0,0
20200316,055136,聯發科富邦99購06,,,,,0.00,0.00,0,0,0,0,0,0,0,0,0,0,0,0,0
20200316,055137,GIS富邦98購01,,,,,0.00,0.00,0,0,0,0,0,0,0,0,0,0,0,0,0
20200316,055138,大毅永豐97購02,0.60,0.60,0.44,0.44,-0.14,-24.14,45000,8,23220,0,0,0,0,0,0,0,45000,-45000,-45000
20200316,055139,欣興永豐97購01,0.05,0.05,0.03,0.03,0.00,0.00,30000,3,1100,0,0,0,0,0,0,0,30000,-30000,-30000
20200316,05513P,玉山金台新96售01,0.64,0.83,0.64,0.83,+0.32,62.75,295000,20,222840,0,0,0,0,0,0,0,259000,-259000,-259000
20200316,055140,晶相光永豐97購01,0.24,0.24,0.24,0.24,-0.01,-4.0,20000,1,4800,0,0,0,0,0,0,20000,0,20000,20000
20200316,055141,牧德永豐98購02,,,,,0.00,0.00,0,0,0,0,0,0,0,0,0,0,0,0,0
20200316,055142,健策永豐98購01,,,,,0.00,0.00,0,0,0,0,0,0,0,0,0,0,0,0,0
20200316,055143,臻鼎永豐97購01,0.09,0.09,0.05,0.05,0.00,0.00,40000,4,2700,0,0,0,0,0,0,0,40000,-40000,-40000
20200316,055144,T50反1元大97購03,,,,,0.00,0.00,0,0,0,0,0,0,0,0,0,0,0,0,0
20200316,055145,T50反1元大97購04,,,,,0.00,0.00,0,0,0,0,0,0,0,0,0,0,0,0,0
20200316,055146,華通元大98購04,0.25,0.25,0.18,0.18,0.00,0.00,90000,9,18300,0,0,0,0,0,0,0,90000,-90000,-90000
20200316,055147,鴻海元大97購11,,,,,0.00,0.00,0,0,0,0,0,0,0,0,0,0,0,0,0
20200316,055148,鴻海元大98購02,0.35,0.35,0.30,0.30,-0.16,-34.78,20000,3,6500,0,0,0,0,0,0,10000,10000,0,0
20200316,055149,國巨元大97購06,0.16,0.16,0.08,0.08,-0.05,-38.46,339000,38,40260,0,0,0,0,0,0,2000,337000,-335000,-335000
20200316,05514P,康舒永豐96售01,1.34,1.34,1.34,1.34,-0.05,-3.6,10000,1,13400,0,0,0,0,0,0,0,10000,-10000,-10000
20200316,055150,台積電元大98購04,,,,,0.00,0.00,0,0,0,0,0,0,0,0,0,0,0,0,0
20200316,055151,台積電元大98購05,0.16,0.18,0.16,0.18,0.00,0.00,21000,2,3760,0,0,0,0,0,0,0,1000,-1000,-1000
20200316,055152,旺宏元大98購04,0.25,0.31,0.20,0.20,-0.08,-28.57,480000,42,115500,0,0,0,0,0,0,105000,365000,-260000,-260000
20200316,055153,台光電元大98購02,0.34,0.36,0.34,0.36,+0.07,24.14,30000,2,10400,0,0,0,0,0,0,20000,10000,10000,10000
20200316,055154,聯發科元大98購01,,,,,0.00,0.00,0,0,0,0,0,0,0,0,0,0,0,0,0
20200316,055155,奇力新元大99購01,0.13,0.13,0.08,0.08,-0.01,-11.11,210000,12,21300,0,0,0,0,0,0,110000,100000,10000,10000
20200316,055156,華新科元大99購02,0.22,0.22,0.22,0.22,+0.14,175.0,20000,2,4400,0,0,0,0,0,0,0,20000,-20000,-20000
20200316,055157,晶豪科元大97購01,0.51,0.53,0.33,0.33,-0.14,-29.79,280000,30,116350,0,0,0,0,0,0,0,280000,-280000,-280000
20200316,055158,亞光元大99購01,,,,,0.00,0.00,0,0,0,0,0,0,0,0,0,0,0,0,0
20200316,055159,玉晶光元大98購05,0.18,0.18,0.18,0.18,+0.01,5.88,100000,1,18000,0,0,0,0,0,0,100000,0,100000,100000
20200316,05515P,台積電群益96售03,,,,,0.00,0.00,0,0,0,0,0,0,0,0,0,0,0,0,0
20200316,055160,玉晶光元大99購03,0.28,0.28,0.19,0.19,-0.11,-36.67,189000,17,43750,0,0,0,0,0,0,67000,122000,-55000,-55000
20200316,055161,貿聯元大98購03,0.27,0.27,0.24,0.24,+0.03,14.29,10000,2,2550,0,0,0,0,0,0,0,10000,-10000,-10000
20200316,055162,新唐元大97購01,,,,,0.00,0.00,0,0,0,0,0,0,0,0,0,0,0,0,0
20200316,055163,訊芯元大98購01,0.19,0.19,0.12,0.12,-0.04,-25.0,152000,16,24920,0,0,0,0,0,0,22000,130000,-108000,-108000
20200316,055164,矽創元大98購01,0.41,0.41,0.26,0.26,-0.14,-35.0,170000,8,57030,0,0,0,0,0,0,160000,80000,80000,80000
20200316,055165,元油反統一98購01,,,,,0.00,0.00,0,0,0,0,0,0,0,0,0,0,0,0,0
20200316,055166,台積電統一97購05,0.28,0.28,0.17,0.17,-0.16,-48.48,882000,9,159000,0,0,0,0,0,0,499000,0,499000,499000
20200316,055167,友訊統一97購01,0.32,0.32,0.32,0.32,+0.14,77.78,10000,1,3200,0,0,0,0,0,0,0,10000,-10000,-10000
20200316,055168,光罩統一98購01,,,,,0.00,0.00,0,0,0,0,0,0,0,0,0,0,0,0,0
20200316,055169,光罩統一99購01,,,,,0.00,0.00,0,0,0,0,0,0,0,0,0,0,0,0,0
20200316,05516P,台積電元大96售12,,,,,0.00,0.00,0,0,0,0,0,0,0,0,0,0,0,0,0
20200316,055170,光磊統一97購01,,,,,0.00,0.00,0,0,0,0,0,0,0,0,0,0,0,0,0
20200316,055171,凱美統一97購01,,,,,0.00,0.00,0,0,0,0,0,0,0,0,0,0,0,0,0
20200316,055172,凱美統一97購02,,,,,0.00,0.00,0,0,0,0,0,0,0,0,0,0,0,0,0
20200316,055173,瑞昱統一97購01,0.59,0.59,0.59,0.59,0.00,0.00,20000,2,11800,0,0,0,0,0,0,0,20000,-20000,-20000
20200316,055174,精元統一97購01,,,,,0.00,0.00,0,0,0,0,0,0,0,0,0,0,0,0,0
20200316,055175,建準統一97購01,,,,,0.00,0.00,0,0,0,0,0,0,0,0,0,0,0,0,0
20200316,055176,大毅統一98購02,1.58,1.58,1.58,1.58,0.00,0.00,5000,1,7900,0,0,0,0,0,0,5000,0,5000,5000
20200316,055177,宏達電統一99購01,,,,,0.00,0.00,0,0,0,0,0,0,0,0,0,0,0,0,0
20200316,055178,晶豪科統一97購01,0.45,0.45,0.45,0.45,+0.11,32.35,3000,1,1350,0,0,0,0,0,0,3000,0,3000,3000
20200316,055179,大立光統一97購04,,,,,0.00,0.00,0,0,0,0,0,0,0,0,0,0,0,0,0
20200316,05517P,臻鼎元大96售01,6.65,6.75,5.95,6.75,0.00,0.00,47000,4,309550,0,0,0,0,0,0,42000,5000,37000,37000
20200316,055180,文曄統一97購01,0.77,0.77,0.67,0.67,+0.06,9.84,16000,2,10820,0,0,0,0,0,0,16000,0,16000,16000
20200316,055181,日電貿統一97購01,,,,,0.00,0.00,0,0,0,0,0,0,0,0,0,0,0,0,0
20200316,055182,京鼎統一98購01,,,,,0.00,0.00,0,0,0,0,0,0,0,0,0,0,0,0,0
20200316,055183,聯鈞統一97購01,1.14,1.14,1.14,1.14,+0.24,26.67,10000,1,11400,0,0,0,0,0,0,10000,0,10000,10000
20200316,055184,群創統一98購02,,,,,0.00,0.00,0,0,0,0,0,0,0,0,0,0,0,0,0
20200316,055185,晶相光統一97購01,,,,,0.00,0.00,0,0,0,0,0,0,0,0,0,0,0,0,0
20200316,055186,正文統一97購01,,,,,0.00,0.00,0,0,0,0,0,0,0,0,0,0,0,0,0
20200316,055187,彩晶統一98購01,0.16,0.16,0.16,0.16,0.00,0.00,10000,1,1600,0,0,0,0,0,0,0,10000,-10000,-10000
20200316,055188,亞翔統一97購01,,,,,0.00,0.00,0,0,0,0,0,0,0,0,0,0,0,0,0
20200316,055189,台虹統一97購01,0.95,0.95,0.95,0.95,+0.13,15.85,10000,1,9500,0,0,0,0,0,0,10000,0,10000,10000
20200316,05518P,T50反1凱基98售03,,,,,0.00,0.00,0,0,0,0,0,0,0,0,0,0,0,0,0
20200316,055190,華新科元富97購01,0.07,0.08,0.05,0.08,+0.02,33.33,281000,14,16680,0,0,0,0,0,0,100000,100000,0,0
20200316,055191,牧德元富97購01,0.36,0.37,0.36,0.37,+0.07,23.33,10000,2,3630,0,0,0,0,0,0,10000,0,10000,10000
20200316,055192,世芯元富97購01,0.30,0.30,0.18,0.18,-0.09,-33.33,225000,15,45850,0,0,0,0,0,0,125000,100000,25000,25000
20200316,055193,世芯元富97購02,0.43,0.44,0.24,0.25,-0.18,-41.86,675000,52,215810,0,0,0,0,0,0,232000,401000,-169000,-169000
20200316,055194,昇陽半元富97購01,,,,,0.00,0.00,0,0,0,0,0,0,0,0,0,0,0,0,0
20200316,055195,昇陽半元富97購02,,,,,0.00,0.00,0,0,0,0,0,0,0,0,0,0,0,0,0
20200316,055196,致新元富97購01,0.38,0.38,0.38,0.38,+0.12,46.15,10000,1,3800,0,0,0,0,0,0,10000,0,10000,10000
20200316,055197,致新元富97購02,,,,,0.00,0.00,0,0,0,0,0,0,0,0,0,0,0,0,0
20200316,055198,奇力新第一97購01,0.07,0.07,0.07,0.07,0.00,0.00,50000,1,3500,0,0,0,0,0,0,0,0,0,0
20200316,055199,國喬群益97購01,,,,,0.00,0.00,0,0,0,0,0,0,0,0,0,0,0,0,0
20200316,05519P,上証2X凱基98售01,2.32,2.59,2.32,2.58,+0.42,19.44,35000,3,86500,0,0,0,0,0,0,15000,20000,-5000,-5000
20200316,055200,和大群益98購01,0.21,0.21,0.16,0.16,-0.01,-5.88,84000,5,16730,0,0,0,0,0,0,12000,72000,-60000,-60000
20200316,055201,興勤群益98購01,,,,,0.00,0.00,0,0,0,0,0,0,0,0,0,0,0,0,0
20200316,055202,神達群益97購01,0.68,0.69,0.51,0.51,-0.02,-3.77,217000,9,114300,0,0,0,0,0,0,156000,60000,96000,96000
20200316,055203,建準中信97購01,,,,,0.00,0.00,0,0,0,0,0,0,0,0,0,0,0,0,0
20200316,055204,宏達電中信99購01,,,,,0.00,0.00,0,0,0,0,0,0,0,0,0,0,0,0,0
20200316,055205,京鼎中信99購01,,,,,0.00,0.00,0,0,0,0,0,0,0,0,0,0,0,0,0
20200316,055206,台虹中信97購01,0.27,0.27,0.26,0.26,+0.01,4.0,20000,2,5300,0,0,0,0,0,0,10000,10000,0,0
20200316,055207,致新中信99購01,0.14,0.14,0.14,0.14,+0.01,7.69,20000,1,2800,0,0,0,0,0,0,20000,0,20000,20000
20200316,055208,京鼎康和97購02,,,,,0.00,0.00,0,0,0,0,0,0,0,0,0,0,0,0,0
20200316,055209,勤誠康和97購01,0.42,0.46,0.35,0.35,-0.09,-20.45,295000,13,125290,0,0,0,0,0,0,130000,165000,-35000,-35000
20200316,05520P,聯詠凱基96售01,,,,,0.00,0.00,0,0,0,0,0,0,0,0,0,0,0,0,0
20200316,055210,S&P正2凱基97購01,0.06,0.08,0.03,0.08,-0.02,-20.0,142000,6,8320,0,0,0,0,0,0,0,0,0,0
20200316,055211,A50反1凱基9A購01,1.05,1.16,1.04,1.16,+0.16,16.0,858000,31,946240,0,0,0,0,0,0,428000,425000,3000,3000
20200316,055212,和大凱基97購02,,,,,0.00,0.00,0,0,0,0,0,0,0,0,0,0,0,0,0
20200316,055213,大成鋼凱基98購01,0.39,0.40,0.37,0.37,-0.02,-5.13,645000,8,250030,0,0,0,0,0,0,0,645000,-645000,-645000
20200316,055214,聯電凱基97購02,0.24,0.25,0.24,0.24,-0.06,-20.0,10000,3,2460,0,0,0,0,0,0,6000,10000,-4000,-4000
20200316,055215,智邦凱基98購02,,,,,0.00,0.00,0,0,0,0,0,0,0,0,0,0,0,0,0
20200316,055216,友達凱基98購05,0.52,0.52,0.52,0.52,0.00,0.00,200000,2,104000,0,0,0,0,0,0,0,200000,-200000,-200000
20200316,055217,緯創凱基97購02,,,,,0.00,0.00,0,0,0,0,0,0,0,0,0,0,0,0,0
20200316,055218,彩晶凱基99購01,,,,,0.00,0.00,0,0,0,0,0,0,0,0,0,0,0,0,0
20200316,055219,啟碁凱基98購01,,,,,0.00,0.00,0,0,0,0,0,0,0,0,0,0,0,0,0
20200316,05521P,創意永豐96售01,,,,,0.00,0.00,0,0,0,0,0,0,0,0,0,0,0,0,0
20200316,055220,緯穎凱基98購02,1.75,1.75,1.62,1.62,+0.47,40.87,55000,3,90600,0,0,0,0,0,0,55000,10000,45000,45000
20200316,055221,矽創凱基97購02,0.53,0.57,0.53,0.56,+0.12,27.27,12000,5,6630,0,0,0,0,0,0,12000,0,12000,12000
20200316,055222,臺股指凱基97購05,0.02,0.03,0.02,0.02,-0.03,-60.0,694000,45,15580,0,0,0,0,0,0,99000,400000,-301000,-301000
20200316,055223,和大國票98購01,0.08,0.08,0.07,0.07,+0.01,16.67,6856000,14,484910,0,0,0,0,0,0,6856000,0,6856000,6856000
20200316,055224,鴻海國票99購02,0.07,0.07,0.06,0.06,0.00,0.00,200000,4,13000,0,0,0,0,0,0,0,0,0,0
20200316,055225,華邦電國票99購01,,,,,0.00,0.00,0,0,0,0,0,0,0,0,0,0,0,0,0
20200316,055226,聯發科國票97購05,,,,,0.00,0.00,0,0,0,0,0,0,0,0,0,0,0,0,0
20200316,055227,聯發科國票98購02,0.27,0.27,0.22,0.22,-0.03,-12.0,10000,2,2450,0,0,0,0,0,0,0,10000,-10000,-10000
20200316,055228,聯發科國票98購03,0.22,0.22,0.22,0.22,+0.04,22.22,110000,1,24200,0,0,0,0,0,0,110000,0,110000,110000
20200316,055229,大毅國票97購02,2.26,2.26,2.26,2.26,+0.03,1.35,18000,2,40680,0,0,0,0,0,0,10000,8000,2000,2000
20200316,05522P,友達元富96售02,1.11,1.28,1.09,1.19,+0.04,3.48,26000,11,29540,0,0,0,0,0,0,26000,0,26000,26000
20200316,055230,大毅國票98購01,2.76,2.87,2.65,2.74,+0.03,1.11,174000,6,473680,0,0,0,0,0,0,174000,0,174000,174000
20200316,055231,大毅國票98購02,1.97,2.19,1.97,2.19,+0.25,12.89,20000,2,41600,0,0,0,0,0,0,20000,0,20000,20000
20200316,055232,泰碩國票98購01,1.17,1.20,0.92,0.92,-0.23,-20.0,133000,6,138190,0,0,0,0,0,0,131000,0,131000,131000
20200316,055233,康友國票98購01,0.59,0.59,0.32,0.32,-0.30,-48.39,55000,9,25570,0,0,0,0,0,0,23000,32000,-9000,-9000
20200316,055234,昇陽半國票98購02,,,,,0.00,0.00,0,0,0,0,0,0,0,0,0,0,0,0,0
20200316,055235,金寶台新98購01,0.46,0.48,0.37,0.37,-0.11,-22.92,198000,5,80840,0,0,0,0,0,0,160000,38000,122000,122000
20200316,055236,建準台新98購01,,,,,0.00,0.00,0,0,0,0,0,0,0,0,0,0,0,0,0
20200316,055237,晶豪科台新97購01,0.23,0.23,0.23,0.23,+0.01,4.55,50000,1,11500,0,0,0,0,0,0,50000,0,50000,50000
20200316,055238,茂林台新97購01,0.29,0.29,0.29,0.29,+0.03,11.54,89000,1,25810,0,0,0,0,0,0,89000,89000,0,0
20200316,055239,帆宣台新97購01,,,,,0.00,0.00,0,0,0,0,0,0,0,0,0,0,0,0,0
20200316,05523P,聯發科國票96售04,,,,,0.00,0.00,0,0,0,0,0,0,0,0,0,0,0,0,0
20200316,055240,京元電元富97購01,0.42,0.46,0.34,0.39,+0.12,44.44,133000,29,56760,0,0,0,0,0,0,0,133000,-133000,-133000
20200316,055241,T50反1統一99購01,1.71,1.88,1.71,1.88,-0.03,-1.57,30000,2,54700,0,0,0,0,0,0,10000,0,10000,10000
20200316,055242,道瓊銀統一98購01,,,,,0.00,0.00,0,0,0,0,0,0,0,0,0,0,0,0,0
20200316,055243,國巨統一97購04,0.21,0.21,0.11,0.11,0.00,0.00,20000,3,2700,0,0,0,0,0,0,0,20000,-20000,-20000
20200316,055244,國巨統一98購01,,,,,0.00,0.00,0,0,0,0,0,0,0,0,0,0,0,0,0
20200316,055245,凱美統一99購01,,,,,0.00,0.00,0,0,0,0,0,0,0,0,0,0,0,0,0
20200316,055246,美律統一98購01,,,,,0.00,0.00,0,0,0,0,0,0,0,0,0,0,0,0,0
20200316,055247,聯發科統一98購01,,,,,0.00,0.00,0,0,0,0,0,0,0,0,0,0,0,0,0
20200316,055248,可成統一97購02,,,,,0.00,0.00,0,0,0,0,0,0,0,0,0,0,0,0,0
20200316,055249,大毅統一99購01,0.65,0.65,0.42,0.42,-0.18,-30.0,181000,12,93900,0,0,0,0,0,0,83000,64000,19000,19000
20200316,05524P,瀚宇博國票97售02,,,,,0.00,0.00,0,0,0,0,0,0,0,0,0,0,0,0,0
20200316,055250,華新科統一97購02,,,,,0.00,0.00,0,0,0,0,0,0,0,0,0,0,0,0,0
20200316,055251,華新科統一99購01,,,,,0.00,0.00,0,0,0,0,0,0,0,0,0,0,0,0,0
20200316,055252,新光金統一98購02,,,,,0.00,0.00,0,0,0,0,0,0,0,0,0,0,0,0,0
20200316,055253,大立光統一97購06,0.31,0.31,0.31,0.31,+0.01,3.33,75000,1,23250,0,0,0,0,0,0,75000,0,75000,75000
20200316,055254,聯詠統一97購03,,,,,0.00,0.00,0,0,0,0,0,0,0,0,0,0,0,0,0
20200316,055255,欣興統一97購02,0.08,0.08,0.08,0.08,0.00,0.00,24000,1,1920,0,0,0,0,0,0,24000,0,24000,24000
20200316,055256,日電貿統一99購01,,,,,0.00,0.00,0,0,0,0,0,0,0,0,0,0,0,0,0
20200316,055257,景碩統一97購01,,,,,0.00,0.00,0,0,0,0,0,0,0,0,0,0,0,0,0
20200316,055258,玉晶光統一97購03,0.16,0.16,0.16,0.16,0.00,0.00,15000,2,2400,0,0,0,0,0,0,15000,0,15000,15000
20200316,055259,玉晶光統一9A購01,0.37,0.37,0.36,0.36,0.00,0.00,84000,4,30880,0,0,0,0,0,0,64000,20000,44000,44000
20200316,05525P,奇力新群益96售02,,,,,0.00,0.00,0,0,0,0,0,0,0,0,0,0,0,0,0
20200316,055260,晶相光統一98購01,,,,,0.00,0.00,0,0,0,0,0,0,0,0,0,0,0,0,0
20200316,055261,帆宣統一98購01,0.33,0.33,0.33,0.33,+0.02,6.45,5000,2,1650,0,0,0,0,0,0,5000,0,5000,5000
20200316,055262,台虹國泰98購01,0.79,0.82,0.65,0.65,-0.19,-22.62,226000,3,170380,0,0,0,0,0,0,157000,69000,88000,88000
20200316,055263,華新科富邦9A購01,0.15,0.15,0.08,0.14,-0.01,-6.67,50000,6,5460,0,0,0,0,0,0,0,0,0,0
20200316,055264,國巨永豐98購01,0.17,0.17,0.17,0.17,-0.05,-22.73,5000,1,850,0,0,0,0,0,0,0,5000,-5000,-5000
20200316,055265,玉晶光永豐98購03,0.14,0.14,0.10,0.10,-0.05,-33.33,65000,2,6700,0,0,0,0,0,0,60000,5000,55000,55000
20200316,055266,京鼎永豐97購01,,,,,0.00,0.00,0,0,0,0,0,0,0,0,0,0,0,0,0
20200316,055267,百和永豐97購01,,,,,0.00,0.00,0,0,0,0,0,0,0,0,0,0,0,0,0
20200316,055268,和大元大97購01,0.15,0.15,0.15,0.15,0.00,0.00,10000,1,1500,0,0,0,0,0,0,0,10000,-10000,-10000
20200316,055269,和大元大97購02,0.17,0.18,0.17,0.18,+0.03,20.0,20000,4,3530,0,0,0,0,0,0,20000,0,20000,20000
20200316,05526P,茂林群益96售03,,,,,0.00,0.00,0,0,0,0,0,0,0,0,0,0,0,0,0
20200316,055270,上銀元大97購03,1.10,1.19,0.77,0.80,-0.20,-20.0,69000,6,64820,0,0,0,0,0,0,69000,48000,21000,21000
20200316,055271,鴻海元大98購03,0.31,0.34,0.31,0.34,-0.03,-8.11,90000,5,28800,0,0,0,0,0,0,50000,40000,10000,10000
20200316,055272,國巨元大98購04,0.34,0.34,0.22,0.25,-0.09,-26.47,117000,12,36820,0,0,0,0,0,0,50000,52000,-2000,-2000
20200316,055273,華泰元大97購01,,,,,0.00,0.00,0,0,0,0,0,0,0,0,0,0,0,0,0
20200316,055274,華泰元大97購02,,,,,0.00,0.00,0,0,0,0,0,0,0,0,0,0,0,0,0
20200316,055275,台積電元大97購19,0.30,0.30,0.20,0.23,-0.08,-25.81,313000,15,71450,0,0,0,0,0,0,138000,10000,128000,128000
20200316,055276,台積電元大97購20,0.37,0.38,0.23,0.23,-0.15,-39.47,512000,28,143450,0,0,0,0,0,0,321000,0,321000,321000
20200316,055277,旺宏元大97購04,0.12,0.14,0.06,0.06,-0.05,-45.45,175000,21,18080,0,0,0,0,0,0,10000,165000,-155000,-155000
20200316,055278,旺宏元大98購05,0.23,0.23,0.23,0.23,0.00,0.00,55000,1,12650,0,0,0,0,0,0,55000,0,55000,55000
20200316,055279,華邦電元大97購02,,,,,0.00,0.00,0,0,0,0,0,0,0,0,0,0,0,0,0
20200316,05527P,聯茂群益96售01,1.79,2.01,1.73,2.01,-0.09,-4.29,16000,4,29800,0,0,0,0,0,0,5000,12000,-7000,-7000
20200316,055280,智邦元大97購01,2.06,2.31,2.02,2.06,-0.12,-5.5,36000,6,74570,0,0,0,0,0,0,31000,14000,17000,17000
20200316,055281,台光電元大98購03,0.27,0.28,0.27,0.28,-0.01,-3.45,52000,2,14160,0,0,0,0,0,0,52000,0,52000,52000
20200316,055282,聯發科元大97購15,0.28,0.30,0.15,0.15,-0.05,-25.0,129000,13,29110,0,0,0,0,0,0,25000,104000,-79000,-79000
20200316,055283,聯發科元大97購16,0.29,0.30,0.17,0.17,-0.18,-51.43,609000,35,154820,0,0,0,0,0,0,315000,294000,21000,21000
20200316,055284,全新元大99購01,0.09,0.09,0.09,0.09,0.00,0.00,1000,1,90,0,0,0,0,0,0,0,1000,-1000,-1000
20200316,055285,華新科元大99購03,0.18,0.18,0.18,0.18,+0.04,28.57,10000,1,1800,0,0,0,0,0,0,10000,0,10000,10000
20200316,055286,晶技元大98購03,0.79,0.84,0.79,0.84,+0.16,23.53,70000,4,58300,0,0,0,0,0,0,70000,8000,62000,62000
20200316,055287,日電貿元大97購01,,,,,0.00,0.00,0,0,0,0,0,0,0,0,0,0,0,0,0
20200316,055288,日電貿元大97購02,0.50,0.58,0.40,0.41,-0.05,-10.87,16000,5,7390,0,0,0,0,0,0,9000,7000,2000,2000
20200316,055289,泰碩元大98購01,0.67,0.72,0.53,0.53,-0.12,-18.46,807000,66,536670,0,0,0,0,0,0,623000,399000,224000,224000
20200316,05528P,臺股指群益96售01,,,,,0.00,0.00,0,0,0,0,0,0,0,0,0,0,0,0,0
20200316,055290,玉晶光元大98購08,0.18,0.18,0.14,0.14,-0.08,-36.36,57000,7,9190,0,0,0,0,0,0,4000,53000,-49000,-49000
20200316,055291,京鼎元大97購02,0.38,0.39,0.32,0.32,-0.07,-17.95,88000,4,32540,0,0,0,0,0,0,58000,30000,28000,28000
20200316,055292,聯鈞元大97購02,1.20,1.20,0.93,0.93,-0.25,-21.19,90000,10,94900,0,0,0,0,0,0,10000,80000,-70000,-70000
20200316,055293,晶相光元大97購01,0.79,0.79,0.48,0.48,-0.16,-25.0,25000,3,15500,0,0,0,0,0,0,10000,25000,-15000,-15000
20200316,055294,智易元大98購01,0.15,0.16,0.12,0.12,-0.03,-20.0,230000,13,31600,0,0,0,0,0,0,130000,100000,30000,30000
20200316,055295,瀚宇博元大97購02,,,,,0.00,0.00,0,0,0,0,0,0,0,0,0,0,0,0,0
20200316,055296,康舒元大97購02,0.44,0.44,0.35,0.35,-0.11,-23.91,51000,3,20910,0,0,0,0,0,0,36000,15000,21000,21000
20200316,055297,啟碁元大97購01,,,,,0.00,0.00,0,0,0,0,0,0,0,0,0,0,0,0,0
20200316,055298,啟碁元大97購02,,,,,0.00,0.00,0,0,0,0,0,0,0,0,0,0,0,0,0
20200316,055299,康友元大97購02,,,,,0.00,0.00,0,0,0,0,0,0,0,0,0,0,0,0,0
20200316,05529P,臺股指群益96售02,,,,,0.00,0.00,0,0,0,0,0,0,0,0,0,0,0,0,0
20200316,055300,緯穎元大98購01,1.93,1.93,1.49,1.49,-0.24,-13.87,363000,44,619930,0,0,0,0,0,0,298000,105000,193000,193000
20200316,055301,台虹元大97購01,0.96,1.06,0.96,1.06,+0.27,34.18,36000,8,35790,0,0,0,0,0,0,36000,0,36000,36000
20200316,055302,達方元大97購01,0.37,0.37,0.30,0.30,0.00,0.00,41000,3,13180,0,0,0,0,0,0,31000,10000,21000,21000
20200316,055303,鈺齊元大97購01,0.13,0.13,0.09,0.09,-0.03,-25.0,115000,12,13200,0,0,0,0,0,0,0,115000,-115000,-115000
20200316,055304,瑞昱第一98購01,0.17,0.17,0.15,0.15,-0.03,-16.67,20000,2,3200,0,0,0,0,0,0,0,20000,-20000,-20000
20200316,055305,旺宏群益99購01,,,,,0.00,0.00,0,0,0,0,0,0,0,0,0,0,0,0,0
20200316,055306,燿華群益97購01,,,,,0.00,0.00,0,0,0,0,0,0,0,0,0,0,0,0,0
20200316,055307,瑞昱群益97購02,0.23,0.23,0.23,0.23,-0.19,-45.24,20000,2,4600,0,0,0,0,0,0,0,20000,-20000,-20000
20200316,055308,聯發科群益97購04,,,,,0.00,0.00,0,0,0,0,0,0,0,0,0,0,0,0,0
20200316,055309,冠德群益97購01,0.04,0.04,0.03,0.03,0.00,0.00,20000,2,700,0,0,0,0,0,0,0,20000,-20000,-20000
20200316,05530P,臺股指群益96售03,,,,,0.00,0.00,0,0,0,0,0,0,0,0,0,0,0,0,0
20200316,055310,聯詠群益97購02,0.46,0.56,0.46,0.46,-0.14,-23.33,60000,4,29600,0,0,0,0,0,0,30000,30000,0,0
20200316,055311,健策群益98購02,0.18,0.23,0.18,0.23,+0.01,4.55,9000,2,1670,0,0,0,0,0,0,8000,0,8000,8000
20200316,055312,台虹群益99購01,,,,,0.00,0.00,0,0,0,0,0,0,0,0,0,0,0,0,0
20200316,055313,南電群益97購01,1.26,1.26,1.08,1.08,+0.12,12.5,40000,2,45900,0,0,0,0,0,0,25000,15000,10000,10000
20200316,055314,華邦電中信99購01,,,,,0.00,0.00,0,0,0,0,0,0,0,0,0,0,0,0,0
20200316,055315,晶技麥證97購01,0.70,0.70,0.52,0.52,+0.01,1.96,25000,3,14300,5000,20000,-15000,0,0,0,5000,20000,-15000,-15000
20200316,055316,上銀國票98購01,0.19,0.19,0.18,0.18,-0.17,-48.57,30000,2,5600,0,0,0,0,0,0,0,10000,-10000,-10000
20200316,055317,金寶國票98購01,,,,,0.00,0.00,0,0,0,0,0,0,0,0,0,0,0,0,0
20200316,055318,華通國票98購01,,,,,0.00,0.00,0,0,0,0,0,0,0,0,0,0,0,0,0
20200316,055319,國巨國票98購03,0.47,0.47,0.19,0.19,-0.16,-45.71,509000,2,99510,0,0,0,0,0,0,499000,0,499000,499000
20200316,05531P,臺股指群益96售04,6.00,6.70,6.00,6.70,+1.05,18.58,28000,9,176850,0,0,0,0,0,0,18000,0,18000,18000
20200316,055320,建準國票98購01,,,,,0.00,0.00,0,0,0,0,0,0,0,0,0,0,0,0,0
20200316,055321,大立光國票98購02,0.28,0.28,0.28,0.28,+0.05,21.74,50000,1,14000,0,0,0,0,0,0,50000,0,50000,50000
20200316,055322,欣興國票97購06,0.20,0.21,0.08,0.08,-0.13,-61.9,158000,18,16100,0,0,0,0,0,0,0,158000,-158000,-158000
20200316,055323,貿聯國票98購01,0.19,0.19,0.19,0.19,-0.02,-9.52,10000,1,1900,0,0,0,0,0,0,10000,0,10000,10000
20200316,055324,TPK國票98購03,0.26,0.26,0.26,0.26,+0.02,8.33,5000,1,1300,0,0,0,0,0,0,5000,0,5000,5000
20200316,055325,佐登國票98購01,,,,,0.00,0.00,0,0,0,0,0,0,0,0,0,0,0,0,0
20200316,055326,緯穎國票97購06,3.52,3.52,3.52,3.52,+0.42,13.55,10000,1,35200,0,0,0,0,0,0,10000,0,10000,10000
20200316,055327,致新國票98購01,0.63,0.63,0.45,0.45,0.00,0.00,57000,2,32310,0,0,0,0,0,0,57000,0,57000,57000
20200316,055328,鈺齊國票98購01,,,,,0.00,0.00,0,0,0,0,0,0,0,0,0,0,0,0,0
20200316,055329,百和國票98購01,,,,,0.00,0.00,0,0,0,0,0,0,0,0,0,0,0,0,0
20200316,05532P,臺股指群益96售05,6.30,6.90,6.25,6.90,+1.30,23.21,36000,12,234750,0,0,0,0,0,0,36000,0,36000,36000
20200316,055330,上銀兆豐98購02,0.79,0.87,0.54,0.54,-0.32,-37.21,193000,8,149170,0,0,0,0,0,0,88000,105000,-17000,-17000
20200316,055331,國巨兆豐99購01,0.41,0.41,0.40,0.40,0.00,0.00,90000,2,36400,0,0,0,0,0,0,90000,0,90000,90000
20200316,055332,奇力新兆豐98購01,,,,,0.00,0.00,0,0,0,0,0,0,0,0,0,0,0,0,0
20200316,055333,晶豪科兆豐97購01,0.60,0.63,0.57,0.57,+0.05,9.62,87000,4,52950,0,0,0,0,0,0,62000,25000,37000,37000
20200316,055334,禾伸堂兆豐97購01,0.71,0.74,0.71,0.74,+0.08,12.12,138000,4,100290,0,0,0,0,0,0,84000,54000,30000,30000
20200316,055335,健策兆豐98購01,,,,,0.00,0.00,0,0,0,0,0,0,0,0,0,0,0,0,0
20200316,055336,茂林兆豐98購01,0.47,0.47,0.31,0.31,-0.16,-34.04,322000,28,134910,0,0,0,0,0,0,310000,12000,298000,298000
20200316,055337,超眾兆豐98購01,0.14,0.14,0.13,0.13,+0.01,8.33,100000,3,13500,0,0,0,0,0,0,70000,30000,40000,40000
20200316,055338,GIS兆豐97購01,,,,,0.00,0.00,0,0,0,0,0,0,0,0,0,0,0,0,0
20200316,055339,緯穎兆豐98購01,3.58,3.58,3.44,3.44,+0.97,39.27,8000,5,28320,0,0,0,0,0,0,6000,2000,4000,4000
20200316,05533P,滬深2X富邦97售01,1.45,1.62,1.45,1.62,+0.41,33.88,30000,3,45200,0,0,0,0,0,0,20000,10000,10000,10000
20200316,055340,華新科日盛97購01,0.05,0.05,0.05,0.05,-0.06,-54.55,7000,1,350,0,0,0,0,0,0,7000,0,7000,7000
20200316,055341,台達電凱基97購02,0.21,0.21,0.15,0.15,-0.07,-31.82,409000,4,64950,0,0,0,0,0,0,110000,299000,-189000,-189000
20200316,055342,鴻海凱基97購04,0.32,0.32,0.25,0.25,0.00,0.00,421000,14,122950,0,0,0,0,0,0,421000,0,421000,421000
20200316,055343,國巨凱基97購03,0.61,0.61,0.58,0.58,0.00,0.00,410000,5,246800,0,0,0,0,0,0,0,410000,-410000,-410000
20200316,055344,國巨凱基97購04,0.81,0.81,0.81,0.81,+0.04,5.19,78000,1,63180,0,0,0,0,0,0,78000,0,78000,78000
20200316,055345,國巨凱基98購01,0.23,0.23,0.17,0.17,-0.03,-15.0,11000,2,2470,0,0,0,0,0,0,0,1000,-1000,-1000
20200316,055346,國巨凱基98購02,0.34,0.34,0.34,0.34,-0.01,-2.86,21000,1,7140,0,0,0,0,0,0,21000,0,21000,21000
20200316,055347,台積電凱基97購10,,,,,0.00,0.00,0,0,0,0,0,0,0,0,0,0,0,0,0
20200316,055348,旺宏凱基97購01,,,,,0.00,0.00,0,0,0,0,0,0,0,0,0,0,0,0,0
20200316,055349,京元電凱基97購02,0.41,0.55,0.39,0.39,+0.10,34.48,554000,41,248360,0,0,0,0,0,0,230000,324000,-94000,-94000
20200316,05534P,元油反元大96售06,,,,,0.00,0.00,0,0,0,0,0,0,0,0,0,0,0,0,0
20200316,055350,聯發科凱基97購02,0.28,0.31,0.19,0.19,+0.05,35.71,205000,17,58750,0,0,0,0,0,0,200000,5000,195000,195000
20200316,055351,聯發科凱基97購03,0.70,0.70,0.59,0.59,0.00,0.00,20000,2,12900,0,0,0,0,0,0,0,20000,-20000,-20000
20200316,055352,奇力新凱基97購01,,,,,0.00,0.00,0,0,0,0,0,0,0,0,0,0,0,0,0
20200316,055353,華新科凱基98購03,,,,,0.00,0.00,0,0,0,0,0,0,0,0,0,0,0,0,0
20200316,055354,宏達電凱基98購01,0.30,0.30,0.29,0.29,0.00,0.00,500000,3,147000,0,0,0,0,0,0,0,500000,-500000,-500000
20200316,055355,大立光凱基97購05,0.49,0.49,0.28,0.28,-0.22,-44.0,475000,10,145820,0,0,0,0,0,0,414000,31000,383000,383000
20200316,055356,大立光凱基97購06,0.83,0.83,0.53,0.53,-0.30,-36.14,128000,7,86400,0,0,0,0,0,0,68000,60000,8000,8000
20200316,055357,欣興凱基97購04,,,,,0.00,0.00,0,0,0,0,0,0,0,0,0,0,0,0,0
20200316,055358,臻鼎凱基97購01,0.26,0.36,0.26,0.26,+0.07,36.84,149000,7,45440,0,0,0,0,0,0,14000,135000,-121000,-121000
20200316,055359,超眾凱基97購01,,,,,0.00,0.00,0,0,0,0,0,0,0,0,0,0,0,0,0
20200316,05535P,台積電元大97售06,3.66,4.72,3.66,4.60,+0.08,1.77,87000,13,387150,0,0,0,0,0,0,52000,85000,-33000,-33000
20200316,055360,台表科凱基97購02,0.30,0.30,0.30,0.30,0.00,0.00,100000,1,30000,0,0,0,0,0,0,0,100000,-100000,-100000
20200316,055361,樺漢凱基97購01,,,,,0.00,0.00,0,0,0,0,0,0,0,0,0,0,0,0,0
20200316,055362,GIS凱基97購03,0.21,0.21,0.17,0.17,0.00,0.00,150000,2,29500,0,0,0,0,0,0,0,150000,-150000,-150000
20200316,055363,緯穎凱基98購03,2.07,2.28,1.89,1.89,-0.21,-10.0,1336000,94,2673900,0,0,0,0,0,0,169000,1259000,-1090000,-1090000
20200316,055364,矽創凱基97購03,0.13,0.13,0.13,0.13,+0.04,44.44,2000,1,260,0,0,0,0,0,0,2000,0,2000,2000
20200316,055365,華通元大97購03,0.59,0.62,0.44,0.44,-0.09,-16.98,55000,5,30540,0,0,0,0,0,0,34000,45000,-11000,-11000
20200316,055366,國巨元大98購05,0.73,0.74,0.73,0.74,+0.11,17.46,40000,2,29300,0,0,0,0,0,0,30000,10000,20000,20000
20200316,055367,台積電元大97購23,0.84,0.90,0.52,0.53,-0.45,-45.92,1404000,91,951950,0,0,0,0,0,0,727000,674000,53000,53000
20200316,055368,台積電元大97購24,0.45,0.48,0.26,0.26,-0.19,-42.22,139000,17,46580,0,0,0,0,0,0,20000,29000,-9000,-9000
20200316,055369,友訊元大97購01,0.29,0.29,0.22,0.23,-0.07,-23.33,1030000,101,253700,0,0,0,0,0,0,0,1000000,-1000000,-1000000
20200316,05536P,奇力新元大96售03,1.01,1.34,0.98,1.34,+0.17,14.53,259000,34,314700,0,0,0,0,0,0,49000,210000,-161000,-161000
20200316,055370,旺宏元大97購05,0.06,0.06,0.06,0.06,0.00,0.00,10000,1,600,0,0,0,0,0,0,0,10000,-10000,-10000
20200316,055371,正崴元大97購02,0.18,0.19,0.14,0.14,-0.01,-6.67,260000,11,44250,0,0,0,0,0,0,208000,60000,148000,148000
20200316,055372,宏達電元大97購04,0.18,0.21,0.10,0.10,-0.11,-52.38,260000,26,47930,0,0,0,0,0,0,40000,220000,-180000,-180000
20200316,055373,聯詠元大97購03,1.00,1.11,0.87,0.87,-0.24,-21.62,185000,19,185580,0,0,0,0,0,0,84000,95000,-11000,-11000
20200316,055374,明泰元大97購01,0.68,0.68,0.58,0.58,-0.03,-4.92,20000,2,12600,0,0,0,0,0,0,0,20000,-20000,-20000
20200316,055375,京鼎元大97購03,,,,,0.00,0.00,0,0,0,0,0,0,0,0,0,0,0,0,0
20200316,055376,群創元大01購01,0.65,0.71,0.61,0.61,-0.05,-7.58,285000,24,191330,0,0,0,0,0,0,124000,161000,-37000,-37000
20200316,055377,揚明光元大98購01,0.29,0.29,0.29,0.29,0.00,0.00,20000,1,5800,0,0,0,0,0,0,20000,0,20000,20000
20200316,055378,晶相光元大97購02,0.64,0.64,0.43,0.43,-0.22,-33.85,31000,5,15790,0,0,0,0,0,0,10000,21000,-11000,-11000
20200316,055379,牧德元大97購03,0.11,0.11,0.10,0.10,-0.05,-33.33,21000,2,2300,0,0,0,0,0,0,20000,1000,19000,19000
20200316,05537P,群創中信98售01,,,,,0.00,0.00,0,0,0,0,0,0,0,0,0,0,0,0,0
20200316,055380,智易元大98購02,0.21,0.21,0.20,0.20,-0.02,-9.09,50000,6,10150,0,0,0,0,0,0,0,50000,-50000,-50000
20200316,055381,茂林元大97購02,1.37,1.37,0.92,0.92,-0.58,-38.67,245000,15,291900,0,0,0,0,0,0,215000,80000,135000,135000
20200316,055382,台郡元大99購01,1.39,1.39,1.27,1.27,0.00,0.00,15000,2,20250,0,0,0,0,0,0,0,15000,-15000,-15000
20200316,055383,GIS元大97購02,0.20,0.28,0.20,0.21,+0.03,16.67,53000,8,13380,0,0,0,0,0,0,10000,43000,-33000,-33000
20200316,055384,緯穎元大98購02,1.98,1.98,1.55,1.55,-0.21,-11.93,71000,9,129010,0,0,0,0,0,0,59000,61000,-2000,-2000
20200316,055385,昇陽半元大98購01,0.26,0.26,0.16,0.17,-0.06,-26.09,90000,7,16000,0,0,0,0,0,0,70000,20000,50000,50000
20200316,055386,致新元大97購02,0.34,0.35,0.25,0.25,-0.10,-28.57,50000,5,14600,0,0,0,0,0,0,20000,30000,-10000,-10000
20200316,055387,世紀鋼元大97購01,2.45,2.46,2.26,2.46,+0.25,11.31,180000,19,432400,0,0,0,0,0,0,120000,60000,60000,60000
20200316,055388,華通統一97購03,,,,,0.00,0.00,0,0,0,0,0,0,0,0,0,0,0,0,0
20200316,055389,國巨統一98購02,,,,,0.00,0.00,0,0,0,0,0,0,0,0,0,0,0,0,0
20200316,05538P,玉晶光國票97售02,3.60,4.51,3.60,4.51,+1.02,29.23,113000,4,498400,0,0,0,0,0,0,100000,13000,87000,87000
20200316,055390,國巨統一98購03,,,,,0.00,0.00,0,0,0,0,0,0,0,0,0,0,0,0,0
20200316,055391,光罩統一97購02,,,,,0.00,0.00,0,0,0,0,0,0,0,0,0,0,0,0,0
20200316,055392,凱美統一97購03,,,,,0.00,0.00,0,0,0,0,0,0,0,0,0,0,0,0,0
20200316,055393,華新科統一97購03,0.29,0.29,0.29,0.29,+0.06,26.09,143000,1,41470,0,0,0,0,0,0,143000,0,143000,143000
20200316,055394,健策統一97購01,,,,,0.00,0.00,0,0,0,0,0,0,0,0,0,0,0,0,0
20200316,055395,泰鼎統一97購01,,,,,0.00,0.00,0,0,0,0,0,0,0,0,0,0,0,0,0
20200316,055396,瑞儀統一97購01,,,,,0.00,0.00,0,0,0,0,0,0,0,0,0,0,0,0,0
20200316,055397,超眾統一97購02,,,,,0.00,0.00,0,0,0,0,0,0,0,0,0,0,0,0,0
20200316,055398,超眾統一97購03,0.19,0.19,0.19,0.19,0.00,0.00,31000,1,5890,0,0,0,0,0,0,31000,0,31000,31000
20200316,055399,超眾統一99購01,0.11,0.11,0.11,0.11,+0.01,10.0,15000,1,1650,0,0,0,0,0,0,0,15000,-15000,-15000
20200316,05539P,鎧勝永豐96售01,,,,,0.00,0.00,0,0,0,0,0,0,0,0,0,0,0,0,0
20200316,055400,緯穎統一97購01,,,,,0.00,0.00,0,0,0,0,0,0,0,0,0,0,0,0,0
20200316,055401,亞光元富9A購01,0.11,0.11,0.06,0.06,-0.04,-40.0,240000,9,21200,0,0,0,0,0,0,150000,90000,60000,60000
20200316,055402,正文元富97購02,,,,,0.00,0.00,0,0,0,0,0,0,0,0,0,0,0,0,0
20200316,055403,泰鼎元富97購01,1.69,1.86,1.27,1.27,-0.53,-29.44,58000,31,98060,0,0,0,0,0,0,58000,0,58000,58000
20200316,055404,超眾元富97購01,,,,,0.00,0.00,0,0,0,0,0,0,0,0,0,0,0,0,0
20200316,055405,華泰國泰98購01,0.13,0.13,0.13,0.13,-0.04,-23.53,30000,1,3900,0,0,0,0,0,0,0,30000,-30000,-30000
20200316,055406,大毅國泰99購01,0.95,1.07,0.67,0.67,-0.26,-27.96,819000,27,796750,0,0,0,0,0,0,650000,719000,-69000,-69000
20200316,055407,祥碩國泰98購01,,,,,0.00,0.00,0,0,0,0,0,0,0,0,0,0,0,0,0
20200316,055408,力成國泰98購01,1.14,1.22,1.06,1.06,-0.26,-19.7,95000,5,106480,0,0,0,0,0,0,75000,25000,50000,50000
20200316,055409,元黃金富邦01購01,0.72,0.87,0.72,0.73,-0.27,-27.0,185000,19,142000,0,0,0,0,0,0,141000,35000,106000,106000
20200316,05540P,亞德客凱基96售01,0.69,0.91,0.64,0.91,+0.01,1.11,1524000,19,1041690,0,0,0,0,0,0,200000,1324000,-1124000,-1124000
20200316,055410,元油反富邦9A購01,,,,,0.00,0.00,0,0,0,0,0,0,0,0,0,0,0,0,0
20200316,055411,國巨富邦9A購02,0.15,0.25,0.10,0.25,+0.05,25.0,728000,38,96060,0,0,0,0,0,0,10000,56000,-46000,-46000
20200316,055412,旺宏富邦99購01,,,,,0.00,0.00,0,0,0,0,0,0,0,0,0,0,0,0,0
20200316,055413,全新富邦98購01,,,,,0.00,0.00,0,0,0,0,0,0,0,0,0,0,0,0,0
20200316,055414,奇力新富邦9B購01,0.15,0.15,0.10,0.10,0.00,0.00,35000,4,4490,0,0,0,0,0,0,0,35000,-35000,-35000
20200316,055415,禾伸堂富邦9B購01,0.22,0.22,0.22,0.22,-0.04,-15.38,11000,1,2420,0,0,0,0,0,0,11000,0,11000,11000
20200316,055416,欣興富邦98購01,0.14,0.14,0.11,0.11,-0.06,-35.29,14000,5,1900,0,0,0,0,0,0,0,14000,-14000,-14000
20200316,055417,健策富邦98購02,0.10,0.10,0.10,0.10,0.00,0.00,402000,9,40200,0,0,0,0,0,0,0,382000,-382000,-382000
20200316,055418,華通永豐97購01,,,,,0.00,0.00,0,0,0,0,0,0,0,0,0,0,0,0,0
20200316,055419,國巨永豐97購03,,,,,0.00,0.00,0,0,0,0,0,0,0,0,0,0,0,0,0
20200316,05541P,鴻海統一96售08,4.58,4.58,4.58,4.58,0.00,0.00,8000,2,36640,0,0,0,0,0,0,0,8000,-8000,-8000
20200316,055420,欣興永豐98購01,0.29,0.29,0.17,0.17,-0.12,-41.38,68000,4,16380,0,0,0,0,0,0,48000,38000,10000,10000
20200316,055421,玉晶光永豐98購04,0.38,0.38,0.34,0.35,-0.08,-18.6,30000,3,10700,0,0,0,0,0,0,0,30000,-30000,-30000
20200316,055422,康控永豐97購01,,,,,0.00,0.00,0,0,0,0,0,0,0,0,0,0,0,0,0
20200316,055423,亞光亞東99購01,,,,,0.00,0.00,0,0,0,0,0,0,0,0,0,0,0,0,0
20200316,055424,聚陽群益98購01,0.23,0.23,0.22,0.22,0.00,0.00,22000,3,4990,0,0,0,0,0,0,22000,0,22000,22000
20200316,055425,聚陽群益99購01,0.24,0.24,0.22,0.22,-0.07,-24.14,200000,2,46000,0,0,0,0,0,0,0,200000,-200000,-200000
20200316,055426,旺宏群益99購02,,,,,0.00,0.00,0,0,0,0,0,0,0,0,0,0,0,0,0
20200316,055427,技嘉群益98購01,0.97,0.97,0.97,0.97,0.00,0.00,15000,1,14550,0,0,0,0,0,0,0,15000,-15000,-15000
20200316,055428,友達群益9C購01,0.18,0.18,0.13,0.14,+0.01,7.69,1430000,103,206800,0,0,0,0,0,0,400000,1010000,-610000,-610000
20200316,055429,華新科群益99購01,0.15,0.15,0.15,0.15,-0.04,-21.05,25000,1,3750,0,0,0,0,0,0,25000,0,25000,25000
20200316,05542P,滬深2X元富96售01,,,,,0.00,0.00,0,0,0,0,0,0,0,0,0,0,0,0,0
20200316,055430,宏達電群益97購01,0.41,0.41,0.41,0.41,-0.06,-12.77,2000,1,820,0,0,0,0,0,0,2000,2000,0,0
20200316,055431,和鑫群益98購01,0.14,0.14,0.12,0.12,0.00,0.00,55000,2,7200,0,0,0,0,0,0,0,55000,-55000,-55000
20200316,055432,臻鼎群益97購02,0.16,0.16,0.16,0.16,0.00,0.00,98000,1,15680,0,0,0,0,0,0,98000,0,98000,98000
20200316,055433,嘉聯益群益99購01,,,,,0.00,0.00,0,0,0,0,0,0,0,0,0,0,0,0,0
20200316,055434,樺漢群益97購01,,,,,0.00,0.00,0,0,0,0,0,0,0,0,0,0,0,0,0
20200316,055435,佳世達中信99購01,0.21,0.21,0.21,0.21,+0.03,16.67,20000,1,4200,0,0,0,0,0,0,0,20000,-20000,-20000
20200316,055436,晶豪科中信99購01,0.32,0.32,0.32,0.32,0.00,0.00,5000,1,1600,0,0,0,0,0,0,0,5000,-5000,-5000
20200316,055437,禾伸堂中信99購01,,,,,0.00,0.00,0,0,0,0,0,0,0,0,0,0,0,0,0
20200316,055438,鴻海國票98購01,0.18,0.18,0.13,0.14,-0.05,-26.32,300000,30,45400,0,0,0,0,0,0,0,300000,-300000,-300000
20200316,055439,台表科國票98購02,0.12,0.60,0.05,0.05,-0.06,-54.55,20000,3,1900,0,0,0,0,0,0,19000,0,19000,19000
20200316,05543P,鴻海元富96售04,5.55,6.30,5.55,6.30,+1.76,38.77,80000,9,492450,0,0,0,0,0,0,56000,30000,26000,26000
20200316,055440,矽力國票98購01,1.76,1.77,1.52,1.52,-0.12,-7.32,75000,4,119700,0,0,0,0,0,0,65000,0,65000,65000
20200316,055441,緯穎國票98購01,3.89,3.89,3.87,3.87,+1.71,79.17,11000,2,42770,0,0,0,0,0,0,11000,0,11000,11000
20200316,055442,矽創國票98購02,0.62,0.62,0.62,0.62,+0.04,6.9,80000,1,49600,0,0,0,0,0,0,80000,0,80000,80000
20200316,055443,台虹國票98購01,1.19,1.19,1.19,1.19,-0.02,-1.65,10000,1,11900,0,0,0,0,0,0,10000,0,10000,10000
20200316,055444,致新台新97購01,0.19,0.19,0.19,0.19,-0.05,-20.83,5000,1,950,0,0,0,0,0,0,0,5000,-5000,-5000
20200316,055445,旺宏統一99購01,,,,,0.00,0.00,0,0,0,0,0,0,0,0,0,0,0,0,0
20200316,055446,奇力新統一9A購01,0.38,0.38,0.21,0.26,-0.02,-7.14,43000,4,13630,0,0,0,0,0,0,0,20000,-20000,-20000
20200316,055447,華新科統一97購04,,,,,0.00,0.00,0,0,0,0,0,0,0,0,0,0,0,0,0
20200316,055448,健策統一97購02,,,,,0.00,0.00,0,0,0,0,0,0,0,0,0,0,0,0,0
20200316,055449,超眾統一9A購01,0.52,0.52,0.52,0.52,+0.10,23.81,1000,1,520,0,0,0,0,0,0,1000,0,1000,1000
20200316,05544P,台表科元富96售01,3.38,3.38,3.38,3.38,+0.25,7.99,44000,1,148720,0,0,0,0,0,0,0,44000,-44000,-44000
20200316,055450,台積電元富97購01,0.16,0.16,0.14,0.15,-0.09,-37.5,270000,6,40500,0,0,0,0,0,0,269000,0,269000,269000
20200316,055451,台積電元富97購02,0.04,0.04,0.03,0.03,-0.05,-62.5,110000,2,4000,0,0,0,0,0,0,70000,0,70000,70000
20200316,055452,台積電元富97購03,,,,,0.00,0.00,0,0,0,0,0,0,0,0,0,0,0,0,0
20200316,055453,華邦電元富97購01,,,,,0.00,0.00,0,0,0,0,0,0,0,0,0,0,0,0,0
20200316,055454,華邦電元富97購02,0.05,0.05,0.05,0.05,0.00,0.00,20000,1,1000,0,0,0,0,0,0,20000,20000,0,0
20200316,055455,健策國泰98購02,,,,,0.00,0.00,0,0,0,0,0,0,0,0,0,0,0,0,0
20200316,055456,上銀富邦99購01,0.64,0.64,0.46,0.46,+0.11,31.43,345000,8,178840,0,0,0,0,0,0,45000,300000,-255000,-255000
20200316,055457,聚陽永豐97購01,,,,,0.00,0.00,0,0,0,0,0,0,0,0,0,0,0,0,0
20200316,055458,燿華永豐98購01,0.11,0.11,0.08,0.08,-0.03,-27.27,217000,22,20090,0,0,0,0,0,0,0,197000,-197000,-197000
20200316,055459,建準永豐97購03,0.33,0.37,0.32,0.37,+0.10,37.04,20000,4,6970,0,0,0,0,0,0,10000,10000,0,0
20200316,05545P,台表科國泰98售01,2.31,2.40,2.31,2.33,-0.16,-6.43,78000,3,184880,0,0,0,0,0,0,18000,60000,-42000,-42000
20200316,055460,華擎永豐97購01,1.04,1.11,0.88,0.88,+0.08,10.0,392000,17,392040,0,0,0,0,0,0,156000,235000,-79000,-79000
20200316,055461,TPK永豐97購01,,,,,0.00,0.00,0,0,0,0,0,0,0,0,0,0,0,0,0
20200316,055462,華邦電日盛97購01,0.15,0.15,0.15,0.15,+0.05,50.0,1000,1,150,0,0,0,0,0,0,0,1000,-1000,-1000
20200316,055463,國喬凱基97購01,,,,,0.00,0.00,0,0,0,0,0,0,0,0,0,0,0,0,0
20200316,055464,聚陽凱基97購01,,,,,0.00,0.00,0,0,0,0,0,0,0,0,0,0,0,0,0
20200316,055465,和大凱基97購03,,,,,0.00,0.00,0,0,0,0,0,0,0,0,0,0,0,0,0
20200316,055466,台達電凱基97購03,0.25,0.27,0.20,0.20,-0.07,-25.93,50000,5,11700,0,0,0,0,0,0,10000,40000,-30000,-30000
20200316,055467,國巨凱基97購05,0.54,0.54,0.54,0.54,+0.11,25.58,10000,1,5400,0,0,0,0,0,0,10000,0,10000,10000
20200316,055468,智邦凱基97購04,,,,,0.00,0.00,0,0,0,0,0,0,0,0,0,0,0,0,0
20200316,055469,台光電凱基97購01,,,,,0.00,0.00,0,0,0,0,0,0,0,0,0,0,0,0,0
20200316,05546P,全新元大97售01,2.57,2.92,2.57,2.92,+0.24,8.96,4000,2,10630,0,0,0,0,0,0,4000,0,4000,4000
20200316,055470,南亞科凱基97購01,0.35,0.35,0.35,0.35,+0.03,9.38,15000,1,5250,0,0,0,0,0,0,15000,0,15000,15000
20200316,055471,聯發科凱基97購04,0.81,0.81,0.71,0.71,+0.22,44.9,8000,2,5980,0,0,0,0,0,0,3000,5000,-2000,-2000
20200316,055472,大立光凱基97購07,,,,,0.00,0.00,0,0,0,0,0,0,0,0,0,0,0,0,0
20200316,055473,禾伸堂凱基97購01,,,,,0.00,0.00,0,0,0,0,0,0,0,0,0,0,0,0,0
20200316,055474,欣興凱基97購05,0.26,0.26,0.20,0.20,-0.13,-39.39,287000,20,66780,0,0,0,0,0,0,136000,247000,-111000,-111000
20200316,055475,臻鼎凱基97購02,0.26,0.26,0.26,0.26,0.00,0.00,260000,3,67600,0,0,0,0,0,0,10000,250000,-240000,-240000
20200316,055476,台郡凱基97購02,1.06,1.06,1.05,1.05,0.00,0.00,67000,2,70920,0,0,0,0,0,0,0,67000,-67000,-67000
20200316,055477,同欣電凱基98購01,0.42,0.44,0.29,0.29,-0.17,-36.96,874000,23,329680,0,0,0,0,0,0,658000,60000,598000,598000
20200316,055478,訊芯凱基97購01,,,,,0.00,0.00,0,0,0,0,0,0,0,0,0,0,0,0,0
20200316,055479,GIS凱基97購04,,,,,0.00,0.00,0,0,0,0,0,0,0,0,0,0,0,0,0
20200316,05547P,群創元大96售03,1.41,1.41,1.38,1.38,-0.15,-9.8,20000,2,27900,0,0,0,0,0,0,0,20000,-20000,-20000
20200316,055480,元上證元大97購02,0.59,0.59,0.56,0.56,-0.12,-17.65,17000,3,9770,0,0,0,0,0,0,0,17000,-17000,-17000
20200316,055481,聚陽元大97購01,0.35,0.35,0.26,0.26,-0.03,-10.34,165000,8,53310,0,0,0,0,0,0,130000,35000,95000,95000
20200316,055482,聚陽元大97購02,0.33,0.34,0.23,0.23,-0.09,-28.12,100000,11,27400,0,0,0,0,0,0,20000,80000,-60000,-60000
20200316,055483,和大元大97購03,0.10,0.10,0.09,0.10,0.00,0.00,80000,8,7700,0,0,0,0,0,0,10000,70000,-60000,-60000
20200316,055484,華通元大97購04,0.23,0.25,0.14,0.14,-0.07,-33.33,290000,13,59500,0,0,0,0,0,0,180000,110000,70000,70000
20200316,055485,國巨元大97購09,0.71,0.71,0.50,0.50,-0.17,-25.37,184000,8,100840,0,0,0,0,0,0,144000,40000,104000,104000
20200316,055486,國巨元大98購06,0.89,0.89,0.64,0.64,-0.33,-34.02,68000,7,53140,0,0,0,0,0,0,30000,38000,-8000,-8000
20200316,055487,國巨元大98購07,0.86,0.86,0.79,0.79,-0.07,-8.14,170000,2,137100,0,0,0,0,0,0,170000,0,170000,170000
20200316,055488,華邦電元大98購01,0.18,0.19,0.08,0.08,-0.09,-52.94,617000,61,92670,0,0,0,0,0,0,27000,590000,-563000,-563000
20200316,055489,瑞昱元大97購02,0.64,0.67,0.46,0.46,-0.34,-42.5,1004000,95,580760,0,0,0,0,0,0,170000,943000,-773000,-773000
20200316,05548P,臺股指元大96售02,6.00,7.40,6.00,7.40,+1.50,25.42,63000,9,403050,0,0,0,0,0,0,56000,3000,53000,53000
20200316,055490,台光電元大97購01,0.26,0.30,0.26,0.30,+0.03,11.11,14000,2,4040,0,0,0,0,0,0,4000,10000,-6000,-6000
20200316,055491,奇力新元大98購03,,,,,0.00,0.00,0,0,0,0,0,0,0,0,0,0,0,0,0
20200316,055492,華新科元大97購08,0.30,0.30,0.30,0.30,0.00,0.00,11000,3,3300,0,0,0,0,0,0,0,0,0,0
20200316,055493,華新科元大97購09,0.35,0.35,0.25,0.26,-0.07,-21.21,235000,26,71110,0,0,0,0,0,0,10000,225000,-215000,-215000
20200316,055494,華新科元大98購01,0.31,0.33,0.22,0.22,-0.02,-8.33,167000,14,51900,0,0,0,0,0,0,40000,127000,-87000,-87000
20200316,055495,長榮航元大97購01,0.13,0.13,0.12,0.12,-0.08,-40.0,60000,6,7400,0,0,0,0,0,0,0,60000,-60000,-60000
20200316,055496,高鐵元大97購02,,,,,0.00,0.00,0,0,0,0,0,0,0,0,0,0,0,0,0
20200316,055497,開發金元大97購01,,,,,0.00,0.00,0,0,0,0,0,0,0,0,0,0,0,0,0
20200316,055498,大立光元大97購07,0.65,0.65,0.38,0.40,-0.30,-42.86,335000,35,170110,0,0,0,0,0,0,15000,331000,-316000,-316000
20200316,055499,大立光元大98購05,0.56,0.57,0.34,0.35,-0.22,-38.6,218000,23,94370,0,0,0,0,0,0,63000,176000,-113000,-113000
20200316,05549P,臺股指元大96售03,3.74,5.15,3.74,5.15,+1.38,36.6,1717000,177,7750570,0,0,0,0,0,0,745000,1679000,-934000,-934000
20200316,055500,京鼎元大97購04,0.25,0.25,0.25,0.25,-0.02,-7.41,58000,1,14500,0,0,0,0,0,0,58000,0,58000,58000
20200316,055501,創意元大97購01,0.57,0.65,0.53,0.53,+0.06,12.77,109000,7,64920,0,0,0,0,0,0,106000,29000,77000,77000
20200316,055502,群創元大9C購03,,,,,0.00,0.00,0,0,0,0,0,0,0,0,0,0,0,0,0
20200316,055503,健策元大98購05,0.23,0.23,0.17,0.17,-0.05,-22.73,30000,3,5700,0,0,0,0,0,0,0,30000,-30000,-30000
20200316,055504,貿聯元大98購04,,,,,0.00,0.00,0,0,0,0,0,0,0,0,0,0,0,0,0
20200316,055505,新唐元大97購02,,,,,0.00,0.00,0,0,0,0,0,0,0,0,0,0,0,0,0
20200316,055506,台郡元大99購02,,,,,0.00,0.00,0,0,0,0,0,0,0,0,0,0,0,0,0
20200316,055507,樺漢元大98購02,0.28,0.28,0.17,0.17,-0.11,-39.29,105000,11,22350,0,0,0,0,0,0,0,105000,-105000,-105000
20200316,055508,矽力元大97購01,2.60,2.60,2.04,2.04,-0.52,-20.31,90000,8,197300,0,0,0,0,0,0,20000,70000,-50000,-50000
20200316,055509,訊芯元大97購03,,,,,0.00,0.00,0,0,0,0,0,0,0,0,0,0,0,0,0
20200316,05550P,臺股指元大96售07,7.35,7.75,7.35,7.75,-0.85,-9.88,20000,2,151000,0,0,0,0,0,0,0,20000,-20000,-20000
20200316,055510,GIS元大97購03,0.12,0.14,0.12,0.14,+0.03,27.27,10000,2,1320,0,0,0,0,0,0,10000,0,10000,10000
20200316,055511,大立光兆豐97購02,0.21,0.21,0.13,0.13,-0.18,-58.06,161000,3,29710,0,0,0,0,0,0,111000,10000,101000,101000
20200316,055512,聯詠兆豐97購01,0.66,0.71,0.45,0.45,-0.11,-19.64,75000,4,48250,0,0,0,0,0,0,48000,27000,21000,21000
20200316,055513,旺宏亞東98購01,0.20,0.20,0.20,0.20,0.00,0.00,70000,2,14000,0,0,0,0,0,0,0,70000,-70000,-70000
20200316,055514,亞光麥證97購01,,,,,0.00,0.00,0,0,0,0,0,0,0,0,0,0,0,0,0
20200316,055515,聚陽中信9A購01,0.24,0.24,0.17,0.17,-0.03,-15.0,13000,3,2400,0,0,0,0,0,0,13000,0,13000,13000
20200316,055516,上銀中信97購01,0.21,0.21,0.21,0.21,-0.02,-8.7,299000,1,62790,0,0,0,0,0,0,0,299000,-299000,-299000
20200316,055517,國巨中信97購03,,,,,0.00,0.00,0,0,0,0,0,0,0,0,0,0,0,0,0
20200316,055518,華新科中信99購01,0.18,0.18,0.08,0.08,-0.11,-57.89,514000,18,48680,0,0,0,0,0,0,0,0,0,0
20200316,055519,茂林中信99購01,0.51,0.51,0.36,0.37,-0.14,-27.45,193000,31,88310,0,0,0,0,0,0,120000,73000,47000,47000
20200316,05551P,電子類元大96售01,4.41,5.30,4.20,5.30,+1.52,40.21,28000,9,135820,0,0,0,0,0,0,26000,2000,24000,24000
20200316,055520,矽力中信97購02,0.65,0.66,0.42,0.42,-0.20,-32.26,436000,27,211350,0,0,0,0,0,0,87000,349000,-262000,-262000
20200316,055521,S&P反1群益01購01,,,,,0.00,0.00,0,0,0,0,0,0,0,0,0,0,0,0,0
20200316,055522,道瓊反群益01購01,2.66,2.88,2.66,2.88,+0.40,16.13,9000,3,25310,0,0,0,0,0,0,0,0,0,0
20200316,055523,道瓊銀群益9A購01,0.17,0.17,0.17,0.17,-0.10,-37.04,10000,1,1700,0,0,0,0,0,0,10000,0,10000,10000
20200316,055524,鴻海群益98購01,0.42,0.42,0.36,0.36,+0.05,16.13,300000,2,117000,0,0,0,0,0,0,150000,150000,0,0
20200316,055525,國巨群益98購05,0.53,0.53,0.53,0.53,0.00,0.00,10000,1,5300,0,0,0,0,0,0,10000,0,10000,10000
20200316,055526,台積電群益97購02,0.09,0.10,0.08,0.09,-0.08,-47.06,130000,15,11650,0,0,0,0,0,0,20000,110000,-90000,-90000
20200316,055527,旺宏群益99購03,,,,,0.00,0.00,0,0,0,0,0,0,0,0,0,0,0,0,0
20200316,055528,華邦電群益97購01,,,,,0.00,0.00,0,0,0,0,0,0,0,0,0,0,0,0,0
20200316,055529,華邦電群益97購02,0.03,0.03,0.03,0.03,0.00,0.00,10000,1,300,0,0,0,0,0,0,0,10000,-10000,-10000
20200316,05552P,聯詠群益96售01,,,,,0.00,0.00,0,0,0,0,0,0,0,0,0,0,0,0,0
20200316,055530,聯發科群益98購01,0.19,0.19,0.19,0.19,-0.09,-32.14,3000,1,570,0,0,0,0,0,0,3000,0,3000,3000
20200316,055531,華新科群益98購03,,,,,0.00,0.00,0,0,0,0,0,0,0,0,0,0,0,0,0
20200316,055532,中工群益98購01,0.36,0.36,0.29,0.29,-0.06,-17.14,43000,4,14060,0,0,0,0,0,0,30000,13000,17000,17000
20200316,055533,大立光群益97購03,,,,,0.00,0.00,0,0,0,0,0,0,0,0,0,0,0,0,0
20200316,055534,晶技群益97購03,0.92,0.92,0.92,0.92,+0.22,31.43,2000,1,1840,0,0,0,0,0,0,2000,0,2000,2000
20200316,055535,緯創群益98購01,0.13,0.13,0.09,0.09,0.00,0.00,86000,6,9910,0,0,0,0,0,0,55000,31000,24000,24000
20200316,055536,嘉聯益群益99購02,,,,,0.00,0.00,0,0,0,0,0,0,0,0,0,0,0,0,0
20200316,055537,康友群益97購03,,,,,0.00,0.00,0,0,0,0,0,0,0,0,0,0,0,0,0
20200316,055538,鴻海日盛97購04,0.15,0.19,0.10,0.16,-0.02,-11.11,473000,25,55260,0,0,0,0,0,0,165000,10000,155000,155000
20200316,055539,億光台新97購01,,,,,0.00,0.00,0,0,0,0,0,0,0,0,0,0,0,0,0
20200316,05553P,智原群益96售01,,,,,0.00,0.00,0,0,0,0,0,0,0,0,0,0,0,0,0
20200316,055540,京鼎台新97購01,,,,,0.00,0.00,0,0,0,0,0,0,0,0,0,0,0,0,0
20200316,055541,聚陽凱基98購01,,,,,0.00,0.00,0,0,0,0,0,0,0,0,0,0,0,0,0
20200316,055542,亞德客凱基97購01,0.16,0.16,0.16,0.16,+0.05,45.45,10000,1,1600,0,0,0,0,0,0,10000,0,10000,10000
20200316,055543,為升凱基97購01,,,,,0.00,0.00,0,0,0,0,0,0,0,0,0,0,0,0,0
20200316,055544,鴻海凱基97購05,,,,,0.00,0.00,0,0,0,0,0,0,0,0,0,0,0,0,0
20200316,055545,國巨凱基97購06,,,,,0.00,0.00,0,0,0,0,0,0,0,0,0,0,0,0,0
20200316,055546,台積電凱基97購12,,,,,0.00,0.00,0,0,0,0,0,0,0,0,0,0,0,0,0
20200316,055547,台積電凱基97購13,0.19,0.19,0.19,0.19,0.00,0.00,125000,1,23750,0,0,0,0,0,0,125000,0,125000,125000
20200316,055548,旺宏凱基97購02,,,,,0.00,0.00,0,0,0,0,0,0,0,0,0,0,0,0,0
20200316,055549,旺宏凱基97購03,,,,,0.00,0.00,0,0,0,0,0,0,0,0,0,0,0,0,0
20200316,05554P,群創群益96售02,,,,,0.00,0.00,0,0,0,0,0,0,0,0,0,0,0,0,0
20200316,055550,華邦電凱基97購03,,,,,0.00,0.00,0,0,0,0,0,0,0,0,0,0,0,0,0
20200316,055551,致茂凱基98購01,,,,,0.00,0.00,0,0,0,0,0,0,0,0,0,0,0,0,0
20200316,055552,瑞昱凱基97購02,,,,,0.00,0.00,0,0,0,0,0,0,0,0,0,0,0,0,0
20200316,055553,聯發科凱基97購05,,,,,0.00,0.00,0,0,0,0,0,0,0,0,0,0,0,0,0
20200316,055554,聯發科凱基97購06,,,,,0.00,0.00,0,0,0,0,0,0,0,0,0,0,0,0,0
20200316,055555,全新凱基9A購01,,,,,0.00,0.00,0,0,0,0,0,0,0,0,0,0,0,0,0
20200316,055556,奇力新凱基98購03,,,,,0.00,0.00,0,0,0,0,0,0,0,0,0,0,0,0,0
20200316,055557,華新科凱基97購01,0.29,0.30,0.29,0.30,+0.12,66.67,30000,3,8800,0,0,0,0,0,0,0,30000,-30000,-30000
20200316,055558,大立光凱基97購08,,,,,0.00,0.00,0,0,0,0,0,0,0,0,0,0,0,0,0
20200316,055559,大立光凱基97購09,0.34,0.34,0.20,0.20,-0.07,-25.93,30000,2,7400,0,0,0,0,0,0,10000,20000,-10000,-10000
20200316,05555P,健策群益98售01,,,,,0.00,0.00,0,0,0,0,0,0,0,0,0,0,0,0,0
20200316,055560,大立光凱基97購10,,,,,0.00,0.00,0,0,0,0,0,0,0,0,0,0,0,0,0
20200316,055561,奇鋐凱基97購01,0.26,0.27,0.22,0.22,0.00,0.00,47000,4,11740,0,0,0,0,0,0,47000,0,47000,47000
20200316,055562,欣興凱基97購06,,,,,0.00,0.00,0,0,0,0,0,0,0,0,0,0,0,0,0
20200316,055563,智易凱基97購02,,,,,0.00,0.00,0,0,0,0,0,0,0,0,0,0,0,0,0
20200316,055564,茂林凱基98購01,,,,,0.00,0.00,0,0,0,0,0,0,0,0,0,0,0,0,0
20200316,055565,祥碩凱基97購01,1.92,2.02,1.33,1.33,-0.69,-34.16,125000,33,223420,0,0,0,0,0,0,64000,111000,-47000,-47000
20200316,055566,台表科凱基97購03,0.15,0.15,0.14,0.14,-0.01,-6.67,300000,2,44000,0,0,0,0,0,0,300000,0,300000,300000
20200316,055567,訊芯凱基98購02,,,,,0.00,0.00,0,0,0,0,0,0,0,0,0,0,0,0,0
20200316,055568,緯穎凱基97購02,2.10,2.15,1.85,1.85,0.00,0.00,75000,17,157850,0,0,0,0,0,0,75000,0,75000,75000
20200316,055569,聚陽統一98購01,0.31,0.31,0.23,0.23,+0.07,43.75,27000,3,6770,0,0,0,0,0,0,0,27000,-27000,-27000
20200316,05556P,全新國票96售04,,,,,0.00,0.00,0,0,0,0,0,0,0,0,0,0,0,0,0
20200316,055570,華通統一98購03,0.09,0.09,0.09,0.09,0.00,0.00,35000,1,3150,0,0,0,0,0,0,35000,0,35000,35000
20200316,055571,鴻海統一97購03,,,,,0.00,0.00,0,0,0,0,0,0,0,0,0,0,0,0,0
20200316,055572,鴻海統一98購04,,,,,0.00,0.00,0,0,0,0,0,0,0,0,0,0,0,0,0
20200316,055573,國巨統一97購06,0.26,0.26,0.26,0.26,0.00,0.00,50000,1,13000,0,0,0,0,0,0,50000,0,50000,50000
20200316,055574,美律統一97購01,,,,,0.00,0.00,0,0,0,0,0,0,0,0,0,0,0,0,0
20200316,055575,華新科統一98購01,,,,,0.00,0.00,0,0,0,0,0,0,0,0,0,0,0,0,0
20200316,055576,嘉晶統一98購01,,,,,0.00,0.00,0,0,0,0,0,0,0,0,0,0,0,0,0
20200316,055577,晶技統一97購02,,,,,0.00,0.00,0,0,0,0,0,0,0,0,0,0,0,0,0
20200316,055578,群創統一98購03,,,,,0.00,0.00,0,0,0,0,0,0,0,0,0,0,0,0,0
20200316,055579,健策統一9A購01,0.31,0.32,0.31,0.32,+0.02,6.67,93000,2,29550,0,0,0,0,0,0,21000,0,21000,21000
20200316,05557P,S&P500中信96售02,3.92,3.92,3.92,3.92,-0.90,-18.67,10000,1,39200,0,0,0,0,0,0,0,10000,-10000,-10000
20200316,055580,南茂統一97購01,,,,,0.00,0.00,0,0,0,0,0,0,0,0,0,0,0,0,0
20200316,055581,和大元大97購04,,,,,0.00,0.00,0,0,0,0,0,0,0,0,0,0,0,0,0
20200316,055582,亞德客元大97購01,1.20,1.25,0.88,0.88,+0.07,8.64,90000,11,103040,0,0,0,0,0,0,47000,80000,-33000,-33000
20200316,055583,國巨元大97購10,1.07,1.07,0.72,0.72,-0.23,-24.21,60000,3,57200,0,0,0,0,0,0,40000,20000,20000,20000
20200316,055584,國巨元大97購11,0.55,0.55,0.37,0.37,-0.17,-31.48,259000,8,113280,0,0,0,0,0,0,221000,38000,183000,183000
20200316,055585,國巨元大98購08,0.47,0.47,0.47,0.47,-0.24,-33.8,10000,1,4700,0,0,0,0,0,0,10000,0,10000,10000
20200316,055586,旺宏元大98購06,0.57,0.57,0.57,0.57,0.00,0.00,5000,1,2850,0,0,0,0,0,0,5000,0,5000,5000
20200316,055587,智邦元大97購02,2.07,2.33,2.07,2.16,+0.44,25.58,28000,16,60820,0,0,0,0,0,0,28000,18000,10000,10000
20200316,055588,瑞昱元大97購03,0.36,0.37,0.25,0.25,-0.08,-24.24,260000,22,78330,0,0,0,0,0,0,110000,250000,-140000,-140000
20200316,055589,台光電元大98購04,0.93,0.93,0.84,0.84,+0.08,10.53,25000,2,21900,0,0,0,0,0,0,15000,10000,5000,5000
20200316,05558P,鴻海麥證96售01,4.12,4.35,4.12,4.35,+0.36,9.02,34000,3,144000,30000,4000,26000,0,0,0,30000,4000,26000,26000
20200316,055590,聯發科元大98購02,0.35,0.36,0.35,0.36,0.00,0.00,27000,3,9670,0,0,0,0,0,0,5000,10000,-5000,-5000
20200316,055591,全新元大98購01,0.36,0.36,0.35,0.36,+0.10,38.46,20000,4,7140,0,0,0,0,0,0,20000,0,20000,20000
20200316,055592,奇力新元大97購07,,,,,0.00,0.00,0,0,0,0,0,0,0,0,0,0,0,0,0
20200316,055593,華新科元大97購10,0.16,0.16,0.09,0.10,-0.02,-16.67,115000,11,14400,0,0,0,0,0,0,20000,95000,-75000,-75000
20200316,055594,華新科元大98購02,0.87,0.96,0.79,0.79,-0.03,-3.66,170000,7,152100,0,0,0,0,0,0,130000,40000,90000,90000
20200316,055595,宏達電元大98購02,0.36,0.36,0.17,0.17,-0.20,-54.05,431000,47,114510,0,0,0,0,0,0,11000,421000,-410000,-410000
20200316,055596,新光金元大9B購02,0.29,0.29,0.24,0.25,-0.04,-13.79,445000,43,114650,0,0,0,0,0,0,40000,405000,-365000,-365000
20200316,055597,禾伸堂元大98購02,0.82,0.89,0.77,0.77,+0.06,8.45,35000,7,28360,0,0,0,0,0,0,35000,25000,10000,10000
20200316,055598,欣興元大97購03,0.39,0.39,0.22,0.22,-0.14,-38.89,71000,8,16990,0,0,0,0,0,0,10000,61000,-51000,-51000
20200316,055599,TPK元大97購01,,,,,0.00,0.00,0,0,0,0,0,0,0,0,0,0,0,0,0
20200316,05559P,臺股指麥證96售01,,,,,0.00,0.00,0,0,0,0,0,0,0,0,0,0,0,0,0
20200316,055600,致伸元大97購02,0.07,0.07,0.07,0.07,+0.03,75.0,100000,1,7000,0,0,0,0,0,0,100000,0,100000,100000
20200316,055601,茂林元大97購03,0.57,0.57,0.37,0.37,-0.26,-41.27,26000,3,13640,0,0,0,0,0,0,21000,5000,16000,16000
20200316,055602,康控元大97購03,0.10,0.10,0.10,0.10,-0.06,-37.5,30000,3,3000,0,0,0,0,0,0,30000,0,30000,30000
20200316,055603,超眾元大97購04,,,,,0.00,0.00,0,0,0,0,0,0,0,0,0,0,0,0,0
20200316,055604,訊芯元大98購02,,,,,0.00,0.00,0,0,0,0,0,0,0,0,0,0,0,0,0
20200316,055605,緯穎元大97購02,1.52,1.64,1.19,1.19,-0.23,-16.2,346000,31,514210,0,0,0,0,0,0,245000,150000,95000,95000
20200316,055606,矽創元大97購01,0.42,0.42,0.25,0.25,-0.16,-39.02,155000,18,57150,0,0,0,0,0,0,40000,130000,-90000,-90000
20200316,055607,華通康和97購01,,,,,0.00,0.00,0,0,0,0,0,0,0,0,0,0,0,0,0
20200316,055608,華邦電康和97購01,,,,,0.00,0.00,0,0,0,0,0,0,0,0,0,0,0,0,0
20200316,055609,旺宏國票99購01,0.19,0.20,0.19,0.20,+0.01,5.26,15000,2,2950,0,0,0,0,0,0,15000,0,15000,15000
20200316,05560P,友達兆豐96售01,,,,,0.00,0.00,0,0,0,0,0,0,0,0,0,0,0,0,0
20200316,055610,光磊國票98購01,,,,,0.00,0.00,0,0,0,0,0,0,0,0,0,0,0,0,0
20200316,055611,燿華國票98購02,,,,,0.00,0.00,0,0,0,0,0,0,0,0,0,0,0,0,0
20200316,055612,台光電國票97購04,0.60,0.60,0.60,0.60,+0.19,46.34,38000,1,22800,0,0,0,0,0,0,38000,0,38000,38000
20200316,055613,全新國票98購01,0.08,0.08,0.08,0.08,0.00,0.00,10000,3,800,0,0,0,0,0,0,0,10000,-10000,-10000
20200316,055614,華新科國票97購02,0.07,0.07,0.07,0.07,+0.02,40.0,10000,1,700,0,0,0,0,0,0,0,0,0,0
20200316,055615,宏達電國票99購02,0.16,0.16,0.16,0.16,-0.02,-11.11,10000,1,1600,0,0,0,0,0,0,0,10000,-10000,-10000
20200316,055616,智原國票97購03,,,,,0.00,0.00,0,0,0,0,0,0,0,0,0,0,0,0,0
20200316,055617,TPK國票98購04,,,,,0.00,0.00,0,0,0,0,0,0,0,0,0,0,0,0,0
20200316,055618,麗豐國票98購01,,,,,0.00,0.00,0,0,0,0,0,0,0,0,0,0,0,0,0
20200316,055619,同欣電國票98購02,0.53,0.53,0.53,0.53,+0.14,35.9,40000,1,21200,0,0,0,0,0,0,40000,0,40000,40000
20200316,05561P,大立光兆豐96售02,1.05,1.10,1.05,1.10,-0.18,-14.06,30000,3,32000,0,0,0,0,0,0,0,30000,-30000,-30000
20200316,055620,樺漢國票98購01,,,,,0.00,0.00,0,0,0,0,0,0,0,0,0,0,0,0,0
20200316,055621,國巨國泰98購03,0.38,0.38,0.38,0.38,0.00,0.00,4000,1,1520,0,0,0,0,0,0,4000,0,4000,4000
20200316,055622,群創國泰99購01,,,,,0.00,0.00,0,0,0,0,0,0,0,0,0,0,0,0,0
20200316,055623,貿聯國泰99購01,,,,,0.00,0.00,0,0,0,0,0,0,0,0,0,0,0,0,0
20200316,055624,聯發科富邦99購07,0.47,0.47,0.30,0.31,-0.13,-29.55,340000,19,135600,0,0,0,0,0,0,0,290000,-290000,-290000
20200316,055625,亞光富邦98購01,,,,,0.00,0.00,0,0,0,0,0,0,0,0,0,0,0,0,0
20200316,055626,力山永豐97購01,,,,,0.00,0.00,0,0,0,0,0,0,0,0,0,0,0,0,0
20200316,055627,亞德客永豐97購02,,,,,0.00,0.00,0,0,0,0,0,0,0,0,0,0,0,0,0
20200316,055628,旺宏永豐97購01,0.24,0.25,0.15,0.15,-0.08,-34.78,70000,4,14700,0,0,0,0,0,0,30000,40000,-10000,-10000
20200316,055629,華新科永豐97購04,,,,,0.00,0.00,0,0,0,0,0,0,0,0,0,0,0,0,0
20200316,05562P,鴻海元大96售16,3.61,4.02,3.59,4.02,+0.77,23.69,123000,5,453910,0,0,0,0,0,0,123000,0,123000,123000
20200316,055630,聯詠永豐97購02,,,,,0.00,0.00,0,0,0,0,0,0,0,0,0,0,0,0,0
20200316,055631,創意永豐98購01,0.10,0.10,0.10,0.10,0.00,0.00,102000,2,10200,0,0,0,0,0,0,0,102000,-102000,-102000
20200316,055632,群創永豐98購01,,,,,0.00,0.00,0,0,0,0,0,0,0,0,0,0,0,0,0
20200316,055633,牧德永豐97購02,0.06,0.06,0.06,0.06,0.00,0.00,30000,2,1800,0,0,0,0,0,0,0,30000,-30000,-30000
20200316,055634,訊芯永豐97購02,,,,,0.00,0.00,0,0,0,0,0,0,0,0,0,0,0,0,0
20200316,055635,緯穎永豐97購01,0.61,0.63,0.56,0.63,+0.04,6.78,78000,6,48080,0,0,0,0,0,0,78000,0,78000,78000
20200316,055636,元油反元富97購02,,,,,0.00,0.00,0,0,0,0,0,0,0,0,0,0,0,0,0
20200316,055637,亞德客元富97購01,1.26,1.35,1.13,1.13,0.00,0.00,209000,37,273730,0,0,0,0,0,0,2000,207000,-205000,-205000
20200316,055638,上銀元富97購01,0.18,0.18,0.17,0.17,+0.02,13.33,23000,3,4010,0,0,0,0,0,0,23000,0,23000,23000
20200316,055639,上銀元富97購02,0.51,0.51,0.39,0.39,-0.08,-17.02,30000,2,12900,0,0,0,0,0,0,30000,20000,10000,10000
20200316,05563P,台積電元大97售07,,,,,0.00,0.00,0,0,0,0,0,0,0,0,0,0,0,0,0
20200316,055640,鴻海元富97購03,,,,,0.00,0.00,0,0,0,0,0,0,0,0,0,0,0,0,0
20200316,055641,鴻海元富97購04,0.43,0.44,0.27,0.27,-0.13,-32.5,135000,7,43050,0,0,0,0,0,0,110000,25000,85000,85000
20200316,055642,廣宇元富97購01,0.43,0.43,0.38,0.38,+0.08,26.67,57000,21,22520,0,0,0,0,0,0,42000,56000,-14000,-14000
20200316,055643,宏碁元富97購01,,,,,0.00,0.00,0,0,0,0,0,0,0,0,0,0,0,0,0
20200316,055644,致茂元富97購01,0.35,0.35,0.21,0.21,-0.08,-27.59,93000,11,25720,0,0,0,0,0,0,10000,83000,-73000,-73000
20200316,055645,技嘉元富97購01,0.52,0.52,0.44,0.44,+0.06,15.79,163000,4,77960,0,0,0,0,0,0,163000,0,163000,163000
20200316,055646,漢唐元富97購01,0.17,0.17,0.17,0.17,0.00,0.00,15000,3,2550,0,0,0,0,0,0,15000,15000,0,0
20200316,055647,義隆元富97購01,0.32,0.32,0.32,0.32,-0.04,-11.11,10000,1,3200,0,0,0,0,0,0,10000,0,10000,10000
20200316,055648,可成元富97購01,0.36,0.37,0.36,0.37,+0.12,48.0,29000,7,10530,0,0,0,0,0,0,0,29000,-29000,-29000
20200316,055649,華新科元富97購03,0.13,0.13,0.11,0.12,+0.03,33.33,127000,13,15010,0,0,0,0,0,0,110000,127000,-17000,-17000
20200316,05564P,玉晶光元大97售02,0.83,1.07,0.81,1.07,+0.26,32.1,471000,43,423140,0,0,0,0,0,0,167000,304000,-137000,-137000
20200316,055650,華新科元富98購01,0.14,0.15,0.14,0.14,+0.03,27.27,30000,3,4300,0,0,0,0,0,0,10000,20000,-10000,-10000
20200316,055651,富邦金元富97購01,0.22,0.23,0.14,0.14,-0.01,-6.67,2158000,19,428980,0,0,0,0,0,0,1030000,1128000,-98000,-98000
20200316,055652,聯詠元富01購01,0.62,0.62,0.51,0.51,-0.14,-21.54,271000,4,156720,0,0,0,0,0,0,150000,121000,29000,29000
20200316,055653,聯詠元富01購02,0.62,0.62,0.50,0.50,-0.12,-19.35,265000,8,161300,0,0,0,0,0,0,230000,35000,195000,195000
20200316,055654,景碩元富97購01,,,,,0.00,0.00,0,0,0,0,0,0,0,0,0,0,0,0,0
20200316,055655,群創元富99購07,0.05,0.05,0.05,0.05,-0.01,-16.67,10000,1,500,0,0,0,0,0,0,0,0,0,0
20200316,055656,新唐元富97購01,,,,,0.00,0.00,0,0,0,0,0,0,0,0,0,0,0,0,0
20200316,055657,超眾元富97購02,0.35,0.35,0.35,0.35,+0.01,2.94,1000,1,350,0,0,0,0,0,0,1000,0,1000,1000
20200316,055658,南電元富97購01,,,,,0.00,0.00,0,0,0,0,0,0,0,0,0,0,0,0,0
20200316,055659,百和元富97購01,,,,,0.00,0.00,0,0,0,0,0,0,0,0,0,0,0,0,0
20200316,05565P,鎧勝元大96售01,,,,,0.00,0.00,0,0,0,0,0,0,0,0,0,0,0,0,0
20200316,055660,台光電兆豐97購01,,,,,0.00,0.00,0,0,0,0,0,0,0,0,0,0,0,0,0
20200316,055661,亞德客中信98購01,0.24,0.25,0.19,0.19,+0.03,18.75,21000,5,5120,0,0,0,0,0,0,4000,17000,-13000,-13000
20200316,055662,上銀中信99購01,,,,,0.00,0.00,0,0,0,0,0,0,0,0,0,0,0,0,0
20200316,055663,崇越中信97購01,0.21,0.21,0.12,0.12,-0.03,-20.0,201000,3,24210,0,0,0,0,0,0,0,200000,-200000,-200000
20200316,055664,和大群益98購02,,,,,0.00,0.00,0,0,0,0,0,0,0,0,0,0,0,0,0
20200316,055665,亞德客群益97購01,0.56,0.57,0.54,0.57,+0.17,42.5,65000,4,36750,0,0,0,0,0,0,65000,0,65000,65000
20200316,055666,鴻海群益97購05,0.04,0.04,0.04,0.04,-0.05,-55.56,150000,3,6000,0,0,0,0,0,0,0,150000,-150000,-150000
20200316,055667,致茂群益98購01,,,,,0.00,0.00,0,0,0,0,0,0,0,0,0,0,0,0,0
20200316,055668,欣興群益97購01,,,,,0.00,0.00,0,0,0,0,0,0,0,0,0,0,0,0,0
20200316,055669,緯穎群益97購02,1.23,1.23,1.23,1.23,+0.16,14.95,5000,1,6150,0,0,0,0,0,0,0,5000,-5000,-5000
20200316,05566P,景碩永豐96售01,,,,,0.00,0.00,0,0,0,0,0,0,0,0,0,0,0,0,0
20200316,055670,矽創群益98購02,,,,,0.00,0.00,0,0,0,0,0,0,0,0,0,0,0,0,0
20200316,055671,世紀鋼群益97購01,4.07,4.07,3.62,3.62,+0.01,0.28,31000,7,122930,0,0,0,0,0,0,27000,4000,23000,23000
20200316,055672,國巨日盛97購02,0.41,0.48,0.28,0.28,-0.08,-22.22,153000,18,67160,0,0,0,0,0,0,150000,123000,27000,27000
20200316,055673,旺宏日盛97購01,,,,,0.00,0.00,0,0,0,0,0,0,0,0,0,0,0,0,0
20200316,055674,南港康和97購02,0.51,0.56,0.50,0.56,0.00,0.00,147000,4,77010,0,0,0,0,0,0,0,147000,-147000,-147000
20200316,055675,亞德客凱基97購02,0.40,0.40,0.34,0.34,+0.09,36.0,4000,4,1480,0,0,0,0,0,0,2000,2000,0,0
20200316,055676,亞德客凱基97購03,0.39,0.41,0.39,0.41,+0.10,32.26,8000,2,3200,0,0,0,0,0,0,8000,0,8000,8000
20200316,055677,喬山凱基97購01,,,,,0.00,0.00,0,0,0,0,0,0,0,0,0,0,0,0,0
20200316,055678,上銀凱基97購02,0.11,0.11,0.11,0.11,0.00,0.00,20000,1,2200,0,0,0,0,0,0,20000,0,20000,20000
20200316,055679,華通凱基99購01,0.13,0.13,0.13,0.13,+0.01,8.33,10000,1,1300,0,0,0,0,0,0,10000,0,10000,10000
20200316,05567P,致伸群益96售01,,,,,0.00,0.00,0,0,0,0,0,0,0,0,0,0,0,0,0
20200316,055680,美律凱基99購01,0.24,0.24,0.24,0.24,+0.04,20.0,5000,1,1200,0,0,0,0,0,0,0,5000,-5000,-5000
20200316,055681,奇鋐凱基98購03,0.21,0.21,0.21,0.21,0.00,0.00,170000,1,35700,0,0,0,0,0,0,170000,0,170000,170000
20200316,055682,智原凱基98購02,,,,,0.00,0.00,0,0,0,0,0,0,0,0,0,0,0,0,0
20200316,055683,晶技凱基99購01,0.62,0.64,0.46,0.47,-0.09,-16.07,58000,9,33790,0,0,0,0,0,0,17000,41000,-24000,-24000
20200316,055684,京鼎凱基97購01,,,,,0.00,0.00,0,0,0,0,0,0,0,0,0,0,0,0,0
20200316,055685,日月光凱基97購02,,,,,0.00,0.00,0,0,0,0,0,0,0,0,0,0,0,0,0
20200316,055686,致伸凱基97購02,,,,,0.00,0.00,0,0,0,0,0,0,0,0,0,0,0,0,0
20200316,055687,瀚宇博凱基97購01,0.40,0.40,0.40,0.40,+0.05,14.29,20000,1,8000,0,0,0,0,0,0,20000,0,20000,20000
20200316,055688,力成凱基98購02,0.34,0.34,0.34,0.34,+0.05,17.24,6000,1,2040,0,0,0,0,0,0,0,6000,-6000,-6000
20200316,055689,台郡凱基99購01,,,,,0.00,0.00,0,0,0,0,0,0,0,0,0,0,0,0,0
20200316,05568P,台積電統一96售03,1.52,1.85,1.52,1.85,+0.45,32.14,41000,4,66350,0,0,0,0,0,0,41000,0,41000,41000
20200316,055690,矽力凱基97購02,0.36,0.36,0.36,0.36,-0.07,-16.28,20000,2,7200,0,0,0,0,0,0,0,20000,-20000,-20000
20200316,055691,訊芯凱基97購02,0.10,0.10,0.10,0.10,0.00,0.00,10000,1,1000,0,0,0,0,0,0,0,10000,-10000,-10000
20200316,055692,緯穎凱基97購03,,,,,0.00,0.00,0,0,0,0,0,0,0,0,0,0,0,0,0
20200316,055693,南茂凱基97購01,0.30,0.30,0.30,0.30,+0.02,7.14,360000,1,108000,0,0,0,0,0,0,360000,0,360000,360000
20200316,055694,光罩國票98購01,0.48,0.48,0.39,0.39,0.00,0.00,167000,2,66030,0,0,0,0,0,0,167000,0,167000,167000
20200316,055695,大毅國票98購03,2.31,2.59,2.31,2.59,+0.32,14.1,30000,2,74900,0,0,0,0,0,0,30000,0,30000,30000
20200316,055696,華新科國票98購01,,,,,0.00,0.00,0,0,0,0,0,0,0,0,0,0,0,0,0
20200316,055697,牧德國票98購01,0.20,0.20,0.13,0.13,-0.04,-23.53,162000,15,25700,0,0,0,0,0,0,22000,140000,-118000,-118000
20200316,055698,茂林國票98購03,0.34,0.34,0.34,0.34,-0.12,-26.09,35000,1,11900,0,0,0,0,0,0,35000,0,35000,35000
20200316,055699,康控國票97購04,0.05,0.05,0.05,0.05,-0.05,-50.0,10000,1,500,0,0,0,0,0,0,0,10000,-10000,-10000
20200316,05569P,漢唐統一97售01,,,,,0.00,0.00,0,0,0,0,0,0,0,0,0,0,0,0,0
20200316,055700,緯穎國泰98購02,1.50,1.67,1.50,1.61,+0.17,11.81,129000,25,203620,0,0,0,0,0,0,118000,20000,98000,98000
20200316,055701,亞德客富邦99購01,0.44,0.51,0.41,0.41,+0.06,17.14,359000,24,169850,0,0,0,0,0,0,59000,300000,-241000,-241000
20200316,055702,美律富邦98購01,0.09,0.09,0.09,0.09,0.00,0.00,3000,1,270,0,0,0,0,0,0,0,3000,-3000,-3000
20200316,055703,緯穎富邦98購01,0.32,0.36,0.24,0.25,-0.05,-16.67,211000,21,61370,0,0,0,0,0,0,74000,82000,-8000,-8000
20200316,055704,亞德客永豐97購04,,,,,0.00,0.00,0,0,0,0,0,0,0,0,0,0,0,0,0
20200316,055705,微星永豐97購01,,,,,0.00,0.00,0,0,0,0,0,0,0,0,0,0,0,0,0
20200316,055706,大立光永豐97購03,,,,,0.00,0.00,0,0,0,0,0,0,0,0,0,0,0,0,0
20200316,055707,聯鈞永豐98購01,0.55,0.55,0.55,0.55,+0.17,44.74,2000,1,1100,0,0,0,0,0,0,2000,0,2000,2000
20200316,055708,茂林永豐97購02,,,,,0.00,0.00,0,0,0,0,0,0,0,0,0,0,0,0,0
20200316,055709,深中小元大97購03,0.47,0.47,0.38,0.38,-0.03,-7.32,50000,4,20900,0,0,0,0,0,0,20000,30000,-10000,-10000
20200316,05570P,聯發科統一96售04,,,,,0.00,0.00,0,0,0,0,0,0,0,0,0,0,0,0,0
20200316,055710,亞德客元大97購03,0.66,0.79,0.54,0.55,-0.03,-5.17,88000,16,62030,0,0,0,0,0,0,40000,48000,-8000,-8000
20200316,055711,上銀元大97購04,0.36,0.44,0.20,0.20,-0.22,-52.38,32000,5,9520,0,0,0,0,0,0,20000,22000,-2000,-2000
20200316,055712,金寶元大97購02,0.34,0.34,0.34,0.34,+0.04,13.33,10000,1,3400,0,0,0,0,0,0,10000,0,10000,10000
20200316,055713,國巨元大98購09,1.80,1.80,1.80,1.80,+0.65,56.52,30000,1,54000,0,0,0,0,0,0,30000,0,30000,30000
20200316,055714,智邦元大97購03,1.21,1.41,1.21,1.23,+0.19,18.27,62000,6,79790,0,0,0,0,0,0,52000,41000,11000,11000
20200316,055715,智邦元大97購04,2.53,2.65,2.53,2.65,+0.92,53.18,12000,2,30600,0,0,0,0,0,0,12000,0,12000,12000
20200316,055716,致茂元大97購01,0.87,0.87,0.50,0.50,-0.10,-16.67,69000,7,42610,0,0,0,0,0,0,23000,46000,-23000,-23000
20200316,055717,聯發科元大97購19,,,,,0.00,0.00,0,0,0,0,0,0,0,0,0,0,0,0,0
20200316,055718,可成元大97購02,0.29,0.30,0.25,0.25,-0.03,-10.71,220000,25,58420,0,0,0,0,0,0,22000,198000,-176000,-176000
20200316,055719,可成元大97購03,0.51,0.53,0.44,0.44,-0.08,-15.38,325000,29,159950,0,0,0,0,0,0,295000,190000,105000,105000
20200316,05571P,大立光統一96售03,3.79,3.79,3.79,3.79,+0.24,6.76,1000,1,3790,0,0,0,0,0,0,1000,0,1000,1000
20200316,055720,宏達電元大97購05,0.35,0.35,0.33,0.33,+0.04,13.79,5000,2,1730,0,0,0,0,0,0,5000,5000,0,0
20200316,055721,聯詠元大97購04,0.22,0.23,0.22,0.23,+0.03,15.0,30000,3,6700,0,0,0,0,0,0,30000,0,30000,30000
20200316,055722,聯鈞元大97購03,1.02,1.07,0.82,0.82,-0.18,-18.0,79000,14,80340,0,0,0,0,0,0,35000,44000,-9000,-9000
20200316,055723,康控元大97購04,0.13,0.13,0.13,0.13,0.00,0.00,5000,1,650,0,0,0,0,0,0,0,5000,-5000,-5000
20200316,055724,祥碩元大97購03,3.64,3.72,2.82,2.84,-0.26,-8.39,96000,17,319760,0,0,0,0,0,0,34000,86000,-52000,-52000
20200316,055725,嘉聯益元大98購03,,,,,0.00,0.00,0,0,0,0,0,0,0,0,0,0,0,0,0
20200316,055726,台表科元大98購03,0.72,0.72,0.62,0.64,+0.06,10.34,42000,4,27840,0,0,0,0,0,0,32000,10000,22000,22000
20200316,055727,矽力元大97購02,1.26,1.26,1.06,1.06,-0.63,-37.28,2000,2,2320,0,0,0,0,0,0,0,2000,-2000,-2000
20200316,055728,緯穎元大97購03,1.08,1.08,0.93,0.93,+0.04,4.49,76000,6,78770,0,0,0,0,0,0,76000,15000,61000,61000
20200316,055729,金寶元富99購01,0.31,0.31,0.20,0.21,-0.10,-32.26,428000,19,105440,0,0,0,0,0,0,280000,148000,132000,132000
20200316,05572P,群創統一96售02,,,,,0.00,0.00,0,0,0,0,0,0,0,0,0,0,0,0,0
20200316,055730,建準元富97購02,0.28,0.28,0.28,0.28,0.00,0.00,10000,1,2800,0,0,0,0,0,0,0,10000,-10000,-10000
20200316,055731,美律元富97購01,,,,,0.00,0.00,0,0,0,0,0,0,0,0,0,0,0,0,0
20200316,055732,全新元富9A購01,,,,,0.00,0.00,0,0,0,0,0,0,0,0,0,0,0,0,0
20200316,055733,奇力新元富97購01,,,,,0.00,0.00,0,0,0,0,0,0,0,0,0,0,0,0,0
20200316,055734,奇力新元富97購02,,,,,0.00,0.00,0,0,0,0,0,0,0,0,0,0,0,0,0
20200316,055735,宏達電元富98購01,0.22,0.24,0.12,0.12,-0.13,-52.0,965000,18,213300,0,0,0,0,0,0,865000,100000,765000,765000
20200316,055736,宏達電元富99購01,,,,,0.00,0.00,0,0,0,0,0,0,0,0,0,0,0,0,0
20200316,055737,開發金元富97購01,,,,,0.00,0.00,0,0,0,0,0,0,0,0,0,0,0,0,0
20200316,055738,玉山金元富97購01,0.97,1.12,0.77,0.80,-0.48,-37.5,828000,27,759680,0,0,0,0,0,0,505000,248000,257000,257000
20200316,055739,健鼎元富97購01,0.21,0.21,0.21,0.21,+0.01,5.0,30000,1,6300,0,0,0,0,0,0,30000,0,30000,30000
20200316,05573P,仁寶元富96售02,1.43,1.55,1.41,1.55,+0.09,6.16,260000,32,384930,0,0,0,0,0,0,170000,130000,40000,40000
20200316,055740,智易元富97購01,,,,,0.00,0.00,0,0,0,0,0,0,0,0,0,0,0,0,0
20200316,055741,健策元富97購01,0.18,0.18,0.18,0.18,-0.01,-5.26,100000,1,18000,0,0,0,0,0,0,100000,0,100000,100000
20200316,055742,健策元富97購02,0.07,0.07,0.06,0.06,0.00,0.00,70000,7,4300,0,0,0,0,0,0,0,70000,-70000,-70000
20200316,055743,TPK元富98購01,,,,,0.00,0.00,0,0,0,0,0,0,0,0,0,0,0,0,0
20200316,055744,茂林元富97購02,0.32,0.32,0.19,0.19,-0.16,-45.71,90000,11,20110,0,0,0,0,0,0,39000,52000,-13000,-13000
20200316,055745,臻鼎元富97購01,0.07,0.09,0.06,0.06,-0.01,-14.29,270000,18,21600,0,0,0,0,0,0,120000,150000,-30000,-30000
20200316,055746,同欣電元富97購01,,,,,0.00,0.00,0,0,0,0,0,0,0,0,0,0,0,0,0
20200316,055747,康舒元富97購01,0.49,0.49,0.46,0.46,+0.02,4.55,28000,3,13420,0,0,0,0,0,0,18000,10000,8000,8000
20200316,055748,GIS元富97購01,0.15,0.15,0.15,0.15,0.00,0.00,20000,1,3000,0,0,0,0,0,0,0,20000,-20000,-20000
20200316,055749,智邦永昌9C購01,,,,,0.00,0.00,0,0,0,0,0,0,0,0,0,0,0,0,0
20200316,05574P,英業達元富96售01,1.50,1.55,1.39,1.55,+0.17,12.32,239000,28,349590,0,0,0,0,0,0,229000,10000,219000,219000
20200316,055750,瑞昱永昌9C購01,,,,,0.00,0.00,0,0,0,0,0,0,0,0,0,0,0,0,0
20200316,055751,南亞科永昌9C購01,,,,,0.00,0.00,0,0,0,0,0,0,0,0,0,0,0,0,0
20200316,055752,臺股指永昌97購01,,,,,0.00,0.00,0,0,0,0,0,0,0,0,0,0,0,0,0
20200316,055753,貿聯第一98購01,,,,,0.00,0.00,0,0,0,0,0,0,0,0,0,0,0,0,0
20200316,055754,和大兆豐97購01,0.08,0.08,0.07,0.07,+0.01,16.67,51000,6,3920,0,0,0,0,0,0,0,51000,-51000,-51000
20200316,055755,禾伸堂兆豐97購02,0.74,0.78,0.74,0.78,+0.09,13.04,146000,4,110970,0,0,0,0,0,0,64000,82000,-18000,-18000
20200316,055756,臺股指兆豐97購01,,,,,0.00,0.00,0,0,0,0,0,0,0,0,0,0,0,0,0
20200316,055757,大成鋼群益99購01,0.27,0.27,0.27,0.27,-0.03,-10.0,26000,3,7020,0,0,0,0,0,0,25000,1000,24000,24000
20200316,055758,旺宏群益97購01,0.59,0.59,0.49,0.49,-0.04,-7.55,32000,4,16060,0,0,0,0,0,0,32000,0,32000,32000
20200316,055759,技嘉群益98購02,0.46,0.46,0.40,0.40,-0.04,-9.09,42000,5,18540,0,0,0,0,0,0,32000,10000,22000,22000
20200316,05575P,玉晶光元富96售01,1.39,1.85,1.39,1.78,+0.28,18.67,995000,39,1731520,0,0,0,0,0,0,404000,922000,-518000,-518000
20200316,055760,新日興群益98購02,,,,,0.00,0.00,0,0,0,0,0,0,0,0,0,0,0,0,0
20200316,055761,創意群益97購01,0.19,0.19,0.19,0.19,+0.05,35.71,6000,1,1140,0,0,0,0,0,0,0,6000,-6000,-6000
20200316,055762,智伸科群益97購01,,,,,0.00,0.00,0,0,0,0,0,0,0,0,0,0,0,0,0
20200316,055763,鎧勝群益97購01,0.13,0.13,0.13,0.13,0.00,0.00,20000,1,2600,0,0,0,0,0,0,20000,0,20000,20000
20200316,055764,臺股指群益97購02,,,,,0.00,0.00,0,0,0,0,0,0,0,0,0,0,0,0,0
20200316,055765,臺股指群益97購03,,,,,0.00,0.00,0,0,0,0,0,0,0,0,0,0,0,0,0
20200316,055766,臺股指群益97購04,,,,,0.00,0.00,0,0,0,0,0,0,0,0,0,0,0,0,0
20200316,055767,臺股指群益97購05,,,,,0.00,0.00,0,0,0,0,0,0,0,0,0,0,0,0,0
20200316,055768,臺股指群益97購06,0.10,0.10,0.04,0.04,+0.03,300.0,91000,2,3700,0,0,0,0,0,0,0,0,0,0
20200316,055769,智伸科中信97購01,,,,,0.00,0.00,0,0,0,0,0,0,0,0,0,0,0,0,0
20200316,05576P,群創日盛99售02,1.02,1.19,1.02,1.19,-0.01,-0.83,53000,3,57120,0,0,0,0,0,0,35000,18000,17000,17000
20200316,055770,欣興麥證97購01,0.09,0.09,0.09,0.09,-0.01,-10.0,10000,1,900,0,10000,-10000,0,0,0,0,10000,-10000,-10000
20200316,055771,台積電日盛97購04,0.11,0.14,0.08,0.09,-0.06,-40.0,1432000,30,148160,0,0,0,0,0,0,952000,10000,942000,942000
20200316,055772,致茂凱基97購01,,,,,0.00,0.00,0,0,0,0,0,0,0,0,0,0,0,0,0
20200316,055773,瑞昱凱基97購03,,,,,0.00,0.00,0,0,0,0,0,0,0,0,0,0,0,0,0
20200316,055774,台光電凱基97購02,0.26,0.27,0.25,0.25,0.00,0.00,60000,4,15500,0,0,0,0,0,0,60000,0,60000,60000
20200316,055775,友達凱基9A購01,,,,,0.00,0.00,0,0,0,0,0,0,0,0,0,0,0,0,0
20200316,055776,宏達電凱基98購02,0.62,0.62,0.62,0.62,+0.31,100.0,1000,1,620,0,0,0,0,0,0,1000,0,1000,1000
20200316,055777,冠德凱基97購01,,,,,0.00,0.00,0,0,0,0,0,0,0,0,0,0,0,0,0
20200316,055778,美食凱基97購01,,,,,0.00,0.00,0,0,0,0,0,0,0,0,0,0,0,0,0
20200316,055779,國泰金凱基97購02,,,,,0.00,0.00,0,0,0,0,0,0,0,0,0,0,0,0,0
20200316,05577P,上銀凱基96售02,1.17,1.17,0.97,1.12,-0.05,-4.27,213000,4,228810,0,0,0,0,0,0,12000,201000,-189000,-189000
20200316,055780,禾伸堂凱基99購01,1.30,1.30,1.26,1.26,0.00,0.00,84000,2,106240,0,0,0,0,0,0,84000,0,84000,84000
20200316,055781,聯詠凱基98購01,0.30,0.30,0.22,0.22,+0.03,15.79,3000,2,740,0,0,0,0,0,0,1000,2000,-1000,-1000
20200316,055782,新日興凱基99購01,0.41,0.41,0.35,0.35,-0.01,-2.78,20000,2,7600,0,0,0,0,0,0,0,20000,-20000,-20000
20200316,055783,群創凱基99購03,0.05,0.05,0.05,0.05,0.00,0.00,30000,3,1500,0,0,0,0,0,0,0,0,0,0
20200316,055784,TPK凱基97購02,,,,,0.00,0.00,0,0,0,0,0,0,0,0,0,0,0,0,0
20200316,055785,祥碩凱基97購02,1.34,1.35,1.21,1.22,+0.12,10.91,53000,22,67430,0,0,0,0,0,0,53000,53000,0,0
20200316,055786,彩晶凱基99購02,,,,,0.00,0.00,0,0,0,0,0,0,0,0,0,0,0,0,0
20200316,055787,聯茂凱基99購01,0.97,0.97,0.92,0.92,+0.07,8.24,12000,2,11340,0,0,0,0,0,0,0,12000,-12000,-12000
20200316,055788,緯穎凱基97購04,2.41,2.41,2.10,2.23,+0.90,67.67,121000,28,276020,0,0,0,0,0,0,65000,56000,9000,9000
20200316,055789,台虹凱基97購01,,,,,0.00,0.00,0,0,0,0,0,0,0,0,0,0,0,0,0
20200316,05578P,鴻海凱基96售11,7.05,7.05,7.05,7.05,+1.20,20.51,20000,1,141000,0,0,0,0,0,0,20000,20000,0,0
20200316,055790,南電凱基97購01,0.77,0.77,0.53,0.53,-0.09,-14.52,452000,11,317740,0,0,0,0,0,0,392000,50000,342000,342000
20200316,055791,臺股指凱基97購14,0.05,0.05,0.05,0.05,-0.08,-61.54,10000,1,500,0,0,0,0,0,0,0,0,0,0
20200316,055792,臺股指凱基97購15,,,,,0.00,0.00,0,0,0,0,0,0,0,0,0,0,0,0,0
20200316,055793,臺股指凱基97購16,0.02,0.02,0.02,0.02,0.00,0.00,300000,30,6000,0,0,0,0,0,0,0,300000,-300000,-300000
20200316,055794,聯發科國泰99購01,,,,,0.00,0.00,0,0,0,0,0,0,0,0,0,0,0,0,0
20200316,055795,茂林國泰98購01,0.34,0.34,0.34,0.34,-0.04,-10.53,3000,1,1020,0,0,0,0,0,0,3000,0,3000,3000
20200316,055796,南電國泰98購01,0.97,0.97,0.97,0.97,+0.11,12.79,1000,1,970,0,0,0,0,0,0,1000,0,1000,1000
20200316,055797,華通富邦98購01,0.09,0.09,0.09,0.09,0.00,0.00,10000,1,900,0,0,0,0,0,0,0,0,0,0
20200316,055798,聯茂富邦98購01,0.41,0.44,0.31,0.31,-0.11,-26.19,780000,26,317160,0,0,0,0,0,0,200000,580000,-380000,-380000
20200316,055799,致茂永豐97購02,,,,,0.00,0.00,0,0,0,0,0,0,0,0,0,0,0,0,0
20200316,05579P,友達凱基98售03,,,,,0.00,0.00,0,0,0,0,0,0,0,0,0,0,0,0,0
20200316,055800,欣興永豐97購02,0.02,0.02,0.02,0.02,0.00,0.00,600000,2,12000,0,0,0,0,0,0,600000,0,600000,600000
20200316,055801,景碩永豐97購02,,,,,0.00,0.00,0,0,0,0,0,0,0,0,0,0,0,0,0
20200316,055802,新日興永豐97購01,,,,,0.00,0.00,0,0,0,0,0,0,0,0,0,0,0,0,0
20200316,055803,鎧勝永豐97購01,,,,,0.00,0.00,0,0,0,0,0,0,0,0,0,0,0,0,0
20200316,055804,祥碩永豐97購02,0.93,0.95,0.83,0.95,+0.08,9.2,155000,16,139410,0,0,0,0,0,0,154000,30000,124000,124000
20200316,055805,矽力永豐97購01,,,,,0.00,0.00,0,0,0,0,0,0,0,0,0,0,0,0,0
20200316,055806,致新永豐97購02,,,,,0.00,0.00,0,0,0,0,0,0,0,0,0,0,0,0,0
20200316,055807,勤誠永豐97購01,0.19,0.19,0.17,0.17,0.00,0.00,20000,2,3600,0,0,0,0,0,0,0,20000,-20000,-20000
20200316,055808,世紀鋼永豐97購01,1.64,1.70,1.33,1.33,-0.07,-5.0,571000,49,865800,0,0,0,0,0,0,391000,173000,218000,218000
20200316,055809,T50反1國票98購02,2.16,2.42,2.16,2.42,-0.20,-7.63,32000,4,74470,0,0,0,0,0,0,32000,0,32000,32000
20200316,05580P,美律凱基96售03,2.00,2.26,1.97,2.26,-0.36,-13.74,98000,8,199300,0,0,0,0,0,0,6000,92000,-86000,-86000
20200316,055810,T50反1國票99購01,,,,,0.00,0.00,0,0,0,0,0,0,0,0,0,0,0,0,0
20200316,055811,國巨國票98購05,0.73,0.73,0.51,0.51,-0.33,-39.29,410000,9,282050,0,0,0,0,0,0,395000,10000,385000,385000
20200316,055812,台積電國票99購02,0.10,0.10,0.04,0.04,-0.05,-55.56,299000,10,16530,0,0,0,0,0,0,0,0,0,0
20200316,055813,聯發科國票98購04,,,,,0.00,0.00,0,0,0,0,0,0,0,0,0,0,0,0,0
20200316,055814,晶豪科國票97購02,,,,,0.00,0.00,0,0,0,0,0,0,0,0,0,0,0,0,0
20200316,055815,亞光國票99購01,,,,,0.00,0.00,0,0,0,0,0,0,0,0,0,0,0,0,0
20200316,055816,新日興國票98購01,0.51,0.51,0.37,0.37,-0.13,-26.0,42000,2,21140,0,0,0,0,0,0,40000,2000,38000,38000
20200316,055817,京鼎國票99購01,,,,,0.00,0.00,0,0,0,0,0,0,0,0,0,0,0,0,0
20200316,055818,晶相光國票97購02,0.62,0.62,0.62,0.62,+0.09,16.98,6000,1,3720,0,0,0,0,0,0,6000,0,6000,6000
20200316,055819,晶相光國票98購01,,,,,0.00,0.00,0,0,0,0,0,0,0,0,0,0,0,0,0
20200316,05581P,華新科凱基96售07,0.90,0.91,0.90,0.91,0.00,0.00,11000,2,9910,0,0,0,0,0,0,10000,11000,-1000,-1000
20200316,055820,矽力國票98購02,0.62,0.62,0.62,0.62,0.00,0.00,10000,1,6200,0,0,0,0,0,0,0,10000,-10000,-10000
20200316,055821,勤誠國票98購01,0.56,0.56,0.54,0.54,+0.17,45.95,20000,2,11000,0,0,0,0,0,0,20000,0,20000,20000
20200316,055822,臺股指國票97購09,,,,,0.00,0.00,0,0,0,0,0,0,0,0,0,0,0,0,0
20200316,055823,臺股指國票97購10,,,,,0.00,0.00,0,0,0,0,0,0,0,0,0,0,0,0,0
20200316,055824,臺股指國票97購11,,,,,0.00,0.00,0,0,0,0,0,0,0,0,0,0,0,0,0
20200316,055825,臺股指國票97購12,,,,,0.00,0.00,0,0,0,0,0,0,0,0,0,0,0,0,0
20200316,055826,中石化元大97購01,0.11,0.11,0.10,0.11,+0.03,37.5,221000,3,22310,0,0,0,0,0,0,221000,1000,220000,220000
20200316,055827,中石化元大98購01,0.12,0.12,0.12,0.12,+0.03,33.33,4000,1,480,0,0,0,0,0,0,0,4000,-4000,-4000
20200316,055828,上銀元大97購05,0.60,0.72,0.34,0.34,-0.37,-52.11,135000,12,80570,0,0,0,0,0,0,77000,66000,11000,11000
20200316,055829,上銀元大97購06,0.66,0.66,0.65,0.65,-0.06,-8.45,50000,2,32600,0,0,0,0,0,0,50000,0,50000,50000
20200316,05582P,群創凱基98售06,,,,,0.00,0.00,0,0,0,0,0,0,0,0,0,0,0,0,0
20200316,055830,上銀元大97購07,0.84,0.84,0.67,0.68,-0.16,-19.05,26000,3,19180,0,0,0,0,0,0,26000,16000,10000,10000
20200316,055831,台達電元大97購01,0.27,0.27,0.21,0.21,-0.06,-22.22,371000,14,93070,0,0,0,0,0,0,250000,121000,129000,129000
20200316,055832,台達電元大97購02,0.09,0.09,0.06,0.06,-0.03,-33.33,40000,4,2700,0,0,0,0,0,0,10000,30000,-20000,-20000
20200316,055833,華通元大98購05,0.15,0.15,0.15,0.15,+0.03,25.0,50000,1,7500,0,0,0,0,0,0,50000,0,50000,50000
20200316,055834,國巨元大97購13,1.14,1.14,0.73,0.76,-0.22,-22.45,50000,4,45300,0,0,0,0,0,0,20000,30000,-10000,-10000
20200316,055835,華邦電元大97購03,,,,,0.00,0.00,0,0,0,0,0,0,0,0,0,0,0,0,0
20200316,055836,華邦電元大97購04,,,,,0.00,0.00,0,0,0,0,0,0,0,0,0,0,0,0,0
20200316,055837,致茂元大97購02,,,,,0.00,0.00,0,0,0,0,0,0,0,0,0,0,0,0,0
20200316,055838,致茂元大97購03,,,,,0.00,0.00,0,0,0,0,0,0,0,0,0,0,0,0,0
20200316,055839,瑞昱元大97購04,0.39,0.39,0.39,0.39,+0.02,5.41,20000,2,7800,0,0,0,0,0,0,10000,10000,0,0
20200316,05583P,訊芯凱基96售01,1.54,2.02,1.54,2.02,+0.20,10.99,460000,12,752580,0,0,0,0,0,0,74000,396000,-322000,-322000
20200316,055840,南亞科元大97購03,0.08,0.08,0.07,0.08,0.00,0.00,240000,24,18100,0,0,0,0,0,0,0,240000,-240000,-240000
20200316,055841,南亞科元大97購04,,,,,0.00,0.00,0,0,0,0,0,0,0,0,0,0,0,0,0
20200316,055842,建準元大98購01,,,,,0.00,0.00,0,0,0,0,0,0,0,0,0,0,0,0,0
20200316,055843,美律元大97購02,,,,,0.00,0.00,0,0,0,0,0,0,0,0,0,0,0,0,0
20200316,055844,大毅元大98購01,0.82,0.87,0.62,0.62,-0.17,-21.52,76000,10,61360,0,0,0,0,0,0,58000,18000,40000,40000
20200316,055845,大立光元大97購08,,,,,0.00,0.00,0,0,0,0,0,0,0,0,0,0,0,0,0
20200316,055846,大立光元大97購09,,,,,0.00,0.00,0,0,0,0,0,0,0,0,0,0,0,0,0
20200316,055847,大立光元大97購10,,,,,0.00,0.00,0,0,0,0,0,0,0,0,0,0,0,0,0
20200316,055848,大立光元大97購11,,,,,0.00,0.00,0,0,0,0,0,0,0,0,0,0,0,0,0
20200316,055849,聯詠元大97購05,0.48,0.48,0.47,0.48,-0.04,-7.69,100000,7,47800,0,0,0,0,0,0,30000,40000,-10000,-10000
20200316,05584P,臺股指凱基96售13,6.40,6.40,6.35,6.35,0.00,0.00,10000,2,63600,0,0,0,0,0,0,10000,0,10000,10000
20200316,055850,聯詠元大97購06,0.62,0.70,0.60,0.60,+0.08,15.38,70000,5,45000,0,0,0,0,0,0,40000,30000,10000,10000
20200316,055851,智原元大98購01,,,,,0.00,0.00,0,0,0,0,0,0,0,0,0,0,0,0,0
20200316,055852,聯鈞元大98購01,0.74,0.77,0.57,0.57,-0.15,-20.83,580000,56,402070,0,0,0,0,0,0,71000,499000,-428000,-428000
20200316,055853,群創元大98購03,,,,,0.00,0.00,0,0,0,0,0,0,0,0,0,0,0,0,0
20200316,055854,群創元大98購04,,,,,0.00,0.00,0,0,0,0,0,0,0,0,0,0,0,0,0
20200316,055855,牧德元大99購02,0.23,0.23,0.16,0.16,-0.08,-33.33,103000,11,19880,0,0,0,0,0,0,0,103000,-103000,-103000
20200316,055856,新唐元大97購03,,,,,0.00,0.00,0,0,0,0,0,0,0,0,0,0,0,0,0
20200316,055857,嘉聯益元大97購04,0.25,0.25,0.24,0.24,+0.04,20.0,95000,2,23300,0,0,0,0,0,0,95000,0,95000,95000
20200316,055858,聯茂元大97購03,0.67,0.72,0.48,0.49,-0.04,-7.55,170000,14,98360,0,0,0,0,0,0,90000,82000,8000,8000
20200316,055859,啟碁元大97購03,0.16,0.16,0.16,0.16,+0.01,6.67,10000,1,1600,0,0,0,0,0,0,0,10000,-10000,-10000
20200316,05585P,臺股指凱基96售14,,,,,0.00,0.00,0,0,0,0,0,0,0,0,0,0,0,0,0
20200316,055860,啟碁元大97購04,0.27,0.27,0.22,0.22,-0.07,-24.14,165000,3,43800,0,0,0,0,0,0,150000,5000,145000,145000
20200316,055861,矽力元大97購03,0.58,0.59,0.44,0.44,-0.22,-33.33,235000,24,131300,0,0,0,0,0,0,0,235000,-235000,-235000
20200316,055862,矽力元大97購04,0.74,0.74,0.53,0.53,-0.24,-31.17,46000,5,27250,0,0,0,0,0,0,35000,11000,24000,24000
20200316,055863,緯穎元大97購05,0.70,0.80,0.59,0.59,-0.11,-15.71,845000,53,603550,0,0,0,0,0,0,556000,425000,131000,131000
20200316,055864,臺股指元大97購01,,,,,0.00,0.00,0,0,0,0,0,0,0,0,0,0,0,0,0
20200316,055865,臺股指元大97購02,0.24,0.24,0.22,0.22,0.00,0.00,21000,2,4640,0,0,0,0,0,0,21000,0,21000,21000
20200316,055866,臺股指元大97購03,,,,,0.00,0.00,0,0,0,0,0,0,0,0,0,0,0,0,0
20200316,055867,臺股指元大97購05,0.06,0.06,0.02,0.05,-0.03,-37.5,271000,11,9220,0,0,0,0,0,0,0,0,0,0
20200316,055868,臺股指元大97購07,,,,,0.00,0.00,0,0,0,0,0,0,0,0,0,0,0,0,0
20200316,055869,臺股指元大97購08,,,,,0.00,0.00,0,0,0,0,0,0,0,0,0,0,0,0,0
20200316,05586P,臺股指凱基96售15,7.50,7.65,7.50,7.65,-0.55,-6.71,2000,2,15150,0,0,0,0,0,0,2000,0,2000,2000
20200316,055870,智原台新97購01,,,,,0.00,0.00,0,0,0,0,0,0,0,0,0,0,0,0,0
20200316,055871,群創台新97購02,,,,,0.00,0.00,0,0,0,0,0,0,0,0,0,0,0,0,0
20200316,055872,亞泥元富97購01,0.40,0.40,0.40,0.40,-0.01,-2.44,10000,1,4000,0,0,0,0,0,0,10000,0,10000,10000
20200316,055873,聚陽元富97購01,0.09,0.09,0.07,0.07,-0.03,-30.0,147000,9,11660,0,0,0,0,0,0,27000,120000,-93000,-93000
20200316,055874,中環元富9A購01,0.53,0.54,0.43,0.46,+0.02,4.55,392000,36,199740,0,0,0,0,0,0,52000,320000,-268000,-268000
20200316,055875,光罩元富97購02,,,,,0.00,0.00,0,0,0,0,0,0,0,0,0,0,0,0,0
20200316,055876,美食元富9A購01,0.18,0.19,0.16,0.16,-0.09,-36.0,169000,17,31840,0,0,0,0,0,0,15000,154000,-139000,-139000
20200316,055877,奇鋐元富97購01,0.40,0.40,0.31,0.31,0.00,0.00,48000,4,17380,0,0,0,0,0,0,28000,20000,8000,8000
20200316,055878,泰碩元富97購02,0.54,0.55,0.34,0.34,-0.11,-24.44,26000,6,13280,0,0,0,0,0,0,23000,3000,20000,20000
20200316,055879,神達元富97購01,0.80,0.84,0.63,0.63,-0.19,-23.17,184000,14,143480,0,0,0,0,0,0,118000,66000,52000,52000
20200316,05587P,鴻海凱基96售12,,,,,0.00,0.00,0,0,0,0,0,0,0,0,0,0,0,0,0
20200316,055880,神達元富97購02,0.87,0.91,0.67,0.67,-0.23,-25.56,200000,15,165470,0,0,0,0,0,0,165000,35000,130000,130000
20200316,055881,康控元富97購01,0.14,0.14,0.09,0.09,-0.07,-43.75,77000,8,7280,0,0,0,0,0,0,7000,70000,-63000,-63000
20200316,055882,嘉聯益元富97購01,,,,,0.00,0.00,0,0,0,0,0,0,0,0,0,0,0,0,0
20200316,055883,樺漢元富97購01,,,,,0.00,0.00,0,0,0,0,0,0,0,0,0,0,0,0,0
20200316,055884,臺股指元富97購01,0.02,0.02,0.02,0.02,+0.01,100.0,99000,2,1980,0,0,0,0,0,0,0,0,0,0
20200316,055885,大成鋼統一97購02,,,,,0.00,0.00,0,0,0,0,0,0,0,0,0,0,0,0,0
20200316,055886,上銀統一97購02,,,,,0.00,0.00,0,0,0,0,0,0,0,0,0,0,0,0,0
20200316,055887,上銀統一97購03,,,,,0.00,0.00,0,0,0,0,0,0,0,0,0,0,0,0,0
20200316,055888,鴻海統一97購04,,,,,0.00,0.00,0,0,0,0,0,0,0,0,0,0,0,0,0
20200316,055889,鴻海統一97購05,,,,,0.00,0.00,0,0,0,0,0,0,0,0,0,0,0,0,0
20200316,05588P,群創兆豐97售02,,,,,0.00,0.00,0,0,0,0,0,0,0,0,0,0,0,0,0
20200316,055890,鴻海統一99購01,0.20,0.24,0.20,0.24,+0.10,71.43,28000,3,6320,0,0,0,0,0,0,0,18000,-18000,-18000
20200316,055891,鴻海統一9A購01,0.50,0.50,0.36,0.36,-0.23,-38.98,324000,34,136170,0,0,0,0,0,0,147000,0,147000,147000
20200316,055892,國巨統一99購01,0.74,0.74,0.74,0.74,+0.04,5.71,60000,3,44400,0,0,0,0,0,0,50000,0,50000,50000
20200316,055893,大立光統一97購07,,,,,0.00,0.00,0,0,0,0,0,0,0,0,0,0,0,0,0
20200316,055894,欣興統一97購03,,,,,0.00,0.00,0,0,0,0,0,0,0,0,0,0,0,0,0
20200316,055895,群創統一97購04,,,,,0.00,0.00,0,0,0,0,0,0,0,0,0,0,0,0,0
20200316,055896,南電統一97購02,,,,,0.00,0.00,0,0,0,0,0,0,0,0,0,0,0,0,0
20200316,055897,TXFI0永昌99購01,,,,,0.00,0.00,0,0,0,0,0,0,0,0,0,0,0,0,0
20200316,055898,訊芯第一97購01,,,,,0.00,0.00,0,0,0,0,0,0,0,0,0,0,0,0,0
20200316,055899,群創中信99購01,,,,,0.00,0.00,0,0,0,0,0,0,0,0,0,0,0,0,0
20200316,05589P,大立光中信9A售01,1.14,1.49,1.14,1.49,+0.34,29.57,145000,17,175820,0,0,0,0,0,0,96000,129000,-33000,-33000
20200316,055900,瀚宇博中信97購01,,,,,0.00,0.00,0,0,0,0,0,0,0,0,0,0,0,0,0
20200316,055901,超眾中信97購01,0.03,0.03,0.03,0.03,0.00,0.00,55000,6,1650,0,0,0,0,0,0,0,55000,-55000,-55000
20200316,055902,同欣電中信99購01,0.28,0.28,0.21,0.21,-0.07,-25.0,25000,2,6650,0,0,0,0,0,0,5000,0,5000,5000
20200316,055903,鈺齊中信97購02,,,,,0.00,0.00,0,0,0,0,0,0,0,0,0,0,0,0,0
20200316,055904,貿聯亞東99購01,,,,,0.00,0.00,0,0,0,0,0,0,0,0,0,0,0,0,0
20200316,055905,可成兆豐97購03,,,,,0.00,0.00,0,0,0,0,0,0,0,0,0,0,0,0,0
20200316,055906,大立光兆豐97購03,,,,,0.00,0.00,0,0,0,0,0,0,0,0,0,0,0,0,0
20200316,055907,台虹兆豐98購01,0.67,0.67,0.63,0.63,+0.06,10.53,312000,4,204660,0,0,0,0,0,0,312000,0,312000,312000
20200316,055908,GIS日盛97購01,,,,,0.00,0.00,0,0,0,0,0,0,0,0,0,0,0,0,0
20200316,055909,大成鋼凱基98購02,0.35,0.36,0.35,0.35,-0.09,-20.45,374000,4,134440,0,0,0,0,0,0,0,374000,-374000,-374000
20200316,05590P,臺股指中信96售05,,,,,0.00,0.00,0,0,0,0,0,0,0,0,0,0,0,0,0
20200316,055910,瑞昱凱基98購01,0.33,0.33,0.33,0.33,0.00,0.00,5000,1,1650,0,0,0,0,0,0,0,5000,-5000,-5000
20200316,055911,可成凱基98購02,0.27,0.30,0.27,0.30,-0.06,-16.67,52000,2,15390,0,0,0,0,0,0,0,52000,-52000,-52000
20200316,055912,宏達電凱基98購03,,,,,0.00,0.00,0,0,0,0,0,0,0,0,0,0,0,0,0
20200316,055913,中信金凱基97購01,0.12,0.12,0.10,0.10,0.00,0.00,305000,10,33400,0,0,0,0,0,0,120000,185000,-65000,-65000
20200316,055914,大立光凱基97購13,0.09,0.09,0.09,0.09,-0.01,-10.0,200000,1,18000,0,0,0,0,0,0,0,0,0,0
20200316,055915,大立光凱基98購07,0.28,0.28,0.25,0.25,-0.05,-16.67,105000,3,29340,0,0,0,0,0,0,100000,5000,95000,95000
20200316,055916,奇鋐凱基99購01,,,,,0.00,0.00,0,0,0,0,0,0,0,0,0,0,0,0,0
20200316,055917,禾伸堂凱基98購02,0.24,0.24,0.24,0.24,-0.01,-4.0,5000,1,1200,0,0,0,0,0,0,5000,0,5000,5000
20200316,055918,和鑫凱基97購01,,,,,0.00,0.00,0,0,0,0,0,0,0,0,0,0,0,0,0
20200316,055919,景碩凱基98購02,,,,,0.00,0.00,0,0,0,0,0,0,0,0,0,0,0,0,0
20200316,05591P,義隆群益96售03,,,,,0.00,0.00,0,0,0,0,0,0,0,0,0,0,0,0,0
20200316,055920,智伸科凱基97購02,,,,,0.00,0.00,0,0,0,0,0,0,0,0,0,0,0,0,0
20200316,055921,新唐凱基98購01,0.23,0.23,0.23,0.23,0.00,0.00,15000,1,3450,0,0,0,0,0,0,15000,0,15000,15000
20200316,055922,台郡凱基98購03,0.10,0.10,0.10,0.10,0.00,0.00,10000,1,1000,0,0,0,0,0,0,0,0,0,0
20200316,055923,矽力凱基98購01,0.87,0.87,0.87,0.87,+0.13,17.57,200000,1,174000,0,0,0,0,0,0,200000,0,200000,200000
20200316,055924,深中小群益9B購01,0.54,0.54,0.54,0.54,0.00,0.00,10000,1,5400,0,0,0,0,0,0,10000,0,10000,10000
20200316,055925,上銀群益97購01,,,,,0.00,0.00,0,0,0,0,0,0,0,0,0,0,0,0,0
20200316,055926,國巨群益98購06,,,,,0.00,0.00,0,0,0,0,0,0,0,0,0,0,0,0,0
20200316,055927,南亞科群益97購01,,,,,0.00,0.00,0,0,0,0,0,0,0,0,0,0,0,0,0
20200316,055928,南亞科群益97購02,,,,,0.00,0.00,0,0,0,0,0,0,0,0,0,0,0,0,0
20200316,055929,聯發科群益97購05,,,,,0.00,0.00,0,0,0,0,0,0,0,0,0,0,0,0,0
20200316,05592P,可成群益96售03,,,,,0.00,0.00,0,0,0,0,0,0,0,0,0,0,0,0,0
20200316,055930,可成群益98購01,,,,,0.00,0.00,0,0,0,0,0,0,0,0,0,0,0,0,0
20200316,055931,冠德群益97購02,0.06,0.06,0.06,0.06,+0.02,50.0,20000,1,1200,0,0,0,0,0,0,0,20000,-20000,-20000
20200316,055932,玉山金群益99購01,0.81,0.81,0.62,0.62,-0.05,-7.46,47000,6,35670,0,0,0,0,0,0,27000,20000,7000,7000
20200316,055933,欣興群益98購02,,,,,0.00,0.00,0,0,0,0,0,0,0,0,0,0,0,0,0
20200316,055934,景碩群益98購03,,,,,0.00,0.00,0,0,0,0,0,0,0,0,0,0,0,0,0
20200316,055935,創意群益97購02,,,,,0.00,0.00,0,0,0,0,0,0,0,0,0,0,0,0,0
20200316,055936,彩晶群益98購02,,,,,0.00,0.00,0,0,0,0,0,0,0,0,0,0,0,0,0
20200316,055937,康舒群益97購01,,,,,0.00,0.00,0,0,0,0,0,0,0,0,0,0,0,0,0
20200316,055938,矽力群益97購01,0.49,0.49,0.28,0.28,-0.23,-45.1,211000,12,74960,0,0,0,0,0,0,20000,191000,-171000,-171000
20200316,055939,GIS群益97購01,,,,,0.00,0.00,0,0,0,0,0,0,0,0,0,0,0,0,0
20200316,05593P,鴻海國票97售03,,,,,0.00,0.00,0,0,0,0,0,0,0,0,0,0,0,0,0
20200316,055940,致新群益98購01,0.36,0.36,0.36,0.36,-0.06,-14.29,1000,1,360,0,0,0,0,0,0,1000,0,1000,1000
20200316,055941,百和群益98購02,,,,,0.00,0.00,0,0,0,0,0,0,0,0,0,0,0,0,0
20200316,055942,臺股指群益9C購01,,,,,0.00,0.00,0,0,0,0,0,0,0,0,0,0,0,0,0
20200316,055943,瑞昱麥證97購01,,,,,0.00,0.00,0,0,0,0,0,0,0,0,0,0,0,0,0
20200316,055944,日月光麥證97購01,,,,,0.00,0.00,0,0,0,0,0,0,0,0,0,0,0,0,0
20200316,055945,上証2X元大97購04,,,,,0.00,0.00,0,0,0,0,0,0,0,0,0,0,0,0,0
20200316,055946,元油反元大97購02,,,,,0.00,0.00,0,0,0,0,0,0,0,0,0,0,0,0,0
20200316,055947,元油反元大98購03,,,,,0.00,0.00,0,0,0,0,0,0,0,0,0,0,0,0,0
20200316,055948,道瓊銀元大98購02,,,,,0.00,0.00,0,0,0,0,0,0,0,0,0,0,0,0,0
20200316,055949,亞德客元大97購04,0.75,0.86,0.75,0.81,+0.26,47.27,50000,5,41000,0,0,0,0,0,0,40000,30000,10000,10000
20200316,05594P,旺宏國票96售04,,,,,0.00,0.00,0,0,0,0,0,0,0,0,0,0,0,0,0
20200316,055950,華新元大97購02,,,,,0.00,0.00,0,0,0,0,0,0,0,0,0,0,0,0,0
20200316,055951,大成鋼元大97購02,0.32,0.34,0.32,0.33,+0.01,3.12,40000,4,13300,0,0,0,0,0,0,20000,20000,0,0
20200316,055952,上銀元大97購08,0.48,0.48,0.27,0.27,-0.14,-34.15,41000,2,19470,0,0,0,0,0,0,40000,1000,39000,39000
20200316,055953,上銀元大97購09,0.76,0.76,0.48,0.48,-0.03,-5.88,56000,6,38300,0,0,0,0,0,0,32000,24000,8000,8000
20200316,055954,南港元大97購02,0.36,0.37,0.36,0.37,0.00,0.00,2000,2,730,0,0,0,0,0,0,1000,1000,0,0
20200316,055955,微星元大97購01,1.16,1.16,1.16,1.16,+0.22,23.4,10000,1,11600,0,0,0,0,0,0,10000,0,10000,10000
20200316,055956,瑞昱元大97購05,0.27,0.29,0.25,0.25,-0.08,-24.24,78000,7,20400,0,0,0,0,0,0,58000,68000,-10000,-10000
20200316,055957,瑞昱元大97購06,0.14,0.14,0.12,0.12,0.00,0.00,20000,2,2600,0,0,0,0,0,0,0,20000,-20000,-20000
20200316,055958,台光電元大97購02,0.34,0.34,0.34,0.34,+0.07,25.93,10000,1,3400,0,0,0,0,0,0,0,10000,-10000,-10000
20200316,055959,美律元大97購03,0.15,0.15,0.15,0.15,+0.07,87.5,13000,2,1950,0,0,0,0,0,0,13000,0,13000,13000
20200316,05595P,友達統一96售02,,,,,0.00,0.00,0,0,0,0,0,0,0,0,0,0,0,0,0
20200316,055960,義隆元大97購01,0.76,0.84,0.64,0.64,+0.05,8.47,282000,10,223850,0,0,0,0,0,0,264000,18000,246000,246000
20200316,055961,國泰金元大97購01,,,,,0.00,0.00,0,0,0,0,0,0,0,0,0,0,0,0,0
20200316,055962,晶豪科元大97購02,0.72,0.72,0.72,0.72,+0.18,33.33,10000,1,7200,0,0,0,0,0,0,10000,0,10000,10000
20200316,055963,欣興元大97購04,,,,,0.00,0.00,0,0,0,0,0,0,0,0,0,0,0,0,0
20200316,055964,正文元大97購02,0.41,0.41,0.24,0.24,-0.18,-42.86,70000,7,25900,0,0,0,0,0,0,20000,50000,-30000,-30000
20200316,055965,泰鼎元大97購03,2.04,2.06,2.04,2.06,0.00,0.00,60000,2,122600,0,0,0,0,0,0,50000,10000,40000,40000
20200316,055966,茂林元大99購01,0.40,0.40,0.29,0.29,-0.14,-32.56,88000,9,30930,0,0,0,0,0,0,60000,28000,32000,32000
20200316,055967,臻鼎元大97購01,0.07,0.11,0.06,0.06,-0.03,-33.33,361000,10,27780,0,0,0,0,0,0,301000,50000,251000,251000
20200316,055968,祥碩元大97購04,3.26,3.29,2.60,2.60,-0.54,-17.2,191000,40,601690,0,0,0,0,0,0,59000,179000,-120000,-120000
20200316,055969,彩晶元大99購02,,,,,0.00,0.00,0,0,0,0,0,0,0,0,0,0,0,0,0
20200316,05596P,可成統一96售01,,,,,0.00,0.00,0,0,0,0,0,0,0,0,0,0,0,0,0
20200316,055970,聯茂元大97購04,,,,,0.00,0.00,0,0,0,0,0,0,0,0,0,0,0,0,0
20200316,055971,矽力元大97購05,0.61,0.61,0.33,0.33,-0.25,-43.1,216000,23,86800,0,0,0,0,0,0,10000,206000,-196000,-196000
20200316,055972,GIS元大97購04,,,,,0.00,0.00,0,0,0,0,0,0,0,0,0,0,0,0,0
20200316,055973,亞德客統一97購01,,,,,0.00,0.00,0,0,0,0,0,0,0,0,0,0,0,0,0
20200316,055974,上銀統一97購05,,,,,0.00,0.00,0,0,0,0,0,0,0,0,0,0,0,0,0
20200316,055975,鴻海統一98購05,0.14,0.14,0.14,0.14,-0.01,-6.67,10000,1,1400,0,0,0,0,0,0,10000,0,10000,10000
20200316,055976,台積電統一99購03,0.17,0.17,0.11,0.11,-0.19,-63.33,90000,4,10500,0,0,0,0,0,0,0,10000,-10000,-10000
20200316,055977,南亞科統一97購01,,,,,0.00,0.00,0,0,0,0,0,0,0,0,0,0,0,0,0
20200316,055978,大立光統一98購05,0.10,0.10,0.10,0.10,-0.10,-50.0,10000,1,1000,0,0,0,0,0,0,0,0,0,0
20200316,055979,聯鈞統一97購03,0.40,0.40,0.40,0.40,+0.10,33.33,2000,1,800,0,0,0,0,0,0,0,0,0,0
20200316,05597P,鴻海元富96售06,4.93,5.35,4.93,5.35,-0.40,-6.96,20000,3,102800,0,0,0,0,0,0,0,20000,-20000,-20000
20200316,055980,祥碩統一98購01,0.52,0.52,0.50,0.50,-0.10,-16.67,5000,2,2520,0,0,0,0,0,0,0,4000,-4000,-4000
20200316,055981,臺股指統一97購03,,,,,0.00,0.00,0,0,0,0,0,0,0,0,0,0,0,0,0
20200316,055982,T50反1元富97購01,,,,,0.00,0.00,0,0,0,0,0,0,0,0,0,0,0,0,0
20200316,055983,全新元富9A購02,,,,,0.00,0.00,0,0,0,0,0,0,0,0,0,0,0,0,0
20200316,055984,大立光元富97購02,0.49,0.49,0.31,0.32,-0.05,-13.51,24000,4,8180,0,0,0,0,0,0,2000,22000,-20000,-20000
20200316,055985,聯鈞元富97購01,0.88,0.88,0.88,0.88,0.00,0.00,10000,1,8800,0,0,0,0,0,0,0,10000,-10000,-10000
20200316,055986,祥碩元富97購01,1.08,1.08,0.79,0.89,-0.21,-19.09,37000,8,34420,0,0,0,0,0,0,17000,13000,4000,4000
20200316,055987,台表科元富97購01,,,,,0.00,0.00,0,0,0,0,0,0,0,0,0,0,0,0,0
20200316,055988,矽力元富97購01,,,,,0.00,0.00,0,0,0,0,0,0,0,0,0,0,0,0,0
20200316,055989,矽力元富9A購01,0.77,0.77,0.63,0.63,-0.15,-19.23,85000,9,58160,0,0,0,0,0,0,63000,15000,48000,48000
20200316,05598P,國巨元富96售03,1.13,1.88,1.10,1.88,+0.72,62.07,929000,94,1223800,0,0,0,0,0,0,148000,730000,-582000,-582000
20200316,055990,矽創元富97購01,,,,,0.00,0.00,0,0,0,0,0,0,0,0,0,0,0,0,0
20200316,055991,鈺齊元富97購01,,,,,0.00,0.00,0,0,0,0,0,0,0,0,0,0,0,0,0
20200316,055992,智原台新97購02,,,,,0.00,0.00,0,0,0,0,0,0,0,0,0,0,0,0,0
20200316,055993,致茂國泰99購01,0.43,0.45,0.28,0.28,-0.06,-17.65,261000,14,108450,0,0,0,0,0,0,204000,50000,154000,154000
20200316,055994,聯發科國泰99購02,0.61,0.61,0.42,0.42,-0.17,-28.81,108000,9,51220,0,0,0,0,0,0,36000,22000,14000,14000
20200316,055995,華擎國泰99購01,,,,,0.00,0.00,0,0,0,0,0,0,0,0,0,0,0,0,0
20200316,055996,矽力國泰99購01,0.70,0.81,0.56,0.56,-0.14,-20.0,546000,9,375690,0,0,0,0,0,0,546000,0,546000,546000
20200316,055997,矽創國泰99購01,,,,,0.00,0.00,0,0,0,0,0,0,0,0,0,0,0,0,0
20200316,055998,臺股指富邦99購01,0.03,0.09,0.03,0.09,-0.01,-10.0,124000,4,3840,0,0,0,0,0,0,0,0,0,0
20200316,055999,電子類富邦99購01,,,,,0.00,0.00,0,0,0,0,0,0,0,0,0,0,0,0,0
20200316,05599P,欣興台新96售01,2.08,2.08,2.08,2.08,-0.04,-1.89,1000,1,2080,0,0,0,0,0,0,0,1000,-1000,-1000
20200316,056000,佳世達永豐97購01,,,,,0.00,0.00,0,0,0,0,0,0,0,0,0,0,0,0,0
20200316,056001,美食永豐97購01,,,,,0.00,0.00,0,0,0,0,0,0,0,0,0,0,0,0,0
20200316,056002,嘉晶永豐97購01,0.60,0.64,0.43,0.43,-0.20,-31.75,273000,13,163150,0,0,0,0,0,0,184000,89000,95000,95000
20200316,056003,智伸科永豐97購02,,,,,0.00,0.00,0,0,0,0,0,0,0,0,0,0,0,0,0
20200316,056004,南電永豐97購02,,,,,0.00,0.00,0,0,0,0,0,0,0,0,0,0,0,0,0
20200316,056005,臺股指永豐97購04,0.05,0.06,0.03,0.05,-0.07,-58.33,206000,5,9600,0,0,0,0,0,0,0,0,0,0
20200316,056006,義隆亞東97購01,0.22,0.22,0.22,0.22,+0.07,46.67,2000,1,440,0,0,0,0,0,0,2000,0,2000,2000
20200316,056007,上銀中信97購02,0.04,0.04,0.02,0.02,-0.02,-50.0,305000,31,7350,0,0,0,0,0,0,25000,275000,-250000,-250000
20200316,056008,全新中信9B購01,0.10,0.10,0.07,0.07,-0.02,-22.22,60000,6,4500,0,0,0,0,0,0,0,60000,-60000,-60000
20200316,056009,奇力新中信98購03,0.08,0.08,0.06,0.06,-0.01,-14.29,227000,4,17620,0,0,0,0,0,0,0,227000,-227000,-227000
20200316,05600P,玉晶光台新96售04,0.83,1.18,0.83,1.18,+0.12,11.32,885000,9,901400,0,0,0,0,0,0,625000,860000,-235000,-235000
20200316,056010,力成中信97購01,,,,,0.00,0.00,0,0,0,0,0,0,0,0,0,0,0,0,0
20200316,056011,矽力中信99購01,0.39,0.41,0.24,0.24,-0.11,-31.43,259000,27,74460,0,0,0,0,0,0,0,259000,-259000,-259000
20200316,056012,勤誠中信99購01,,,,,0.00,0.00,0,0,0,0,0,0,0,0,0,0,0,0,0
20200316,056013,T50反1群益97購01,,,,,0.00,0.00,0,0,0,0,0,0,0,0,0,0,0,0,0
20200316,056014,上銀群益97購02,,,,,0.00,0.00,0,0,0,0,0,0,0,0,0,0,0,0,0
20200316,056015,華通群益99購01,0.25,0.25,0.15,0.16,-0.05,-23.81,184000,10,39510,0,0,0,0,0,0,30000,154000,-124000,-124000
20200316,056016,鴻海群益97購06,0.25,0.25,0.17,0.18,-0.01,-5.26,570000,10,109500,0,0,0,0,0,0,0,570000,-570000,-570000
20200316,056017,台積電群益97購04,0.30,0.30,0.13,0.13,-0.24,-64.86,2261000,86,498640,0,0,0,0,0,0,1497000,554000,943000,943000
20200316,056018,旺宏群益97購02,0.23,0.23,0.23,0.23,+0.02,9.52,340000,2,78200,0,0,0,0,0,0,340000,0,340000,340000
20200316,056019,燿華群益97購02,,,,,0.00,0.00,0,0,0,0,0,0,0,0,0,0,0,0,0
20200316,05601P,鴻海元大97售04,6.35,7.40,6.35,7.10,+1.30,22.41,503000,49,3410500,0,0,0,0,0,0,242000,351000,-109000,-109000
20200316,056020,義隆群益97購01,0.28,0.28,0.28,0.28,0.00,0.00,5000,1,1400,0,0,0,0,0,0,5000,0,5000,5000
20200316,056021,興富發群益97購01,,,,,0.00,0.00,0,0,0,0,0,0,0,0,0,0,0,0,0
20200316,056022,新光金群益97購02,,,,,0.00,0.00,0,0,0,0,0,0,0,0,0,0,0,0,0
20200316,056023,晶豪科群益97購01,,,,,0.00,0.00,0,0,0,0,0,0,0,0,0,0,0,0,0
20200316,056024,大立光群益97購05,,,,,0.00,0.00,0,0,0,0,0,0,0,0,0,0,0,0,0
20200316,056025,嘉晶群益97購01,,,,,0.00,0.00,0,0,0,0,0,0,0,0,0,0,0,0,0
20200316,056026,智易群益97購01,,,,,0.00,0.00,0,0,0,0,0,0,0,0,0,0,0,0,0
20200316,056027,樺漢群益97購02,,,,,0.00,0.00,0,0,0,0,0,0,0,0,0,0,0,0,0
20200316,056028,GIS群益97購02,0.07,0.07,0.07,0.07,+0.01,16.67,6000,1,420,0,0,0,0,0,0,0,6000,-6000,-6000
20200316,056029,國巨麥證98購01,0.23,0.23,0.23,0.23,-0.10,-30.3,3000,1,690,0,3000,-3000,0,0,0,0,3000,-3000,-3000
20200316,05602P,國巨元大96售06,1.28,1.68,1.28,1.68,+0.31,22.63,52000,6,70560,0,0,0,0,0,0,12000,30000,-18000,-18000
20200316,056030,華通日盛97購01,,,,,0.00,0.00,0,0,0,0,0,0,0,0,0,0,0,0,0
20200316,056031,勤誠康和97購02,,,,,0.00,0.00,0,0,0,0,0,0,0,0,0,0,0,0,0
20200316,056032,勤誠康和97購03,0.20,0.20,0.20,0.20,-0.02,-9.09,5000,1,1000,0,0,0,0,0,0,5000,0,5000,5000
20200316,056033,T50正2凱基99購02,0.27,0.27,0.15,0.15,-0.09,-37.5,62000,5,11080,0,0,0,0,0,0,0,0,0,0
20200316,056034,華通凱基98購01,0.25,0.25,0.17,0.17,-0.04,-19.05,35000,4,6350,0,0,0,0,0,0,0,35000,-35000,-35000
20200316,056035,鴻海凱基97購06,0.45,0.45,0.38,0.38,-0.02,-5.0,25000,2,10900,0,0,0,0,0,0,20000,5000,15000,15000
20200316,056036,鴻海凱基97購07,,,,,0.00,0.00,0,0,0,0,0,0,0,0,0,0,0,0,0
20200316,056037,美律凱基98購03,0.12,0.12,0.12,0.12,0.00,0.00,110000,11,13200,0,0,0,0,0,0,0,110000,-110000,-110000
20200316,056038,可成凱基97購01,0.14,0.17,0.14,0.17,0.00,0.00,80000,2,12400,0,0,0,0,0,0,40000,40000,0,0
20200316,056039,宏達電凱基97購02,,,,,0.00,0.00,0,0,0,0,0,0,0,0,0,0,0,0,0
20200316,05603P,聯發科元大96售09,2.92,2.92,2.92,2.92,+0.05,1.74,10000,1,29200,0,0,0,0,0,0,10000,0,10000,10000
20200316,056040,亞光凱基98購01,,,,,0.00,0.00,0,0,0,0,0,0,0,0,0,0,0,0,0
20200316,056041,禾伸堂凱基98購03,,,,,0.00,0.00,0,0,0,0,0,0,0,0,0,0,0,0,0
20200316,056042,京鼎凱基97購02,,,,,0.00,0.00,0,0,0,0,0,0,0,0,0,0,0,0,0
20200316,056043,力成凱基97購01,,,,,0.00,0.00,0,0,0,0,0,0,0,0,0,0,0,0,0
20200316,056044,同欣電凱基97購03,,,,,0.00,0.00,0,0,0,0,0,0,0,0,0,0,0,0,0
20200316,056045,勤誠凱基97購01,,,,,0.00,0.00,0,0,0,0,0,0,0,0,0,0,0,0,0
20200316,056046,百和凱基97購01,,,,,0.00,0.00,0,0,0,0,0,0,0,0,0,0,0,0,0
20200316,056047,台積電兆豐97購02,0.03,0.03,0.03,0.03,-0.06,-66.67,10000,1,300,0,0,0,0,0,0,0,10000,-10000,-10000
20200316,056048,同欣電兆豐97購01,0.04,0.04,0.04,0.04,0.00,0.00,7000,1,280,0,0,0,0,0,0,0,0,0,0
20200316,056049,奇力新國票98購01,,,,,0.00,0.00,0,0,0,0,0,0,0,0,0,0,0,0,0
20200316,05604P,聯發科元大96售10,5.85,5.85,5.85,5.85,-0.90,-13.33,2000,1,11700,0,0,0,0,0,0,2000,0,2000,2000
20200316,056050,晶技國票98購01,1.09,1.12,1.09,1.09,+0.20,22.47,206000,3,224660,0,0,0,0,0,0,206000,0,206000,206000
20200316,056051,T50反1元大97購05,,,,,0.00,0.00,0,0,0,0,0,0,0,0,0,0,0,0,0
20200316,056052,T50反1元大97購06,,,,,0.00,0.00,0,0,0,0,0,0,0,0,0,0,0,0,0
20200316,056053,和大元大97購05,0.19,0.21,0.19,0.19,-0.02,-9.52,42000,5,8170,0,0,0,0,0,0,42000,0,42000,42000
20200316,056054,亞德客元大97購05,0.71,0.71,0.50,0.52,+0.10,23.81,50000,5,29100,0,0,0,0,0,0,0,50000,-50000,-50000
20200316,056055,國巨元大97購15,0.32,0.32,0.21,0.21,-0.06,-22.22,278000,7,78570,0,0,0,0,0,0,255000,23000,232000,232000
20200316,056056,旺宏元大97購06,0.37,0.37,0.23,0.23,-0.06,-20.69,15000,2,4850,0,0,0,0,0,0,10000,5000,5000,5000
20200316,056057,華邦電元大97購05,,,,,0.00,0.00,0,0,0,0,0,0,0,0,0,0,0,0,0
20200316,056058,建準元大97購02,,,,,0.00,0.00,0,0,0,0,0,0,0,0,0,0,0,0,0
20200316,056059,美律元大98購02,0.23,0.46,0.19,0.35,+0.09,34.62,367000,41,80330,0,0,0,0,0,0,0,346000,-346000,-346000
20200316,05605P,嘉聯益元大97售02,,,,,0.00,0.00,0,0,0,0,0,0,0,0,0,0,0,0,0
20200316,056060,宏達電元大99購01,0.22,0.23,0.14,0.14,-0.11,-44.0,361000,31,69460,0,0,0,0,0,0,118000,243000,-125000,-125000
20200316,056061,國泰金元大97購02,0.41,0.41,0.34,0.34,-0.07,-17.07,32000,3,12380,0,0,0,0,0,0,30000,2000,28000,28000
20200316,056062,大立光元大97購12,0.77,0.77,0.49,0.50,-0.30,-37.5,143000,16,95870,0,0,0,0,0,0,127000,143000,-16000,-16000
20200316,056063,大立光元大97購13,0.61,0.61,0.44,0.44,-0.23,-34.33,30000,3,16000,0,0,0,0,0,0,10000,30000,-20000,-20000
20200316,056064,大立光元大97購14,0.62,0.62,0.61,0.61,-0.22,-26.51,20000,2,12300,0,0,0,0,0,0,20000,20000,0,0
20200316,056065,奇鋐元大97購01,0.34,0.36,0.31,0.31,+0.01,3.33,22000,3,7180,0,0,0,0,0,0,22000,0,22000,22000
20200316,056066,奇鋐元大98購02,0.25,0.26,0.22,0.23,+0.03,15.0,50000,6,12260,0,0,0,0,0,0,16000,20000,-4000,-4000
20200316,056067,智原元大97購01,,,,,0.00,0.00,0,0,0,0,0,0,0,0,0,0,0,0,0
20200316,056068,欣興元大97購05,0.53,0.53,0.42,0.42,-0.05,-10.64,55000,6,23650,0,0,0,0,0,0,5000,55000,-50000,-50000
20200316,056069,新日興元大97購03,0.12,0.12,0.11,0.11,-0.08,-42.11,30000,2,3400,0,0,0,0,0,0,20000,10000,10000,10000
20200316,05606P,TPK國票97售02,3.53,3.53,3.53,3.53,0.00,0.00,2000,1,7060,0,0,0,0,0,0,2000,0,2000,2000
20200316,056070,新日興元大97購04,0.22,0.22,0.22,0.22,-0.03,-12.0,30000,3,6600,0,0,0,0,0,0,0,30000,-30000,-30000
20200316,056071,創意元大97購02,0.42,0.43,0.30,0.30,-0.02,-6.25,326000,13,126760,0,0,0,0,0,0,236000,90000,146000,146000
20200316,056072,群創元大97購01,0.12,0.12,0.10,0.10,+0.01,11.11,420000,20,48600,0,0,0,0,0,0,250000,170000,80000,80000
20200316,056073,智伸科元大97購01,0.17,0.17,0.17,0.17,-0.01,-5.56,15000,2,2550,0,0,0,0,0,0,0,15000,-15000,-15000
20200316,056074,茂林元大97購04,0.33,0.33,0.19,0.19,-0.10,-34.48,120000,10,30100,0,0,0,0,0,0,30000,60000,-30000,-30000
20200316,056075,瀚宇博元大97購03,0.60,0.60,0.43,0.43,-0.15,-25.86,286000,20,164880,0,0,0,0,0,0,106000,186000,-80000,-80000
20200316,056076,超眾元大97購05,0.39,0.39,0.39,0.39,-0.05,-11.36,10000,1,3900,0,0,0,0,0,0,0,10000,-10000,-10000
20200316,056077,矽力元大97購07,0.74,0.74,0.42,0.42,-0.22,-34.38,439000,29,276740,0,0,0,0,0,0,288000,151000,137000,137000
20200316,056078,勤誠元大97購01,0.15,0.15,0.14,0.14,0.00,0.00,13000,2,1850,0,0,0,0,0,0,10000,3000,7000,7000
20200316,056079,世紀鋼元大97購02,2.72,3.08,2.64,2.83,+0.11,4.04,327000,43,958630,0,0,0,0,0,0,257000,124000,133000,133000
20200316,05607P,華通日盛96售01,,,,,0.00,0.00,0,0,0,0,0,0,0,0,0,0,0,0,0
20200316,056080,世紀鋼元大97購03,1.71,1.72,1.54,1.55,+0.03,1.97,212000,24,350290,0,0,0,0,0,0,201000,16000,185000,185000
20200316,056081,T50反1統一99購02,,,,,0.00,0.00,0,0,0,0,0,0,0,0,0,0,0,0,0
20200316,056082,旺宏統一99購02,,,,,0.00,0.00,0,0,0,0,0,0,0,0,0,0,0,0,0
20200316,056083,億光統一97購03,,,,,0.00,0.00,0,0,0,0,0,0,0,0,0,0,0,0,0
20200316,056084,漢唐統一97購03,,,,,0.00,0.00,0,0,0,0,0,0,0,0,0,0,0,0,0
20200316,056085,聯發科統一97購01,,,,,0.00,0.00,0,0,0,0,0,0,0,0,0,0,0,0,0
20200316,056086,奇力新統一98購01,0.10,0.10,0.10,0.10,0.00,0.00,40000,4,4000,0,0,0,0,0,0,0,40000,-40000,-40000
20200316,056087,世芯統一97購01,0.20,0.20,0.11,0.11,-0.02,-15.38,81000,7,11140,0,0,0,0,0,0,33000,0,33000,33000
20200316,056088,台郡統一97購02,,,,,0.00,0.00,0,0,0,0,0,0,0,0,0,0,0,0,0
20200316,056089,同欣電統一98購01,,,,,0.00,0.00,0,0,0,0,0,0,0,0,0,0,0,0,0
20200316,05608P,聯發科凱基96售10,7.00,7.25,7.00,7.25,+1.85,34.26,7000,2,50250,0,0,0,0,0,0,7000,0,7000,7000
20200316,056090,康舒統一97購01,,,,,0.00,0.00,0,0,0,0,0,0,0,0,0,0,0,0,0
20200316,056091,百和統一97購01,,,,,0.00,0.00,0,0,0,0,0,0,0,0,0,0,0,0,0
20200316,056092,亞德客元富97購02,0.96,1.04,0.76,0.76,+0.03,4.11,143000,30,140950,0,0,0,0,0,0,5000,122000,-117000,-117000
20200316,056093,大毅元富97購01,1.36,1.43,1.00,1.00,-0.26,-20.63,35000,3,42900,0,0,0,0,0,0,10000,25000,-15000,-15000
20200316,056094,大立光元富97購03,,,,,0.00,0.00,0,0,0,0,0,0,0,0,0,0,0,0,0
20200316,056095,臻鼎元富9A購01,0.20,0.29,0.18,0.18,-0.06,-25.0,187000,19,45700,0,0,0,0,0,0,100000,86000,14000,14000
20200316,056096,超眾元富9A購01,0.64,0.66,0.64,0.64,+0.03,4.92,96000,8,61520,0,0,0,0,0,0,86000,10000,76000,76000
20200316,056097,訊芯元富97購02,,,,,0.00,0.00,0,0,0,0,0,0,0,0,0,0,0,0,0
20200316,056098,矽創元富97購02,0.26,0.28,0.22,0.22,+0.01,4.76,145000,24,37000,0,0,0,0,0,0,115000,30000,85000,85000
20200316,056099,上銀永豐97購02,0.06,0.10,0.05,0.10,-0.10,-50.0,211000,5,12100,0,0,0,0,0,0,0,0,0,0
20200316,05609P,國泰金凱基96售01,1.00,1.20,1.00,1.20,+0.13,12.15,525000,37,587670,0,0,0,0,0,0,198000,414000,-216000,-216000
20200316,056100,楠梓電永豐97購02,,,,,0.00,0.00,0,0,0,0,0,0,0,0,0,0,0,0,0
20200316,056101,光磊永豐98購01,0.18,0.18,0.18,0.18,+0.03,20.0,54000,1,9720,0,0,0,0,0,0,54000,0,54000,54000
20200316,056102,億光永豐97購02,,,,,0.00,0.00,0,0,0,0,0,0,0,0,0,0,0,0,0
20200316,056103,聯發科永豐97購03,,,,,0.00,0.00,0,0,0,0,0,0,0,0,0,0,0,0,0
20200316,056104,義隆永豐97購01,,,,,0.00,0.00,0,0,0,0,0,0,0,0,0,0,0,0,0
20200316,056105,智原永豐97購01,,,,,0.00,0.00,0,0,0,0,0,0,0,0,0,0,0,0,0
20200316,056106,晶相光永豐97購02,0.20,0.20,0.20,0.20,0.00,0.00,116000,1,23200,0,0,0,0,0,0,116000,0,116000,116000
20200316,056107,智易永豐97購02,0.16,0.16,0.16,0.16,+0.02,14.29,1000,1,160,0,0,0,0,0,0,1000,0,1000,1000
20200316,056108,麗豐永豐97購01,0.11,0.11,0.11,0.11,0.00,0.00,2000,1,220,0,0,0,0,0,0,0,2000,-2000,-2000
20200316,056109,彩晶永豐98購01,,,,,0.00,0.00,0,0,0,0,0,0,0,0,0,0,0,0,0
20200316,05610P,國巨群益98售01,,,,,0.00,0.00,0,0,0,0,0,0,0,0,0,0,0,0,0
20200316,056110,嘉聯益永豐97購02,,,,,0.00,0.00,0,0,0,0,0,0,0,0,0,0,0,0,0
20200316,056111,力成永豐97購01,,,,,0.00,0.00,0,0,0,0,0,0,0,0,0,0,0,0,0
20200316,056112,勤誠永豐97購02,,,,,0.00,0.00,0,0,0,0,0,0,0,0,0,0,0,0,0
20200316,056113,新日興兆豐98購01,,,,,0.00,0.00,0,0,0,0,0,0,0,0,0,0,0,0,0
20200316,056114,台達電群益97購02,0.10,0.10,0.10,0.10,+0.04,66.67,15000,1,1500,0,0,0,0,0,0,0,15000,-15000,-15000
20200316,056115,奇力新群益97購06,0.07,0.07,0.07,0.07,-0.01,-12.5,50000,1,3500,0,0,0,0,0,0,0,50000,-50000,-50000
20200316,056116,義隆群益97購02,,,,,0.00,0.00,0,0,0,0,0,0,0,0,0,0,0,0,0
20200316,056117,宏達電群益97購02,,,,,0.00,0.00,0,0,0,0,0,0,0,0,0,0,0,0,0
20200316,056118,聯詠群益97購03,,,,,0.00,0.00,0,0,0,0,0,0,0,0,0,0,0,0,0
20200316,056119,欣興群益97購02,,,,,0.00,0.00,0,0,0,0,0,0,0,0,0,0,0,0,0
20200316,05611P,康控群益96售02,4.05,4.16,4.05,4.16,+0.11,2.72,10000,2,41050,0,0,0,0,0,0,0,10000,-10000,-10000
20200316,056120,聯茂群益97購02,1.68,1.68,1.68,1.68,+0.13,8.39,10000,1,16800,0,0,0,0,0,0,10000,0,10000,10000
20200316,056121,勤誠群益97購01,,,,,0.00,0.00,0,0,0,0,0,0,0,0,0,0,0,0,0
20200316,056122,勤誠群益97購02,,,,,0.00,0.00,0,0,0,0,0,0,0,0,0,0,0,0,0
20200316,056123,鈺齊群益97購01,,,,,0.00,0.00,0,0,0,0,0,0,0,0,0,0,0,0,0
20200316,056124,華通國票98購02,,,,,0.00,0.00,0,0,0,0,0,0,0,0,0,0,0,0,0
20200316,056125,旺宏國票98購02,,,,,0.00,0.00,0,0,0,0,0,0,0,0,0,0,0,0,0
20200316,056126,台郡國票98購02,1.08,1.08,1.08,1.08,+0.02,1.89,20000,1,21600,0,0,0,0,0,0,20000,0,20000,20000
20200316,056127,致新國票98購02,0.28,0.28,0.28,0.28,-0.07,-20.0,5000,1,1400,0,0,0,0,0,0,5000,0,5000,5000
20200316,056128,和大中信99購01,0.15,0.15,0.15,0.15,0.00,0.00,12000,2,1800,0,0,0,0,0,0,0,12000,-12000,-12000
20200316,056129,義隆麥證97購01,,,,,0.00,0.00,0,0,0,0,0,0,0,0,0,0,0,0,0
20200316,05612P,台積電元大96售13,1.23,2.12,1.23,2.12,+1.00,89.29,63000,5,89650,0,0,0,0,0,0,43000,20000,23000,23000
20200316,056130,新日興麥證97購01,,,,,0.00,0.00,0,0,0,0,0,0,0,0,0,0,0,0,0
20200316,056131,鴻海元大97購12,0.50,0.50,0.34,0.36,-0.05,-12.2,92000,11,38030,0,0,0,0,0,0,21000,72000,-51000,-51000
20200316,056132,台光電元大97購03,1.19,1.21,1.19,1.21,+0.20,19.8,17000,2,20370,0,0,0,0,0,0,7000,17000,-10000,-10000
20200316,056133,可成元大97購05,0.60,0.61,0.60,0.61,+0.06,10.91,30000,2,18100,0,0,0,0,0,0,30000,10000,20000,20000
20200316,056134,可成元大97購06,0.53,0.56,0.49,0.52,0.00,0.00,70000,7,36900,0,0,0,0,0,0,50000,20000,30000,30000
20200316,056135,緯創元大98購01,0.55,0.55,0.43,0.43,-0.13,-23.21,98000,8,46840,0,0,0,0,0,0,40000,58000,-18000,-18000
20200316,056136,京鼎元大98購01,,,,,0.00,0.00,0,0,0,0,0,0,0,0,0,0,0,0,0
20200316,056137,聯鈞元大9A購01,1.05,1.13,0.86,0.86,-0.21,-19.63,195000,17,204000,0,0,0,0,0,0,65000,130000,-65000,-65000
20200316,056138,群創元大9B購01,,,,,0.00,0.00,0,0,0,0,0,0,0,0,0,0,0,0,0
20200316,056139,貿聯元大97購04,,,,,0.00,0.00,0,0,0,0,0,0,0,0,0,0,0,0,0
20200316,05613P,臻鼎台新96售01,,,,,0.00,0.00,0,0,0,0,0,0,0,0,0,0,0,0,0
20200316,056140,康控元大98購01,0.25,0.25,0.16,0.16,-0.08,-33.33,79000,9,15780,0,0,0,0,0,0,11000,68000,-57000,-57000
20200316,056141,聯茂元大97購05,1.67,1.67,1.65,1.65,+0.22,15.38,30000,3,49900,0,0,0,0,0,0,10000,30000,-20000,-20000
20200316,056142,超眾元大97購06,0.25,0.25,0.23,0.23,0.00,0.00,6000,2,1400,0,0,0,0,0,0,0,6000,-6000,-6000
20200316,056143,訊芯元大97購04,,,,,0.00,0.00,0,0,0,0,0,0,0,0,0,0,0,0,0
20200316,056144,GIS元大98購01,0.24,0.33,0.24,0.26,+0.04,18.18,392000,13,113440,0,0,0,0,0,0,310000,82000,228000,228000
20200316,056145,緯穎元大98購03,1.10,1.10,0.99,1.00,+0.02,2.04,29000,5,31340,0,0,0,0,0,0,16000,13000,3000,3000
20200316,056146,台虹元大98購01,1.15,1.22,1.09,1.09,+0.09,9.0,50000,6,57830,0,0,0,0,0,0,45000,5000,40000,40000
20200316,056147,鴻海日盛97購05,,,,,0.00,0.00,0,0,0,0,0,0,0,0,0,0,0,0,0
20200316,056148,臺股指日盛97購03,,,,,0.00,0.00,0,0,0,0,0,0,0,0,0,0,0,0,0
20200316,056149,亞光康和97購01,,,,,0.00,0.00,0,0,0,0,0,0,0,0,0,0,0,0,0
20200316,05614P,臺股指康和96售03,3.84,3.84,3.84,3.84,-0.30,-7.25,1000,1,3840,0,0,0,0,0,0,1000,0,1000,1000
20200316,056150,台光電凱基98購02,,,,,0.00,0.00,0,0,0,0,0,0,0,0,0,0,0,0,0
20200316,056151,建準凱基97購01,0.41,0.41,0.41,0.41,0.00,0.00,50000,1,20500,0,0,0,0,0,0,0,50000,-50000,-50000
20200316,056152,可成凱基97購02,0.21,0.21,0.18,0.18,0.00,0.00,60000,6,11700,0,0,0,0,0,0,0,60000,-60000,-60000
20200316,056153,華新科凱基97購02,,,,,0.00,0.00,0,0,0,0,0,0,0,0,0,0,0,0,0
20200316,056154,宏達電凱基97購03,0.33,0.33,0.28,0.28,+0.02,7.69,125000,9,37750,0,0,0,0,0,0,55000,75000,-20000,-20000
20200316,056155,嘉晶凱基97購01,0.76,0.80,0.57,0.57,-0.13,-18.57,377000,32,272210,0,0,0,0,0,0,262000,40000,222000,222000
20200316,056156,禾伸堂凱基98購04,1.15,1.15,1.15,1.15,+0.64,125.49,10000,1,11500,0,0,0,0,0,0,10000,0,10000,10000
20200316,056157,聯詠凱基97購03,,,,,0.00,0.00,0,0,0,0,0,0,0,0,0,0,0,0,0
20200316,056158,新日興凱基98購02,,,,,0.00,0.00,0,0,0,0,0,0,0,0,0,0,0,0,0
20200316,056159,牧德凱基99購01,0.15,0.15,0.15,0.15,0.00,0.00,100000,10,15000,0,0,0,0,0,0,0,100000,-100000,-100000
20200316,05615P,臺股指康和96售04,,,,,0.00,0.00,0,0,0,0,0,0,0,0,0,0,0,0,0
20200316,056160,智易凱基97購03,,,,,0.00,0.00,0,0,0,0,0,0,0,0,0,0,0,0,0
20200316,056161,康控凱基98購02,0.25,0.25,0.25,0.25,0.00,0.00,3000,1,750,0,0,0,0,0,0,3000,0,3000,3000
20200316,056162,祥碩凱基97購03,0.92,0.93,0.76,0.76,-0.19,-20.0,499000,28,435850,0,0,0,0,0,0,484000,67000,417000,417000
20200316,056163,嘉聯益凱基98購03,,,,,0.00,0.00,0,0,0,0,0,0,0,0,0,0,0,0,0
20200316,056164,聯茂凱基98購03,1.94,1.94,1.69,1.69,+0.15,9.74,82000,5,153980,0,0,0,0,0,0,60000,22000,38000,38000
20200316,056165,矽力凱基98購02,0.41,0.41,0.34,0.35,-0.03,-7.89,125000,4,49550,0,0,0,0,0,0,125000,0,125000,125000
20200316,056166,微星台新97購01,0.27,0.27,0.27,0.27,+0.05,22.73,35000,4,9450,0,0,0,0,0,0,35000,35000,0,0
20200316,056167,力成台新97購01,,,,,0.00,0.00,0,0,0,0,0,0,0,0,0,0,0,0,0
20200316,056168,鴻海元富97購07,0.62,0.62,0.45,0.45,-0.21,-31.82,92000,5,52800,0,0,0,0,0,0,60000,32000,28000,28000
20200316,056169,鴻海元富97購08,0.51,0.51,0.35,0.35,-0.20,-36.36,14000,4,6820,0,0,0,0,0,0,10000,4000,6000,6000
20200316,05616P,台光電永豐96售01,,,,,0.00,0.00,0,0,0,0,0,0,0,0,0,0,0,0,0
20200316,056170,鴻海元富97購09,0.69,0.69,0.49,0.49,-0.30,-37.97,35000,3,21700,0,0,0,0,0,0,20000,15000,5000,5000
20200316,056171,鴻海元富97購10,0.52,0.52,0.40,0.40,-0.19,-32.2,42000,3,18640,0,0,0,0,0,0,22000,20000,2000,2000
20200316,056172,鴻海元富97購11,0.29,0.30,0.22,0.22,+0.03,15.79,220000,9,56800,0,0,0,0,0,0,0,220000,-220000,-220000
20200316,056173,廣達元富97購01,0.79,0.79,0.53,0.53,-0.23,-30.26,359000,29,248600,0,0,0,0,0,0,182000,157000,25000,25000
20200316,056174,億光元富97購01,,,,,0.00,0.00,0,0,0,0,0,0,0,0,0,0,0,0,0
20200316,056175,可成元富97購03,,,,,0.00,0.00,0,0,0,0,0,0,0,0,0,0,0,0,0
20200316,056176,創意元富97購01,,,,,0.00,0.00,0,0,0,0,0,0,0,0,0,0,0,0,0
20200316,056177,嘉澤元富97購01,,,,,0.00,0.00,0,0,0,0,0,0,0,0,0,0,0,0,0
20200316,056178,嘉澤元富97購02,,,,,0.00,0.00,0,0,0,0,0,0,0,0,0,0,0,0,0
20200316,056179,康友元富97購02,0.64,0.64,0.60,0.61,-0.05,-7.58,30000,3,18500,0,0,0,0,0,0,10000,20000,-10000,-10000
20200316,05617P,大立光統一97售02,2.08,2.08,2.08,2.08,-0.28,-11.86,10000,1,20800,0,0,0,0,0,0,0,10000,-10000,-10000
20200316,056180,南茂元富97購01,0.27,0.27,0.18,0.19,-0.05,-20.83,1025000,13,263310,0,0,0,0,0,0,975000,50000,925000,925000
20200316,056181,百和元富97購02,,,,,0.00,0.00,0,0,0,0,0,0,0,0,0,0,0,0,0
20200316,056182,台光電統一97購03,,,,,0.00,0.00,0,0,0,0,0,0,0,0,0,0,0,0,0
20200316,056183,南亞科統一97購02,,,,,0.00,0.00,0,0,0,0,0,0,0,0,0,0,0,0,0
20200316,056184,南亞科統一97購03,,,,,0.00,0.00,0,0,0,0,0,0,0,0,0,0,0,0,0
20200316,056185,全新統一98購01,,,,,0.00,0.00,0,0,0,0,0,0,0,0,0,0,0,0,0
20200316,056186,智原統一97購01,,,,,0.00,0.00,0,0,0,0,0,0,0,0,0,0,0,0,0
20200316,056187,京鼎統一97購01,,,,,0.00,0.00,0,0,0,0,0,0,0,0,0,0,0,0,0
20200316,056188,晶相光統一99購01,0.17,0.23,0.17,0.17,-0.07,-29.17,156000,7,27230,0,0,0,0,0,0,100000,0,100000,100000
20200316,056189,樺漢統一97購02,,,,,0.00,0.00,0,0,0,0,0,0,0,0,0,0,0,0,0
20200316,05618P,聯發科元富96售02,3.32,3.82,3.32,3.82,+0.09,2.41,212000,11,786750,0,0,0,0,0,0,151000,211000,-60000,-60000
20200316,056190,昇陽半統一97購01,,,,,0.00,0.00,0,0,0,0,0,0,0,0,0,0,0,0,0
20200316,056191,世紀鋼統一97購01,,,,,0.00,0.00,0,0,0,0,0,0,0,0,0,0,0,0,0
20200316,056192,智邦富邦98購01,0.49,0.51,0.43,0.43,-0.01,-2.27,705000,16,342350,350000,0,350000,0,0,0,285000,405000,-120000,230000
20200316,056193,聯發科富邦99購08,0.30,0.48,0.30,0.38,-0.13,-25.49,449000,29,179060,0,0,0,0,0,0,229000,104000,125000,125000
20200316,056194,聯發科富邦9B購01,0.50,0.50,0.37,0.37,-0.09,-19.57,117000,6,50400,0,0,0,0,0,0,50000,67000,-17000,-17000
20200316,056195,群創富邦98購01,,,,,0.00,0.00,0,0,0,0,0,0,0,0,0,0,0,0,0
20200316,056196,聯茂富邦98購02,0.31,0.33,0.22,0.22,-0.02,-8.33,81000,4,26140,0,0,0,0,0,0,7000,74000,-67000,-67000
20200316,056197,友訊永豐97購01,0.07,0.07,0.07,0.07,-0.04,-36.36,30000,1,2100,0,0,0,0,0,0,0,30000,-30000,-30000
20200316,056198,台光電永豐97購02,0.35,0.35,0.35,0.35,+0.03,9.38,27000,1,9450,0,0,0,0,0,0,0,27000,-27000,-27000
20200316,056199,美律永豐97購01,,,,,0.00,0.00,0,0,0,0,0,0,0,0,0,0,0,0,0
20200316,05619P,創意元富96售02,2.95,3.21,2.92,3.13,+0.27,9.44,93000,11,280230,0,0,0,0,0,0,53000,40000,13000,13000
20200316,056200,大毅永豐98購01,0.54,0.54,0.38,0.38,-0.13,-25.49,245000,8,112900,0,0,0,0,0,0,195000,50000,145000,145000
20200316,056201,華新科永豐98購01,,,,,0.00,0.00,0,0,0,0,0,0,0,0,0,0,0,0,0
20200316,056202,國揚永豐97購01,,,,,0.00,0.00,0,0,0,0,0,0,0,0,0,0,0,0,0
20200316,056203,興富發永豐97購01,,,,,0.00,0.00,0,0,0,0,0,0,0,0,0,0,0,0,0
20200316,056204,嘉澤永豐97購01,,,,,0.00,0.00,0,0,0,0,0,0,0,0,0,0,0,0,0
20200316,056205,貿聯永豐97購01,,,,,0.00,0.00,0,0,0,0,0,0,0,0,0,0,0,0,0
20200316,056206,泰鼎永豐97購01,0.53,0.57,0.35,0.35,-0.21,-37.5,64000,11,24940,0,0,0,0,0,0,61000,1000,60000,60000
20200316,056207,茂林永豐97購03,0.14,0.14,0.14,0.14,0.00,0.00,15000,1,2100,0,0,0,0,0,0,0,15000,-15000,-15000
20200316,056208,崇越永豐97購01,,,,,0.00,0.00,0,0,0,0,0,0,0,0,0,0,0,0,0
20200316,056209,超眾永豐97購02,,,,,0.00,0.00,0,0,0,0,0,0,0,0,0,0,0,0,0
20200316,05620P,大立光富邦9B售01,0.96,1.03,0.89,1.03,+0.19,22.62,160000,18,157370,0,0,0,0,0,0,89000,0,89000,89000
20200316,056210,矽創永豐97購02,,,,,0.00,0.00,0,0,0,0,0,0,0,0,0,0,0,0,0
20200316,056211,南港國票98購01,0.56,0.56,0.56,0.56,0.00,0.00,20000,1,11200,0,0,0,0,0,0,20000,0,20000,20000
20200316,056212,台光電國票98購03,1.42,1.42,1.42,1.42,+0.10,7.58,2000,1,2840,0,0,0,0,0,0,2000,0,2000,2000
20200316,056213,建準國票98購02,,,,,0.00,0.00,0,0,0,0,0,0,0,0,0,0,0,0,0
20200316,056214,義隆國票99購01,,,,,0.00,0.00,0,0,0,0,0,0,0,0,0,0,0,0,0
20200316,056215,華新科國票97購03,,,,,0.00,0.00,0,0,0,0,0,0,0,0,0,0,0,0,0
20200316,056216,智原第一97購01,,,,,0.00,0.00,0,0,0,0,0,0,0,0,0,0,0,0,0
20200316,056217,A50正2中信99購02,0.45,0.45,0.45,0.45,-0.07,-13.46,17000,1,7650,0,0,0,0,0,0,0,17000,-17000,-17000
20200316,056218,億光中信98購01,0.08,0.08,0.08,0.08,0.00,0.00,5000,1,400,0,0,0,0,0,0,0,5000,-5000,-5000
20200316,056219,T50反1日盛02購01,2.05,2.55,2.05,2.55,+0.53,26.24,207000,12,493290,0,0,0,0,0,0,14000,133000,-119000,-119000
20200316,05621P,聯電中信96售01,1.53,1.63,1.53,1.63,+0.14,9.4,61000,8,96270,0,0,0,0,0,0,41000,45000,-4000,-4000
20200316,056220,上証2X凱基99購01,0.48,0.48,0.48,0.48,-0.03,-5.88,97000,2,46560,0,0,0,0,0,0,97000,0,97000,97000
20200316,056221,鴻海凱基99購01,0.11,0.11,0.08,0.08,-0.07,-46.67,233000,4,19060,0,0,0,0,0,0,213000,10000,203000,203000
20200316,056222,台積電凱基9A購01,0.84,0.84,0.73,0.73,-0.30,-29.13,40000,6,30800,0,0,0,0,0,0,0,40000,-40000,-40000
20200316,056223,華邦電凱基97購04,,,,,0.00,0.00,0,0,0,0,0,0,0,0,0,0,0,0,0
20200316,056224,聯發科凱基97購08,,,,,0.00,0.00,0,0,0,0,0,0,0,0,0,0,0,0,0
20200316,056225,聯發科凱基97購09,,,,,0.00,0.00,0,0,0,0,0,0,0,0,0,0,0,0,0
20200316,056226,聯發科凱基97購10,,,,,0.00,0.00,0,0,0,0,0,0,0,0,0,0,0,0,0
20200316,056227,奇力新凱基98購04,0.27,0.27,0.27,0.27,+0.02,8.0,50000,1,13500,0,0,0,0,0,0,0,50000,-50000,-50000
20200316,056228,可成凱基97購03,,,,,0.00,0.00,0,0,0,0,0,0,0,0,0,0,0,0,0
20200316,056229,可成凱基97購04,0.30,0.32,0.28,0.32,0.00,0.00,193000,7,61310,0,0,0,0,0,0,10000,183000,-173000,-173000
20200316,05622P,台積電中信96售02,,,,,0.00,0.00,0,0,0,0,0,0,0,0,0,0,0,0,0
20200316,056230,可成凱基98購03,0.55,0.55,0.55,0.55,0.00,0.00,119000,3,65450,0,0,0,0,0,0,0,119000,-119000,-119000
20200316,056231,嘉聯益凱基97購02,,,,,0.00,0.00,0,0,0,0,0,0,0,0,0,0,0,0,0
20200316,056232,瑞儀凱基98購01,0.16,0.16,0.16,0.16,+0.04,33.33,300000,3,48000,0,0,0,0,0,0,200000,100000,100000,100000
20200316,056233,超眾凱基97購02,0.66,0.77,0.65,0.74,+0.18,32.14,6000,5,4130,0,0,0,0,0,0,6000,0,6000,6000
20200316,056234,GIS麥證97購01,,,,,0.00,0.00,0,0,0,0,0,0,0,0,0,0,0,0,0
20200316,056235,鴻海群益97購07,0.08,0.08,0.07,0.07,0.00,0.00,600000,7,43300,0,0,0,0,0,0,350000,250000,100000,100000
20200316,056236,台積電群益97購06,0.53,0.53,0.53,0.53,+0.18,51.43,5000,1,2650,0,0,0,0,0,0,0,0,0,0
20200316,056237,智邦群益97購02,,,,,0.00,0.00,0,0,0,0,0,0,0,0,0,0,0,0,0
20200316,056238,聯發科群益98購02,,,,,0.00,0.00,0,0,0,0,0,0,0,0,0,0,0,0,0
20200316,056239,宏達電群益98購01,0.30,0.30,0.30,0.30,0.00,0.00,1000,1,300,0,0,0,0,0,0,1000,1000,0,0
20200316,05623P,台積電中信96售03,0.99,1.01,0.99,0.99,+0.05,5.32,20000,3,20000,0,0,0,0,0,0,0,20000,-20000,-20000
20200316,056240,嘉晶群益97購02,0.85,0.88,0.62,0.66,-0.34,-34.0,103000,14,82550,0,0,0,0,0,0,93000,0,93000,93000
20200316,056241,緯創群益97購01,,,,,0.00,0.00,0,0,0,0,0,0,0,0,0,0,0,0,0
20200316,056242,緯創群益9A購01,0.16,0.18,0.16,0.17,+0.03,21.43,30000,3,5100,0,0,0,0,0,0,5000,25000,-20000,-20000
20200316,056243,創意群益97購03,,,,,0.00,0.00,0,0,0,0,0,0,0,0,0,0,0,0,0
20200316,056244,群創群益98購09,,,,,0.00,0.00,0,0,0,0,0,0,0,0,0,0,0,0,0
20200316,056245,嘉澤群益97購01,,,,,0.00,0.00,0,0,0,0,0,0,0,0,0,0,0,0,0
20200316,056246,祥碩群益97購01,1.68,1.68,1.32,1.32,-0.55,-29.41,122000,26,195660,0,0,0,0,0,0,112000,70000,42000,42000
20200316,056247,台郡群益97購01,0.27,0.29,0.26,0.26,0.00,0.00,100000,3,27100,0,0,0,0,0,0,100000,0,100000,100000
20200316,056248,康友群益97購04,,,,,0.00,0.00,0,0,0,0,0,0,0,0,0,0,0,0,0
20200316,056249,鴻海兆豐97購05,0.16,0.16,0.16,0.16,0.00,0.00,200000,1,32000,0,0,0,0,0,0,0,200000,-200000,-200000
20200316,05624P,同欣電中信98售01,,,,,0.00,0.00,0,0,0,0,0,0,0,0,0,0,0,0,0
20200316,056250,瑞昱兆豐97購02,0.09,0.09,0.06,0.06,0.00,0.00,170000,14,12600,0,0,0,0,0,0,0,170000,-170000,-170000
20200316,056251,聯發科兆豐97購02,,,,,0.00,0.00,0,0,0,0,0,0,0,0,0,0,0,0,0
20200316,056252,聯發科兆豐97購03,,,,,0.00,0.00,0,0,0,0,0,0,0,0,0,0,0,0,0
20200316,056253,京鼎兆豐98購01,,,,,0.00,0.00,0,0,0,0,0,0,0,0,0,0,0,0,0
20200316,056254,為升元富97購01,,,,,0.00,0.00,0,0,0,0,0,0,0,0,0,0,0,0,0
20200316,056255,華新科元富97購05,0.20,0.20,0.14,0.14,+0.02,16.67,170000,9,31800,0,0,0,0,0,0,100000,70000,30000,30000
20200316,056256,聯茂元富97購03,0.63,0.63,0.62,0.62,0.00,0.00,190000,2,119600,0,0,0,0,0,0,180000,10000,170000,170000
20200316,056257,聯茂元富97購04,0.70,0.70,0.57,0.57,-0.09,-13.64,85000,2,50400,0,0,0,0,0,0,85000,0,85000,85000
20200316,056258,訊芯元富97購04,,,,,0.00,0.00,0,0,0,0,0,0,0,0,0,0,0,0,0
20200316,056259,T50反1統一9A購01,,,,,0.00,0.00,0,0,0,0,0,0,0,0,0,0,0,0,0
20200316,05625P,國巨國票97售01,,,,,0.00,0.00,0,0,0,0,0,0,0,0,0,0,0,0,0
20200316,056260,鴻海統一98購07,,,,,0.00,0.00,0,0,0,0,0,0,0,0,0,0,0,0,0
20200316,056261,台積電統一97購07,,,,,0.00,0.00,0,0,0,0,0,0,0,0,0,0,0,0,0
20200316,056262,台積電統一98購04,,,,,0.00,0.00,0,0,0,0,0,0,0,0,0,0,0,0,0
20200316,056263,友訊統一99購01,0.18,0.18,0.18,0.18,-0.03,-14.29,38000,1,6840,0,0,0,0,0,0,38000,0,38000,38000
20200316,056264,聯發科統一98購02,,,,,0.00,0.00,0,0,0,0,0,0,0,0,0,0,0,0,0
20200316,056265,國泰金統一97購01,,,,,0.00,0.00,0,0,0,0,0,0,0,0,0,0,0,0,0
20200316,056266,開發金統一9A購01,,,,,0.00,0.00,0,0,0,0,0,0,0,0,0,0,0,0,0
20200316,056267,文曄統一97購02,,,,,0.00,0.00,0,0,0,0,0,0,0,0,0,0,0,0,0
20200316,056268,新日興統一97購01,0.22,0.22,0.22,0.22,-0.05,-18.52,6000,1,1320,0,0,0,0,0,0,6000,0,6000,6000
20200316,056269,新日興統一98購01,,,,,0.00,0.00,0,0,0,0,0,0,0,0,0,0,0,0,0
20200316,05626P,景碩國票97售03,3.79,3.79,3.79,3.79,-0.17,-4.29,1000,1,3790,0,0,0,0,0,0,1000,0,1000,1000
20200316,056270,群創統一98購04,0.07,0.07,0.04,0.06,+0.01,20.0,252000,6,10130,0,0,0,0,0,0,0,0,0,0
20200316,056271,嘉澤統一97購01,,,,,0.00,0.00,0,0,0,0,0,0,0,0,0,0,0,0,0
20200316,056272,嘉澤統一99購01,,,,,0.00,0.00,0,0,0,0,0,0,0,0,0,0,0,0,0
20200316,056273,祥碩統一97購02,1.21,1.21,1.08,1.08,-0.02,-1.82,30000,3,33700,0,0,0,0,0,0,20000,10000,10000,10000
20200316,056274,彩晶統一98購02,,,,,0.00,0.00,0,0,0,0,0,0,0,0,0,0,0,0,0
20200316,056275,國巨國泰98購04,0.78,0.78,0.78,0.78,+0.39,100.0,2000,1,1560,0,0,0,0,0,0,2000,0,2000,2000
20200316,056276,同欣電國泰98購01,,,,,0.00,0.00,0,0,0,0,0,0,0,0,0,0,0,0,0
20200316,056277,上銀富邦99購02,0.20,0.20,0.17,0.17,-0.11,-39.29,13000,2,2510,0,0,0,0,0,0,0,13000,-13000,-13000
20200316,056278,全新富邦98購02,,,,,0.00,0.00,0,0,0,0,0,0,0,0,0,0,0,0,0
20200316,056279,新日興富邦99購01,0.24,0.24,0.24,0.24,+0.02,9.09,20000,2,4800,0,0,0,0,0,0,20000,0,20000,20000
20200316,05627P,致伸國票97售01,,,,,0.00,0.00,0,0,0,0,0,0,0,0,0,0,0,0,0
20200316,056280,上証2X永豐98購01,,,,,0.00,0.00,0,0,0,0,0,0,0,0,0,0,0,0,0
20200316,056281,深中小永豐97購01,1.15,1.15,1.15,1.15,-0.23,-16.67,10000,1,11500,0,0,0,0,0,0,0,10000,-10000,-10000
20200316,056282,S&P反1永豐97購01,,,,,0.00,0.00,0,0,0,0,0,0,0,0,0,0,0,0,0
20200316,056283,鴻海永豐97購03,0.03,0.04,0.03,0.03,0.00,0.00,135000,4,4100,0,0,0,0,0,0,0,0,0,0
20200316,056284,台積電永豐97購06,0.05,0.05,0.05,0.05,0.00,0.00,50000,1,2500,0,0,0,0,0,0,0,0,0,0
20200316,056285,可成永豐97購02,0.08,0.08,0.07,0.07,+0.02,40.0,50000,4,3600,0,0,0,0,0,0,0,50000,-50000,-50000
20200316,056286,奇鋐永豐97購01,0.26,0.30,0.23,0.23,0.00,0.00,33000,4,8400,0,0,0,0,0,0,30000,3000,27000,27000
20200316,056287,亞光永豐97購02,,,,,0.00,0.00,0,0,0,0,0,0,0,0,0,0,0,0,0
20200316,056288,健鼎永豐97購01,,,,,0.00,0.00,0,0,0,0,0,0,0,0,0,0,0,0,0
20200316,056289,合勤控永豐97購01,,,,,0.00,0.00,0,0,0,0,0,0,0,0,0,0,0,0,0
20200316,05628P,茂林國票97售02,1.82,1.82,1.80,1.80,-0.07,-3.74,20000,3,36200,0,0,0,0,0,0,0,15000,-15000,-15000
20200316,056290,正文永豐98購01,0.37,0.37,0.27,0.27,-0.10,-27.03,109000,8,36390,0,0,0,0,0,0,26000,83000,-57000,-57000
20200316,056291,聯茂永豐97購03,0.68,0.69,0.45,0.45,-0.03,-6.25,392000,12,242860,0,0,0,0,0,0,10000,392000,-382000,-382000
20200316,056292,統一元大97購01,1.20,1.22,1.04,1.04,-0.31,-22.96,165000,12,190500,0,0,0,0,0,0,139000,26000,113000,113000
20200316,056293,上銀元大97購10,0.35,0.35,0.35,0.35,-0.01,-2.78,10000,1,3500,0,0,0,0,0,0,10000,0,10000,10000
20200316,056294,上銀元大97購11,0.48,0.48,0.33,0.33,-0.03,-8.33,20000,3,8200,0,0,0,0,0,0,10000,10000,0,0
20200316,056295,國巨元大97購16,1.23,1.23,1.23,1.23,+0.09,7.89,50000,1,61500,0,0,0,0,0,0,50000,0,50000,50000
20200316,056296,旺宏元大97購07,,,,,0.00,0.00,0,0,0,0,0,0,0,0,0,0,0,0,0
20200316,056297,台光電元大97購04,0.44,0.46,0.39,0.39,0.00,0.00,47000,4,20540,0,0,0,0,0,0,37000,10000,27000,27000
20200316,056298,億光元大97購02,,,,,0.00,0.00,0,0,0,0,0,0,0,0,0,0,0,0,0
20200316,056299,友達元大9B購04,0.45,0.45,0.39,0.41,-0.01,-2.38,198000,8,86520,0,0,0,0,0,0,162000,36000,126000,126000
20200316,05629P,聯發科永昌99售02,,,,,0.00,0.00,0,0,0,0,0,0,0,0,0,0,0,0,0
20200316,056300,聯發科元大97購23,,,,,0.00,0.00,0,0,0,0,0,0,0,0,0,0,0,0,0
20200316,056301,開發金元大9A購01,0.28,0.31,0.28,0.31,-0.03,-8.82,44000,3,12440,0,0,0,0,0,0,40000,4000,36000,36000
20200316,056302,大立光元大97購17,0.49,0.49,0.48,0.48,+0.09,23.08,45000,3,21610,0,0,0,0,0,0,45000,0,45000,45000
20200316,056303,亞光元大97購04,0.30,0.30,0.18,0.18,-0.07,-28.0,140000,5,37300,0,0,0,0,0,0,120000,20000,100000,100000
20200316,056304,創意元大97購03,,,,,0.00,0.00,0,0,0,0,0,0,0,0,0,0,0,0,0
20200316,056305,群創元大9A購03,0.27,0.30,0.26,0.26,-0.03,-10.34,95000,10,26350,0,0,0,0,0,0,0,90000,-90000,-90000
20200316,056306,晶相光元大98購01,0.72,0.77,0.57,0.57,-0.09,-13.64,130000,10,81850,0,0,0,0,0,0,130000,70000,60000,60000
20200316,056307,貿聯元大97購05,0.21,0.21,0.21,0.21,0.00,0.00,10000,1,2100,0,0,0,0,0,0,0,10000,-10000,-10000
20200316,056308,TPK元大97購02,,,,,0.00,0.00,0,0,0,0,0,0,0,0,0,0,0,0,0
20200316,056309,合勤控元大97購01,0.26,0.26,0.26,0.26,0.00,0.00,4000,1,1040,0,0,0,0,0,0,0,4000,-4000,-4000
20200316,05630P,大立光永昌96售06,4.08,4.08,4.08,4.08,-1.47,-26.49,10000,1,40800,0,0,0,0,0,0,10000,10000,0,0
20200316,056310,神達元大97購02,1.35,1.57,1.17,1.17,-0.35,-23.03,142000,16,200970,0,0,0,0,0,0,117000,46000,71000,71000
20200316,056311,泰鼎元大98購01,1.01,1.08,0.71,0.71,-0.30,-29.7,215000,21,192710,0,0,0,0,0,0,114000,101000,13000,13000
20200316,056312,茂林元大98購01,0.34,0.34,0.34,0.34,-0.03,-8.11,20000,2,6800,0,0,0,0,0,0,0,20000,-20000,-20000
20200316,056313,聯茂元大98購01,0.95,1.02,0.74,0.74,-0.28,-27.45,98000,11,87750,0,0,0,0,0,0,23000,88000,-65000,-65000
20200316,056314,力成元大97購01,,,,,0.00,0.00,0,0,0,0,0,0,0,0,0,0,0,0,0
20200316,056315,同欣電元大97購05,0.19,0.19,0.19,0.19,-0.02,-9.52,10000,1,1900,0,0,0,0,0,0,0,10000,-10000,-10000
20200316,056316,訊芯元大98購03,0.20,0.20,0.15,0.15,-0.02,-11.76,110000,11,20600,0,0,0,0,0,0,0,110000,-110000,-110000
20200316,056317,華通群益99購02,0.09,0.09,0.09,0.09,0.00,0.00,40000,2,3600,0,0,0,0,0,0,0,40000,-40000,-40000
20200316,056318,鴻海群益98購02,0.29,0.29,0.25,0.25,-0.02,-7.41,113000,4,30350,0,0,0,0,0,0,8000,105000,-97000,-97000
20200316,056319,智原群益98購02,,,,,0.00,0.00,0,0,0,0,0,0,0,0,0,0,0,0,0
20200316,05631P,國巨富邦9A售01,1.18,1.32,1.05,1.32,+0.22,20.0,108000,16,121120,0,0,0,0,0,0,78000,17000,61000,61000
20200316,056320,京鼎群益99購01,0.29,0.29,0.27,0.27,0.00,0.00,251000,3,68870,0,0,0,0,0,0,251000,0,251000,251000
20200316,056321,創意群益98購02,0.29,0.29,0.29,0.29,+0.13,81.25,10000,1,2900,0,0,0,0,0,0,0,10000,-10000,-10000
20200316,056322,臺股指群益98購01,0.10,0.10,0.05,0.05,+0.01,25.0,20000,5,1200,0,0,0,0,0,0,0,0,0,0
20200316,056323,旺宏兆豐98購01,,,,,0.00,0.00,0,0,0,0,0,0,0,0,0,0,0,0,0
20200316,056324,南亞科兆豐98購01,0.17,0.17,0.17,0.17,+0.03,21.43,20000,1,3400,0,0,0,0,0,0,20000,0,20000,20000
20200316,056325,群創兆豐9A購01,0.06,0.06,0.05,0.05,0.00,0.00,109000,10,6440,0,0,0,0,0,0,0,109000,-109000,-109000
20200316,056326,TPK兆豐98購01,0.15,0.15,0.15,0.15,-0.03,-16.67,30000,1,4500,0,0,0,0,0,0,0,30000,-30000,-30000
20200316,056327,樺漢兆豐98購01,,,,,0.00,0.00,0,0,0,0,0,0,0,0,0,0,0,0,0
20200316,056328,訊芯兆豐98購01,,,,,0.00,0.00,0,0,0,0,0,0,0,0,0,0,0,0,0
20200316,056329,上銀國票98購02,0.15,0.17,0.15,0.17,+0.04,30.77,16000,2,2600,0,0,0,0,0,0,0,10000,-10000,-10000
20200316,05632P,大立光群益96售02,5.20,5.25,5.20,5.25,+1.45,38.16,41000,4,214000,0,0,0,0,0,0,41000,0,41000,41000
20200316,056330,玉晶光國票99購03,,,,,0.00,0.00,0,0,0,0,0,0,0,0,0,0,0,0,0
20200316,056331,聯鈞國票99購01,,,,,0.00,0.00,0,0,0,0,0,0,0,0,0,0,0,0,0
20200316,056332,台郡國票99購01,0.99,0.99,0.99,0.99,-0.03,-2.94,10000,1,9900,0,0,0,0,0,0,10000,0,10000,10000
20200316,056333,台積電日盛9B購01,0.53,0.57,0.33,0.40,-0.20,-33.33,507000,43,257940,0,0,0,0,0,0,282000,190000,92000,92000
20200316,056334,台積電凱基98購06,,,,,0.00,0.00,0,0,0,0,0,0,0,0,0,0,0,0,0
20200316,056335,微星凱基98購01,0.43,0.44,0.40,0.44,-0.04,-8.33,83000,6,35220,0,0,0,0,0,0,83000,0,83000,83000
20200316,056336,南亞科凱基98購02,,,,,0.00,0.00,0,0,0,0,0,0,0,0,0,0,0,0,0
20200316,056337,聯發科凱基98購06,,,,,0.00,0.00,0,0,0,0,0,0,0,0,0,0,0,0,0
20200316,056338,聯發科凱基99購01,0.84,0.85,0.56,0.56,-0.33,-37.08,128000,13,85100,0,0,0,0,0,0,25000,103000,-78000,-78000
20200316,056339,聯發科凱基99購02,0.42,0.42,0.31,0.32,-0.24,-42.86,82000,9,28580,0,0,0,0,0,0,0,82000,-82000,-82000
20200316,05633P,台表科群益96售04,,,,,0.00,0.00,0,0,0,0,0,0,0,0,0,0,0,0,0
20200316,056340,可成凱基98購04,0.58,0.58,0.49,0.49,-0.03,-5.77,222000,6,120690,0,0,0,0,0,0,97000,125000,-28000,-28000
20200316,056341,宏達電凱基9A購01,0.28,0.28,0.15,0.15,-0.12,-44.44,220000,18,48800,0,0,0,0,0,0,40000,105000,-65000,-65000
20200316,056342,中工凱基98購01,,,,,0.00,0.00,0,0,0,0,0,0,0,0,0,0,0,0,0
20200316,056343,高鐵凱基98購02,,,,,0.00,0.00,0,0,0,0,0,0,0,0,0,0,0,0,0
20200316,056344,嘉晶凱基98購02,1.08,1.15,0.86,0.97,-0.11,-10.19,343000,29,377230,0,0,0,0,0,0,250000,94000,156000,156000
20200316,056345,嘉聯益凱基99購01,,,,,0.00,0.00,0,0,0,0,0,0,0,0,0,0,0,0,0
20200316,056346,聯茂凱基99購02,0.47,0.52,0.38,0.38,-0.05,-11.63,92000,8,44010,0,0,0,0,0,0,69000,65000,4000,4000
20200316,056347,GIS凱基9A購01,0.21,0.26,0.20,0.26,+0.08,44.44,300000,23,70500,0,0,0,0,0,0,300000,0,300000,300000
20200316,056348,S&P反1元大9A購01,4.12,4.12,3.88,4.06,+0.10,2.53,232000,27,933690,0,0,0,0,0,0,0,217000,-217000,-217000
20200316,056349,道瓊銀元大9B購01,,,,,0.00,0.00,0,0,0,0,0,0,0,0,0,0,0,0,0
20200316,05634P,玉晶光台新97售01,1.47,1.47,1.47,1.47,+0.12,8.89,5000,1,7350,0,0,0,0,0,0,5000,0,5000,5000
20200316,056350,上銀元大98購02,0.13,0.13,0.13,0.13,-0.13,-50.0,20000,2,2600,0,0,0,0,0,0,0,20000,-20000,-20000
20200316,056351,鴻海元大98購06,0.39,0.40,0.39,0.40,+0.02,5.26,21000,2,8390,0,0,0,0,0,0,21000,1000,20000,20000
20200316,056352,鴻海元大99購01,0.47,0.48,0.47,0.48,+0.01,2.13,69000,2,33110,0,0,0,0,0,0,69000,1000,68000,68000
20200316,056353,鴻海元大99購02,0.44,0.45,0.37,0.37,-0.16,-30.19,164000,11,68460,0,0,0,0,0,0,90000,74000,16000,16000
20200316,056354,國巨元大98購10,1.30,1.30,0.91,0.94,-0.23,-19.66,40000,4,40900,0,0,0,0,0,0,10000,30000,-20000,-20000
20200316,056355,台積電元大98購08,0.91,0.91,0.55,0.56,-0.45,-44.55,1216000,92,847810,0,0,0,0,0,0,423000,793000,-370000,-370000
20200316,056356,台積電元大99購01,0.58,0.61,0.39,0.41,-0.21,-33.87,1380000,121,672360,0,0,0,0,0,0,365000,945000,-580000,-580000
20200316,056357,台積電元大9A購01,0.78,0.81,0.55,0.55,-0.30,-35.29,1092000,89,743590,0,0,0,0,0,0,575000,511000,64000,64000
20200316,056358,友訊元大99購01,0.42,0.42,0.42,0.42,+0.07,20.0,24000,1,10080,0,0,0,0,0,0,24000,0,24000,24000
20200316,056359,旺宏元大9A購01,0.42,0.44,0.32,0.32,0.00,0.00,27000,5,10380,0,0,0,0,0,0,5000,22000,-17000,-17000
20200316,05635P,健策台新96售02,1.89,2.28,1.74,2.25,+0.09,4.17,730000,20,1570380,0,0,0,0,0,0,86000,644000,-558000,-558000
20200316,056360,智邦元大98購01,1.43,1.55,1.20,1.20,-0.05,-4.0,55000,4,75960,0,0,0,0,0,0,45000,45000,0,0
20200316,056361,美律元大99購02,0.25,0.25,0.25,0.25,+0.05,25.0,42000,1,10500,0,0,0,0,0,0,42000,0,42000,42000
20200316,056362,聯發科元大99購01,0.60,0.63,0.46,0.50,-0.15,-23.08,708000,46,394840,0,0,0,0,0,0,343000,405000,-62000,-62000
20200316,056363,華新科元大99購04,0.96,0.97,0.72,0.72,-0.18,-20.0,306000,24,264850,0,0,0,0,0,0,116000,190000,-74000,-74000
20200316,056364,亞光元大99購02,0.10,0.10,0.10,0.10,-0.02,-16.67,10000,1,1000,0,0,0,0,0,0,0,10000,-10000,-10000
20200316,056365,欣興元大98購01,0.53,0.53,0.53,0.53,+0.06,12.77,10000,1,5300,0,0,0,0,0,0,10000,0,10000,10000
20200316,056366,玉晶光元大99購04,,,,,0.00,0.00,0,0,0,0,0,0,0,0,0,0,0,0,0
20200316,056367,祥碩元大98購01,2.09,2.14,1.72,1.72,-0.05,-2.82,112000,22,221140,0,0,0,0,0,0,92000,112000,-20000,-20000
20200316,056368,祥碩元大98購02,1.84,1.93,1.40,1.40,-0.20,-12.5,85000,11,139360,0,0,0,0,0,0,55000,73000,-18000,-18000
20200316,056369,彩晶元大01購01,0.15,0.15,0.15,0.15,0.00,0.00,99000,10,14850,0,0,0,0,0,0,0,99000,-99000,-99000
20200316,05636P,國巨永豐96售03,1.60,1.83,1.60,1.83,+0.09,5.17,6000,2,10290,0,0,0,0,0,0,0,6000,-6000,-6000
20200316,056370,台郡元大98購03,0.43,0.43,0.43,0.43,+0.06,16.22,3000,1,1290,0,0,0,0,0,0,3000,0,3000,3000
20200316,056371,樺漢元大98購03,0.40,0.40,0.31,0.31,-0.03,-8.82,20000,2,7100,0,0,0,0,0,0,10000,10000,0,0
20200316,056372,訊芯元大98購04,,,,,0.00,0.00,0,0,0,0,0,0,0,0,0,0,0,0,0
20200316,056373,上銀統一99購02,0.19,0.19,0.19,0.19,0.00,0.00,5000,1,950,0,0,0,0,0,0,0,5000,-5000,-5000
20200316,056374,聯發科統一9B購01,0.62,0.62,0.60,0.60,-0.15,-20.0,30000,2,18400,0,0,0,0,0,0,20000,10000,10000,10000
20200316,056375,玉晶光統一01購01,,,,,0.00,0.00,0,0,0,0,0,0,0,0,0,0,0,0,0
20200316,056376,玉晶光統一98購01,0.27,0.27,0.27,0.27,0.00,0.00,20000,2,5400,0,0,0,0,0,0,0,20000,-20000,-20000
20200316,056377,智伸科統一9A購01,,,,,0.00,0.00,0,0,0,0,0,0,0,0,0,0,0,0,0
20200316,056378,欣興元富98購01,,,,,0.00,0.00,0,0,0,0,0,0,0,0,0,0,0,0,0
20200316,056379,玉晶光元富98購01,1.43,1.46,1.42,1.42,-0.02,-1.39,218000,7,310150,0,0,0,0,0,0,218000,0,218000,218000
20200316,05637P,聯電元大96售04,1.43,1.43,1.43,1.43,+0.04,2.88,13000,1,18590,0,0,0,0,0,0,13000,0,13000,13000
20200316,056380,麗豐元富98購01,0.38,0.38,0.36,0.36,+0.08,28.57,20000,2,7400,0,0,0,0,0,0,10000,10000,0,0
20200316,056381,台虹元富98購01,0.98,0.98,0.96,0.98,+0.09,10.11,30000,4,29300,0,0,0,0,0,0,20000,0,20000,20000
20200316,056382,道瓊反國泰9A購01,3.66,3.66,3.29,3.29,-0.51,-13.42,4000,4,13720,0,0,0,0,0,0,0,4000,-4000,-4000
20200316,056383,上銀國泰99購01,0.49,0.49,0.49,0.49,-0.12,-19.67,10000,1,4900,0,0,0,0,0,0,0,10000,-10000,-10000
20200316,056384,玉晶光國泰9A購02,0.46,0.46,0.30,0.31,-0.16,-34.04,88000,9,29790,0,0,0,0,0,0,37000,51000,-14000,-14000
20200316,056385,創意國泰99購01,0.35,0.39,0.35,0.37,+0.13,54.17,239000,8,89880,0,0,0,0,0,0,10000,229000,-219000,-219000
20200316,056386,TPK國泰99購01,0.55,0.55,0.44,0.44,-0.04,-8.33,96000,3,50230,0,0,0,0,0,0,59000,37000,22000,22000
20200316,056387,智伸科國泰99購01,0.22,0.22,0.22,0.22,+0.04,22.22,15000,1,3300,0,0,0,0,0,0,15000,0,15000,15000
20200316,056388,勤誠國泰99購01,0.27,0.27,0.21,0.21,-0.03,-12.5,60000,2,14400,0,0,0,0,0,0,0,60000,-60000,-60000
20200316,056389,鴻海富邦99購01,,,,,0.00,0.00,0,0,0,0,0,0,0,0,0,0,0,0,0
20200316,05638P,國巨統一96售04,2.54,3.50,2.54,3.50,+0.88,33.59,256000,33,777090,0,0,0,0,0,0,232000,0,232000,232000
20200316,056390,台積電富邦9B購01,0.20,0.20,0.20,0.20,-0.09,-31.03,20000,1,4000,0,0,0,0,0,0,0,0,0,0
20200316,056391,大立光富邦9C購01,0.17,0.22,0.12,0.17,-0.03,-15.0,164000,21,27210,0,0,0,0,0,0,17000,0,17000,17000
20200316,056392,玉晶光富邦9C購01,0.27,0.27,0.19,0.19,-0.06,-24.0,37000,3,9430,0,0,0,0,0,0,10000,27000,-17000,-17000
20200316,056393,精元永豐98購01,0.19,0.19,0.16,0.16,+0.02,14.29,198000,2,34650,0,0,0,0,0,0,0,198000,-198000,-198000
20200316,056394,晶豪科永豐98購01,0.45,0.49,0.45,0.49,+0.14,40.0,6000,2,2820,0,0,0,0,0,0,3000,3000,0,0
20200316,056395,玉晶光永豐9B購01,0.40,0.40,0.29,0.29,0.00,0.00,64000,6,22320,0,0,0,0,0,0,2000,62000,-60000,-60000
20200316,056396,祥碩永豐98購01,0.45,0.45,0.34,0.34,-0.03,-8.11,88000,4,34300,0,0,0,0,0,0,38000,50000,-12000,-12000
20200316,056397,彩晶永豐99購01,,,,,0.00,0.00,0,0,0,0,0,0,0,0,0,0,0,0,0
20200316,056398,南茂永豐98購01,0.69,0.69,0.63,0.63,-0.04,-5.97,265000,4,175220,0,0,0,0,0,0,265000,0,265000,265000
20200316,056399,上証2X群益9C購01,1.56,1.58,1.31,1.31,-0.49,-27.22,150000,15,213120,0,0,0,0,0,0,55000,85000,-30000,-30000
20200316,05639P,欣興統一97售01,,,,,0.00,0.00,0,0,0,0,0,0,0,0,0,0,0,0,0
20200316,056400,道瓊反群益9C購01,,,,,0.00,0.00,0,0,0,0,0,0,0,0,0,0,0,0,0
20200316,056401,國巨群益98購07,,,,,0.00,0.00,0,0,0,0,0,0,0,0,0,0,0,0,0
20200316,056402,智易群益98購02,0.80,0.80,0.58,0.58,-0.12,-17.14,15000,2,10900,0,0,0,0,0,0,0,15000,-15000,-15000
20200316,056403,茂林群益98購01,,,,,0.00,0.00,0,0,0,0,0,0,0,0,0,0,0,0,0
20200316,056404,嘉聯益群益9A購01,0.71,0.71,0.54,0.54,-0.04,-6.9,10000,2,6250,0,0,0,0,0,0,0,10000,-10000,-10000
20200316,056405,聯茂群益98購01,3.55,3.55,2.89,2.89,+0.64,28.44,17000,4,50600,0,0,0,0,0,0,0,17000,-17000,-17000
20200316,056406,建準國票99購01,,,,,0.00,0.00,0,0,0,0,0,0,0,0,0,0,0,0,0
20200316,056407,嘉晶國票99購01,4.40,4.40,4.30,4.30,+0.21,5.13,84000,3,369000,0,0,0,0,0,0,84000,0,84000,84000
20200316,056408,奇鋐國票99購01,0.71,0.71,0.71,0.71,0.00,0.00,20000,1,14200,0,0,0,0,0,0,20000,0,20000,20000
20200316,056409,麗豐國票99購01,0.76,0.76,0.76,0.76,+0.17,28.81,34000,1,25840,0,0,0,0,0,0,34000,0,34000,34000
20200316,05640P,旺宏元富96售03,2.51,2.65,2.45,2.64,-0.70,-20.96,171000,7,448560,0,0,0,0,0,0,136000,35000,101000,101000
20200316,056410,康控國票99購01,,,,,0.00,0.00,0,0,0,0,0,0,0,0,0,0,0,0,0
20200316,056411,緯穎國票99購01,,,,,0.00,0.00,0,0,0,0,0,0,0,0,0,0,0,0,0
20200316,056412,上証2X中信9A購02,1.12,1.16,1.01,1.01,-0.26,-20.47,531000,30,574820,0,0,0,0,0,0,444000,75000,369000,369000
20200316,056413,上証反中信9A購01,0.47,0.52,0.47,0.52,+0.04,8.33,610000,12,303100,0,0,0,0,0,0,410000,200000,210000,210000
20200316,056414,國巨中信98購02,0.30,0.30,0.20,0.20,+0.05,33.33,17000,2,4100,0,0,0,0,0,0,7000,10000,-3000,-3000
20200316,056415,聯發科中信98購04,,,,,0.00,0.00,0,0,0,0,0,0,0,0,0,0,0,0,0
20200316,056416,華新科中信98購01,0.28,0.28,0.25,0.25,+0.02,8.7,130000,3,34700,0,0,0,0,0,0,130000,0,130000,130000
20200316,056417,欣興中信98購01,0.22,0.22,0.14,0.14,-0.06,-30.0,23000,4,4880,0,0,0,0,0,0,0,23000,-23000,-23000
20200316,056418,台光電元富98購01,0.73,0.76,0.68,0.71,+0.08,12.7,91000,12,65980,0,0,0,0,0,0,86000,5000,81000,81000
20200316,056419,欣興元富98購02,0.82,0.82,0.74,0.74,+0.08,12.12,50000,5,39200,0,0,0,0,0,0,50000,0,50000,50000
20200316,05641P,貿聯元富96售02,3.71,3.90,3.71,3.90,-0.06,-1.52,40000,4,154120,0,0,0,0,0,0,40000,0,40000,40000
20200316,056420,台表科元富98購01,,,,,0.00,0.00,0,0,0,0,0,0,0,0,0,0,0,0,0
20200316,056421,鴻海統一98購08,,,,,0.00,0.00,0,0,0,0,0,0,0,0,0,0,0,0,0
20200316,056422,全新統一98購02,,,,,0.00,0.00,0,0,0,0,0,0,0,0,0,0,0,0,0
20200316,056423,奇鋐統一98購01,0.60,0.60,0.60,0.60,+0.20,50.0,20000,1,12000,0,0,0,0,0,0,20000,0,20000,20000
20200316,056424,泰碩統一98購01,1.67,1.67,1.67,1.67,-0.03,-1.76,10000,1,16700,0,0,0,0,0,0,10000,0,10000,10000
20200316,056425,聯發科日盛9A購01,0.72,0.72,0.54,0.54,0.00,0.00,55000,6,36200,0,0,0,0,0,0,0,55000,-55000,-55000
20200316,056426,上証2X凱基9A購01,1.98,2.03,1.95,1.95,-0.15,-7.14,143000,8,283330,0,0,0,0,0,0,88000,55000,33000,33000
20200316,056427,上銀凱基98購03,0.78,0.78,0.78,0.78,+0.61,358.82,10000,1,7800,0,0,0,0,0,0,10000,0,10000,10000
20200316,056428,台達電凱基99購01,0.60,0.62,0.49,0.53,-0.07,-11.67,211000,24,120260,0,0,0,0,0,0,128000,83000,45000,45000
20200316,056429,華通凱基98購02,0.57,0.57,0.57,0.57,+0.03,5.56,110000,2,62700,0,0,0,0,0,0,110000,0,110000,110000
20200316,05642P,玉晶光兆豐97售02,0.93,1.18,0.93,1.18,+0.31,35.63,2038000,53,2090620,0,0,0,0,0,0,385000,1973000,-1588000,-1588000
20200316,056430,鴻海凱基98購06,0.99,1.02,0.85,0.85,-0.25,-22.73,55000,13,48800,0,0,0,0,0,0,55000,55000,0,0
20200316,056431,鴻海凱基98購07,0.46,0.46,0.43,0.43,-0.12,-21.82,88000,4,38740,0,0,0,0,0,0,38000,0,38000,38000
20200316,056432,鴻海凱基98購08,0.81,0.81,0.62,0.62,-0.16,-20.51,118000,5,90770,0,0,0,0,0,0,103000,15000,88000,88000
20200316,056433,鴻海凱基98購09,1.24,1.27,0.96,0.96,-0.43,-30.94,164000,22,185060,0,0,0,0,0,0,114000,142000,-28000,-28000
20200316,056434,國巨凱基98購03,,,,,0.00,0.00,0,0,0,0,0,0,0,0,0,0,0,0,0
20200316,056435,台積電凱基98購09,,,,,0.00,0.00,0,0,0,0,0,0,0,0,0,0,0,0,0
20200316,056436,台積電凱基98購10,0.63,0.67,0.63,0.67,+0.17,34.0,55000,4,35900,0,0,0,0,0,0,55000,0,55000,55000
20200316,056437,台積電凱基98購11,1.23,1.33,0.94,0.94,-0.50,-34.72,448000,52,515280,0,0,0,0,0,0,100000,305000,-205000,-205000
20200316,056438,旺宏凱基98購05,,,,,0.00,0.00,0,0,0,0,0,0,0,0,0,0,0,0,0
20200316,056439,華邦電凱基98購02,0.45,0.49,0.25,0.25,-0.17,-40.48,167000,7,73520,0,0,0,0,0,0,142000,54000,88000,88000
20200316,05643P,大立光中信98售01,1.55,1.79,1.55,1.79,+0.37,26.06,20000,3,33550,0,0,0,0,0,0,10000,20000,-10000,-10000
20200316,056440,智邦凱基98購03,,,,,0.00,0.00,0,0,0,0,0,0,0,0,0,0,0,0,0
20200316,056441,燿華凱基98購01,0.29,0.29,0.29,0.29,+0.04,16.0,100000,1,29000,0,0,0,0,0,0,0,100000,-100000,-100000
20200316,056442,瑞昱凱基98購02,0.36,0.38,0.32,0.32,-0.01,-3.03,158000,16,55990,0,0,0,0,0,0,155000,23000,132000,132000
20200316,056443,南亞科凱基98購03,0.48,0.54,0.48,0.52,+0.15,40.54,66000,4,34680,0,0,0,0,0,0,0,66000,-66000,-66000
20200316,056444,南亞科凱基99購01,0.96,0.97,0.65,0.65,+0.07,12.07,39000,7,35200,0,0,0,0,0,0,35000,4000,31000,31000
20200316,056445,聯發科凱基98購07,0.98,1.07,0.69,0.69,-0.23,-25.0,292000,15,270320,0,0,0,0,0,0,192000,100000,92000,92000
20200316,056446,聯發科凱基98購08,0.51,0.51,0.29,0.29,-0.25,-46.3,355000,23,132000,0,0,0,0,0,0,180000,175000,5000,5000
20200316,056447,聯發科凱基98購09,0.68,0.68,0.46,0.46,-0.02,-4.17,7000,4,4070,0,0,0,0,0,0,1000,6000,-5000,-5000
20200316,056448,全新凱基99購01,0.81,0.81,0.64,0.64,-0.07,-9.86,66000,7,51740,0,0,0,0,0,0,56000,16000,40000,40000
20200316,056449,義隆凱基98購03,,,,,0.00,0.00,0,0,0,0,0,0,0,0,0,0,0,0,0
20200316,05644P,大立光中信9A售03,0.71,0.94,0.70,0.93,+0.24,34.78,529000,39,450050,0,0,0,0,0,0,117000,336000,-219000,-219000
20200316,056450,可成凱基98購05,0.61,0.63,0.61,0.63,+0.01,1.61,173000,3,107630,0,0,0,0,0,0,68000,105000,-37000,-37000
20200316,056451,可成凱基99購01,0.49,0.49,0.47,0.49,0.00,0.00,163000,4,78870,0,0,0,0,0,0,0,163000,-163000,-163000
20200316,056452,亞光凱基98購02,,,,,0.00,0.00,0,0,0,0,0,0,0,0,0,0,0,0,0
20200316,056453,禾伸堂凱基99購02,1.21,1.23,1.01,1.01,+0.27,36.49,50000,4,55300,0,0,0,0,0,0,40000,10000,30000,30000
20200316,056454,欣興凱基98購02,,,,,0.00,0.00,0,0,0,0,0,0,0,0,0,0,0,0,0
20200316,056455,群創凱基9A購01,0.40,0.42,0.33,0.33,0.00,0.00,211000,9,83630,0,0,0,0,0,0,200000,11000,189000,189000
20200316,056456,群創凱基9B購01,,,,,0.00,0.00,0,0,0,0,0,0,0,0,0,0,0,0,0
20200316,056457,嘉澤凱基98購01,0.46,0.46,0.29,0.29,-0.07,-19.44,85000,9,30680,0,0,0,0,0,0,3000,82000,-79000,-79000
20200316,056458,日月光凱基98購02,,,,,0.00,0.00,0,0,0,0,0,0,0,0,0,0,0,0,0
20200316,056459,茂林凱基99購01,0.69,0.73,0.53,0.53,-0.12,-18.46,259000,17,166360,0,0,0,0,0,0,176000,83000,93000,93000
20200316,05645P,聯發科凱基96售13,,,,,0.00,0.00,0,0,0,0,0,0,0,0,0,0,0,0,0
20200316,056460,同欣電凱基99購01,0.26,0.26,0.26,0.26,-0.01,-3.7,40000,4,10400,0,0,0,0,0,0,0,40000,-40000,-40000
20200316,056461,樺漢凱基98購02,0.53,0.53,0.36,0.36,-0.16,-30.77,414000,4,151000,0,0,0,0,0,0,7000,407000,-400000,-400000
20200316,056462,訊芯凱基98購03,0.36,0.36,0.20,0.20,-0.09,-31.03,160000,7,47600,0,0,0,0,0,0,110000,50000,60000,60000
20200316,056463,台虹凱基98購02,1.19,1.26,1.07,1.07,-0.10,-8.55,44000,5,51420,0,0,0,0,0,0,33000,10000,23000,23000
20200316,056464,臺股指凱基99購06,0.08,0.08,0.06,0.06,-0.01,-14.29,319000,14,21540,0,0,0,0,0,0,0,120000,-120000,-120000
20200316,056465,臺股指凱基99購07,0.07,0.07,0.07,0.07,-0.11,-61.11,20000,2,1400,0,0,0,0,0,0,0,5000,-5000,-5000
20200316,056466,臺股指凱基99購08,0.06,0.14,0.05,0.09,0.00,0.00,829000,56,68790,0,0,0,0,0,0,0,690000,-690000,-690000
20200316,056467,上証2X元大98購02,1.37,1.37,1.19,1.19,-0.43,-26.54,63000,9,79360,0,0,0,0,0,0,6000,37000,-31000,-31000
20200316,056468,鴻海元大98購07,0.87,0.90,0.70,0.70,-0.09,-11.39,97000,8,79970,0,0,0,0,0,0,87000,12000,75000,75000
20200316,056469,國巨元大99購01,1.61,1.62,1.11,1.11,-0.42,-27.45,201000,34,271080,0,0,0,0,0,0,58000,152000,-94000,-94000
20200316,05646P,聯發科國票96售05,,,,,0.00,0.00,0,0,0,0,0,0,0,0,0,0,0,0,0
20200316,056470,旺宏元大99購01,0.84,0.91,0.64,0.64,-0.17,-20.99,270000,28,218600,0,0,0,0,0,0,50000,210000,-160000,-160000
20200316,056471,台光電元大99購01,0.96,0.96,0.96,0.96,+0.15,18.52,10000,1,9600,0,0,0,0,0,0,0,10000,-10000,-10000
20200316,056472,美律元大99購03,0.82,0.85,0.71,0.71,-0.08,-10.13,62000,8,49260,0,0,0,0,0,0,52000,20000,32000,32000
20200316,056473,奇力新元大99購02,0.44,0.50,0.36,0.36,+0.01,2.86,350000,8,143300,0,0,0,0,0,0,320000,30000,290000,290000
20200316,056474,華新科元大99購05,0.96,1.05,0.71,0.71,-0.11,-13.41,134000,14,120940,0,0,0,0,0,0,14000,120000,-106000,-106000
20200316,056475,宏達電元大99購02,1.24,1.35,0.82,0.82,-0.50,-37.88,184000,23,209340,0,0,0,0,0,0,39000,170000,-131000,-131000
20200316,056476,智原元大98購02,0.32,0.34,0.31,0.31,0.00,0.00,80000,8,26000,0,0,0,0,0,0,0,80000,-80000,-80000
20200316,056477,欣興元大98購02,0.74,0.74,0.62,0.62,-0.09,-12.68,78000,5,54080,0,0,0,0,0,0,78000,20000,58000,58000
20200316,056478,晶技元大99購01,0.90,1.00,0.90,0.99,+0.19,23.75,144000,4,142820,0,0,0,0,0,0,144000,8000,136000,136000
20200316,056479,玉晶光元大99購05,0.95,0.95,0.89,0.89,+0.09,11.25,3000,3,2770,0,0,0,0,0,0,3000,3000,0,0
20200316,05647P,聯發科國票97售02,,,,,0.00,0.00,0,0,0,0,0,0,0,0,0,0,0,0,0
20200316,056480,京鼎元大98購02,,,,,0.00,0.00,0,0,0,0,0,0,0,0,0,0,0,0,0
20200316,056481,創意元大98購01,,,,,0.00,0.00,0,0,0,0,0,0,0,0,0,0,0,0,0
20200316,056482,貿聯元大99購01,0.40,0.40,0.26,0.27,-0.06,-18.18,120000,9,39600,0,0,0,0,0,0,60000,60000,0,0
20200316,056483,TPK元大98購01,,,,,0.00,0.00,0,0,0,0,0,0,0,0,0,0,0,0,0
20200316,056484,聯茂元大98購02,2.14,2.14,2.14,2.14,0.00,0.00,10000,1,21400,0,0,0,0,0,0,0,10000,-10000,-10000
20200316,056485,同欣電元大98購01,0.35,0.35,0.26,0.26,-0.12,-31.58,140000,8,40700,0,0,0,0,0,0,130000,10000,120000,120000
20200316,056486,樺漢元大98購04,0.62,0.62,0.37,0.37,-0.28,-43.08,115000,14,53280,0,0,0,0,0,0,15000,100000,-85000,-85000
20200316,056487,康友元大98購01,0.73,0.73,0.46,0.46,-0.28,-37.84,62000,7,41420,0,0,0,0,0,0,22000,42000,-20000,-20000
20200316,056488,致新元大99購01,0.55,0.55,0.48,0.48,+0.03,6.67,20000,2,10300,0,0,0,0,0,0,10000,10000,0,0
20200316,056489,S&P反1國泰9A購01,,,,,0.00,0.00,0,0,0,0,0,0,0,0,0,0,0,0,0
20200316,05648P,康控國票97售01,,,,,0.00,0.00,0,0,0,0,0,0,0,0,0,0,0,0,0
20200316,056490,台積電國泰99購01,0.62,0.66,0.46,0.46,-0.04,-8.0,349000,19,193450,0,0,0,0,0,0,309000,30000,279000,279000
20200316,056491,南亞科國泰99購01,0.53,0.53,0.45,0.45,+0.07,18.42,65000,6,33250,0,0,0,0,0,0,15000,50000,-35000,-35000
20200316,056492,全新國泰9A購01,0.80,0.80,0.77,0.79,+0.11,16.18,460000,4,361500,0,0,0,0,0,0,460000,0,460000,460000
20200316,056493,晶技國泰99購01,3.03,3.03,3.03,3.03,+0.80,35.87,6000,1,18180,0,0,0,0,0,0,6000,0,6000,6000
20200316,056494,緯創國泰99購01,0.54,0.56,0.41,0.42,0.00,0.00,276000,8,144400,0,0,0,0,0,0,98000,175000,-77000,-77000
20200316,056495,泰鼎國泰99購01,1.14,1.16,1.14,1.16,+0.16,16.0,17000,2,19520,0,0,0,0,0,0,17000,0,17000,17000
20200316,056496,康控國泰99購01,,,,,0.00,0.00,0,0,0,0,0,0,0,0,0,0,0,0,0
20200316,056497,GIS國泰99購01,0.39,0.45,0.37,0.45,+0.17,60.71,89000,12,36620,0,0,0,0,0,0,0,89000,-89000,-89000
20200316,056498,A50正2富邦9B購01,0.80,0.80,0.79,0.79,-0.16,-16.84,11000,2,8700,0,0,0,0,0,0,10000,0,10000,10000
20200316,056499,鴻海富邦98購02,,,,,0.00,0.00,0,0,0,0,0,0,0,0,0,0,0,0,0
20200316,05649P,矽創國票97售03,3.41,3.41,3.37,3.37,-0.48,-12.47,100000,2,339000,0,0,0,0,0,0,100000,0,100000,100000
20200316,056500,大立光富邦9B購02,0.32,0.33,0.25,0.27,-0.06,-18.18,706000,29,189740,0,0,0,0,0,0,352000,105000,247000,247000
20200316,056501,貿聯富邦99購01,0.26,0.26,0.18,0.18,-0.05,-21.74,150000,2,31000,0,0,0,0,0,0,0,150000,-150000,-150000
20200316,056502,A50正2永豐98購01,,,,,0.00,0.00,0,0,0,0,0,0,0,0,0,0,0,0,0
20200316,056503,楠梓電永豐98購01,0.98,0.98,0.98,0.98,+0.09,10.11,20000,1,19600,0,0,0,0,0,0,20000,0,20000,20000
20200316,056504,國巨永豐98購02,0.37,0.37,0.37,0.37,-0.15,-28.85,10000,1,3700,0,0,0,0,0,0,10000,0,10000,10000
20200316,056505,聯發科永豐98購01,0.41,0.44,0.26,0.26,-0.11,-29.73,1567000,40,560530,0,0,0,0,0,0,817000,1350000,-533000,-533000
20200316,056506,晶豪科永豐98購02,0.93,0.93,0.66,0.66,-0.05,-7.04,28000,5,24260,0,0,0,0,0,0,0,28000,-28000,-28000
20200316,056507,創意永豐98購02,0.34,0.38,0.34,0.38,+0.15,65.22,236000,10,86770,0,0,0,0,0,0,4000,232000,-228000,-228000
20200316,056508,揚明光永豐98購01,0.37,0.37,0.37,0.37,-0.16,-30.19,10000,1,3700,0,0,0,0,0,0,0,10000,-10000,-10000
20200316,056509,晶相光永豐98購01,0.75,0.76,0.75,0.76,0.00,0.00,40000,2,30100,0,0,0,0,0,0,30000,10000,20000,20000
20200316,05650P,台積電富邦96售01,0.58,0.85,0.58,0.85,+0.33,63.46,75000,5,47850,0,0,0,0,0,0,70000,0,70000,70000
20200316,056510,正文永豐98購02,0.24,0.24,0.16,0.16,-0.06,-27.27,40000,4,8400,0,0,0,0,0,0,0,40000,-40000,-40000
20200316,056511,超眾永豐98購01,,,,,0.00,0.00,0,0,0,0,0,0,0,0,0,0,0,0,0
20200316,056512,易華電永豐98購01,0.62,0.62,0.43,0.43,-0.23,-34.85,47000,4,24240,0,0,0,0,0,0,0,47000,-47000,-47000
20200316,056513,臻鼎亞東99購01,0.15,0.15,0.12,0.12,-0.04,-25.0,45000,4,5440,0,0,0,0,0,0,42000,0,42000,42000
20200316,056514,訊芯亞東99購01,,,,,0.00,0.00,0,0,0,0,0,0,0,0,0,0,0,0,0
20200316,056515,燿華兆豐99購01,0.21,0.21,0.13,0.13,-0.10,-43.48,925000,21,151450,0,0,0,0,0,0,0,925000,-925000,-925000
20200316,056516,晶豪科兆豐98購01,0.67,0.69,0.46,0.47,-0.18,-27.69,3433000,46,1943770,0,0,0,0,0,0,2378000,1087000,1291000,1291000
20200316,056517,茂林兆豐99購01,0.32,0.33,0.29,0.29,-0.06,-17.14,323000,24,100740,0,0,0,0,0,0,287000,0,287000,287000
20200316,056518,美律國票99購01,,,,,0.00,0.00,0,0,0,0,0,0,0,0,0,0,0,0,0
20200316,056519,創意國票99購01,0.84,0.93,0.73,0.73,+0.02,2.82,76000,6,68670,0,0,0,0,0,0,68000,8000,60000,60000
20200316,05651P,大立光元大97售02,3.65,3.65,3.60,3.60,+0.10,2.86,20000,2,72500,0,0,0,0,0,0,10000,10000,0,0
20200316,056520,鴻海日盛99購01,,,,,0.00,0.00,0,0,0,0,0,0,0,0,0,0,0,0,0
20200316,056521,群創日盛98購01,,,,,0.00,0.00,0,0,0,0,0,0,0,0,0,0,0,0,0
20200316,056522,T50反1中信9B購01,,,,,0.00,0.00,0,0,0,0,0,0,0,0,0,0,0,0,0
20200316,056523,光寶科中信98購01,0.52,0.53,0.49,0.49,-0.10,-16.95,292000,5,151270,0,0,0,0,0,0,141000,151000,-10000,-10000
20200316,056524,欣興中信98購02,0.24,0.24,0.15,0.16,-0.08,-33.33,441000,10,80760,0,0,0,0,0,0,240000,181000,59000,59000
20200316,056525,T50反1凱基99購06,,,,,0.00,0.00,0,0,0,0,0,0,0,0,0,0,0,0,0
20200316,056526,力山凱基98購01,0.49,0.56,0.47,0.47,0.00,0.00,237000,13,124070,0,0,0,0,0,0,31000,222000,-191000,-191000
20200316,056527,大成鋼凱基98購03,1.54,1.63,1.40,1.43,+0.21,17.21,280000,12,439520,0,0,0,0,0,0,1000,279000,-278000,-278000
20200316,056528,為升凱基98購01,0.24,0.26,0.16,0.16,-0.12,-42.86,251000,49,53430,0,0,0,0,0,0,131000,120000,11000,11000
20200316,056529,中環凱基98購01,0.34,0.39,0.34,0.36,+0.06,20.0,325000,10,117150,0,0,0,0,0,0,115000,210000,-95000,-95000
20200316,05652P,臻鼎群益96售01,5.15,5.15,4.85,4.85,0.00,0.00,54000,5,265100,0,0,0,0,0,0,49000,5000,44000,44000
20200316,056530,旺宏凱基98購06,0.50,0.50,0.45,0.45,0.00,0.00,20000,2,9500,0,0,0,0,0,0,0,20000,-20000,-20000
20200316,056531,佳世達凱基98購01,0.39,0.39,0.31,0.31,-0.12,-27.91,170000,9,61000,0,0,0,0,0,0,0,170000,-170000,-170000
20200316,056532,技嘉凱基98購01,0.94,0.97,0.82,0.82,-0.13,-13.68,324000,9,298260,0,0,0,0,0,0,319000,5000,314000,314000
20200316,056533,友達凱基9A購02,0.40,0.40,0.33,0.33,0.00,0.00,250000,2,96500,0,0,0,0,0,0,0,250000,-250000,-250000
20200316,056534,京元電凱基98購01,1.92,2.41,1.63,1.63,-0.48,-22.75,125000,25,279860,0,0,0,0,0,0,15000,113000,-98000,-98000
20200316,056535,全新凱基99購02,0.68,0.69,0.65,0.65,+0.12,22.64,143000,12,95650,0,0,0,0,0,0,143000,0,143000,143000
20200316,056536,義隆凱基98購04,0.81,0.85,0.81,0.82,+0.06,7.89,116000,6,96740,0,0,0,0,0,0,48000,68000,-20000,-20000
20200316,056537,冠德凱基98購01,0.60,0.64,0.54,0.55,-0.08,-12.7,156000,10,90270,0,0,0,0,0,0,145000,11000,134000,134000
20200316,056538,國泰金凱基98購01,0.43,0.43,0.40,0.41,-0.20,-32.79,126000,10,51620,0,0,0,0,0,0,22000,104000,-82000,-82000
20200316,056539,新光金凱基9A購01,0.21,0.21,0.20,0.20,-0.04,-16.67,27000,3,5610,0,0,0,0,0,0,0,27000,-27000,-27000
20200316,05653P,華邦電統一96售02,,,,,0.00,0.00,0,0,0,0,0,0,0,0,0,0,0,0,0
20200316,056540,聯詠凱基98購02,0.82,0.90,0.68,0.69,-0.19,-21.59,1167000,11,815310,0,0,0,0,0,0,160000,1007000,-847000,-847000
20200316,056541,智原凱基98購03,0.10,0.10,0.10,0.10,0.00,0.00,20000,2,2000,0,0,0,0,0,0,0,20000,-20000,-20000
20200316,056542,緯創凱基98購01,0.31,0.31,0.21,0.21,-0.01,-4.55,355000,8,92100,0,0,0,0,0,0,190000,165000,25000,25000
20200316,056543,京鼎凱基98購01,0.39,0.39,0.25,0.25,0.00,0.00,340000,4,106600,0,0,0,0,0,0,230000,110000,120000,120000
20200316,056544,貿聯凱基98購03,,,,,0.00,0.00,0,0,0,0,0,0,0,0,0,0,0,0,0
20200316,056545,TPK凱基98購02,0.60,0.61,0.42,0.42,-0.13,-23.64,66000,7,35440,0,0,0,0,0,0,10000,56000,-46000,-46000
20200316,056546,致伸凱基98購01,0.66,0.71,0.52,0.52,-0.09,-14.75,390000,13,258900,0,0,0,0,0,0,220000,170000,50000,50000
20200316,056547,臻鼎凱基99購01,0.39,0.40,0.36,0.36,0.00,0.00,70000,7,26700,0,0,0,0,0,0,10000,30000,-20000,-20000
20200316,056548,瀚宇博凱基98購02,1.11,1.14,0.82,0.82,-0.29,-26.13,308000,22,322920,0,0,0,0,0,0,208000,154000,54000,54000
20200316,056549,嘉聯益凱基98購04,0.36,0.36,0.35,0.35,+0.01,2.94,400000,2,142000,0,0,0,0,0,0,200000,200000,0,0
20200316,05654P,台光電統一96售01,,,,,0.00,0.00,0,0,0,0,0,0,0,0,0,0,0,0,0
20200316,056550,瑞儀凱基99購01,0.33,0.35,0.33,0.35,+0.04,12.9,80000,6,27580,0,0,0,0,0,0,40000,60000,-20000,-20000
20200316,056551,台郡凱基98購04,1.74,1.74,1.64,1.64,0.00,0.00,20000,2,33800,0,0,0,0,0,0,0,20000,-20000,-20000
20200316,056552,台表科凱基99購01,0.70,0.74,0.46,0.48,-0.12,-20.0,614000,15,349920,0,0,0,0,0,0,106000,508000,-402000,-402000
20200316,056553,啟碁凱基98購02,0.51,0.53,0.40,0.40,-0.16,-28.57,219000,5,94270,0,0,0,0,0,0,19000,200000,-181000,-181000
20200316,056554,GIS凱基99購01,,,,,0.00,0.00,0,0,0,0,0,0,0,0,0,0,0,0,0
20200316,056555,矽創凱基98購01,0.95,0.95,0.69,0.69,-0.18,-20.69,179000,27,154590,0,0,0,0,0,0,137000,31000,106000,106000
20200316,056556,南電凱基98購01,2.94,3.03,2.30,2.30,-0.31,-11.88,191000,16,528000,0,0,0,0,0,0,186000,32000,154000,154000
20200316,056557,世紀鋼凱基98購02,4.75,4.89,4.42,4.80,+0.84,21.21,189000,26,879740,0,0,0,0,0,0,179000,18000,161000,161000
20200316,056558,台達電群益98購01,0.46,0.46,0.45,0.45,+0.03,7.14,30000,3,13610,0,0,0,0,0,0,30000,0,30000,30000
20200316,056559,華通群益98購02,0.14,0.14,0.09,0.09,0.00,0.00,70000,2,7300,0,0,0,0,0,0,20000,50000,-30000,-30000
20200316,05655P,南亞科統一96售01,2.50,2.55,2.47,2.47,-0.09,-3.52,25000,3,62600,0,0,0,0,0,0,25000,0,25000,25000
20200316,056560,旺宏群益98購03,0.93,0.93,0.57,0.57,-0.06,-9.52,51000,5,38720,0,0,0,0,0,0,31000,21000,10000,10000
20200316,056561,台光電群益98購02,0.99,0.99,0.80,0.80,+0.03,3.9,12000,2,11690,0,0,0,0,0,0,11000,1000,10000,10000
20200316,056562,奇力新群益98購01,0.33,0.33,0.33,0.33,+0.10,43.48,133000,1,43890,0,0,0,0,0,0,133000,0,133000,133000
20200316,056563,華新科群益98購04,,,,,0.00,0.00,0,0,0,0,0,0,0,0,0,0,0,0,0
20200316,056564,亞光群益98購02,,,,,0.00,0.00,0,0,0,0,0,0,0,0,0,0,0,0,0
20200316,056565,欣興群益98購03,0.64,0.64,0.40,0.41,-0.20,-32.79,1085000,12,562370,0,0,0,0,0,0,512000,573000,-61000,-61000
20200316,056566,臻鼎群益98購01,0.40,0.44,0.34,0.34,-0.01,-2.86,420000,6,164740,0,0,0,0,0,0,420000,9000,411000,411000
20200316,056567,瀚宇博群益98購02,0.96,0.96,0.96,0.96,+0.04,4.35,5000,1,4800,0,0,0,0,0,0,5000,0,5000,5000
20200316,056568,台表科群益98購01,,,,,0.00,0.00,0,0,0,0,0,0,0,0,0,0,0,0,0
20200316,056569,T50正2元大9B購02,0.36,0.37,0.27,0.28,-0.15,-34.88,724000,79,250510,0,0,0,0,0,0,0,708000,-708000,-708000
20200316,05656P,台表科統一96售01,,,,,0.00,0.00,0,0,0,0,0,0,0,0,0,0,0,0,0
20200316,056570,旺宏元大98購07,0.42,0.42,0.36,0.36,+0.03,9.09,70000,8,27200,0,0,0,0,0,0,35000,35000,0,0
20200316,056571,燿華元大98購02,0.50,0.55,0.29,0.29,-0.25,-46.3,183000,25,72000,0,0,0,0,0,0,25000,158000,-133000,-133000
20200316,056572,義隆元大99購01,0.89,0.96,0.86,0.86,+0.14,19.44,172000,5,150400,0,0,0,0,0,0,162000,10000,152000,152000
20200316,056573,華新科元大99購06,0.85,0.91,0.82,0.82,+0.10,13.89,80000,8,69200,0,0,0,0,0,0,10000,70000,-60000,-60000
20200316,056574,亞光元大99購03,0.95,0.95,0.88,0.88,+0.14,18.92,20000,2,18300,0,0,0,0,0,0,20000,10000,10000,10000
20200316,056575,禾伸堂元大99購01,1.73,1.82,1.53,1.53,-0.24,-13.56,514000,35,885010,0,0,0,0,0,0,305000,260000,45000,45000
20200316,056576,晶技元大99購02,1.57,1.57,1.46,1.50,+0.25,20.0,32000,3,48440,0,0,0,0,0,0,32000,0,32000,32000
20200316,056577,玉晶光元大99購06,0.58,0.63,0.45,0.45,-0.09,-16.67,40000,4,22500,0,0,0,0,0,0,10000,30000,-20000,-20000
20200316,056578,智易元大99購02,0.47,0.47,0.47,0.47,-0.03,-6.0,10000,1,4700,0,0,0,0,0,0,0,10000,-10000,-10000
20200316,056579,麗豐元大99購01,0.88,0.92,0.79,0.79,+0.05,6.76,61000,8,53380,0,0,0,0,0,0,38000,23000,15000,15000
20200316,05657P,樺漢統一97售01,,,,,0.00,0.00,0,0,0,0,0,0,0,0,0,0,0,0,0
20200316,056580,泰鼎元大9A購01,0.81,0.81,0.63,0.63,-0.15,-19.23,520000,15,396740,0,0,0,0,0,0,462000,48000,414000,414000
20200316,056581,超眾元大99購01,1.57,1.57,1.15,1.15,0.00,0.00,20000,2,27200,0,0,0,0,0,0,0,20000,-20000,-20000
20200316,056582,易華電元大98購01,0.68,0.68,0.55,0.55,0.00,0.00,11000,2,7350,0,0,0,0,0,0,0,11000,-11000,-11000
20200316,056583,昇陽半元大98購02,0.64,0.64,0.53,0.53,0.00,0.00,140000,2,75300,0,0,0,0,0,0,130000,10000,120000,120000
20200316,056584,鴻海統一9B購01,1.16,1.16,1.03,1.03,-0.21,-16.94,33000,4,34300,0,0,0,0,0,0,32000,2000,30000,30000
20200316,056585,台積電統一9A購01,,,,,0.00,0.00,0,0,0,0,0,0,0,0,0,0,0,0,0
20200316,056586,光罩統一98購02,0.61,0.61,0.61,0.61,-0.03,-4.69,5000,1,3050,0,0,0,0,0,0,5000,0,5000,5000
20200316,056587,聯發科統一9A購01,,,,,0.00,0.00,0,0,0,0,0,0,0,0,0,0,0,0,0
20200316,056588,聯發科統一9A購02,1.20,1.20,0.95,0.95,-0.35,-26.92,7000,4,7460,0,0,0,0,0,0,3000,4000,-1000,-1000
20200316,056589,康控統一98購01,,,,,0.00,0.00,0,0,0,0,0,0,0,0,0,0,0,0,0
20200316,05658P,日月光元富96售02,6.25,6.40,6.25,6.40,-0.60,-8.57,35000,4,220250,0,0,0,0,0,0,25000,10000,15000,15000
20200316,056590,樺漢統一9A購01,0.42,0.42,0.26,0.26,0.00,0.00,4000,3,1200,0,0,0,0,0,0,1000,1000,0,0
20200316,056591,S&P正2元富9A購01,0.15,0.15,0.15,0.15,0.00,0.00,58000,4,8700,0,0,0,0,0,0,0,0,0,0
20200316,056592,台積電元富98購01,1.02,1.02,0.60,0.60,-0.43,-41.75,1299000,115,1034200,0,0,0,0,0,0,602000,194000,408000,408000
20200316,056593,台積電元富98購02,0.75,0.75,0.37,0.47,-0.28,-37.33,452000,24,230180,0,0,0,0,0,0,290000,133000,157000,157000
20200316,056594,台積電元富98購03,0.49,0.49,0.22,0.22,-0.19,-46.34,789000,49,250610,0,0,0,0,0,0,0,274000,-274000,-274000
20200316,056595,台積電元富98購04,0.25,0.26,0.22,0.22,-0.07,-24.14,113000,7,26250,0,0,0,0,0,0,100000,13000,87000,87000
20200316,056596,光磊元富98購01,0.69,0.69,0.64,0.64,+0.01,1.59,55000,4,37300,0,0,0,0,0,0,30000,25000,5000,5000
20200316,056597,宏碁元富98購01,0.31,0.31,0.23,0.23,-0.10,-30.3,1160000,18,331480,0,0,0,0,0,0,660000,500000,160000,160000
20200316,056598,京元電元富98購01,1.17,1.31,1.08,1.08,-0.13,-10.74,540000,27,636320,0,0,0,0,0,0,540000,0,540000,540000
20200316,056599,臻鼎元富98購01,0.42,0.43,0.30,0.32,-0.02,-5.88,167000,13,59520,0,0,0,0,0,0,60000,107000,-47000,-47000
20200316,05659P,A50正2中信97售01,1.77,1.98,1.77,1.98,+0.07,3.66,21000,3,37480,0,0,0,0,0,0,1000,20000,-19000,-19000
20200316,056600,聯茂元富98購01,1.37,1.37,1.20,1.20,-0.12,-9.09,235000,6,303840,0,0,0,0,0,0,233000,2000,231000,231000
20200316,056601,鈺齊元富98購01,,,,,0.00,0.00,0,0,0,0,0,0,0,0,0,0,0,0,0
20200316,056602,嘉澤國泰99購01,0.49,0.50,0.34,0.34,-0.24,-41.38,322000,23,134170,0,0,0,0,0,0,5000,317000,-312000,-312000
20200316,056603,嘉聯益國泰9A購01,1.12,1.23,0.97,0.97,-0.11,-10.19,71000,4,82370,0,0,0,0,0,0,60000,11000,49000,49000
20200316,056604,鴻海富邦9A購01,0.39,0.39,0.35,0.35,-0.09,-20.45,118000,4,45380,0,0,0,0,0,0,10000,108000,-98000,-98000
20200316,056605,台積電富邦9B購02,0.49,0.49,0.31,0.31,-0.09,-22.5,982000,75,412240,0,0,0,0,0,0,0,344000,-344000,-344000
20200316,056606,華新科富邦9A購02,0.32,0.32,0.17,0.26,-0.04,-13.33,425000,14,99310,0,0,0,0,0,0,311000,1000,310000,310000
20200316,056607,貿聯富邦99購02,,,,,0.00,0.00,0,0,0,0,0,0,0,0,0,0,0,0,0
20200316,056608,力山永豐98購01,0.27,0.32,0.27,0.31,+0.07,29.17,181000,7,55170,0,0,0,0,0,0,12000,169000,-157000,-157000
20200316,056609,楠梓電永豐98購02,,,,,0.00,0.00,0,0,0,0,0,0,0,0,0,0,0,0,0
20200316,05660P,玉晶光第一96售01,,,,,0.00,0.00,0,0,0,0,0,0,0,0,0,0,0,0,0
20200316,056610,鴻海永豐98購01,0.44,0.44,0.44,0.44,0.00,0.00,10000,1,4400,0,0,0,0,0,0,0,10000,-10000,-10000
20200316,056611,國巨永豐98購03,0.52,0.52,0.52,0.52,0.00,0.00,10000,1,5200,0,0,0,0,0,0,0,10000,-10000,-10000
20200316,056612,台積電永豐98購01,0.33,0.33,0.26,0.26,-0.17,-39.53,17000,2,5120,0,0,0,0,0,0,7000,10000,-3000,-3000
20200316,056613,旺宏永豐98購01,,,,,0.00,0.00,0,0,0,0,0,0,0,0,0,0,0,0,0
20200316,056614,智邦永豐98購01,0.62,0.64,0.62,0.64,+0.08,14.29,116000,2,74140,0,0,0,0,0,0,116000,0,116000,116000
20200316,056615,燿華永豐98購02,,,,,0.00,0.00,0,0,0,0,0,0,0,0,0,0,0,0,0
20200316,056616,台光電永豐98購01,0.73,0.74,0.69,0.69,-0.02,-2.82,172000,10,125020,0,0,0,0,0,0,60000,122000,-62000,-62000
20200316,056617,美律永豐98購01,0.60,0.60,0.51,0.53,+0.01,1.92,63000,5,36510,0,0,0,0,0,0,28000,36000,-8000,-8000
20200316,056618,京元電永豐98購01,0.81,0.99,0.80,0.90,+0.04,4.65,698000,36,635500,0,0,0,0,0,0,331000,356000,-25000,-25000
20200316,056619,強茂永豐98購01,,,,,0.00,0.00,0,0,0,0,0,0,0,0,0,0,0,0,0
20200316,05661P,聯發科統一96售06,4.05,4.05,4.05,4.05,-0.64,-13.65,4000,1,16200,0,0,0,0,0,0,4000,0,4000,4000
20200316,056620,華新科永豐98購02,,,,,0.00,0.00,0,0,0,0,0,0,0,0,0,0,0,0,0
20200316,056621,宏達電永豐98購01,0.74,0.74,0.63,0.63,-0.07,-10.0,52000,3,37580,0,0,0,0,0,0,49000,22000,27000,27000
20200316,056622,高鐵永豐98購01,,,,,0.00,0.00,0,0,0,0,0,0,0,0,0,0,0,0,0
20200316,056623,禾伸堂永豐98購01,,,,,0.00,0.00,0,0,0,0,0,0,0,0,0,0,0,0,0
20200316,056624,景碩永豐98購01,0.55,0.55,0.55,0.55,0.00,0.00,20000,2,11000,0,0,0,0,0,0,0,20000,-20000,-20000
20200316,056625,致伸永豐98購01,0.16,0.16,0.16,0.16,+0.06,60.0,300000,2,48000,0,0,0,0,0,0,200000,100000,100000,100000
20200316,056626,同欣電永豐98購01,,,,,0.00,0.00,0,0,0,0,0,0,0,0,0,0,0,0,0
20200316,056627,訊芯永豐98購01,,,,,0.00,0.00,0,0,0,0,0,0,0,0,0,0,0,0,0
20200316,056628,矽創永豐98購01,0.33,0.37,0.33,0.34,0.00,0.00,86000,9,31500,0,0,0,0,0,0,32000,54000,-22000,-22000
20200316,056629,昇陽半永豐98購01,,,,,0.00,0.00,0,0,0,0,0,0,0,0,0,0,0,0,0
20200316,05662P,景碩元富96售01,2.66,3.08,2.66,3.08,+0.24,8.45,21000,3,60320,0,0,0,0,0,0,0,21000,-21000,-21000
20200316,056630,臺股指永豐98購02,,,,,0.00,0.00,0,0,0,0,0,0,0,0,0,0,0,0,0
20200316,056631,臺股指永豐98購03,,,,,0.00,0.00,0,0,0,0,0,0,0,0,0,0,0,0,0
20200316,056632,鴻海永昌98購01,,,,,0.00,0.00,0,0,0,0,0,0,0,0,0,0,0,0,0
20200316,056633,鴻海永昌98購02,,,,,0.00,0.00,0,0,0,0,0,0,0,0,0,0,0,0,0
20200316,056634,為升兆豐99購01,0.47,0.50,0.30,0.30,-0.21,-41.18,357000,38,147460,0,0,0,0,0,0,40000,307000,-267000,-267000
20200316,056635,亞德客日盛99購01,1.00,1.00,1.00,1.00,+0.32,47.06,5000,1,5000,0,0,0,0,0,0,5000,0,5000,5000
20200316,056636,台積電日盛9A購01,1.21,1.21,0.80,0.88,-0.33,-27.27,878000,57,862800,0,0,0,0,0,0,537000,480000,57000,57000
20200316,056637,台光電日盛9A購01,1.10,1.17,1.10,1.10,0.00,0.00,140000,10,158240,0,0,0,0,0,0,139000,0,139000,139000
20200316,056638,臺股指日盛98購01,0.04,0.08,0.04,0.08,-0.05,-38.46,120000,2,5600,0,0,0,0,0,0,100000,0,100000,100000
20200316,056639,國產康和98購01,0.37,0.37,0.36,0.37,+0.08,27.59,150000,5,55000,0,0,0,0,0,0,50000,100000,-50000,-50000
20200316,05663P,創意元富96售04,3.02,3.18,2.94,3.16,+0.24,8.22,135000,17,409690,0,0,0,0,0,0,41000,94000,-53000,-53000
20200316,056640,元油2X凱基9A購01,,,,,0.00,0.00,0,0,0,0,0,0,0,0,0,0,0,0,0
20200316,056641,華通凱基98購03,0.74,0.77,0.57,0.57,-0.11,-16.18,186000,15,134480,0,0,0,0,0,0,186000,0,186000,186000
20200316,056642,旺宏凱基98購07,0.83,0.83,0.55,0.55,-0.10,-15.38,191000,17,123120,0,0,0,0,0,0,50000,141000,-91000,-91000
20200316,056643,奇力新凱基99購01,,,,,0.00,0.00,0,0,0,0,0,0,0,0,0,0,0,0,0
20200316,056644,宏達電凱基98購04,1.37,1.37,1.33,1.33,+0.63,90.0,72000,2,98160,0,0,0,0,0,0,72000,72000,0,0
20200316,056645,大立光凱基98購12,1.37,1.37,0.88,0.90,-0.19,-17.43,194000,13,218160,0,0,0,0,0,0,134000,20000,114000,114000
20200316,056646,奇鋐凱基99購02,0.36,0.36,0.36,0.36,+0.01,2.86,15000,1,5400,0,0,0,0,0,0,15000,0,15000,15000
20200316,056647,晶技凱基98購02,1.92,2.06,1.91,2.00,+0.30,17.65,41000,10,82210,0,0,0,0,0,0,39000,2000,37000,37000
20200316,056648,牧德凱基99購02,,,,,0.00,0.00,0,0,0,0,0,0,0,0,0,0,0,0,0
20200316,056649,智易凱基98購01,0.52,0.60,0.41,0.41,-0.12,-22.64,150000,15,81220,0,0,0,0,0,0,86000,67000,19000,19000
20200316,05664P,國巨凱基96售09,1.82,2.34,1.82,2.34,+0.46,24.47,12000,3,24000,0,0,0,0,0,0,8000,4000,4000,4000
20200316,056650,彩晶凱基9A購01,,,,,0.00,0.00,0,0,0,0,0,0,0,0,0,0,0,0,0
20200316,056651,聯茂凱基98購04,1.86,2.04,1.44,1.44,-0.29,-16.76,172000,13,308140,0,0,0,0,0,0,150000,32000,118000,118000
20200316,056652,上証反元大9B購01,0.31,0.31,0.29,0.29,-0.06,-17.14,29000,4,8790,0,0,0,0,0,0,10000,0,10000,10000
20200316,056653,元石油元大98購01,0.10,0.10,0.07,0.07,-0.03,-30.0,1073000,44,86910,0,0,0,0,0,0,0,200000,-200000,-200000
20200316,056654,元油2X元大98購02,,,,,0.00,0.00,0,0,0,0,0,0,0,0,0,0,0,0,0
20200316,056655,旺宏元大99購02,1.04,1.07,0.96,0.96,+0.16,20.0,25000,3,25900,0,0,0,0,0,0,5000,25000,-20000,-20000
20200316,056656,華邦電元大98購02,0.68,0.70,0.47,0.47,-0.16,-25.4,110000,9,63800,0,0,0,0,0,0,40000,60000,-20000,-20000
20200316,056657,華邦電元大99購01,1.12,1.12,0.78,0.78,-0.28,-26.42,30000,2,30200,0,0,0,0,0,0,20000,10000,10000,10000
20200316,056658,美食元大98購01,0.75,0.75,0.49,0.49,-0.29,-37.18,380000,26,213900,0,0,0,0,0,0,150000,210000,-60000,-60000
20200316,056659,泰碩元大99購01,1.57,1.58,1.09,1.10,-0.42,-27.63,449000,38,651950,0,0,0,0,0,0,307000,146000,161000,161000
20200316,05665P,台積電凱基96售08,1.70,2.37,1.70,2.34,+0.80,51.95,30000,4,61530,0,0,0,0,0,0,10000,20000,-10000,-10000
20200316,056660,臺股指元大9A購07,,,,,0.00,0.00,0,0,0,0,0,0,0,0,0,0,0,0,0
20200316,056661,臺股指元大9A購08,,,,,0.00,0.00,0,0,0,0,0,0,0,0,0,0,0,0,0
20200316,056662,臺股指元大9A購09,0.30,0.35,0.26,0.35,0.00,0.00,29000,4,9120,0,0,0,0,0,0,0,0,0,0
20200316,056663,臺股指元大9A購10,0.55,0.55,0.33,0.40,-0.15,-27.27,118000,14,50450,0,0,0,0,0,0,0,0,0,0
20200316,056664,上証反中信9B購01,0.43,0.45,0.43,0.45,0.00,0.00,150000,2,64700,0,0,0,0,0,0,0,150000,-150000,-150000
20200316,056665,上証2X國票99購02,1.00,1.00,0.89,0.89,+0.02,2.3,15000,4,14450,0,0,0,0,0,0,0,10000,-10000,-10000
20200316,056666,元油2X國票9A購01,0.04,0.04,0.04,0.04,0.00,0.00,325000,5,13000,0,0,0,0,0,0,0,0,0,0
20200316,056667,上銀國票99購01,0.57,0.58,0.50,0.50,-0.07,-12.28,129000,5,68560,0,0,0,0,0,0,129000,0,129000,129000
20200316,056668,光磊國票99購01,1.35,1.35,1.00,1.03,-0.20,-16.26,75000,5,89900,0,0,0,0,0,0,70000,5000,65000,65000
20200316,056669,貿聯國票99購01,0.71,0.71,0.64,0.64,-0.01,-1.54,66000,2,44410,0,0,0,0,0,0,66000,0,66000,66000
20200316,05666P,聯發科凱基96售14,3.48,3.94,3.48,3.94,-0.45,-10.25,205000,3,765100,0,0,0,0,0,0,205000,0,205000,205000
20200316,056670,樺漢國票99購01,0.78,0.78,0.78,0.78,+0.01,1.3,20000,1,15600,0,0,0,0,0,0,20000,0,20000,20000
20200316,056671,台灣50元富9A購01,0.33,0.34,0.20,0.20,-0.16,-44.44,821000,45,211920,0,0,0,0,0,0,0,0,0,0
20200316,056672,元油2X元富98購10,0.09,0.18,0.07,0.10,-0.03,-23.08,1092000,33,111030,0,0,0,0,0,0,0,0,0,0
20200316,056673,中石化元富9B購01,0.42,0.42,0.39,0.39,-0.04,-9.3,350000,8,141300,0,0,0,0,0,0,330000,20000,310000,310000
20200316,056674,華邦電元富98購01,0.51,0.51,0.34,0.34,-0.13,-27.66,59000,5,25710,0,0,0,0,0,0,59000,20000,39000,39000
20200316,056675,聯發科元富02購01,0.62,0.62,0.47,0.47,-0.21,-30.88,292000,11,160780,0,0,0,0,0,0,0,292000,-292000,-292000
20200316,056676,國產元富98購01,0.37,0.37,0.25,0.25,-0.01,-3.85,198000,11,56700,0,0,0,0,0,0,0,198000,-198000,-198000
20200316,056677,智伸科元富98購01,0.65,0.65,0.43,0.43,-0.17,-28.33,81000,8,49260,0,0,0,0,0,0,52000,29000,23000,23000
20200316,056678,力成元富98購01,0.38,0.38,0.36,0.36,-0.02,-5.26,35000,4,12810,0,0,0,0,0,0,35000,0,35000,35000
20200316,056679,元油2X統一98購01,,,,,0.00,0.00,0,0,0,0,0,0,0,0,0,0,0,0,0
20200316,05667P,旺宏台新96售01,,,,,0.00,0.00,0,0,0,0,0,0,0,0,0,0,0,0,0
20200316,056680,華通統一98購04,0.27,0.27,0.24,0.24,-0.10,-29.41,25000,2,6600,0,0,0,0,0,0,0,25000,-25000,-25000
20200316,056681,鴻海統一98購09,,,,,0.00,0.00,0,0,0,0,0,0,0,0,0,0,0,0,0
20200316,056682,鴻海統一98購10,,,,,0.00,0.00,0,0,0,0,0,0,0,0,0,0,0,0,0
20200316,056683,台積電統一98購05,,,,,0.00,0.00,0,0,0,0,0,0,0,0,0,0,0,0,0
20200316,056684,旺宏統一98購02,,,,,0.00,0.00,0,0,0,0,0,0,0,0,0,0,0,0,0
20200316,056685,光罩統一98購03,0.49,0.49,0.48,0.48,0.00,0.00,20000,2,9650,0,0,0,0,0,0,0,20000,-20000,-20000
20200316,056686,可成統一98購01,,,,,0.00,0.00,0,0,0,0,0,0,0,0,0,0,0,0,0
20200316,056687,元大金統一98購01,,,,,0.00,0.00,0,0,0,0,0,0,0,0,0,0,0,0,0
20200316,056688,聯詠統一98購01,,,,,0.00,0.00,0,0,0,0,0,0,0,0,0,0,0,0,0
20200316,056689,玉晶光統一9A購03,,,,,0.00,0.00,0,0,0,0,0,0,0,0,0,0,0,0,0
20200316,05668P,滬深2X永豐96售04,,,,,0.00,0.00,0,0,0,0,0,0,0,0,0,0,0,0,0
20200316,056691,元油2X群益9B購01,0.07,0.07,0.06,0.07,+0.02,40.0,96000,5,6680,0,0,0,0,0,0,0,0,0,0
20200316,056692,燿華群益98購03,0.20,0.20,0.18,0.18,0.00,0.00,40000,2,7600,0,0,0,0,0,0,0,40000,-40000,-40000
20200316,056693,國產群益98購01,,,,,0.00,0.00,0,0,0,0,0,0,0,0,0,0,0,0,0
20200316,056694,欣興群益98購04,1.36,1.36,1.28,1.31,+0.10,8.26,160000,4,214400,0,0,0,0,0,0,110000,50000,60000,60000
20200316,056695,景碩群益99購01,,,,,0.00,0.00,0,0,0,0,0,0,0,0,0,0,0,0,0
20200316,056696,茂林群益98購02,,,,,0.00,0.00,0,0,0,0,0,0,0,0,0,0,0,0,0
20200316,056697,緯穎群益98購01,,,,,0.00,0.00,0,0,0,0,0,0,0,0,0,0,0,0,0
20200316,056698,T50反1國泰9A購01,1.98,2.08,1.98,2.08,+0.33,18.86,4000,2,8120,0,0,0,0,0,0,4000,0,4000,4000
20200316,056699,光罩國泰99購01,1.02,1.02,0.80,0.80,-0.10,-11.11,244000,7,245690,0,0,0,0,0,0,231000,13000,218000,218000
20200316,05669P,嘉晶永豐96售03,1.12,1.32,1.12,1.32,-0.16,-10.81,121000,17,145840,0,0,0,0,0,0,57000,114000,-57000,-57000
20200316,056700,華新科國泰99購03,,,,,0.00,0.00,0,0,0,0,0,0,0,0,0,0,0,0,0
20200316,056701,國產國泰9A購01,0.49,0.51,0.37,0.37,-0.06,-13.95,546000,24,257720,0,0,0,0,0,0,326000,200000,126000,126000
20200316,056702,欣興國泰9A購01,0.59,0.59,0.37,0.37,-0.21,-36.21,427000,15,181120,0,0,0,0,0,0,201000,226000,-25000,-25000
20200316,056703,群創國泰9A購01,0.19,0.19,0.15,0.15,0.00,0.00,140000,3,23800,0,0,0,0,0,0,120000,20000,100000,100000
20200316,056704,健策國泰99購01,,,,,0.00,0.00,0,0,0,0,0,0,0,0,0,0,0,0,0
20200316,056705,超眾國泰99購01,0.78,0.88,0.53,0.53,-0.23,-30.26,103000,29,82100,0,0,0,0,0,0,90000,13000,77000,77000
20200316,056706,元油2X富邦9B購01,0.07,0.07,0.07,0.07,-0.01,-12.5,120000,6,8400,0,0,0,0,0,0,0,0,0,0
20200316,056707,鴻海富邦99購03,0.65,0.65,0.51,0.51,-0.02,-3.77,340000,10,199000,0,0,0,0,0,0,170000,170000,0,0
20200316,056708,元油2X永豐98購02,,,,,0.00,0.00,0,0,0,0,0,0,0,0,0,0,0,0,0
20200316,056709,華通永豐98購01,,,,,0.00,0.00,0,0,0,0,0,0,0,0,0,0,0,0,0
20200316,05670P,台積電國票98售01,1.85,2.65,1.85,2.65,+1.08,68.79,78000,5,159500,0,0,0,0,0,0,52000,26000,26000,26000
20200316,056710,漢唐永豐98購01,,,,,0.00,0.00,0,0,0,0,0,0,0,0,0,0,0,0,0
20200316,056711,亞光永豐98購01,,,,,0.00,0.00,0,0,0,0,0,0,0,0,0,0,0,0,0
20200316,056712,京鼎永豐98購01,,,,,0.00,0.00,0,0,0,0,0,0,0,0,0,0,0,0,0
20200316,056713,華擎永豐98購01,0.54,0.70,0.49,0.50,-0.10,-16.67,176000,17,114580,0,0,0,0,0,0,19000,157000,-138000,-138000
20200316,056714,晶相光永豐98購02,1.07,1.07,1.07,1.07,+0.06,5.94,8000,2,8560,0,0,0,0,0,0,8000,0,8000,8000
20200316,056715,瀚宇博永豐98購01,0.74,0.78,0.74,0.78,+0.05,6.85,137000,5,105290,0,0,0,0,0,0,110000,27000,83000,83000
20200316,056716,康舒永豐98購01,,,,,0.00,0.00,0,0,0,0,0,0,0,0,0,0,0,0,0
20200316,056717,康友永豐98購01,,,,,0.00,0.00,0,0,0,0,0,0,0,0,0,0,0,0,0
20200316,056718,GIS永豐98購01,,,,,0.00,0.00,0,0,0,0,0,0,0,0,0,0,0,0,0
20200316,056719,台虹永豐98購01,0.86,0.90,0.86,0.90,+0.09,11.11,10000,3,8810,0,0,0,0,0,0,10000,0,10000,10000
20200316,05671P,友達國泰97售03,1.29,1.40,1.29,1.40,-0.20,-12.5,3000,2,3980,0,0,0,0,0,0,3000,0,3000,3000
20200316,056720,世紀鋼永豐98購01,3.00,3.26,2.88,3.24,+0.39,13.68,326000,21,981200,0,0,0,0,0,0,305000,11000,294000,294000
20200316,056721,台灣50永昌9A購01,0.70,0.72,0.42,0.44,-0.16,-26.67,200000,28,106290,0,0,0,0,0,0,5000,159000,-154000,-154000
20200316,056722,滬深反中信9B購01,,,,,0.00,0.00,0,0,0,0,0,0,0,0,0,0,0,0,0
20200316,056723,國巨中信9A購01,0.54,0.55,0.49,0.49,-0.03,-5.77,220000,4,119400,0,0,0,0,0,0,210000,10000,200000,200000
20200316,056724,臻鼎中信9A購01,0.13,0.16,0.12,0.12,0.00,0.00,118000,7,16610,0,0,0,0,0,0,68000,50000,18000,18000
20200316,056725,鴻海國票99購03,0.07,0.08,0.07,0.08,+0.01,14.29,110000,2,7800,0,0,0,0,0,0,110000,0,110000,110000
20200316,056726,友達日盛9A購01,,,,,0.00,0.00,0,0,0,0,0,0,0,0,0,0,0,0,0
20200316,056727,滬深反凱基9B購01,0.47,0.54,0.47,0.54,+0.10,22.73,895000,9,434200,0,0,0,0,0,0,795000,100000,695000,695000
20200316,056728,元油2X凱基9A購02,,,,,0.00,0.00,0,0,0,0,0,0,0,0,0,0,0,0,0
20200316,056729,元油2X凱基9A購03,,,,,0.00,0.00,0,0,0,0,0,0,0,0,0,0,0,0,0
20200316,05672P,鴻海群益96售03,4.66,4.66,4.66,4.66,+0.50,12.02,10000,2,46600,0,0,0,0,0,0,0,10000,-10000,-10000
20200316,056730,元油2X凱基9A購04,0.05,0.05,0.05,0.05,-0.05,-50.0,16000,1,800,0,0,0,0,0,0,0,0,0,0
20200316,056731,國巨凱基98購04,,,,,0.00,0.00,0,0,0,0,0,0,0,0,0,0,0,0,0
20200316,056732,國巨凱基98購07,,,,,0.00,0.00,0,0,0,0,0,0,0,0,0,0,0,0,0
20200316,056733,國巨凱基98購10,,,,,0.00,0.00,0,0,0,0,0,0,0,0,0,0,0,0,0
20200316,056734,國巨凱基99購01,0.63,0.63,0.56,0.56,-0.04,-6.67,170000,3,102200,0,0,0,0,0,0,168000,2000,166000,166000
20200316,056735,國巨凱基99購02,0.75,0.76,0.55,0.55,-0.18,-24.66,298000,6,211500,0,0,0,0,0,0,165000,133000,32000,32000
20200316,056736,國巨凱基99購03,,,,,0.00,0.00,0,0,0,0,0,0,0,0,0,0,0,0,0
20200316,056737,國巨凱基9A購01,1.18,1.18,0.92,0.92,-0.06,-6.12,60000,4,65100,0,0,0,0,0,0,10000,50000,-40000,-40000
20200316,056738,國巨凱基9A購02,1.18,1.20,0.90,0.90,-0.11,-10.89,12000,3,13900,0,0,0,0,0,0,11000,1000,10000,10000
20200316,056739,美律凱基98購04,0.42,0.44,0.35,0.35,-0.03,-7.89,257000,30,97150,0,0,0,0,0,0,237000,157000,80000,80000
20200316,05673P,台積電群益96售05,3.86,6.05,3.69,6.05,+2.64,77.42,57000,10,226530,0,0,0,0,0,0,20000,37000,-17000,-17000
20200316,056740,大立光凱基98購13,,,,,0.00,0.00,0,0,0,0,0,0,0,0,0,0,0,0,0
20200316,056741,大立光凱基98購14,,,,,0.00,0.00,0,0,0,0,0,0,0,0,0,0,0,0,0
20200316,056742,玉晶光凱基9A購01,0.28,0.28,0.20,0.20,-0.08,-28.57,353000,32,74980,0,0,0,0,0,0,60000,293000,-233000,-233000
20200316,056743,貿聯凱基98購04,0.42,0.42,0.42,0.42,+0.08,23.53,10000,1,4200,0,0,0,0,0,0,10000,0,10000,10000
20200316,056744,麗豐凱基9A購01,0.48,0.48,0.45,0.45,+0.04,9.76,117000,3,55590,0,0,0,0,0,0,50000,67000,-17000,-17000
20200316,056745,聯茂凱基99購03,1.51,1.65,1.40,1.40,+0.09,6.87,23000,3,35800,0,0,0,0,0,0,23000,3000,20000,20000
20200316,056746,超眾凱基99購01,1.16,1.16,0.77,0.77,-0.12,-13.48,104000,9,98530,0,0,0,0,0,0,94000,80000,14000,14000
20200316,056747,致新凱基99購01,0.54,0.54,0.46,0.46,-0.12,-20.69,68000,4,35000,0,0,0,0,0,0,54000,14000,40000,40000
20200316,056748,T50反1兆豐99購01,,,,,0.00,0.00,0,0,0,0,0,0,0,0,0,0,0,0,0
20200316,056749,滬深2X兆豐99購01,0.97,1.01,0.80,0.80,-0.29,-26.61,2055000,76,1867700,0,0,0,0,0,0,521000,1494000,-973000,-973000
20200316,05674P,瑞昱群益96售02,2.11,2.11,2.11,2.11,-0.20,-8.66,10000,1,21100,0,0,0,0,0,0,10000,0,10000,10000
20200316,056750,元油2X兆豐9A購01,,,,,0.00,0.00,0,0,0,0,0,0,0,0,0,0,0,0,0
20200316,056751,和大兆豐98購01,,,,,0.00,0.00,0,0,0,0,0,0,0,0,0,0,0,0,0
20200316,056752,國巨兆豐98購02,,,,,0.00,0.00,0,0,0,0,0,0,0,0,0,0,0,0,0
20200316,056753,群創兆豐98購02,0.04,0.04,0.03,0.03,-0.01,-25.0,480000,8,18700,0,0,0,0,0,0,430000,50000,380000,380000
20200316,056754,智易兆豐99購01,0.57,0.61,0.44,0.44,-0.11,-20.0,198000,14,115630,0,0,0,0,0,0,48000,150000,-102000,-102000
20200316,056755,聯茂兆豐98購01,0.99,0.99,0.70,0.72,-0.19,-20.88,78000,8,65900,0,0,0,0,0,0,20000,58000,-38000,-38000
20200316,056756,T50反1元大98購06,1.80,1.98,1.78,1.98,+0.27,15.79,105000,11,191550,0,0,0,0,0,0,20000,85000,-65000,-65000
20200316,056757,T50反1元大98購07,,,,,0.00,0.00,0,0,0,0,0,0,0,0,0,0,0,0,0
20200316,056758,元石油元大98購02,0.09,0.09,0.07,0.09,0.00,0.00,570000,28,47950,0,0,0,0,0,0,0,0,0,0
20200316,056759,元油2X元大98購05,0.02,0.08,0.02,0.08,0.00,0.00,41000,3,2020,0,0,0,0,0,0,0,0,0,0
20200316,05675P,美律群益97售01,,,,,0.00,0.00,0,0,0,0,0,0,0,0,0,0,0,0,0
20200316,056760,元油2X元大98購06,0.03,0.04,0.03,0.03,0.00,0.00,870000,16,26600,0,0,0,0,0,0,0,0,0,0
20200316,056761,元油2X元大98購07,0.07,0.07,0.03,0.05,0.00,0.00,482000,11,19240,0,0,0,0,0,0,0,0,0,0
20200316,056762,亞德客元大98購01,1.05,1.05,1.01,1.01,+0.25,32.89,26000,4,26600,0,0,0,0,0,0,13000,13000,0,0
20200316,056763,國巨元大99購02,1.72,1.72,1.15,1.18,+0.17,16.83,62000,5,89960,0,0,0,0,0,0,32000,30000,2000,2000
20200316,056764,友達元大9A購03,0.34,0.37,0.29,0.29,+0.01,3.57,116000,12,38900,0,0,0,0,0,0,87000,29000,58000,58000
20200316,056765,友達元大9B購05,0.38,0.38,0.31,0.31,+0.03,10.71,540000,32,185900,0,0,0,0,0,0,270000,270000,0,0
20200316,056766,義隆元大98購01,1.33,1.45,1.30,1.30,+0.02,1.56,93000,9,128730,0,0,0,0,0,0,63000,30000,33000,33000
20200316,056767,大毅元大99購01,0.96,0.99,0.72,0.73,-0.10,-12.05,47000,11,41700,0,0,0,0,0,0,11000,34000,-23000,-23000
20200316,056768,宏達電元大99購03,1.57,1.64,1.11,1.11,-0.52,-31.9,133000,13,200780,0,0,0,0,0,0,113000,113000,0,0
20200316,056769,國產元大98購01,0.49,0.50,0.41,0.41,+0.04,10.81,64000,6,31440,0,0,0,0,0,0,50000,14000,36000,36000
20200316,05676P,欣興群益96售04,,,,,0.00,0.00,0,0,0,0,0,0,0,0,0,0,0,0,0
20200316,056770,國產元大98購02,0.54,0.55,0.42,0.42,-0.04,-8.7,80000,8,37300,0,0,0,0,0,0,30000,50000,-20000,-20000
20200316,056771,嘉晶元大99購01,4.83,5.30,4.37,4.37,-0.39,-8.19,70000,15,352500,0,0,0,0,0,0,28000,70000,-42000,-42000
20200316,056772,欣興元大99購01,0.96,0.96,0.87,0.87,-0.07,-7.45,4000,4,3590,0,0,0,0,0,0,4000,4000,0,0
20200316,056773,晶技元大99購03,1.20,1.32,1.18,1.30,+0.17,15.04,559000,39,703050,0,0,0,0,0,0,519000,8000,511000,511000
20200316,056774,和鑫元大98購01,0.55,0.59,0.55,0.56,+0.11,24.44,74000,8,42160,0,0,0,0,0,0,10000,64000,-54000,-54000
20200316,056775,康控元大99購01,0.63,0.63,0.44,0.44,-0.16,-26.67,120000,12,54900,0,0,0,0,0,0,0,120000,-120000,-120000
20200316,056776,聯茂元大99購01,3.16,3.16,2.85,2.94,0.00,0.00,28000,3,83620,0,0,0,0,0,0,8000,28000,-20000,-20000
20200316,056777,矽力元大98購02,1.08,1.16,0.72,0.72,-0.39,-35.14,164000,23,152090,0,0,0,0,0,0,5000,159000,-154000,-154000
20200316,056778,元石油群益9B購01,0.30,0.30,0.21,0.21,-0.13,-38.24,1528000,10,337450,0,0,0,0,0,0,1303000,0,1303000,1303000
20200316,056779,元油2X群益9A購02,,,,,0.00,0.00,0,0,0,0,0,0,0,0,0,0,0,0,0
20200316,05677P,玉晶光群益98售03,0.55,0.70,0.55,0.70,+0.02,2.94,1256000,56,752400,0,0,0,0,0,0,502000,256000,246000,246000
20200316,056780,元油2X群益9A購03,0.05,0.06,0.05,0.05,-0.01,-16.67,353000,8,19380,0,0,0,0,0,0,0,0,0,0
20200316,056781,元油2X群益9B購02,0.03,0.04,0.02,0.03,0.00,0.00,2394000,17,70860,0,0,0,0,0,0,0,0,0,0
20200316,056782,鴻海群益98購04,1.07,1.14,0.90,0.90,-0.31,-25.62,132000,8,129370,0,0,0,0,0,0,87000,42000,45000,45000
20200316,056783,國巨群益99購01,1.03,1.03,0.77,0.77,-0.16,-17.2,360000,8,328130,0,0,0,0,0,0,31000,329000,-298000,-298000
20200316,056784,南亞科群益98購01,,,,,0.00,0.00,0,0,0,0,0,0,0,0,0,0,0,0,0
20200316,056785,可成群益99購01,,,,,0.00,0.00,0,0,0,0,0,0,0,0,0,0,0,0,0
20200316,056786,亞光群益98購03,0.30,0.30,0.20,0.20,0.00,0.00,119000,6,32550,0,0,0,0,0,0,0,119000,-119000,-119000
20200316,056787,健鼎群益98購01,,,,,0.00,0.00,0,0,0,0,0,0,0,0,0,0,0,0,0
20200316,056788,日月光群益98購01,0.15,0.15,0.13,0.13,-0.02,-13.33,160000,16,22100,0,0,0,0,0,0,0,160000,-160000,-160000
20200316,056789,和碩群益98購01,0.57,0.57,0.48,0.48,+0.03,6.67,60000,3,32000,0,0,0,0,0,0,0,60000,-60000,-60000
20200316,05678P,群創群益97售01,,,,,0.00,0.00,0,0,0,0,0,0,0,0,0,0,0,0,0
20200316,056790,彩晶群益98購03,0.19,0.19,0.19,0.19,-0.02,-9.52,11000,1,2090,0,0,0,0,0,0,11000,11000,0,0
20200316,056791,嘉聯益群益98購01,,,,,0.00,0.00,0,0,0,0,0,0,0,0,0,0,0,0,0
20200316,056792,訊芯群益98購01,0.17,0.17,0.13,0.13,-0.03,-18.75,110000,2,14700,0,0,0,0,0,0,10000,100000,-90000,-90000
20200316,056793,臺股指群益98購03,,,,,0.00,0.00,0,0,0,0,0,0,0,0,0,0,0,0,0
20200316,056794,上銀麥證98購01,0.68,0.68,0.64,0.64,+0.02,3.23,20000,2,13200,20000,0,20000,0,0,0,20000,0,20000,20000
20200316,056795,鴻海麥證98購01,0.53,0.53,0.53,0.53,-0.09,-14.52,10000,1,5300,10000,0,10000,0,0,0,10000,0,10000,10000
20200316,056796,國巨麥證98購02,1.01,1.01,0.97,0.97,+0.13,15.48,100000,5,97700,100000,0,100000,0,0,0,100000,0,100000,100000
20200316,056797,台積電麥證98購01,1.28,1.28,0.94,0.95,-0.16,-14.41,415000,13,431490,360000,45000,315000,0,0,0,360000,45000,315000,315000
20200316,056798,華新科麥證98購01,0.27,0.27,0.20,0.20,-0.06,-23.08,30000,3,7000,10000,20000,-10000,0,0,0,10000,20000,-10000,-10000
20200316,056799,群創麥證98購01,,,,,0.00,0.00,0,0,0,0,0,0,0,0,0,0,0,0,0
20200316,05679P,台表科群益96售05,,,,,0.00,0.00,0,0,0,0,0,0,0,0,0,0,0,0,0
20200316,056800,臺股指麥證98購01,,,,,0.00,0.00,0,0,0,0,0,0,0,0,0,0,0,0,0
20200316,056801,國巨台新98購01,,,,,0.00,0.00,0,0,0,0,0,0,0,0,0,0,0,0,0
20200316,056802,友達台新98購01,,,,,0.00,0.00,0,0,0,0,0,0,0,0,0,0,0,0,0
20200316,056803,群創台新99購02,,,,,0.00,0.00,0,0,0,0,0,0,0,0,0,0,0,0,0
20200316,056804,T50反1統一9A購03,,,,,0.00,0.00,0,0,0,0,0,0,0,0,0,0,0,0,0
20200316,056805,元石油統一9B購01,0.31,0.31,0.24,0.24,-0.07,-22.58,369000,12,97250,0,0,0,0,0,0,0,0,0,0
20200316,056806,元油2X統一98購02,,,,,0.00,0.00,0,0,0,0,0,0,0,0,0,0,0,0,0
20200316,056807,元油2X統一9B購01,0.04,0.04,0.04,0.04,-0.01,-20.0,30000,2,1200,0,0,0,0,0,0,0,0,0,0
20200316,056808,台積電統一98購06,,,,,0.00,0.00,0,0,0,0,0,0,0,0,0,0,0,0,0
20200316,056809,旺宏統一98購03,,,,,0.00,0.00,0,0,0,0,0,0,0,0,0,0,0,0,0
20200316,05680P,聯發科元大96售12,,,,,0.00,0.00,0,0,0,0,0,0,0,0,0,0,0,0,0
20200316,056810,群創統一9A購01,,,,,0.00,0.00,0,0,0,0,0,0,0,0,0,0,0,0,0
20200316,056811,健策統一9B購01,,,,,0.00,0.00,0,0,0,0,0,0,0,0,0,0,0,0,0
20200316,056812,泰鼎統一98購01,0.74,0.74,0.74,0.74,-0.08,-9.76,100000,1,74000,0,0,0,0,0,0,100000,0,100000,100000
20200316,056813,聯茂統一99購01,,,,,0.00,0.00,0,0,0,0,0,0,0,0,0,0,0,0,0
20200316,056814,元油2X永豐98購04,,,,,0.00,0.00,0,0,0,0,0,0,0,0,0,0,0,0,0
20200316,056815,元油2X永豐98購05,,,,,0.00,0.00,0,0,0,0,0,0,0,0,0,0,0,0,0
20200316,056816,華通永豐98購02,,,,,0.00,0.00,0,0,0,0,0,0,0,0,0,0,0,0,0
20200316,056817,國巨永豐98購04,0.18,0.18,0.18,0.18,0.00,0.00,12000,1,2160,0,0,0,0,0,0,12000,0,12000,12000
20200316,056818,正崴永豐98購01,0.24,0.24,0.24,0.24,+0.01,4.35,5000,1,1200,0,0,0,0,0,0,5000,5000,0,0
20200316,056819,奇力新永豐98購01,,,,,0.00,0.00,0,0,0,0,0,0,0,0,0,0,0,0,0
20200316,05681P,大立光元大96售05,,,,,0.00,0.00,0,0,0,0,0,0,0,0,0,0,0,0,0
20200316,056820,欣興永豐98購02,,,,,0.00,0.00,0,0,0,0,0,0,0,0,0,0,0,0,0
20200316,056821,日電貿永豐98購01,0.30,0.30,0.30,0.30,0.00,0.00,5000,1,1500,0,0,0,0,0,0,0,5000,-5000,-5000
20200316,056822,佐登永豐98購01,,,,,0.00,0.00,0,0,0,0,0,0,0,0,0,0,0,0,0
20200316,056823,智伸科永豐98購01,,,,,0.00,0.00,0,0,0,0,0,0,0,0,0,0,0,0,0
20200316,056824,元石油富邦9B購01,,,,,0.00,0.00,0,0,0,0,0,0,0,0,0,0,0,0,0
20200316,056825,深中小富邦9B購01,,,,,0.00,0.00,0,0,0,0,0,0,0,0,0,0,0,0,0
20200316,056826,A50正2富邦9B購02,0.71,0.71,0.71,0.71,-0.02,-2.74,5000,1,3550,0,0,0,0,0,0,5000,0,5000,5000
20200316,056827,元油2X富邦02購01,0.16,0.24,0.16,0.21,-0.04,-16.0,500000,37,99470,0,0,0,0,0,0,0,0,0,0
20200316,056828,國巨富邦9A購03,0.27,0.27,0.25,0.25,-0.06,-19.35,16000,2,4200,0,0,0,0,0,0,0,16000,-16000,-16000
20200316,056829,台積電富邦9A購01,0.33,0.40,0.27,0.28,-0.08,-22.22,2606000,159,785260,35000,0,35000,0,0,0,0,282000,-282000,-247000
20200316,05682P,大立光元大98售03,2.08,2.58,2.08,2.48,+0.40,19.23,98000,9,236850,0,0,0,0,0,0,84000,11000,73000,73000
20200316,056830,友達富邦99購01,,,,,0.00,0.00,0,0,0,0,0,0,0,0,0,0,0,0,0
20200316,056831,元油2X元富98購11,0.04,0.04,0.03,0.03,-0.01,-25.0,540000,3,17600,0,0,0,0,0,0,0,0,0,0
20200316,056832,元油2X元富98購12,0.02,0.02,0.02,0.02,-0.01,-33.33,605000,4,12100,0,0,0,0,0,0,0,0,0,0
20200316,056833,和大元富9B購01,0.44,0.44,0.44,0.44,-0.04,-8.33,4000,1,1760,0,0,0,0,0,0,4000,0,4000,4000
20200316,056834,華新元富99購01,,,,,0.00,0.00,0,0,0,0,0,0,0,0,0,0,0,0,0
20200316,056835,聯電元富99購01,0.75,0.76,0.67,0.68,-0.12,-15.0,1416000,41,977000,0,0,0,0,0,0,628000,778000,-150000,-150000
20200316,056836,國巨元富98購01,0.32,0.32,0.20,0.20,-0.12,-37.5,38000,9,9580,0,0,0,0,0,0,8000,0,8000,8000
20200316,056837,國巨元富98購02,0.28,0.28,0.22,0.22,-0.03,-12.0,50000,3,12280,0,0,0,0,0,0,48000,0,48000,48000
20200316,056838,旺宏元富98購01,,,,,0.00,0.00,0,0,0,0,0,0,0,0,0,0,0,0,0
20200316,056839,台光電元富98購02,1.00,1.05,0.94,1.03,+0.10,10.75,103000,8,104890,0,0,0,0,0,0,93000,10000,83000,83000
20200316,05683P,矽創元大96售01,2.15,2.50,2.15,2.50,+0.21,9.17,35000,4,80900,0,0,0,0,0,0,0,35000,-35000,-35000
20200316,056840,友達元富98購02,,,,,0.00,0.00,0,0,0,0,0,0,0,0,0,0,0,0,0
20200316,056841,友達元富98購03,,,,,0.00,0.00,0,0,0,0,0,0,0,0,0,0,0,0,0
20200316,056842,全新元富98購01,,,,,0.00,0.00,0,0,0,0,0,0,0,0,0,0,0,0,0
20200316,056843,冠德元富98購01,0.45,0.45,0.41,0.41,+0.07,20.59,144000,4,59500,0,0,0,0,0,0,130000,14000,116000,116000
20200316,056844,欣興元富98購03,1.07,1.07,0.65,0.65,-0.26,-28.57,116000,10,108400,0,0,0,0,0,0,83000,33000,50000,50000
20200316,056845,揚明光元富98購01,0.74,0.74,0.44,0.45,0.00,0.00,21000,3,9640,0,0,0,0,0,0,0,21000,-21000,-21000
20200316,056846,晶相光元富98購01,1.90,1.91,1.31,1.31,-0.37,-22.02,176000,25,309390,0,0,0,0,0,0,110000,66000,44000,44000
20200316,056847,佐登元富98購01,1.26,1.26,1.26,1.26,0.00,0.00,10000,1,12600,0,0,0,0,0,0,0,10000,-10000,-10000
20200316,056848,泰鼎元富98購01,0.72,0.77,0.56,0.56,-0.20,-26.32,93000,15,60710,0,0,0,0,0,0,17000,76000,-59000,-59000
20200316,056849,瀚宇博元富98購01,1.58,1.61,1.19,1.19,-0.13,-9.85,77000,8,111550,0,0,0,0,0,0,2000,75000,-73000,-73000
20200316,05684P,臺股指元大96售09,,,,,0.00,0.00,0,0,0,0,0,0,0,0,0,0,0,0,0
20200316,056850,彩晶元富99購01,0.14,0.14,0.14,0.14,0.00,0.00,1000,1,140,0,0,0,0,0,0,1000,0,1000,1000
20200316,056851,瑞儀元富98購01,0.55,0.64,0.54,0.56,+0.13,30.23,151000,22,90400,0,0,0,0,0,0,25000,146000,-121000,-121000
20200316,056852,矽格元富98購01,2.23,2.41,1.85,1.85,-0.30,-13.95,206000,13,471400,0,0,0,0,0,0,146000,60000,86000,86000
20200316,056853,元油2X中信9B購02,,,,,0.00,0.00,0,0,0,0,0,0,0,0,0,0,0,0,0
20200316,056854,友達中信9A購01,0.09,0.09,0.08,0.08,+0.02,33.33,33000,2,2670,0,0,0,0,0,0,3000,30000,-27000,-27000
20200316,056855,祥碩中信98購02,0.24,0.28,0.20,0.20,-0.09,-31.03,125000,9,29380,0,0,0,0,0,0,105000,20000,85000,85000
20200316,056856,華通群益9A購01,0.86,0.87,0.62,0.62,-0.18,-22.5,12000,5,9070,0,0,0,0,0,0,7000,5000,2000,2000
20200316,056857,國巨群益99購02,0.79,0.80,0.60,0.60,-0.08,-11.76,90000,4,64800,0,0,0,0,0,0,50000,40000,10000,10000
20200316,056858,國巨群益99購03,0.71,0.71,0.71,0.71,0.00,0.00,200000,1,142000,0,0,0,0,0,0,200000,0,200000,200000
20200316,056859,台積電群益98購02,0.52,0.52,0.39,0.39,-0.38,-49.35,25000,4,11400,0,0,0,0,0,0,0,25000,-25000,-25000
20200316,05685P,臺股指元大96售10,8.00,8.50,8.00,8.50,+0.60,7.59,75000,6,614750,0,0,0,0,0,0,75000,0,75000,75000
20200316,056860,正崴群益98購01,,,,,0.00,0.00,0,0,0,0,0,0,0,0,0,0,0,0,0
20200316,056861,美律群益99購01,0.65,0.65,0.65,0.65,0.00,0.00,50000,1,32500,0,0,0,0,0,0,50000,0,50000,50000
20200316,056862,聯發科群益98購03,,,,,0.00,0.00,0,0,0,0,0,0,0,0,0,0,0,0,0
20200316,056863,義隆群益98購01,,,,,0.00,0.00,0,0,0,0,0,0,0,0,0,0,0,0,0
20200316,056864,新日興群益99購01,0.41,0.41,0.32,0.33,-0.20,-37.74,180000,4,61300,0,0,0,0,0,0,180000,0,180000,180000
20200316,056865,樺漢群益98購01,,,,,0.00,0.00,0,0,0,0,0,0,0,0,0,0,0,0,0
20200316,056866,矽創群益98購03,,,,,0.00,0.00,0,0,0,0,0,0,0,0,0,0,0,0,0
20200316,056867,華通麥證98購01,0.33,0.33,0.33,0.33,0.00,0.00,22000,1,7260,22000,0,22000,0,0,0,22000,0,22000,22000
20200316,056868,奇力新麥證98購01,,,,,0.00,0.00,0,0,0,0,0,0,0,0,0,0,0,0,0
20200316,056869,國巨日盛99購03,0.78,0.78,0.47,0.47,-0.22,-31.88,145000,7,94050,0,0,0,0,0,0,145000,0,145000,145000
20200316,05686P,臺股指元大96售11,7.45,7.45,7.45,7.45,-0.55,-6.88,2000,1,14900,0,0,0,0,0,0,2000,0,2000,2000
20200316,056870,全新日盛9A購01,0.46,0.46,0.46,0.46,-0.02,-4.17,15000,2,6900,0,0,0,0,0,0,0,15000,-15000,-15000
20200316,056871,新日興日盛99購01,,,,,0.00,0.00,0,0,0,0,0,0,0,0,0,0,0,0,0
20200316,056872,旺宏凱基98購08,,,,,0.00,0.00,0,0,0,0,0,0,0,0,0,0,0,0,0
20200316,056873,友達凱基98購07,,,,,0.00,0.00,0,0,0,0,0,0,0,0,0,0,0,0,0
20200316,056874,友達凱基98購08,,,,,0.00,0.00,0,0,0,0,0,0,0,0,0,0,0,0,0
20200316,056875,亞光凱基98購03,0.35,0.35,0.33,0.33,0.00,0.00,97000,6,32960,0,0,0,0,0,0,97000,0,97000,97000
20200316,056876,群創凱基98購11,,,,,0.00,0.00,0,0,0,0,0,0,0,0,0,0,0,0,0
20200316,056877,群創凱基99購04,,,,,0.00,0.00,0,0,0,0,0,0,0,0,0,0,0,0,0
20200316,056878,元油2X國票99購02,,,,,0.00,0.00,0,0,0,0,0,0,0,0,0,0,0,0,0
20200316,056879,旺宏國票99購02,,,,,0.00,0.00,0,0,0,0,0,0,0,0,0,0,0,0,0
20200316,05687P,臺股指元大96售12,,,,,0.00,0.00,0,0,0,0,0,0,0,0,0,0,0,0,0
20200316,056880,緯穎國票98購02,1.67,1.67,1.67,1.67,+0.03,1.83,40000,1,66800,0,0,0,0,0,0,40000,0,40000,40000
20200316,056881,台灣50康和9A購01,0.08,0.08,0.08,0.08,-0.12,-60.0,40000,1,3200,0,0,0,0,0,0,40000,0,40000,40000
20200316,056882,華邦電康和98購01,,,,,0.00,0.00,0,0,0,0,0,0,0,0,0,0,0,0,0
20200316,056883,美食康和98購01,,,,,0.00,0.00,0,0,0,0,0,0,0,0,0,0,0,0,0
20200316,056884,元油2X元大99購02,,,,,0.00,0.00,0,0,0,0,0,0,0,0,0,0,0,0,0
20200316,056885,元油2X元大99購03,,,,,0.00,0.00,0,0,0,0,0,0,0,0,0,0,0,0,0
20200316,056886,元油2X元大99購04,0.02,0.02,0.02,0.02,-0.03,-60.0,300000,1,6000,0,0,0,0,0,0,0,0,0,0
20200316,056887,元油2X元大99購05,,,,,0.00,0.00,0,0,0,0,0,0,0,0,0,0,0,0,0
20200316,056888,元油2X元大99購06,,,,,0.00,0.00,0,0,0,0,0,0,0,0,0,0,0,0,0
20200316,056889,元油2X元大99購07,0.05,0.08,0.05,0.07,+0.03,75.0,765000,55,45200,0,0,0,0,0,0,0,0,0,0
20200316,05688P,臺股指元大96售13,6.60,6.60,6.45,6.45,+0.30,4.88,40000,4,260000,0,0,0,0,0,0,40000,0,40000,40000
20200316,056890,國巨元大98購11,0.91,0.91,0.91,0.91,+0.14,18.18,30000,1,27300,0,0,0,0,0,0,30000,0,30000,30000
20200316,056891,國巨元大99購03,1.33,1.33,0.91,0.91,-0.17,-15.74,40000,2,49000,0,0,0,0,0,0,30000,10000,20000,20000
20200316,056892,旺宏元大9A購02,0.94,0.96,0.94,0.96,+0.25,35.21,20000,2,19000,0,0,0,0,0,0,0,20000,-20000,-20000
20200316,056893,智邦元大98購02,1.27,1.42,1.26,1.32,+0.12,10.0,133000,29,178720,0,0,0,0,0,0,68000,94000,-26000,-26000
20200316,056894,佳世達元大99購01,,,,,0.00,0.00,0,0,0,0,0,0,0,0,0,0,0,0,0
20200316,056895,技嘉元大98購01,1.34,1.34,1.29,1.29,+0.04,3.2,2000,2,2630,0,0,0,0,0,0,1000,1000,0,0
20200316,056896,南亞科元大98購01,0.50,0.50,0.45,0.45,+0.02,4.65,100000,10,47500,0,0,0,0,0,0,0,100000,-100000,-100000
20200316,056897,南亞科元大98購02,,,,,0.00,0.00,0,0,0,0,0,0,0,0,0,0,0,0,0
20200316,056898,全新元大98購02,0.45,0.45,0.44,0.45,+0.11,32.35,10000,3,4470,0,0,0,0,0,0,10000,0,10000,10000
20200316,056899,可成元大98購01,0.66,0.69,0.60,0.60,-0.02,-3.23,102000,4,68800,0,0,0,0,0,0,102000,12000,90000,90000
20200316,05689P,滬深2X中信97售02,2.59,2.59,2.59,2.59,0.00,0.00,9000,1,23310,0,0,0,0,0,0,0,9000,-9000,-9000
20200316,056900,可成元大98購02,0.84,0.84,0.76,0.76,+0.04,5.56,50000,4,41000,0,0,0,0,0,0,40000,20000,20000,20000
20200316,056901,華新科元大98購03,0.28,0.28,0.21,0.21,-0.01,-4.55,55000,6,13800,0,0,0,0,0,0,10000,45000,-35000,-35000
20200316,056902,大立光元大98購12,1.28,1.28,0.88,0.88,-0.26,-22.81,50000,4,56900,0,0,0,0,0,0,40000,20000,20000,20000
20200316,056903,大立光元大99購04,1.18,1.18,0.86,0.88,-0.24,-21.43,30000,4,29980,0,0,0,0,0,0,27000,20000,7000,7000
20200316,056904,大立光元大99購05,0.69,0.69,0.48,0.50,-0.18,-26.47,45000,10,27020,0,0,0,0,0,0,25000,28000,-3000,-3000
20200316,056905,欣興元大98購03,0.73,0.73,0.61,0.61,-0.11,-15.28,13000,5,8760,0,0,0,0,0,0,13000,2000,11000,11000
20200316,056906,玉晶光元大9B購01,0.67,0.70,0.50,0.50,-0.20,-28.57,442000,32,257620,0,0,0,0,0,0,170000,272000,-102000,-102000
20200316,056907,群創元大9C購04,,,,,0.00,0.00,0,0,0,0,0,0,0,0,0,0,0,0,0
20200316,056908,牧德元大99購03,0.27,0.27,0.27,0.27,-0.06,-18.18,10000,1,2700,0,0,0,0,0,0,0,10000,-10000,-10000
20200316,056909,嘉聯益元大99購03,1.31,1.31,1.02,1.02,-0.24,-19.05,34000,7,39890,0,0,0,0,0,0,32000,2000,30000,30000
20200316,05690P,友達中信96售02,0.97,0.97,0.94,0.94,-0.20,-17.54,61000,5,58440,0,0,0,0,0,0,61000,0,61000,61000
20200316,056910,超眾元大99購02,1.16,1.18,0.82,0.83,-0.26,-23.85,100000,10,99700,0,0,0,0,0,0,50000,80000,-30000,-30000
20200316,056911,緯穎元大99購01,1.21,1.23,1.03,1.05,-0.01,-0.94,51000,5,58630,0,0,0,0,0,0,38000,13000,25000,25000
20200316,056912,臺股指元大99購04,0.84,0.84,0.84,0.84,-0.02,-2.33,100000,1,84000,0,0,0,0,0,0,100000,0,100000,100000
20200316,056913,臺股指元大99購05,0.75,0.76,0.50,0.51,-0.25,-32.89,953000,86,565720,0,0,0,0,0,0,255000,688000,-433000,-433000
20200316,056914,臺股指元大99購09,1.42,1.55,1.10,1.13,-0.46,-28.93,3380000,213,4338580,0,0,0,0,0,0,2167000,1183000,984000,984000
20200316,056915,上銀兆豐99購01,0.22,0.22,0.12,0.12,-0.08,-40.0,60000,3,8700,0,0,0,0,0,0,5000,55000,-50000,-50000
20200316,056916,台達電兆豐98購02,0.31,0.31,0.25,0.25,-0.05,-16.67,58000,2,16780,0,0,0,0,0,0,38000,20000,18000,18000
20200316,056917,國巨兆豐98購03,,,,,0.00,0.00,0,0,0,0,0,0,0,0,0,0,0,0,0
20200316,056918,台積電兆豐98購01,0.60,0.60,0.29,0.53,-0.02,-3.64,184000,10,57190,0,0,0,0,0,0,0,0,0,0
20200316,056919,英業達兆豐98購01,0.93,1.00,0.85,0.85,-0.21,-19.81,359000,12,347030,0,0,0,0,0,0,243000,116000,127000,127000
20200316,05691P,聯發科中信98售01,1.96,2.30,1.89,2.30,-0.30,-11.54,82000,11,160660,0,0,0,0,0,0,10000,72000,-62000,-62000
20200316,056920,友達兆豐98購02,,,,,0.00,0.00,0,0,0,0,0,0,0,0,0,0,0,0,0
20200316,056921,京元電兆豐98購01,1.04,1.25,0.91,0.95,+0.05,5.56,1212000,41,1385300,0,0,0,0,0,0,344000,909000,-565000,-565000
20200316,056922,全新兆豐99購01,,,,,0.00,0.00,0,0,0,0,0,0,0,0,0,0,0,0,0
20200316,056923,奇力新兆豐99購02,,,,,0.00,0.00,0,0,0,0,0,0,0,0,0,0,0,0,0
20200316,056924,亞光兆豐98購01,,,,,0.00,0.00,0,0,0,0,0,0,0,0,0,0,0,0,0
20200316,056925,群創兆豐98購03,0.07,0.07,0.05,0.05,-0.02,-28.57,887000,70,54750,0,0,0,0,0,0,0,887000,-887000,-887000
20200316,056926,日月光兆豐98購01,,,,,0.00,0.00,0,0,0,0,0,0,0,0,0,0,0,0,0
20200316,056927,T50反1台新02購01,,,,,0.00,0.00,0,0,0,0,0,0,0,0,0,0,0,0,0
20200316,056928,旺宏台新98購01,,,,,0.00,0.00,0,0,0,0,0,0,0,0,0,0,0,0,0
20200316,056929,華新科台新98購01,0.24,0.24,0.20,0.20,+0.06,42.86,10000,2,2200,0,0,0,0,0,0,5000,5000,0,0
20200316,05692P,聯發科中信9A售02,1.62,1.72,1.57,1.72,+0.12,7.5,96000,8,152420,0,0,0,0,0,0,65000,36000,29000,29000
20200316,056930,晶豪科台新98購01,0.84,0.90,0.68,0.69,-0.16,-18.82,1163000,12,911860,0,0,0,0,0,0,1112000,51000,1061000,1061000
20200316,056931,智原台新98購01,,,,,0.00,0.00,0,0,0,0,0,0,0,0,0,0,0,0,0
20200316,056932,T50反1元富98購01,2.04,2.04,2.04,2.04,+0.13,6.81,31000,1,63240,0,0,0,0,0,0,31000,0,31000,31000
20200316,056933,國巨元富98購03,,,,,0.00,0.00,0,0,0,0,0,0,0,0,0,0,0,0,0
20200316,056934,國巨元富98購04,0.07,0.07,0.07,0.07,-0.06,-46.15,40000,1,2800,0,0,0,0,0,0,40000,0,40000,40000
20200316,056935,華新科元富98購02,0.31,0.31,0.19,0.19,-0.03,-13.64,175000,17,37850,0,0,0,0,0,0,40000,145000,-105000,-105000
20200316,056936,禾伸堂元富98購01,0.87,0.91,0.81,0.84,+0.01,1.2,489000,23,409320,0,0,0,0,0,0,469000,0,469000,469000
20200316,056937,智原元富98購01,0.30,0.32,0.29,0.30,0.00,0.00,100000,6,29800,0,0,0,0,0,0,0,100000,-100000,-100000
20200316,056938,泰碩元富98購01,1.17,1.33,0.90,0.90,-0.27,-23.08,164000,17,182980,0,0,0,0,0,0,53000,61000,-8000,-8000
20200316,056939,康控元富98購01,0.54,0.58,0.42,0.42,-0.14,-25.0,38000,5,19740,0,0,0,0,0,0,0,38000,-38000,-38000
20200316,05693P,滬深2X凱基98售02,2.33,2.57,2.26,2.57,+0.10,4.05,476000,10,1115180,0,0,0,0,0,0,104000,372000,-268000,-268000
20200316,056940,嘉聯益元富98購01,,,,,0.00,0.00,0,0,0,0,0,0,0,0,0,0,0,0,0
20200316,056941,台郡元富9B購01,1.27,1.33,1.05,1.05,-0.28,-21.05,23000,5,29430,0,0,0,0,0,0,11000,12000,-1000,-1000
20200316,056942,昇陽半元富98購01,0.40,0.40,0.40,0.40,0.00,0.00,10000,1,4000,0,0,0,0,0,0,0,10000,-10000,-10000
20200316,056943,華通統一99購01,,,,,0.00,0.00,0,0,0,0,0,0,0,0,0,0,0,0,0
20200316,056944,鴻海統一98購11,,,,,0.00,0.00,0,0,0,0,0,0,0,0,0,0,0,0,0
20200316,056945,鴻海統一98購12,0.61,0.68,0.54,0.60,+0.06,11.11,20000,6,11460,0,0,0,0,0,0,16000,1000,15000,15000
20200316,056946,國巨統一98購05,0.33,0.33,0.33,0.33,0.00,0.00,80000,1,26400,0,0,0,0,0,0,80000,0,80000,80000
20200316,056947,國巨統一9A購01,,,,,0.00,0.00,0,0,0,0,0,0,0,0,0,0,0,0,0
20200316,056948,旺宏統一9A購01,,,,,0.00,0.00,0,0,0,0,0,0,0,0,0,0,0,0,0
20200316,056949,義隆統一98購01,,,,,0.00,0.00,0,0,0,0,0,0,0,0,0,0,0,0,0
20200316,05694P,台積電凱基96售09,3.16,3.16,3.16,3.16,-0.40,-11.24,2000,1,6320,0,0,0,0,0,0,2000,0,2000,2000
20200316,056950,亞光統一99購01,,,,,0.00,0.00,0,0,0,0,0,0,0,0,0,0,0,0,0
20200316,056951,牧德統一99購01,,,,,0.00,0.00,0,0,0,0,0,0,0,0,0,0,0,0,0
20200316,056952,元油2X國泰99購01,,,,,0.00,0.00,0,0,0,0,0,0,0,0,0,0,0,0,0
20200316,056953,智邦富邦98購02,0.34,0.34,0.34,0.34,0.00,0.00,10000,2,3400,0,0,0,0,0,0,0,10000,-10000,-10000
20200316,056954,聯詠富邦9A購01,0.43,0.43,0.39,0.39,+0.01,2.63,2000,2,820,0,0,0,0,0,0,1000,1000,0,0
20200316,056955,台灣50永豐98購01,0.23,0.23,0.12,0.12,-0.11,-47.83,1295000,127,181360,0,0,0,0,0,0,0,880000,-880000,-880000
20200316,056956,元油2X永豐99購01,,,,,0.00,0.00,0,0,0,0,0,0,0,0,0,0,0,0,0
20200316,056957,元油2X永豐9A購02,,,,,0.00,0.00,0,0,0,0,0,0,0,0,0,0,0,0,0
20200316,056958,喬山永豐98購01,,,,,0.00,0.00,0,0,0,0,0,0,0,0,0,0,0,0,0
20200316,056959,鴻海永豐98購03,,,,,0.00,0.00,0,0,0,0,0,0,0,0,0,0,0,0,0
20200316,05695P,台積電凱基96售10,3.58,4.52,3.58,4.52,-0.07,-1.53,174000,8,720620,0,0,0,0,0,0,64000,110000,-46000,-46000
20200316,056960,光罩永豐98購01,0.62,0.62,0.57,0.57,+0.01,1.79,10000,2,5950,0,0,0,0,0,0,5000,5000,0,0
20200316,056961,凱美永豐98購01,,,,,0.00,0.00,0,0,0,0,0,0,0,0,0,0,0,0,0
20200316,056962,技嘉永豐98購01,0.31,0.31,0.29,0.29,+0.03,11.54,60000,6,18400,0,0,0,0,0,0,0,60000,-60000,-60000
20200316,056963,建準永豐98購01,,,,,0.00,0.00,0,0,0,0,0,0,0,0,0,0,0,0,0
20200316,056964,聯發科永豐98購03,0.23,0.23,0.15,0.15,-0.13,-46.43,540000,4,106200,0,0,0,0,0,0,290000,250000,40000,40000
20200316,056965,全新永豐98購01,,,,,0.00,0.00,0,0,0,0,0,0,0,0,0,0,0,0,0
20200316,056966,嘉晶永豐98購01,2.24,2.44,1.90,1.90,-0.40,-17.39,267000,22,628970,0,0,0,0,0,0,122000,149000,-27000,-27000
20200316,056967,奇鋐永豐98購01,0.84,0.85,0.79,0.85,+0.23,37.1,77000,4,64350,0,0,0,0,0,0,0,77000,-77000,-77000
20200316,056968,揚明光永豐98購02,,,,,0.00,0.00,0,0,0,0,0,0,0,0,0,0,0,0,0
20200316,056969,智易永豐98購01,0.48,0.52,0.44,0.44,-0.02,-4.35,50000,7,24250,0,0,0,0,0,0,11000,39000,-28000,-28000
20200316,05696P,南亞科凱基96售01,2.05,2.21,1.70,2.18,+0.13,6.34,439000,16,806180,0,0,0,0,0,0,303000,136000,167000,167000
20200316,056970,TPK永豐98購01,,,,,0.00,0.00,0,0,0,0,0,0,0,0,0,0,0,0,0
20200316,056971,麗豐永豐98購01,0.52,0.52,0.51,0.51,+0.14,37.84,52000,3,26540,0,0,0,0,0,0,52000,0,52000,52000
20200316,056972,祥碩永豐98購02,0.30,0.38,0.26,0.27,-0.12,-30.77,323000,26,100280,0,0,0,0,0,0,126000,160000,-34000,-34000
20200316,056973,T50反1永昌9C購01,,,,,0.00,0.00,0,0,0,0,0,0,0,0,0,0,0,0,0
20200316,056974,臻鼎永昌9C購01,,,,,0.00,0.00,0,0,0,0,0,0,0,0,0,0,0,0,0
20200316,056975,元油2X群益98購03,,,,,0.00,0.00,0,0,0,0,0,0,0,0,0,0,0,0,0
20200316,056976,喬山群益98購01,0.19,0.19,0.11,0.11,-0.06,-35.29,132000,6,21880,0,0,0,0,0,0,60000,72000,-12000,-12000
20200316,056977,國巨群益9A購01,0.60,0.60,0.42,0.42,-0.09,-17.65,596000,5,345040,0,0,0,0,0,0,0,596000,-596000,-596000
20200316,056978,技嘉群益99購01,,,,,0.00,0.00,0,0,0,0,0,0,0,0,0,0,0,0,0
20200316,056979,微星群益98購01,,,,,0.00,0.00,0,0,0,0,0,0,0,0,0,0,0,0,0
20200316,05697P,友達凱基96售01,1.56,1.56,1.56,1.56,-0.37,-19.17,10000,1,15600,0,0,0,0,0,0,10000,0,10000,10000
20200316,056980,建準群益98購02,0.31,0.31,0.31,0.31,+0.08,34.78,10000,1,3100,0,0,0,0,0,0,0,10000,-10000,-10000
20200316,056981,全新群益99購03,,,,,0.00,0.00,0,0,0,0,0,0,0,0,0,0,0,0,0
20200316,056982,華新科群益98購05,0.31,0.31,0.23,0.23,0.00,0.00,114000,5,35210,0,0,0,0,0,0,0,114000,-114000,-114000
20200316,056983,大立光群益99購02,0.62,0.62,0.55,0.55,+0.05,10.0,20000,2,11700,0,0,0,0,0,0,10000,10000,0,0
20200316,056984,嘉晶群益98購01,,,,,0.00,0.00,0,0,0,0,0,0,0,0,0,0,0,0,0
20200316,056985,智原群益98購03,,,,,0.00,0.00,0,0,0,0,0,0,0,0,0,0,0,0,0
20200316,056986,超眾群益98購03,,,,,0.00,0.00,0,0,0,0,0,0,0,0,0,0,0,0,0
20200316,056987,南茂群益98購01,0.70,0.70,0.64,0.67,+0.03,4.69,1505000,7,984590,0,0,0,0,0,0,1485000,23000,1462000,1462000
20200316,056988,聚陽兆豐98購01,0.25,0.25,0.25,0.25,-0.01,-3.85,100000,5,25000,0,0,0,0,0,0,100000,0,100000,100000
20200316,056989,鴻海兆豐98購02,0.31,0.33,0.28,0.28,-0.03,-9.68,60000,7,18000,0,0,0,0,0,0,35000,25000,10000,10000
20200316,05698P,群創凱基96售01,,,,,0.00,0.00,0,0,0,0,0,0,0,0,0,0,0,0,0
20200316,056990,聯發科兆豐98購01,0.32,0.32,0.31,0.31,0.00,0.00,40000,2,12700,0,0,0,0,0,0,0,40000,-40000,-40000
20200316,056991,牧德兆豐98購01,,,,,0.00,0.00,0,0,0,0,0,0,0,0,0,0,0,0,0
20200316,056992,祥碩兆豐98購01,0.45,0.45,0.42,0.42,-0.13,-23.64,22000,2,9750,0,0,0,0,0,0,5000,17000,-12000,-12000
20200316,056993,GIS兆豐99購01,0.24,0.24,0.20,0.20,+0.03,17.65,110000,3,26000,0,0,0,0,0,0,0,110000,-110000,-110000
20200316,056994,緯穎兆豐98購02,0.73,0.75,0.60,0.60,-0.10,-14.29,668000,28,453110,0,0,0,0,0,0,306000,362000,-56000,-56000
20200316,056995,華新科日盛99購01,,,,,0.00,0.00,0,0,0,0,0,0,0,0,0,0,0,0,0
20200316,056996,矽力日盛99購01,,,,,0.00,0.00,0,0,0,0,0,0,0,0,0,0,0,0,0
20200316,056997,台灣50康和9A購02,0.22,0.22,0.13,0.13,-0.09,-40.91,80000,8,11920,0,0,0,0,0,0,41000,0,41000,41000
20200316,056998,麗豐康和98購01,0.60,0.60,0.60,0.60,+0.14,30.43,68000,1,40800,0,0,0,0,0,0,68000,0,68000,68000
20200316,056999,元油2X國票98購02,0.03,0.03,0.03,0.03,-0.01,-25.0,30000,1,900,0,0,0,0,0,0,0,0,0,0
20200316,05699P,茂林凱基96售05,0.94,1.19,0.87,1.19,+0.34,40.0,245000,18,256290,0,0,0,0,0,0,226000,7000,219000,219000
20200316,057000,亞德客國票99購01,1.11,1.11,1.08,1.08,+0.44,68.75,7000,2,7710,0,0,0,0,0,0,0,7000,-7000,-7000
20200316,057001,華邦電國票99購02,,,,,0.00,0.00,0,0,0,0,0,0,0,0,0,0,0,0,0
20200316,057002,友達國票98購01,,,,,0.00,0.00,0,0,0,0,0,0,0,0,0,0,0,0,0
20200316,057003,立積國票98購01,1.63,1.63,0.85,0.85,-0.46,-35.11,94000,7,128900,0,0,0,0,0,0,64000,30000,34000,34000
20200316,057004,滬深反中信9A購01,1.46,1.46,1.46,1.46,-0.09,-5.81,10000,1,14600,0,0,0,0,0,0,0,10000,-10000,-10000
20200316,057005,元油2X中信9C購01,0.11,0.11,0.09,0.10,0.00,0.00,34000,5,3480,0,0,0,0,0,0,0,24000,-24000,-24000
20200316,057006,國巨中信98購03,0.23,0.23,0.15,0.16,+0.04,33.33,32000,4,5750,0,0,0,0,0,0,10000,22000,-12000,-12000
20200316,057007,奇力新中信98購04,,,,,0.00,0.00,0,0,0,0,0,0,0,0,0,0,0,0,0
20200316,057008,華新科中信99購02,,,,,0.00,0.00,0,0,0,0,0,0,0,0,0,0,0,0,0
20200316,057009,信邦中信99購01,0.36,0.36,0.36,0.36,-0.01,-2.7,70000,1,25200,0,0,0,0,0,0,70000,0,70000,70000
20200316,05700P,臻鼎凱基96售02,3.85,4.00,3.85,4.00,+0.44,12.36,6000,2,23250,0,0,0,0,0,0,0,6000,-6000,-6000
20200316,057010,景碩中信98購01,,,,,0.00,0.00,0,0,0,0,0,0,0,0,0,0,0,0,0
20200316,057011,日月光中信99購01,,,,,0.00,0.00,0,0,0,0,0,0,0,0,0,0,0,0,0
20200316,057012,康控中信98購01,,,,,0.00,0.00,0,0,0,0,0,0,0,0,0,0,0,0,0
20200316,057013,聯發科麥證98購01,1.00,1.14,0.70,0.81,-0.34,-29.57,406000,18,375030,330000,76000,254000,0,0,0,340000,76000,264000,264000
20200316,057014,元油2X凱基9A購05,,,,,0.00,0.00,0,0,0,0,0,0,0,0,0,0,0,0,0
20200316,057015,元油2X凱基9B購04,,,,,0.00,0.00,0,0,0,0,0,0,0,0,0,0,0,0,0
20200316,057016,中石化凱基9B購01,0.40,0.40,0.37,0.37,+0.01,2.78,63000,4,23940,0,0,0,0,0,0,52000,11000,41000,41000
20200316,057017,和大凱基98購01,,,,,0.00,0.00,0,0,0,0,0,0,0,0,0,0,0,0,0
20200316,057018,亞德客凱基98購01,0.31,0.31,0.31,0.31,0.00,0.00,200000,2,62000,0,0,0,0,0,0,0,200000,-200000,-200000
20200316,057019,台積電凱基98購14,0.91,0.91,0.68,0.68,-0.02,-2.86,15000,3,11350,0,0,0,0,0,0,5000,0,5000,5000
20200316,05701P,彩晶凱基96售01,1.09,1.09,1.09,1.09,-0.26,-19.26,10000,2,10900,0,0,0,0,0,0,0,10000,-10000,-10000
20200316,057020,台積電凱基99購02,0.39,0.39,0.32,0.33,-0.28,-45.9,100000,5,37480,0,0,0,0,0,0,88000,12000,76000,76000
20200316,057021,台積電凱基9A購02,0.57,0.57,0.50,0.50,+0.06,13.64,28000,4,14560,0,0,0,0,0,0,0,28000,-28000,-28000
20200316,057022,智邦凱基98購04,1.16,1.18,1.01,1.01,-0.08,-7.34,142000,15,155910,0,0,0,0,0,0,84000,78000,6000,6000
20200316,057023,美律凱基99購02,0.75,0.75,0.67,0.69,+0.23,50.0,170000,4,119300,0,0,0,0,0,0,60000,110000,-50000,-50000
20200316,057024,義隆凱基99購01,0.48,0.51,0.48,0.51,+0.12,30.77,43000,3,21060,0,0,0,0,0,0,43000,0,43000,43000
20200316,057025,華新科凱基98購04,,,,,0.00,0.00,0,0,0,0,0,0,0,0,0,0,0,0,0
20200316,057026,長榮航凱基98購01,0.30,0.30,0.23,0.23,-0.12,-34.29,600000,22,159050,0,0,0,0,0,0,260000,340000,-80000,-80000
20200316,057027,祥碩凱基98購01,0.23,0.29,0.18,0.20,-0.14,-41.18,101000,17,25230,0,0,0,0,0,0,15000,70000,-55000,-55000
20200316,057028,台郡凱基99購02,1.02,1.02,0.88,0.88,0.00,0.00,67000,5,67660,0,0,0,0,0,0,4000,63000,-59000,-59000
20200316,057029,緯穎凱基98購04,0.81,0.81,0.81,0.81,0.00,0.00,100000,1,81000,0,0,0,0,0,0,100000,0,100000,100000
20200316,05702P,矽創凱基96售02,0.74,0.95,0.74,0.95,+0.14,17.28,80000,6,66200,0,0,0,0,0,0,40000,40000,0,0
20200316,057030,滬深反元大9B購01,,,,,0.00,0.00,0,0,0,0,0,0,0,0,0,0,0,0,0
20200316,057031,滬深反元大9B購02,,,,,0.00,0.00,0,0,0,0,0,0,0,0,0,0,0,0,0
20200316,057032,A50反1元大9B購01,0.85,0.85,0.85,0.85,+0.13,18.06,10000,1,8500,0,0,0,0,0,0,10000,0,10000,10000
20200316,057033,A50反1元大9B購02,,,,,0.00,0.00,0,0,0,0,0,0,0,0,0,0,0,0,0
20200316,057034,道瓊反元大9B購01,1.76,1.93,1.76,1.93,+0.25,14.88,408000,49,761590,0,0,0,0,0,0,1000,407000,-406000,-406000
20200316,057035,元油2X元大9B購03,0.01,0.01,0.01,0.01,0.00,0.00,100000,2,1000,0,0,0,0,0,0,0,0,0,0
20200316,057036,元油2X元大9B購04,0.10,0.10,0.04,0.04,-0.06,-60.0,70000,4,3400,0,0,0,0,0,0,0,0,0,0
20200316,057037,元油2X元大9B購05,0.06,0.10,0.06,0.06,+0.03,100.0,865000,14,66060,0,0,0,0,0,0,0,0,0,0
20200316,057038,元油2X元大9B購06,0.05,0.05,0.04,0.04,-0.02,-33.33,150000,3,6800,0,0,0,0,0,0,0,0,0,0
20200316,057039,元油2X元大9B購07,0.06,0.06,0.05,0.06,-0.01,-14.29,1437000,22,76700,0,0,0,0,0,0,0,0,0,0
20200316,05703P,矽力群益96售03,1.30,1.30,1.30,1.30,+0.12,10.17,1000,1,1300,0,0,0,0,0,0,1000,0,1000,1000
20200316,057040,國巨元大98購12,1.04,1.04,0.75,0.76,-0.18,-19.15,83000,8,69790,0,0,0,0,0,0,26000,57000,-31000,-31000
20200316,057041,國巨元大99購04,0.89,0.89,0.62,0.62,-0.26,-29.55,176000,10,126190,0,0,0,0,0,0,160000,71000,89000,89000
20200316,057042,台積電元大98購10,1.13,1.18,0.68,0.73,-0.62,-45.93,1030000,98,922450,10000,0,10000,0,0,0,217000,823000,-606000,-596000
20200316,057043,台積電元大99購02,0.67,0.70,0.48,0.48,-0.26,-35.14,1033000,94,601470,0,0,0,0,0,0,469000,552000,-83000,-83000
20200316,057044,旺宏元大98購08,,,,,0.00,0.00,0,0,0,0,0,0,0,0,0,0,0,0,0
20200316,057045,美律元大99購04,1.12,1.16,1.06,1.06,-0.01,-0.93,34000,6,38700,0,0,0,0,0,0,21000,13000,8000,8000
20200316,057046,奇力新元大99購03,,,,,0.00,0.00,0,0,0,0,0,0,0,0,0,0,0,0,0
20200316,057047,華新科元大99購07,0.41,0.47,0.29,0.29,-0.11,-27.5,104000,19,38480,0,0,0,0,0,0,4000,100000,-96000,-96000
20200316,057048,新日興元大98購01,0.61,0.63,0.51,0.51,-0.02,-3.77,100000,6,57400,0,0,0,0,0,0,70000,30000,40000,40000
20200316,057049,新日興元大98購02,0.54,0.57,0.39,0.39,-0.07,-15.22,77000,9,39700,0,0,0,0,0,0,12000,65000,-53000,-53000
20200316,05704P,矽力群益96售04,,,,,0.00,0.00,0,0,0,0,0,0,0,0,0,0,0,0,0
20200316,057050,群創元大99購03,,,,,0.00,0.00,0,0,0,0,0,0,0,0,0,0,0,0,0
20200316,057051,群創元大9B購03,,,,,0.00,0.00,0,0,0,0,0,0,0,0,0,0,0,0,0
20200316,057052,華擎元大98購01,0.75,0.75,0.75,0.75,0.00,0.00,1000,1,750,0,0,0,0,0,0,1000,0,1000,1000
20200316,057053,立積元大98購02,1.45,1.45,1.38,1.38,0.00,0.00,15000,2,21050,0,0,0,0,0,0,15000,0,15000,15000
20200316,057054,立積元大98購03,1.10,1.10,1.07,1.07,+0.02,1.9,6000,2,6450,0,0,0,0,0,0,6000,0,6000,6000
20200316,057055,立積元大99購01,1.32,1.35,0.95,0.95,-0.19,-16.67,34000,4,42400,0,0,0,0,0,0,18000,24000,-6000,-6000
20200316,057056,立積元大99購02,1.79,1.79,1.79,1.79,+0.01,0.56,10000,2,17900,0,0,0,0,0,0,5000,5000,0,0
20200316,057057,立積元大9A購01,,,,,0.00,0.00,0,0,0,0,0,0,0,0,0,0,0,0,0
20200316,057058,祥碩元大98購04,1.22,1.22,0.94,0.98,-0.23,-19.01,162000,32,175910,0,0,0,0,0,0,154000,152000,2000,2000
20200316,057059,易華電元大99購01,0.71,0.71,0.59,0.59,-0.20,-25.32,9000,2,5910,0,0,0,0,0,0,0,9000,-9000,-9000
20200316,05705P,上証2X永豐96售03,,,,,0.00,0.00,0,0,0,0,0,0,0,0,0,0,0,0,0
20200316,057060,緯穎元大98購05,1.23,1.30,1.18,1.18,+0.39,49.37,30000,3,37100,0,0,0,0,0,0,20000,10000,10000,10000
20200316,057061,華擎國泰9A購01,0.88,0.91,0.88,0.91,+0.09,10.98,45000,3,40600,0,0,0,0,0,0,45000,0,45000,45000
20200316,057062,立積國泰99購01,0.81,0.85,0.58,0.58,-0.18,-23.68,67000,7,49120,0,0,0,0,0,0,22000,45000,-23000,-23000
20200316,057063,立積國泰9A購01,0.77,0.77,0.53,0.53,-0.15,-22.06,355000,6,253650,0,0,0,0,0,0,355000,0,355000,355000
20200316,057064,華新科富邦9B購01,0.23,0.24,0.16,0.16,-0.12,-42.86,113000,9,22640,0,0,0,0,0,0,31000,2000,29000,29000
20200316,057065,牧德富邦99購01,0.09,0.09,0.09,0.09,0.00,0.00,209000,4,18810,0,0,0,0,0,0,0,209000,-209000,-209000
20200316,057066,緯穎富邦99購01,0.38,0.38,0.34,0.35,+0.13,59.09,227000,8,84490,0,0,0,0,0,0,45000,227000,-182000,-182000
20200316,057067,元油2X永豐9B購01,,,,,0.00,0.00,0,0,0,0,0,0,0,0,0,0,0,0,0
20200316,057068,國巨永豐98購06,,,,,0.00,0.00,0,0,0,0,0,0,0,0,0,0,0,0,0
20200316,057069,台積電永豐98購02,0.15,0.15,0.13,0.13,0.00,0.00,66000,5,8740,0,0,0,0,0,0,8000,58000,-50000,-50000
20200316,05706P,TPK永豐96售02,,,,,0.00,0.00,0,0,0,0,0,0,0,0,0,0,0,0,0
20200316,057070,美律永豐98購02,,,,,0.00,0.00,0,0,0,0,0,0,0,0,0,0,0,0,0
20200316,057071,華擎永豐98購02,0.31,0.35,0.28,0.30,-0.01,-3.23,850000,14,272730,0,0,0,0,0,0,353000,497000,-144000,-144000
20200316,057072,日月光永豐98購01,,,,,0.00,0.00,0,0,0,0,0,0,0,0,0,0,0,0,0
20200316,057073,康控永豐98購01,0.41,0.44,0.31,0.31,-0.07,-18.42,62000,5,25070,0,0,0,0,0,0,52000,10000,42000,42000
20200316,057074,立積永豐98購01,0.50,0.50,0.30,0.30,-0.08,-21.05,123000,6,48300,0,0,0,0,0,0,15000,108000,-93000,-93000
20200316,057075,嘉聯益永豐98購01,,,,,0.00,0.00,0,0,0,0,0,0,0,0,0,0,0,0,0
20200316,057076,緯穎永豐98購01,0.48,0.53,0.48,0.53,+0.28,112.0,49000,3,23650,0,0,0,0,0,0,49000,0,49000,49000
20200316,057077,國巨統一98購06,,,,,0.00,0.00,0,0,0,0,0,0,0,0,0,0,0,0,0
20200316,057078,國巨統一9A購02,0.35,0.36,0.31,0.33,-0.05,-13.16,81000,12,26360,0,0,0,0,0,0,48000,1000,47000,47000
20200316,057079,台積電統一9A購02,,,,,0.00,0.00,0,0,0,0,0,0,0,0,0,0,0,0,0
20200316,05707P,中磊永豐96售01,,,,,0.00,0.00,0,0,0,0,0,0,0,0,0,0,0,0,0
20200316,057080,華新科統一99購02,,,,,0.00,0.00,0,0,0,0,0,0,0,0,0,0,0,0,0
20200316,057081,大立光統一98購07,0.37,0.37,0.37,0.37,0.00,0.00,10000,1,3700,0,0,0,0,0,0,0,10000,-10000,-10000
20200316,057082,玉晶光統一9A購04,,,,,0.00,0.00,0,0,0,0,0,0,0,0,0,0,0,0,0
20200316,057083,立積統一98購01,0.86,0.86,0.56,0.60,-0.24,-28.57,31000,3,19240,0,0,0,0,0,0,31000,0,31000,31000
20200316,057084,立積統一9B購01,0.85,0.85,0.85,0.85,-0.01,-1.16,1000,1,850,0,0,0,0,0,0,1000,0,1000,1000
20200316,057085,立積統一9B購02,,,,,0.00,0.00,0,0,0,0,0,0,0,0,0,0,0,0,0
20200316,057086,立積統一9C購01,,,,,0.00,0.00,0,0,0,0,0,0,0,0,0,0,0,0,0
20200316,057087,台郡統一99購01,,,,,0.00,0.00,0,0,0,0,0,0,0,0,0,0,0,0,0
20200316,057088,上銀元富98購01,,,,,0.00,0.00,0,0,0,0,0,0,0,0,0,0,0,0,0
20200316,057089,奇力新元富98購01,0.13,0.13,0.13,0.13,-0.01,-7.14,10000,1,1300,0,0,0,0,0,0,0,10000,-10000,-10000
20200316,05708P,奇力新國票97售04,2.34,2.34,2.34,2.34,-0.10,-4.1,10000,1,23400,0,0,0,0,0,0,0,0,0,0
20200316,057090,奇力新元富98購02,,,,,0.00,0.00,0,0,0,0,0,0,0,0,0,0,0,0,0
20200316,057091,華新科元富9A購01,0.46,0.53,0.37,0.37,-0.06,-13.95,986000,67,463300,0,0,0,0,0,0,440000,546000,-106000,-106000
20200316,057092,健策元富98購01,,,,,0.00,0.00,0,0,0,0,0,0,0,0,0,0,0,0,0
20200316,057093,臻鼎元富98購02,0.46,0.65,0.38,0.38,-0.11,-22.45,966000,68,473180,0,0,0,0,0,0,403000,488000,-85000,-85000
20200316,057094,祥碩元富98購01,0.72,0.76,0.55,0.55,-0.27,-32.93,2740000,43,1860240,0,0,0,0,0,0,2735000,70000,2665000,2665000
20200316,057095,祥碩元富98購02,0.40,0.42,0.30,0.31,-0.10,-24.39,292000,31,100490,0,0,0,0,0,0,177000,50000,127000,127000
20200316,057096,緯穎元富98購01,1.10,1.20,0.98,0.98,+0.29,42.03,110000,12,123210,0,0,0,0,0,0,78000,32000,46000,46000
20200316,057097,致新元富98購01,1.30,1.39,1.13,1.13,0.00,0.00,121000,7,154420,0,0,0,0,0,0,81000,40000,41000,41000
20200316,057098,新光金台新98購01,,,,,0.00,0.00,0,0,0,0,0,0,0,0,0,0,0,0,0
20200316,057099,元油2X中信9B購03,0.34,0.35,0.34,0.35,-0.12,-25.53,160000,4,55900,0,0,0,0,0,0,50000,110000,-60000,-60000
20200316,05709P,大立光國票97售01,,,,,0.00,0.00,0,0,0,0,0,0,0,0,0,0,0,0,0
20200316,057100,國巨中信9A購02,0.28,0.28,0.28,0.28,+0.03,12.0,40000,1,11200,0,0,0,0,0,0,40000,0,40000,40000
20200316,057101,新光金中信9A購01,,,,,0.00,0.00,0,0,0,0,0,0,0,0,0,0,0,0,0
20200316,057102,亞光中信9A購01,,,,,0.00,0.00,0,0,0,0,0,0,0,0,0,0,0,0,0
20200316,057103,禾伸堂中信9A購01,0.65,0.65,0.65,0.65,0.00,0.00,10000,1,6500,0,0,0,0,0,0,10000,0,10000,10000
20200316,057104,康友中信99購01,0.20,0.20,0.20,0.20,-0.12,-37.5,5000,1,1000,0,0,0,0,0,0,0,5000,-5000,-5000
20200316,057105,致茂群益9A購01,0.68,0.68,0.68,0.68,+0.16,30.77,11000,1,7480,0,0,0,0,0,0,11000,0,11000,11000
20200316,057106,美律群益98購03,,,,,0.00,0.00,0,0,0,0,0,0,0,0,0,0,0,0,0
20200316,057107,華新科群益98購06,,,,,0.00,0.00,0,0,0,0,0,0,0,0,0,0,0,0,0
20200316,057108,潤泰全群益98購01,0.73,0.73,0.73,0.73,+0.08,12.31,20000,1,14600,0,0,0,0,0,0,20000,0,20000,20000
20200316,057109,信邦群益98購01,,,,,0.00,0.00,0,0,0,0,0,0,0,0,0,0,0,0,0
20200316,05710P,禾伸堂國票97售02,,,,,0.00,0.00,0,0,0,0,0,0,0,0,0,0,0,0,0
20200316,057110,立積群益98購01,,,,,0.00,0.00,0,0,0,0,0,0,0,0,0,0,0,0,0
20200316,057111,立積群益98購02,1.27,1.27,0.78,0.78,-0.29,-27.1,97000,9,96080,0,0,0,0,0,0,62000,35000,27000,27000
20200316,057112,立積群益99購01,,,,,0.00,0.00,0,0,0,0,0,0,0,0,0,0,0,0,0
20200316,057113,祥碩群益98購01,0.82,0.82,0.73,0.73,+0.04,5.8,39000,11,29270,0,0,0,0,0,0,39000,19000,20000,20000
20200316,057114,台虹群益98購01,0.97,0.97,0.69,0.69,-0.21,-23.33,95000,10,77350,0,0,0,0,0,0,20000,70000,-50000,-50000
20200316,057115,元油2X日盛9A購01,0.08,0.08,0.08,0.08,0.00,0.00,12000,2,960,0,0,0,0,0,0,0,12000,-12000,-12000
20200316,057116,鴻海日盛9A購01,0.96,0.98,0.80,0.80,-0.23,-22.33,108000,15,94880,0,0,0,0,0,0,45000,98000,-53000,-53000
20200316,057117,開發金日盛9B購01,,,,,0.00,0.00,0,0,0,0,0,0,0,0,0,0,0,0,0
20200316,057118,欣興日盛9A購01,0.66,0.66,0.66,0.66,+0.10,17.86,20000,1,13200,0,0,0,0,0,0,20000,0,20000,20000
20200316,057119,微星康和98購01,,,,,0.00,0.00,0,0,0,0,0,0,0,0,0,0,0,0,0
20200316,05711P,茂林國票97售03,1.80,1.88,1.78,1.78,-0.25,-12.32,21000,3,37680,0,0,0,0,0,0,10000,11000,-1000,-1000
20200316,057120,茂林康和98購01,0.35,0.35,0.21,0.21,-0.11,-34.38,124000,13,37360,0,0,0,0,0,0,92000,2000,90000,90000
20200316,057121,立積康和98購01,0.58,0.58,0.58,0.58,+0.08,16.0,68000,1,39440,0,0,0,0,0,0,68000,0,68000,68000
20200316,057122,元油2X凱基9B購05,,,,,0.00,0.00,0,0,0,0,0,0,0,0,0,0,0,0,0
20200316,057123,上銀凱基98購05,,,,,0.00,0.00,0,0,0,0,0,0,0,0,0,0,0,0,0
20200316,057124,為升凱基98購02,0.10,0.11,0.09,0.09,-0.03,-25.0,190000,21,19600,0,0,0,0,0,0,0,159000,-159000,-159000
20200316,057125,國巨凱基98購12,0.61,0.65,0.47,0.47,-0.15,-24.19,200000,7,119200,0,0,0,0,0,0,160000,40000,120000,120000
20200316,057126,台積電凱基99購03,0.87,0.87,0.87,0.87,+0.20,29.85,35000,3,30450,0,0,0,0,0,0,35000,0,35000,35000
20200316,057127,旺宏凱基98購09,,,,,0.00,0.00,0,0,0,0,0,0,0,0,0,0,0,0,0
20200316,057128,台光電凱基98購03,0.94,0.94,0.94,0.94,+0.41,77.36,6000,1,5640,0,0,0,0,0,0,6000,0,6000,6000
20200316,057129,聯發科凱基99購03,0.72,0.94,0.72,0.94,+0.34,56.67,81000,2,60520,0,0,0,0,0,0,71000,10000,61000,61000
20200316,05712P,友達統一97售03,1.69,1.69,1.69,1.69,-0.03,-1.74,5000,1,8450,0,0,0,0,0,0,0,5000,-5000,-5000
20200316,057130,全新凱基98購03,,,,,0.00,0.00,0,0,0,0,0,0,0,0,0,0,0,0,0
20200316,057131,奇力新凱基98購05,,,,,0.00,0.00,0,0,0,0,0,0,0,0,0,0,0,0,0
20200316,057132,華新科凱基98購05,,,,,0.00,0.00,0,0,0,0,0,0,0,0,0,0,0,0,0
20200316,057133,京鼎凱基98購02,0.25,0.25,0.25,0.25,+0.01,4.17,200000,1,50000,0,0,0,0,0,0,200000,0,200000,200000
20200316,057134,茂林凱基98購02,,,,,0.00,0.00,0,0,0,0,0,0,0,0,0,0,0,0,0
20200316,057135,立積凱基98購01,1.10,1.18,0.69,0.69,-0.29,-29.59,175000,17,185290,0,0,0,0,0,0,150000,25000,125000,125000
20200316,057136,立積凱基98購02,,,,,0.00,0.00,0,0,0,0,0,0,0,0,0,0,0,0,0
20200316,057137,鈺齊凱基98購01,0.19,0.19,0.19,0.19,+0.04,26.67,100000,1,19000,0,0,0,0,0,0,100000,0,100000,100000
20200316,057138,亞德客兆豐98購01,0.46,0.49,0.45,0.45,0.00,0.00,107000,3,50530,0,0,0,0,0,0,0,107000,-107000,-107000
20200316,057139,華新科兆豐98購02,0.13,0.13,0.11,0.11,+0.01,10.0,110000,3,13700,0,0,0,0,0,0,100000,0,100000,100000
20200316,05713P,大立光統一96售05,2.14,2.14,2.12,2.12,+0.32,17.78,6000,2,12760,0,0,0,0,0,0,6000,0,6000,6000
20200316,057140,宏達電兆豐98購01,,,,,0.00,0.00,0,0,0,0,0,0,0,0,0,0,0,0,0
20200316,057141,嘉聯益兆豐99購01,,,,,0.00,0.00,0,0,0,0,0,0,0,0,0,0,0,0,0
20200316,057142,力成兆豐98購01,,,,,0.00,0.00,0,0,0,0,0,0,0,0,0,0,0,0,0
20200316,057143,台郡兆豐98購01,0.44,0.48,0.38,0.38,-0.10,-20.83,1951000,41,854330,0,0,0,0,0,0,201000,1750000,-1549000,-1549000
20200316,057144,南電兆豐98購01,0.91,0.91,0.89,0.89,-0.24,-21.24,20000,2,18000,0,0,0,0,0,0,20000,0,20000,20000
20200316,057145,上銀國票98購03,0.47,0.47,0.26,0.26,-0.12,-31.58,35000,4,12100,0,0,0,0,0,0,10000,25000,-15000,-15000
20200316,057146,技嘉國票98購01,0.81,0.81,0.81,0.81,+0.13,19.12,6000,1,4860,0,0,0,0,0,0,0,6000,-6000,-6000
20200316,057147,新日興國票99購01,,,,,0.00,0.00,0,0,0,0,0,0,0,0,0,0,0,0,0
20200316,057148,玉晶光國票99購04,1.07,1.07,1.03,1.03,0.00,0.00,13000,3,13430,0,0,0,0,0,0,13000,13000,0,0
20200316,057149,京鼎國票99購02,0.30,0.30,0.30,0.30,-0.11,-26.83,10000,1,3000,0,0,0,0,0,0,10000,0,10000,10000
20200316,05714P,群創統一97售03,,,,,0.00,0.00,0,0,0,0,0,0,0,0,0,0,0,0,0
20200316,057150,貿聯國票99購02,,,,,0.00,0.00,0,0,0,0,0,0,0,0,0,0,0,0,0
20200316,057151,易華電國票99購01,0.69,0.69,0.62,0.62,-0.25,-28.74,15000,3,9780,0,0,0,0,0,0,0,15000,-15000,-15000
20200316,057152,緯穎國票99購03,,,,,0.00,0.00,0,0,0,0,0,0,0,0,0,0,0,0,0
20200316,057153,祥碩國泰99購01,0.85,0.85,0.78,0.81,0.00,0.00,21000,10,16900,0,0,0,0,0,0,21000,21000,0,0
20200316,057154,易華電國泰99購01,0.47,0.47,0.47,0.47,-0.02,-4.08,29000,1,13630,0,0,0,0,0,0,0,29000,-29000,-29000
20200316,057155,元油2X富邦9B購02,,,,,0.00,0.00,0,0,0,0,0,0,0,0,0,0,0,0,0
20200316,057156,元油2X富邦9C購01,0.11,0.16,0.11,0.15,+0.04,36.36,26000,3,3110,0,0,0,0,0,0,0,0,0,0
20200316,057157,群創富邦98購02,,,,,0.00,0.00,0,0,0,0,0,0,0,0,0,0,0,0,0
20200316,057158,義隆永豐99購01,0.44,0.44,0.42,0.42,+0.02,5.0,95000,4,40360,0,0,0,0,0,0,52000,43000,9000,9000
20200316,057159,晶技永豐98購01,1.53,1.71,1.48,1.55,+0.13,9.15,65000,5,101130,0,0,0,0,0,0,50000,15000,35000,35000
20200316,05715P,創意元富96售05,2.24,2.40,2.17,2.38,+0.22,10.19,303000,26,675210,0,0,0,0,0,0,103000,260000,-157000,-157000
20200316,057160,佐登永豐98購02,,,,,0.00,0.00,0,0,0,0,0,0,0,0,0,0,0,0,0
20200316,057161,亞德客元大98購02,0.70,0.83,0.70,0.83,+0.24,40.68,128000,3,91260,0,0,0,0,0,0,128000,0,128000,128000
20200316,057162,上銀元大98購03,0.68,0.68,0.52,0.52,-0.02,-3.7,20000,2,12000,0,0,0,0,0,0,20000,10000,10000,10000
20200316,057163,上銀元大98購04,0.40,0.40,0.40,0.40,+0.03,8.11,10000,1,4000,0,0,0,0,0,0,10000,0,10000,10000
20200316,057164,國巨元大98購14,,,,,0.00,0.00,0,0,0,0,0,0,0,0,0,0,0,0,0
20200316,057165,國巨元大99購05,1.46,1.47,1.08,1.08,-0.30,-21.74,141000,8,193660,0,0,0,0,0,0,111000,30000,81000,81000
20200316,057166,國巨元大99購06,0.83,0.83,0.68,0.69,-0.21,-23.33,10000,5,7620,0,0,0,0,0,0,0,10000,-10000,-10000
20200316,057167,台積電元大99購03,1.23,1.23,0.86,0.88,-0.44,-33.33,1821000,176,1951780,0,0,0,0,0,0,451000,1264000,-813000,-813000
20200316,057168,旺宏元大99購03,,,,,0.00,0.00,0,0,0,0,0,0,0,0,0,0,0,0,0
20200316,057169,微星元大98購01,1.05,1.05,1.05,1.05,+0.07,7.14,10000,1,10500,0,0,0,0,0,0,10000,0,10000,10000
20200316,05716P,T50反1元大98售03,,,,,0.00,0.00,0,0,0,0,0,0,0,0,0,0,0,0,0
20200316,057170,瑞昱元大98購01,0.71,0.72,0.54,0.54,-0.31,-36.47,82000,9,52840,0,0,0,0,0,0,12000,72000,-60000,-60000
20200316,057171,台光電元大9B購01,1.09,1.14,1.01,1.01,-0.12,-10.62,129000,10,138950,0,0,0,0,0,0,109000,48000,61000,61000
20200316,057172,南亞科元大98購03,,,,,0.00,0.00,0,0,0,0,0,0,0,0,0,0,0,0,0
20200316,057173,南亞科元大98購04,,,,,0.00,0.00,0,0,0,0,0,0,0,0,0,0,0,0,0
20200316,057174,南亞科元大98購05,,,,,0.00,0.00,0,0,0,0,0,0,0,0,0,0,0,0,0
20200316,057175,美律元大98購03,0.54,0.56,0.46,0.46,-0.04,-8.0,166000,13,86590,0,0,0,0,0,0,76000,91000,-15000,-15000
20200316,057176,全新元大99購02,0.72,0.72,0.52,0.52,-0.19,-26.76,100000,10,60300,0,0,0,0,0,0,20000,80000,-60000,-60000
20200316,057177,奇力新元大99購04,,,,,0.00,0.00,0,0,0,0,0,0,0,0,0,0,0,0,0
20200316,057178,可成元大98購03,0.74,0.77,0.67,0.67,-0.01,-1.47,90000,6,66900,0,0,0,0,0,0,70000,40000,30000,30000
20200316,057179,可成元大98購04,0.96,0.96,0.82,0.88,-0.01,-1.12,159000,11,147340,0,0,0,0,0,0,100000,79000,21000,21000
20200316,05717P,鴻海元大97售07,4.76,4.76,4.76,4.76,-0.19,-3.84,10000,1,47600,0,0,0,0,0,0,10000,10000,0,0
20200316,057180,華新科元大99購08,0.45,0.48,0.34,0.36,-0.01,-2.7,272000,15,109500,0,0,0,0,0,0,162000,110000,52000,52000
20200316,057181,亞光元大98購02,1.17,1.17,0.76,0.76,-0.09,-10.59,41000,5,40880,0,0,0,0,0,0,31000,21000,10000,10000
20200316,057182,禾伸堂元大99購02,0.64,0.65,0.50,0.50,-0.10,-16.67,83000,14,50080,0,0,0,0,0,0,36000,47000,-11000,-11000
20200316,057183,玉晶光元大99購07,0.51,0.51,0.45,0.45,-0.08,-15.09,71000,5,33050,0,0,0,0,0,0,41000,30000,11000,11000
20200316,057184,群創元大98購05,,,,,0.00,0.00,0,0,0,0,0,0,0,0,0,0,0,0,0
20200316,057185,群創元大98購06,,,,,0.00,0.00,0,0,0,0,0,0,0,0,0,0,0,0,0
20200316,057186,群創元大99購04,,,,,0.00,0.00,0,0,0,0,0,0,0,0,0,0,0,0,0
20200316,057187,群創元大9B購04,,,,,0.00,0.00,0,0,0,0,0,0,0,0,0,0,0,0,0
20200316,057188,佐登元大98購01,0.74,0.74,0.74,0.74,-0.11,-12.94,9000,1,6660,0,0,0,0,0,0,0,9000,-9000,-9000
20200316,057189,康控元大98購02,0.79,0.81,0.49,0.49,-0.31,-38.75,150000,15,93380,0,0,0,0,0,0,40000,110000,-70000,-70000
20200316,05718P,國巨元大96售09,2.31,2.85,2.21,2.85,+0.45,18.75,467000,54,1122950,0,0,0,0,0,0,122000,438000,-316000,-316000
20200316,057190,立積元大9A購02,0.97,0.98,0.79,0.79,-0.17,-17.71,62000,8,57820,0,0,0,0,0,0,42000,30000,12000,12000
20200316,057191,祥碩元大98購05,1.31,1.31,0.98,0.98,-0.26,-20.97,196000,27,222590,0,0,0,0,0,0,196000,86000,110000,110000
20200316,057192,力成元大98購01,0.18,0.18,0.15,0.15,0.00,0.00,55000,6,8800,0,0,0,0,0,0,5000,50000,-45000,-45000
20200316,057193,力成元大98購02,0.21,0.21,0.18,0.18,-0.10,-35.71,25000,2,4950,0,0,0,0,0,0,25000,0,25000,25000
20200316,057194,南電元大98購01,3.16,3.16,2.37,2.37,-0.51,-17.71,118000,12,332110,0,0,0,0,0,0,53000,65000,-12000,-12000
20200316,057195,南茂元大98購01,1.23,1.23,0.93,0.93,-0.23,-19.83,92000,8,105210,0,0,0,0,0,0,77000,52000,25000,25000
20200316,057196,茂林台新98購01,,,,,0.00,0.00,0,0,0,0,0,0,0,0,0,0,0,0,0
20200316,057197,立積台新98購01,0.67,0.67,0.39,0.40,-0.16,-28.57,153000,15,86370,0,0,0,0,0,0,123000,30000,93000,93000
20200316,057198,智伸科統一9B購01,0.26,0.26,0.20,0.21,-0.05,-19.23,230000,12,52300,0,0,0,0,0,0,100000,130000,-30000,-30000
20200316,057199,台達電元富02購01,0.59,0.60,0.51,0.54,-0.05,-8.47,246000,20,140490,0,0,0,0,0,0,190000,56000,134000,134000
20200316,05719P,可成元大96售03,5.90,6.30,5.70,5.95,-1.45,-19.59,39000,7,233150,0,0,0,0,0,0,10000,29000,-19000,-19000
20200316,057200,技嘉元富98購01,1.17,1.25,1.13,1.15,-0.02,-1.71,139000,10,167080,0,0,0,0,0,0,80000,59000,21000,21000
20200316,057201,華擎元富98購01,0.90,1.10,0.86,0.86,+0.02,2.38,178000,23,165580,0,0,0,0,0,0,115000,63000,52000,52000
20200316,057202,TPK元富98購02,0.45,0.45,0.30,0.32,-0.11,-25.58,33000,4,13240,0,0,0,0,0,0,20000,13000,7000,7000
20200316,057203,麗豐元富98購02,0.59,0.62,0.57,0.57,+0.01,1.79,319000,17,191890,0,0,0,0,0,0,232000,87000,145000,145000
20200316,057204,利勤元富98購01,0.45,0.45,0.39,0.39,-0.04,-9.3,35000,7,14220,0,0,0,0,0,0,15000,20000,-5000,-5000
20200316,057205,元翎元富98購01,0.78,0.78,0.66,0.66,-0.05,-7.04,160000,8,112400,0,0,0,0,0,0,30000,130000,-100000,-100000
20200316,057206,立積元富98購01,1.52,1.57,0.98,0.98,-0.29,-22.83,65000,7,84950,0,0,0,0,0,0,0,65000,-65000,-65000
20200316,057207,立積元富98購02,2.01,2.01,2.01,2.01,+0.49,32.24,10000,1,20100,0,0,0,0,0,0,0,10000,-10000,-10000
20200316,057208,上海銀元富98購01,0.40,0.40,0.31,0.31,-0.03,-8.82,700000,8,248000,0,0,0,0,0,0,300000,400000,-100000,-100000
20200316,057209,元油2X第一98購01,0.04,0.04,0.04,0.04,0.00,0.00,340000,5,13600,0,0,0,0,0,0,0,0,0,0
20200316,05720P,可成中信98售01,1.99,2.26,1.99,2.26,-0.31,-12.06,59000,7,126020,0,0,0,0,0,0,36000,23000,13000,13000
20200316,057210,T50反1群益98購01,1.48,1.66,1.45,1.66,+0.15,9.93,1379000,19,2118840,0,0,0,0,0,0,6000,1373000,-1367000,-1367000
20200316,057211,鴻海群益98購05,,,,,0.00,0.00,0,0,0,0,0,0,0,0,0,0,0,0,0
20200316,057212,台積電群益98購03,0.28,0.28,0.20,0.20,0.00,0.00,90000,8,22600,0,0,0,0,0,0,0,50000,-50000,-50000
20200316,057213,華邦電群益98購01,0.29,0.29,0.15,0.15,-0.06,-28.57,170000,5,34000,0,0,0,0,0,0,50000,120000,-70000,-70000
20200316,057214,瑞昱群益98購01,0.21,0.21,0.21,0.21,-0.06,-22.22,20000,1,4200,0,0,0,0,0,0,0,20000,-20000,-20000
20200316,057215,友達群益98購03,0.06,0.06,0.05,0.05,+0.01,25.0,380000,4,22000,0,0,0,0,0,0,200000,180000,20000,20000
20200316,057216,聯發科群益99購01,0.54,0.54,0.50,0.50,-0.10,-16.67,14000,2,7400,0,0,0,0,0,0,0,14000,-14000,-14000
20200316,057217,奇力新群益99購01,,,,,0.00,0.00,0,0,0,0,0,0,0,0,0,0,0,0,0
20200316,057218,可成群益99購03,,,,,0.00,0.00,0,0,0,0,0,0,0,0,0,0,0,0,0
20200316,057219,群創群益98購10,,,,,0.00,0.00,0,0,0,0,0,0,0,0,0,0,0,0,0
20200316,05721P,全新群益98售02,1.81,2.08,1.81,2.08,+0.19,10.05,30000,2,57000,0,0,0,0,0,0,20000,10000,10000,10000
20200316,057220,鈺齊群益98購01,0.16,0.16,0.16,0.16,-0.02,-11.11,100000,1,16000,0,0,0,0,0,0,0,100000,-100000,-100000
20200316,057221,華通國票98購03,,,,,0.00,0.00,0,0,0,0,0,0,0,0,0,0,0,0,0
20200316,057222,鴻海國票99購04,0.01,0.95,0.01,0.75,-0.29,-27.88,22000,8,16260,0,0,0,0,0,0,20000,22000,-2000,-2000
20200316,057223,富邦金日盛99購01,0.34,0.35,0.22,0.22,-0.07,-24.14,218000,6,54320,0,0,0,0,0,0,103000,0,103000,103000
20200316,057224,和碩日盛9A購01,0.90,1.00,0.85,0.85,+0.03,3.66,102000,12,93620,0,0,0,0,0,0,70000,22000,48000,48000
20200316,057225,華新凱基98購01,,,,,0.00,0.00,0,0,0,0,0,0,0,0,0,0,0,0,0
20200316,057226,上銀凱基98購06,0.34,0.35,0.29,0.29,-0.08,-21.62,76000,6,25100,0,0,0,0,0,0,76000,20000,56000,56000
20200316,057227,台積電凱基98購15,0.39,0.39,0.35,0.35,-0.05,-12.5,58000,4,21420,0,0,0,0,0,0,28000,30000,-2000,-2000
20200316,057228,友達凱基9B購01,0.42,0.42,0.34,0.34,0.00,0.00,250000,2,101000,0,0,0,0,0,0,0,250000,-250000,-250000
20200316,057229,友達凱基9B購02,,,,,0.00,0.00,0,0,0,0,0,0,0,0,0,0,0,0,0
20200316,05722P,玉晶光國票97售03,2.17,2.78,2.17,2.78,+0.33,13.47,103000,24,267340,0,0,0,0,0,0,79000,16000,63000,63000
20200316,057230,建準凱基98購02,0.72,0.72,0.72,0.72,0.00,0.00,20000,1,14400,0,0,0,0,0,0,0,20000,-20000,-20000
20200316,057231,美律凱基98購05,0.63,0.66,0.54,0.54,-0.06,-10.0,256000,21,159600,0,0,0,0,0,0,175000,96000,79000,79000
20200316,057232,京元電凱基98購02,1.09,1.20,0.84,0.84,+0.42,100.0,124000,21,137490,0,0,0,0,0,0,0,124000,-124000,-124000
20200316,057233,聯發科凱基98購14,0.49,0.52,0.40,0.40,-0.27,-40.3,56000,5,28100,0,0,0,0,0,0,46000,10000,36000,36000
20200316,057234,宏達電凱基98購05,1.44,1.44,0.93,0.93,+0.12,14.81,397000,6,449090,0,0,0,0,0,0,97000,397000,-300000,-300000
20200316,057235,亞光凱基98購04,,,,,0.00,0.00,0,0,0,0,0,0,0,0,0,0,0,0,0
20200316,057236,聯詠凱基98購03,0.55,0.55,0.45,0.45,-0.02,-4.26,26000,2,12300,0,0,0,0,0,0,0,26000,-26000,-26000
20200316,057237,群創凱基9B購02,,,,,0.00,0.00,0,0,0,0,0,0,0,0,0,0,0,0,0
20200316,057238,群創凱基9B購03,,,,,0.00,0.00,0,0,0,0,0,0,0,0,0,0,0,0,0
20200316,057239,貿聯凱基98購05,0.74,0.74,0.74,0.74,+0.07,10.45,20000,1,14800,0,0,0,0,0,0,20000,0,20000,20000
20200316,05723P,華通永豐96售03,3.48,3.91,3.47,3.91,+0.16,4.27,108000,9,389300,0,0,0,0,0,0,58000,70000,-12000,-12000
20200316,057240,茂林凱基9A購01,0.34,0.34,0.27,0.27,-0.17,-38.64,364000,15,121370,0,0,0,0,0,0,314000,49000,265000,265000
20200316,057241,超眾凱基99購02,1.26,1.43,1.01,1.01,-0.21,-17.21,138000,11,152510,0,0,0,0,0,0,38000,100000,-62000,-62000
20200316,057242,台郡凱基98購05,1.31,1.39,1.16,1.16,-0.15,-11.45,434000,13,570980,0,0,0,0,0,0,201000,233000,-32000,-32000
20200316,057243,樺漢凱基99購01,,,,,0.00,0.00,0,0,0,0,0,0,0,0,0,0,0,0,0
20200316,057244,鈺齊凱基99購01,,,,,0.00,0.00,0,0,0,0,0,0,0,0,0,0,0,0,0
20200316,057245,福懋科台新98購01,0.60,0.60,0.60,0.60,0.00,0.00,2000,1,1200,0,0,0,0,0,0,2000,0,2000,2000
20200316,057246,元油2X統一99購01,,,,,0.00,0.00,0,0,0,0,0,0,0,0,0,0,0,0,0
20200316,057247,元油2X統一9A購01,,,,,0.00,0.00,0,0,0,0,0,0,0,0,0,0,0,0,0
20200316,057248,台積電統一98購08,,,,,0.00,0.00,0,0,0,0,0,0,0,0,0,0,0,0,0
20200316,057249,華邦電統一9A購01,0.52,0.52,0.52,0.52,-0.07,-11.86,3000,1,1560,0,0,0,0,0,0,0,3000,-3000,-3000
20200316,05724P,致茂永豐96售01,1.13,1.46,1.12,1.46,+0.10,7.35,226000,22,295650,0,0,0,0,0,0,105000,121000,-16000,-16000
20200316,057250,大立光統一98購08,,,,,0.00,0.00,0,0,0,0,0,0,0,0,0,0,0,0,0
20200316,057251,泰鼎統一98購02,1.32,1.32,1.32,1.32,+0.08,6.45,15000,1,19800,0,0,0,0,0,0,0,15000,-15000,-15000
20200316,057252,牧德元富98購01,0.42,0.42,0.42,0.42,0.00,0.00,55000,1,23100,0,0,0,0,0,0,0,55000,-55000,-55000
20200316,057253,高股息中信99購02,0.30,0.35,0.25,0.25,-0.10,-28.57,170000,7,52000,0,0,0,0,0,0,0,150000,-150000,-150000
20200316,057254,友達麥證98購01,,,,,0.00,0.00,0,0,0,0,0,0,0,0,0,0,0,0,0
20200316,057255,聯發科麥證98購02,0.51,0.51,0.43,0.43,+0.01,2.38,20000,2,9400,10000,10000,0,0,0,0,20000,10000,10000,10000
20200316,057256,元油2X兆豐98購01,0.03,0.04,0.03,0.04,+0.02,100.0,68000,5,2520,0,0,0,0,0,0,0,0,0,0
20200316,057257,台泥兆豐99購01,0.78,0.78,0.67,0.67,-0.15,-18.29,121000,5,89640,0,0,0,0,0,0,118000,3000,115000,115000
20200316,057258,中環兆豐98購01,0.35,0.41,0.35,0.36,+0.07,24.14,412000,10,158910,0,0,0,0,0,0,59000,353000,-294000,-294000
20200316,057259,台積電兆豐98購03,0.33,0.33,0.22,0.22,-0.11,-33.33,390000,38,96820,0,0,0,0,0,0,177000,100000,77000,77000
20200316,05725P,嘉聯益永豐96售02,,,,,0.00,0.00,0,0,0,0,0,0,0,0,0,0,0,0,0
20200316,057260,微星兆豐98購01,0.54,0.57,0.54,0.57,-0.06,-9.52,63000,2,35550,0,0,0,0,0,0,63000,0,63000,63000
20200316,057261,瑞昱兆豐98購01,0.20,0.20,0.11,0.11,-0.08,-42.11,55000,5,9450,0,0,0,0,0,0,0,55000,-55000,-55000
20200316,057262,友達兆豐98購03,0.03,0.03,0.03,0.03,0.00,0.00,46000,1,1380,0,0,0,0,0,0,0,0,0,0
20200316,057263,可成兆豐99購01,0.30,0.30,0.25,0.25,+0.03,13.64,670000,16,189600,0,0,0,0,0,0,505000,160000,345000,345000
20200316,057264,新光金兆豐98購01,0.14,0.14,0.12,0.12,-0.02,-14.29,50000,3,6600,0,0,0,0,0,0,0,50000,-50000,-50000
20200316,057265,聯詠兆豐98購01,0.45,0.47,0.34,0.35,-0.04,-10.26,1030000,21,417220,0,0,0,0,0,0,211000,819000,-608000,-608000
20200316,057266,TPK兆豐98購02,0.46,0.46,0.33,0.33,-0.11,-25.0,50000,6,22050,0,0,0,0,0,0,30000,20000,10000,10000
20200316,057267,康控兆豐99購01,0.38,0.38,0.35,0.35,0.00,0.00,26000,4,9500,0,0,0,0,0,0,6000,0,6000,6000
20200316,057268,臻鼎兆豐99購01,0.25,0.36,0.21,0.36,+0.12,50.0,1035000,21,239400,0,0,0,0,0,0,853000,0,853000,853000
20200316,057269,鈺齊兆豐98購01,,,,,0.00,0.00,0,0,0,0,0,0,0,0,0,0,0,0,0
20200316,05726P,易華電永豐96售02,,,,,0.00,0.00,0,0,0,0,0,0,0,0,0,0,0,0,0
20200316,057270,遠東新元大98購01,0.71,0.71,0.58,0.60,-0.17,-22.08,500000,49,325000,0,0,0,0,0,0,30000,470000,-440000,-440000
20200316,057271,國巨元大98購17,0.68,0.68,0.49,0.49,0.00,0.00,45000,6,26750,0,0,0,0,0,0,0,45000,-45000,-45000
20200316,057272,台積電元大98購14,1.49,1.49,0.99,1.01,-0.57,-36.08,2310000,194,2797600,0,0,0,0,0,0,1142000,1247000,-105000,-105000
20200316,057273,智邦元大98購05,2.35,2.60,2.32,2.32,+0.10,4.5,225000,11,524680,0,0,0,0,0,0,225000,10000,215000,215000
20200316,057274,友達元大98購03,0.14,0.14,0.10,0.10,0.00,0.00,600000,7,67300,0,0,0,0,0,0,560000,40000,520000,520000
20200316,057275,友達元大9A購04,,,,,0.00,0.00,0,0,0,0,0,0,0,0,0,0,0,0,0
20200316,057276,全新元大99購03,0.52,0.52,0.40,0.40,-0.05,-11.11,67000,8,32440,0,0,0,0,0,0,47000,37000,10000,10000
20200316,057277,可成元大98購05,0.80,0.80,0.72,0.72,+0.04,5.88,30000,3,23200,0,0,0,0,0,0,30000,20000,10000,10000
20200316,057278,可成元大98購06,0.76,0.78,0.71,0.71,+0.01,1.43,102000,6,77240,0,0,0,0,0,0,80000,32000,48000,48000
20200316,057279,國揚元大98購01,1.08,1.08,0.83,0.83,-0.07,-7.78,50000,5,45600,0,0,0,0,0,0,0,50000,-50000,-50000
20200316,05727P,新光金日盛96售02,1.76,1.98,1.76,1.98,+0.09,4.76,190000,5,357580,0,0,0,0,0,0,63000,127000,-64000,-64000
20200316,057280,大立光元大98購15,,,,,0.00,0.00,0,0,0,0,0,0,0,0,0,0,0,0,0
20200316,057281,大立光元大98購16,1.26,1.26,0.91,0.92,-0.29,-23.97,40000,4,40100,0,0,0,0,0,0,30000,30000,0,0
20200316,057282,大立光元大99購06,0.91,0.92,0.69,0.69,-0.21,-23.33,44000,5,36600,0,0,0,0,0,0,32000,22000,10000,10000
20200316,057283,欣興元大98購07,0.94,1.01,0.66,0.66,-0.28,-29.79,140000,14,118690,0,0,0,0,0,0,62000,100000,-38000,-38000
20200316,057284,新日興元大98購03,,,,,0.00,0.00,0,0,0,0,0,0,0,0,0,0,0,0,0
20200316,057285,群創元大98購07,,,,,0.00,0.00,0,0,0,0,0,0,0,0,0,0,0,0,0
20200316,057286,群創元大9B購05,,,,,0.00,0.00,0,0,0,0,0,0,0,0,0,0,0,0,0
20200316,057287,彩晶元大9C購03,0.58,0.58,0.57,0.58,+0.14,31.82,10000,3,5770,0,0,0,0,0,0,10000,0,10000,10000
20200316,057288,聯茂元大98購03,2.86,3.01,2.75,2.82,+0.34,13.71,32000,4,91840,0,0,0,0,0,0,12000,20000,-8000,-8000
20200316,057289,力成元大98購03,,,,,0.00,0.00,0,0,0,0,0,0,0,0,0,0,0,0,0
20200316,05728P,滬深2X凱基98售03,2.21,2.48,2.21,2.48,-0.31,-11.11,173000,3,406710,0,0,0,0,0,0,93000,80000,13000,13000
20200316,057290,元油2X國泰99購02,,,,,0.00,0.00,0,0,0,0,0,0,0,0,0,0,0,0,0
20200316,057291,國巨國泰9A購01,0.50,0.50,0.38,0.38,0.00,0.00,250000,3,96000,0,0,0,0,0,0,225000,0,225000,225000
20200316,057292,國巨國泰9B購01,0.38,0.38,0.38,0.38,0.00,0.00,14000,2,5320,0,0,0,0,0,0,0,0,0,0
20200316,057293,力成國泰99購01,,,,,0.00,0.00,0,0,0,0,0,0,0,0,0,0,0,0,0
20200316,057294,台灣50永豐99購01,,,,,0.00,0.00,0,0,0,0,0,0,0,0,0,0,0,0,0
20200316,057295,可成永豐98購02,,,,,0.00,0.00,0,0,0,0,0,0,0,0,0,0,0,0,0
20200316,057296,智原永豐98購01,0.31,0.31,0.20,0.20,0.00,0.00,33000,4,9400,0,0,0,0,0,0,0,33000,-33000,-33000
20200316,057297,新日興永豐98購01,,,,,0.00,0.00,0,0,0,0,0,0,0,0,0,0,0,0,0
20200316,057298,旭富永豐98購01,0.58,0.61,0.52,0.52,-0.01,-1.89,132000,10,76670,0,0,0,0,0,0,90000,37000,53000,53000
20200316,057299,立積永豐98購02,0.43,0.43,0.43,0.43,+0.07,19.44,10000,1,4300,0,0,0,0,0,0,0,10000,-10000,-10000
20200316,05729P,臺股指凱基97售02,5.90,6.60,5.90,6.40,+0.60,10.34,25000,4,156000,0,0,0,0,0,0,10000,9000,1000,1000
20200316,057300,訊連永豐98購01,0.56,0.58,0.45,0.45,-0.10,-18.18,149000,26,81490,0,0,0,0,0,0,73000,66000,7000,7000
20200316,057301,嘉聯益永豐98購02,,,,,0.00,0.00,0,0,0,0,0,0,0,0,0,0,0,0,0
20200316,057302,福懋科中信98購01,0.30,0.30,0.26,0.26,-0.03,-10.34,110000,2,29000,0,0,0,0,0,0,0,110000,-110000,-110000
20200316,057303,喬山兆豐99購01,0.38,0.38,0.27,0.27,-0.11,-28.95,364000,11,116010,0,0,0,0,0,0,130000,234000,-104000,-104000
20200316,057304,為升兆豐99購02,,,,,0.00,0.00,0,0,0,0,0,0,0,0,0,0,0,0,0
20200316,057305,南亞科兆豐98購02,0.19,0.20,0.14,0.14,-0.07,-33.33,1272000,14,206660,0,0,0,0,0,0,202000,1070000,-868000,-868000
20200316,057306,玉晶光兆豐99購01,0.48,0.48,0.44,0.44,0.00,0.00,25000,2,11680,0,0,0,0,0,0,0,25000,-25000,-25000
20200316,057307,瀚宇博兆豐99購01,0.55,0.55,0.41,0.43,-0.10,-18.87,804000,26,395260,0,0,0,0,0,0,370000,434000,-64000,-64000
20200316,057308,同欣電兆豐99購01,0.28,0.28,0.28,0.28,-0.02,-6.67,55000,2,15400,0,0,0,0,0,0,55000,0,55000,55000
20200316,057309,南茂兆豐99購01,0.60,0.62,0.47,0.47,-0.06,-11.32,298000,11,170490,0,0,0,0,0,0,185000,93000,92000,92000
20200316,05730P,臺股指凱基97售03,,,,,0.00,0.00,0,0,0,0,0,0,0,0,0,0,0,0,0
20200316,057310,聯發科日盛99購01,,,,,0.00,0.00,0,0,0,0,0,0,0,0,0,0,0,0,0
20200316,057311,玉晶光日盛9A購01,0.85,0.87,0.67,0.67,-0.16,-19.28,63000,11,49560,0,0,0,0,0,0,23000,40000,-17000,-17000
20200316,057312,美律麥證98購01,0.52,0.58,0.49,0.49,+0.02,4.26,50000,6,27200,40000,10000,30000,0,0,0,40000,10000,30000,30000
20200316,057313,聯發科麥證99購01,0.84,0.89,0.76,0.76,-0.32,-29.63,40000,4,33600,0,40000,-40000,0,0,0,0,40000,-40000,-40000
20200316,057314,全新麥證98購01,,,,,0.00,0.00,0,0,0,0,0,0,0,0,0,0,0,0,0
20200316,057315,台灣50康和9A購03,0.16,0.16,0.13,0.13,-0.13,-50.0,100000,3,13350,0,0,0,0,0,0,85000,0,85000,85000
20200316,057316,國巨凱基99購04,,,,,0.00,0.00,0,0,0,0,0,0,0,0,0,0,0,0,0
20200316,057317,技嘉凱基98購02,0.28,0.28,0.26,0.26,+0.04,18.18,140000,4,37700,0,0,0,0,0,0,125000,15000,110000,110000
20200316,057318,台光電凱基9A購01,0.61,0.61,0.61,0.61,+0.11,22.0,33000,1,20130,0,0,0,0,0,0,33000,0,33000,33000
20200316,057319,奇力新凱基99購02,,,,,0.00,0.00,0,0,0,0,0,0,0,0,0,0,0,0,0
20200316,05731P,創意統一96售03,2.28,2.55,2.28,2.55,-0.01,-0.39,11000,2,25890,0,0,0,0,0,0,11000,0,11000,11000
20200316,057320,玉晶光凱基98購01,,,,,0.00,0.00,0,0,0,0,0,0,0,0,0,0,0,0,0
20200316,057321,台泥群益98購01,1.85,1.85,1.59,1.59,+0.06,3.92,30000,2,50300,0,0,0,0,0,0,20000,10000,10000,10000
20200316,057322,旺宏群益98購04,,,,,0.00,0.00,0,0,0,0,0,0,0,0,0,0,0,0,0
20200316,057323,智邦群益98購01,,,,,0.00,0.00,0,0,0,0,0,0,0,0,0,0,0,0,0
20200316,057324,億光群益98購01,,,,,0.00,0.00,0,0,0,0,0,0,0,0,0,0,0,0,0
20200316,057325,可成群益9A購01,,,,,0.00,0.00,0,0,0,0,0,0,0,0,0,0,0,0,0
20200316,057326,景碩群益99購02,,,,,0.00,0.00,0,0,0,0,0,0,0,0,0,0,0,0,0
20200316,057327,玉晶光群益9A購04,0.51,0.51,0.51,0.51,0.00,0.00,3000,1,1530,0,0,0,0,0,0,3000,0,3000,3000
20200316,057328,京鼎群益99購02,,,,,0.00,0.00,0,0,0,0,0,0,0,0,0,0,0,0,0
20200316,057329,緯穎群益98購02,1.68,1.68,1.68,1.68,+1.09,184.75,10000,1,16800,0,0,0,0,0,0,10000,0,10000,10000
20200316,05732P,臺股指統一96售02,,,,,0.00,0.00,0,0,0,0,0,0,0,0,0,0,0,0,0
20200316,057330,台積電國票99購03,0.52,0.52,0.36,0.36,-0.26,-41.94,45000,9,19450,0,0,0,0,0,0,0,45000,-45000,-45000
20200316,057331,台積電國票99購04,0.49,0.50,0.32,0.34,-0.34,-50.0,221000,44,99760,0,0,0,0,0,0,60000,56000,4000,4000
20200316,057332,旺宏國票99購03,,,,,0.00,0.00,0,0,0,0,0,0,0,0,0,0,0,0,0
20200316,057333,智邦國票99購01,1.39,1.39,1.13,1.13,+0.06,5.61,30000,2,39100,0,0,0,0,0,0,20000,10000,10000,10000
20200316,057334,技嘉國票98購02,,,,,0.00,0.00,0,0,0,0,0,0,0,0,0,0,0,0,0
20200316,057335,技嘉國票99購01,0.54,0.54,0.47,0.47,0.00,0.00,30000,3,15200,0,0,0,0,0,0,0,30000,-30000,-30000
20200316,057336,聯發科國票99購01,0.75,0.75,0.75,0.75,-0.36,-32.43,5000,1,3750,0,0,0,0,0,0,5000,0,5000,5000
20200316,057337,聯發科國票99購02,0.92,1.00,0.75,0.86,-0.31,-26.5,182000,14,156020,0,0,0,0,0,0,60000,122000,-62000,-62000
20200316,057338,群創國票99購01,,,,,0.00,0.00,0,0,0,0,0,0,0,0,0,0,0,0,0
20200316,057339,群創國票99購02,,,,,0.00,0.00,0,0,0,0,0,0,0,0,0,0,0,0,0
20200316,05733P,臺股指統一96售03,6.90,8.10,6.90,8.10,0.00,0.00,15000,4,107400,0,0,0,0,0,0,15000,0,15000,15000
20200316,057340,玉晶光元富98購04,1.78,1.91,1.60,1.70,-0.02,-1.16,118000,28,214200,0,0,0,0,0,0,98000,20000,78000,78000
20200316,057341,技嘉台新98購01,0.47,0.47,0.47,0.47,-0.03,-6.0,96000,1,45120,0,0,0,0,0,0,96000,0,96000,96000
20200316,057342,玉晶光台新98購01,0.39,0.39,0.29,0.29,-0.18,-38.3,230000,3,79100,0,0,0,0,0,0,130000,100000,30000,30000
20200316,057343,道瓊反統一9A購01,4.25,4.25,4.25,4.25,+0.04,0.95,4000,1,17000,0,0,0,0,0,0,4000,0,4000,4000
20200316,057344,元油2X統一98購03,,,,,0.00,0.00,0,0,0,0,0,0,0,0,0,0,0,0,0
20200316,057345,中50統一98購01,,,,,0.00,0.00,0,0,0,0,0,0,0,0,0,0,0,0,0
20200316,057346,鴻海統一98購13,,,,,0.00,0.00,0,0,0,0,0,0,0,0,0,0,0,0,0
20200316,057347,國巨統一9A購03,0.52,0.52,0.52,0.52,0.00,0.00,10000,1,5200,0,0,0,0,0,0,0,10000,-10000,-10000
20200316,057348,台積電統一98購09,0.15,0.15,0.15,0.15,-0.03,-16.67,10000,1,1500,0,0,0,0,0,0,0,0,0,0
20200316,057349,聯發科統一98購04,0.80,0.80,0.80,0.80,-0.10,-11.11,5000,1,4000,0,0,0,0,0,0,0,5000,-5000,-5000
20200316,05734P,臺股指統一96售04,,,,,0.00,0.00,0,0,0,0,0,0,0,0,0,0,0,0,0
20200316,057350,全新統一98購03,,,,,0.00,0.00,0,0,0,0,0,0,0,0,0,0,0,0,0
20200316,057351,奇力新統一98購02,,,,,0.00,0.00,0,0,0,0,0,0,0,0,0,0,0,0,0
20200316,057352,大立光統一9A購02,,,,,0.00,0.00,0,0,0,0,0,0,0,0,0,0,0,0,0
20200316,057353,玉晶光統一99購01,,,,,0.00,0.00,0,0,0,0,0,0,0,0,0,0,0,0,0
20200316,057354,聯鈞統一99購03,,,,,0.00,0.00,0,0,0,0,0,0,0,0,0,0,0,0,0
20200316,057355,彩晶統一98購03,,,,,0.00,0.00,0,0,0,0,0,0,0,0,0,0,0,0,0
20200316,057356,彩晶統一98購04,,,,,0.00,0.00,0,0,0,0,0,0,0,0,0,0,0,0,0
20200316,057357,超眾統一98購01,,,,,0.00,0.00,0,0,0,0,0,0,0,0,0,0,0,0,0
20200316,057358,元油2X元大98購08,,,,,0.00,0.00,0,0,0,0,0,0,0,0,0,0,0,0,0
20200316,057359,元油2X元大98購09,,,,,0.00,0.00,0,0,0,0,0,0,0,0,0,0,0,0,0
20200316,05735P,臺股指統一96售05,,,,,0.00,0.00,0,0,0,0,0,0,0,0,0,0,0,0,0
20200316,057360,元油2X元大98購10,,,,,0.00,0.00,0,0,0,0,0,0,0,0,0,0,0,0,0
20200316,057361,元油2X元大98購11,,,,,0.00,0.00,0,0,0,0,0,0,0,0,0,0,0,0,0
20200316,057362,元油2X元大98購12,0.03,0.03,0.03,0.03,0.00,0.00,750000,13,22500,0,0,0,0,0,0,0,0,0,0
20200316,057363,華通元大99購02,1.57,1.57,1.07,1.07,-0.37,-25.69,62000,6,84940,0,0,0,0,0,0,52000,42000,10000,10000
20200316,057364,國巨元大98購18,1.29,1.29,1.29,1.29,+0.19,17.27,10000,1,12900,0,0,0,0,0,0,10000,0,10000,10000
20200316,057365,智邦元大98購07,2.03,2.03,1.78,1.89,+0.04,2.16,269000,21,487230,0,0,0,0,0,0,228000,69000,159000,159000
20200316,057366,智邦元大98購08,1.13,1.28,1.00,1.05,-0.12,-10.26,203000,39,229170,0,0,0,0,0,0,101000,145000,-44000,-44000
20200316,057367,技嘉元大98購02,1.02,1.02,0.83,0.83,-0.01,-1.19,15000,2,14350,0,0,0,0,0,0,0,15000,-15000,-15000
20200316,057368,微星元大98購02,1.04,1.04,1.04,1.04,+0.21,25.3,20000,1,20800,0,0,0,0,0,0,20000,0,20000,20000
20200316,057369,奇力新元大99購05,0.58,0.58,0.58,0.58,0.00,0.00,10000,1,5800,0,0,0,0,0,0,0,10000,-10000,-10000
20200316,05736P,臺股指統一96售06,,,,,0.00,0.00,0,0,0,0,0,0,0,0,0,0,0,0,0
20200316,057370,可成元大98購07,0.51,0.55,0.50,0.50,+0.09,21.95,40000,4,20600,0,0,0,0,0,0,10000,30000,-20000,-20000
20200316,057371,可成元大98購08,0.79,0.79,0.72,0.72,-0.01,-1.37,60000,4,46600,0,0,0,0,0,0,50000,30000,20000,20000
20200316,057372,華新科元大99購10,0.38,0.39,0.28,0.28,-0.06,-17.65,160000,12,54350,0,0,0,0,0,0,70000,90000,-20000,-20000
20200316,057373,大立光元大98購17,1.30,1.30,0.85,0.89,-0.11,-11.0,68000,6,74260,0,0,0,0,0,0,34000,34000,0,0
20200316,057374,禾伸堂元大99購03,1.11,1.15,1.06,1.06,-0.02,-1.85,75000,7,82250,0,0,0,0,0,0,60000,55000,5000,5000
20200316,057375,欣興元大98購09,1.11,1.11,1.03,1.03,-0.06,-5.5,10000,6,10740,0,0,0,0,0,0,10000,10000,0,0
20200316,057376,新日興元大98購04,0.82,0.82,0.52,0.52,-0.18,-25.71,20000,2,13400,0,0,0,0,0,0,0,20000,-20000,-20000
20200316,057377,康控元大99購02,0.77,0.81,0.56,0.56,-0.17,-23.29,100000,11,67270,0,0,0,0,0,0,17000,100000,-83000,-83000
20200316,057378,康友元大98購02,1.11,1.11,1.04,1.04,-0.07,-6.31,9000,2,9430,0,0,0,0,0,0,9000,0,9000,9000
20200316,057379,寶成元大98購02,0.76,0.79,0.69,0.69,-0.20,-22.47,64000,6,47860,0,0,0,0,0,0,30000,34000,-4000,-4000
20200316,05737P,臺股指統一96售07,,,,,0.00,0.00,0,0,0,0,0,0,0,0,0,0,0,0,0
20200316,057380,技嘉國泰9A購01,0.53,0.53,0.46,0.46,-0.05,-9.8,505000,4,254650,0,0,0,0,0,0,205000,300000,-95000,-95000
20200316,057381,微星國泰9A購01,0.69,0.69,0.59,0.59,-0.16,-21.33,666000,30,417610,0,0,0,0,0,0,466000,264000,202000,202000
20200316,057382,聯發科國泰9A購01,0.53,0.53,0.41,0.41,-0.26,-38.81,270000,18,137200,0,0,0,0,0,0,20000,170000,-150000,-150000
20200316,057383,玉晶光富邦9A購01,,,,,0.00,0.00,0,0,0,0,0,0,0,0,0,0,0,0,0
20200316,057384,台灣50永豐99購02,0.12,0.12,0.12,0.12,-0.02,-14.29,10000,1,1200,0,0,0,0,0,0,0,0,0,0
20200316,057385,光罩永豐99購01,0.48,0.48,0.42,0.42,+0.06,16.67,16000,2,7560,0,0,0,0,0,0,16000,0,16000,16000
20200316,057386,聯發科永豐98購04,,,,,0.00,0.00,0,0,0,0,0,0,0,0,0,0,0,0,0
20200316,057387,奇力新永豐98購03,,,,,0.00,0.00,0,0,0,0,0,0,0,0,0,0,0,0,0
20200316,057388,奇鋐永豐98購02,0.42,0.42,0.42,0.42,+0.02,5.0,10000,1,4200,0,0,0,0,0,0,10000,0,10000,10000
20200316,057389,玉晶光永豐98購06,0.26,0.26,0.16,0.16,-0.12,-42.86,121000,9,25070,0,0,0,0,0,0,30000,91000,-61000,-61000
20200316,05738P,臺股指統一97售01,,,,,0.00,0.00,0,0,0,0,0,0,0,0,0,0,0,0,0
20200316,057390,台表科永豐98購01,,,,,0.00,0.00,0,0,0,0,0,0,0,0,0,0,0,0,0
20200316,057391,樺漢永豐98購01,,,,,0.00,0.00,0,0,0,0,0,0,0,0,0,0,0,0,0
20200316,057392,福懋科永豐98購01,0.37,0.37,0.28,0.28,-0.11,-28.21,19000,3,6270,0,0,0,0,0,0,10000,9000,1000,1000
20200316,057393,台積電中信02購01,0.28,0.32,0.25,0.25,-0.01,-3.85,778000,80,222070,0,0,0,0,0,0,0,364000,-364000,-364000
20200316,057394,台積電中信9C購02,0.12,0.12,0.12,0.12,-0.13,-52.0,30000,1,3600,0,0,0,0,0,0,0,30000,-30000,-30000
20200316,057395,旺宏中信98購03,,,,,0.00,0.00,0,0,0,0,0,0,0,0,0,0,0,0,0
20200316,057396,健鼎中信99購01,0.32,0.32,0.32,0.32,+0.02,6.67,2000,1,640,0,0,0,0,0,0,2000,0,2000,2000
20200316,057397,茂林中信9A購01,0.26,0.26,0.17,0.17,-0.10,-37.04,120000,19,28700,0,0,0,0,0,0,110000,10000,100000,100000
20200316,057398,台郡中信99購01,0.27,0.27,0.24,0.24,-0.05,-17.24,7000,3,1720,0,0,0,0,0,0,5000,2000,3000,3000
20200316,057399,滬深反群益9C購01,1.20,1.24,1.20,1.24,-0.10,-7.46,61000,3,75600,0,0,0,0,0,0,61000,0,61000,61000
20200316,05739P,臺股指統一97售02,,,,,0.00,0.00,0,0,0,0,0,0,0,0,0,0,0,0,0
20200316,057400,全新群益9A購01,0.17,0.17,0.12,0.12,0.00,0.00,15000,2,2300,0,0,0,0,0,0,0,15000,-15000,-15000
20200316,057401,晶豪科群益99購01,,,,,0.00,0.00,0,0,0,0,0,0,0,0,0,0,0,0,0
20200316,057402,嘉晶群益98購02,1.80,1.80,1.42,1.42,-0.27,-15.98,204000,4,333420,0,0,0,0,0,0,199000,0,199000,199000
20200316,057403,亞光群益98購04,0.36,0.36,0.31,0.31,+0.03,10.71,40000,5,13640,0,0,0,0,0,0,15000,25000,-10000,-10000
20200316,057404,貿聯群益99購01,0.22,0.22,0.22,0.22,+0.01,4.76,10000,1,2200,0,0,0,0,0,0,10000,0,10000,10000
20200316,057405,麗豐群益98購01,,,,,0.00,0.00,0,0,0,0,0,0,0,0,0,0,0,0,0
20200316,057406,茂林群益98購03,0.40,0.40,0.40,0.40,+0.09,29.03,50000,1,20000,0,0,0,0,0,0,0,50000,-50000,-50000
20200316,057407,超眾群益99購01,,,,,0.00,0.00,0,0,0,0,0,0,0,0,0,0,0,0,0
20200316,057408,台郡群益98購01,,,,,0.00,0.00,0,0,0,0,0,0,0,0,0,0,0,0,0
20200316,057409,台虹群益98購02,,,,,0.00,0.00,0,0,0,0,0,0,0,0,0,0,0,0,0
20200316,05740P,宏達電元富96售01,1.15,1.39,1.15,1.38,+0.24,21.05,15000,6,18570,0,0,0,0,0,0,8000,7000,1000,1000
20200316,057410,南電群益98購01,0.96,0.96,0.73,0.73,-0.23,-23.96,330000,2,312200,0,0,0,0,0,0,330000,0,330000,330000
20200316,057411,臺股指群益99購05,0.07,0.07,0.07,0.07,0.00,0.00,5000,1,350,0,0,0,0,0,0,5000,0,5000,5000
20200316,057412,臺股指群益99購06,,,,,0.00,0.00,0,0,0,0,0,0,0,0,0,0,0,0,0
20200316,057413,臺股指群益9C購04,,,,,0.00,0.00,0,0,0,0,0,0,0,0,0,0,0,0,0
20200316,057414,華新科日盛9A購01,0.39,0.44,0.25,0.25,-0.05,-16.67,62000,5,18680,0,0,0,0,0,0,50000,2000,48000,48000
20200316,057415,和碩日盛98購01,0.38,0.38,0.38,0.38,-0.06,-13.64,1000,1,380,0,0,0,0,0,0,0,0,0,0
20200316,057416,T50反1凱基9C購01,1.98,1.98,1.97,1.97,0.00,0.00,22000,3,43460,0,0,0,0,0,0,0,22000,-22000,-22000
20200316,057417,國巨凱基9A購03,0.23,0.23,0.18,0.18,-0.03,-14.29,220000,7,46050,0,0,0,0,0,0,127000,90000,37000,37000
20200316,057418,台光電凱基98購04,0.62,0.62,0.62,0.62,+0.09,16.98,10000,1,6200,0,0,0,0,0,0,10000,0,10000,10000
20200316,057419,奇力新凱基98購06,,,,,0.00,0.00,0,0,0,0,0,0,0,0,0,0,0,0,0
20200316,05741P,聯發科元大96售14,7.40,9.10,7.20,8.15,+0.70,9.4,91000,8,723900,0,0,0,0,0,0,71000,29000,42000,42000
20200316,057420,美食凱基98購01,,,,,0.00,0.00,0,0,0,0,0,0,0,0,0,0,0,0,0
20200316,057421,智原凱基98購04,,,,,0.00,0.00,0,0,0,0,0,0,0,0,0,0,0,0,0
20200316,057422,欣興凱基98購04,0.30,0.30,0.30,0.30,0.00,0.00,20000,1,6000,0,0,0,0,0,0,0,20000,-20000,-20000
20200316,057423,台郡凱基98購06,,,,,0.00,0.00,0,0,0,0,0,0,0,0,0,0,0,0,0
20200316,057424,訊芯凱基98購04,,,,,0.00,0.00,0,0,0,0,0,0,0,0,0,0,0,0,0
20200316,057425,臺股指凱基9C購02,0.07,0.13,0.06,0.06,-0.06,-50.0,406000,16,32070,0,0,0,0,0,0,0,0,0,0
20200316,057426,元油2X兆豐9B購01,,,,,0.00,0.00,0,0,0,0,0,0,0,0,0,0,0,0,0
20200316,057427,華通兆豐99購01,0.25,0.25,0.14,0.14,-0.08,-36.36,730000,22,128400,0,0,0,0,0,0,50000,680000,-630000,-630000
20200316,057428,正崴兆豐98購01,0.32,0.34,0.32,0.33,-0.01,-2.94,55000,3,18410,0,0,0,0,0,0,55000,0,55000,55000
20200316,057429,華新科兆豐98購03,0.12,0.12,0.12,0.12,-0.04,-25.0,20000,1,2400,0,0,0,0,0,0,20000,0,20000,20000
20200316,05742P,可成元大96售04,3.40,3.65,3.40,3.65,-0.56,-13.3,33000,5,113050,0,0,0,0,0,0,10000,23000,-13000,-13000
20200316,057430,富邦金兆豐98購01,0.18,0.18,0.18,0.18,-0.02,-10.0,100000,1,18000,0,0,0,0,0,0,0,100000,-100000,-100000
20200316,057431,京鼎兆豐98購02,0.29,0.29,0.18,0.18,-0.08,-30.77,318000,12,73420,0,0,0,0,0,0,38000,280000,-242000,-242000
20200316,057432,T50反1國票9B購01,,,,,0.00,0.00,0,0,0,0,0,0,0,0,0,0,0,0,0
20200316,057433,上銀國票98購04,0.83,0.84,0.83,0.84,+0.17,25.37,48000,2,40220,0,0,0,0,0,0,48000,0,48000,48000
20200316,057434,國巨國票99購03,0.20,0.20,0.14,0.14,-0.08,-36.36,260000,5,51400,0,0,0,0,0,0,0,0,0,0
20200316,057435,旺宏國票99購04,,,,,0.00,0.00,0,0,0,0,0,0,0,0,0,0,0,0,0
20200316,057436,義隆國票99購02,,,,,0.00,0.00,0,0,0,0,0,0,0,0,0,0,0,0,0
20200316,057437,可成國票99購01,0.50,0.50,0.44,0.44,-0.07,-13.73,230000,2,103000,0,0,0,0,0,0,230000,0,230000,230000
20200316,057438,禾伸堂國票99購01,0.57,0.57,0.57,0.57,+0.02,3.64,10000,1,5700,0,0,0,0,0,0,10000,0,10000,10000
20200316,057439,元油2X統一99購02,,,,,0.00,0.00,0,0,0,0,0,0,0,0,0,0,0,0,0
20200316,05743P,創意元大96售01,3.64,3.69,3.59,3.59,-1.29,-26.43,44000,6,161140,0,0,0,0,0,0,4000,40000,-36000,-36000
20200316,057440,台積電統一98購10,0.26,0.26,0.26,0.26,-0.09,-25.71,10000,1,2600,0,0,0,0,0,0,10000,0,10000,10000
20200316,057441,奇力新統一98購03,,,,,0.00,0.00,0,0,0,0,0,0,0,0,0,0,0,0,0
20200316,057442,玉晶光統一98購03,0.32,0.32,0.32,0.32,0.00,0.00,10000,1,3200,0,0,0,0,0,0,10000,0,10000,10000
20200316,057443,臺股指統一99購04,0.18,0.18,0.18,0.18,0.00,0.00,50000,1,9000,0,0,0,0,0,0,50000,0,50000,50000
20200316,057444,台泥元富98購01,1.15,1.23,1.00,1.00,-0.30,-23.08,157000,7,187330,0,0,0,0,0,0,127000,30000,97000,97000
20200316,057445,華通元富02購01,0.51,0.52,0.39,0.40,-0.02,-4.76,146000,12,67790,0,0,0,0,0,0,10000,136000,-126000,-126000
20200316,057446,旺宏元富02購01,0.67,0.67,0.49,0.49,-0.09,-15.52,93000,7,57690,0,0,0,0,0,0,25000,68000,-43000,-43000
20200316,057447,智邦元富02購01,1.28,1.30,1.10,1.10,-0.07,-5.98,478000,17,606860,0,0,0,0,0,0,420000,58000,362000,362000
20200316,057448,致茂元富98購01,0.63,0.68,0.51,0.51,-0.02,-3.77,429000,19,236030,0,0,0,0,0,0,130000,299000,-169000,-169000
20200316,057449,華新科元富99購02,0.34,0.34,0.25,0.25,-0.03,-10.71,45000,5,14450,0,0,0,0,0,0,0,45000,-45000,-45000
20200316,05744P,台表科元大96售04,3.22,3.91,3.22,3.91,+0.43,12.36,47000,5,167740,0,0,0,0,0,0,27000,20000,7000,7000
20200316,057450,國泰金元富98購01,1.13,1.13,0.95,0.96,-0.21,-17.95,328000,14,343970,0,0,0,0,0,0,271000,57000,214000,214000
20200316,057451,大立光元富9B購01,0.99,1.05,0.82,0.82,+0.01,1.23,160000,3,142000,0,0,0,0,0,0,60000,110000,-50000,-50000
20200316,057452,新日興元富98購01,0.49,0.49,0.49,0.49,+0.06,13.95,10000,1,4900,0,0,0,0,0,0,10000,0,10000,10000
20200316,057453,矽創元富98購01,0.91,1.00,0.63,0.63,-0.17,-21.25,125000,17,113470,0,0,0,0,0,0,115000,10000,105000,105000
20200316,057454,上銀國泰99購02,0.44,0.44,0.44,0.44,+0.08,22.22,98000,1,43120,0,0,0,0,0,0,98000,0,98000,98000
20200316,057455,景碩國泰99購01,0.55,0.55,0.41,0.42,-0.12,-22.22,666000,9,330340,0,0,0,0,0,0,289000,377000,-88000,-88000
20200316,057456,道瓊銀富邦9C購01,0.82,0.85,0.71,0.84,-0.34,-28.81,240000,30,191720,0,0,0,0,0,0,121000,190000,-69000,-69000
20200316,057457,華邦電富邦98購01,,,,,0.00,0.00,0,0,0,0,0,0,0,0,0,0,0,0,0
20200316,057458,TPK富邦9A購01,,,,,0.00,0.00,0,0,0,0,0,0,0,0,0,0,0,0,0
20200316,057459,臺股指富邦99購03,,,,,0.00,0.00,0,0,0,0,0,0,0,0,0,0,0,0,0
20200316,05745P,富邦金兆豐96售02,3.84,4.40,3.82,4.40,+0.07,1.62,233000,20,950040,0,0,0,0,0,0,36000,197000,-161000,-161000
20200316,057460,楠梓電永豐98購03,,,,,0.00,0.00,0,0,0,0,0,0,0,0,0,0,0,0,0
20200316,057461,國巨永豐98購07,0.12,0.12,0.12,0.12,0.00,0.00,20000,1,2400,0,0,0,0,0,0,0,20000,-20000,-20000
20200316,057462,光磊永豐98購02,,,,,0.00,0.00,0,0,0,0,0,0,0,0,0,0,0,0,0
20200316,057463,華邦電永豐98購01,,,,,0.00,0.00,0,0,0,0,0,0,0,0,0,0,0,0,0
20200316,057464,大立光永豐98購02,,,,,0.00,0.00,0,0,0,0,0,0,0,0,0,0,0,0,0
20200316,057465,智易永豐98購02,,,,,0.00,0.00,0,0,0,0,0,0,0,0,0,0,0,0,0
20200316,057466,泰鼎永豐98購01,0.37,0.37,0.37,0.37,0.00,0.00,2000,1,740,0,0,0,0,0,0,0,2000,-2000,-2000
20200316,057467,祥碩永豐98購04,0.21,0.21,0.13,0.13,-0.08,-38.1,771000,32,143840,0,0,0,0,0,0,384000,316000,68000,68000
20200316,057468,台郡永豐98購01,,,,,0.00,0.00,0,0,0,0,0,0,0,0,0,0,0,0,0
20200316,057469,康友永豐98購02,,,,,0.00,0.00,0,0,0,0,0,0,0,0,0,0,0,0,0
20200316,05746P,台積電群益96售07,5.55,6.95,5.55,6.95,+0.80,13.01,15000,2,90250,0,0,0,0,0,0,15000,0,15000,15000
20200316,057470,易華電永豐98購02,,,,,0.00,0.00,0,0,0,0,0,0,0,0,0,0,0,0,0
20200316,057471,昇陽半永豐98購02,,,,,0.00,0.00,0,0,0,0,0,0,0,0,0,0,0,0,0
20200316,057472,T50正2元大9B購03,0.19,0.19,0.18,0.18,-0.04,-18.18,6000,2,1120,0,0,0,0,0,0,0,0,0,0
20200316,057473,T50反1元大98購08,2.11,2.28,2.11,2.28,+0.34,17.53,9000,3,20120,0,0,0,0,0,0,6000,3000,3000,3000
20200316,057474,T50反1元大98購09,,,,,0.00,0.00,0,0,0,0,0,0,0,0,0,0,0,0,0
20200316,057475,聯電元大9A購01,0.42,0.43,0.38,0.40,-0.03,-6.98,107000,18,43610,0,0,0,0,0,0,47000,60000,-13000,-13000
20200316,057476,國巨元大98購19,0.82,0.82,0.75,0.77,+0.09,13.24,55000,5,44150,0,0,0,0,0,0,40000,15000,25000,25000
20200316,057477,智邦元大98購09,1.40,1.52,1.38,1.38,+0.01,0.73,50000,4,71400,0,0,0,0,0,0,50000,10000,40000,40000
20200316,057478,智邦元大99購01,1.20,1.34,1.10,1.10,-0.15,-12.0,325000,41,404320,0,0,0,0,0,0,263000,72000,191000,191000
20200316,057479,致茂元大98購03,0.82,0.82,0.82,0.82,0.00,0.00,10000,1,8200,0,0,0,0,0,0,0,10000,-10000,-10000
20200316,05747P,漢唐群益96售03,2.30,2.30,2.30,2.30,-0.16,-6.5,8000,1,18400,0,0,0,0,0,0,0,8000,-8000,-8000
20200316,057480,技嘉元大98購03,0.76,0.76,0.76,0.76,+0.10,15.15,22000,3,16720,0,0,0,0,0,0,0,22000,-22000,-22000
20200316,057481,技嘉元大98購04,0.87,0.87,0.70,0.70,+0.03,4.48,3000,3,2390,0,0,0,0,0,0,1000,2000,-1000,-1000
20200316,057482,微星元大98購03,0.92,0.92,0.92,0.92,-0.06,-6.12,10000,1,9200,0,0,0,0,0,0,10000,0,10000,10000
20200316,057483,微星元大98購04,,,,,0.00,0.00,0,0,0,0,0,0,0,0,0,0,0,0,0
20200316,057484,南亞科元大98購06,0.28,0.28,0.18,0.18,-0.05,-21.74,30000,3,6900,0,0,0,0,0,0,10000,20000,-10000,-10000
20200316,057485,友達元大9C購04,0.39,0.39,0.34,0.34,+0.05,17.24,30000,3,10900,0,0,0,0,0,0,0,30000,-30000,-30000
20200316,057486,美律元大98購04,0.99,0.99,0.79,0.79,+0.11,16.18,23000,3,21470,0,0,0,0,0,0,23000,3000,20000,20000
20200316,057487,聯發科元大98購10,0.99,1.08,0.73,0.73,-0.41,-35.96,385000,34,366350,0,0,0,0,0,0,190000,225000,-35000,-35000
20200316,057488,聯發科元大99購02,0.85,0.86,0.64,0.64,-0.32,-33.33,659000,51,510030,0,0,0,0,0,0,383000,466000,-83000,-83000
20200316,057489,奇力新元大99購06,,,,,0.00,0.00,0,0,0,0,0,0,0,0,0,0,0,0,0
20200316,05748P,臺股指群益99售02,7.55,7.75,7.55,7.75,+0.70,9.93,3000,2,22850,0,0,0,0,0,0,3000,0,3000,3000
20200316,057490,可成元大98購10,0.52,0.52,0.52,0.52,+0.02,4.0,60000,3,31200,0,0,0,0,0,0,50000,20000,30000,30000
20200316,057491,美食元大98購03,0.91,0.91,0.67,0.67,0.00,0.00,290000,20,199700,0,0,0,0,0,0,100000,190000,-90000,-90000
20200316,057492,大立光元大98購18,1.50,1.50,0.94,0.99,-0.14,-12.39,58000,5,70620,0,0,0,0,0,0,34000,24000,10000,10000
20200316,057493,聯詠元大98購02,1.24,1.36,1.22,1.22,-0.08,-6.15,96000,11,121710,0,0,0,0,0,0,65000,36000,29000,29000
20200316,057494,玉晶光元大99購09,1.05,1.08,0.86,0.86,-0.13,-13.13,134000,7,131520,0,0,0,0,0,0,134000,24000,110000,110000
20200316,057495,牧德元大99購04,0.63,0.63,0.62,0.62,0.00,0.00,10000,2,6250,0,0,0,0,0,0,0,10000,-10000,-10000
20200316,057496,佐登元大98購02,,,,,0.00,0.00,0,0,0,0,0,0,0,0,0,0,0,0,0
20200316,057497,祥碩元大98購06,1.31,1.32,1.03,1.03,-0.20,-16.26,277000,26,336900,0,0,0,0,0,0,277000,67000,210000,210000
20200316,057498,台郡元大98購04,,,,,0.00,0.00,0,0,0,0,0,0,0,0,0,0,0,0,0
20200316,057499,奇鋐群益98購01,0.73,0.73,0.61,0.61,+0.04,7.02,14000,2,9260,0,0,0,0,0,0,14000,0,14000,14000
20200316,05749P,臺股指群益99售03,11.40,12.10,11.40,12.10,+0.90,8.04,10000,5,117800,0,0,0,0,0,0,10000,0,10000,10000
20200316,057500,神達群益98購01,2.29,2.29,2.29,2.29,-0.28,-10.89,10000,1,22900,0,0,0,0,0,0,10000,0,10000,10000
20200316,057501,超眾群益98購04,0.73,0.73,0.73,0.73,0.00,0.00,35000,1,25550,0,0,0,0,0,0,35000,0,35000,35000
20200316,057502,訊芯群益98購02,0.33,0.33,0.22,0.22,-0.04,-15.38,20000,2,5500,0,0,0,0,0,0,0,20000,-20000,-20000
20200316,057503,世紀鋼群益98購02,7.00,7.00,7.00,7.00,+0.70,11.11,8000,1,56000,0,0,0,0,0,0,8000,0,8000,8000
20200316,057504,技嘉麥證98購01,0.27,0.27,0.22,0.22,-0.05,-18.52,13000,2,3360,13000,0,13000,0,0,0,13000,0,13000,13000
20200316,057505,健策麥證98購01,,,,,0.00,0.00,0,0,0,0,0,0,0,0,0,0,0,0,0
20200316,057506,聯鈞國票99購02,1.06,1.08,0.93,0.93,-0.04,-4.12,63000,4,65890,0,0,0,0,0,0,63000,0,63000,63000
20200316,057507,貿聯國票98購02,0.43,0.43,0.43,0.43,+0.03,7.5,20000,1,8600,0,0,0,0,0,0,20000,0,20000,20000
20200316,057508,康控國票99購03,0.38,0.39,0.37,0.37,+0.02,5.71,30000,3,11400,0,0,0,0,0,0,10000,10000,0,0
20200316,057509,聯發科統一9A購03,,,,,0.00,0.00,0,0,0,0,0,0,0,0,0,0,0,0,0
20200316,05750P,臺股指群益99售04,,,,,0.00,0.00,0,0,0,0,0,0,0,0,0,0,0,0,0
20200316,057510,泰碩統一98購02,1.87,1.89,1.87,1.87,+0.57,43.85,11000,3,20670,0,0,0,0,0,0,5000,0,5000,5000
20200316,057511,健策統一98購02,,,,,0.00,0.00,0,0,0,0,0,0,0,0,0,0,0,0,0
20200316,057512,華邦電台新98購01,0.36,0.36,0.25,0.25,-0.01,-3.85,68000,3,21860,0,0,0,0,0,0,0,68000,-68000,-68000
20200316,057513,智邦台新98購01,0.92,1.01,0.79,0.79,-0.15,-15.96,484000,23,448210,0,0,0,0,0,0,176000,338000,-162000,-162000
20200316,057514,華新科元富99購03,0.17,0.17,0.17,0.17,0.00,0.00,10000,1,1700,0,0,0,0,0,0,10000,10000,0,0
20200316,057515,智原元富98購02,0.16,0.16,0.14,0.14,+0.01,7.69,313000,15,46630,0,0,0,0,0,0,0,313000,-313000,-313000
20200316,057516,和鑫元富98購01,0.44,0.45,0.37,0.37,+0.07,23.33,201000,5,84950,0,0,0,0,0,0,50000,151000,-101000,-101000
20200316,057517,矽創元富98購02,0.34,0.35,0.33,0.33,+0.02,6.45,12000,6,4080,0,0,0,0,0,0,12000,0,12000,12000
20200316,057518,世紀鋼元富98購01,3.25,3.83,3.25,3.37,+0.02,0.6,373000,56,1333480,0,0,0,0,0,0,315000,56000,259000,259000
20200316,057519,元油2X元大98購14,,,,,0.00,0.00,0,0,0,0,0,0,0,0,0,0,0,0,0
20200316,05751P,台積電中信96售05,,,,,0.00,0.00,0,0,0,0,0,0,0,0,0,0,0,0,0
20200316,057520,元油2X元大98購15,,,,,0.00,0.00,0,0,0,0,0,0,0,0,0,0,0,0,0
20200316,057521,元油2X元大98購16,,,,,0.00,0.00,0,0,0,0,0,0,0,0,0,0,0,0,0
20200316,057522,元油2X元大98購17,,,,,0.00,0.00,0,0,0,0,0,0,0,0,0,0,0,0,0
20200316,057523,大成鋼元大99購01,1.52,1.56,1.50,1.53,-0.03,-1.92,153000,12,233970,0,0,0,0,0,0,90000,83000,7000,7000
20200316,057524,旺宏元大99購04,0.89,0.92,0.89,0.92,+0.12,15.0,30000,3,27200,0,0,0,0,0,0,10000,20000,-10000,-10000
20200316,057525,光磊元大99購01,0.45,0.45,0.40,0.40,0.00,0.00,120000,11,49000,0,0,0,0,0,0,20000,100000,-80000,-80000
20200316,057526,智邦元大98購10,1.20,1.36,1.19,1.25,-0.03,-2.34,128000,26,158080,0,0,0,0,0,0,108000,58000,50000,50000
20200316,057527,億光元大98購01,0.43,0.43,0.37,0.37,-0.02,-5.13,110000,11,46200,0,0,0,0,0,0,0,110000,-110000,-110000
20200316,057528,南亞科元大99購01,0.45,0.46,0.35,0.35,-0.07,-16.67,100000,5,41000,0,0,0,0,0,0,90000,10000,80000,80000
20200316,057529,嘉晶元大99購02,2.61,2.73,2.13,2.13,-0.34,-13.77,833000,87,2050940,0,0,0,0,0,0,515000,773000,-258000,-258000
20200316,05752P,台積電中信96售06,,,,,0.00,0.00,0,0,0,0,0,0,0,0,0,0,0,0,0
20200316,057530,奇鋐元大99購01,1.66,1.66,1.48,1.48,-0.01,-0.67,34000,4,53220,0,0,0,0,0,0,14000,20000,-6000,-6000
20200316,057531,禾伸堂元大99購04,,,,,0.00,0.00,0,0,0,0,0,0,0,0,0,0,0,0,0
20200316,057532,智原元大98購03,0.47,0.49,0.35,0.35,0.00,0.00,93000,10,43950,0,0,0,0,0,0,0,93000,-93000,-93000
20200316,057533,晶相光元大98購02,1.33,1.39,1.01,1.01,-0.15,-12.93,85000,8,104690,0,0,0,0,0,0,60000,25000,35000,35000
20200316,057534,旭富元大98購01,1.66,1.68,1.35,1.35,-0.18,-11.76,46000,11,72710,0,0,0,0,0,0,20000,35000,-15000,-15000
20200316,057535,泰鼎元大99購01,0.85,0.86,0.83,0.83,-0.12,-12.63,118000,5,98430,0,0,0,0,0,0,108000,10000,98000,98000
20200316,057536,康控元大99購03,0.75,0.75,0.66,0.66,0.00,0.00,40000,4,28100,0,0,0,0,0,0,0,40000,-40000,-40000
20200316,057537,聯茂元大98購04,1.41,1.43,1.20,1.20,+0.07,6.19,41000,4,54900,0,0,0,0,0,0,31000,10000,21000,21000
20200316,057538,緯穎元大98購07,,,,,0.00,0.00,0,0,0,0,0,0,0,0,0,0,0,0,0
20200316,057539,南茂元大98購02,1.31,1.33,1.04,1.04,-0.21,-16.8,999000,9,1258150,0,0,0,0,0,0,974000,25000,949000,949000
20200316,05753P,臺股指中信99售02,2.64,3.84,2.64,3.84,+1.01,35.69,201000,18,582090,0,0,0,0,0,0,131000,70000,61000,61000
20200316,057540,緯穎日盛99購01,1.39,1.40,1.35,1.37,+0.17,14.17,89000,15,123850,0,0,0,0,0,0,89000,0,89000,89000
20200316,057541,台灣50康和9A購04,0.23,0.23,0.20,0.20,-0.03,-13.04,10000,2,2150,0,0,0,0,0,0,0,0,0,0
20200316,057542,上銀凱基99購01,0.16,0.16,0.14,0.15,-0.11,-42.31,1928000,8,275430,0,0,0,0,0,0,1808000,10000,1798000,1798000
20200316,057543,華通凱基99購02,,,,,0.00,0.00,0,0,0,0,0,0,0,0,0,0,0,0,0
20200316,057544,鴻海凱基02購01,0.47,0.48,0.41,0.42,-0.16,-27.59,203000,15,90410,0,0,0,0,0,0,120000,83000,37000,37000
20200316,057545,國巨凱基99購05,0.19,0.19,0.17,0.17,-0.04,-19.05,70000,2,12100,0,0,0,0,0,0,0,70000,-70000,-70000
20200316,057546,台積電凱基02購01,0.53,0.53,0.37,0.37,-0.15,-28.85,1212000,152,497380,0,0,0,0,0,0,0,310000,-310000,-310000
20200316,057547,技嘉凱基99購01,,,,,0.00,0.00,0,0,0,0,0,0,0,0,0,0,0,0,0
20200316,057548,微星凱基99購01,0.30,0.30,0.30,0.30,+0.02,7.14,50000,1,15000,0,0,0,0,0,0,0,50000,-50000,-50000
20200316,057549,台光電凱基98購05,,,,,0.00,0.00,0,0,0,0,0,0,0,0,0,0,0,0,0
20200316,05754P,臺股指中信99售03,2.61,2.61,2.61,2.61,+0.11,4.4,7000,2,18270,0,0,0,0,0,0,7000,0,7000,7000
20200316,057550,聯發科凱基02購01,0.39,0.40,0.33,0.33,-0.10,-23.26,157000,13,57790,0,0,0,0,0,0,87000,67000,20000,20000
20200316,057551,華新科凱基98購06,,,,,0.00,0.00,0,0,0,0,0,0,0,0,0,0,0,0,0
20200316,057552,禾伸堂凱基98購05,0.33,0.33,0.33,0.33,-0.10,-23.26,31000,1,10230,0,0,0,0,0,0,31000,0,31000,31000
20200316,057553,景碩凱基98購03,,,,,0.00,0.00,0,0,0,0,0,0,0,0,0,0,0,0,0
20200316,057554,新日興凱基99購02,,,,,0.00,0.00,0,0,0,0,0,0,0,0,0,0,0,0,0
20200316,057555,玉晶光凱基9A購02,0.29,0.29,0.24,0.24,-0.08,-25.0,514000,3,148410,0,0,0,0,0,0,0,514000,-514000,-514000
20200316,057556,智易凱基99購01,0.40,0.44,0.40,0.44,+0.16,57.14,123000,4,53400,0,0,0,0,0,0,18000,105000,-87000,-87000
20200316,057557,聯茂凱基99購04,0.97,1.05,0.86,0.86,+0.02,2.38,97000,5,98190,0,0,0,0,0,0,78000,19000,59000,59000
20200316,057558,致新凱基98購01,,,,,0.00,0.00,0,0,0,0,0,0,0,0,0,0,0,0,0
20200316,057559,可成兆豐99購02,,,,,0.00,0.00,0,0,0,0,0,0,0,0,0,0,0,0,0
20200316,05755P,臺股指中信99售04,2.18,2.60,2.14,2.60,+0.47,22.07,162000,17,372350,0,0,0,0,0,0,85000,31000,54000,54000
20200316,057560,華新科兆豐99購01,0.14,0.14,0.14,0.14,+0.03,27.27,10000,1,1400,0,0,0,0,0,0,10000,0,10000,10000
20200316,057561,大立光兆豐98購02,0.24,0.24,0.22,0.22,-0.03,-12.0,359000,4,85960,0,0,0,0,0,0,299000,50000,249000,249000
20200316,057562,奇鋐兆豐98購01,0.65,0.70,0.51,0.51,-0.12,-19.05,359000,16,233720,0,0,0,0,0,0,205000,154000,51000,51000
20200316,057563,旭富國泰9A購01,1.23,1.33,1.07,1.08,-0.08,-6.9,1729000,43,2111990,0,0,0,0,0,0,53000,1353000,-1300000,-1300000
20200316,057564,台積電富邦9B購03,0.11,0.14,0.10,0.14,-0.03,-17.65,796000,31,88780,0,0,0,0,0,0,45000,0,45000,45000
20200316,057565,可成富邦99購01,0.14,0.15,0.13,0.13,0.00,0.00,135000,3,18800,0,0,0,0,0,0,25000,110000,-85000,-85000
20200316,057566,欣興富邦99購01,0.18,0.18,0.14,0.14,-0.07,-33.33,25000,7,3590,0,0,0,0,0,0,0,25000,-25000,-25000
20200316,057567,嘉聯益富邦9A購01,0.43,0.43,0.34,0.34,-0.13,-27.66,21000,3,7330,0,0,0,0,0,0,1000,20000,-19000,-19000
20200316,057568,友訊永豐99購01,,,,,0.00,0.00,0,0,0,0,0,0,0,0,0,0,0,0,0
20200316,057569,光磊永豐98購03,0.18,0.18,0.18,0.18,-0.01,-5.26,15000,1,2700,0,0,0,0,0,0,0,15000,-15000,-15000
20200316,05756P,臺股指中信99售05,,,,,0.00,0.00,0,0,0,0,0,0,0,0,0,0,0,0,0
20200316,057570,技嘉永豐98購02,0.17,0.17,0.13,0.13,-0.02,-13.33,60000,7,9200,0,0,0,0,0,0,0,60000,-60000,-60000
20200316,057571,泰碩永豐98購01,0.98,0.98,0.98,0.98,0.00,0.00,10000,1,9800,0,0,0,0,0,0,10000,0,10000,10000
20200316,057572,明泰永豐98購01,0.25,0.25,0.25,0.25,-0.02,-7.41,50000,1,12500,0,0,0,0,0,0,50000,0,50000,50000
20200316,057573,京鼎永豐98購02,,,,,0.00,0.00,0,0,0,0,0,0,0,0,0,0,0,0,0
20200316,057574,中磊永豐98購01,0.28,0.28,0.28,0.28,+0.04,16.67,130000,1,36400,0,0,0,0,0,0,130000,0,130000,130000
20200316,057575,世紀鋼永豐98購02,2.44,2.54,2.12,2.12,-0.12,-5.36,298000,13,693670,0,0,0,0,0,0,293000,5000,288000,288000
20200316,057576,南亞科第一9C購01,,,,,0.00,0.00,0,0,0,0,0,0,0,0,0,0,0,0,0
20200316,057577,廣宇中信9A購01,0.47,0.47,0.47,0.47,+0.05,11.9,2000,1,940,0,0,0,0,0,0,0,2000,-2000,-2000
20200316,057578,可成中信99購01,0.26,0.26,0.26,0.26,+0.06,30.0,2000,1,520,0,0,0,0,0,0,0,2000,-2000,-2000
20200316,057579,長榮航中信9A購01,0.26,0.26,0.26,0.26,-0.21,-44.68,10000,1,2600,0,0,0,0,0,0,0,10000,-10000,-10000
20200316,05757P,旺宏永豐96售03,2.46,2.74,2.46,2.74,+0.15,5.79,28000,2,69720,0,0,0,0,0,0,0,28000,-28000,-28000
20200316,057580,玉山金中信9A購01,0.60,0.60,0.49,0.49,-0.05,-9.26,55000,15,30450,0,0,0,0,0,0,0,55000,-55000,-55000
20200316,057581,元大金中信9A購01,,,,,0.00,0.00,0,0,0,0,0,0,0,0,0,0,0,0,0
20200316,057582,亞光中信9A購02,0.52,0.52,0.52,0.52,0.00,0.00,5000,1,2600,0,0,0,0,0,0,0,5000,-5000,-5000
20200316,057583,啟碁中信9A購01,,,,,0.00,0.00,0,0,0,0,0,0,0,0,0,0,0,0,0
20200316,057584,國巨亞東99購01,0.34,0.34,0.34,0.34,-0.08,-19.05,100000,1,34000,0,0,0,0,0,0,100000,0,100000,100000
20200316,057585,鴻海國票99購05,0.19,0.19,0.19,0.19,-0.02,-9.52,3000,1,570,0,0,0,0,0,0,3000,0,3000,3000
20200316,057586,台積電國票99購06,0.33,0.33,0.25,0.25,-0.24,-48.98,166000,8,51830,0,0,0,0,0,0,110000,15000,95000,95000
20200316,057587,微星國票99購01,0.60,0.60,0.60,0.60,+0.07,13.21,200000,1,120000,0,0,0,0,0,0,200000,0,200000,200000
20200316,057588,南亞科國票99購01,,,,,0.00,0.00,0,0,0,0,0,0,0,0,0,0,0,0,0
20200316,057589,超眾國票9A購01,0.63,0.63,0.63,0.63,+0.08,14.55,1000,1,630,0,0,0,0,0,0,1000,0,1000,1000
20200316,05758P,光罩永豐96售02,2.19,2.55,2.19,2.55,+0.10,4.08,112000,2,281280,0,0,0,0,0,0,112000,0,112000,112000
20200316,057590,元油2X兆豐98購02,0.03,0.03,0.01,0.02,+0.01,100.0,207000,6,4690,0,0,0,0,0,0,0,0,0,0
20200316,057591,鴻海兆豐99購01,0.32,0.32,0.32,0.32,+0.09,39.13,5000,1,1600,0,0,0,0,0,0,5000,0,5000,5000
20200316,057592,美律兆豐99購01,,,,,0.00,0.00,0,0,0,0,0,0,0,0,0,0,0,0,0
20200316,057593,聯發科兆豐98購03,,,,,0.00,0.00,0,0,0,0,0,0,0,0,0,0,0,0,0
20200316,057594,宏達電兆豐99購01,,,,,0.00,0.00,0,0,0,0,0,0,0,0,0,0,0,0,0
20200316,057595,健鼎兆豐98購01,,,,,0.00,0.00,0,0,0,0,0,0,0,0,0,0,0,0,0
20200316,057596,聯茂兆豐99購01,0.47,0.48,0.31,0.31,-0.05,-13.89,305000,15,131550,0,0,0,0,0,0,134000,171000,-37000,-37000
20200316,057597,華通群益9A購02,0.19,0.19,0.19,0.19,-0.07,-26.92,250000,1,47500,0,0,0,0,0,0,250000,0,250000,250000
20200316,057598,鴻海群益98購07,0.51,0.51,0.41,0.41,-0.03,-6.82,11000,2,5010,0,0,0,0,0,0,5000,6000,-1000,-1000
20200316,057599,技嘉群益9A購01,,,,,0.00,0.00,0,0,0,0,0,0,0,0,0,0,0,0,0
20200316,05759P,智邦永豐96售02,0.85,0.96,0.82,0.96,+0.09,10.34,290000,30,248540,0,0,0,0,0,0,67000,229000,-162000,-162000
20200316,057600,大立光群益99購03,1.16,1.16,0.80,0.83,-0.21,-20.19,65000,9,63830,0,0,0,0,0,0,10000,65000,-55000,-55000
20200316,057601,中磊群益98購01,,,,,0.00,0.00,0,0,0,0,0,0,0,0,0,0,0,0,0
20200316,057602,聯茂群益98購02,0.80,0.80,0.78,0.78,+0.24,44.44,150000,3,119000,0,0,0,0,0,0,150000,0,150000,150000
20200316,057603,樺漢群益98購02,,,,,0.00,0.00,0,0,0,0,0,0,0,0,0,0,0,0,0
20200316,057604,鴻海統一9C購01,,,,,0.00,0.00,0,0,0,0,0,0,0,0,0,0,0,0,0
20200316,057605,旺宏統一99購03,,,,,0.00,0.00,0,0,0,0,0,0,0,0,0,0,0,0,0
20200316,057606,健策統一98購03,,,,,0.00,0.00,0,0,0,0,0,0,0,0,0,0,0,0,0
20200316,057607,旺宏台新98購02,,,,,0.00,0.00,0,0,0,0,0,0,0,0,0,0,0,0,0
20200316,057608,南亞科台新98購01,,,,,0.00,0.00,0,0,0,0,0,0,0,0,0,0,0,0,0
20200316,057609,友訊元富98購01,0.36,0.36,0.36,0.36,+0.07,24.14,10000,1,3600,0,0,0,0,0,0,10000,0,10000,10000
20200316,05760P,京鼎永豐96售02,,,,,0.00,0.00,0,0,0,0,0,0,0,0,0,0,0,0,0
20200316,057610,致茂元富98購02,0.46,0.48,0.44,0.44,+0.03,7.32,64000,17,30330,0,0,0,0,0,0,58000,0,58000,58000
20200316,057611,技嘉元富98購02,0.56,0.58,0.56,0.58,+0.10,20.83,58000,4,33440,0,0,0,0,0,0,58000,0,58000,58000
20200316,057612,瑞昱元富02購01,0.65,0.65,0.56,0.56,-0.13,-18.84,195000,7,124750,0,0,0,0,0,0,155000,40000,115000,115000
20200316,057613,瑞昱元富02購02,0.47,0.47,0.47,0.47,-0.09,-16.07,10000,1,4700,0,0,0,0,0,0,10000,0,10000,10000
20200316,057614,華新科元富99購04,0.19,0.19,0.19,0.19,0.00,0.00,10000,1,1900,0,0,0,0,0,0,10000,10000,0,0
20200316,057615,元油2X凱基98購02,0.11,0.11,0.11,0.11,0.00,0.00,50000,4,5500,0,0,0,0,0,0,0,20000,-20000,-20000
20200316,057616,聯電凱基99購01,,,,,0.00,0.00,0,0,0,0,0,0,0,0,0,0,0,0,0
20200316,057617,國巨凱基99購06,,,,,0.00,0.00,0,0,0,0,0,0,0,0,0,0,0,0,0
20200316,057618,台光電凱基99購01,0.54,0.54,0.54,0.54,+0.11,25.58,24000,1,12960,0,0,0,0,0,0,24000,0,24000,24000
20200316,057619,玉晶光凱基98購02,,,,,0.00,0.00,0,0,0,0,0,0,0,0,0,0,0,0,0
20200316,05761P,嘉澤永豐96售01,2.33,2.75,2.33,2.75,+0.41,17.52,30000,3,76300,0,0,0,0,0,0,10000,20000,-10000,-10000
20200316,057620,康控凱基99購01,0.24,0.25,0.24,0.25,-0.01,-3.85,53000,2,12750,0,0,0,0,0,0,50000,3000,47000,47000
20200316,057621,崇越凱基98購01,,,,,0.00,0.00,0,0,0,0,0,0,0,0,0,0,0,0,0
20200316,057622,元油2X國泰99購03,,,,,0.00,0.00,0,0,0,0,0,0,0,0,0,0,0,0,0
20200316,057623,友訊國泰99購01,0.50,0.50,0.50,0.50,+0.01,2.04,184000,1,92000,0,0,0,0,0,0,184000,0,184000,184000
20200316,057624,新日興國泰99購01,0.48,0.48,0.48,0.48,0.00,0.00,79000,1,37920,0,0,0,0,0,0,79000,79000,0,0
20200316,057625,泰鼎國泰9A購01,0.32,0.34,0.25,0.25,-0.06,-19.35,573000,19,163040,0,0,0,0,0,0,69000,504000,-435000,-435000
20200316,057626,技嘉富邦9A購01,,,,,0.00,0.00,0,0,0,0,0,0,0,0,0,0,0,0,0
20200316,057627,和大永豐98購01,,,,,0.00,0.00,0,0,0,0,0,0,0,0,0,0,0,0,0
20200316,057628,旺宏永豐98購02,,,,,0.00,0.00,0,0,0,0,0,0,0,0,0,0,0,0,0
20200316,057629,泰碩永豐98購02,2.25,2.25,2.25,2.25,0.00,0.00,10000,1,22500,0,0,0,0,0,0,10000,0,10000,10000
20200316,05762P,昇陽半永豐96售04,3.13,3.30,3.13,3.30,+0.29,9.63,20000,3,64800,0,0,0,0,0,0,0,20000,-20000,-20000
20200316,057630,茂林永豐98購01,0.21,0.21,0.17,0.17,0.00,0.00,140000,3,27000,0,0,0,0,0,0,80000,60000,20000,20000
20200316,057631,康控永豐98購02,,,,,0.00,0.00,0,0,0,0,0,0,0,0,0,0,0,0,0
20200316,057632,傳奇永豐98購01,,,,,0.00,0.00,0,0,0,0,0,0,0,0,0,0,0,0,0
20200316,057633,緯穎永豐98購02,0.55,0.58,0.55,0.58,+0.23,65.71,2000,2,1130,0,0,0,0,0,0,2000,0,2000,2000
20200316,057634,道瓊反元大99購01,3.39,3.48,3.24,3.39,+0.38,12.62,93000,13,312510,0,0,0,0,0,0,0,93000,-93000,-93000
20200316,057635,中鋼元大98購01,0.39,0.39,0.36,0.37,-0.01,-2.63,250000,14,93650,0,0,0,0,0,0,150000,100000,50000,50000
20200316,057636,上銀元大98購06,0.37,0.37,0.26,0.26,-0.10,-27.78,80000,4,27300,0,0,0,0,0,0,60000,20000,40000,40000
20200316,057637,上銀元大98購07,,,,,0.00,0.00,0,0,0,0,0,0,0,0,0,0,0,0,0
20200316,057638,上銀元大99購01,0.49,0.49,0.45,0.45,-0.02,-4.26,4000,2,1880,0,0,0,0,0,0,0,4000,-4000,-4000
20200316,057639,國巨元大99購07,,,,,0.00,0.00,0,0,0,0,0,0,0,0,0,0,0,0,0
20200316,05763P,致新永豐96售01,1.56,1.64,1.56,1.64,+0.11,7.19,15000,2,24200,0,0,0,0,0,0,0,15000,-15000,-15000
20200316,057640,台積電元大98購16,0.93,0.97,0.62,0.62,-0.39,-38.61,393000,39,323240,0,0,0,0,0,0,116000,277000,-161000,-161000
20200316,057641,旺宏元大98購10,0.74,0.82,0.56,0.56,-0.15,-21.13,53000,5,38060,0,0,0,0,0,0,50000,3000,47000,47000
20200316,057642,南亞科元大98購07,,,,,0.00,0.00,0,0,0,0,0,0,0,0,0,0,0,0,0
20200316,057643,聯發科元大99購03,1.32,1.32,0.99,1.02,-0.44,-30.14,169000,18,208630,0,0,0,0,0,0,168000,71000,97000,97000
20200316,057644,奇力新元大98購04,0.26,0.26,0.26,0.26,+0.07,36.84,10000,1,2600,0,0,0,0,0,0,0,10000,-10000,-10000
20200316,057645,華新科元大99購11,0.83,0.91,0.61,0.66,-0.03,-4.35,356000,29,265620,0,0,0,0,0,0,125000,231000,-106000,-106000
20200316,057646,玉山金元大98購01,0.78,0.83,0.61,0.61,-0.31,-33.7,394000,27,290010,0,0,0,0,0,0,218000,176000,42000,42000
20200316,057647,欣興元大98購10,,,,,0.00,0.00,0,0,0,0,0,0,0,0,0,0,0,0,0
20200316,057648,和碩元大98購01,1.09,1.15,1.07,1.07,-0.21,-16.41,140000,10,152540,0,0,0,0,0,0,140000,0,140000,140000
20200316,057649,嘉聯益元大99購04,,,,,0.00,0.00,0,0,0,0,0,0,0,0,0,0,0,0,0
20200316,05764P,世紀鋼永豐96售03,0.40,0.44,0.37,0.41,-0.05,-10.87,165000,17,63000,0,0,0,0,0,0,0,165000,-165000,-165000
20200316,057650,力成元大98購04,,,,,0.00,0.00,0,0,0,0,0,0,0,0,0,0,0,0,0
20200316,057651,矽力元大98購03,1.29,1.29,1.03,1.03,-0.42,-28.97,85000,9,96400,0,0,0,0,0,0,0,85000,-85000,-85000
20200316,057652,欣興永昌9C購01,1.80,1.80,1.60,1.60,-0.40,-20.0,2000,2,3400,0,0,0,0,0,0,0,2000,-2000,-2000
20200316,057653,臺股指永昌98購01,,,,,0.00,0.00,0,0,0,0,0,0,0,0,0,0,0,0,0
20200316,057654,A50正2中信98購01,0.59,0.59,0.58,0.58,+0.08,16.0,6000,3,3500,0,0,0,0,0,0,0,6000,-6000,-6000
20200316,057655,奇力新中信98購05,,,,,0.00,0.00,0,0,0,0,0,0,0,0,0,0,0,0,0
20200316,057656,大成鋼兆豐98購01,0.61,0.64,0.55,0.55,-0.12,-17.91,795000,20,487800,0,0,0,0,0,0,306000,489000,-183000,-183000
20200316,057657,國巨兆豐98購04,,,,,0.00,0.00,0,0,0,0,0,0,0,0,0,0,0,0,0
20200316,057658,玉晶光兆豐99購02,0.36,0.36,0.29,0.29,-0.05,-14.71,20000,3,6500,0,0,0,0,0,0,5000,10000,-5000,-5000
20200316,057659,台表科兆豐98購01,0.19,0.19,0.19,0.19,+0.01,5.56,30000,1,5700,0,0,0,0,0,0,30000,0,30000,30000
20200316,05765P,臺股指永豐96售01,,,,,0.00,0.00,0,0,0,0,0,0,0,0,0,0,0,0,0
20200316,057660,訊芯兆豐98購02,,,,,0.00,0.00,0,0,0,0,0,0,0,0,0,0,0,0,0
20200316,057661,臺股指兆豐98購01,,,,,0.00,0.00,0,0,0,0,0,0,0,0,0,0,0,0,0
20200316,057662,上銀元大9A購01,0.63,0.63,0.63,0.63,-0.04,-5.97,10000,1,6300,0,0,0,0,0,0,10000,0,10000,10000
20200316,057663,國巨元大99購08,0.49,0.51,0.36,0.36,-0.08,-18.18,106000,12,43900,0,0,0,0,0,0,60000,46000,14000,14000
20200316,057664,台積電元大9A購03,0.62,0.72,0.52,0.53,-0.24,-31.17,2417000,229,1525830,60000,0,60000,0,0,0,647000,1529000,-882000,-822000
20200316,057665,技嘉元大99購01,0.60,0.60,0.60,0.60,0.00,0.00,1000,1,600,0,0,0,0,0,0,1000,0,1000,1000
20200316,057666,奇力新元大9A購01,,,,,0.00,0.00,0,0,0,0,0,0,0,0,0,0,0,0,0
20200316,057667,可成元大99購01,0.62,0.62,0.58,0.62,+0.07,12.73,81000,6,49420,0,0,0,0,0,0,51000,31000,20000,20000
20200316,057668,華新科元大9A購01,0.52,0.55,0.46,0.46,-0.04,-8.0,90000,5,44100,0,0,0,0,0,0,90000,0,90000,90000
20200316,057669,嘉晶元大99購03,1.51,1.55,1.18,1.21,-0.25,-17.12,577000,52,828810,0,0,0,0,0,0,313000,362000,-49000,-49000
20200316,05766P,A50正2凱基99售01,1.53,1.78,1.51,1.78,+0.34,23.61,269000,12,425660,0,0,0,0,0,0,129000,140000,-11000,-11000
20200316,057670,欣興元大99購02,1.04,1.04,0.93,0.93,-0.05,-5.1,13000,4,13260,0,0,0,0,0,0,3000,13000,-10000,-10000
20200316,057671,群創元大9B購06,,,,,0.00,0.00,0,0,0,0,0,0,0,0,0,0,0,0,0
20200316,057672,茂林元大98購02,1.09,1.09,0.87,0.87,-0.23,-20.91,40000,5,40000,0,0,0,0,0,0,10000,30000,-20000,-20000
20200316,057673,臻鼎元大98購01,0.46,0.64,0.46,0.47,-0.06,-11.32,361000,34,193240,0,0,0,0,0,0,114000,274000,-160000,-160000
20200316,057674,台郡元大99購03,0.64,0.64,0.64,0.64,+0.11,20.75,10000,1,6400,0,0,0,0,0,0,0,10000,-10000,-10000
20200316,057675,同欣電元大98購02,0.49,0.53,0.48,0.48,+0.07,17.07,53000,5,27140,0,0,0,0,0,0,40000,13000,27000,27000
20200316,057676,臺股指元大98購06,0.50,0.50,0.35,0.35,+0.05,16.67,31000,4,12200,0,0,0,0,0,0,11000,0,11000,11000
20200316,057677,臺股指元大98購07,,,,,0.00,0.00,0,0,0,0,0,0,0,0,0,0,0,0,0
20200316,057678,臺股指元大98購08,0.12,0.12,0.12,0.12,-0.01,-7.69,51000,1,6120,0,0,0,0,0,0,51000,0,51000,51000
20200316,057679,臺股指元大98購09,0.15,0.15,0.13,0.13,-0.04,-23.53,507000,5,74070,0,0,0,0,0,0,507000,0,507000,507000
20200316,05767P,國巨凱基96售11,1.20,2.50,1.20,2.50,+1.14,83.82,622000,66,941480,0,0,0,0,0,0,115000,581000,-466000,-466000
20200316,057680,臺股指元大98購10,,,,,0.00,0.00,0,0,0,0,0,0,0,0,0,0,0,0,0
20200316,057681,T50反1日盛9C購01,,,,,0.00,0.00,0,0,0,0,0,0,0,0,0,0,0,0,0
20200316,057682,台積電日盛9A購03,0.43,0.43,0.29,0.29,-0.27,-48.21,260000,5,80000,0,0,0,0,0,0,230000,0,230000,230000
20200316,057683,技嘉日盛98購01,0.33,0.33,0.33,0.33,0.00,0.00,5000,1,1650,0,0,0,0,0,0,0,5000,-5000,-5000
20200316,057684,聯茂日盛99購01,1.10,1.10,1.10,1.10,-0.04,-3.51,20000,1,22000,0,0,0,0,0,0,20000,0,20000,20000
20200316,057685,台灣50凱基9C購01,0.31,0.31,0.23,0.24,-0.10,-29.41,100000,11,25800,0,0,0,0,0,0,0,70000,-70000,-70000
20200316,057686,中50凱基99購01,0.45,0.47,0.45,0.45,0.00,0.00,75000,6,33970,0,0,0,0,0,0,60000,15000,45000,45000
20200316,057687,中502X凱基98購01,0.10,0.10,0.10,0.10,0.00,0.00,11000,3,1100,0,0,0,0,0,0,0,11000,-11000,-11000
20200316,057688,國巨凱基99購07,,,,,0.00,0.00,0,0,0,0,0,0,0,0,0,0,0,0,0
20200316,057689,南亞科凱基99購02,0.12,0.12,0.12,0.12,0.00,0.00,102000,1,12240,0,0,0,0,0,0,102000,0,102000,102000
20200316,05768P,台積電凱基96售15,,,,,0.00,0.00,0,0,0,0,0,0,0,0,0,0,0,0,0
20200316,057690,美律凱基99購03,0.60,0.60,0.47,0.47,-0.05,-9.62,32000,5,17240,0,0,0,0,0,0,22000,22000,0,0
20200316,057691,健策凱基99購01,0.23,0.23,0.23,0.23,+0.04,21.05,20000,1,4600,0,0,0,0,0,0,20000,0,20000,20000
20200316,057692,臺股指凱基98購10,0.16,0.16,0.12,0.12,-0.02,-14.29,184000,14,25950,0,0,0,0,0,0,0,0,0,0
20200316,057693,臺股指凱基98購11,0.05,0.05,0.03,0.05,+0.02,66.67,254000,13,12320,60000,0,60000,0,0,0,0,0,0,60000
20200316,057694,臺股指凱基98購12,0.05,0.05,0.05,0.05,-0.05,-50.0,30000,3,1500,0,0,0,0,0,0,0,0,0,0
20200316,057695,S&P反1群益9B購01,,,,,0.00,0.00,0,0,0,0,0,0,0,0,0,0,0,0,0
20200316,057696,聯電群益9A購01,,,,,0.00,0.00,0,0,0,0,0,0,0,0,0,0,0,0,0
20200316,057697,國巨群益98購09,0.31,0.35,0.20,0.20,-0.15,-42.86,1269000,6,356590,0,0,0,0,0,0,564000,705000,-141000,-141000
20200316,057698,奇力新群益98購02,,,,,0.00,0.00,0,0,0,0,0,0,0,0,0,0,0,0,0
20200316,057699,可成群益9A購02,,,,,0.00,0.00,0,0,0,0,0,0,0,0,0,0,0,0,0
20200316,05769P,台積電凱基96售16,5.80,6.80,5.80,6.80,+0.55,8.8,195000,31,1224650,0,0,0,0,0,0,195000,195000,0,0
20200316,057700,新日興群益9A購01,,,,,0.00,0.00,0,0,0,0,0,0,0,0,0,0,0,0,0
20200316,057701,嘉聯益群益98購02,,,,,0.00,0.00,0,0,0,0,0,0,0,0,0,0,0,0,0
20200316,057702,同欣電群益99購01,0.16,0.16,0.13,0.13,-0.08,-38.1,13000,2,2020,0,0,0,0,0,0,0,13000,-13000,-13000
20200316,057703,矽力群益98購01,0.39,0.39,0.31,0.31,-0.14,-31.11,108000,6,34660,0,0,0,0,0,0,0,108000,-108000,-108000
20200316,057704,台虹群益98購03,,,,,0.00,0.00,0,0,0,0,0,0,0,0,0,0,0,0,0
20200316,057705,臺股指群益98購05,,,,,0.00,0.00,0,0,0,0,0,0,0,0,0,0,0,0,0
20200316,057706,臺股指群益98購06,,,,,0.00,0.00,0,0,0,0,0,0,0,0,0,0,0,0,0
20200316,057707,臺股指群益98購07,,,,,0.00,0.00,0,0,0,0,0,0,0,0,0,0,0,0,0
20200316,057708,臺股指群益98購08,,,,,0.00,0.00,0,0,0,0,0,0,0,0,0,0,0,0,0
20200316,057709,電子類群益98購01,0.33,0.33,0.22,0.23,-0.20,-46.51,1252000,36,356830,0,0,0,0,0,0,338000,0,338000,338000
20200316,05770P,聯發科凱基96售16,2.05,3.17,2.05,3.17,+1.38,77.09,385000,7,869330,0,0,0,0,0,0,370000,15000,355000,355000
20200316,057710,金融類群益98購01,0.19,0.19,0.13,0.13,0.00,0.00,810000,11,132700,0,0,0,0,0,0,790000,0,790000,790000
20200316,057711,台積電統一9A購03,0.26,0.26,0.26,0.26,+0.01,4.0,20000,2,5200,0,0,0,0,0,0,0,20000,-20000,-20000
20200316,057712,南亞科統一9A購01,,,,,0.00,0.00,0,0,0,0,0,0,0,0,0,0,0,0,0
20200316,057713,美律統一99購01,0.49,0.49,0.49,0.49,+0.08,19.51,4000,1,1960,0,0,0,0,0,0,4000,0,4000,4000
20200316,057714,聯發科統一98購05,,,,,0.00,0.00,0,0,0,0,0,0,0,0,0,0,0,0,0
20200316,057715,聯發科統一99購03,0.47,0.47,0.47,0.47,+0.13,38.24,50000,1,23500,0,0,0,0,0,0,0,0,0,0
20200316,057716,神達統一98購01,,,,,0.00,0.00,0,0,0,0,0,0,0,0,0,0,0,0,0
20200316,057717,友訊元富98購02,0.26,0.26,0.22,0.22,0.00,0.00,90000,8,22200,0,0,0,0,0,0,10000,60000,-50000,-50000
20200316,057718,旺宏元富02購02,0.63,0.63,0.59,0.60,+0.06,11.11,171000,6,106660,0,0,0,0,0,0,111000,60000,51000,51000
20200316,057719,欣興元富02購01,0.50,0.50,0.33,0.33,-0.10,-23.26,387000,22,175360,0,0,0,0,0,0,278000,109000,169000,169000
20200316,05771P,大立光凱基96售13,,,,,0.00,0.00,0,0,0,0,0,0,0,0,0,0,0,0,0
20200316,057720,日電貿元富98購01,,,,,0.00,0.00,0,0,0,0,0,0,0,0,0,0,0,0,0
20200316,057721,華擎元富98購02,0.50,0.63,0.49,0.49,+0.06,13.95,251000,28,141810,0,0,0,0,0,0,54000,195000,-141000,-141000
20200316,057722,臺股指元富98購01,,,,,0.00,0.00,0,0,0,0,0,0,0,0,0,0,0,0,0
20200316,057723,臺股指元富98購02,0.11,0.11,0.05,0.05,-0.06,-54.55,258000,8,18880,0,0,0,0,0,0,0,10000,-10000,-10000
20200316,057724,亞德客國泰99購01,0.60,0.68,0.52,0.52,+0.05,10.64,1539000,14,991120,0,0,0,0,0,0,467000,1072000,-605000,-605000
20200316,057725,台達電國泰9A購01,0.59,0.59,0.48,0.48,-0.03,-5.88,176000,4,102740,0,0,0,0,0,0,156000,20000,136000,136000
20200316,057726,華通國泰9A購01,0.21,0.21,0.21,0.21,0.00,0.00,100000,1,21000,0,0,0,0,0,0,100000,0,100000,100000
20200316,057727,華邦電國泰9A購01,0.89,0.90,0.60,0.60,-0.24,-28.57,193000,8,151010,0,0,0,0,0,0,110000,83000,27000,27000
20200316,057728,瑞昱國泰99購01,0.47,0.47,0.33,0.33,-0.14,-29.79,330000,3,112300,0,0,0,0,0,0,330000,0,330000,330000
20200316,057729,華新科國泰99購04,,,,,0.00,0.00,0,0,0,0,0,0,0,0,0,0,0,0,0
20200316,05772P,景碩凱基96售02,1.36,1.75,1.36,1.75,+0.27,18.24,305000,8,461330,0,0,0,0,0,0,275000,195000,80000,80000
20200316,057730,聯鈞國泰9A購01,,,,,0.00,0.00,0,0,0,0,0,0,0,0,0,0,0,0,0
20200316,057731,華擎國泰9A購02,,,,,0.00,0.00,0,0,0,0,0,0,0,0,0,0,0,0,0
20200316,057732,牧德國泰9A購01,0.47,0.47,0.33,0.33,-0.19,-36.54,188000,3,87280,0,0,0,0,0,0,180000,8000,172000,172000
20200316,057733,嘉聯益國泰99購01,0.56,0.56,0.50,0.50,+0.03,6.38,20000,2,10600,0,0,0,0,0,0,10000,10000,0,0
20200316,057734,訊芯國泰9A購01,0.42,0.46,0.30,0.30,-0.10,-25.0,354000,12,137960,0,0,0,0,0,0,233000,121000,112000,112000
20200316,057735,台灣50富邦9C購02,0.65,0.65,0.46,0.46,-0.08,-14.81,112000,19,63540,0,0,0,0,0,0,0,94000,-94000,-94000
20200316,057736,鴻海富邦99購04,,,,,0.00,0.00,0,0,0,0,0,0,0,0,0,0,0,0,0
20200316,057737,國巨富邦99購02,0.20,0.21,0.12,0.15,-0.05,-25.0,290000,26,44290,0,0,0,0,0,0,0,38000,-38000,-38000
20200316,057738,旺宏富邦9A購01,,,,,0.00,0.00,0,0,0,0,0,0,0,0,0,0,0,0,0
20200316,057739,新日興富邦9B購01,,,,,0.00,0.00,0,0,0,0,0,0,0,0,0,0,0,0,0
20200316,05773P,臺股指凱基99售03,4.57,5.65,4.57,5.60,+1.07,23.62,236000,28,1163130,0,0,0,0,0,0,213000,203000,10000,10000
20200316,057740,茂林富邦9A購01,0.24,0.24,0.18,0.20,-0.02,-9.09,831000,13,158280,0,0,0,0,0,0,694000,67000,627000,627000
20200316,057741,超眾富邦98購01,,,,,0.00,0.00,0,0,0,0,0,0,0,0,0,0,0,0,0
20200316,057742,喬山永豐98購02,,,,,0.00,0.00,0,0,0,0,0,0,0,0,0,0,0,0,0
20200316,057743,華擎永豐98購03,0.26,0.26,0.26,0.26,+0.05,23.81,30000,1,7800,0,0,0,0,0,0,0,30000,-30000,-30000
20200316,057744,健策永豐98購02,0.08,0.08,0.08,0.08,0.00,0.00,15000,1,1200,0,0,0,0,0,0,0,15000,-15000,-15000
20200316,057745,泰鼎永豐99購01,0.32,0.32,0.30,0.30,-0.01,-3.23,50000,3,15300,0,0,0,0,0,0,30000,20000,10000,10000
20200316,057746,同欣電永豐98購02,,,,,0.00,0.00,0,0,0,0,0,0,0,0,0,0,0,0,0
20200316,057747,致新永豐98購01,,,,,0.00,0.00,0,0,0,0,0,0,0,0,0,0,0,0,0
20200316,057748,華通國票98購04,0.48,0.48,0.48,0.48,+0.10,26.32,10000,1,4800,0,0,0,0,0,0,10000,0,10000,10000
20200316,057749,華新科國票99購01,0.38,0.38,0.19,0.21,-0.08,-27.59,1789000,9,387410,0,0,0,0,0,0,1785000,0,1785000,1785000
20200316,05774P,臺股指凱基99售04,4.77,5.60,4.70,5.55,+0.83,17.58,46000,9,232930,0,0,0,0,0,0,21000,13000,8000,8000
20200316,057750,神達國票99購01,0.38,0.38,0.34,0.34,-0.07,-17.07,122000,2,42360,0,0,0,0,0,0,122000,0,122000,122000
20200316,057751,神達國票99購02,2.01,2.09,1.70,1.70,-0.36,-17.48,98000,5,195820,0,0,0,0,0,0,97000,1000,96000,96000
20200316,057752,臺股指國票98購08,0.10,0.10,0.10,0.10,0.00,0.00,12000,1,1200,0,0,0,0,0,0,12000,0,12000,12000
20200316,057753,臺股指國票98購09,,,,,0.00,0.00,0,0,0,0,0,0,0,0,0,0,0,0,0
20200316,057754,臺股指國票98購10,,,,,0.00,0.00,0,0,0,0,0,0,0,0,0,0,0,0,0
20200316,057755,鴻海日盛98購01,,,,,0.00,0.00,0,0,0,0,0,0,0,0,0,0,0,0,0
20200316,057756,瑞昱日盛99購01,,,,,0.00,0.00,0,0,0,0,0,0,0,0,0,0,0,0,0
20200316,057757,鴻海凱基98購13,0.99,1.02,0.70,0.76,-0.32,-29.63,453000,18,379650,0,0,0,0,0,0,453000,63000,390000,390000
20200316,057758,鴻海凱基99購03,0.44,0.44,0.44,0.44,+0.10,29.41,30000,1,13200,0,0,0,0,0,0,30000,0,30000,30000
20200316,057759,聯發科凱基98購17,0.92,1.01,0.63,0.63,-0.37,-37.0,121000,8,108830,0,0,0,0,0,0,71000,50000,21000,21000
20200316,05775P,台積電國泰98售02,3.32,3.32,3.32,3.32,+0.24,7.79,3000,1,9960,0,0,0,0,0,0,3000,0,3000,3000
20200316,057760,聯發科凱基98購18,,,,,0.00,0.00,0,0,0,0,0,0,0,0,0,0,0,0,0
20200316,057761,聯發科凱基99購04,,,,,0.00,0.00,0,0,0,0,0,0,0,0,0,0,0,0,0
20200316,057762,全新凱基99購03,,,,,0.00,0.00,0,0,0,0,0,0,0,0,0,0,0,0,0
20200316,057763,康控凱基99購02,0.24,0.24,0.17,0.17,+0.03,21.43,15000,2,2900,0,0,0,0,0,0,15000,0,15000,15000
20200316,057764,台表科凱基9A購01,0.35,0.35,0.15,0.15,0.00,0.00,126000,14,21350,0,0,0,0,0,0,0,126000,-126000,-126000
20200316,057765,康舒凱基98購01,,,,,0.00,0.00,0,0,0,0,0,0,0,0,0,0,0,0,0
20200316,057766,矽力凱基98購03,1.22,1.22,0.93,0.93,-0.17,-15.45,305000,3,370650,0,0,0,0,0,0,200000,105000,95000,95000
20200316,057767,緯穎凱基98購06,0.72,0.73,0.72,0.73,+0.32,78.05,35000,2,25400,0,0,0,0,0,0,35000,0,35000,35000
20200316,057768,華新科中信9A購01,,,,,0.00,0.00,0,0,0,0,0,0,0,0,0,0,0,0,0
20200316,057769,T50反1群益98購02,1.87,1.87,1.87,1.87,+0.13,7.47,2000,1,3740,0,0,0,0,0,0,0,2000,-2000,-2000
20200316,05776P,鴻海統一98售02,3.51,3.85,3.51,3.85,-0.23,-5.64,43000,5,164610,0,0,0,0,0,0,13000,30000,-17000,-17000
20200316,057770,亞德客群益98購01,0.55,0.55,0.44,0.44,+0.01,2.33,60000,2,31900,0,0,0,0,0,0,50000,10000,40000,40000
20200316,057771,鴻海群益99購01,1.83,1.87,1.42,1.42,-0.43,-23.24,38000,11,61410,0,0,0,0,0,0,22000,23000,-1000,-1000
20200316,057772,台積電群益99購01,1.59,1.59,1.21,1.29,-0.49,-27.53,44000,6,57390,0,0,0,0,0,0,20000,24000,-4000,-4000
20200316,057773,技嘉群益9A購02,,,,,0.00,0.00,0,0,0,0,0,0,0,0,0,0,0,0,0
20200316,057774,台光電群益99購02,,,,,0.00,0.00,0,0,0,0,0,0,0,0,0,0,0,0,0
20200316,057775,南亞科群益98購02,,,,,0.00,0.00,0,0,0,0,0,0,0,0,0,0,0,0,0
20200316,057776,京元電群益98購02,1.23,1.23,1.09,1.09,+0.20,22.47,30000,2,35500,0,0,0,0,0,0,20000,10000,10000,10000
20200316,057777,可成群益9A購03,0.47,0.47,0.47,0.47,+0.11,30.56,3000,1,1410,0,0,0,0,0,0,3000,0,3000,3000
20200316,057778,大立光群益98購02,0.73,0.73,0.73,0.73,+0.04,5.8,10000,1,7300,0,0,0,0,0,0,10000,0,10000,10000
20200316,057779,禾伸堂群益98購02,,,,,0.00,0.00,0,0,0,0,0,0,0,0,0,0,0,0,0
20200316,05777P,台積電統一96售04,,,,,0.00,0.00,0,0,0,0,0,0,0,0,0,0,0,0,0
20200316,057780,台郡群益98購02,,,,,0.00,0.00,0,0,0,0,0,0,0,0,0,0,0,0,0
20200316,057781,國巨國票99購04,0.27,0.28,0.27,0.28,0.00,0.00,505000,2,136410,0,0,0,0,0,0,505000,0,505000,505000
20200316,057782,台積電國票99購07,0.79,0.80,0.67,0.67,-0.33,-33.0,153000,15,109180,0,0,0,0,0,0,9000,58000,-49000,-49000
20200316,057783,台積電國票9A購01,0.64,0.65,0.55,0.55,+0.15,37.5,25000,3,15200,0,0,0,0,0,0,5000,20000,-15000,-15000
20200316,057784,台積電國票9B購01,0.59,0.59,0.26,0.26,-0.34,-56.67,390000,31,145410,0,0,0,0,0,0,215000,67000,148000,148000
20200316,057785,智邦國票99購02,,,,,0.00,0.00,0,0,0,0,0,0,0,0,0,0,0,0,0
20200316,057786,聯發科國票98購05,0.50,0.50,0.21,0.21,-0.40,-65.57,858000,22,297100,0,0,0,0,0,0,587000,7000,580000,580000
20200316,057787,TPK國票99購01,0.43,0.43,0.31,0.31,-0.09,-22.5,146000,12,50180,0,0,0,0,0,0,41000,105000,-64000,-64000
20200316,057788,嘉聯益國票99購01,0.44,0.44,0.37,0.37,0.00,0.00,60000,6,24300,0,0,0,0,0,0,0,60000,-60000,-60000
20200316,057789,上銀統一9A購01,,,,,0.00,0.00,0,0,0,0,0,0,0,0,0,0,0,0,0
20200316,05778P,台積電統一96售05,4.96,4.96,4.96,4.96,-0.79,-13.74,20000,2,99200,0,0,0,0,0,0,20000,0,20000,20000
20200316,057790,台積電統一99購04,0.14,0.14,0.14,0.14,-0.16,-53.33,10000,1,1400,0,0,0,0,0,0,10000,0,10000,10000
20200316,057791,可成統一99購01,0.12,0.12,0.12,0.12,+0.04,50.0,20000,1,2400,0,0,0,0,0,0,20000,0,20000,20000
20200316,057792,群創統一99購01,,,,,0.00,0.00,0,0,0,0,0,0,0,0,0,0,0,0,0
20200316,057793,群創統一99購02,,,,,0.00,0.00,0,0,0,0,0,0,0,0,0,0,0,0,0
20200316,057794,T50反1兆豐99購02,,,,,0.00,0.00,0,0,0,0,0,0,0,0,0,0,0,0,0
20200316,057795,鴻海兆豐99購02,0.39,0.39,0.33,0.33,-0.06,-15.38,30000,4,10650,0,0,0,0,0,0,15000,15000,0,0
20200316,057796,鴻海兆豐99購03,0.39,0.39,0.36,0.36,-0.10,-21.74,23000,6,8770,0,0,0,0,0,0,10000,13000,-3000,-3000
20200316,057797,大立光兆豐99購01,,,,,0.00,0.00,0,0,0,0,0,0,0,0,0,0,0,0,0
20200316,057798,貿聯兆豐99購01,0.28,0.28,0.23,0.23,-0.09,-28.12,103000,2,23840,0,0,0,0,0,0,0,103000,-103000,-103000
20200316,057799,世紀鋼兆豐98購01,1.51,2.07,1.33,1.34,+0.02,1.52,1786000,109,2552420,0,0,0,0,0,0,1562000,209000,1353000,1353000
20200316,05779P,台積電統一96售06,4.47,4.47,4.47,4.47,+0.17,3.95,120000,12,536400,0,0,0,0,0,0,120000,120000,0,0
20200316,057800,元油2X元大98購18,,,,,0.00,0.00,0,0,0,0,0,0,0,0,0,0,0,0,0
20200316,057801,元油2X元大98購19,,,,,0.00,0.00,0,0,0,0,0,0,0,0,0,0,0,0,0
20200316,057802,卜蜂元大98購01,1.15,1.15,1.12,1.12,+0.19,20.43,115000,13,131160,0,0,0,0,0,0,0,115000,-115000,-115000
20200316,057803,上銀元大98購08,,,,,0.00,0.00,0,0,0,0,0,0,0,0,0,0,0,0,0
20200316,057804,為升元大98購01,0.28,0.29,0.19,0.19,-0.13,-40.62,103000,8,26940,4000,0,4000,0,0,0,94000,9000,85000,89000
20200316,057805,華通元大98購06,0.99,0.99,0.99,0.99,0.00,0.00,10000,1,9900,0,0,0,0,0,0,0,10000,-10000,-10000
20200316,057806,國巨元大98購20,0.48,0.54,0.30,0.31,-0.19,-38.0,1338000,153,604920,0,0,0,0,0,0,64000,1258000,-1194000,-1194000
20200316,057807,友訊元大98購02,0.53,0.53,0.48,0.48,+0.02,4.35,38000,5,19140,0,0,0,0,0,0,15000,23000,-8000,-8000
20200316,057808,旺宏元大99購05,,,,,0.00,0.00,0,0,0,0,0,0,0,0,0,0,0,0,0
20200316,057809,英業達元大98購01,1.21,1.21,1.01,1.01,-0.04,-3.81,95000,8,105150,0,0,0,0,0,0,60000,35000,25000,25000
20200316,05780P,台積電統一96售07,2.92,3.20,2.92,3.20,+0.41,14.7,10000,2,30600,0,0,0,0,0,0,10000,0,10000,10000
20200316,057810,技嘉元大98購06,,,,,0.00,0.00,0,0,0,0,0,0,0,0,0,0,0,0,0
20200316,057811,南亞科元大98購08,0.43,0.43,0.31,0.32,-0.06,-15.79,55000,5,20950,0,0,0,0,0,0,25000,30000,-5000,-5000
20200316,057812,友達元大9A購05,,,,,0.00,0.00,0,0,0,0,0,0,0,0,0,0,0,0,0
20200316,057813,京元電元大98購03,1.21,1.23,1.02,1.07,-0.18,-14.4,234000,24,254310,0,0,0,0,0,0,84000,200000,-116000,-116000
20200316,057814,聯發科元大98購12,1.06,1.14,0.79,0.79,-0.40,-33.61,972000,89,972490,0,0,0,0,0,0,270000,815000,-545000,-545000
20200316,057815,信邦元大98購01,0.92,0.92,0.76,0.76,-0.17,-18.28,190000,6,154000,0,0,0,0,0,0,170000,20000,150000,150000
20200316,057816,欣興元大98購13,,,,,0.00,0.00,0,0,0,0,0,0,0,0,0,0,0,0,0
20200316,057817,景碩元大98購01,1.09,1.09,0.77,0.77,-0.11,-12.5,23000,5,21660,0,0,0,0,0,0,13000,10000,3000,3000
20200316,057818,泰碩元大9A購01,2.54,2.61,1.94,1.94,-0.42,-17.8,259000,32,609960,0,0,0,0,0,0,135000,138000,-3000,-3000
20200316,057819,新日興元大99購01,0.74,0.77,0.74,0.77,+0.14,22.22,22000,3,16640,0,0,0,0,0,0,0,22000,-22000,-22000
20200316,05781P,臺股指統一99售02,,,,,0.00,0.00,0,0,0,0,0,0,0,0,0,0,0,0,0
20200316,057820,華擎元大98購02,0.41,0.41,0.41,0.41,-0.01,-2.38,10000,1,4100,0,0,0,0,0,0,10000,0,10000,10000
20200316,057821,晶相光元大98購03,0.77,0.77,0.77,0.77,-0.03,-3.75,90000,2,69300,0,0,0,0,0,0,25000,0,25000,25000
20200316,057822,牧德元大9A購01,,,,,0.00,0.00,0,0,0,0,0,0,0,0,0,0,0,0,0
20200316,057823,神達元大98購01,1.01,1.15,0.43,1.00,-0.12,-10.71,203000,24,217240,0,0,0,0,0,0,158000,47000,111000,111000
20200316,057824,日月光元大98購01,0.74,0.76,0.66,0.66,-0.13,-16.46,75000,8,52950,0,0,0,0,0,0,55000,20000,35000,35000
20200316,057825,和碩元大98購02,0.71,0.77,0.60,0.60,-0.14,-18.92,167000,12,117980,0,0,0,0,0,0,167000,0,167000,167000
20200316,057826,祥碩元大98購08,0.96,0.98,0.76,0.79,-0.25,-24.04,353000,33,319750,0,0,0,0,0,0,313000,71000,242000,242000
20200316,057827,康友元大98購03,0.74,0.74,0.57,0.57,-0.19,-25.0,33000,4,22370,0,0,0,0,0,0,13000,20000,-7000,-7000
20200316,057828,緯穎元大99購02,1.48,1.48,1.37,1.38,+0.48,53.33,60000,4,84000,0,0,0,0,0,0,50000,20000,30000,30000
20200316,057829,臺股指元大98購12,,,,,0.00,0.00,0,0,0,0,0,0,0,0,0,0,0,0,0
20200316,05782P,聯詠元富96售02,1.82,2.00,1.70,2.00,+0.34,20.48,203000,13,376500,0,0,0,0,0,0,71000,132000,-61000,-61000
20200316,057830,T50反1台新02購02,,,,,0.00,0.00,0,0,0,0,0,0,0,0,0,0,0,0,0
20200316,057831,聯發科元富02購04,0.86,0.86,0.70,0.70,-0.13,-15.66,109000,8,87150,0,0,0,0,0,0,6000,103000,-97000,-97000
20200316,057832,聯發科元富02購05,,,,,0.00,0.00,0,0,0,0,0,0,0,0,0,0,0,0,0
20200316,057833,聯發科元富02購06,0.78,0.78,0.68,0.68,-0.14,-17.07,370000,3,279600,0,0,0,0,0,0,360000,10000,350000,350000
20200316,057834,聯發科元富02購07,,,,,0.00,0.00,0,0,0,0,0,0,0,0,0,0,0,0,0
20200316,057835,華擎元富9B購01,0.85,0.99,0.85,0.89,+0.20,28.99,44000,9,41210,0,0,0,0,0,0,6000,38000,-32000,-32000
20200316,057836,南亞科國泰9A購01,,,,,0.00,0.00,0,0,0,0,0,0,0,0,0,0,0,0,0
20200316,057837,康控國泰99購02,,,,,0.00,0.00,0,0,0,0,0,0,0,0,0,0,0,0,0
20200316,057838,台郡國泰99購01,0.88,0.90,0.71,0.71,-0.16,-18.39,612000,7,545440,0,0,0,0,0,0,118000,509000,-391000,-391000
20200316,057839,台積電富邦9A購02,,,,,0.00,0.00,0,0,0,0,0,0,0,0,0,0,0,0,0
20200316,05783P,嘉澤元富96售01,2.35,2.89,2.31,2.78,+0.29,11.65,127000,27,323760,0,0,0,0,0,0,96000,31000,65000,65000
20200316,057840,健策富邦99購01,0.09,0.09,0.08,0.08,-0.06,-42.86,380000,4,31900,0,0,0,0,0,0,380000,0,380000,380000
20200316,057841,茂林富邦9A購02,0.22,0.22,0.16,0.16,-0.08,-33.33,15000,2,2700,0,0,0,0,0,0,10000,5000,5000,5000
20200316,057842,緯穎富邦99購02,0.42,0.42,0.36,0.36,-0.07,-16.28,594000,9,245970,0,0,0,0,0,0,393000,201000,192000,192000
20200316,057843,晶技永豐98購02,,,,,0.00,0.00,0,0,0,0,0,0,0,0,0,0,0,0,0
20200316,057844,新日興永豐99購01,,,,,0.00,0.00,0,0,0,0,0,0,0,0,0,0,0,0,0
20200316,057845,晶相光永豐98購03,0.21,0.21,0.13,0.13,-0.09,-40.91,520000,27,81400,0,0,0,0,0,0,260000,260000,0,0
20200316,057846,神達永豐98購01,,,,,0.00,0.00,0,0,0,0,0,0,0,0,0,0,0,0,0
20200316,057847,聯茂永豐98購01,0.46,0.47,0.43,0.44,-0.02,-4.35,91000,6,40490,0,0,0,0,0,0,0,91000,-91000,-91000
20200316,057848,台表科永豐98購02,,,,,0.00,0.00,0,0,0,0,0,0,0,0,0,0,0,0,0
20200316,057849,南茂永豐98購02,,,,,0.00,0.00,0,0,0,0,0,0,0,0,0,0,0,0,0
20200316,05784P,臺股指元大96售18,,,,,0.00,0.00,0,0,0,0,0,0,0,0,0,0,0,0,0
20200316,057850,上銀兆豐99購02,0.08,0.08,0.08,0.08,-0.04,-33.33,25000,2,2000,0,0,0,0,0,0,0,25000,-25000,-25000
20200316,057851,鴻海國票99購06,0.11,0.11,0.10,0.10,-0.05,-33.33,444000,23,45750,0,0,0,0,0,0,294000,150000,144000,144000
20200316,057852,國巨國票99購05,0.48,0.48,0.48,0.48,+0.01,2.13,7000,1,3360,0,0,0,0,0,0,7000,0,7000,7000
20200316,057853,旺宏國票99購05,,,,,0.00,0.00,0,0,0,0,0,0,0,0,0,0,0,0,0
20200316,057854,聯發科國票99購03,0.95,0.95,0.95,0.95,-0.13,-12.04,10000,1,9500,0,0,0,0,0,0,10000,10000,0,0
20200316,057855,晶技國票99購01,2.02,2.12,1.99,2.12,+0.35,19.77,511000,14,1032370,0,0,0,0,0,0,511000,0,511000,511000
20200316,057856,聯鈞國票99購03,,,,,0.00,0.00,0,0,0,0,0,0,0,0,0,0,0,0,0
20200316,057857,牧德國票99購01,0.27,0.28,0.27,0.27,-0.14,-34.15,30000,3,8200,0,0,0,0,0,0,0,30000,-30000,-30000
20200316,057858,T50正2康和98購01,0.13,0.13,0.12,0.12,+0.01,9.09,40000,4,5000,0,0,0,0,0,0,0,40000,-40000,-40000
20200316,057859,神達康和98購01,1.13,1.15,1.13,1.15,-0.01,-0.86,16000,2,18320,0,0,0,0,0,0,16000,16000,0,0
20200316,05785P,臺股指元大96售19,,,,,0.00,0.00,0,0,0,0,0,0,0,0,0,0,0,0,0
20200316,057860,金寶凱基98購01,0.30,0.30,0.22,0.22,-0.05,-18.52,20000,2,5200,0,0,0,0,0,0,0,20000,-20000,-20000
20200316,057861,台積電凱基98購16,0.46,0.46,0.46,0.46,-0.19,-29.23,10000,1,4600,0,0,0,0,0,0,10000,0,10000,10000
20200316,057862,智邦凱基99購01,0.77,0.79,0.62,0.62,-0.16,-20.51,164000,24,112410,0,0,0,0,0,0,22000,137000,-115000,-115000
20200316,057863,美律凱基9A購01,0.52,0.52,0.52,0.52,+0.08,18.18,20000,1,10400,0,0,0,0,0,0,20000,0,20000,20000
20200316,057864,奇力新凱基99購03,0.36,0.36,0.24,0.24,-0.02,-7.69,550000,11,137050,0,0,0,0,0,0,475000,55000,420000,420000
20200316,057865,富邦金凱基98購01,0.24,0.24,0.22,0.22,0.00,0.00,130000,4,30900,0,0,0,0,0,0,0,130000,-130000,-130000
20200316,057866,玉山金凱基98購01,0.27,0.32,0.23,0.23,-0.13,-36.11,76000,6,20670,0,0,0,0,0,0,10000,66000,-56000,-56000
20200316,057867,大立光凱基98購17,,,,,0.00,0.00,0,0,0,0,0,0,0,0,0,0,0,0,0
20200316,057868,大立光凱基98購18,,,,,0.00,0.00,0,0,0,0,0,0,0,0,0,0,0,0,0
20200316,057869,大立光凱基99購01,,,,,0.00,0.00,0,0,0,0,0,0,0,0,0,0,0,0,0
20200316,05786P,臺股指永昌96售03,43.00,45.00,43.00,44.00,+16.00,57.14,32000,8,1408000,0,0,0,0,0,0,32000,32000,0,0
20200316,057870,大立光凱基99購02,1.30,1.31,0.92,0.92,-0.03,-3.16,233000,11,285900,0,0,0,0,0,0,203000,30000,173000,173000
20200316,057871,國巨元大99購09,0.46,0.47,0.32,0.32,0.00,0.00,97000,11,36580,0,0,0,0,0,0,42000,55000,-13000,-13000
20200316,057872,旺宏元大99購06,0.87,0.89,0.87,0.89,+0.23,34.85,20000,2,17600,0,0,0,0,0,0,0,20000,-20000,-20000
20200316,057873,義隆元大98購03,1.47,1.61,1.47,1.61,+0.25,18.38,20000,2,30800,0,0,0,0,0,0,10000,10000,0,0
20200316,057874,可成元大99購02,0.69,0.72,0.68,0.69,0.00,0.00,60000,6,41700,0,0,0,0,0,0,60000,10000,50000,50000
20200316,057875,京鼎元大98購03,0.32,0.33,0.22,0.22,-0.11,-33.33,225000,4,72000,0,0,0,0,0,0,200000,25000,175000,175000
20200316,057876,隆達元大98購01,0.51,0.51,0.51,0.51,-0.12,-19.05,10000,1,5100,0,0,0,0,0,0,0,10000,-10000,-10000
20200316,057877,神達元大99購01,1.52,1.72,1.52,1.72,+0.02,1.18,79000,8,127610,0,0,0,0,0,0,79000,3000,76000,76000
20200316,057878,台郡元大99購04,1.29,1.29,1.29,1.29,+0.19,17.27,10000,1,12900,0,0,0,0,0,0,10000,0,10000,10000
20200316,057879,電子類元大99購02,0.56,0.58,0.42,0.42,-0.21,-33.33,351000,36,162050,0,0,0,0,0,0,0,351000,-351000,-351000
20200316,05787P,臺股指永昌96售04,44.00,45.00,44.00,45.00,+17.00,60.71,32000,9,1439000,0,0,0,0,0,0,32000,32000,0,0
20200316,057880,金融類元大99購02,0.25,0.25,0.19,0.19,-0.08,-29.63,895000,76,196450,0,0,0,0,0,0,150000,745000,-595000,-595000
20200316,057881,SP黃豆群益9A購01,,,,,0.00,0.00,0,0,0,0,0,0,0,0,0,0,0,0,0
20200316,057882,華通群益9A購03,,,,,0.00,0.00,0,0,0,0,0,0,0,0,0,0,0,0,0
20200316,057883,中環群益98購01,0.22,0.27,0.22,0.25,+0.07,38.89,197000,7,48390,0,0,0,0,0,0,32000,165000,-133000,-133000
20200316,057884,華邦電群益98購02,0.47,0.47,0.32,0.32,+0.02,6.67,27000,2,11190,0,0,0,0,0,0,17000,10000,7000,7000
20200316,057885,台光電群益98購04,,,,,0.00,0.00,0,0,0,0,0,0,0,0,0,0,0,0,0
20200316,057886,聯詠群益98購01,0.63,0.63,0.63,0.63,+0.04,6.78,20000,1,12600,0,0,0,0,0,0,20000,0,20000,20000
20200316,057887,智原群益98購04,0.22,0.22,0.22,0.22,0.00,0.00,10000,1,2200,0,0,0,0,0,0,0,10000,-10000,-10000
20200316,057888,貿聯群益98購02,,,,,0.00,0.00,0,0,0,0,0,0,0,0,0,0,0,0,0
20200316,057889,致新群益99購01,,,,,0.00,0.00,0,0,0,0,0,0,0,0,0,0,0,0,0
20200316,05788P,臺股指永昌96售05,45.00,58.00,45.00,58.00,+31.00,114.81,35000,7,1971000,0,0,0,0,0,0,34000,31000,3000,3000
20200316,057890,滬深反統一98購01,1.12,1.12,1.12,1.12,0.00,0.00,1000,1,1120,0,0,0,0,0,0,1000,0,1000,1000
20200316,057891,華新科統一9A購01,0.36,0.36,0.29,0.29,-0.15,-34.09,51000,3,16900,0,0,0,0,0,0,51000,0,51000,51000
20200316,057892,上証2X元富02購01,1.52,1.52,1.52,1.52,+0.34,28.81,5000,1,7600,0,0,0,0,0,0,5000,0,5000,5000
20200316,057893,亞德客元富98購03,0.61,0.70,0.61,0.61,+0.12,24.49,168000,11,108420,0,0,0,0,0,0,91000,77000,14000,14000
20200316,057894,華通元富02購02,0.73,0.73,0.66,0.66,+0.04,6.45,55000,2,39800,0,0,0,0,0,0,0,55000,-55000,-55000
20200316,057895,全新元富9B購01,,,,,0.00,0.00,0,0,0,0,0,0,0,0,0,0,0,0,0
20200316,057896,嘉晶元富98購01,2.04,2.10,1.91,2.06,+0.20,10.75,336000,39,681690,0,0,0,0,0,0,156000,180000,-24000,-24000
20200316,057897,華通富邦99購01,0.10,0.10,0.10,0.10,-0.01,-9.09,10000,1,1000,0,0,0,0,0,0,0,0,0,0
20200316,057898,元油2X永豐98購06,,,,,0.00,0.00,0,0,0,0,0,0,0,0,0,0,0,0,0
20200316,057899,台積電永豐98購04,0.30,0.30,0.30,0.30,-0.20,-40.0,5000,1,1500,0,0,0,0,0,0,0,5000,-5000,-5000
20200316,05789P,臺股指永昌96售06,40.00,53.00,40.00,53.00,+20.00,60.61,46000,12,2330000,0,0,0,0,0,0,45000,40000,5000,5000
20200316,057900,南亞科永豐98購01,,,,,0.00,0.00,0,0,0,0,0,0,0,0,0,0,0,0,0
20200316,057901,大立光永豐98購04,,,,,0.00,0.00,0,0,0,0,0,0,0,0,0,0,0,0,0
20200316,057902,嘉晶永豐98購02,0.79,0.85,0.61,0.61,-0.11,-15.28,309000,11,246890,220000,0,220000,0,0,0,14000,295000,-281000,-61000
20200316,057903,聯鈞永豐99購01,0.37,0.37,0.28,0.28,-0.10,-26.32,123000,9,43000,0,0,0,0,0,0,61000,62000,-1000,-1000
20200316,057904,矽力永豐98購01,,,,,0.00,0.00,0,0,0,0,0,0,0,0,0,0,0,0,0
20200316,057905,臺股指永豐98購06,,,,,0.00,0.00,0,0,0,0,0,0,0,0,0,0,0,0,0
20200316,057906,福懋科中信99購01,,,,,0.00,0.00,0,0,0,0,0,0,0,0,0,0,0,0,0
20200316,057907,台達電亞東99購01,,,,,0.00,0.00,0,0,0,0,0,0,0,0,0,0,0,0,0
20200316,057908,國泰金亞東99購01,0.33,0.33,0.33,0.33,0.00,0.00,10000,1,3300,0,0,0,0,0,0,0,10000,-10000,-10000
20200316,057909,台光電兆豐98購01,0.52,0.52,0.48,0.48,-0.02,-4.0,40000,3,20400,0,0,0,0,0,0,0,40000,-40000,-40000
20200316,05790P,臺股指永昌96售07,41.00,67.00,41.00,67.00,+38.90,138.43,54000,10,3192000,0,0,0,0,0,0,52000,30000,22000,22000
20200316,057910,華新科兆豐99購02,0.13,0.13,0.12,0.13,0.00,0.00,287000,6,36310,0,0,0,0,0,0,65000,222000,-157000,-157000
20200316,057911,國巨日盛98購01,0.16,0.16,0.16,0.16,0.00,0.00,17000,1,2720,0,0,0,0,0,0,17000,0,17000,17000
20200316,057912,美律日盛99購01,0.68,0.70,0.60,0.60,-0.03,-4.76,487000,18,317010,0,0,0,0,0,0,484000,0,484000,484000
20200316,057913,健策日盛98購01,,,,,0.00,0.00,0,0,0,0,0,0,0,0,0,0,0,0,0
20200316,057914,日月光日盛9A購01,0.30,0.30,0.30,0.30,-0.09,-23.08,16000,2,4800,0,0,0,0,0,0,1000,15000,-14000,-14000
20200316,057915,台泥凱基98購01,0.63,0.63,0.59,0.59,-0.08,-11.94,40000,2,24400,0,0,0,0,0,0,40000,0,40000,40000
20200316,057916,國巨凱基98購13,0.25,0.25,0.20,0.20,-0.05,-20.0,125000,2,30000,0,0,0,0,0,0,125000,0,125000,125000
20200316,057917,台積電凱基98購17,1.41,1.45,1.04,1.06,-0.11,-9.4,488000,21,619680,0,0,0,0,0,0,110000,378000,-268000,-268000
20200316,057918,旺宏凱基99購01,,,,,0.00,0.00,0,0,0,0,0,0,0,0,0,0,0,0,0
20200316,057919,技嘉凱基98購03,0.47,0.47,0.47,0.47,0.00,0.00,5000,1,2350,0,0,0,0,0,0,0,5000,-5000,-5000
20200316,05791P,臺股指中信99售06,3.47,4.50,3.44,4.50,+1.23,37.61,716000,70,2649560,0,0,0,0,0,0,630000,485000,145000,145000
20200316,057920,奇力新凱基98購08,,,,,0.00,0.00,0,0,0,0,0,0,0,0,0,0,0,0,0
20200316,057921,可成凱基98購09,,,,,0.00,0.00,0,0,0,0,0,0,0,0,0,0,0,0,0
20200316,057922,華新科凱基99購01,,,,,0.00,0.00,0,0,0,0,0,0,0,0,0,0,0,0,0
20200316,057923,晶豪科凱基98購02,0.62,0.62,0.44,0.44,-0.14,-24.14,111000,8,65370,0,0,0,0,0,0,70000,41000,29000,29000
20200316,057924,健策凱基98購02,0.22,0.22,0.21,0.21,+0.02,10.53,120000,3,25900,0,0,0,0,0,0,120000,0,120000,120000
20200316,057925,貿聯凱基99購01,0.37,0.37,0.33,0.33,0.00,0.00,30000,3,10600,0,0,0,0,0,0,0,30000,-30000,-30000
20200316,057926,帆宣凱基98購02,,,,,0.00,0.00,0,0,0,0,0,0,0,0,0,0,0,0,0
20200316,057927,勤誠凱基98購01,0.63,0.68,0.59,0.59,-0.01,-1.67,282000,10,186600,0,0,0,0,0,0,8000,274000,-266000,-266000
20200316,057928,鈺齊凱基98購02,,,,,0.00,0.00,0,0,0,0,0,0,0,0,0,0,0,0,0
20200316,057929,上銀群益98購02,,,,,0.00,0.00,0,0,0,0,0,0,0,0,0,0,0,0,0
20200316,05792P,臺股指中信99售07,4.18,4.41,4.18,4.41,-0.32,-6.77,27000,2,116310,0,0,0,0,0,0,27000,0,27000,27000
20200316,057930,旺宏群益99購04,1.58,1.70,1.58,1.65,+0.13,8.55,12000,3,19780,0,0,0,0,0,0,12000,12000,0,0
20200316,057931,正崴群益98購02,,,,,0.00,0.00,0,0,0,0,0,0,0,0,0,0,0,0,0
20200316,057932,美律群益98購04,0.69,0.69,0.60,0.60,+0.16,36.36,41000,2,25590,0,0,0,0,0,0,41000,0,41000,41000
20200316,057933,聯發科群益98購06,0.95,0.95,0.56,0.60,-0.18,-23.08,65000,7,48100,0,0,0,0,0,0,30000,35000,-5000,-5000
20200316,057934,華新科群益98購07,,,,,0.00,0.00,0,0,0,0,0,0,0,0,0,0,0,0,0
20200316,057935,晶技群益98購02,,,,,0.00,0.00,0,0,0,0,0,0,0,0,0,0,0,0,0
20200316,057936,健策群益99購01,0.21,0.21,0.21,0.21,0.00,0.00,11000,1,2310,0,0,0,0,0,0,11000,11000,0,0
20200316,057937,神達群益98購02,0.47,0.47,0.42,0.42,-0.06,-12.5,308000,5,142750,0,0,0,0,0,0,308000,0,308000,308000
20200316,057938,台表科群益98購02,,,,,0.00,0.00,0,0,0,0,0,0,0,0,0,0,0,0,0
20200316,057939,鈺齊群益98購02,,,,,0.00,0.00,0,0,0,0,0,0,0,0,0,0,0,0,0
20200316,05793P,臺股指中信99售08,3.43,3.91,3.43,3.91,+0.70,21.81,65000,17,229070,0,0,0,0,0,0,15000,49000,-34000,-34000
20200316,057940,和大國票99購01,,,,,0.00,0.00,0,0,0,0,0,0,0,0,0,0,0,0,0
20200316,057941,聯電國票99購01,0.51,0.51,0.45,0.45,-0.07,-13.46,12000,2,6000,0,0,0,0,0,0,12000,0,12000,12000
20200316,057942,可成國票99購02,0.21,0.23,0.19,0.23,-0.03,-11.54,130000,6,25800,0,0,0,0,0,0,130000,0,130000,130000
20200316,057943,可成國票99購03,,,,,0.00,0.00,0,0,0,0,0,0,0,0,0,0,0,0,0
20200316,057944,新日興國票99購02,,,,,0.00,0.00,0,0,0,0,0,0,0,0,0,0,0,0,0
20200316,057945,京鼎國票99購03,0.38,0.38,0.28,0.28,-0.10,-26.32,80000,2,23400,0,0,0,0,0,0,70000,10000,60000,60000
20200316,057946,晶相光國票99購01,,,,,0.00,0.00,0,0,0,0,0,0,0,0,0,0,0,0,0
20200316,057947,和碩國票99購01,,,,,0.00,0.00,0,0,0,0,0,0,0,0,0,0,0,0,0
20200316,057948,嘉聯益國票99購02,,,,,0.00,0.00,0,0,0,0,0,0,0,0,0,0,0,0,0
20200316,057949,南電國票99購01,1.57,1.57,1.57,1.57,+0.42,36.52,16000,1,25120,0,0,0,0,0,0,16000,0,16000,16000
20200316,05794P,華邦電群益96售04,,,,,0.00,0.00,0,0,0,0,0,0,0,0,0,0,0,0,0
20200316,057950,T50正2元大9B購04,0.15,0.15,0.15,0.15,-0.18,-54.55,20000,1,3000,0,0,0,0,0,0,20000,0,20000,20000
20200316,057951,元油2X元大98購20,,,,,0.00,0.00,0,0,0,0,0,0,0,0,0,0,0,0,0
20200316,057952,元油2X元大98購21,,,,,0.00,0.00,0,0,0,0,0,0,0,0,0,0,0,0,0
20200316,057953,聚陽元大98購01,0.47,0.47,0.34,0.35,-0.10,-22.22,293000,33,123970,0,0,0,0,0,0,105000,213000,-108000,-108000
20200316,057954,宏碁元大99購01,0.62,0.64,0.50,0.50,-0.16,-24.24,244000,25,135620,0,0,0,0,0,0,30000,194000,-164000,-164000
20200316,057955,技嘉元大98購07,0.50,0.50,0.50,0.50,0.00,0.00,2000,1,1000,0,0,0,0,0,0,2000,0,2000,2000
20200316,057956,全新元大99購04,,,,,0.00,0.00,0,0,0,0,0,0,0,0,0,0,0,0,0
20200316,057957,嘉晶元大98購01,2.66,2.75,2.45,2.62,+0.08,3.15,38000,5,101580,0,0,0,0,0,0,28000,17000,11000,11000
20200316,057958,禾伸堂元大99購05,0.80,0.80,0.76,0.76,+0.14,22.58,4000,2,3080,0,0,0,0,0,0,4000,4000,0,0
20200316,057959,欣興元大98購14,0.73,0.73,0.66,0.66,-0.06,-8.33,13000,4,9250,0,0,0,0,0,0,3000,13000,-10000,-10000
20200316,05795P,華邦電群益96售05,,,,,0.00,0.00,0,0,0,0,0,0,0,0,0,0,0,0,0
20200316,057960,聯鈞元大98購02,0.60,0.60,0.57,0.57,+0.05,9.62,50000,5,29200,0,0,0,0,0,0,10000,40000,-30000,-30000
20200316,057961,茂林元大9A購01,0.77,0.77,0.61,0.61,-0.22,-26.51,104000,23,73870,0,0,0,0,0,0,20000,84000,-64000,-64000
20200316,057962,超眾元大99購03,1.47,1.47,1.02,1.02,-0.32,-23.88,20000,2,24900,0,0,0,0,0,0,10000,10000,0,0
20200316,057963,緯穎元大98購08,1.31,1.31,1.31,1.31,+0.82,167.35,10000,1,13100,0,0,0,0,0,0,10000,0,10000,10000
20200316,057964,緯穎元大99購03,1.69,1.70,1.37,1.37,-0.22,-13.84,138000,12,225900,0,0,0,0,0,0,111000,27000,84000,84000
20200316,057965,臺股指元大98購14,0.51,0.57,0.42,0.42,-0.15,-26.32,971000,41,470140,0,0,0,0,0,0,655000,316000,339000,339000
20200316,057966,金融類元大98購01,,,,,0.00,0.00,0,0,0,0,0,0,0,0,0,0,0,0,0
20200316,057967,聯發科國泰9A購02,0.55,0.55,0.55,0.55,+0.03,5.77,53000,2,29150,0,0,0,0,0,0,50000,3000,47000,47000
20200316,057968,可成國泰9A購01,,,,,0.00,0.00,0,0,0,0,0,0,0,0,0,0,0,0,0
20200316,057969,緯穎國泰99購01,1.31,1.31,1.14,1.20,+0.02,1.69,510000,30,628430,0,0,0,0,0,0,495000,0,495000,495000
20200316,05796P,臺股指群益96售10,,,,,0.00,0.00,0,0,0,0,0,0,0,0,0,0,0,0,0
20200316,057970,國巨富邦99購03,0.25,0.25,0.24,0.24,+0.05,26.32,20000,2,4900,0,0,0,0,0,0,0,20000,-20000,-20000
20200316,057971,華新科富邦9B購02,,,,,0.00,0.00,0,0,0,0,0,0,0,0,0,0,0,0,0
20200316,057972,群創富邦9C購01,0.44,0.44,0.44,0.44,+0.03,7.32,2000,1,880,0,0,0,0,0,0,2000,0,2000,2000
20200316,057973,神達富邦9A購01,0.47,0.49,0.47,0.49,+0.02,4.26,43000,2,20870,0,0,0,0,0,0,43000,0,43000,43000
20200316,057974,上銀永豐98購02,0.07,0.07,0.07,0.07,-0.02,-22.22,400000,1,28000,0,0,0,0,0,0,400000,0,400000,400000
20200316,057975,台積電永豐98購05,,,,,0.00,0.00,0,0,0,0,0,0,0,0,0,0,0,0,0
20200316,057976,旺宏永豐98購03,0.46,0.46,0.46,0.46,-0.01,-2.13,20000,1,9200,0,0,0,0,0,0,20000,0,20000,20000
20200316,057977,台光電永豐98購02,,,,,0.00,0.00,0,0,0,0,0,0,0,0,0,0,0,0,0
20200316,057978,聯發科永豐98購05,0.46,0.46,0.32,0.32,-0.19,-37.25,183000,11,77520,0,0,0,0,0,0,93000,120000,-27000,-27000
20200316,057979,華新科永豐98購03,,,,,0.00,0.00,0,0,0,0,0,0,0,0,0,0,0,0,0
20200316,05797P,臺股指群益96售11,,,,,0.00,0.00,0,0,0,0,0,0,0,0,0,0,0,0,0
20200316,057980,聯詠永豐98購01,,,,,0.00,0.00,0,0,0,0,0,0,0,0,0,0,0,0,0
20200316,057981,臻鼎永豐98購01,0.14,0.14,0.12,0.13,-0.03,-18.75,48000,4,6160,0,0,0,0,0,0,38000,0,38000,38000
20200316,057982,帆宣永豐98購01,,,,,0.00,0.00,0,0,0,0,0,0,0,0,0,0,0,0,0
20200316,057983,緯穎永豐98購03,,,,,0.00,0.00,0,0,0,0,0,0,0,0,0,0,0,0,0
20200316,057984,聯發科台新98購01,0.46,0.46,0.46,0.46,0.00,0.00,499000,1,229540,0,0,0,0,0,0,499000,499000,0,0
20200316,057985,華通元富02購03,0.80,0.80,0.57,0.57,-0.10,-14.93,80000,3,59000,0,0,0,0,0,0,20000,60000,-40000,-40000
20200316,057986,華新科元富99購05,0.24,0.24,0.14,0.14,-0.06,-30.0,792000,49,155110,0,0,0,0,0,0,390000,402000,-12000,-12000
20200316,057987,大立光元富98購02,,,,,0.00,0.00,0,0,0,0,0,0,0,0,0,0,0,0,0
20200316,057988,鈺齊元富98購02,0.72,0.72,0.72,0.72,0.00,0.00,2000,1,1440,0,0,0,0,0,0,0,2000,-2000,-2000
20200316,057989,旺宏統一99購04,,,,,0.00,0.00,0,0,0,0,0,0,0,0,0,0,0,0,0
20200316,05798P,臺股指群益96售12,,,,,0.00,0.00,0,0,0,0,0,0,0,0,0,0,0,0,0
20200316,057990,美律統一99購02,,,,,0.00,0.00,0,0,0,0,0,0,0,0,0,0,0,0,0
20200316,057991,健策統一9C購01,,,,,0.00,0.00,0,0,0,0,0,0,0,0,0,0,0,0,0
20200316,057992,大立光日盛98購01,,,,,0.00,0.00,0,0,0,0,0,0,0,0,0,0,0,0,0
20200316,057993,中環中信98購01,0.48,0.53,0.48,0.48,0.00,0.00,100000,10,50300,0,0,0,0,0,0,0,100000,-100000,-100000
20200316,057994,技嘉中信98購01,1.38,1.38,1.38,1.38,+0.07,5.34,10000,1,13800,0,0,0,0,0,0,10000,0,10000,10000
20200316,057995,華新科中信98購02,,,,,0.00,0.00,0,0,0,0,0,0,0,0,0,0,0,0,0
20200316,057996,臻鼎中信98購01,1.13,1.29,1.07,1.09,0.00,0.00,253000,19,290910,0,0,0,0,0,0,93000,160000,-67000,-67000
20200316,057997,旺宏第一9C購01,,,,,0.00,0.00,0,0,0,0,0,0,0,0,0,0,0,0,0
20200316,057998,玉晶光麥證9A購01,0.32,0.32,0.31,0.31,0.00,0.00,40000,2,12600,0,40000,-40000,0,0,0,0,40000,-40000,-40000
20200316,057999,智邦亞東99購02,,,,,0.00,0.00,0,0,0,0,0,0,0,0,0,0,0,0,0
20200316,05799P,臺股指群益96售13,,,,,0.00,0.00,0,0,0,0,0,0,0,0,0,0,0,0,0
20200316,058000,FBVIX群益9B購01,,,,,0.00,0.00,0,0,0,0,0,0,0,0,0,0,0,0,0
20200316,058001,FBVIX群益9B購02,,,,,0.00,0.00,0,0,0,0,0,0,0,0,0,0,0,0,0
20200316,058002,FBVIX群益9C購01,,,,,0.00,0.00,0,0,0,0,0,0,0,0,0,0,0,0,0
20200316,058003,FBVIX群益9C購02,,,,,0.00,0.00,0,0,0,0,0,0,0,0,0,0,0,0,0
20200316,058004,大立光群益98購03,0.50,0.50,0.50,0.50,-0.07,-12.28,30000,1,15000,0,0,0,0,0,0,30000,0,30000,30000
20200316,058005,茂林群益98購04,0.40,0.40,0.40,0.40,+0.01,2.56,60000,2,24000,0,0,0,0,0,0,60000,0,60000,60000
20200316,058006,台郡群益98購04,0.65,0.65,0.65,0.65,0.00,0.00,2000,1,1300,0,0,0,0,0,0,0,2000,-2000,-2000
20200316,058007,南電群益98購02,0.39,0.39,0.29,0.29,-0.03,-9.38,32000,4,9930,0,0,0,0,0,0,10000,22000,-12000,-12000
20200316,058008,禾伸堂國票99購02,,,,,0.00,0.00,0,0,0,0,0,0,0,0,0,0,0,0,0
20200316,058009,智易國票99購01,,,,,0.00,0.00,0,0,0,0,0,0,0,0,0,0,0,0,0
20200316,05800P,台積電兆豐96售04,8.45,9.90,8.35,9.90,+2.05,26.11,35000,8,315950,0,0,0,0,0,0,35000,23000,12000,12000
20200316,058010,帆宣國票98購01,,,,,0.00,0.00,0,0,0,0,0,0,0,0,0,0,0,0,0
20200316,058011,台虹國票99購01,2.34,2.34,2.34,2.34,-0.04,-1.68,28000,2,65520,0,0,0,0,0,0,28000,0,28000,28000
20200316,058012,鈺齊國票99購01,0.87,0.87,0.87,0.87,+0.02,2.35,10000,1,8700,0,0,0,0,0,0,10000,0,10000,10000
20200316,058013,SP黃豆凱基9A購01,,,,,0.00,0.00,0,0,0,0,0,0,0,0,0,0,0,0,0
20200316,058014,上銀凱基99購02,,,,,0.00,0.00,0,0,0,0,0,0,0,0,0,0,0,0,0
20200316,058015,旺宏凱基99購02,0.82,0.82,0.82,0.82,0.00,0.00,5000,1,4100,0,0,0,0,0,0,0,5000,-5000,-5000
20200316,058016,智邦凱基98購06,1.24,1.33,1.24,1.27,+0.32,33.68,15000,7,19200,0,0,0,0,0,0,10000,5000,5000,5000
20200316,058017,漢唐凱基99購01,0.62,0.66,0.61,0.61,+0.13,27.08,300000,11,184900,0,0,0,0,0,0,300000,0,300000,300000
20200316,058018,南亞科凱基99購03,,,,,0.00,0.00,0,0,0,0,0,0,0,0,0,0,0,0,0
20200316,058019,美律凱基99購04,0.81,0.81,0.75,0.76,+0.08,11.76,36000,5,27970,0,0,0,0,0,0,6000,32000,-26000,-26000
20200316,05801P,正崴兆豐96售01,6.25,6.25,6.25,6.25,+0.25,4.17,16000,1,100000,0,0,0,0,0,0,16000,0,16000,16000
20200316,058020,大立光凱基99購03,0.50,0.50,0.43,0.45,-0.01,-2.17,50000,4,23100,0,0,0,0,0,0,40000,10000,30000,30000
20200316,058021,牧德凱基98購02,0.41,0.42,0.31,0.31,-0.05,-13.89,110000,12,43900,0,0,0,0,0,0,110000,0,110000,110000
20200316,058022,樺漢凱基99購02,,,,,0.00,0.00,0,0,0,0,0,0,0,0,0,0,0,0,0
20200316,058023,南電凱基98購02,0.78,0.78,0.78,0.78,+0.11,16.42,60000,1,46800,0,0,0,0,0,0,60000,0,60000,60000
20200316,058024,台積電國泰9A購01,0.79,0.79,0.55,0.55,-0.26,-32.1,192000,14,117710,0,0,0,0,0,0,136000,10000,126000,126000
20200316,058025,聯茂國泰99購01,0.96,1.10,0.96,1.05,+0.04,3.96,64000,6,64380,0,0,0,0,0,0,40000,24000,16000,16000
20200316,058026,上銀富邦9A購01,0.35,0.36,0.26,0.26,-0.06,-18.75,57000,7,17600,0,0,0,0,0,0,17000,35000,-18000,-18000
20200316,058027,鴻海富邦98購04,,,,,0.00,0.00,0,0,0,0,0,0,0,0,0,0,0,0,0
20200316,058028,國巨富邦99購04,0.08,0.10,0.08,0.10,+0.04,66.67,51000,7,4140,0,0,0,0,0,0,48000,0,48000,48000
20200316,058029,台灣50永豐9A購01,0.24,0.24,0.16,0.16,-0.08,-33.33,15000,2,2800,0,0,0,0,0,0,0,10000,-10000,-10000
20200316,05802P,臺股指兆豐96售02,,,,,0.00,0.00,0,0,0,0,0,0,0,0,0,0,0,0,0
20200316,058030,國巨永豐98購08,0.08,0.08,0.07,0.07,-0.02,-22.22,85000,4,6550,0,0,0,0,0,0,85000,0,85000,85000
20200316,058031,旺宏永豐98購04,0.58,0.58,0.43,0.43,+0.05,13.16,5000,2,2600,0,0,0,0,0,0,5000,0,5000,5000
20200316,058032,大立光永豐98購05,,,,,0.00,0.00,0,0,0,0,0,0,0,0,0,0,0,0,0
20200316,058033,景碩永豐98購02,,,,,0.00,0.00,0,0,0,0,0,0,0,0,0,0,0,0,0
20200316,058034,神達永豐98購02,0.20,0.20,0.15,0.15,-0.07,-31.82,21000,5,3530,0,0,0,0,0,0,8000,13000,-5000,-5000
20200316,058035,旭富永豐98購02,0.53,0.53,0.43,0.43,0.00,0.00,106000,10,51580,0,0,0,0,0,0,55000,51000,4000,4000
20200316,058036,南電永豐98購01,,,,,0.00,0.00,0,0,0,0,0,0,0,0,0,0,0,0,0
20200316,058037,台灣50元大9B購02,0.60,0.62,0.38,0.38,-0.30,-44.12,498000,70,229940,0,0,0,0,0,0,0,383000,-383000,-383000
20200316,058038,滬深反元大98購01,0.92,0.92,0.92,0.92,-0.01,-1.08,29000,1,26680,0,0,0,0,0,0,29000,0,29000,29000
20200316,058039,元石油元大98購03,0.11,0.11,0.11,0.11,-0.02,-15.38,30000,4,3300,0,0,0,0,0,0,0,0,0,0
20200316,05803P,臺股指兆豐96售03,,,,,0.00,0.00,0,0,0,0,0,0,0,0,0,0,0,0,0
20200316,058040,FBVIX元大98購01,,,,,0.00,0.00,0,0,0,0,0,0,0,0,0,0,0,0,0
20200316,058041,FBVIX元大98購02,,,,,0.00,0.00,0,0,0,0,0,0,0,0,0,0,0,0,0
20200316,058042,鴻海元大98購12,1.47,1.50,1.12,1.14,-0.45,-28.3,235000,46,304810,0,0,0,0,0,0,209000,175000,34000,34000
20200316,058043,鴻海元大98購13,1.22,1.28,0.99,0.99,-0.18,-15.38,158000,32,181520,0,0,0,0,0,0,107000,128000,-21000,-21000
20200316,058044,鴻海元大99購07,1.74,1.82,1.40,1.41,-0.27,-16.07,264000,35,425000,0,0,0,0,0,0,234000,182000,52000,52000
20200316,058045,鴻海元大99購08,1.02,1.04,0.80,0.80,-0.27,-25.23,264000,22,243880,0,0,0,0,0,0,134000,134000,0,0
20200316,058046,國巨元大9A購01,0.84,0.84,0.62,0.62,-0.21,-25.3,144000,18,106490,0,0,0,0,0,0,55000,89000,-34000,-34000
20200316,058047,可成元大98購11,,,,,0.00,0.00,0,0,0,0,0,0,0,0,0,0,0,0,0
20200316,058048,群創元大9B購07,,,,,0.00,0.00,0,0,0,0,0,0,0,0,0,0,0,0,0
20200316,058049,帆宣元大98購01,0.40,0.40,0.30,0.30,+0.03,11.11,60000,3,22200,0,0,0,0,0,0,40000,20000,20000,20000
20200316,05804P,美律永豐96售01,,,,,0.00,0.00,0,0,0,0,0,0,0,0,0,0,0,0,0
20200316,058050,台郡元大99購05,0.83,0.85,0.73,0.73,+0.07,10.61,18000,6,14160,0,0,0,0,0,0,5000,13000,-8000,-8000
20200316,058051,同欣電元大98購03,0.69,0.69,0.69,0.69,+0.09,15.0,10000,2,6900,0,0,0,0,0,0,10000,0,10000,10000
20200316,058052,南電元大98購02,1.66,1.66,1.45,1.45,+0.04,2.84,48000,8,73990,0,0,0,0,0,0,22000,26000,-4000,-4000
20200316,058053,上銀統一9B購01,,,,,0.00,0.00,0,0,0,0,0,0,0,0,0,0,0,0,0
20200316,058054,台積電統一9C購01,0.59,0.59,0.44,0.44,-0.22,-33.33,121000,10,56600,0,0,0,0,0,0,74000,6000,68000,68000
20200316,058055,華擎統一9A購01,0.50,0.50,0.50,0.50,+0.14,38.89,2000,1,1000,0,0,0,0,0,0,0,2000,-2000,-2000
20200316,058056,FBVIX元富98購01,,,,,0.00,0.00,0,0,0,0,0,0,0,0,0,0,0,0,0
20200316,058057,FBVIX元富98購02,,,,,0.00,0.00,0,0,0,0,0,0,0,0,0,0,0,0,0
20200316,058058,大立光元富9B購02,1.33,1.35,0.93,1.00,-0.44,-30.56,541000,30,636590,0,0,0,0,0,0,389000,127000,262000,262000
20200316,058059,晶技元富98購01,0.87,0.96,0.80,0.80,+0.03,3.9,83000,11,73590,0,0,0,0,0,0,37000,40000,-3000,-3000
20200316,05805P,義隆永豐96售02,2.23,2.37,2.23,2.37,+0.14,6.28,18000,5,41010,0,0,0,0,0,0,1000,17000,-16000,-16000
20200316,058060,貿聯元富98購01,0.65,0.66,0.45,0.45,-0.06,-11.76,558000,8,344630,0,0,0,0,0,0,473000,10000,463000,463000
20200316,058061,貿聯元富9B購01,0.88,0.93,0.66,0.66,-0.09,-12.0,59000,6,48430,0,0,0,0,0,0,10000,49000,-39000,-39000
20200316,058062,上銀中信98購01,,,,,0.00,0.00,0,0,0,0,0,0,0,0,0,0,0,0,0
20200316,058063,旺宏中信98購04,1.68,1.78,1.61,1.61,+0.05,3.21,88000,5,144780,0,0,0,0,0,0,68000,20000,48000,48000
20200316,058064,華邦電亞東99購01,0.18,0.18,0.18,0.18,-0.06,-25.0,20000,1,3600,0,0,0,0,0,0,20000,0,20000,20000
20200316,058065,南亞科亞東99購01,,,,,0.00,0.00,0,0,0,0,0,0,0,0,0,0,0,0,0
20200316,058066,可成亞東99購01,,,,,0.00,0.00,0,0,0,0,0,0,0,0,0,0,0,0,0
20200316,058067,台積電第一9C購01,0.38,0.38,0.22,0.27,-0.11,-28.95,91000,8,27620,0,0,0,0,0,0,8000,81000,-73000,-73000
20200316,058068,旺宏凱基98購11,1.03,1.03,1.03,1.03,+0.21,25.61,82000,1,84460,0,0,0,0,0,0,82000,0,82000,82000
20200316,058069,美律凱基99購05,1.54,1.54,1.23,1.23,+0.14,12.84,65000,5,92120,0,0,0,0,0,0,31000,55000,-24000,-24000
20200316,05806P,宏達電永豐96售03,3.81,3.81,3.81,3.81,+0.59,18.32,14000,1,53340,0,0,0,0,0,0,14000,0,14000,14000
20200316,058070,華新科凱基98購07,0.73,0.77,0.73,0.75,0.00,0.00,50000,5,37100,0,0,0,0,0,0,0,50000,-50000,-50000
20200316,058071,大立光凱基98購19,0.70,0.70,0.56,0.56,-0.22,-28.21,287000,8,198900,0,0,0,0,0,0,272000,15000,257000,257000
20200316,058072,大立光凱基98購20,,,,,0.00,0.00,0,0,0,0,0,0,0,0,0,0,0,0,0
20200316,058073,大立光凱基99購04,1.68,1.68,1.19,1.19,-0.56,-32.0,460000,23,729180,0,0,0,0,0,0,41000,419000,-378000,-378000
20200316,058074,欣興凱基99購01,0.59,0.59,0.59,0.59,+0.16,37.21,20000,1,11800,0,0,0,0,0,0,20000,0,20000,20000
20200316,058075,貿聯凱基99購02,0.53,0.56,0.53,0.56,0.00,0.00,241000,5,131960,0,0,0,0,0,0,100000,141000,-41000,-41000
20200316,058076,神達凱基98購02,0.37,0.39,0.36,0.36,+0.05,16.13,228000,4,84620,0,0,0,0,0,0,218000,10000,208000,208000
20200316,058077,超眾凱基98購02,0.78,0.85,0.54,0.54,-0.10,-15.62,26000,5,17900,0,0,0,0,0,0,6000,20000,-14000,-14000
20200316,058078,景碩國票99購01,,,,,0.00,0.00,0,0,0,0,0,0,0,0,0,0,0,0,0
20200316,058079,鴻海群益98購08,,,,,0.00,0.00,0,0,0,0,0,0,0,0,0,0,0,0,0
20200316,05807P,泰鼎永豐96售03,0.77,0.97,0.77,0.97,+0.20,25.97,488000,35,425470,0,0,0,0,0,0,85000,398000,-313000,-313000
20200316,058080,台積電群益98購06,1.33,1.39,1.33,1.39,-0.73,-34.43,15000,2,20250,0,0,0,0,0,0,10000,5000,5000,5000
20200316,058081,技嘉群益9A購03,0.94,0.95,0.90,0.90,-0.09,-9.09,40000,9,37390,0,0,0,0,0,0,39000,0,39000,39000
20200316,058082,美律群益98購05,0.45,0.45,0.45,0.45,+0.11,32.35,11000,1,4950,0,0,0,0,0,0,0,11000,-11000,-11000
20200316,058083,聯發科群益98購08,,,,,0.00,0.00,0,0,0,0,0,0,0,0,0,0,0,0,0
20200316,058084,大立光群益98購04,0.78,0.78,0.78,0.78,-0.17,-17.89,5000,1,3900,0,0,0,0,0,0,5000,0,5000,5000
20200316,058085,景碩群益9A購01,,,,,0.00,0.00,0,0,0,0,0,0,0,0,0,0,0,0,0
20200316,058086,鴻海元大98購14,1.85,1.85,1.42,1.46,-0.22,-13.1,228000,32,372130,0,0,0,0,0,0,228000,153000,75000,75000
20200316,058087,鴻海元大98購15,1.41,1.44,1.09,1.10,-0.41,-27.15,353000,45,444350,0,0,0,0,0,0,313000,282000,31000,31000
20200316,058088,鴻海元大9A購01,1.26,1.26,1.01,1.03,-0.27,-20.77,471000,53,537680,0,0,0,0,0,0,338000,234000,104000,104000
20200316,058089,聯發科元大98購15,1.38,1.45,1.03,1.03,-0.59,-36.42,233000,24,316460,0,0,0,0,0,0,210000,73000,137000,137000
20200316,05808P,臺股指國票96售01,,,,,0.00,0.00,0,0,0,0,0,0,0,0,0,0,0,0,0
20200316,058090,聯發科元大98購16,1.07,1.17,0.82,0.82,-0.40,-32.79,364000,32,373890,0,0,0,0,0,0,279000,197000,82000,82000
20200316,058091,欣興元大99購03,0.70,0.70,0.67,0.67,0.00,0.00,16000,4,10750,0,0,0,0,0,0,2000,1000,1000,1000
20200316,058092,牧德元大98購02,0.61,0.62,0.56,0.56,-0.23,-29.11,45000,7,27290,0,0,0,0,0,0,0,45000,-45000,-45000
20200316,058093,神達元大9A購01,0.80,0.92,0.80,0.81,-0.09,-10.0,440000,15,384000,0,0,0,0,0,0,430000,13000,417000,417000
20200316,058094,祥碩元大98購09,1.19,1.22,0.96,0.96,-0.25,-20.66,469000,30,534060,0,0,0,0,0,0,459000,149000,310000,310000
20200316,058095,昇陽半元大98購03,0.80,0.80,0.70,0.70,0.00,0.00,9000,6,6870,0,0,0,0,0,0,0,9000,-9000,-9000
20200316,058096,南電元大98購04,1.16,1.16,1.16,1.16,+0.26,28.89,10000,2,11600,0,0,0,0,0,0,10000,0,10000,10000
20200316,058097,台灣50國泰99購01,0.56,0.56,0.39,0.39,-0.03,-7.14,307000,18,149900,0,0,0,0,0,0,10000,297000,-287000,-287000
20200316,058098,T50反1國泰9A購02,1.80,1.80,1.80,1.80,-0.20,-10.0,13000,1,23400,0,0,0,0,0,0,13000,0,13000,13000
20200316,058099,鴻海國泰9A購02,0.46,0.46,0.36,0.36,-0.10,-21.74,2533000,21,961270,0,0,0,0,0,0,2491000,2191000,300000,300000
20200316,05809P,臺股指國票96售02,,,,,0.00,0.00,0,0,0,0,0,0,0,0,0,0,0,0,0
20200316,058100,聯茂國泰99購02,0.82,0.82,0.73,0.73,-0.13,-15.12,88000,10,67890,0,0,0,0,0,0,36000,52000,-16000,-16000
20200316,058101,台積電富邦9C購01,0.26,0.34,0.24,0.25,-0.11,-30.56,376000,49,108260,0,0,0,0,0,0,17000,301000,-284000,-284000
20200316,058102,楠梓電永豐98購04,,,,,0.00,0.00,0,0,0,0,0,0,0,0,0,0,0,0,0
20200316,058103,台積電永豐98購06,0.54,0.54,0.40,0.40,-0.22,-35.48,205000,25,93440,0,0,0,0,0,0,50000,145000,-95000,-95000
20200316,058104,國巨統一9A購04,,,,,0.00,0.00,0,0,0,0,0,0,0,0,0,0,0,0,0
20200316,058105,旺宏統一9A購02,0.85,0.87,0.85,0.87,0.00,0.00,20000,2,17200,0,0,0,0,0,0,0,20000,-20000,-20000
20200316,058106,神達統一98購02,0.40,0.40,0.40,0.40,0.00,0.00,19000,1,7600,0,0,0,0,0,0,19000,0,19000,19000
20200316,058107,全新台新99購01,,,,,0.00,0.00,0,0,0,0,0,0,0,0,0,0,0,0,0
20200316,058108,台郡台新99購01,,,,,0.00,0.00,0,0,0,0,0,0,0,0,0,0,0,0,0
20200316,058109,台灣50元富9B購01,0.36,0.39,0.24,0.28,-0.12,-30.0,823000,36,230630,0,0,0,0,0,0,420000,138000,282000,282000
20200316,05810P,臺股指國票96售03,,,,,0.00,0.00,0,0,0,0,0,0,0,0,0,0,0,0,0
20200316,058110,光寶科元富98購01,1.62,1.62,1.57,1.59,-0.16,-9.14,280000,11,450080,0,0,0,0,0,0,230000,50000,180000,180000
20200316,058111,健鼎元富98購01,,,,,0.00,0.00,0,0,0,0,0,0,0,0,0,0,0,0,0
20200316,058112,神達元富98購01,0.42,0.45,0.34,0.34,-0.14,-29.17,231000,21,91150,0,0,0,0,0,0,31000,200000,-169000,-169000
20200316,058113,百和元富98購01,,,,,0.00,0.00,0,0,0,0,0,0,0,0,0,0,0,0,0
20200316,058114,台積電第一01購01,0.80,0.80,0.51,0.51,+0.01,2.0,41000,3,24400,0,0,0,0,0,0,0,40000,-40000,-40000
20200316,058115,台光電中信99購01,1.51,1.63,1.42,1.42,+0.06,4.41,179000,9,281750,0,0,0,0,0,0,48000,131000,-83000,-83000
20200316,058116,正崴中信99購02,0.69,0.73,0.66,0.66,-0.04,-5.71,142000,7,98130,0,0,0,0,0,0,94000,48000,46000,46000
20200316,058117,元石油群益9B購02,0.08,0.08,0.08,0.08,-0.04,-33.33,30000,1,2400,0,0,0,0,0,0,30000,0,30000,30000
20200316,058118,瑞昱群益99購01,,,,,0.00,0.00,0,0,0,0,0,0,0,0,0,0,0,0,0
20200316,058119,華新亞東99購01,,,,,0.00,0.00,0,0,0,0,0,0,0,0,0,0,0,0,0
20200316,05811P,臺股指國票96售04,8.60,8.60,8.45,8.45,0.00,0.00,10000,2,84800,0,0,0,0,0,0,10000,0,10000,10000
20200316,058120,台灣50國票99購03,0.47,0.49,0.35,0.35,-0.32,-47.76,2922000,86,1262010,0,0,0,0,0,0,2156000,358000,1798000,1798000
20200316,058121,國巨國票9A購01,0.24,0.30,0.20,0.22,-0.11,-33.33,637000,14,140420,0,0,0,0,0,0,577000,10000,567000,567000
20200316,058122,美律國票9A購01,0.95,0.95,0.87,0.87,+0.08,10.13,74000,7,69820,0,0,0,0,0,0,74000,0,74000,74000
20200316,058123,亞光國票9A購01,,,,,0.00,0.00,0,0,0,0,0,0,0,0,0,0,0,0,0
20200316,058124,玉晶光國票9A購01,0.48,0.48,0.48,0.48,+0.07,17.07,10000,1,4800,0,0,0,0,0,0,0,10000,-10000,-10000
20200316,058125,元油2X元大9C購01,0.10,0.10,0.07,0.08,-0.02,-20.0,1188000,43,88260,0,0,0,0,0,0,0,0,0,0
20200316,058126,元油2X元大9C購02,,,,,0.00,0.00,0,0,0,0,0,0,0,0,0,0,0,0,0
20200316,058127,FBVIX元大9C購01,7.15,7.15,7.15,7.15,-0.20,-2.72,4000,1,28600,0,0,0,0,0,0,4000,0,4000,4000
20200316,058128,FBVIX元大9C購02,,,,,0.00,0.00,0,0,0,0,0,0,0,0,0,0,0,0,0
20200316,058129,國巨元大99購10,0.66,0.66,0.61,0.61,-0.01,-1.61,23000,4,14320,0,0,0,0,0,0,1000,22000,-21000,-21000
20200316,05812P,臺股指國票96售05,,,,,0.00,0.00,0,0,0,0,0,0,0,0,0,0,0,0,0
20200316,058130,瑞昱元大99購01,1.22,1.28,1.01,1.01,-0.40,-28.37,218000,17,258770,0,0,0,0,0,0,177000,129000,48000,48000
20200316,058131,義隆元大99購02,,,,,0.00,0.00,0,0,0,0,0,0,0,0,0,0,0,0,0
20200316,058132,義隆元大99購03,0.88,0.88,0.88,0.88,+0.12,15.79,10000,1,8800,0,0,0,0,0,0,0,10000,-10000,-10000
20200316,058133,華新科元大9A購02,0.28,0.28,0.28,0.28,+0.04,16.67,1000,1,280,0,0,0,0,0,0,1000,0,1000,1000
20200316,058134,信邦元大99購01,0.74,0.74,0.59,0.59,-0.19,-24.36,72000,7,49380,0,0,0,0,0,0,40000,32000,8000,8000
20200316,058135,景碩元大99購01,,,,,0.00,0.00,0,0,0,0,0,0,0,0,0,0,0,0,0
20200316,058136,景碩元大99購02,,,,,0.00,0.00,0,0,0,0,0,0,0,0,0,0,0,0,0
20200316,058137,玉晶光元大99購11,,,,,0.00,0.00,0,0,0,0,0,0,0,0,0,0,0,0,0
20200316,058138,晶相光元大9C購01,0.58,0.58,0.45,0.45,-0.13,-22.41,132000,18,67100,0,0,0,0,0,0,20000,112000,-92000,-92000
20200316,058139,臻鼎元大99購01,0.30,0.30,0.30,0.30,0.00,0.00,108000,6,32400,0,0,0,0,0,0,58000,40000,18000,18000
20200316,05813P,臺股指國票96售06,,,,,0.00,0.00,0,0,0,0,0,0,0,0,0,0,0,0,0
20200316,058140,臻鼎元大99購02,0.36,0.38,0.34,0.34,0.00,0.00,60000,6,21900,0,0,0,0,0,0,0,60000,-60000,-60000
20200316,058141,嘉聯益元大99購05,,,,,0.00,0.00,0,0,0,0,0,0,0,0,0,0,0,0,0
20200316,058142,瑞儀元大99購01,0.65,0.75,0.64,0.70,+0.09,14.75,289000,30,198120,0,0,0,0,0,0,114000,260000,-146000,-146000
20200316,058143,瑞儀元大99購02,0.50,0.54,0.50,0.51,+0.04,8.51,156000,17,80680,0,0,0,0,0,0,116000,134000,-18000,-18000
20200316,058144,聯茂元大99購02,0.83,0.89,0.62,0.62,-0.04,-6.06,70000,7,52600,0,0,0,0,0,0,20000,50000,-30000,-30000
20200316,058145,聯茂元大99購03,0.75,0.75,0.65,0.65,+0.07,12.07,30000,3,20700,0,0,0,0,0,0,10000,20000,-10000,-10000
20200316,058146,勤誠元大99購01,,,,,0.00,0.00,0,0,0,0,0,0,0,0,0,0,0,0,0
20200316,058147,鈺齊元大99購01,,,,,0.00,0.00,0,0,0,0,0,0,0,0,0,0,0,0,0
20200316,058148,百和元大99購01,0.74,0.74,0.49,0.49,-0.21,-30.0,20000,2,12300,0,0,0,0,0,0,10000,10000,0,0
20200316,058149,百和元大99購02,0.87,0.87,0.87,0.87,+0.02,2.35,10000,1,8700,0,0,0,0,0,0,10000,0,10000,10000
20200316,05814P,臺股指國票96售07,,,,,0.00,0.00,0,0,0,0,0,0,0,0,0,0,0,0,0
20200316,058150,中502X統一9B購01,0.42,0.42,0.42,0.42,0.00,0.00,20000,2,8400,0,0,0,0,0,0,0,20000,-20000,-20000
20200316,058151,台積電統一9A購04,0.69,0.70,0.69,0.70,-0.13,-15.66,35000,2,24200,0,0,0,0,0,0,30000,0,30000,30000
20200316,058152,聯發科統一9B購02,,,,,0.00,0.00,0,0,0,0,0,0,0,0,0,0,0,0,0
20200316,058153,景碩統一9B購01,0.24,0.24,0.24,0.24,0.00,0.00,10000,1,2400,0,0,0,0,0,0,0,10000,-10000,-10000
20200316,058154,泰碩統一9A購01,1.38,1.38,1.25,1.25,0.00,0.00,100000,8,131620,0,0,0,0,0,0,55000,0,55000,55000
20200316,058155,牧德統一9A購01,,,,,0.00,0.00,0,0,0,0,0,0,0,0,0,0,0,0,0
20200316,058156,超眾統一9A購02,0.22,0.22,0.22,0.22,0.00,0.00,11000,3,2420,0,0,0,0,0,0,0,11000,-11000,-11000
20200316,058157,華通台新99購01,,,,,0.00,0.00,0,0,0,0,0,0,0,0,0,0,0,0,0
20200316,058158,台積電台新99購01,0.41,0.49,0.38,0.38,-0.01,-2.56,1206000,33,571710,0,0,0,0,0,0,1206000,1168000,38000,38000
20200316,058159,健策台新9A購01,,,,,0.00,0.00,0,0,0,0,0,0,0,0,0,0,0,0,0
20200316,05815P,台積電凱基97售06,3.58,3.58,3.58,3.58,-0.28,-7.25,5000,1,17900,0,0,0,0,0,0,5000,0,5000,5000
20200316,058160,奇鋐元富99購01,1.41,1.54,1.25,1.25,+0.02,1.63,140000,17,212300,0,0,0,0,0,0,10000,130000,-120000,-120000
20200316,058161,T50反1日盛03購01,1.98,2.19,1.98,2.19,+0.25,12.89,11000,5,23440,0,0,0,0,0,0,2000,9000,-7000,-7000
20200316,058162,上銀日盛9B購01,0.22,0.22,0.22,0.22,-0.03,-12.0,20000,1,4400,0,0,0,0,0,0,20000,0,20000,20000
20200316,058163,道瓊反凱基9B購01,3.69,3.69,3.45,3.55,-0.05,-1.39,158000,17,562590,0,0,0,0,0,0,18000,152000,-134000,-134000
20200316,058164,FBVIX凱基03購02,,,,,0.00,0.00,0,0,0,0,0,0,0,0,0,0,0,0,0
20200316,058165,FBVIX凱基9C購01,6.70,6.70,6.70,6.70,+0.25,3.88,1000,1,6700,0,0,0,0,0,0,1000,0,1000,1000
20200316,058166,鴻海凱基9A購01,1.17,1.20,1.03,1.03,-0.20,-16.26,125000,26,132690,0,0,0,0,0,0,125000,125000,0,0
20200316,058167,鴻海凱基9A購03,1.58,1.63,1.31,1.31,+0.05,3.97,161000,25,225770,0,0,0,0,0,0,131000,161000,-30000,-30000
20200316,058168,國巨凱基9A購04,0.41,0.41,0.35,0.35,-0.09,-20.45,236000,3,91260,0,0,0,0,0,0,136000,100000,36000,36000
20200316,058169,國巨凱基9A購05,0.26,0.26,0.21,0.21,-0.04,-16.0,211000,11,48380,0,0,0,0,0,0,55000,126000,-71000,-71000
20200316,05816P,台積電凱基97售07,13.20,13.70,13.20,13.70,0.00,0.00,110000,2,1502000,0,0,0,0,0,0,110000,110000,0,0
20200316,058170,國巨凱基9A購06,,,,,0.00,0.00,0,0,0,0,0,0,0,0,0,0,0,0,0
20200316,058171,國巨凱基9A購07,0.35,0.35,0.35,0.35,0.00,0.00,10000,1,3500,0,0,0,0,0,0,0,10000,-10000,-10000
20200316,058172,國巨凱基9B購02,0.21,0.21,0.15,0.15,-0.06,-28.57,369000,6,69550,0,0,0,0,0,0,220000,149000,71000,71000
20200316,058173,台積電凱基99購04,1.06,1.09,0.74,0.76,-0.36,-32.14,366000,30,344080,0,0,0,0,0,0,159000,194000,-35000,-35000
20200316,058174,台積電凱基9A購05,1.45,1.47,1.12,1.12,-0.42,-27.27,2134000,32,2888090,0,0,0,0,0,0,353000,1781000,-1428000,-1428000
20200316,058175,旺宏凱基99購03,0.80,0.80,0.80,0.80,+0.06,8.11,14000,2,11200,0,0,0,0,0,0,14000,0,14000,14000
20200316,058176,聯發科凱基99購05,0.81,0.81,0.81,0.81,+0.09,12.5,68000,1,55080,0,0,0,0,0,0,68000,0,68000,68000
20200316,058177,華新科凱基99購02,0.75,0.79,0.75,0.78,0.00,0.00,40000,4,30800,0,0,0,0,0,0,0,40000,-40000,-40000
20200316,058178,國巨國泰9A購02,,,,,0.00,0.00,0,0,0,0,0,0,0,0,0,0,0,0,0
20200316,058179,國巨國泰9B購02,0.19,0.19,0.19,0.19,0.00,0.00,6000,1,1140,0,0,0,0,0,0,6000,0,6000,6000
20200316,05817P,可成凱基96售07,2.60,2.60,2.60,2.60,-0.34,-11.56,40000,1,104000,0,0,0,0,0,0,0,40000,-40000,-40000
20200316,058180,華新科國泰9A購01,,,,,0.00,0.00,0,0,0,0,0,0,0,0,0,0,0,0,0
20200316,058181,華新科國泰9B購01,,,,,0.00,0.00,0,0,0,0,0,0,0,0,0,0,0,0,0
20200316,058182,日電貿國泰9A購01,0.70,0.70,0.62,0.62,0.00,0.00,60000,3,41200,0,0,0,0,0,0,10000,50000,-40000,-40000
20200316,058183,國巨富邦9A購06,,,,,0.00,0.00,0,0,0,0,0,0,0,0,0,0,0,0,0
20200316,058184,鴻海永豐99購01,0.54,0.54,0.49,0.49,-0.11,-18.33,97000,4,52140,0,0,0,0,0,0,85000,12000,73000,73000
20200316,058185,國巨永豐99購01,0.11,0.12,0.11,0.12,0.00,0.00,150000,9,17900,0,0,0,0,0,0,0,150000,-150000,-150000
20200316,058186,聯發科永豐99購01,0.72,0.72,0.49,0.49,-0.29,-37.18,663000,21,416440,0,0,0,0,0,0,300000,413000,-113000,-113000
20200316,058187,泰碩永豐99購01,1.43,1.43,0.90,0.90,0.00,0.00,20000,2,23300,0,0,0,0,0,0,20000,0,20000,20000
20200316,058188,華擎永豐99購01,0.34,0.34,0.31,0.31,+0.08,34.78,255000,3,80700,0,0,0,0,0,0,55000,200000,-145000,-145000
20200316,058189,嘉澤永豐99購01,0.34,0.34,0.34,0.34,+0.11,47.83,40000,1,13600,0,0,0,0,0,0,40000,0,40000,40000
20200316,05818P,大立光凱基96售14,,,,,0.00,0.00,0,0,0,0,0,0,0,0,0,0,0,0,0
20200316,058190,貿聯永豐99購01,,,,,0.00,0.00,0,0,0,0,0,0,0,0,0,0,0,0,0
20200316,058191,祥碩永豐99購01,0.78,0.78,0.60,0.61,-0.10,-14.08,4429000,70,3182190,0,0,0,0,0,0,2910000,1365000,1545000,1545000
20200316,058192,訊芯永豐99購01,0.16,0.16,0.16,0.16,-0.02,-11.11,100000,1,16000,0,0,0,0,0,0,0,100000,-100000,-100000
20200316,058193,緯穎永豐99購01,1.07,1.16,1.07,1.12,+0.44,64.71,30000,12,33430,0,0,0,0,0,0,30000,0,30000,30000
20200316,058194,勤誠永豐99購01,0.44,0.44,0.44,0.44,0.00,0.00,27000,1,11880,0,0,0,0,0,0,0,27000,-27000,-27000
20200316,058195,鈺齊永豐99購01,0.36,0.36,0.25,0.25,-0.05,-16.67,30000,3,9450,0,0,0,0,0,0,30000,0,30000,30000
20200316,058196,台塑中信99購01,0.82,0.82,0.70,0.70,-0.19,-21.35,127000,4,101550,0,0,0,0,0,0,116000,11000,105000,105000
20200316,058197,國巨中信99購02,,,,,0.00,0.00,0,0,0,0,0,0,0,0,0,0,0,0,0
20200316,058198,瑞昱亞東99購01,,,,,0.00,0.00,0,0,0,0,0,0,0,0,0,0,0,0,0
20200316,058199,國巨康和99購01,,,,,0.00,0.00,0,0,0,0,0,0,0,0,0,0,0,0,0
20200316,05819P,臺股指凱基96售16,,,,,0.00,0.00,0,0,0,0,0,0,0,0,0,0,0,0,0
20200316,058200,世芯康和99購01,0.48,0.49,0.46,0.47,-0.03,-6.0,140000,21,66900,0,0,0,0,0,0,140000,0,140000,140000
20200316,058201,華通凱基9A購01,0.74,0.74,0.74,0.74,0.00,0.00,7000,1,5180,0,0,0,0,0,0,7000,0,7000,7000
20200316,058202,鴻海凱基9A購04,0.65,0.65,0.62,0.62,+0.02,3.33,88000,3,54910,0,0,0,0,0,0,83000,0,83000,83000
20200316,058203,信邦凱基99購01,0.51,0.52,0.51,0.52,-0.02,-3.7,160000,4,83000,0,0,0,0,0,0,20000,140000,-120000,-120000
20200316,058204,世芯凱基9A購01,0.84,0.85,0.54,0.54,-0.29,-34.94,249000,27,187640,0,0,0,0,0,0,233000,28000,205000,205000
20200316,058205,神達凱基9B購01,0.59,0.65,0.50,0.50,-0.14,-21.88,314000,16,187200,0,0,0,0,0,0,258000,62000,196000,196000
20200316,058206,祥碩凱基99購01,1.50,1.53,1.17,1.17,-0.32,-21.48,616000,63,871620,0,0,0,0,0,0,594000,160000,434000,434000
20200316,058207,南茂凱基99購01,0.72,0.72,0.56,0.56,-0.13,-18.84,1561000,30,1078370,0,0,0,0,0,0,1268000,457000,811000,811000
20200316,058208,百和凱基99購01,0.55,0.55,0.34,0.34,-0.12,-26.09,45000,4,18950,0,0,0,0,0,0,20000,25000,-5000,-5000
20200316,058209,臺股指凱基01購01,0.30,0.30,0.17,0.18,-0.16,-47.06,274000,26,64920,0,0,0,0,0,0,22000,144000,-122000,-122000
20200316,05820P,臺股指凱基96售17,,,,,0.00,0.00,0,0,0,0,0,0,0,0,0,0,0,0,0
20200316,058210,臺股指凱基9C購04,0.50,0.50,0.24,0.29,-0.21,-42.0,987000,88,359890,0,0,0,0,0,0,0,0,0,0
20200316,058211,國巨群益9A購02,0.84,0.84,0.84,0.84,+0.08,10.53,150000,1,126000,0,0,0,0,0,0,0,150000,-150000,-150000
20200316,058212,華新科群益9A購01,0.93,0.93,0.62,0.62,-0.03,-4.62,302000,4,228600,0,0,0,0,0,0,102000,200000,-98000,-98000
20200316,058213,欣興群益99購01,,,,,0.00,0.00,0,0,0,0,0,0,0,0,0,0,0,0,0
20200316,058214,世芯群益9A購01,1.01,1.01,1.01,1.01,+0.19,23.17,10000,1,10100,0,0,0,0,0,0,10000,0,10000,10000
20200316,058215,貿聯群益99購02,,,,,0.00,0.00,0,0,0,0,0,0,0,0,0,0,0,0,0
20200316,058216,TPK群益99購01,,,,,0.00,0.00,0,0,0,0,0,0,0,0,0,0,0,0,0
20200316,058217,新唐群益99購01,,,,,0.00,0.00,0,0,0,0,0,0,0,0,0,0,0,0,0
20200316,058218,緯穎群益99購01,,,,,0.00,0.00,0,0,0,0,0,0,0,0,0,0,0,0,0
20200316,058219,台灣50國票9A購02,1.08,1.08,0.79,0.79,-0.56,-41.48,74000,8,69110,0,0,0,0,0,0,1000,48000,-47000,-47000
20200316,05821P,臺股指凱基96售18,,,,,0.00,0.00,0,0,0,0,0,0,0,0,0,0,0,0,0
20200316,058220,世芯國票9A購01,0.87,0.87,0.87,0.87,-0.30,-25.64,12000,1,10440,0,0,0,0,0,0,12000,0,12000,12000
20200316,058221,上銀統一99購04,,,,,0.00,0.00,0,0,0,0,0,0,0,0,0,0,0,0,0
20200316,058222,玉晶光統一9B購01,,,,,0.00,0.00,0,0,0,0,0,0,0,0,0,0,0,0,0
20200316,058223,世芯統一9B購01,1.33,1.33,1.33,1.33,+0.13,10.83,5000,1,6650,0,0,0,0,0,0,5000,0,5000,5000
20200316,058224,世芯統一9B購02,0.72,0.72,0.70,0.70,+0.09,14.75,13000,2,9300,0,0,0,0,0,0,13000,0,13000,13000
20200316,058225,旺宏元富99購01,1.03,1.05,0.71,0.71,-0.11,-13.41,528000,12,462780,0,0,0,0,0,0,298000,230000,68000,68000
20200316,058226,世芯元富99購01,1.86,1.89,1.17,1.26,-0.45,-26.32,416000,43,685210,0,0,0,0,0,0,272000,133000,139000,139000
20200316,058227,台灣50元大9C購01,0.92,0.92,0.71,0.71,-0.04,-5.33,196000,29,155850,0,0,0,0,0,0,12000,173000,-161000,-161000
20200316,058228,為升元大99購01,0.36,0.36,0.21,0.23,-0.13,-36.11,418000,47,99810,0,0,0,0,0,0,135000,353000,-218000,-218000
20200316,058229,為升元大99購02,0.41,0.41,0.28,0.28,-0.12,-30.0,114000,6,40940,0,0,0,0,0,0,74000,40000,34000,34000
20200316,05822P,臺股指凱基96售19,,,,,0.00,0.00,0,0,0,0,0,0,0,0,0,0,0,0,0
20200316,058230,國巨元大99購11,0.76,0.76,0.65,0.65,-0.10,-13.33,45000,8,31500,0,0,0,0,0,0,10000,35000,-25000,-25000
20200316,058231,技嘉元大99購02,1.17,1.18,1.16,1.16,+0.11,10.48,36000,3,41960,0,0,0,0,0,0,31000,5000,26000,26000
20200316,058232,聯發科元大99購05,1.63,1.79,1.27,1.32,-0.57,-30.16,158000,19,254840,0,0,0,0,0,0,158000,70000,88000,88000
20200316,058233,聯發科元大99購06,1.88,2.03,1.48,1.64,-0.50,-23.36,204000,25,362260,0,0,0,0,0,0,154000,134000,20000,20000
20200316,058234,華新科元大99購12,,,,,0.00,0.00,0,0,0,0,0,0,0,0,0,0,0,0,0
20200316,058235,大立光元大99購08,1.79,1.79,1.26,1.32,-0.57,-30.16,663000,61,1015820,0,0,0,0,0,0,323000,441000,-118000,-118000
20200316,058236,大立光元大99購09,1.72,1.72,1.17,1.17,-0.54,-31.58,80000,6,113700,0,0,0,0,0,0,40000,40000,0,0
20200316,058237,嘉晶元大99購04,2.91,2.99,2.50,2.50,-0.31,-11.03,259000,19,702710,0,0,0,0,0,0,178000,108000,70000,70000
20200316,058238,奇鋐元大99購02,1.59,1.64,1.45,1.45,-0.01,-0.68,33000,5,52660,0,0,0,0,0,0,29000,9000,20000,20000
20200316,058239,景碩元大99購03,0.90,0.90,0.88,0.88,+0.15,20.55,20000,3,17880,0,0,0,0,0,0,20000,0,20000,20000
20200316,05823P,臺股指凱基96售20,,,,,0.00,0.00,0,0,0,0,0,0,0,0,0,0,0,0,0
20200316,058240,景碩元大99購04,0.91,0.91,0.91,0.91,+0.14,18.18,10000,1,9100,0,0,0,0,0,0,10000,0,10000,10000
20200316,058241,景碩元大99購05,,,,,0.00,0.00,0,0,0,0,0,0,0,0,0,0,0,0,0
20200316,058242,玉晶光元大9A購01,,,,,0.00,0.00,0,0,0,0,0,0,0,0,0,0,0,0,0
20200316,058243,華擎元大99購01,0.48,0.52,0.45,0.45,+0.01,2.27,117000,12,55730,0,0,0,0,0,0,50000,67000,-17000,-17000
20200316,058244,神達元大99購02,0.72,0.84,0.72,0.83,0.00,0.00,224000,8,182300,0,0,0,0,0,0,224000,6000,218000,218000
20200316,058245,訊連元大99購01,0.72,0.77,0.62,0.62,-0.04,-6.06,75000,10,52510,0,0,0,0,0,0,9000,66000,-57000,-57000
20200316,058246,帆宣元大99購01,0.39,0.39,0.39,0.39,0.00,0.00,10000,1,3900,0,0,0,0,0,0,0,10000,-10000,-10000
20200316,058247,聯茂元大99購04,0.80,0.85,0.69,0.71,+0.03,4.41,88000,10,68600,0,0,0,0,0,0,28000,78000,-50000,-50000
20200316,058248,聯茂元大99購05,0.76,0.83,0.65,0.67,+0.05,8.06,55000,6,40200,0,0,0,0,0,0,15000,45000,-30000,-30000
20200316,058249,緯穎元大99購04,1.92,1.92,1.79,1.79,+0.39,27.86,31000,4,57820,0,0,0,0,0,0,11000,30000,-19000,-19000
20200316,05824P,臺股指凱基96售21,,,,,0.00,0.00,0,0,0,0,0,0,0,0,0,0,0,0,0
20200316,058250,台虹元大99購01,2.10,2.21,2.10,2.21,+0.13,6.25,65000,4,140890,0,0,0,0,0,0,65000,0,65000,65000
20200316,058251,百和元大99購03,,,,,0.00,0.00,0,0,0,0,0,0,0,0,0,0,0,0,0
20200316,058252,臺股指元大9A購16,0.47,0.47,0.46,0.46,0.00,0.00,10000,2,4650,0,0,0,0,0,0,0,10000,-10000,-10000
20200316,058253,臺股指元大9A購17,0.37,0.38,0.21,0.26,+0.06,30.0,500000,16,146620,0,0,0,0,0,0,340000,103000,237000,237000
20200316,058254,臺股指元大9A購18,,,,,0.00,0.00,0,0,0,0,0,0,0,0,0,0,0,0,0
20200316,058255,臺股指元大9A購19,,,,,0.00,0.00,0,0,0,0,0,0,0,0,0,0,0,0,0
20200316,058256,臺股指元大9A購20,0.57,0.65,0.57,0.61,-0.19,-23.75,78000,7,47970,0,0,0,0,0,0,0,0,0,0
20200316,058257,聯陽國泰9B購01,1.26,1.35,1.02,1.02,-0.33,-24.44,431000,22,523590,0,0,0,0,0,0,316000,113000,203000,203000
20200316,058258,世芯國泰9A購01,0.90,0.90,0.78,0.78,-0.15,-16.13,113000,4,89180,0,0,0,0,0,0,113000,10000,103000,103000
20200316,058259,訊連國泰9B購01,1.15,1.23,0.91,0.91,-0.24,-20.87,557000,35,603790,0,0,0,0,0,0,293000,264000,29000,29000
20200316,05825P,臺股指凱基96售22,,,,,0.00,0.00,0,0,0,0,0,0,0,0,0,0,0,0,0
20200316,058260,華新科富邦9C購01,0.10,0.10,0.10,0.10,-0.02,-16.67,5000,1,500,0,0,0,0,0,0,5000,0,5000,5000
20200316,058261,大立光富邦03購01,0.44,0.44,0.31,0.35,-0.06,-14.63,260000,19,93560,0,0,0,0,0,0,62000,101000,-39000,-39000
20200316,058262,大立光富邦9C購02,,,,,0.00,0.00,0,0,0,0,0,0,0,0,0,0,0,0,0
20200316,058263,大成鋼永豐99購01,0.64,0.66,0.59,0.59,-0.11,-15.71,72000,4,43820,0,0,0,0,0,0,72000,0,72000,72000
20200316,058264,瑞昱永豐99購01,0.44,0.44,0.44,0.44,-0.11,-20.0,68000,1,29920,0,0,0,0,0,0,68000,0,68000,68000
20200316,058265,奇力新永豐9A購01,,,,,0.00,0.00,0,0,0,0,0,0,0,0,0,0,0,0,0
20200316,058266,宏達電永豐99購01,0.49,0.49,0.36,0.37,-0.15,-28.85,77000,4,28410,0,0,0,0,0,0,75000,3000,72000,72000
20200316,058267,奇鋐永豐99購01,,,,,0.00,0.00,0,0,0,0,0,0,0,0,0,0,0,0,0
20200316,058268,泰碩永豐9A購01,,,,,0.00,0.00,0,0,0,0,0,0,0,0,0,0,0,0,0
20200316,058269,世芯永豐9A購01,0.70,0.70,0.58,0.58,-0.11,-15.94,39000,3,25650,0,0,0,0,0,0,39000,19000,20000,20000
20200316,05826P,臺股指凱基96售23,,,,,0.00,0.00,0,0,0,0,0,0,0,0,0,0,0,0,0
20200316,058270,上緯控永豐99購01,,,,,0.00,0.00,0,0,0,0,0,0,0,0,0,0,0,0,0
20200316,058271,訊連永豐99購01,0.48,0.49,0.39,0.39,-0.06,-13.33,59000,13,27230,0,0,0,0,0,0,46000,13000,33000,33000
20200316,058272,超眾永豐9A購01,0.31,0.31,0.31,0.31,-0.07,-18.42,10000,1,3100,0,0,0,0,0,0,0,10000,-10000,-10000
20200316,058273,同欣電永豐99購01,0.17,0.17,0.15,0.15,0.00,0.00,20000,2,3200,0,0,0,0,0,0,0,20000,-20000,-20000
20200316,058274,世紀鋼永豐99購01,2.28,2.34,2.07,2.07,-0.09,-4.17,284000,18,631560,0,0,0,0,0,0,280000,4000,276000,276000
20200316,058275,S&P500中信9B購01,0.17,0.20,0.17,0.20,-0.03,-13.04,121000,4,22200,0,0,0,0,0,0,121000,0,121000,121000
20200316,058276,道瓊指中信9C購01,0.17,0.21,0.16,0.20,-0.11,-35.48,585000,14,104590,0,0,0,0,0,0,474000,0,474000,474000
20200316,058277,FBVIX中信03購01,,,,,0.00,0.00,0,0,0,0,0,0,0,0,0,0,0,0,0
20200316,058278,FBVIX中信03購02,3.60,4.04,3.60,4.04,+0.53,15.1,213000,37,837470,0,0,0,0,0,0,162000,47000,115000,115000
20200316,058279,FBVIX中信03購03,,,,,0.00,0.00,0,0,0,0,0,0,0,0,0,0,0,0,0
20200316,05827P,台積電統一96售10,,,,,0.00,0.00,0,0,0,0,0,0,0,0,0,0,0,0,0
20200316,058280,SGBR2X中信99購01,,,,,0.00,0.00,0,0,0,0,0,0,0,0,0,0,0,0,0
20200316,058281,奇力新中信99購01,0.37,0.37,0.27,0.27,-0.04,-12.9,69000,8,21750,0,0,0,0,0,0,10000,59000,-49000,-49000
20200316,058282,聯茂中信99購01,0.28,0.40,0.27,0.36,-0.02,-5.26,123000,10,42660,0,0,0,0,0,0,30000,93000,-63000,-63000
20200316,058283,世紀鋼中信99購01,1.63,1.74,1.46,1.46,+0.02,1.39,1287000,117,2087930,0,0,0,0,0,0,630000,583000,47000,47000
20200316,058284,滬深反群益01購01,1.32,1.48,1.32,1.48,+0.08,5.71,75000,5,107100,0,0,0,0,0,0,5000,70000,-65000,-65000
20200316,058285,牧德群益9A購02,,,,,0.00,0.00,0,0,0,0,0,0,0,0,0,0,0,0,0
20200316,058286,道瓊指國票9B購01,,,,,0.00,0.00,0,0,0,0,0,0,0,0,0,0,0,0,0
20200316,058287,國巨國票9A購02,,,,,0.00,0.00,0,0,0,0,0,0,0,0,0,0,0,0,0
20200316,058288,南亞科國票9A購01,0.35,0.35,0.23,0.23,-0.12,-34.29,60000,6,15000,0,0,0,0,0,0,10000,50000,-40000,-40000
20200316,058289,奇鋐國票9A購01,1.54,1.55,1.53,1.54,+0.05,3.36,210000,5,323900,0,0,0,0,0,0,210000,0,210000,210000
20200316,05828P,台積電統一97售02,3.69,3.69,3.69,3.69,-0.54,-12.77,10000,1,36900,0,0,0,0,0,0,10000,10000,0,0
20200316,058290,南電國票9A購01,1.00,1.00,1.00,1.00,+0.31,44.93,15000,1,15000,0,0,0,0,0,0,15000,0,15000,15000
20200316,058291,元油2X日盛99購01,0.05,0.06,0.05,0.06,0.00,0.00,60000,4,3100,0,0,0,0,0,0,0,0,0,0
20200316,058292,上銀凱基9A購01,0.50,0.53,0.38,0.38,-0.09,-19.15,140000,13,62000,0,0,0,0,0,0,20000,120000,-100000,-100000
20200316,058293,光寶科凱基9A購01,0.96,0.99,0.92,0.92,-0.11,-10.68,72000,5,69100,0,0,0,0,0,0,62000,29000,33000,33000
20200316,058294,華新科凱基9A購01,,,,,0.00,0.00,0,0,0,0,0,0,0,0,0,0,0,0,0
20200316,058295,欣興凱基99購02,,,,,0.00,0.00,0,0,0,0,0,0,0,0,0,0,0,0,0
20200316,058296,明泰凱基99購01,0.49,0.49,0.48,0.49,+0.07,16.67,120000,3,58700,0,0,0,0,0,0,0,120000,-120000,-120000
20200316,058297,茂林凱基9A購02,,,,,0.00,0.00,0,0,0,0,0,0,0,0,0,0,0,0,0
20200316,058298,聯茂凱基99購05,0.74,0.82,0.72,0.72,+0.07,10.77,54000,5,39910,0,0,0,0,0,0,48000,9000,39000,39000
20200316,058299,同欣電凱基9A購01,0.32,0.33,0.23,0.23,-0.07,-23.33,142000,12,41580,0,0,0,0,0,0,132000,10000,122000,122000
20200316,05829P,臺股指統一96售08,,,,,0.00,0.00,0,0,0,0,0,0,0,0,0,0,0,0,0
20200316,058300,元油2X元大99購09,,,,,0.00,0.00,0,0,0,0,0,0,0,0,0,0,0,0,0
20200316,058301,元油2X元大99購10,,,,,0.00,0.00,0,0,0,0,0,0,0,0,0,0,0,0,0
20200316,058302,元油2X元大99購11,,,,,0.00,0.00,0,0,0,0,0,0,0,0,0,0,0,0,0
20200316,058303,華通元大99購03,1.40,1.45,1.03,1.11,-0.22,-16.54,259000,30,326540,0,0,0,0,0,0,167000,177000,-10000,-10000
20200316,058304,鴻海元大99購12,2.03,2.13,1.67,1.69,-0.60,-26.2,489000,46,906490,0,0,0,0,0,0,459000,427000,32000,32000
20200316,058305,華邦電元大99購02,0.69,0.72,0.45,0.45,-0.19,-29.69,180000,22,105220,0,0,0,0,0,0,54000,140000,-86000,-86000
20200316,058306,聯發科元大99購07,2.14,2.20,1.71,1.76,-0.50,-22.12,119000,16,239950,0,0,0,0,0,0,109000,99000,10000,10000
20200316,058307,聯發科元大99購08,2.17,2.31,1.71,1.86,-0.46,-19.83,104000,17,209700,0,0,0,0,0,0,104000,83000,21000,21000
20200316,058308,全新元大9B購01,,,,,0.00,0.00,0,0,0,0,0,0,0,0,0,0,0,0,0
20200316,058309,大毅元大99購02,1.50,1.62,1.27,1.27,0.00,0.00,45000,5,64850,0,0,0,0,0,0,0,45000,-45000,-45000
20200316,05830P,滬深2X元富99售03,2.78,3.05,2.78,3.05,+0.43,16.41,75000,4,211500,0,0,0,0,0,0,70000,0,70000,70000
20200316,058310,大立光元大99購10,2.04,2.08,1.49,1.54,-0.63,-29.03,263000,42,474410,0,0,0,0,0,0,93000,204000,-111000,-111000
20200316,058311,緯穎元大99購05,2.85,3.00,2.39,2.39,-0.35,-12.77,115000,34,309860,0,0,0,0,0,0,75000,56000,19000,19000
20200316,058312,大毅國泰9B購01,0.67,0.75,0.51,0.51,-0.17,-25.0,274000,11,181640,0,0,0,0,0,0,30000,244000,-214000,-214000
20200316,058313,台積電富邦9B購04,0.46,0.46,0.46,0.46,0.00,0.00,80000,2,36800,0,0,0,0,0,0,80000,80000,0,0
20200316,058314,欣興富邦9B購01,0.19,0.19,0.16,0.16,-0.04,-20.0,3000,3,530,0,0,0,0,0,0,0,3000,-3000,-3000
20200316,058315,TPK富邦9C購01,0.36,0.36,0.36,0.36,0.00,0.00,20000,1,7200,0,0,0,0,0,0,0,20000,-20000,-20000
20200316,058316,元油2X永豐9A購03,,,,,0.00,0.00,0,0,0,0,0,0,0,0,0,0,0,0,0
20200316,058317,國巨永豐99購02,,,,,0.00,0.00,0,0,0,0,0,0,0,0,0,0,0,0,0
20200316,058318,致茂永豐9A購01,0.52,0.53,0.36,0.36,-0.08,-18.18,114000,18,55450,0,0,0,0,0,0,87000,27000,60000,60000
20200316,058319,大毅永豐9A購01,0.57,0.57,0.52,0.52,+0.02,4.0,10000,3,5300,0,0,0,0,0,0,2000,8000,-6000,-6000
20200316,05831P,臺股指元富96售03,,,,,0.00,0.00,0,0,0,0,0,0,0,0,0,0,0,0,0
20200316,058320,華新科永豐99購02,0.36,0.36,0.34,0.34,+0.06,21.43,25000,2,8800,0,0,0,0,0,0,0,25000,-25000,-25000
20200316,058321,大立光永豐99購01,0.76,0.76,0.76,0.76,-0.15,-16.48,2000,2,1520,0,0,0,0,0,0,2000,2000,0,0
20200316,058322,玉晶光永豐99購02,0.54,0.54,0.39,0.39,-0.19,-32.76,75000,6,35200,0,0,0,0,0,0,0,75000,-75000,-75000
20200316,058323,泰鼎永豐9A購01,0.51,0.53,0.41,0.41,0.00,0.00,41000,4,19310,0,0,0,0,0,0,11000,30000,-19000,-19000
20200316,058324,嘉聯益永豐9A購01,0.52,0.52,0.44,0.44,-0.06,-12.0,70000,7,34400,0,0,0,0,0,0,15000,55000,-40000,-40000
20200316,058325,昇陽半永豐99購01,,,,,0.00,0.00,0,0,0,0,0,0,0,0,0,0,0,0,0
20200316,058326,祥碩台新99購01,,,,,0.00,0.00,0,0,0,0,0,0,0,0,0,0,0,0,0
20200316,058327,大毅統一9B購01,,,,,0.00,0.00,0,0,0,0,0,0,0,0,0,0,0,0,0
20200316,058328,世紀鋼統一9B購01,1.09,1.12,0.99,0.99,+0.11,12.5,82000,22,87970,0,0,0,0,0,0,0,81000,-81000,-81000
20200316,058329,S&P正2元富01購01,0.24,0.24,0.19,0.24,-0.06,-20.0,498000,20,118120,0,0,0,0,0,0,0,0,0,0
20200316,05832P,臺股指元富96售04,,,,,0.00,0.00,0,0,0,0,0,0,0,0,0,0,0,0,0
20200316,058330,鴻海元富99購01,1.16,1.18,0.88,0.91,-0.33,-26.61,737000,22,735660,0,0,0,0,0,0,335000,579000,-244000,-244000
20200316,058331,鴻海元富99購02,0.88,0.88,0.75,0.75,-0.30,-28.57,120000,5,93540,0,0,0,0,0,0,88000,0,88000,88000
20200316,058332,鴻海元富99購03,1.11,1.12,0.94,0.98,-0.24,-19.67,643000,16,630470,0,0,0,0,0,0,203000,523000,-320000,-320000
20200316,058333,鴻海元富99購04,1.07,1.10,1.06,1.10,-0.06,-5.17,141000,3,154400,0,0,0,0,0,0,131000,10000,121000,121000
20200316,058334,鴻海元富99購05,0.99,0.99,0.81,0.82,+0.03,3.8,277000,6,248570,0,0,0,0,0,0,227000,50000,177000,177000
20200316,058335,鴻海元富99購06,0.89,0.90,0.65,0.65,-0.33,-33.67,179000,6,154210,0,0,0,0,0,0,159000,20000,139000,139000
20200316,058336,鴻海元富99購07,0.79,0.79,0.63,0.63,-0.24,-27.59,198000,3,132260,0,0,0,0,0,0,188000,10000,178000,178000
20200316,058337,日月光元富99購01,0.69,0.69,0.64,0.64,+0.11,20.75,268000,18,177320,0,0,0,0,0,0,98000,170000,-72000,-72000
20200316,058338,康友元富99購01,1.24,1.36,0.93,0.93,-0.41,-30.6,220000,21,258250,0,0,0,0,0,0,70000,150000,-80000,-80000
20200316,058339,康友元富99購02,1.28,1.28,1.12,1.12,-0.06,-5.08,21000,3,23680,0,0,0,0,0,0,1000,20000,-19000,-19000
20200316,05833P,臺股指元富96售05,,,,,0.00,0.00,0,0,0,0,0,0,0,0,0,0,0,0,0
20200316,058340,高股息群益99購01,0.25,0.26,0.19,0.19,0.00,0.00,4978000,21,1080220,0,0,0,0,0,0,4899000,4978000,-79000,-79000
20200316,058341,T50反1群益99購01,1.37,1.57,1.30,1.57,+0.30,23.62,243000,24,348370,0,0,0,0,0,0,66000,40000,26000,26000
20200316,058342,鴻海群益9A購01,1.41,1.44,1.32,1.32,-0.01,-0.75,71000,7,94270,0,0,0,0,0,0,71000,11000,60000,60000
20200316,058343,台積電群益99購02,0.96,0.96,0.70,0.70,-0.09,-11.39,301000,7,213900,0,0,0,0,0,0,19000,282000,-263000,-263000
20200316,058344,旺宏群益99購05,1.79,1.79,1.35,1.35,-0.31,-18.67,143000,10,221440,0,0,0,0,0,0,40000,118000,-78000,-78000
20200316,058345,台光電群益99購03,0.57,0.57,0.57,0.57,+0.06,11.76,1000,1,570,0,0,0,0,0,0,1000,0,1000,1000
20200316,058346,嘉晶群益99購01,1.18,1.21,1.10,1.10,+0.02,1.85,12000,3,14140,0,0,0,0,0,0,11000,1000,10000,10000
20200316,058347,玉晶光群益9B購01,2.31,2.31,1.49,1.49,-0.65,-30.37,218000,5,433040,0,0,0,0,0,0,212000,9000,203000,203000
20200316,058348,台表科群益99購01,0.64,0.71,0.64,0.71,0.00,0.00,2000,2,1350,0,0,0,0,0,0,1000,1000,0,0
20200316,058349,滬深2X日盛9A購01,1.04,1.04,1.04,1.04,-0.11,-9.57,4000,2,4160,0,0,0,0,0,0,0,4000,-4000,-4000
20200316,05834P,臺股指元富96售06,,,,,0.00,0.00,0,0,0,0,0,0,0,0,0,0,0,0,0
20200316,058350,T50正2凱基9B購01,0.28,0.28,0.24,0.24,-0.16,-40.0,164000,5,43780,0,0,0,0,0,0,163000,0,163000,163000
20200316,058351,上銀凱基9A購02,0.54,0.54,0.40,0.40,-0.20,-33.33,3700000,14,1492700,0,0,0,0,0,0,3670000,30000,3640000,3640000
20200316,058352,鴻海凱基9A購05,1.01,1.03,0.87,0.87,-0.23,-20.91,61000,12,55960,0,0,0,0,0,0,61000,48000,13000,13000
20200316,058353,國巨凱基99購09,0.66,0.66,0.55,0.55,-0.07,-11.29,137000,5,87820,0,0,0,0,0,0,117000,20000,97000,97000
20200316,058354,台積電凱基9A購06,1.00,1.01,0.74,0.76,-0.32,-29.63,971000,58,867780,0,0,0,0,0,0,475000,528000,-53000,-53000
20200316,058355,旺宏凱基99購04,1.35,1.46,1.05,1.05,-0.26,-19.85,287000,13,373510,0,0,0,0,0,0,167000,120000,47000,47000
20200316,058356,華邦電凱基99購01,0.72,0.72,0.64,0.64,-0.01,-1.54,7000,2,4960,0,0,0,0,0,0,0,7000,-7000,-7000
20200316,058357,智邦凱基99購02,2.24,2.24,2.00,2.00,0.00,0.00,34000,7,72150,0,0,0,0,0,0,6000,28000,-22000,-22000
20200316,058358,技嘉凱基9A購01,,,,,0.00,0.00,0,0,0,0,0,0,0,0,0,0,0,0,0
20200316,058359,瑞昱凱基99購01,1.31,1.31,1.07,1.07,-0.06,-5.31,305000,15,362160,0,0,0,0,0,0,35000,290000,-255000,-255000
20200316,05835P,臺股指元富96售07,7.30,9.10,7.30,9.10,+3.30,56.9,25000,3,205000,0,0,0,0,0,0,25000,0,25000,25000
20200316,058360,台光電凱基9A購02,1.18,1.24,1.07,1.07,-0.06,-5.31,45000,5,54480,0,0,0,0,0,0,45000,0,45000,45000
20200316,058361,美律凱基99購06,1.08,1.11,0.95,0.95,+0.16,20.25,167000,14,177170,0,0,0,0,0,0,97000,98000,-1000,-1000
20200316,058362,聯發科凱基99購06,1.48,1.60,1.18,1.18,-0.10,-7.81,157000,16,220460,0,0,0,0,0,0,85000,72000,13000,13000
20200316,058363,全新凱基9A購02,1.28,1.28,1.24,1.24,+0.15,13.76,36000,3,45890,0,0,0,0,0,0,36000,0,36000,36000
20200316,058364,奇力新凱基99購04,0.63,0.63,0.46,0.46,-0.02,-4.17,6000,3,3380,0,0,0,0,0,0,4000,2000,2000,2000
20200316,058365,奇力新凱基9A購01,0.64,0.69,0.47,0.49,0.00,0.00,275000,14,170690,0,0,0,0,0,0,182000,63000,119000,119000
20200316,058366,元大金凱基99購01,0.53,0.53,0.51,0.51,+0.12,30.77,240000,7,126900,0,0,0,0,0,0,15000,225000,-210000,-210000
20200316,058367,大立光凱基9A購01,0.78,0.80,0.70,0.70,-0.14,-16.67,291000,18,216900,0,0,0,0,0,0,221000,28000,193000,193000
20200316,058368,奇鋐凱基9A購01,1.00,1.06,0.79,0.82,-0.19,-18.81,133000,29,125560,0,0,0,0,0,0,26000,117000,-91000,-91000
20200316,058369,亞光凱基99購02,1.00,1.03,0.74,0.74,-0.04,-5.13,100000,15,97030,0,0,0,0,0,0,70000,30000,40000,40000
20200316,05836P,臺股指元富96售08,,,,,0.00,0.00,0,0,0,0,0,0,0,0,0,0,0,0,0
20200316,058370,聯詠凱基99購01,0.72,0.72,0.61,0.61,-0.10,-14.08,78000,2,55060,0,0,0,0,0,0,0,78000,-78000,-78000
20200316,058371,智原凱基9A購01,0.47,0.47,0.38,0.38,0.00,0.00,15000,7,6660,0,0,0,0,0,0,9000,5000,4000,4000
20200316,058372,欣興凱基99購03,,,,,0.00,0.00,0,0,0,0,0,0,0,0,0,0,0,0,0
20200316,058373,晶技凱基99購02,1.43,1.59,1.32,1.32,+0.51,62.96,265000,17,391740,0,0,0,0,0,0,27000,264000,-237000,-237000
20200316,058374,玉晶光凱基9A購03,0.86,0.86,0.75,0.75,-0.07,-8.54,90000,4,73600,0,0,0,0,0,0,50000,40000,10000,10000
20200316,058375,群創凱基9B購04,0.59,0.59,0.58,0.58,-0.08,-12.12,72000,6,41950,0,0,0,0,0,0,72000,72000,0,0
20200316,058376,貿聯凱基9A購01,0.59,0.62,0.41,0.42,-0.17,-28.81,310000,21,171060,0,0,0,0,0,0,96000,194000,-98000,-98000
20200316,058377,茂林凱基9A購03,0.85,0.85,0.65,0.65,-0.27,-29.35,266000,10,206330,0,0,0,0,0,0,68000,198000,-130000,-130000
20200316,058378,南電凱基99購01,0.98,1.02,0.75,0.75,-0.07,-8.54,381000,21,351400,0,0,0,0,0,0,367000,14000,353000,353000
20200316,058379,臺股指凱基99購14,0.29,0.36,0.22,0.25,-0.11,-30.56,4114000,219,1138690,0,0,0,0,0,0,0,367000,-367000,-367000
20200316,05837P,臺股指富邦96售04,5.55,5.55,5.55,5.55,0.00,0.00,97000,1,538350,0,0,0,0,0,0,97000,0,97000,97000
20200316,058380,臺股指凱基99購15,0.25,0.25,0.15,0.22,-0.07,-24.14,4193000,144,791440,0,0,0,0,0,0,5000,1690000,-1685000,-1685000
20200316,058381,元石油中信9C購01,0.22,0.22,0.20,0.20,-0.07,-25.93,1575000,9,316090,0,0,0,0,0,0,1466000,0,1466000,1466000
20200316,058382,S&P500中信99購01,0.17,0.25,0.16,0.16,-0.07,-30.43,830000,9,141930,0,0,0,0,0,0,484000,0,484000,484000
20200316,058383,道瓊指中信9C購02,0.31,0.31,0.18,0.24,-0.08,-25.0,945000,21,205200,0,0,0,0,0,0,455000,10000,445000,445000
20200316,058384,大成鋼中信99購01,0.50,0.50,0.46,0.46,+0.04,9.52,116000,3,56840,0,0,0,0,0,0,51000,65000,-14000,-14000
20200316,058385,創意中信99購01,0.69,0.74,0.64,0.67,+0.06,9.84,842000,23,576660,0,0,0,0,0,0,412000,430000,-18000,-18000
20200316,058386,A50正2國票9B購01,,,,,0.00,0.00,0,0,0,0,0,0,0,0,0,0,0,0,0
20200316,058387,國巨國票9A購03,0.74,0.74,0.59,0.59,-0.09,-13.24,100000,3,65900,0,0,0,0,0,0,100000,0,100000,100000
20200316,058388,健策國票9A購01,0.40,0.40,0.31,0.31,-0.13,-29.55,555000,6,202400,0,0,0,0,0,0,555000,0,555000,555000
20200316,058389,聯茂國票9A購01,,,,,0.00,0.00,0,0,0,0,0,0,0,0,0,0,0,0,0
20200316,05838P,臺股指富邦96售05,,,,,0.00,0.00,0,0,0,0,0,0,0,0,0,0,0,0,0
20200316,058390,樺漢國票9A購01,,,,,0.00,0.00,0,0,0,0,0,0,0,0,0,0,0,0,0
20200316,058391,T50反1元大99購02,1.48,1.80,1.44,1.80,+0.42,30.43,1330000,148,2092830,0,0,0,0,0,0,91000,1185000,-1094000,-1094000
20200316,058392,元油2X元大99購12,0.05,0.06,0.05,0.06,-0.02,-25.0,872000,17,47610,0,0,0,0,0,0,0,0,0,0
20200316,058393,元油2X元大99購13,0.04,0.05,0.04,0.05,-0.01,-16.67,780000,16,31300,0,0,0,0,0,0,0,0,0,0
20200316,058394,元油2X元大99購14,0.04,0.04,0.04,0.04,0.00,0.00,370000,5,14800,0,0,0,0,0,0,0,0,0,0
20200316,058395,元油2X元大99購15,0.03,0.03,0.03,0.03,-0.01,-25.0,820000,9,24600,0,0,0,0,0,0,0,0,0,0
20200316,058396,力山元大99購01,0.81,0.81,0.70,0.70,+0.07,11.11,60000,6,46800,0,0,0,0,0,0,0,60000,-60000,-60000
20200316,058397,大成鋼元大99購02,1.65,1.71,1.52,1.55,-0.14,-8.28,123000,14,201650,0,0,0,0,0,0,83000,77000,6000,6000
20200316,058398,中環元大99購02,0.50,0.56,0.50,0.52,+0.12,30.0,120000,10,63900,0,0,0,0,0,0,30000,90000,-60000,-60000
20200316,058399,美律元大99購05,0.62,0.64,0.54,0.54,-0.04,-6.9,55000,10,33020,0,0,0,0,0,0,15000,45000,-30000,-30000
20200316,05839P,臺股指富邦96售06,5.50,5.50,5.50,5.50,-0.30,-5.17,10000,1,55000,0,0,0,0,0,0,10000,0,10000,10000
20200316,058400,聯發科元大99購09,2.04,2.21,1.63,1.68,-0.62,-26.96,176000,22,346180,0,0,0,0,0,0,166000,101000,65000,65000
20200316,058401,華航元大9A購01,0.54,0.54,0.47,0.47,-0.06,-11.32,290000,9,137430,0,0,0,0,0,0,260000,30000,230000,230000
20200316,058402,欣興元大99購04,1.01,1.01,0.85,0.85,-0.14,-14.14,8000,4,7110,0,0,0,0,0,0,3000,8000,-5000,-5000
20200316,058403,玉晶光元大99購12,1.78,1.84,1.17,1.17,-0.58,-33.14,455000,27,702790,0,0,0,0,0,0,384000,198000,186000,186000
20200316,058404,貿聯元大99購02,0.50,0.50,0.34,0.34,-0.15,-30.61,47000,3,17580,0,0,0,0,0,0,37000,37000,0,0
20200316,058405,訊連元大99購02,0.76,0.76,0.67,0.67,+0.07,11.67,26000,2,18860,0,0,0,0,0,0,16000,10000,6000,6000
20200316,058406,聯茂元大99購06,0.61,0.64,0.47,0.47,-0.05,-9.62,130000,8,75990,0,0,0,0,0,0,80000,50000,30000,30000
20200316,058407,滬深2X兆豐9A購01,0.86,0.88,0.70,0.70,-0.26,-27.08,1266000,22,1005930,0,0,0,0,0,0,0,1266000,-1266000,-1266000
20200316,058408,華通兆豐99購02,0.42,0.42,0.23,0.23,-0.10,-30.3,135000,3,48050,0,0,0,0,0,0,75000,135000,-60000,-60000
20200316,058409,鴻海兆豐99購05,0.68,0.68,0.53,0.53,-0.22,-29.33,317000,9,183520,0,0,0,0,0,0,284000,34000,250000,250000
20200316,05840P,臺股指富邦96售07,2.60,2.60,2.60,2.60,+0.17,7.0,1000,1,2600,0,0,0,0,0,0,0,0,0,0
20200316,058410,國巨兆豐99購03,0.86,0.86,0.67,0.67,-0.33,-33.0,100000,7,76450,0,0,0,0,0,0,60000,40000,20000,20000
20200316,058411,技嘉兆豐99購01,,,,,0.00,0.00,0,0,0,0,0,0,0,0,0,0,0,0,0
20200316,058412,聯發科兆豐99購01,0.60,0.60,0.45,0.49,-0.10,-16.95,334000,16,177610,0,0,0,0,0,0,85000,309000,-224000,-224000
20200316,058413,義隆兆豐99購01,0.60,0.60,0.52,0.52,+0.02,4.0,111000,4,65370,0,0,0,0,0,0,30000,81000,-51000,-51000
20200316,058414,大立光兆豐99購02,0.89,0.89,0.57,0.64,-0.28,-30.43,840000,38,677860,0,0,0,0,0,0,560000,779000,-219000,-219000
20200316,058415,祥碩兆豐99購01,0.78,0.80,0.61,0.61,-0.24,-28.24,205000,7,132010,0,0,0,0,0,0,179000,25000,154000,154000
20200316,058416,鴻海麥證99購01,0.97,0.98,0.81,0.81,-0.22,-21.36,100000,16,83740,100000,0,100000,0,0,0,100000,100000,0,0
20200316,058417,國巨麥證99購01,1.34,1.34,0.83,0.85,-0.40,-32.0,92000,8,96180,50000,42000,8000,0,0,0,50000,42000,8000,8000
20200316,058418,台積電麥證99購01,,,,,0.00,0.00,0,0,0,0,0,0,0,0,0,0,0,0,0
20200316,058419,聯發科麥證99購02,1.47,1.47,1.15,1.15,+0.03,2.68,250000,7,339600,240000,10000,230000,0,0,0,240000,10000,230000,230000
20200316,05841P,華通元大96售04,,,,,0.00,0.00,0,0,0,0,0,0,0,0,0,0,0,0,0
20200316,058420,聯發科麥證99購03,1.00,1.00,0.68,0.68,-0.31,-31.31,60000,3,45900,40000,20000,20000,0,0,0,40000,20000,20000,20000
20200316,058421,國泰金麥證01購01,1.05,1.05,0.90,0.90,-0.16,-15.09,159000,8,150900,130000,29000,101000,0,0,0,130000,29000,101000,101000
20200316,058422,百和麥證99購01,0.76,0.76,0.55,0.55,-0.20,-26.67,40000,2,28300,30000,10000,20000,0,0,0,30000,10000,20000,20000
20200316,058423,臺股指麥證99購01,0.80,0.80,0.80,0.80,0.00,0.00,2000,1,1600,0,0,0,0,0,0,0,0,0,0
20200316,058424,滬深2X元富99購04,1.33,1.33,1.11,1.11,-0.18,-13.95,9000,2,11310,0,0,0,0,0,0,0,9000,-9000,-9000
20200316,058425,S&P正2元富01購02,0.34,0.36,0.31,0.31,-0.34,-52.31,2219000,24,715960,0,0,0,0,0,0,1797000,0,1797000,1797000
20200316,058426,旺宏元富99購02,1.37,1.40,0.96,0.96,-0.25,-20.66,608000,16,694980,0,0,0,0,0,0,28000,580000,-552000,-552000
20200316,058427,大毅元富99購01,1.05,1.05,0.95,0.95,+0.14,17.28,25000,2,24750,0,0,0,0,0,0,0,25000,-25000,-25000
20200316,058428,大立光元富99購02,1.45,1.45,1.13,1.13,-0.60,-34.68,18000,8,24010,0,0,0,0,0,0,10000,8000,2000,2000
20200316,058429,欣興元富99購01,0.74,0.74,0.51,0.51,-0.27,-34.62,76000,5,44720,0,0,0,0,0,0,40000,36000,4000,4000
20200316,05842P,台積電元大96售15,6.25,7.90,6.15,7.90,+1.90,31.67,395000,83,2549550,0,0,0,0,0,0,387000,375000,12000,12000
20200316,058430,滬深2X統一99購02,,,,,0.00,0.00,0,0,0,0,0,0,0,0,0,0,0,0,0
20200316,058431,國巨統一9B購01,,,,,0.00,0.00,0,0,0,0,0,0,0,0,0,0,0,0,0
20200316,058432,台積電統一9B購03,0.31,0.31,0.31,0.31,-0.07,-18.42,120000,1,37200,0,0,0,0,0,0,120000,0,120000,120000
20200316,058433,台積電統一9B購04,0.84,0.84,0.70,0.70,-0.17,-19.54,80000,5,59450,0,0,0,0,0,0,0,5000,-5000,-5000
20200316,058434,旺宏統一9B購01,,,,,0.00,0.00,0,0,0,0,0,0,0,0,0,0,0,0,0
20200316,058435,旺宏統一9B購02,,,,,0.00,0.00,0,0,0,0,0,0,0,0,0,0,0,0,0
20200316,058436,聯發科統一9B購03,0.59,0.59,0.59,0.59,-0.16,-21.33,14000,1,8260,0,0,0,0,0,0,14000,0,14000,14000
20200316,058437,可成統一9B購01,,,,,0.00,0.00,0,0,0,0,0,0,0,0,0,0,0,0,0
20200316,058438,大立光統一9B購01,0.85,0.85,0.85,0.85,+0.05,6.25,10000,1,8500,0,0,0,0,0,0,10000,0,10000,10000
20200316,058439,玉晶光統一01購02,1.15,1.15,0.86,0.86,-0.16,-15.69,9000,4,9140,0,0,0,0,0,0,4000,7000,-3000,-3000
20200316,05843P,台積電元大96售16,,,,,0.00,0.00,0,0,0,0,0,0,0,0,0,0,0,0,0
20200316,058440,玉晶光統一99購02,,,,,0.00,0.00,0,0,0,0,0,0,0,0,0,0,0,0,0
20200316,058441,T50反1台新03購01,,,,,0.00,0.00,0,0,0,0,0,0,0,0,0,0,0,0,0
20200316,058442,玉晶光台新99購01,,,,,0.00,0.00,0,0,0,0,0,0,0,0,0,0,0,0,0
20200316,058443,T50正2富邦01購01,,,,,0.00,0.00,0,0,0,0,0,0,0,0,0,0,0,0,0
20200316,058444,國巨富邦9B購01,,,,,0.00,0.00,0,0,0,0,0,0,0,0,0,0,0,0,0
20200316,058445,旺宏富邦9C購01,0.54,0.54,0.40,0.40,-0.01,-2.44,52000,6,26260,0,0,0,0,0,0,0,52000,-52000,-52000
20200316,058446,新光金富邦9C購01,0.40,0.40,0.38,0.38,-0.13,-25.49,90000,3,35400,0,0,0,0,0,0,50000,20000,30000,30000
20200316,058447,玉晶光富邦9A購02,,,,,0.00,0.00,0,0,0,0,0,0,0,0,0,0,0,0,0
20200316,058448,滬深2X永豐9A購01,0.53,0.53,0.53,0.53,0.00,0.00,2000,1,1060,0,0,0,0,0,0,0,2000,-2000,-2000
20200316,058449,台積電永豐99購01,0.52,0.52,0.45,0.45,0.00,0.00,11000,2,5650,0,0,0,0,0,0,0,11000,-11000,-11000
20200316,05844P,旺宏元大96售07,2.14,2.54,2.13,2.54,+0.13,5.39,175000,32,385790,0,0,0,0,0,0,175000,160000,15000,15000
20200316,058450,旺宏永豐99購01,0.87,0.91,0.63,0.63,-0.19,-23.17,293000,11,250540,0,0,0,0,0,0,144000,150000,-6000,-6000
20200316,058451,智邦永豐9A購01,1.07,1.17,0.96,0.96,-0.13,-11.93,562000,48,628810,0,0,0,0,0,0,391000,225000,166000,166000
20200316,058452,義隆永豐99購02,0.94,1.04,0.83,0.83,-0.05,-5.68,135000,7,133530,0,0,0,0,0,0,82000,53000,29000,29000
20200316,058453,可成永豐99購01,,,,,0.00,0.00,0,0,0,0,0,0,0,0,0,0,0,0,0
20200316,058454,嘉晶永豐99購01,1.19,1.25,1.01,1.01,-0.14,-12.17,54000,11,64490,0,0,0,0,0,0,11000,51000,-40000,-40000
20200316,058455,玉晶光永豐99購03,,,,,0.00,0.00,0,0,0,0,0,0,0,0,0,0,0,0,0
20200316,058456,京鼎永豐99購01,0.22,0.22,0.14,0.14,0.00,0.00,268000,3,53520,0,0,0,0,0,0,268000,0,268000,268000
20200316,058457,創意永豐99購01,0.55,0.61,0.47,0.47,-0.05,-9.62,567000,20,318670,0,0,0,0,0,0,164000,403000,-239000,-239000
20200316,058458,牧德永豐9A購01,0.33,0.33,0.25,0.25,-0.05,-16.67,100000,2,29000,0,0,0,0,0,0,50000,50000,0,0
20200316,058459,南電永豐99購01,0.61,0.62,0.51,0.51,+0.04,8.51,27000,5,14700,0,0,0,0,0,0,2000,25000,-23000,-23000
20200316,05845P,大立光元大96售06,5.25,6.05,5.25,6.05,+0.20,3.42,19000,4,106950,0,0,0,0,0,0,10000,9000,1000,1000
20200316,058460,臺股指永豐99購01,,,,,0.00,0.00,0,0,0,0,0,0,0,0,0,0,0,0,0
20200316,058461,滬深2X永昌9C購01,,,,,0.00,0.00,0,0,0,0,0,0,0,0,0,0,0,0,0
20200316,058462,台積電兆豐99購01,0.77,0.77,0.77,0.77,-1.45,-65.32,184000,35,141680,0,39000,-39000,0,0,0,10000,0,10000,-29000
20200316,058463,宏達電兆豐99購02,,,,,0.00,0.00,0,0,0,0,0,0,0,0,0,0,0,0,0
20200316,058464,矽創兆豐9A購01,0.65,0.66,0.45,0.45,-0.16,-26.23,842000,29,511230,0,0,0,0,0,0,541000,261000,280000,280000
20200316,058465,元石油中信01購01,,,,,0.00,0.00,0,0,0,0,0,0,0,0,0,0,0,0,0
20200316,058466,SGBR2X中信99購02,0.10,0.10,0.09,0.09,-0.04,-30.77,375000,14,36650,0,0,0,0,0,0,0,0,0,0
20200316,058467,日月光中信9A購01,0.46,0.46,0.46,0.46,+0.02,4.55,48000,1,22080,0,0,0,0,0,0,48000,0,48000,48000
20200316,058468,聯茂中信99購02,0.37,0.54,0.37,0.43,-0.09,-17.31,222000,15,104660,0,0,0,0,0,0,78000,144000,-66000,-66000
20200316,058469,臺股指中信9A購05,0.20,0.21,0.15,0.21,-0.09,-30.0,264000,14,42950,0,0,0,0,0,0,90000,25000,65000,65000
20200316,05846P,大立光元大96售07,4.43,5.00,4.43,5.00,-1.35,-21.26,14000,3,64300,0,0,0,0,0,0,10000,4000,6000,6000
20200316,058470,台灣50日盛9B購02,0.34,0.34,0.28,0.28,-0.17,-37.78,111000,5,36080,0,0,0,0,0,0,9000,0,9000,9000
20200316,058471,台積電日盛9C購01,1.30,1.30,1.08,1.09,-0.56,-33.94,35000,5,40230,0,0,0,0,0,0,0,35000,-35000,-35000
20200316,058472,亞德客凱基9A購01,0.80,0.87,0.71,0.71,+0.01,1.43,803000,15,624450,0,0,0,0,0,0,83000,720000,-637000,-637000
20200316,058473,上銀凱基9A購03,0.57,0.57,0.49,0.49,0.00,0.00,4000,2,2120,0,0,0,0,0,0,0,4000,-4000,-4000
20200316,058474,鴻海凱基9A購06,1.08,1.10,0.84,0.84,-0.39,-31.71,170000,20,153280,0,0,0,0,0,0,170000,81000,89000,89000
20200316,058475,台積電凱基99購06,0.93,0.97,0.57,0.59,-0.54,-47.79,609000,64,477150,0,0,0,0,0,0,320000,251000,69000,69000
20200316,058476,旺宏凱基9A購01,1.13,1.13,1.02,1.02,+0.16,18.6,15000,2,15850,0,0,0,0,0,0,10000,5000,5000,5000
20200316,058477,億光凱基9A購01,0.49,0.49,0.38,0.38,-0.12,-24.0,76000,4,34880,0,0,0,0,0,0,5000,71000,-66000,-66000
20200316,058478,聯發科凱基9A購01,1.16,1.20,1.04,1.04,-0.25,-19.38,66000,5,76810,0,0,0,0,0,0,43000,23000,20000,20000
20200316,058479,亞光凱基9A購01,,,,,0.00,0.00,0,0,0,0,0,0,0,0,0,0,0,0,0
20200316,05847P,大立光元大96售08,3.28,3.67,3.27,3.67,+0.37,11.21,15000,8,50110,0,0,0,0,0,0,2000,13000,-11000,-11000
20200316,058480,新日興凱基9A購01,,,,,0.00,0.00,0,0,0,0,0,0,0,0,0,0,0,0,0
20200316,058481,玉晶光凱基9A購04,,,,,0.00,0.00,0,0,0,0,0,0,0,0,0,0,0,0,0
20200316,058482,祥碩凱基99購02,1.15,1.16,0.86,0.86,-0.29,-25.22,1485000,53,1588080,0,0,0,0,0,0,1307000,143000,1164000,1164000
20200316,058483,道瓊指國票9A購01,0.25,0.25,0.22,0.25,-0.02,-7.41,970000,26,224890,0,0,0,0,0,0,0,10000,-10000,-10000
20200316,058484,元金2X國票04購01,0.54,0.60,0.54,0.58,-0.21,-26.58,16000,4,8900,0,0,0,0,0,0,0,5000,-5000,-5000
20200316,058485,智邦國票9A購01,2.62,2.62,2.45,2.49,-0.11,-4.23,126000,4,317880,0,0,0,0,0,0,126000,0,126000,126000
20200316,058486,大立光國票9A購01,1.16,1.19,1.05,1.05,-0.11,-9.48,78000,9,86160,0,0,0,0,0,0,73000,0,73000,73000
20200316,058487,晶技國票9A購01,0.81,0.87,0.81,0.87,+0.17,24.29,48000,3,39160,0,0,0,0,0,0,48000,0,48000,48000
20200316,058488,華擎國票9A購01,,,,,0.00,0.00,0,0,0,0,0,0,0,0,0,0,0,0,0
20200316,058489,台灣50群益9B購01,0.44,0.44,0.44,0.44,-0.36,-45.0,339000,2,149160,0,0,0,0,0,0,339000,0,339000,339000
20200316,05848P,臺股指元大96售24,,,,,0.00,0.00,0,0,0,0,0,0,0,0,0,0,0,0,0
20200316,058490,元黃金群益9B購01,0.53,0.58,0.53,0.57,-0.10,-14.93,350000,4,197100,0,0,0,0,0,0,0,350000,-350000,-350000
20200316,058491,滬深2X群益01購01,1.17,1.19,1.00,1.00,-0.30,-23.08,32000,12,34390,0,0,0,0,0,0,0,30000,-30000,-30000
20200316,058492,華通群益9B購01,,,,,0.00,0.00,0,0,0,0,0,0,0,0,0,0,0,0,0
20200316,058493,台積電群益9A購01,0.68,0.68,0.58,0.58,-0.03,-4.92,135000,6,87750,0,0,0,0,0,0,100000,35000,65000,65000
20200316,058494,可成群益9B購01,,,,,0.00,0.00,0,0,0,0,0,0,0,0,0,0,0,0,0
20200316,058495,元大金群益9B購01,,,,,0.00,0.00,0,0,0,0,0,0,0,0,0,0,0,0,0
20200316,058496,文曄群益99購01,,,,,0.00,0.00,0,0,0,0,0,0,0,0,0,0,0,0,0
20200316,058497,新日興群益9B購01,,,,,0.00,0.00,0,0,0,0,0,0,0,0,0,0,0,0,0
20200316,058498,世紀鋼群益99購01,1.93,2.05,1.90,2.04,+0.18,9.68,257000,18,499380,0,0,0,0,0,0,257000,0,257000,257000
20200316,058499,滬深2X元大9C購01,,,,,0.00,0.00,0,0,0,0,0,0,0,0,0,0,0,0,0
20200316,05849P,臺股指元大96售25,5.85,6.05,5.85,6.05,+0.15,2.54,20000,3,119000,0,0,0,0,0,0,19000,0,19000,19000
20200316,058500,元石油元大9C購01,0.18,0.18,0.14,0.16,-0.02,-11.11,1354000,34,204260,0,0,0,0,0,0,410000,0,410000,410000
20200316,058501,S&P正2元大99購01,0.37,0.37,0.20,0.22,-0.13,-37.14,235000,16,57330,0,0,0,0,0,0,50000,28000,22000,22000
20200316,058502,鴻海元大99購13,1.59,1.62,1.21,1.25,-0.03,-2.34,222000,38,314380,0,0,0,0,0,0,182000,154000,28000,28000
20200316,058503,鴻海元大99購14,1.65,1.69,1.25,1.26,-0.25,-16.56,199000,34,285230,0,0,0,0,0,0,189000,159000,30000,30000
20200316,058504,台積電元大99購07,1.27,1.31,0.80,0.81,-0.53,-39.55,98000,16,99490,0,0,0,0,0,0,50000,58000,-8000,-8000
20200316,058505,台積電元大99購08,1.72,1.78,1.26,1.28,-0.62,-32.63,387000,43,611920,0,0,0,0,0,0,277000,157000,120000,120000
20200316,058506,台積電元大99購09,1.75,1.81,1.29,1.31,-0.62,-32.12,522000,63,808590,0,0,0,0,0,0,223000,384000,-161000,-161000
20200316,058507,美律元大9A購01,0.65,0.70,0.61,0.62,+0.02,3.33,43000,7,27900,0,0,0,0,0,0,23000,32000,-9000,-9000
20200316,058508,聯發科元大99購11,1.85,2.01,1.44,1.49,-0.60,-28.71,163000,22,287390,0,0,0,0,0,0,147000,103000,44000,44000
20200316,058509,聯發科元大99購12,1.80,1.88,1.43,1.48,-0.57,-27.8,303000,26,538510,0,0,0,0,0,0,268000,121000,147000,147000
20200316,05850P,台積電兆豐96售06,7.65,8.95,7.65,8.95,+2.25,33.58,154000,20,1185550,0,0,0,0,0,0,154000,140000,14000,14000
20200316,058510,全新元大9B購02,0.30,0.30,0.22,0.22,0.00,0.00,70000,10,16650,0,0,0,0,0,0,0,70000,-70000,-70000
20200316,058511,華新科元大9B購01,0.48,0.48,0.38,0.38,-0.03,-7.32,392000,13,172020,0,0,0,0,0,0,280000,112000,168000,168000
20200316,058512,宏達電元大99購04,0.58,0.58,0.58,0.58,0.00,0.00,1000,1,580,0,0,0,0,0,0,1000,1000,0,0
20200316,058513,宏達電元大99購05,0.91,0.97,0.90,0.90,-0.07,-7.22,54000,4,50340,0,0,0,0,0,0,52000,24000,28000,28000
20200316,058514,潤泰全元大99購01,1.38,1.43,1.33,1.42,-0.16,-10.13,183000,12,252490,0,0,0,0,0,0,168000,90000,78000,78000
20200316,058515,健鼎元大99購01,0.80,0.80,0.80,0.80,+0.04,5.26,10000,1,8000,0,0,0,0,0,0,10000,0,10000,10000
20200316,058516,健鼎元大99購02,0.79,0.79,0.79,0.79,+0.05,6.76,10000,1,7900,0,0,0,0,0,0,10000,0,10000,10000
20200316,058517,景碩元大99購06,,,,,0.00,0.00,0,0,0,0,0,0,0,0,0,0,0,0,0
20200316,058518,玉晶光元大99購13,0.48,0.53,0.35,0.35,-0.13,-27.08,90000,7,41800,0,0,0,0,0,0,40000,50000,-10000,-10000
20200316,058519,嘉澤元大99購01,1.30,1.38,0.94,0.94,-0.36,-27.69,110000,10,119800,0,0,0,0,0,0,40000,70000,-30000,-30000
20200316,05851P,力山群益97售01,,,,,0.00,0.00,0,0,0,0,0,0,0,0,0,0,0,0,0
20200316,058520,智易元大99購03,1.10,1.18,1.10,1.14,-0.04,-3.39,169000,8,195940,0,0,0,0,0,0,166000,3000,163000,163000
20200316,058521,日月光元大99購01,0.92,0.93,0.85,0.85,-0.09,-9.57,43000,6,37860,0,0,0,0,0,0,13000,30000,-17000,-17000
20200316,058522,聯茂元大99購07,0.63,0.70,0.50,0.50,-0.13,-20.63,230000,14,141300,0,0,0,0,0,0,200000,120000,80000,80000
20200316,058523,聯茂元大99購08,0.49,0.49,0.45,0.45,-0.01,-2.17,168000,4,81500,0,0,0,0,0,0,158000,10000,148000,148000
20200316,058524,超眾元大99購04,1.05,1.10,0.81,0.81,-0.21,-20.59,60000,6,56900,0,0,0,0,0,0,50000,40000,10000,10000
20200316,058525,台虹元大99購02,0.98,0.98,0.76,0.80,-0.17,-17.53,412000,38,350360,0,0,0,0,0,0,42000,370000,-328000,-328000
20200316,058526,鈺齊元大99購02,0.88,0.88,0.69,0.69,-0.07,-9.21,822000,62,634740,0,0,0,0,0,0,222000,600000,-378000,-378000
20200316,058527,世紀鋼元大99購01,2.39,2.40,1.89,2.06,-0.02,-0.96,1014000,94,2233990,0,0,0,0,0,0,675000,323000,352000,352000
20200316,058528,世紀鋼元大99購02,0.91,0.94,0.80,0.80,0.00,0.00,894000,115,783980,0,0,0,0,0,0,334000,432000,-98000,-98000
20200316,058529,S&P正2元富9B購01,0.22,0.22,0.19,0.19,-0.09,-32.14,339000,17,66060,0,0,0,0,0,0,139000,0,139000,139000
20200316,05852P,嘉晶群益96售01,,,,,0.00,0.00,0,0,0,0,0,0,0,0,0,0,0,0,0
20200316,058530,為升元富99購01,0.43,0.44,0.24,0.24,-0.18,-42.86,952000,25,323020,0,0,0,0,0,0,166000,786000,-620000,-620000
20200316,058531,華通元富99購01,1.07,1.07,0.71,0.71,-0.26,-26.8,385000,16,343800,0,0,0,0,0,0,105000,280000,-175000,-175000
20200316,058532,禾伸堂元富99購01,0.64,0.68,0.64,0.65,+0.05,8.33,234000,13,155700,0,0,0,0,0,0,234000,0,234000,234000
20200316,058533,玉晶光元富99購01,0.89,0.96,0.64,0.64,-0.21,-24.71,40000,9,30990,0,0,0,0,0,0,10000,30000,-20000,-20000
20200316,058534,友達統一9B購01,,,,,0.00,0.00,0,0,0,0,0,0,0,0,0,0,0,0,0
20200316,058535,玉晶光統一9A購06,,,,,0.00,0.00,0,0,0,0,0,0,0,0,0,0,0,0,0
20200316,058536,群創統一9B購01,,,,,0.00,0.00,0,0,0,0,0,0,0,0,0,0,0,0,0
20200316,058537,彩晶統一9B購01,,,,,0.00,0.00,0,0,0,0,0,0,0,0,0,0,0,0,0
20200316,058538,智邦台新99購02,1.58,1.59,1.25,1.25,-0.09,-6.72,648000,39,959750,0,0,0,0,0,0,413000,367000,46000,46000
20200316,058539,聯發科台新99購01,0.70,0.70,0.61,0.61,0.00,0.00,624000,7,408850,0,0,0,0,0,0,574000,614000,-40000,-40000
20200316,05853P,欣興群益96售05,3.30,3.78,3.30,3.78,0.00,0.00,2000,2,7080,0,0,0,0,0,0,2000,0,2000,2000
20200316,058540,嘉聯益國泰9A購02,0.93,0.93,0.93,0.93,+0.13,16.25,20000,1,18600,0,0,0,0,0,0,20000,0,20000,20000
20200316,058541,T50反1富邦01購01,,,,,0.00,0.00,0,0,0,0,0,0,0,0,0,0,0,0,0
20200316,058542,T50反1富邦9B購01,1.30,1.57,1.30,1.57,+0.15,10.56,10000,2,14350,0,0,0,0,0,0,0,10000,-10000,-10000
20200316,058543,滬深2X富邦9A購01,,,,,0.00,0.00,0,0,0,0,0,0,0,0,0,0,0,0,0
20200316,058544,FBVIX富邦9B購01,6.35,6.45,6.35,6.45,+0.85,15.18,5000,2,32150,0,0,0,0,0,0,5000,0,5000,5000
20200316,058545,義隆富邦9C購01,0.54,0.54,0.50,0.50,-0.06,-10.71,12000,2,6240,0,0,0,0,0,0,6000,6000,0,0
20200316,058546,玉晶光富邦9B購01,,,,,0.00,0.00,0,0,0,0,0,0,0,0,0,0,0,0,0
20200316,058547,世紀鋼富邦9A購01,0.75,0.79,0.67,0.72,+0.02,2.86,3227000,106,2379520,0,0,0,0,0,0,1037000,2089000,-1052000,-1052000
20200316,058548,元石油永豐99購01,0.19,0.22,0.19,0.22,-0.02,-8.33,40000,2,7900,0,0,0,0,0,0,30000,0,30000,30000
20200316,058549,藍天永豐99購01,0.49,0.50,0.48,0.50,-0.03,-5.66,199000,3,97510,0,0,0,0,0,0,91000,108000,-17000,-17000
20200316,05854P,華新科凱基96售09,1.59,1.67,1.59,1.67,+0.07,4.38,25000,3,40250,0,0,0,0,0,0,10000,15000,-5000,-5000
20200316,058550,南亞科永豐99購01,0.12,0.12,0.12,0.12,-0.02,-14.29,5000,1,600,0,0,0,0,0,0,5000,0,5000,5000
20200316,058551,義隆永豐99購03,0.97,1.02,0.81,0.81,-0.06,-6.9,146000,5,135640,0,0,0,0,0,0,70000,76000,-6000,-6000
20200316,058552,欣興永豐99購01,0.21,0.21,0.12,0.12,-0.06,-33.33,65000,6,13350,0,0,0,0,0,0,60000,5000,55000,55000
20200316,058553,合勤控永豐99購01,0.21,0.21,0.15,0.15,0.00,0.00,20000,2,3600,0,0,0,0,0,0,0,20000,-20000,-20000
20200316,058554,瀚宇博永豐99購01,0.30,0.30,0.30,0.30,+0.07,30.43,6000,1,1800,0,0,0,0,0,0,6000,0,6000,6000
20200316,058555,矽創永豐9A購01,0.35,0.38,0.35,0.36,+0.01,2.86,22000,8,8070,0,0,0,0,0,0,22000,0,22000,22000
20200316,058556,百和永豐99購01,,,,,0.00,0.00,0,0,0,0,0,0,0,0,0,0,0,0,0
20200316,058557,健策第一01購01,,,,,0.00,0.00,0,0,0,0,0,0,0,0,0,0,0,0,0
20200316,058558,鴻海日盛9A購02,1.08,1.10,0.86,0.86,-0.27,-23.89,64000,12,57460,0,0,0,0,0,0,64000,62000,2000,2000
20200316,058559,華新科日盛99購02,,,,,0.00,0.00,0,0,0,0,0,0,0,0,0,0,0,0,0
20200316,05855P,滬深2X中信9C售01,0.95,1.03,0.94,1.03,+0.09,9.57,326000,14,321290,0,0,0,0,0,0,50000,276000,-226000,-226000
20200316,058560,T50反1凱基9A購04,,,,,0.00,0.00,0,0,0,0,0,0,0,0,0,0,0,0,0
20200316,058561,T50反1凱基9A購05,,,,,0.00,0.00,0,0,0,0,0,0,0,0,0,0,0,0,0
20200316,058562,元油2X凱基99購01,0.10,0.10,0.09,0.09,-0.09,-50.0,125000,4,11350,0,0,0,0,0,0,0,10000,-10000,-10000
20200316,058563,元油2X凱基9B購07,,,,,0.00,0.00,0,0,0,0,0,0,0,0,0,0,0,0,0
20200316,058564,元金2X凱基9C購01,0.51,0.58,0.51,0.55,-0.10,-15.38,87000,7,47450,10000,0,10000,0,0,0,0,45000,-45000,-35000
20200316,058565,鴻海凱基9A購07,0.98,1.02,0.87,0.87,-0.20,-18.69,113000,16,110030,0,0,0,0,0,0,113000,103000,10000,10000
20200316,058566,聯發科凱基9A購02,2.14,2.35,2.07,2.33,+0.48,25.95,108000,8,243620,0,0,0,0,0,0,105000,3000,102000,102000
20200316,058567,華新科凱基9A購02,,,,,0.00,0.00,0,0,0,0,0,0,0,0,0,0,0,0,0
20200316,058568,宏達電凱基9A購02,0.76,0.76,0.62,0.62,0.00,0.00,164000,8,115640,0,0,0,0,0,0,64000,160000,-96000,-96000
20200316,058569,健策凱基9A購01,0.52,0.59,0.46,0.46,-0.10,-17.86,568000,19,297790,0,0,0,0,0,0,562000,6000,556000,556000
20200316,05856P,A50正2中信99售01,2.05,2.18,2.02,2.18,0.00,0.00,45000,6,92100,0,0,0,0,0,0,0,45000,-45000,-45000
20200316,058570,臻鼎凱基9A購01,0.42,0.44,0.42,0.44,0.00,0.00,104000,2,43840,0,0,0,0,0,0,104000,8000,96000,96000
20200316,058571,緯穎凱基9A購02,1.69,1.69,1.58,1.64,+0.14,9.33,39000,4,64670,0,0,0,0,0,0,39000,20000,19000,19000
20200316,058572,百和凱基9A購01,,,,,0.00,0.00,0,0,0,0,0,0,0,0,0,0,0,0,0
20200316,058573,鴻海群益9A購02,1.45,1.48,1.21,1.21,-0.15,-11.03,15000,10,20250,0,0,0,0,0,0,15000,15000,0,0
20200316,058574,台積電群益99購03,0.93,0.93,0.93,0.93,-0.01,-1.06,13000,1,12090,0,0,0,0,0,0,13000,0,13000,13000
20200316,058575,智邦群益99購01,1.30,1.30,1.30,1.30,+0.39,42.86,44000,1,57200,0,0,0,0,0,0,44000,0,44000,44000
20200316,058576,南亞科群益99購01,0.62,0.62,0.62,0.62,0.00,0.00,22000,1,13640,0,0,0,0,0,0,22000,0,22000,22000
20200316,058577,南亞科群益99購02,,,,,0.00,0.00,0,0,0,0,0,0,0,0,0,0,0,0,0
20200316,058578,聯發科群益99購03,,,,,0.00,0.00,0,0,0,0,0,0,0,0,0,0,0,0,0
20200316,058579,聯發科群益99購04,,,,,0.00,0.00,0,0,0,0,0,0,0,0,0,0,0,0,0
20200316,05857P,旺宏中信98售02,1.61,1.61,1.61,1.61,-0.17,-9.55,10000,1,16100,0,0,0,0,0,0,0,10000,-10000,-10000
20200316,058580,華新科群益99購02,0.70,0.70,0.70,0.70,+0.03,4.48,20000,1,14000,0,0,0,0,0,0,20000,0,20000,20000
20200316,058581,大立光群益99購05,,,,,0.00,0.00,0,0,0,0,0,0,0,0,0,0,0,0,0
20200316,058582,禾伸堂群益99購02,1.09,1.09,0.98,1.02,+0.17,20.0,19000,6,19440,0,0,0,0,0,0,13000,19000,-6000,-6000
20200316,058583,臻鼎群益99購01,,,,,0.00,0.00,0,0,0,0,0,0,0,0,0,0,0,0,0
20200316,058584,百和群益9A購01,,,,,0.00,0.00,0,0,0,0,0,0,0,0,0,0,0,0,0
20200316,058585,S&P正2中信9B購02,0.19,0.20,0.19,0.20,-0.01,-4.76,21000,2,4100,0,0,0,0,0,0,21000,0,21000,21000
20200316,058586,鴻海中信01購02,0.54,0.61,0.49,0.49,-0.11,-18.33,713000,14,370050,0,0,0,0,0,0,692000,21000,671000,671000
20200316,058587,台積電中信9C購03,0.61,0.70,0.48,0.48,-0.15,-23.81,538000,50,304390,0,0,0,0,0,0,218000,50000,168000,168000
20200316,058588,致茂中信9B購01,1.03,1.06,0.96,0.98,+0.05,5.38,232000,24,231470,0,0,0,0,0,0,230000,0,230000,230000
20200316,058589,群創中信01購01,,,,,0.00,0.00,0,0,0,0,0,0,0,0,0,0,0,0,0
20200316,05858P,矽力中信96售01,0.60,0.86,0.60,0.86,+0.21,32.31,260000,15,197530,0,0,0,0,0,0,110000,0,110000,110000
20200316,058590,南電中信9A購02,0.27,0.27,0.23,0.23,-0.01,-4.17,56000,3,14680,0,0,0,0,0,0,6000,50000,-44000,-44000
20200316,058591,台灣50統一9B購02,0.91,0.91,0.91,0.91,-0.11,-10.78,5000,1,4550,0,0,0,0,0,0,0,5000,-5000,-5000
20200316,058592,聯發科統一9C購01,,,,,0.00,0.00,0,0,0,0,0,0,0,0,0,0,0,0,0
20200316,058593,大立光統一9B購02,,,,,0.00,0.00,0,0,0,0,0,0,0,0,0,0,0,0,0
20200316,058594,台灣50元富9B購03,0.48,0.48,0.48,0.48,+0.19,65.52,30000,1,14400,0,0,0,0,0,0,30000,0,30000,30000
20200316,058595,T50正2元富99購01,0.55,0.55,0.33,0.36,-0.19,-34.55,1826000,46,805510,0,0,0,0,0,0,1439000,10000,1429000,1429000
20200316,058596,旺宏台新99購01,,,,,0.00,0.00,0,0,0,0,0,0,0,0,0,0,0,0,0
20200316,058597,瑞昱台新99購01,0.57,0.58,0.49,0.51,-0.08,-13.56,233000,9,121460,0,0,0,0,0,0,174000,59000,115000,115000
20200316,058598,T50反1元大99購04,2.01,2.28,1.91,2.28,+0.05,2.24,29000,7,59420,0,0,0,0,0,0,5000,24000,-19000,-19000
20200316,058599,T50反1元大99購05,,,,,0.00,0.00,0,0,0,0,0,0,0,0,0,0,0,0,0
20200316,05859P,台表科國票97售04,,,,,0.00,0.00,0,0,0,0,0,0,0,0,0,0,0,0,0
20200316,058600,國巨元大99購15,0.76,0.76,0.59,0.59,-0.14,-19.18,499000,33,331750,0,0,0,0,0,0,270000,229000,41000,41000
20200316,058601,台積電元大99購10,1.58,1.64,1.15,1.18,-0.58,-32.95,396000,49,577810,0,0,0,0,0,0,97000,356000,-259000,-259000
20200316,058602,台積電元大99購11,1.64,1.70,1.20,1.22,-0.58,-32.22,307000,38,443380,0,0,0,0,0,0,101000,283000,-182000,-182000
20200316,058603,台積電元大99購12,2.32,2.40,1.71,1.73,-0.73,-29.67,1289000,168,2552080,0,0,0,0,0,0,395000,849000,-454000,-454000
20200316,058604,華邦電元大99購03,,,,,0.00,0.00,0,0,0,0,0,0,0,0,0,0,0,0,0
20200316,058605,華邦電元大99購04,0.39,0.39,0.39,0.39,0.00,0.00,20000,2,7800,0,0,0,0,0,0,0,20000,-20000,-20000
20200316,058606,聯發科元大99購13,1.90,2.04,1.51,1.55,-0.63,-28.9,202000,19,372080,0,0,0,0,0,0,182000,105000,77000,77000
20200316,058607,聯發科元大99購14,2.00,2.04,1.62,1.76,-0.39,-18.14,281000,35,545610,0,0,0,0,0,0,247000,266000,-19000,-19000
20200316,058608,華新科元大99購13,1.91,2.03,1.52,1.59,-0.29,-15.43,189000,19,341320,0,0,0,0,0,0,79000,167000,-88000,-88000
20200316,058609,玉山金元大99購01,0.67,0.70,0.57,0.57,-0.10,-14.93,115000,6,77050,0,0,0,0,0,0,100000,25000,75000,75000
20200316,05860P,旺宏康和96售01,,,,,0.00,0.00,0,0,0,0,0,0,0,0,0,0,0,0,0
20200316,058610,欣興元大99購05,0.76,0.76,0.76,0.76,-0.03,-3.8,1000,1,760,0,0,0,0,0,0,1000,1000,0,0
20200316,058611,欣興元大99購06,0.84,0.84,0.84,0.84,+0.11,15.07,50000,1,42000,0,0,0,0,0,0,50000,0,50000,50000
20200316,058612,健策元大99購02,1.31,1.31,1.20,1.20,0.00,0.00,20000,2,25100,0,0,0,0,0,0,0,20000,-20000,-20000
20200316,058613,茂林元大99購03,0.68,0.68,0.54,0.54,-0.24,-30.77,80000,4,52700,0,0,0,0,0,0,70000,10000,60000,60000
20200316,058614,台郡元大9A購01,0.56,0.58,0.49,0.49,-0.05,-9.26,268000,26,146780,0,0,0,0,0,0,27000,268000,-241000,-241000
20200316,058615,矽創元大99購01,0.94,0.94,0.62,0.62,-0.28,-31.11,295000,32,236890,0,0,0,0,0,0,121000,174000,-53000,-53000
20200316,058616,台虹元大9A購01,0.53,0.55,0.53,0.55,+0.06,12.24,48000,6,26050,0,0,0,0,0,0,48000,0,48000,48000
20200316,058617,南電元大99購01,1.68,1.68,1.61,1.61,+0.19,13.38,20000,2,32900,0,0,0,0,0,0,10000,10000,0,0
20200316,058618,南電元大99購02,1.55,1.58,1.38,1.38,+0.02,1.47,98000,6,140590,0,0,0,0,0,0,88000,87000,1000,1000
20200316,058619,台灣50國票99購04,1.28,1.38,0.77,0.82,-0.68,-45.33,630000,41,701420,0,0,0,0,0,0,505000,93000,412000,412000
20200316,05861P,瀚宇博永豐96售02,,,,,0.00,0.00,0,0,0,0,0,0,0,0,0,0,0,0,0
20200316,058620,滬深2X國票9A購02,,,,,0.00,0.00,0,0,0,0,0,0,0,0,0,0,0,0,0
20200316,058621,華通國票9A購01,0.53,0.53,0.53,0.53,+0.03,6.0,50000,1,26500,0,0,0,0,0,0,50000,0,50000,50000
20200316,058622,國巨國票99購07,0.99,0.99,0.99,0.99,-0.03,-2.94,10000,1,9900,0,0,0,0,0,0,10000,0,10000,10000
20200316,058623,國巨國票99購08,1.25,1.25,1.03,1.09,-0.10,-8.4,121000,6,139240,0,0,0,0,0,0,121000,0,121000,121000
20200316,058624,台積電國票99購09,0.90,0.90,0.54,0.54,-0.13,-19.4,35000,4,24100,0,0,0,0,0,0,35000,0,35000,35000
20200316,058625,旺宏國票9A購01,1.56,1.56,1.56,1.56,+0.25,19.08,10000,2,15600,0,0,0,0,0,0,5000,0,5000,5000
20200316,058626,瑞昱國票9A購01,1.04,1.04,1.03,1.03,-0.12,-10.43,60000,2,61900,0,0,0,0,0,0,60000,0,60000,60000
20200316,058627,聯發科國票99購04,1.22,1.26,0.97,0.97,-0.41,-29.71,146000,10,168210,0,0,0,0,0,0,142000,3000,139000,139000
20200316,058628,宏達電國票9A購01,0.28,0.28,0.28,0.28,-0.14,-33.33,3000,1,840,0,0,0,0,0,0,0,3000,-3000,-3000
20200316,058629,嘉晶國票9A購01,1.59,1.59,1.55,1.55,+0.02,1.31,70000,3,109700,0,0,0,0,0,0,70000,0,70000,70000
20200316,05862P,大立光國泰98售01,2.49,2.91,2.47,2.88,+0.38,15.2,85000,11,225820,0,0,0,0,0,0,80000,35000,45000,45000
20200316,058630,日月光國票9A購01,0.36,0.36,0.36,0.36,-0.03,-7.69,5000,1,1800,0,0,0,0,0,0,0,5000,-5000,-5000
20200316,058631,鈺齊國票9A購01,,,,,0.00,0.00,0,0,0,0,0,0,0,0,0,0,0,0,0
20200316,058632,世紀鋼國票9A購01,4.16,4.16,3.59,3.59,+0.09,2.57,217000,12,814770,0,0,0,0,0,0,187000,30000,157000,157000
20200316,058633,台灣50兆豐99購01,0.22,0.24,0.16,0.20,-0.08,-28.57,1934000,62,397590,0,0,0,0,0,0,8000,1553000,-1545000,-1545000
20200316,058634,可成兆豐99購03,,,,,0.00,0.00,0,0,0,0,0,0,0,0,0,0,0,0,0
20200316,058635,華新科兆豐99購03,0.36,0.39,0.30,0.30,0.00,0.00,91000,5,30850,0,0,0,0,0,0,51000,40000,11000,11000
20200316,058636,亞光兆豐9A購01,0.41,0.41,0.41,0.41,-0.08,-16.33,5000,1,2050,0,0,0,0,0,0,0,5000,-5000,-5000
20200316,058637,晶技兆豐99購01,0.66,0.66,0.66,0.66,+0.15,29.41,1000,1,660,0,0,0,0,0,0,1000,0,1000,1000
20200316,058638,矽力兆豐99購01,1.09,1.10,0.77,0.77,-0.30,-28.04,621000,33,592340,0,0,0,0,0,0,290000,331000,-41000,-41000
20200316,058639,南電兆豐99購01,,,,,0.00,0.00,0,0,0,0,0,0,0,0,0,0,0,0,0
20200316,05863P,滬深2X元大96售09,2.10,2.33,2.10,2.33,+0.39,20.1,35000,2,79250,0,0,0,0,0,0,35000,0,35000,35000
20200316,058640,台灣50麥證9A購01,1.42,1.62,1.11,1.11,+0.05,4.72,229000,25,315980,199000,30000,169000,0,0,0,199000,30000,169000,169000
20200316,058641,鴻海麥證99購02,0.96,0.97,0.73,0.73,-0.18,-19.78,12000,3,9230,2000,10000,-8000,0,0,0,2000,12000,-10000,-10000
20200316,058642,旺宏麥證9A購01,,,,,0.00,0.00,0,0,0,0,0,0,0,0,0,0,0,0,0
20200316,058643,T50正2富邦03購01,0.27,0.29,0.27,0.29,-0.08,-21.62,90000,12,25700,0,0,0,0,0,0,0,76000,-76000,-76000
20200316,058644,元黃金富邦03購01,,,,,0.00,0.00,0,0,0,0,0,0,0,0,0,0,0,0,0
20200316,058645,康控富邦01購01,,,,,0.00,0.00,0,0,0,0,0,0,0,0,0,0,0,0,0
20200316,058646,聯茂富邦9A購01,0.35,0.35,0.30,0.30,+0.01,3.45,217000,6,71250,0,0,0,0,0,0,0,217000,-217000,-217000
20200316,058647,華新科永豐99購03,,,,,0.00,0.00,0,0,0,0,0,0,0,0,0,0,0,0,0
20200316,058648,聯陽永豐99購01,0.52,0.52,0.42,0.43,-0.19,-30.65,219000,10,109970,0,0,0,0,0,0,144000,75000,69000,69000
20200316,058649,健策永豐99購01,,,,,0.00,0.00,0,0,0,0,0,0,0,0,0,0,0,0,0
20200316,05864P,元油反元大96售07,,,,,0.00,0.00,0,0,0,0,0,0,0,0,0,0,0,0,0
20200316,058650,台虹永豐9A購01,0.57,0.57,0.57,0.57,+0.07,14.0,10000,1,5700,0,0,0,0,0,0,10000,0,10000,10000
20200316,058651,FBVIX中信9C購01,3.07,3.08,3.02,3.08,+0.38,14.07,101000,9,307520,0,0,0,0,0,0,97000,0,97000,97000
20200316,058652,SGBR2X中信01購01,0.36,0.36,0.35,0.35,-0.16,-31.37,63000,3,22280,0,0,0,0,0,0,0,63000,-63000,-63000
20200316,058653,光寶科中信9A購01,2.23,2.27,2.11,2.11,-0.29,-12.08,163000,8,367270,0,0,0,0,0,0,109000,123000,-14000,-14000
20200316,058654,鴻海中信03購01,0.81,0.81,0.81,0.81,-0.12,-12.9,1000,1,810,0,0,0,0,0,0,1000,1000,0,0
20200316,058655,鴻海中信03購02,,,,,0.00,0.00,0,0,0,0,0,0,0,0,0,0,0,0,0
20200316,058656,燿華中信99購01,0.69,0.69,0.43,0.43,-0.25,-36.76,529000,16,262290,0,0,0,0,0,0,150000,379000,-229000,-229000
20200316,058657,大立光中信99購01,,,,,0.00,0.00,0,0,0,0,0,0,0,0,0,0,0,0,0
20200316,058658,瑞儀中信99購01,0.93,1.04,0.92,1.02,+0.17,20.0,383000,12,374660,0,0,0,0,0,0,27000,356000,-329000,-329000
20200316,058659,力成中信99購01,1.27,1.27,1.15,1.16,-0.18,-13.43,42000,3,49520,0,0,0,0,0,0,12000,30000,-18000,-18000
20200316,05865P,大立光元大96售09,5.70,5.95,5.70,5.95,-1.70,-22.22,11000,3,62950,0,0,0,0,0,0,11000,1000,10000,10000
20200316,058660,樺漢中信9A購01,1.24,1.26,1.21,1.21,-0.04,-3.2,76000,3,93900,0,0,0,0,0,0,18000,58000,-40000,-40000
20200316,058661,臺股指中信9C購01,0.27,0.28,0.17,0.26,-0.17,-39.53,755000,23,182440,0,0,0,0,0,0,549000,20000,529000,529000
20200316,058662,禾伸堂兆豐99購01,1.32,1.41,1.14,1.14,-0.18,-13.64,499000,10,669210,0,0,0,0,0,0,307000,192000,115000,115000
20200316,058663,瑞儀兆豐9A購01,0.61,0.68,0.61,0.65,+0.08,14.04,1400000,23,877610,0,0,0,0,0,0,40000,1360000,-1320000,-1320000
20200316,058664,百和兆豐99購01,0.62,0.62,0.58,0.58,+0.02,3.57,46000,4,28120,0,0,0,0,0,0,20000,26000,-6000,-6000
20200316,058665,台灣50群益9B購02,1.30,1.30,0.87,0.88,-0.67,-43.23,165000,20,181140,0,0,0,0,0,0,0,164000,-164000,-164000
20200316,058666,上証反群益01購01,0.88,0.93,0.88,0.93,+0.03,3.33,245000,2,216600,0,0,0,0,0,0,245000,0,245000,245000
20200316,058667,元油2X群益99購01,0.06,0.06,0.04,0.04,-0.02,-33.33,440000,5,18000,0,0,0,0,0,0,0,0,0,0
20200316,058668,元油2X群益9B購04,0.08,0.08,0.07,0.07,-0.01,-12.5,350000,5,27000,0,0,0,0,0,0,0,0,0,0
20200316,058669,上銀群益99購01,,,,,0.00,0.00,0,0,0,0,0,0,0,0,0,0,0,0,0
20200316,05866P,致伸元大96售01,,,,,0.00,0.00,0,0,0,0,0,0,0,0,0,0,0,0,0
20200316,058670,鴻海群益9A購03,,,,,0.00,0.00,0,0,0,0,0,0,0,0,0,0,0,0,0
20200316,058671,旺宏群益9A購01,1.85,1.85,1.66,1.73,+0.25,16.89,30000,5,51810,0,0,0,0,0,0,30000,24000,6000,6000
20200316,058672,可成群益9B購02,,,,,0.00,0.00,0,0,0,0,0,0,0,0,0,0,0,0,0
20200316,058673,華新科群益9A購02,,,,,0.00,0.00,0,0,0,0,0,0,0,0,0,0,0,0,0
20200316,058674,宏達電群益99購01,0.71,0.71,0.71,0.71,0.00,0.00,12000,1,8520,0,0,0,0,0,0,12000,12000,0,0
20200316,058675,康控群益9B購01,,,,,0.00,0.00,0,0,0,0,0,0,0,0,0,0,0,0,0
20200316,058676,聯茂群益99購01,,,,,0.00,0.00,0,0,0,0,0,0,0,0,0,0,0,0,0
20200316,058677,矽格群益99購01,,,,,0.00,0.00,0,0,0,0,0,0,0,0,0,0,0,0,0
20200316,058678,南亞科日盛99購01,0.29,0.29,0.27,0.27,-0.07,-20.59,11000,2,2990,0,0,0,0,0,0,11000,0,11000,11000
20200316,058679,可成日盛99購01,,,,,0.00,0.00,0,0,0,0,0,0,0,0,0,0,0,0,0
20200316,05867P,友達兆豐97售02,,,,,0.00,0.00,0,0,0,0,0,0,0,0,0,0,0,0,0
20200316,058680,國巨麥證99購02,0.30,0.30,0.30,0.30,0.00,0.00,25000,2,7500,0,25000,-25000,0,0,0,0,25000,-25000,-25000
20200316,058681,大立光康和9B購01,,,,,0.00,0.00,0,0,0,0,0,0,0,0,0,0,0,0,0
20200316,058682,聯發科凱基99購07,1.76,1.76,1.61,1.62,0.00,0.00,104000,5,176640,0,0,0,0,0,0,0,104000,-104000,-104000
20200316,058683,可成凱基9A購01,0.76,0.76,0.76,0.76,0.00,0.00,2000,1,1520,0,0,0,0,0,0,0,2000,-2000,-2000
20200316,058684,健策凱基99購02,0.59,0.64,0.59,0.61,+0.02,3.39,77000,13,46810,0,0,0,0,0,0,77000,0,77000,77000
20200316,058685,TPK凱基99購01,,,,,0.00,0.00,0,0,0,0,0,0,0,0,0,0,0,0,0
20200316,058686,祥碩凱基99購03,1.07,1.08,0.85,0.85,-0.25,-22.73,4206000,59,3958350,0,0,0,0,0,0,716000,3594000,-2878000,-2878000
20200316,058687,聯茂凱基9A購01,0.70,0.71,0.63,0.63,+0.03,5.0,107000,6,73840,0,0,0,0,0,0,79000,30000,49000,49000
20200316,058688,矽創凱基9A購01,0.85,0.87,0.77,0.77,+0.09,13.24,29000,4,23410,0,0,0,0,0,0,11000,18000,-7000,-7000
20200316,058689,元油2X國票99購03,0.05,0.07,0.05,0.07,-0.01,-12.5,550000,6,29900,0,0,0,0,0,0,450000,0,450000,450000
20200316,05868P,台積電凱基96售17,,,,,0.00,0.00,0,0,0,0,0,0,0,0,0,0,0,0,0
20200316,058690,元油2X國票9A購03,0.12,0.12,0.11,0.12,+0.03,33.33,1109000,4,131080,0,0,0,0,0,0,1099000,10000,1089000,1089000
20200316,058691,友訊國票9A購01,0.63,0.63,0.56,0.56,-0.11,-16.42,120000,7,72200,0,0,0,0,0,0,60000,60000,0,0
20200316,058692,華邦電國票9B購01,,,,,0.00,0.00,0,0,0,0,0,0,0,0,0,0,0,0,0
20200316,058693,旭富國票9A購01,2.06,2.17,1.99,1.99,+0.33,19.88,20000,5,40670,0,0,0,0,0,0,10000,10000,0,0
20200316,058694,鈺齊國票9A購02,2.24,2.24,2.24,2.24,-0.04,-1.75,20000,2,44800,0,0,0,0,0,0,20000,0,20000,20000
20200316,058695,元油2X元大9C購03,0.06,0.06,0.05,0.05,-0.03,-37.5,230000,2,11800,0,0,0,0,0,0,0,0,0,0
20200316,058696,元油2X元大9C購04,0.04,0.08,0.04,0.08,+0.01,14.29,3000,2,160,0,0,0,0,0,0,0,0,0,0
20200316,058697,亞德客元大99購01,1.65,1.94,1.65,1.88,+0.41,27.89,55000,7,102070,0,0,0,0,0,0,21000,40000,-19000,-19000
20200316,058698,華通元大99購05,0.45,0.46,0.36,0.36,0.00,0.00,80000,8,31900,0,0,0,0,0,0,0,80000,-80000,-80000
20200316,058699,楠梓電元大99購02,0.89,0.89,0.88,0.88,+0.16,22.22,20000,2,17700,0,0,0,0,0,0,10000,10000,0,0
20200316,05869P,旺宏凱基96售05,2.17,2.27,2.17,2.27,-0.04,-1.73,37000,8,82140,0,0,0,0,0,0,37000,25000,12000,12000
20200316,058700,鴻海元大99購15,1.36,1.38,1.07,1.07,-0.09,-7.76,106000,27,125200,0,0,0,0,0,0,106000,104000,2000,2000
20200316,058701,鴻海元大99購16,,,,,0.00,0.00,0,0,0,0,0,0,0,0,0,0,0,0,0
20200316,058702,國巨元大99購16,0.53,0.53,0.45,0.45,-0.16,-26.23,40000,2,20400,0,0,0,0,0,0,30000,10000,20000,20000
20200316,058703,台積電元大99購16,0.46,0.46,0.37,0.37,-0.20,-35.09,170000,16,71860,0,0,0,0,0,0,50000,120000,-70000,-70000
20200316,058704,台積電元大99購17,0.61,0.63,0.47,0.47,-0.29,-38.16,115000,10,67540,0,0,0,0,0,0,50000,65000,-15000,-15000
20200316,058705,長榮航元大99購01,0.52,0.52,0.52,0.52,0.00,0.00,13000,2,6760,0,0,0,0,0,0,0,13000,-13000,-13000
20200316,058706,聯鈞元大9C購01,,,,,0.00,0.00,0,0,0,0,0,0,0,0,0,0,0,0,0
20200316,058707,泰鼎元大99購02,,,,,0.00,0.00,0,0,0,0,0,0,0,0,0,0,0,0,0
20200316,058708,臺股指元大9A購21,1.59,1.73,1.28,1.30,-0.44,-25.29,1610000,89,2301130,0,0,0,0,0,0,1192000,368000,824000,824000
20200316,058709,臺股指元大9A購22,1.09,1.19,0.89,0.89,-0.34,-27.64,954000,98,1011660,0,0,0,0,0,0,363000,583000,-220000,-220000
20200316,05870P,聯發科凱基96售19,,,,,0.00,0.00,0,0,0,0,0,0,0,0,0,0,0,0,0
20200316,058710,臺股指元大9A購23,0.72,0.72,0.55,0.56,-0.23,-29.11,307000,32,199130,0,0,0,0,0,0,100000,207000,-107000,-107000
20200316,058711,鴻海統一9A購02,,,,,0.00,0.00,0,0,0,0,0,0,0,0,0,0,0,0,0
20200316,058712,鴻海統一9B購03,,,,,0.00,0.00,0,0,0,0,0,0,0,0,0,0,0,0,0
20200316,058713,國巨統一9B購02,0.32,0.32,0.32,0.32,+0.02,6.67,10000,1,3200,0,0,0,0,0,0,0,10000,-10000,-10000
20200316,058714,美律統一9B購01,,,,,0.00,0.00,0,0,0,0,0,0,0,0,0,0,0,0,0
20200316,058715,鴻海台新99購02,0.53,0.53,0.35,0.37,-0.26,-41.27,706000,43,281660,0,0,0,0,0,0,666000,690000,-24000,-24000
20200316,058716,華新科台新99購02,,,,,0.00,0.00,0,0,0,0,0,0,0,0,0,0,0,0,0
20200316,058717,南電台新99購02,0.58,0.58,0.46,0.47,-0.01,-2.08,338000,7,179260,0,0,0,0,0,0,100000,238000,-138000,-138000
20200316,058718,台灣50元富03購01,1.13,1.15,0.67,0.75,-0.47,-38.52,1471000,75,1300990,0,0,0,0,0,0,970000,132000,838000,838000
20200316,058719,智邦元富99購01,1.69,1.69,1.48,1.48,+0.15,11.28,399000,15,643720,0,0,0,0,0,0,324000,75000,249000,249000
20200316,05871P,全新凱基96售04,1.14,1.18,1.14,1.18,0.00,0.00,30000,2,34400,0,0,0,0,0,0,0,30000,-30000,-30000
20200316,058720,旭富元富99購01,1.16,1.20,0.95,0.95,0.00,0.00,233000,16,260620,0,0,0,0,0,0,123000,108000,15000,15000
20200316,058721,立積元富9C購01,1.57,1.57,1.08,1.08,-0.35,-24.48,208000,12,301530,0,0,0,0,0,0,123000,85000,38000,38000
20200316,058722,台郡元富99購01,0.57,0.57,0.57,0.57,+0.12,26.67,50000,1,28500,0,0,0,0,0,0,0,50000,-50000,-50000
20200316,058723,元石油國泰9A購01,,,,,0.00,0.00,0,0,0,0,0,0,0,0,0,0,0,0,0
20200316,058724,大立光國泰9B購01,,,,,0.00,0.00,0,0,0,0,0,0,0,0,0,0,0,0,0
20200316,058725,美律富邦9A購01,0.38,0.38,0.35,0.35,+0.03,9.38,2000,2,730,0,0,0,0,0,0,2000,2000,0,0
20200316,058726,宏達電富邦9A購01,,,,,0.00,0.00,0,0,0,0,0,0,0,0,0,0,0,0,0
20200316,058727,嘉晶富邦9A購01,0.49,0.51,0.40,0.40,-0.10,-20.0,669000,38,323990,0,0,0,0,0,0,304000,353000,-49000,-49000
20200316,058728,SP黃豆永豐99購01,,,,,0.00,0.00,0,0,0,0,0,0,0,0,0,0,0,0,0
20200316,058729,國巨永豐99購03,0.59,0.59,0.46,0.46,-0.06,-11.54,3000,2,1510,0,0,0,0,0,0,1000,2000,-1000,-1000
20200316,05872P,大立光凱基96售15,,,,,0.00,0.00,0,0,0,0,0,0,0,0,0,0,0,0,0
20200316,058730,玉晶光永豐9A購01,0.72,0.72,0.72,0.72,0.00,0.00,10000,1,7200,0,0,0,0,0,0,0,10000,-10000,-10000
20200316,058731,貿聯永豐99購02,0.41,0.41,0.41,0.41,-0.13,-24.07,10000,1,4100,0,0,0,0,0,0,10000,10000,0,0
20200316,058732,矽格永豐99購01,0.64,0.65,0.64,0.65,+0.07,12.07,44000,2,28330,0,0,0,0,0,0,27000,17000,10000,10000
20200316,058733,同欣電永豐99購02,0.44,0.44,0.34,0.37,+0.01,2.78,409000,33,150910,0,0,0,0,0,0,120000,289000,-169000,-169000
20200316,058734,康友永豐99購01,,,,,0.00,0.00,0,0,0,0,0,0,0,0,0,0,0,0,0
20200316,058735,南茂永豐99購01,,,,,0.00,0.00,0,0,0,0,0,0,0,0,0,0,0,0,0
20200316,058736,鈺齊永豐99購02,,,,,0.00,0.00,0,0,0,0,0,0,0,0,0,0,0,0,0
20200316,058737,鴻海第一01購01,0.49,0.49,0.42,0.42,+0.01,2.44,12000,2,5180,0,0,0,0,0,0,2000,10000,-8000,-8000
20200316,058738,FBVIX中信03購04,2.60,2.60,2.49,2.56,+0.31,13.78,152000,22,385860,0,0,0,0,0,0,63000,84000,-21000,-21000
20200316,058739,喬山中信99購01,,,,,0.00,0.00,0,0,0,0,0,0,0,0,0,0,0,0,0
20200316,05873P,華通群益97售02,3.77,3.77,3.77,3.77,-0.46,-10.87,10000,1,37700,0,0,0,0,0,0,10000,0,10000,10000
20200316,058740,T50反1日盛9B購02,,,,,0.00,0.00,0,0,0,0,0,0,0,0,0,0,0,0,0
20200316,058741,欣興日盛99購01,,,,,0.00,0.00,0,0,0,0,0,0,0,0,0,0,0,0,0
20200316,058742,鴻海康和99購01,,,,,0.00,0.00,0,0,0,0,0,0,0,0,0,0,0,0,0
20200316,058743,可成康和99購01,,,,,0.00,0.00,0,0,0,0,0,0,0,0,0,0,0,0,0
20200316,058744,FBVIX凱基9C購03,3.13,3.21,3.13,3.21,+0.26,8.81,14000,3,44140,0,0,0,0,0,0,4000,10000,-6000,-6000
20200316,058745,元金2X凱基9C購02,0.78,0.88,0.71,0.86,-0.15,-14.85,1015000,45,817080,0,0,0,0,0,0,0,1015000,-1015000,-1015000
20200316,058746,華通凱基9A購02,0.81,0.81,0.81,0.81,+0.21,35.0,3000,1,2430,0,0,0,0,0,0,3000,0,3000,3000
20200316,058747,友達凱基9A購03,,,,,0.00,0.00,0,0,0,0,0,0,0,0,0,0,0,0,0
20200316,058748,景碩凱基9A購01,0.56,0.56,0.56,0.56,0.00,0.00,10000,1,5600,0,0,0,0,0,0,0,10000,-10000,-10000
20200316,058749,康控凱基99購03,,,,,0.00,0.00,0,0,0,0,0,0,0,0,0,0,0,0,0
20200316,05874P,台積電群益96售10,6.55,6.55,6.55,6.55,0.00,0.00,3000,1,19650,0,0,0,0,0,0,3000,0,3000,3000
20200316,058750,緯穎凱基9A購03,,,,,0.00,0.00,0,0,0,0,0,0,0,0,0,0,0,0,0
20200316,058751,南茂凱基9A購01,1.14,1.14,1.14,1.14,+0.14,14.0,40000,1,45600,0,0,0,0,0,0,40000,0,40000,40000
20200316,058752,鈺齊凱基9A購01,,,,,0.00,0.00,0,0,0,0,0,0,0,0,0,0,0,0,0
20200316,058753,元石油群益9B購03,0.42,0.46,0.41,0.43,-0.09,-17.31,686000,13,290520,0,0,0,0,0,0,511000,0,511000,511000
20200316,058754,元油2X群益99購02,0.09,0.09,0.06,0.06,-0.04,-40.0,810000,14,49600,0,0,0,0,0,0,0,0,0,0
20200316,058755,SGBR2X群益99購01,,,,,0.00,0.00,0,0,0,0,0,0,0,0,0,0,0,0,0
20200316,058756,SGBR2X群益99購02,,,,,0.00,0.00,0,0,0,0,0,0,0,0,0,0,0,0,0
20200316,058757,道瓊銀群益9A購02,,,,,0.00,0.00,0,0,0,0,0,0,0,0,0,0,0,0,0
20200316,058758,台積電群益99購05,0.88,0.88,0.72,0.72,-0.15,-17.24,390000,6,337800,0,0,0,0,0,0,320000,70000,250000,250000
20200316,058759,義隆群益99購01,,,,,0.00,0.00,0,0,0,0,0,0,0,0,0,0,0,0,0
20200316,05875P,旺宏群益98售01,2.60,2.60,2.60,2.60,0.00,0.00,25000,1,65000,0,0,0,0,0,0,25000,0,25000,25000
20200316,058760,嘉晶群益9A購01,1.36,1.40,1.36,1.40,+0.17,13.82,25000,4,34500,0,0,0,0,0,0,19000,0,19000,19000
20200316,058761,欣興群益99購02,0.56,0.59,0.56,0.59,+0.03,5.36,24000,2,13500,0,0,0,0,0,0,24000,0,24000,24000
20200316,058762,貿聯群益99購03,,,,,0.00,0.00,0,0,0,0,0,0,0,0,0,0,0,0,0
20200316,058763,和碩群益99購01,,,,,0.00,0.00,0,0,0,0,0,0,0,0,0,0,0,0,0
20200316,058764,康友群益99購01,1.21,1.21,1.21,1.21,-0.05,-3.97,4000,1,4840,0,0,0,0,0,0,4000,0,4000,4000
20200316,058765,緯穎群益99購03,2.67,2.76,2.67,2.76,+0.32,13.11,3000,2,8100,0,0,0,0,0,0,0,3000,-3000,-3000
20200316,058766,力山兆豐99購01,0.38,0.44,0.38,0.42,+0.09,27.27,121000,4,46820,0,0,0,0,0,0,0,121000,-121000,-121000
20200316,058767,亞德客兆豐99購01,0.69,0.77,0.66,0.66,+0.06,10.0,373000,10,268230,0,0,0,0,0,0,130000,243000,-113000,-113000
20200316,058768,南港兆豐99購01,1.00,1.22,0.85,1.21,+0.34,39.08,686000,31,721740,0,0,0,0,0,0,284000,402000,-118000,-118000
20200316,058769,友達兆豐99購01,0.42,0.42,0.42,0.42,+0.05,13.51,20000,1,8400,0,0,0,0,0,0,20000,0,20000,20000
20200316,05876P,聯發科群益96售03,,,,,0.00,0.00,0,0,0,0,0,0,0,0,0,0,0,0,0
20200316,058770,貿聯兆豐9A購01,0.70,0.71,0.52,0.52,-0.09,-14.75,197000,11,130220,0,0,0,0,0,0,77000,120000,-43000,-43000
20200316,058771,神達兆豐99購01,0.45,0.49,0.45,0.49,+0.10,25.64,121000,2,55690,0,0,0,0,0,0,121000,0,121000,121000
20200316,058772,茂林兆豐9A購01,0.29,0.30,0.28,0.30,-0.02,-6.25,247000,21,71050,0,0,0,0,0,0,247000,0,247000,247000
20200316,058773,和碩兆豐99購01,0.59,0.59,0.48,0.48,-0.07,-12.73,103000,3,60440,0,0,0,0,0,0,100000,3000,97000,97000
20200316,058774,台郡兆豐9A購01,0.41,0.44,0.40,0.40,-0.07,-14.89,14000,4,5970,0,0,0,0,0,0,10000,4000,6000,6000
20200316,058775,台積電國票9A購02,1.79,1.79,1.52,1.52,+0.31,25.62,79000,5,136880,0,0,0,0,0,0,59000,20000,39000,39000
20200316,058776,台積電國票9A購03,1.49,1.49,1.11,1.21,-0.47,-27.98,40000,6,52740,0,0,0,0,0,0,21000,19000,2000,2000
20200316,058777,台光電國票9A購01,,,,,0.00,0.00,0,0,0,0,0,0,0,0,0,0,0,0,0
20200316,058778,聯發科國票9A購01,1.59,1.59,1.59,1.59,+0.29,22.31,10000,1,15900,0,0,0,0,0,0,10000,0,10000,10000
20200316,058779,大立光國票9A購02,,,,,0.00,0.00,0,0,0,0,0,0,0,0,0,0,0,0,0
20200316,05877P,大立光群益96售06,4.77,5.70,4.77,5.70,+0.92,19.25,3000,2,15240,0,0,0,0,0,0,1000,2000,-1000,-1000
20200316,058780,牧德國票9A購01,0.67,0.67,0.67,0.67,+0.07,11.67,50000,1,33500,0,0,0,0,0,0,50000,0,50000,50000
20200316,058781,康友國票9A購01,1.11,1.11,1.11,1.11,0.00,0.00,5000,1,5550,0,0,0,0,0,0,0,5000,-5000,-5000
20200316,058782,臺股指國票99購01,0.75,0.76,0.75,0.76,-0.10,-11.63,117000,10,88420,0,0,0,0,0,0,50000,0,50000,50000
20200316,058783,臺股指國票99購02,0.48,0.48,0.48,0.48,-0.21,-30.43,10000,1,4800,0,0,0,0,0,0,0,0,0,0
20200316,058784,臺股指國票99購03,,,,,0.00,0.00,0,0,0,0,0,0,0,0,0,0,0,0,0
20200316,058785,臺股指國票99購04,0.51,0.52,0.50,0.50,+0.04,8.7,110000,3,56300,0,0,0,0,0,0,110000,0,110000,110000
20200316,058786,元黃金元大99購01,,,,,0.00,0.00,0,0,0,0,0,0,0,0,0,0,0,0,0
20200316,058787,元石油元大9A購01,0.14,0.14,0.14,0.14,-0.09,-39.13,220000,1,30800,0,0,0,0,0,0,220000,0,220000,220000
20200316,058788,喬山元大99購01,,,,,0.00,0.00,0,0,0,0,0,0,0,0,0,0,0,0,0
20200316,058789,喬山元大99購02,,,,,0.00,0.00,0,0,0,0,0,0,0,0,0,0,0,0,0
20200316,05878P,創意群益98售01,3.54,3.54,3.54,3.54,+0.04,1.14,5000,1,17700,0,0,0,0,0,0,5000,0,5000,5000
20200316,058790,楠梓電元大99購03,0.82,0.82,0.82,0.82,0.00,0.00,13000,2,10660,0,0,0,0,0,0,0,13000,-13000,-13000
20200316,058791,鴻海元大99購17,1.31,1.32,1.03,1.03,-0.42,-28.97,165000,34,191420,0,0,0,0,0,0,140000,152000,-12000,-12000
20200316,058792,鴻海元大99購18,1.68,1.69,1.28,1.32,-0.07,-5.04,166000,36,241380,0,0,0,0,0,0,166000,141000,25000,25000
20200316,058793,鴻海元大99購19,1.64,1.66,1.28,1.28,-0.52,-28.89,204000,33,299060,0,0,0,0,0,0,204000,124000,80000,80000
20200316,058794,旺宏元大99購09,1.80,1.90,1.41,1.48,-0.23,-13.45,557000,55,913100,0,0,0,0,0,0,333000,511000,-178000,-178000
20200316,058795,可成元大99購03,1.28,1.33,1.13,1.13,-0.17,-13.08,159000,17,196450,0,0,0,0,0,0,86000,87000,-1000,-1000
20200316,058796,可成元大99購04,,,,,0.00,0.00,0,0,0,0,0,0,0,0,0,0,0,0,0
20200316,058797,大毅元大99購03,1.79,1.79,1.79,1.79,0.00,0.00,4000,1,7160,0,0,0,0,0,0,0,4000,-4000,-4000
20200316,058798,大立光元大99購11,1.65,1.65,1.18,1.21,-0.56,-31.64,88000,11,122120,0,0,0,0,0,0,51000,48000,3000,3000
20200316,058799,晶技元大99購04,2.09,2.32,2.09,2.32,+0.39,20.21,131000,6,292590,0,0,0,0,0,0,131000,8000,123000,123000
20200316,05879P,台積電台新96售03,3.21,3.21,3.21,3.21,-0.40,-11.08,10000,1,32100,0,0,0,0,0,0,10000,10000,0,0
20200316,058800,健策元大99購03,1.10,1.21,1.10,1.21,+0.23,23.47,54000,3,59620,0,0,0,0,0,0,52000,2000,50000,50000
20200316,058801,致伸元大99購01,0.92,0.92,0.92,0.92,+0.18,24.32,5000,1,4600,0,0,0,0,0,0,5000,0,5000,5000
20200316,058802,矽創元大99購02,,,,,0.00,0.00,0,0,0,0,0,0,0,0,0,0,0,0,0
20200316,058803,世紀鋼元大99購03,2.74,2.74,2.39,2.39,-0.08,-3.24,221000,30,585210,0,0,0,0,0,0,150000,101000,49000,49000
20200316,058804,T50反1統一9B購01,,,,,0.00,0.00,0,0,0,0,0,0,0,0,0,0,0,0,0
20200316,058805,元石油統一9B購02,,,,,0.00,0.00,0,0,0,0,0,0,0,0,0,0,0,0,0
20200316,058806,道瓊銀統一9B購01,,,,,0.00,0.00,0,0,0,0,0,0,0,0,0,0,0,0,0
20200316,058807,和大統一9B購01,,,,,0.00,0.00,0,0,0,0,0,0,0,0,0,0,0,0,0
20200316,058808,大成鋼統一9B購01,,,,,0.00,0.00,0,0,0,0,0,0,0,0,0,0,0,0,0
20200316,058809,國巨統一9B購03,0.54,0.54,0.31,0.38,+0.01,2.7,45000,3,16950,0,0,0,0,0,0,25000,20000,5000,5000
20200316,05880P,創意康和96售01,1.48,1.48,1.48,1.48,+0.01,0.68,11000,2,16280,0,0,0,0,0,0,6000,5000,1000,1000
20200316,058810,國巨統一9B購04,,,,,0.00,0.00,0,0,0,0,0,0,0,0,0,0,0,0,0
20200316,058811,台積電統一9A購05,0.75,0.75,0.59,0.59,-0.21,-26.25,55000,10,37950,0,0,0,0,0,0,5000,50000,-45000,-45000
20200316,058812,台積電統一9B購06,,,,,0.00,0.00,0,0,0,0,0,0,0,0,0,0,0,0,0
20200316,058813,旺宏統一9B購04,,,,,0.00,0.00,0,0,0,0,0,0,0,0,0,0,0,0,0
20200316,058814,南亞科台新99購01,0.67,0.67,0.43,0.43,0.00,0.00,13000,2,7990,0,0,0,0,0,0,0,13000,-13000,-13000
20200316,058815,華新科台新99購03,0.73,0.73,0.51,0.51,-0.14,-21.54,472000,10,278560,0,0,0,0,0,0,412000,310000,102000,102000
20200316,058816,祥碩台新99購02,,,,,0.00,0.00,0,0,0,0,0,0,0,0,0,0,0,0,0
20200316,058817,嘉聯益台新99購01,0.67,0.69,0.67,0.69,-0.01,-1.43,284000,3,193020,0,0,0,0,0,0,137000,147000,-10000,-10000
20200316,058818,南電台新99購03,0.65,0.65,0.65,0.65,+0.08,14.04,84000,1,54600,0,0,0,0,0,0,84000,0,84000,84000
20200316,058819,華通國泰9B購01,,,,,0.00,0.00,0,0,0,0,0,0,0,0,0,0,0,0,0
20200316,05881P,彩晶康和96售01,,,,,0.00,0.00,0,0,0,0,0,0,0,0,0,0,0,0,0
20200316,058820,致茂國泰9B購01,1.08,1.12,1.08,1.08,+0.17,18.68,68000,25,75420,0,0,0,0,0,0,68000,0,68000,68000
20200316,058821,泰鼎國泰9B購01,1.32,1.42,1.12,1.12,-0.20,-15.15,125000,19,163600,0,0,0,0,0,0,100000,25000,75000,75000
20200316,058822,樺漢國泰9B購01,,,,,0.00,0.00,0,0,0,0,0,0,0,0,0,0,0,0,0
20200316,058823,聯發科富邦9C購01,,,,,0.00,0.00,0,0,0,0,0,0,0,0,0,0,0,0,0
20200316,058824,晶技富邦9A購01,0.35,0.46,0.32,0.32,0.00,0.00,365000,12,134140,0,0,0,0,0,0,308000,57000,251000,251000
20200316,058825,同欣電富邦9A購01,,,,,0.00,0.00,0,0,0,0,0,0,0,0,0,0,0,0,0
20200316,058826,台積電永豐99購02,0.49,0.49,0.44,0.44,0.00,0.00,102000,11,47980,0,0,0,0,0,0,0,102000,-102000,-102000
20200316,058827,聯發科永豐9A購01,0.66,0.71,0.49,0.49,-0.21,-30.0,313000,8,208120,0,0,0,0,0,0,200000,213000,-13000,-13000
20200316,058828,大毅永豐99購01,,,,,0.00,0.00,0,0,0,0,0,0,0,0,0,0,0,0,0
20200316,058829,華新科永豐99購04,0.61,0.61,0.51,0.51,+0.02,4.08,148000,4,82730,0,0,0,0,0,0,148000,50000,98000,98000
20200316,05882P,華新科永豐96售01,0.90,1.24,0.84,1.24,+0.05,4.2,144000,16,159670,0,0,0,0,0,0,43000,131000,-88000,-88000
20200316,058830,健策永豐99購02,0.39,0.41,0.39,0.41,-0.01,-2.38,120000,2,47400,0,0,0,0,0,0,120000,0,120000,120000
20200316,058831,茂林永豐99購01,0.53,0.53,0.51,0.51,0.00,0.00,6000,3,3160,0,0,0,0,0,0,6000,0,6000,6000
20200316,058832,立積永豐99購01,,,,,0.00,0.00,0,0,0,0,0,0,0,0,0,0,0,0,0
20200316,058833,台表科永豐99購01,0.55,0.55,0.39,0.39,-0.14,-26.42,86000,3,34460,0,0,0,0,0,0,85000,1000,84000,84000
20200316,058834,GIS永豐99購01,0.38,0.43,0.31,0.31,+0.03,10.71,127000,12,47980,0,0,0,0,0,0,17000,110000,-93000,-93000
20200316,058835,元油2X中信9C購02,,,,,0.00,0.00,0,0,0,0,0,0,0,0,0,0,0,0,0
20200316,058836,FBVIX中信03購05,1.65,1.71,1.60,1.70,+0.21,14.09,2256000,137,3746630,0,0,0,0,0,0,708000,1679000,-971000,-971000
20200316,058837,SGBR2X中信9C購01,0.50,0.50,0.46,0.46,-0.20,-30.3,325000,7,157900,0,0,0,0,0,0,100000,225000,-125000,-125000
20200316,058838,國巨中信99購03,0.64,0.67,0.51,0.53,-0.12,-18.46,394000,8,211100,0,0,0,0,0,0,340000,54000,286000,286000
20200316,058839,瑞儀中信99購02,0.57,0.57,0.57,0.57,0.00,0.00,10000,1,5700,0,0,0,0,0,0,0,10000,-10000,-10000
20200316,05883P,致伸永豐96售03,,,,,0.00,0.00,0,0,0,0,0,0,0,0,0,0,0,0,0
20200316,058840,T50反1群益99購02,1.41,1.41,1.41,1.41,+0.23,19.49,11000,2,15510,0,0,0,0,0,0,0,10000,-10000,-10000
20200316,058841,深中小群益01購01,0.90,0.90,0.90,0.90,0.00,0.00,10000,1,9000,0,0,0,0,0,0,0,10000,-10000,-10000
20200316,058842,元油2X群益9C購01,1.61,1.77,1.58,1.77,-0.19,-9.69,170000,11,282010,0,0,0,0,0,0,158000,0,158000,158000
20200316,058843,元油2X群益9C購02,1.24,1.27,1.15,1.15,-0.36,-23.84,49000,3,59920,0,0,0,0,0,0,49000,0,49000,49000
20200316,058844,元油2X群益9C購03,0.70,0.70,0.65,0.65,-0.18,-21.69,31000,3,21350,0,0,0,0,0,0,30000,0,30000,30000
20200316,058845,元油2X群益9C購04,0.33,0.39,0.33,0.38,-0.05,-11.63,352000,7,118880,0,0,0,0,0,0,302000,0,302000,302000
20200316,058846,鴻海群益99購03,2.29,2.29,2.29,2.29,+0.33,16.84,10000,1,22900,0,0,0,0,0,0,10000,0,10000,10000
20200316,058847,國巨群益99購05,,,,,0.00,0.00,0,0,0,0,0,0,0,0,0,0,0,0,0
20200316,058848,台積電群益99購07,1.25,1.26,0.91,0.95,-0.30,-24.0,2763000,156,2961350,0,0,0,0,0,0,603000,1762000,-1159000,-1159000
20200316,058849,奇力新群益99購02,0.52,0.52,0.43,0.43,+0.05,13.16,28000,2,13840,0,0,0,0,0,0,20000,8000,12000,12000
20200316,05884P,旺宏統一96售01,,,,,0.00,0.00,0,0,0,0,0,0,0,0,0,0,0,0,0
20200316,058850,華新科群益99購03,,,,,0.00,0.00,0,0,0,0,0,0,0,0,0,0,0,0,0
20200316,058851,大立光群益99購07,1.82,1.82,1.41,1.43,-0.55,-27.78,112000,10,186580,0,0,0,0,0,0,65000,47000,18000,18000
20200316,058852,貿聯群益99購04,1.27,1.27,1.27,1.27,0.00,0.00,10000,1,12700,0,0,0,0,0,0,0,10000,-10000,-10000
20200316,058853,日月光群益99購01,,,,,0.00,0.00,0,0,0,0,0,0,0,0,0,0,0,0,0
20200316,058854,樺漢群益9B購01,,,,,0.00,0.00,0,0,0,0,0,0,0,0,0,0,0,0,0
20200316,058855,台積電兆豐99購02,1.08,1.08,0.70,0.72,-0.36,-33.33,2223000,125,1885100,0,0,0,0,0,0,1281000,490000,791000,791000
20200316,058856,新光金兆豐99購01,0.50,0.50,0.41,0.41,-0.13,-24.07,74000,4,34970,0,0,0,0,0,0,54000,20000,34000,34000
20200316,058857,元油2X日盛99購02,0.20,0.22,0.17,0.21,-0.06,-22.22,950000,27,176340,0,0,0,0,0,0,578000,0,578000,578000
20200316,058858,元油2X凱基9A購07,0.32,0.37,0.31,0.31,-0.13,-29.55,476000,8,150850,0,0,0,0,0,0,412000,64000,348000,348000
20200316,058859,元油2X凱基9A購08,0.25,0.25,0.25,0.25,-0.02,-7.41,100000,1,25000,0,0,0,0,0,0,0,100000,-100000,-100000
20200316,05885P,牧德統一96售01,1.45,1.74,1.45,1.74,+0.43,32.82,22000,5,34610,0,0,0,0,0,0,17000,3000,14000,14000
20200316,058860,SGBR2X凱基9A購01,1.07,1.16,1.07,1.16,0.00,0.00,12000,2,13740,0,0,0,0,0,0,0,12000,-12000,-12000
20200316,058861,國巨凱基9A購08,,,,,0.00,0.00,0,0,0,0,0,0,0,0,0,0,0,0,0
20200316,058862,聯發科凱基99購08,1.98,1.98,1.98,1.98,+1.07,117.58,30000,1,59400,0,0,0,0,0,0,0,30000,-30000,-30000
20200316,058863,可成凱基99購02,,,,,0.00,0.00,0,0,0,0,0,0,0,0,0,0,0,0,0
20200316,058864,欣興凱基99購04,,,,,0.00,0.00,0,0,0,0,0,0,0,0,0,0,0,0,0
20200316,058865,群創凱基01購01,0.41,0.44,0.36,0.36,0.00,0.00,389000,6,160220,0,0,0,0,0,0,0,389000,-389000,-389000
20200316,058866,元油2X國票99購04,0.39,0.39,0.35,0.35,-0.06,-14.63,477000,17,179780,0,0,0,0,0,0,467000,10000,457000,457000
20200316,058867,元油2X國票99購05,0.45,0.45,0.40,0.41,-0.04,-8.89,50000,4,20650,0,0,0,0,0,0,35000,10000,25000,25000
20200316,058868,元油2X國票99購06,,,,,0.00,0.00,0,0,0,0,0,0,0,0,0,0,0,0,0
20200316,058869,元油2X國票9A購04,,,,,0.00,0.00,0,0,0,0,0,0,0,0,0,0,0,0,0
20200316,05886P,華通元富96售01,5.25,6.10,5.25,6.10,+0.30,5.17,201000,9,1112650,0,0,0,0,0,0,120000,81000,39000,39000
20200316,058870,元油2X國票9A購05,,,,,0.00,0.00,0,0,0,0,0,0,0,0,0,0,0,0,0
20200316,058871,元油2X國票9A購06,0.47,0.47,0.47,0.47,-0.03,-6.0,5000,1,2350,0,0,0,0,0,0,5000,0,5000,5000
20200316,058872,元油2X國票9B購01,,,,,0.00,0.00,0,0,0,0,0,0,0,0,0,0,0,0,0
20200316,058873,美律國票9A購02,0.72,0.72,0.67,0.67,0.00,0.00,2000,2,1390,0,0,0,0,0,0,2000,2000,0,0
20200316,058874,聯鈞國票9A購01,1.45,1.45,1.45,1.45,+0.08,5.84,40000,1,58000,0,0,0,0,0,0,40000,40000,0,0
20200316,058875,台表科國票9A購02,2.46,2.46,2.46,2.46,0.00,0.00,6000,1,14760,0,0,0,0,0,0,0,6000,-6000,-6000
20200316,058876,南電國票9A購02,,,,,0.00,0.00,0,0,0,0,0,0,0,0,0,0,0,0,0
20200316,058877,T50反1國泰9B購01,,,,,0.00,0.00,0,0,0,0,0,0,0,0,0,0,0,0,0
20200316,058878,旭富國泰9B購01,1.05,1.05,0.98,0.98,+0.06,6.52,2000,2,2030,0,0,0,0,0,0,1000,1000,0,0
20200316,058879,智邦富邦99購01,,,,,0.00,0.00,0,0,0,0,0,0,0,0,0,0,0,0,0
20200316,05887P,友達元富99售03,,,,,0.00,0.00,0,0,0,0,0,0,0,0,0,0,0,0,0
20200316,058880,台灣50永豐99購04,,,,,0.00,0.00,0,0,0,0,0,0,0,0,0,0,0,0,0
20200316,058881,全新永豐99購01,0.65,0.65,0.64,0.64,+0.06,10.34,11000,2,7140,0,0,0,0,0,0,1000,10000,-9000,-9000
20200316,058882,晶相光永豐99購01,,,,,0.00,0.00,0,0,0,0,0,0,0,0,0,0,0,0,0
20200316,058883,旭富永豐99購01,,,,,0.00,0.00,0,0,0,0,0,0,0,0,0,0,0,0,0
20200316,058884,世紀鋼永豐99購02,1.40,1.41,1.34,1.38,+0.02,1.47,68000,5,93280,0,0,0,0,0,0,30000,18000,12000,12000
20200316,058885,元石油元大9C購02,1.53,1.53,1.33,1.34,-0.19,-12.42,41000,5,55130,0,0,0,0,0,0,38000,3000,35000,35000
20200316,058886,元石油元大9C購03,1.57,1.57,1.54,1.54,-0.16,-9.41,10000,2,15430,0,0,0,0,0,0,9000,0,9000,9000
20200316,058887,元石油元大9C購04,1.28,1.34,1.28,1.34,-0.04,-2.9,20000,2,26200,0,0,0,0,0,0,10000,0,10000,10000
20200316,058888,元油2X元大99購16,0.60,0.73,0.57,0.67,+0.06,9.84,338000,11,206120,0,0,0,0,0,0,291000,15000,276000,276000
20200316,058889,元油2X元大9C購05,0.99,1.07,0.87,0.87,-0.28,-24.35,228000,15,209590,0,0,0,0,0,0,151000,21000,130000,130000
20200316,05888P,友達元大97售01,1.85,2.06,1.85,2.06,+0.08,4.04,138000,17,269540,0,0,0,0,0,0,40000,98000,-58000,-58000
20200316,058890,元油2X元大9C購06,,,,,0.00,0.00,0,0,0,0,0,0,0,0,0,0,0,0,0
20200316,058891,元油2X元大9C購07,0.50,0.59,0.50,0.57,+0.20,54.05,382000,7,201900,0,0,0,0,0,0,372000,0,372000,372000
20200316,058892,元油2X元大9C購08,,,,,0.00,0.00,0,0,0,0,0,0,0,0,0,0,0,0,0
20200316,058893,元油2X元大9C購10,0.30,0.30,0.30,0.30,+0.12,66.67,100000,2,30000,0,0,0,0,0,0,100000,0,100000,100000
20200316,058894,元油2X元大9C購11,0.88,0.95,0.82,0.83,-0.04,-4.6,152000,20,132250,0,0,0,0,0,0,69000,1000,68000,68000
20200316,058895,鴻海元大99購20,2.05,2.06,1.64,1.66,-0.57,-25.56,302000,48,544100,0,0,0,0,0,0,300000,302000,-2000,-2000
20200316,058896,中環元大99購03,0.70,0.70,0.66,0.66,0.00,0.00,302000,31,204920,0,0,0,0,0,0,0,302000,-302000,-302000
20200316,058897,國巨元大99購17,1.82,1.83,1.34,1.34,-0.51,-27.57,812000,75,1351700,0,0,0,0,0,0,109000,643000,-534000,-534000
20200316,058898,台積電元大99購20,2.20,2.24,1.63,1.65,-0.71,-30.08,407000,50,790850,0,0,0,0,0,0,213000,264000,-51000,-51000
20200316,058899,旺宏元大99購10,1.81,1.92,1.39,1.39,-0.26,-15.76,125000,17,208800,0,0,0,0,0,0,115000,125000,-10000,-10000
20200316,05889P,群創元大98售02,,,,,0.00,0.00,0,0,0,0,0,0,0,0,0,0,0,0,0
20200316,058900,旺宏元大99購11,1.84,1.84,1.30,1.30,-0.27,-17.2,202000,34,320300,0,0,0,0,0,0,116000,190000,-74000,-74000
20200316,058901,美律元大99購07,0.91,0.92,0.85,0.85,-0.01,-1.16,146000,9,131350,0,0,0,0,0,0,102000,56000,46000,46000
20200316,058902,聯發科元大99購15,2.17,2.19,1.71,1.76,-0.57,-24.46,128000,17,254430,0,0,0,0,0,0,78000,128000,-50000,-50000
20200316,058903,聯發科元大99購16,2.20,2.26,1.76,1.76,-0.56,-24.14,434000,48,878900,0,0,0,0,0,0,132000,406000,-274000,-274000
20200316,058904,晶技元大99購05,2.02,2.25,1.93,1.93,+0.12,6.63,371000,41,742080,0,0,0,0,0,0,4000,367000,-363000,-363000
20200316,058905,京鼎元大99購01,0.73,0.75,0.52,0.52,0.00,0.00,215000,13,148050,0,0,0,0,0,0,100000,115000,-15000,-15000
20200316,058906,晶相光元大99購01,0.49,0.49,0.49,0.49,0.00,0.00,10000,1,4900,0,0,0,0,0,0,10000,0,10000,10000
20200316,058907,健策元大99購04,1.55,1.55,1.27,1.27,-0.27,-17.53,69000,9,94480,0,0,0,0,0,0,15000,54000,-39000,-39000
20200316,058908,貿聯元大99購03,0.68,0.68,0.49,0.49,-0.19,-27.94,135000,12,82610,0,0,0,0,0,0,41000,129000,-88000,-88000
20200316,058909,神達元大99購03,1.68,1.79,1.40,1.40,-0.37,-20.9,116000,7,195570,0,0,0,0,0,0,111000,15000,96000,96000
20200316,05890P,彩晶元大99售01,1.57,1.74,1.57,1.74,+0.03,1.75,52000,6,82280,0,0,0,0,0,0,0,52000,-52000,-52000
20200316,058910,泰鼎元大99購03,0.78,0.78,0.68,0.69,0.00,0.00,35000,5,24410,0,0,0,0,0,0,0,35000,-35000,-35000
20200316,058911,茂林元大99購04,0.93,0.94,0.75,0.75,-0.28,-27.18,120000,17,107760,0,0,0,0,0,0,45000,75000,-30000,-30000
20200316,058912,祥碩元大99購01,2.42,2.44,2.04,2.04,-0.27,-11.69,79000,23,184400,0,0,0,0,0,0,79000,68000,11000,11000
20200316,058913,元油2X元富01購01,0.40,0.42,0.35,0.36,-0.07,-16.28,4538000,36,1793690,0,0,0,0,0,0,370000,4168000,-3798000,-3798000
20200316,058914,元油2X元富01購02,0.27,0.30,0.26,0.28,-0.06,-17.65,3190000,30,893900,0,0,0,0,0,0,453000,2737000,-2284000,-2284000
20200316,058915,SGBR2X元富99購01,,,,,0.00,0.00,0,0,0,0,0,0,0,0,0,0,0,0,0
20200316,058916,SGBR2X元富99購02,3.39,3.39,3.31,3.31,-0.51,-13.35,4000,2,13400,0,0,0,0,0,0,2000,2000,0,0
20200316,058917,SGBR2X元富99購03,,,,,0.00,0.00,0,0,0,0,0,0,0,0,0,0,0,0,0
20200316,058918,SGBR2X元富99購04,,,,,0.00,0.00,0,0,0,0,0,0,0,0,0,0,0,0,0
20200316,058919,SGBR2X元富99購05,3.55,3.55,3.55,3.55,-0.70,-16.47,1000,1,3550,0,0,0,0,0,0,0,1000,-1000,-1000
20200316,05891P,聯發科中信98售03,2.93,3.29,2.93,3.29,+0.48,17.08,102000,17,309950,0,0,0,0,0,0,0,102000,-102000,-102000
20200316,058920,SGBR2X元富99購06,,,,,0.00,0.00,0,0,0,0,0,0,0,0,0,0,0,0,0
20200316,058921,聯發科元富03購01,2.12,2.13,2.12,2.13,0.00,0.00,56000,2,119000,0,0,0,0,0,0,0,56000,-56000,-56000
20200316,058922,聯發科元富03購02,2.18,2.25,1.80,1.80,-0.50,-21.74,150000,9,309900,0,0,0,0,0,0,120000,30000,90000,90000
20200316,058923,華新科元富99購06,1.00,1.01,0.99,0.99,0.00,0.00,95000,6,95150,0,0,0,0,0,0,20000,75000,-55000,-55000
20200316,058924,晶相光元富99購02,,,,,0.00,0.00,0,0,0,0,0,0,0,0,0,0,0,0,0
20200316,058925,旭富元富99購02,0.88,0.88,0.79,0.85,0.00,0.00,50000,6,42100,0,0,0,0,0,0,0,50000,-50000,-50000
20200316,058926,勤誠元富99購01,1.02,1.09,1.01,1.01,0.00,0.00,535000,21,569660,0,0,0,0,0,0,0,535000,-535000,-535000
20200316,058927,勤誠元富99購02,1.38,1.40,1.38,1.38,0.00,0.00,58000,10,80260,0,0,0,0,0,0,0,58000,-58000,-58000
20200316,058928,國巨統一9C購01,0.51,0.51,0.40,0.42,-0.11,-20.75,127000,12,57250,0,0,0,0,0,0,0,56000,-56000,-56000
20200316,058929,可成統一9C購01,,,,,0.00,0.00,0,0,0,0,0,0,0,0,0,0,0,0,0
20200316,05892P,大立光中信98售03,3.10,3.14,3.10,3.14,-0.07,-2.18,20000,2,62400,0,0,0,0,0,0,0,20000,-20000,-20000
20200316,058930,華新科統一9B購01,,,,,0.00,0.00,0,0,0,0,0,0,0,0,0,0,0,0,0
20200316,058931,玉晶光統一9C購01,,,,,0.00,0.00,0,0,0,0,0,0,0,0,0,0,0,0,0
20200316,058932,FBVIX台新99購01,2.61,2.71,2.58,2.70,+0.31,12.97,107000,18,284480,0,0,0,0,0,0,1000,106000,-105000,-105000
20200316,058933,FBVIX台新9B購01,2.77,2.80,2.77,2.80,+0.12,4.48,15000,2,41700,0,0,0,0,0,0,0,15000,-15000,-15000
20200316,058934,台灣50中信03購03,2.05,2.05,1.51,1.51,-0.68,-31.05,332000,14,590870,0,0,0,0,0,0,90000,242000,-152000,-152000
20200316,058935,元油2X中信9C購03,0.76,0.82,0.76,0.82,0.00,0.00,30000,3,23500,0,0,0,0,0,0,0,30000,-30000,-30000
20200316,058936,國喬中信99購01,0.83,0.84,0.83,0.84,+0.01,1.2,160000,6,133800,0,0,0,0,0,0,0,159000,-159000,-159000
20200316,058937,仁寶中信99購01,1.16,1.16,1.16,1.16,-0.07,-5.69,20000,1,23200,0,0,0,0,0,0,20000,0,20000,20000
20200316,058938,台積電中信01購03,1.35,1.35,0.95,0.95,-0.34,-26.36,263000,28,307310,0,0,0,0,0,0,92000,158000,-66000,-66000
20200316,058939,台積電中信9B購01,,,,,0.00,0.00,0,0,0,0,0,0,0,0,0,0,0,0,0
20200316,05893P,國巨兆豐96售04,,,,,0.00,0.00,0,0,0,0,0,0,0,0,0,0,0,0,0
20200316,058940,聯發科中信9A購03,,,,,0.00,0.00,0,0,0,0,0,0,0,0,0,0,0,0,0
20200316,058941,華新科中信99購03,0.69,0.71,0.57,0.57,-0.05,-8.06,1169000,38,792120,0,0,0,0,0,0,60000,1119000,-1059000,-1059000
20200316,058942,南茂中信99購01,,,,,0.00,0.00,0,0,0,0,0,0,0,0,0,0,0,0,0
20200316,058943,元石油群益9C購01,2.33,2.33,2.27,2.27,0.00,0.00,115000,14,266140,0,0,0,0,0,0,0,115000,-115000,-115000
20200316,058944,元石油群益9C購02,1.45,1.45,1.45,1.45,+0.12,9.02,10000,1,14500,0,0,0,0,0,0,10000,0,10000,10000
20200316,058945,S&P正2群益9C購01,0.36,0.36,0.24,0.31,-0.05,-13.89,821000,50,231980,0,0,0,0,0,0,0,791000,-791000,-791000
20200316,058946,SGBR2X群益9B購01,,,,,0.00,0.00,0,0,0,0,0,0,0,0,0,0,0,0,0
20200316,058947,SGBR2X群益9B購02,,,,,0.00,0.00,0,0,0,0,0,0,0,0,0,0,0,0,0
20200316,058948,道瓊銀群益9C購01,,,,,0.00,0.00,0,0,0,0,0,0,0,0,0,0,0,0,0
20200316,058949,上銀群益99購02,,,,,0.00,0.00,0,0,0,0,0,0,0,0,0,0,0,0,0
20200316,05894P,友達群益98售02,,,,,0.00,0.00,0,0,0,0,0,0,0,0,0,0,0,0,0
20200316,058950,國巨群益99購06,2.59,2.59,1.96,1.97,-0.73,-27.04,546000,8,1201840,0,0,0,0,0,0,6000,540000,-534000,-534000
20200316,058951,南電群益99購01,0.61,0.61,0.61,0.61,0.00,0.00,4000,1,2440,0,0,0,0,0,0,0,4000,-4000,-4000
20200316,058952,南茂群益99購01,,,,,0.00,0.00,0,0,0,0,0,0,0,0,0,0,0,0,0
20200316,058953,S&P反1國票03購01,1.42,1.42,1.42,1.42,0.00,0.00,10000,1,14200,0,0,0,0,0,0,0,10000,-10000,-10000
20200316,058954,元油2X國票9A購07,0.45,0.45,0.45,0.45,+0.18,66.67,10000,1,4500,0,0,0,0,0,0,0,10000,-10000,-10000
20200316,058955,台積電國票9A購04,2.20,2.20,1.77,1.77,0.00,0.00,40000,4,83700,0,0,0,0,0,0,0,40000,-40000,-40000
20200316,058956,健策國票9A購02,1.51,1.51,1.18,1.18,-0.10,-7.81,51000,6,71730,0,0,0,0,0,0,0,51000,-51000,-51000
20200316,058957,貿聯國票9A購01,,,,,0.00,0.00,0,0,0,0,0,0,0,0,0,0,0,0,0
20200316,058958,台表科國票9A購03,1.57,1.57,1.37,1.37,+0.12,9.6,20000,3,28800,0,0,0,0,0,0,5000,15000,-10000,-10000
20200316,058959,南茂國票9A購01,,,,,0.00,0.00,0,0,0,0,0,0,0,0,0,0,0,0,0
20200316,05895P,奇力新群益96售03,2.12,2.31,2.11,2.26,-0.18,-7.38,80000,8,175000,0,0,0,0,0,0,0,80000,-80000,-80000
20200316,058960,臺股指國票99購05,2.64,2.64,1.66,1.66,-0.93,-35.91,945000,75,2058270,0,0,0,0,0,0,405000,470000,-65000,-65000
20200316,058961,台灣50兆豐9C購01,0.49,0.49,0.28,0.31,-0.27,-46.55,1062000,34,372540,0,0,0,0,0,0,0,1012000,-1012000,-1012000
20200316,058962,元油2X兆豐9A購02,0.20,0.23,0.18,0.19,+0.04,26.67,2608000,28,535190,0,0,0,0,0,0,0,2608000,-2608000,-2608000
20200316,058963,華新科兆豐99購05,,,,,0.00,0.00,0,0,0,0,0,0,0,0,0,0,0,0,0
20200316,058964,群創兆豐99購01,0.34,0.34,0.29,0.29,+0.02,7.41,12000,2,3780,0,0,0,0,0,0,0,12000,-12000,-12000
20200316,058965,祥碩兆豐99購02,0.61,0.61,0.61,0.61,-0.09,-12.86,5000,1,3050,0,0,0,0,0,0,5000,0,5000,5000
20200316,058966,元油2X日盛99購03,1.35,1.35,1.25,1.25,0.00,0.00,40000,4,51800,0,0,0,0,0,0,0,40000,-40000,-40000
20200316,058967,可成麥證99購01,,,,,0.00,0.00,0,0,0,0,0,0,0,0,0,0,0,0,0
20200316,058968,T50正2永豐99購01,1.25,1.29,1.07,1.07,0.00,0.00,145000,17,168370,0,0,0,0,0,0,0,145000,-145000,-145000
20200316,058969,亞德客永豐99購01,1.35,1.43,1.35,1.43,0.00,0.00,77000,4,106550,0,0,0,0,0,0,27000,77000,-50000,-50000
20200316,05896P,宏達電群益96售03,,,,,0.00,0.00,0,0,0,0,0,0,0,0,0,0,0,0,0
20200316,058970,鴻海永豐99購02,0.93,0.96,0.78,0.78,-0.23,-22.77,18000,11,15690,0,0,0,0,0,0,15000,18000,-3000,-3000
20200316,058971,台積電永豐99購03,0.84,0.84,0.65,0.65,-0.05,-7.14,81000,13,55650,0,0,0,0,0,0,1000,80000,-79000,-79000
20200316,058972,新日興永豐9A購01,,,,,0.00,0.00,0,0,0,0,0,0,0,0,0,0,0,0,0
20200316,058973,麗豐永豐99購01,1.03,1.03,0.97,0.97,0.00,0.00,20000,2,20000,0,0,0,0,0,0,0,20000,-20000,-20000
20200316,058974,臺股指永豐99購03,0.58,0.59,0.58,0.59,0.00,0.00,80000,8,46700,0,0,0,0,0,0,0,80000,-80000,-80000
20200316,058975,台灣50凱基01購02,1.61,1.61,1.61,1.61,0.00,0.00,30000,1,48300,0,0,0,0,0,0,0,30000,-30000,-30000
20200316,058976,元油2X凱基9A購09,0.47,0.47,0.42,0.42,-0.08,-16.0,65000,4,29550,0,0,0,0,0,0,40000,25000,15000,15000
20200316,058977,SGBR2X凱基03購01,,,,,0.00,0.00,0,0,0,0,0,0,0,0,0,0,0,0,0
20200316,058978,SGBR2X凱基9A購03,0.95,1.02,0.94,0.95,-0.34,-26.36,914000,22,883370,0,0,0,0,0,0,608000,306000,302000,302000
20200316,058979,上銀凱基99購04,1.00,1.00,0.62,0.62,-0.76,-55.07,263000,10,182210,0,0,0,0,0,0,0,263000,-263000,-263000
20200316,05897P,國巨凱基96售12,2.28,3.10,2.28,3.10,+0.82,35.96,22000,6,57310,0,0,0,0,0,0,1000,11000,-10000,-10000
20200316,058980,鴻海凱基99購06,1.49,1.56,1.14,1.14,-0.41,-26.45,233000,34,295630,0,0,0,0,0,0,213000,153000,60000,60000
20200316,058981,國巨凱基99購10,0.65,0.65,0.65,0.65,0.00,0.00,1000,1,650,0,0,0,0,0,0,0,1000,-1000,-1000
20200316,058982,台積電凱基99購08,1.40,1.50,1.06,1.06,-0.49,-31.61,3214000,75,4177210,0,0,0,0,0,0,1701000,1431000,270000,270000
20200316,058983,旺宏凱基99購05,,,,,0.00,0.00,0,0,0,0,0,0,0,0,0,0,0,0,0
20200316,058984,全新凱基9A購03,0.66,0.66,0.65,0.65,0.00,0.00,18000,2,11870,0,0,0,0,0,0,0,18000,-18000,-18000
20200316,058985,可成凱基99購03,0.62,0.62,0.57,0.57,0.00,0.00,10000,2,5950,0,0,0,0,0,0,0,10000,-10000,-10000
20200316,058986,華新科凱基9A購03,,,,,0.00,0.00,0,0,0,0,0,0,0,0,0,0,0,0,0
20200316,058987,華新科凱基9B購01,1.17,1.17,1.13,1.13,+0.06,5.61,60000,2,69400,0,0,0,0,0,0,0,60000,-60000,-60000
20200316,058988,大立光凱基9A購02,0.97,0.97,0.87,0.87,-0.14,-13.86,52000,2,49440,0,0,0,0,0,0,42000,10000,32000,32000
20200316,058989,茂林凱基99購02,0.86,0.86,0.81,0.81,-0.18,-18.18,7000,2,5920,0,0,0,0,0,0,5000,2000,3000,3000
20200316,05898P,旺宏凱基96售06,1.00,1.33,0.99,1.33,+0.24,22.02,447000,50,507480,0,0,0,0,0,0,76000,361000,-285000,-285000
20200316,058990,GIS凱基99購02,0.81,0.86,0.67,0.71,0.00,0.00,446000,24,339150,0,0,0,0,0,0,0,446000,-446000,-446000
20200316,058991,台灣50元大03購01,4.60,4.60,4.19,4.19,-0.01,-0.24,24000,3,106460,0,0,0,0,0,0,0,24000,-24000,-24000
20200316,058992,上証反元大99購02,,,,,0.00,0.00,0,0,0,0,0,0,0,0,0,0,0,0,0
20200316,058993,滬深反元大9C購01,,,,,0.00,0.00,0,0,0,0,0,0,0,0,0,0,0,0,0
20200316,058994,道瓊指元大99購01,0.69,0.76,0.69,0.76,+0.07,10.14,13000,4,9350,0,0,0,0,0,0,7000,6000,1000,1000
20200316,058995,台達電元大99購01,0.95,0.95,0.95,0.95,+0.01,1.06,6000,1,5700,0,0,0,0,0,0,0,6000,-6000,-6000
20200316,058996,台達電元大99購02,0.95,0.95,0.90,0.90,-0.02,-2.17,54000,8,50500,0,0,0,0,0,0,0,54000,-54000,-54000
20200316,058997,鴻海元大99購21,1.12,1.13,0.94,0.94,-0.12,-11.32,99000,23,99650,0,0,0,0,0,0,99000,99000,0,0
20200316,058998,鴻海元大99購22,2.68,2.70,2.19,2.21,+0.06,2.79,193000,39,463790,0,0,0,0,0,0,173000,193000,-20000,-20000
20200316,058999,台積電元大99購24,0.99,0.99,0.77,0.77,-0.27,-25.96,1260000,107,1106540,0,0,0,0,0,0,543000,747000,-204000,-204000
20200316,05899P,臺股指凱基96售30,,,,,0.00,0.00,0,0,0,0,0,0,0,0,0,0,0,0,0
20200316,059000,台積電元大99購25,2.72,3.67,2.09,2.11,-0.58,-21.56,659000,97,1548180,0,0,0,0,0,0,112000,618000,-506000,-506000
20200316,059001,聯發科元大99購17,2.98,2.98,2.41,2.41,-0.80,-24.92,55000,7,153130,0,0,0,0,0,0,35000,25000,10000,10000
20200316,059002,聯發科元大99購18,2.75,2.76,2.27,2.27,-0.73,-24.33,441000,47,1130480,0,0,0,0,0,0,194000,329000,-135000,-135000
20200316,059003,中壽元大99購01,0.83,0.83,0.64,0.64,-0.31,-32.63,110000,12,82350,0,0,0,0,0,0,30000,80000,-50000,-50000
20200316,059004,嘉晶元大99購05,2.15,2.17,2.03,2.17,+0.41,23.3,18000,5,38530,0,0,0,0,0,0,18000,18000,0,0
20200316,059005,嘉晶元大99購06,1.42,1.43,1.34,1.43,+0.12,9.16,42000,8,58220,0,0,0,0,0,0,27000,32000,-5000,-5000
20200316,059006,樺漢元大99購01,,,,,0.00,0.00,0,0,0,0,0,0,0,0,0,0,0,0,0
20200316,059007,南電元大99購05,,,,,0.00,0.00,0,0,0,0,0,0,0,0,0,0,0,0,0
20200316,059008,鈺齊元大99購03,,,,,0.00,0.00,0,0,0,0,0,0,0,0,0,0,0,0,0
20200316,059009,世紀鋼元大99購04,4.19,4.20,3.65,3.66,-0.06,-1.61,199000,34,786290,0,0,0,0,0,0,126000,186000,-60000,-60000
20200316,05900P,臺股指凱基99售05,4.88,6.85,4.83,6.45,+1.78,38.12,307000,43,1665800,0,0,0,0,0,0,30000,287000,-257000,-257000
20200316,059010,臺股指元大99購12,2.05,2.05,2.05,2.05,0.00,0.00,5000,1,10250,0,0,0,0,0,0,0,5000,-5000,-5000
20200316,059011,臺股指元大9A購30,2.05,2.09,1.73,1.79,-0.44,-19.73,151000,34,284600,0,0,0,0,0,0,49000,95000,-46000,-46000
20200316,059012,臺股指元大9A購31,1.82,1.92,1.59,1.60,-0.46,-22.33,250000,21,431110,0,0,0,0,0,0,112000,136000,-24000,-24000
20200316,059013,臺股指元大9A購32,2.10,2.10,1.66,1.84,-0.48,-20.69,96000,6,174420,0,0,0,0,0,0,50000,46000,4000,4000
20200316,059014,SGBR2X元富03購01,,,,,0.00,0.00,0,0,0,0,0,0,0,0,0,0,0,0,0
20200316,059015,華通元富99購02,1.77,1.77,1.77,1.77,+0.27,18.0,1000,1,1770,0,0,0,0,0,0,1000,0,1000,1000
20200316,059016,晶相光元富99購03,0.96,0.96,0.86,0.86,0.00,0.00,20000,2,18200,0,0,0,0,0,0,0,20000,-20000,-20000
20200316,059017,台灣50統一9B購03,2.15,2.15,1.86,1.86,0.00,0.00,4000,4,7930,0,0,0,0,0,0,0,4000,-4000,-4000
20200316,059018,滬深2X統一9A購01,0.59,0.59,0.45,0.45,0.00,0.00,13000,5,6440,0,0,0,0,0,0,0,13000,-13000,-13000
20200316,059019,元石油統一9B購03,,,,,0.00,0.00,0,0,0,0,0,0,0,0,0,0,0,0,0
20200316,05901P,臺股指凱基9C售01,4.18,5.70,4.14,5.00,+0.88,21.36,1499000,169,7456880,0,0,0,0,0,0,899000,1444000,-545000,-545000
20200316,059020,元油2X統一9B購02,,,,,0.00,0.00,0,0,0,0,0,0,0,0,0,0,0,0,0
20200316,059021,台積電統一9B購07,0.85,0.91,0.72,0.72,-0.23,-24.21,219000,31,185630,0,0,0,0,0,0,0,162000,-162000,-162000
20200316,059022,聯發科統一9B購04,0.89,0.89,0.89,0.89,-0.13,-12.75,10000,1,8900,0,0,0,0,0,0,0,10000,-10000,-10000
20200316,059023,可成統一9B購02,,,,,0.00,0.00,0,0,0,0,0,0,0,0,0,0,0,0,0
20200316,059024,大立光統一9B購04,0.74,0.74,0.59,0.60,-0.17,-22.08,126000,14,80220,0,0,0,0,0,0,30000,76000,-46000,-46000
20200316,059025,台灣50台新9B購02,1.45,1.45,1.06,1.08,-0.32,-22.86,458000,26,534250,0,0,0,0,0,0,10000,448000,-438000,-438000
20200316,059026,FBVIX台新99購03,,,,,0.00,0.00,0,0,0,0,0,0,0,0,0,0,0,0,0
20200316,059027,神達台新99購02,,,,,0.00,0.00,0,0,0,0,0,0,0,0,0,0,0,0,0
20200316,059028,嘉聯益台新99購02,,,,,0.00,0.00,0,0,0,0,0,0,0,0,0,0,0,0,0
20200316,059029,旺宏兆豐99購01,,,,,0.00,0.00,0,0,0,0,0,0,0,0,0,0,0,0,0
20200316,05902P,華通國票96售02,,,,,0.00,0.00,0,0,0,0,0,0,0,0,0,0,0,0,0
20200316,059030,奇力新兆豐99購03,,,,,0.00,0.00,0,0,0,0,0,0,0,0,0,0,0,0,0
20200316,059031,元石油中信03購01,,,,,0.00,0.00,0,0,0,0,0,0,0,0,0,0,0,0,0
20200316,059032,元石油群益9C購03,1.62,1.62,1.62,1.62,+0.55,51.4,12000,4,19440,0,0,0,0,0,0,0,12000,-12000,-12000
20200316,059033,元油2X群益9C購05,,,,,0.00,0.00,0,0,0,0,0,0,0,0,0,0,0,0,0
20200316,059034,華通群益9B購02,,,,,0.00,0.00,0,0,0,0,0,0,0,0,0,0,0,0,0
20200316,059035,旺宏群益99購06,,,,,0.00,0.00,0,0,0,0,0,0,0,0,0,0,0,0,0
20200316,059036,可成群益9B購03,,,,,0.00,0.00,0,0,0,0,0,0,0,0,0,0,0,0,0
20200316,059037,宏達電群益99購02,,,,,0.00,0.00,0,0,0,0,0,0,0,0,0,0,0,0,0
20200316,059038,健策群益9A購02,,,,,0.00,0.00,0,0,0,0,0,0,0,0,0,0,0,0,0
20200316,059039,致伸群益99購01,,,,,0.00,0.00,0,0,0,0,0,0,0,0,0,0,0,0,0
20200316,05903P,聯發科統一96售09,5.60,5.60,5.60,5.60,+0.62,12.45,1000,1,5600,0,0,0,0,0,0,1000,0,1000,1000
20200316,059040,訊芯群益99購03,,,,,0.00,0.00,0,0,0,0,0,0,0,0,0,0,0,0,0
20200316,059041,南茂群益99購02,,,,,0.00,0.00,0,0,0,0,0,0,0,0,0,0,0,0,0
20200316,059042,世紀鋼群益99購02,,,,,0.00,0.00,0,0,0,0,0,0,0,0,0,0,0,0,0
20200316,059043,聯電日盛99購01,,,,,0.00,0.00,0,0,0,0,0,0,0,0,0,0,0,0,0
20200316,059044,聯電日盛99購02,,,,,0.00,0.00,0,0,0,0,0,0,0,0,0,0,0,0,0
20200316,059045,高股息凱基99購01,,,,,0.00,0.00,0,0,0,0,0,0,0,0,0,0,0,0,0
20200316,059046,滬深2X凱基9C購01,,,,,0.00,0.00,0,0,0,0,0,0,0,0,0,0,0,0,0
20200316,059047,元油2X凱基9A購10,1.26,1.26,1.26,1.26,+0.25,24.75,10000,1,12600,0,0,0,0,0,0,0,10000,-10000,-10000
20200316,059048,元油2X凱基9A購11,0.90,0.98,0.87,0.87,+0.07,8.75,57000,10,51660,0,0,0,0,0,0,0,57000,-57000,-57000
20200316,059049,元油2X凱基9A購12,1.02,1.07,1.00,1.01,+0.10,10.99,40000,4,41000,0,0,0,0,0,0,0,40000,-40000,-40000
20200316,05904P,大立光統一96售07,3.67,3.89,3.67,3.89,+0.56,16.82,2000,2,7560,0,0,0,0,0,0,1000,1000,0,0
20200316,059050,元油2X凱基9B購08,,,,,0.00,0.00,0,0,0,0,0,0,0,0,0,0,0,0,0
20200316,059051,和大凱基9A購01,,,,,0.00,0.00,0,0,0,0,0,0,0,0,0,0,0,0,0
20200316,059052,為升凱基99購01,0.47,0.47,0.36,0.36,-0.54,-60.0,230000,5,91700,0,0,0,0,0,0,0,230000,-230000,-230000
20200316,059053,鴻海凱基99購07,1.64,1.70,1.47,1.48,-0.38,-20.43,400000,4,629000,0,0,0,0,0,0,100000,400000,-300000,-300000
20200316,059054,國巨凱基99購11,1.51,1.51,1.19,1.19,-0.73,-38.02,60000,3,87400,0,0,0,0,0,0,0,60000,-60000,-60000
20200316,059055,旺宏凱基9B購02,,,,,0.00,0.00,0,0,0,0,0,0,0,0,0,0,0,0,0
20200316,059056,技嘉凱基99購02,,,,,0.00,0.00,0,0,0,0,0,0,0,0,0,0,0,0,0
20200316,059057,聯發科凱基99購10,,,,,0.00,0.00,0,0,0,0,0,0,0,0,0,0,0,0,0
20200316,059058,可成凱基9B購01,,,,,0.00,0.00,0,0,0,0,0,0,0,0,0,0,0,0,0
20200316,059059,宏達電凱基99購03,0.80,0.80,0.80,0.80,-0.49,-37.98,30000,1,24000,0,0,0,0,0,0,30000,30000,0,0
20200316,05905P,晶技統一97售01,1.33,1.51,1.30,1.41,+0.02,1.44,55000,9,77860,0,0,0,0,0,0,10000,43000,-33000,-33000
20200316,059060,大立光凱基9A購03,1.00,1.01,0.99,1.01,-0.99,-49.5,120000,3,120860,0,0,0,0,0,0,0,120000,-120000,-120000
20200316,059061,晶技凱基9A購01,,,,,0.00,0.00,0,0,0,0,0,0,0,0,0,0,0,0,0
20200316,059062,群創凱基99購05,0.72,0.72,0.68,0.69,-0.29,-29.59,48000,3,33330,0,0,0,0,0,0,17000,48000,-31000,-31000
20200316,059063,康控凱基99購04,,,,,0.00,0.00,0,0,0,0,0,0,0,0,0,0,0,0,0
20200316,059064,緯穎凱基99購02,1.19,1.19,1.19,1.19,+0.18,17.82,100000,1,119000,0,0,0,0,0,0,100000,100000,0,0
20200316,059065,南電凱基9A購01,,,,,0.00,0.00,0,0,0,0,0,0,0,0,0,0,0,0,0
20200316,059066,道瓊指國票04購01,,,,,0.00,0.00,0,0,0,0,0,0,0,0,0,0,0,0,0
20200316,059067,上銀國票9A購02,,,,,0.00,0.00,0,0,0,0,0,0,0,0,0,0,0,0,0
20200316,059068,台虹國票9A購01,,,,,0.00,0.00,0,0,0,0,0,0,0,0,0,0,0,0,0
20200316,059069,臺指反元大9C購01,,,,,0.00,0.00,0,0,0,0,0,0,0,0,0,0,0,0,0
20200316,05906P,國巨元富96售05,1.65,1.89,1.65,1.85,+0.15,8.82,133000,7,227210,0,0,0,0,0,0,103000,20000,83000,83000
20200316,059070,道瓊指元大99購02,,,,,0.00,0.00,0,0,0,0,0,0,0,0,0,0,0,0,0
20200316,059071,元油2X元大9C購12,,,,,0.00,0.00,0,0,0,0,0,0,0,0,0,0,0,0,0
20200316,059072,元油2X元大9C購13,,,,,0.00,0.00,0,0,0,0,0,0,0,0,0,0,0,0,0
20200316,059073,元油2X元大9C購14,,,,,0.00,0.00,0,0,0,0,0,0,0,0,0,0,0,0,0
20200316,059074,元油2X元大9C購15,,,,,0.00,0.00,0,0,0,0,0,0,0,0,0,0,0,0,0
20200316,059075,FBVIX元大99購01,,,,,0.00,0.00,0,0,0,0,0,0,0,0,0,0,0,0,0
20200316,059076,FBVIX元大99購04,,,,,0.00,0.00,0,0,0,0,0,0,0,0,0,0,0,0,0
20200316,059077,FBVIX元大99購05,3.27,3.27,3.27,3.27,+1.42,76.76,3000,1,9810,0,0,0,0,0,0,0,3000,-3000,-3000
20200316,059078,FBVIX元大99購06,,,,,0.00,0.00,0,0,0,0,0,0,0,0,0,0,0,0,0
20200316,059079,SGBR2X元大99購01,,,,,0.00,0.00,0,0,0,0,0,0,0,0,0,0,0,0,0
20200316,05907P,聯發科元富96售05,,,,,0.00,0.00,0,0,0,0,0,0,0,0,0,0,0,0,0
20200316,059080,亞泥元大99購01,1.69,1.69,1.69,1.69,-0.24,-12.44,9000,1,15210,0,0,0,0,0,0,9000,9000,0,0
20200316,059081,和大元大99購01,0.95,0.95,0.95,0.95,-0.47,-33.1,10000,1,9500,0,0,0,0,0,0,0,10000,-10000,-10000
20200316,059082,華通元大99購06,,,,,0.00,0.00,0,0,0,0,0,0,0,0,0,0,0,0,0
20200316,059083,華通元大99購07,,,,,0.00,0.00,0,0,0,0,0,0,0,0,0,0,0,0,0
20200316,059084,鴻海元大99購24,2.37,2.37,1.95,2.06,-0.87,-29.69,95000,23,198820,0,0,0,0,0,0,73000,95000,-22000,-22000
20200316,059085,鴻海元大99購25,2.18,2.18,1.70,1.70,-1.33,-43.89,47000,10,89590,0,0,0,0,0,0,47000,47000,0,0
20200316,059086,國巨元大99購18,0.70,0.70,0.57,0.57,-0.29,-33.72,39000,6,25670,0,0,0,0,0,0,0,39000,-39000,-39000
20200316,059087,台積電元大99購26,2.21,2.23,1.80,1.82,-1.09,-37.46,175000,18,351450,0,0,0,0,0,0,15000,175000,-160000,-160000
20200316,059088,台積電元大99購27,2.31,2.31,1.83,1.83,-1.14,-38.38,55000,10,113350,0,0,0,0,0,0,4000,55000,-51000,-51000
20200316,059089,聯發科元大99購19,1.68,1.68,1.32,1.32,-0.80,-37.74,50000,5,74000,0,0,0,0,0,0,20000,50000,-30000,-30000
20200316,05908P,大立光元富96售05,5.10,5.40,5.10,5.40,+0.30,5.88,33000,4,174800,0,0,0,0,0,0,0,33000,-33000,-33000
20200316,059090,台新金元大99購01,,,,,0.00,0.00,0,0,0,0,0,0,0,0,0,0,0,0,0
20200316,059091,中信金元大99購01,0.82,0.82,0.82,0.82,-0.63,-43.45,1000,1,820,0,0,0,0,0,0,0,1000,-1000,-1000
20200316,059092,聯陽元大99購01,1.67,1.67,1.67,1.67,-0.14,-7.73,50000,5,83500,0,0,0,0,0,0,0,50000,-50000,-50000
20200316,059093,旭富元大99購01,0.76,0.76,0.66,0.67,-0.30,-30.93,75000,8,54950,0,0,0,0,0,0,10000,75000,-65000,-65000
20200316,059094,臻鼎元大99購03,0.93,0.95,0.83,0.83,-0.42,-33.6,464000,47,396220,0,0,0,0,0,0,0,464000,-464000,-464000
20200316,059095,訊芯元大99購01,0.58,0.58,0.58,0.58,-0.39,-40.21,10000,1,5800,0,0,0,0,0,0,0,10000,-10000,-10000
20200316,059096,百和元大99購04,,,,,0.00,0.00,0,0,0,0,0,0,0,0,0,0,0,0,0
20200316,059097,世紀鋼元大99購05,1.24,1.35,1.15,1.16,+0.07,6.42,74000,15,97380,0,0,0,0,0,0,10000,74000,-64000,-64000
20200316,059098,元油2X統一9B購03,0.83,0.83,0.83,0.83,+0.02,2.47,6000,1,4980,0,0,0,0,0,0,0,6000,-6000,-6000
20200316,059099,元油2X統一9C購01,,,,,0.00,0.00,0,0,0,0,0,0,0,0,0,0,0,0,0
20200316,05909P,康友元富96售02,2.38,2.80,2.38,2.80,+0.45,19.15,147000,15,386260,0,0,0,0,0,0,5000,142000,-137000,-137000
20200316,059100,元油2X統一9C購02,,,,,0.00,0.00,0,0,0,0,0,0,0,0,0,0,0,0,0
20200316,059101,康控統一9A購01,,,,,0.00,0.00,0,0,0,0,0,0,0,0,0,0,0,0,0
20200316,059102,聯鈞元富99購01,,,,,0.00,0.00,0,0,0,0,0,0,0,0,0,0,0,0,0
20200316,059103,旭富元富99購03,,,,,0.00,0.00,0,0,0,0,0,0,0,0,0,0,0,0,0
20200316,059104,臺股指元富99購05,,,,,0.00,0.00,0,0,0,0,0,0,0,0,0,0,0,0,0
20200316,059105,臺股指元富99購06,,,,,0.00,0.00,0,0,0,0,0,0,0,0,0,0,0,0,0
20200316,059106,臺股指元富99購07,,,,,0.00,0.00,0,0,0,0,0,0,0,0,0,0,0,0,0
20200316,059107,南茂國泰9A購01,,,,,0.00,0.00,0,0,0,0,0,0,0,0,0,0,0,0,0
20200316,059108,台灣50富邦9B購01,,,,,0.00,0.00,0,0,0,0,0,0,0,0,0,0,0,0,0
20200316,059109,台積電富邦9C購03,0.50,0.50,0.48,0.48,-0.12,-20.0,59000,6,28900,0,0,0,0,0,0,0,59000,-59000,-59000
20200316,05910P,力山永豐96售02,3.53,3.53,3.53,3.53,0.00,0.00,5000,1,17650,0,0,0,0,0,0,0,5000,-5000,-5000
20200316,059110,元油2X永豐99購02,,,,,0.00,0.00,0,0,0,0,0,0,0,0,0,0,0,0,0
20200316,059111,元油2X永豐99購03,0.96,0.96,0.96,0.96,-0.52,-35.14,9000,1,8640,0,0,0,0,0,0,0,9000,-9000,-9000
20200316,059112,上銀永豐99購01,,,,,0.00,0.00,0,0,0,0,0,0,0,0,0,0,0,0,0
20200316,059113,群光永豐99購01,,,,,0.00,0.00,0,0,0,0,0,0,0,0,0,0,0,0,0
20200316,059114,華新科永豐99購05,0.76,0.76,0.62,0.62,-0.34,-35.42,60000,3,45280,0,0,0,0,0,0,56000,60000,-4000,-4000
20200316,059115,美食永豐99購01,,,,,0.00,0.00,0,0,0,0,0,0,0,0,0,0,0,0,0
20200316,059116,晶豪科永豐99購01,,,,,0.00,0.00,0,0,0,0,0,0,0,0,0,0,0,0,0
20200316,059117,禾伸堂永豐99購01,1.17,1.17,1.17,1.17,+0.08,7.34,3000,1,3510,0,0,0,0,0,0,3000,3000,0,0
20200316,059118,晶技永豐9A購01,,,,,0.00,0.00,0,0,0,0,0,0,0,0,0,0,0,0,0
20200316,059119,華擎永豐99購02,,,,,0.00,0.00,0,0,0,0,0,0,0,0,0,0,0,0,0
20200316,05911P,南亞科永豐96售03,3.02,3.20,3.02,3.20,+0.30,10.34,30000,2,92400,0,0,0,0,0,0,30000,0,30000,30000
20200316,059120,致伸永豐99購01,,,,,0.00,0.00,0,0,0,0,0,0,0,0,0,0,0,0,0
20200316,059121,瑞儀永豐99購01,1.10,1.14,1.05,1.05,+0.16,17.98,31000,3,32830,0,0,0,0,0,0,0,31000,-31000,-31000
20200316,059122,超眾永豐99購01,0.97,0.97,0.85,0.85,-0.27,-24.11,40000,4,37400,0,0,0,0,0,0,30000,40000,-10000,-10000
20200316,059123,訊芯永豐99購03,,,,,0.00,0.00,0,0,0,0,0,0,0,0,0,0,0,0,0
20200316,05912P,和大元大96售01,3.15,3.38,3.15,3.37,0.00,0.00,66000,8,211470,0,0,0,0,0,0,1000,65000,-64000,-64000
20200316,05913P,國巨元大96售11,4.45,5.30,4.37,5.30,+0.47,9.73,46000,9,228100,0,0,0,0,0,0,27000,46000,-19000,-19000
20200316,05914P,友達元大96售04,2.05,2.15,2.05,2.15,0.00,0.00,17000,3,36450,0,0,0,0,0,0,16000,1000,15000,15000
20200316,05915P,聯發科元大96售19,4.95,5.60,4.95,5.20,+0.25,5.05,4000,3,20700,0,0,0,0,0,0,3000,1000,2000,2000
20200316,05916P,聯發科元大96售20,,,,,0.00,0.00,0,0,0,0,0,0,0,0,0,0,0,0,0
20200316,05917P,宏達電元大96售02,,,,,0.00,0.00,0,0,0,0,0,0,0,0,0,0,0,0,0
20200316,05918P,大立光元大96售11,,,,,0.00,0.00,0,0,0,0,0,0,0,0,0,0,0,0,0
20200316,05919P,京鼎元大96售03,3.44,3.50,3.44,3.50,0.00,0.00,6000,2,20760,0,0,0,0,0,0,2000,4000,-2000,-2000
20200316,05920P,力成元大96售04,2.34,2.42,2.34,2.38,+0.04,1.71,42000,6,100760,0,0,0,0,0,0,10000,32000,-22000,-22000
20200316,05921P,同欣電元大96售06,2.00,2.20,2.00,2.20,+0.06,2.8,13000,2,26600,0,0,0,0,0,0,3000,10000,-7000,-7000
20200316,05922P,京元電兆豐96售01,2.58,2.58,2.58,2.58,-0.38,-12.84,10000,1,25800,0,0,0,0,0,0,0,10000,-10000,-10000
20200316,05923P,旺宏元富96售05,2.49,2.89,2.46,2.89,+0.02,0.7,201000,8,504620,0,0,0,0,0,0,133000,68000,65000,65000
20200316,05924P,超眾元富96售04,4.07,4.07,4.07,4.07,-0.23,-5.35,10000,1,40700,0,0,0,0,0,0,10000,10000,0,0
20200316,05925P,晶技永豐96售03,1.17,1.31,1.10,1.23,-0.11,-8.21,169000,19,198090,0,0,0,0,0,0,16000,148000,-132000,-132000
20200316,05926P,智易永豐96售02,,,,,0.00,0.00,0,0,0,0,0,0,0,0,0,0,0,0,0
20200316,05927P,正文永豐96售03,2.59,2.59,2.59,2.59,-0.01,-0.38,10000,1,25900,0,0,0,0,0,0,0,10000,-10000,-10000
20200316,05928P,華邦電康和96售01,,,,,0.00,0.00,0,0,0,0,0,0,0,0,0,0,0,0,0
20200316,05929P,宏達電康和96售01,1.60,1.60,1.60,1.60,+0.15,10.34,1000,1,1600,0,0,0,0,0,0,0,1000,-1000,-1000
20200316,05930P,景碩康和96售01,1.72,1.72,1.72,1.72,+0.15,9.55,1000,1,1720,0,0,0,0,0,0,1000,0,1000,1000
20200316,05931P,鴻海凱基96售15,,,,,0.00,0.00,0,0,0,0,0,0,0,0,0,0,0,0,0
20200316,05932P,鴻海凱基96售16,10.80,10.80,10.80,10.80,-1.00,-8.47,20000,2,216000,0,0,0,0,0,0,0,20000,-20000,-20000
20200316,05933P,鴻海凱基97售03,11.90,11.90,11.90,11.90,+2.25,23.32,2000,1,23800,0,0,0,0,0,0,2000,0,2000,2000
20200316,05934P,國巨凱基96售13,1.65,2.63,1.53,2.63,+0.91,52.91,164000,19,283080,0,0,0,0,0,0,135000,105000,30000,30000
20200316,05935P,台積電凱基96售19,7.30,8.25,7.30,8.25,+1.55,23.13,480000,52,3639850,0,0,0,0,0,0,480000,480000,0,0
20200316,05936P,台積電凱基96售20,7.20,8.80,7.20,8.80,+1.85,26.62,152000,30,1156600,0,0,0,0,0,0,152000,152000,0,0
20200316,05937P,台積電凱基96售21,,,,,0.00,0.00,0,0,0,0,0,0,0,0,0,0,0,0,0
20200316,05938P,旺宏凱基96售07,2.19,2.67,2.11,2.67,+0.34,14.59,83000,5,188790,0,0,0,0,0,0,17000,66000,-49000,-49000
20200316,05939P,聯發科凱基96售20,,,,,0.00,0.00,0,0,0,0,0,0,0,0,0,0,0,0,0
20200316,05940P,聯發科凱基96售21,,,,,0.00,0.00,0,0,0,0,0,0,0,0,0,0,0,0,0
20200316,05941P,聯發科凱基96售22,,,,,0.00,0.00,0,0,0,0,0,0,0,0,0,0,0,0,0
20200316,05942P,奇力新凱基96售04,1.20,1.61,1.19,1.61,-0.39,-19.5,72000,27,91870,0,0,0,0,0,0,0,72000,-72000,-72000
20200316,05943P,欣興凱基96售03,,,,,0.00,0.00,0,0,0,0,0,0,0,0,0,0,0,0,0
20200316,05944P,富邦金中信96售01,1.47,1.77,1.47,1.72,+0.17,10.97,153000,13,248430,0,0,0,0,0,0,62000,91000,-29000,-29000
20200316,05945P,聯詠中信96售01,1.09,1.09,1.09,1.09,-0.10,-8.4,10000,1,10900,0,0,0,0,0,0,10000,0,10000,10000
20200316,05946P,和碩中信96售01,2.21,2.45,2.21,2.45,+0.30,13.95,116000,14,276670,0,0,0,0,0,0,7000,109000,-102000,-102000
20200316,05947P,大成鋼元大96售03,2.91,3.05,2.90,3.04,+0.08,2.7,381000,12,1118270,0,0,0,0,0,0,365000,16000,349000,349000
20200316,05948P,茂林元大96售03,1.41,1.98,1.40,1.92,+0.41,27.15,576000,40,989690,0,0,0,0,0,0,321000,239000,82000,82000
20200316,05949P,台積電國票96售09,,,,,0.00,0.00,0,0,0,0,0,0,0,0,0,0,0,0,0
20200316,05950P,台積電國票97售04,,,,,0.00,0.00,0,0,0,0,0,0,0,0,0,0,0,0,0
20200316,05951P,台積電國票97售05,,,,,0.00,0.00,0,0,0,0,0,0,0,0,0,0,0,0,0
20200316,05952P,台積電國票97售06,,,,,0.00,0.00,0,0,0,0,0,0,0,0,0,0,0,0,0
20200316,05953P,台積電國票98售02,,,,,0.00,0.00,0,0,0,0,0,0,0,0,0,0,0,0,0
20200316,05954P,旺宏國票97售03,,,,,0.00,0.00,0,0,0,0,0,0,0,0,0,0,0,0,0
20200316,05955P,台光電國票97售02,,,,,0.00,0.00,0,0,0,0,0,0,0,0,0,0,0,0,0
20200316,05956P,漢唐國票96售02,,,,,0.00,0.00,0,0,0,0,0,0,0,0,0,0,0,0,0
20200316,05957P,友達國票97售04,,,,,0.00,0.00,0,0,0,0,0,0,0,0,0,0,0,0,0
20200316,05958P,聯發科國票97售04,6.05,7.10,6.05,7.10,+1.40,24.56,12000,3,74050,0,0,0,0,0,0,11000,1000,10000,10000
20200316,05959P,聯發科國票98售01,9.90,10.60,9.90,10.60,+1.35,14.59,2000,2,20500,0,0,0,0,0,0,2000,0,2000,2000
20200316,05960P,欣興統一96售01,,,,,0.00,0.00,0,0,0,0,0,0,0,0,0,0,0,0,0
20200316,05961P,鴻海群益97售01,,,,,0.00,0.00,0,0,0,0,0,0,0,0,0,0,0,0,0
20200316,05962P,大立光群益96售07,3.47,5.95,3.40,5.90,+1.41,31.4,891000,91,4484300,0,0,0,0,0,0,881000,890000,-9000,-9000
20200316,05963P,貿聯國票97售02,,,,,0.00,0.00,0,0,0,0,0,0,0,0,0,0,0,0,0
20200316,05964P,華通凱基96售06,,,,,0.00,0.00,0,0,0,0,0,0,0,0,0,0,0,0,0
20200316,05965P,健策凱基96售05,0.56,0.61,0.56,0.60,-0.17,-22.08,160000,15,96200,0,0,0,0,0,0,20000,140000,-120000,-120000
20200316,05966P,矽力凱基96售03,0.89,1.70,0.86,1.70,+0.71,71.72,1486000,28,1655930,0,0,0,0,0,0,10000,1425000,-1415000,-1415000
20200316,05967P,臺股指麥證96售02,,,,,0.00,0.00,0,0,0,0,0,0,0,0,0,0,0,0,0
20200316,05968P,鴻海台新96售02,3.41,3.54,3.41,3.54,-0.10,-2.75,187000,3,643470,0,0,0,0,0,0,180000,187000,-7000,-7000
20200316,05969P,台積電台新96售04,1.95,2.29,1.95,2.29,-0.22,-8.76,749000,27,1530940,0,0,0,0,0,0,749000,749000,0,0
20200316,05970P,超眾永豐96售03,,,,,0.00,0.00,0,0,0,0,0,0,0,0,0,0,0,0,0
20200316,05971P,世紀鋼永豐96售04,1.02,1.02,1.02,1.02,-0.05,-4.67,10000,1,10200,0,0,0,0,0,0,0,10000,-10000,-10000
20200316,05972P,瑞昱元大96售01,3.54,4.02,3.54,4.02,+0.43,11.98,31000,11,115290,0,0,0,0,0,0,16000,15000,1000,1000
20200316,05973P,聯詠元大96售06,3.75,3.87,3.75,3.87,-0.35,-8.29,11000,2,42450,0,0,0,0,0,0,0,11000,-11000,-11000
20200316,05974P,國巨富邦97售03,1.28,1.44,1.25,1.44,+0.19,15.2,15000,4,19290,0,0,0,0,0,0,15000,0,15000,15000
20200316,05975P,國巨日盛99售02,1.94,2.49,1.94,2.49,+0.37,17.45,106000,13,223060,0,0,0,0,0,0,79000,27000,52000,52000
20200316,05976P,國巨凱基96售14,4.51,5.45,4.51,5.45,+1.19,27.93,28000,6,138170,0,0,0,0,0,0,2000,26000,-24000,-24000
20200316,05977P,旺宏永豐96售06,2.26,2.26,2.26,2.26,-0.23,-9.24,5000,1,11300,0,0,0,0,0,0,0,5000,-5000,-5000
20200316,05978P,麗豐永豐96售02,,,,,0.00,0.00,0,0,0,0,0,0,0,0,0,0,0,0,0
20200316,05979P,華新科中信96售02,0.92,1.21,0.92,1.21,+0.03,2.54,76000,3,85080,0,0,0,0,0,0,76000,0,76000,76000
20200316,05980P,台積電永昌96售09,3.44,4.00,3.24,4.00,+0.15,3.9,134000,20,477520,0,0,0,0,0,0,57000,84000,-27000,-27000
20200316,05981P,可成永昌98售02,,,,,0.00,0.00,0,0,0,0,0,0,0,0,0,0,0,0,0
20200316,05982P,漢唐國票96售03,3.32,3.32,3.32,3.32,-0.52,-13.54,1000,1,3320,0,0,0,0,0,0,1000,0,1000,1000
20200316,05983P,聯詠國票96售02,,,,,0.00,0.00,0,0,0,0,0,0,0,0,0,0,0,0,0
20200316,05984P,台積電統一98售01,2.42,2.42,2.42,2.42,+0.17,7.56,10000,1,24200,0,0,0,0,0,0,0,10000,-10000,-10000
20200316,05985P,燿華統一96售03,,,,,0.00,0.00,0,0,0,0,0,0,0,0,0,0,0,0,0
20200316,05986P,大立光統一97售03,,,,,0.00,0.00,0,0,0,0,0,0,0,0,0,0,0,0,0
20200316,05987P,健策統一96售02,2.30,2.30,2.30,2.30,+0.01,0.44,10000,1,23000,0,0,0,0,0,0,10000,0,10000,10000
20200316,05988P,光磊元富96售02,,,,,0.00,0.00,0,0,0,0,0,0,0,0,0,0,0,0,0
20200316,05989P,健策元富96售01,2.22,2.70,2.13,2.56,+0.27,11.79,154000,21,374630,0,0,0,0,0,0,50000,104000,-54000,-54000
20200316,05990P,台積電群益96售13,5.45,6.30,5.45,6.30,-0.45,-6.67,12000,2,67100,0,0,0,0,0,0,10000,2000,8000,8000
20200316,05991P,聯茂群益96售05,1.35,1.35,1.35,1.35,-0.20,-12.9,1000,1,1350,0,0,0,0,0,0,1000,0,1000,1000
20200316,05992P,華通元大96售05,5.70,5.95,5.60,5.85,-0.55,-8.59,32000,7,185900,0,0,0,0,0,0,32000,20000,12000,12000
20200316,05993P,國巨元大96售13,3.71,4.66,3.61,4.66,+0.99,26.98,86000,12,351790,0,0,0,0,0,0,47000,79000,-32000,-32000
20200316,05994P,奇鋐元大96售02,1.61,1.92,1.59,1.89,+0.22,13.17,338000,44,577410,0,0,0,0,0,0,125000,222000,-97000,-97000
20200316,05995P,T50正2中信9C售01,4.08,4.08,4.08,4.08,+0.30,7.94,3000,1,12240,0,0,0,0,0,0,0,3000,-3000,-3000
20200316,05996P,華新科群益96售03,,,,,0.00,0.00,0,0,0,0,0,0,0,0,0,0,0,0,0
20200316,05997P,嘉聯益群益96售02,,,,,0.00,0.00,0,0,0,0,0,0,0,0,0,0,0,0,0
20200316,05998P,台積電元大97售12,3.02,3.02,3.02,3.02,-0.52,-14.69,1000,1,3020,0,0,0,0,0,0,0,1000,-1000,-1000
20200316,05999P,世芯元大96售01,1.96,2.51,1.94,2.51,+0.60,31.41,606000,76,1390040,0,0,0,0,0,0,265000,340000,-75000,-75000
20200316,06000P,GIS元大96售04,,,,,0.00,0.00,0,0,0,0,0,0,0,0,0,0,0,0,0
20200316,06001P,樺漢台新96售01,,,,,0.00,0.00,0,0,0,0,0,0,0,0,0,0,0,0,0
20200316,06002P,華通康和96售01,,,,,0.00,0.00,0,0,0,0,0,0,0,0,0,0,0,0,0
20200316,06003P,亞光康和96售02,,,,,0.00,0.00,0,0,0,0,0,0,0,0,0,0,0,0,0
20200316,06004P,奇力新永豐96售02,,,,,0.00,0.00,0,0,0,0,0,0,0,0,0,0,0,0,0
20200316,06005P,晶豪科永豐96售04,2.29,2.29,2.29,2.29,+0.23,11.17,4000,1,9160,0,0,0,0,0,0,0,4000,-4000,-4000
20200316,06006P,欣興永豐96售04,2.56,3.09,2.48,3.09,+0.54,21.18,101000,18,284710,0,0,0,0,0,0,20000,91000,-71000,-71000
20200316,06007P,世芯永豐96售01,1.41,1.69,1.39,1.66,+0.40,31.75,262000,34,401100,0,0,0,0,0,0,47000,215000,-168000,-168000
20200316,06008P,燿華統一96售04,,,,,0.00,0.00,0,0,0,0,0,0,0,0,0,0,0,0,0
20200316,06009P,宏達電元富96售03,3.01,3.01,3.01,3.01,+0.22,7.89,10000,1,30100,0,0,0,0,0,0,0,10000,-10000,-10000
20200316,06010P,國泰金元富96售01,3.90,4.48,3.90,4.48,+0.51,12.85,69000,12,299790,0,0,0,0,0,0,3000,66000,-63000,-63000
20200316,06011P,貿聯元富96售04,2.77,3.25,2.77,3.19,+0.20,6.69,70000,10,199060,0,0,0,0,0,0,70000,0,70000,70000
20200316,06012P,世芯國票96售01,2.19,2.93,2.19,2.93,+0.44,17.67,161000,6,364130,0,0,0,0,0,0,150000,11000,139000,139000
20200316,06013P,世芯國泰97售03,1.84,2.27,1.74,2.26,+0.54,31.4,964000,96,1952580,0,0,0,0,0,0,351000,595000,-244000,-244000
20200316,06014P,聯發科富邦97售02,2.15,2.51,2.15,2.51,+0.36,16.74,15000,6,34530,0,0,0,0,0,0,12000,1000,11000,11000
20200316,06015P,大立光富邦98售04,0.62,0.67,0.62,0.67,-0.11,-14.1,20000,2,12900,0,0,0,0,0,0,0,10000,-10000,-10000
20200316,06016P,京元電凱基96售03,1.38,1.38,0.97,1.18,-0.20,-14.49,360000,18,416400,0,0,0,0,0,0,30000,330000,-300000,-300000
20200316,06017P,亞光凱基96售04,2.53,2.53,2.53,2.53,-0.27,-9.64,15000,1,37950,0,0,0,0,0,0,0,15000,-15000,-15000
20200316,06018P,康控凱基96售03,1.93,2.48,1.93,2.48,+0.41,19.81,86000,11,196460,0,0,0,0,0,0,1000,76000,-75000,-75000
20200316,06019P,緯穎凱基96售03,0.52,0.60,0.51,0.60,-0.02,-3.23,430000,17,232810,0,0,0,0,0,0,161000,269000,-108000,-108000
20200316,06020P,燿華元富96售04,5.30,5.30,5.30,5.30,+0.32,6.43,25000,1,132500,0,0,0,0,0,0,25000,0,25000,25000
20200316,06021P,世紀鋼元富96售03,1.13,1.28,1.09,1.28,+0.02,1.59,746000,72,885950,0,0,0,0,0,0,340000,396000,-56000,-56000
20200316,06022P,緯穎永豐96售03,0.59,0.67,0.59,0.67,-0.12,-15.19,155000,17,95740,0,0,0,0,0,0,34000,121000,-87000,-87000
20200316,06023P,超眾國票96售03,,,,,0.00,0.00,0,0,0,0,0,0,0,0,0,0,0,0,0
20200316,06024P,台郡國票97售05,,,,,0.00,0.00,0,0,0,0,0,0,0,0,0,0,0,0,0
20200316,06025P,臺股指元大99售02,3.35,3.51,3.26,3.48,+0.24,7.41,850000,92,2849030,0,0,0,0,0,0,224000,613000,-389000,-389000
20200316,06026P,華通台新97售01,3.64,4.16,3.64,4.16,+0.35,9.19,49000,7,182840,0,0,0,0,0,0,0,49000,-49000,-49000
20200316,06027P,鴻海台新96售04,4.85,4.89,4.85,4.89,0.00,0.00,400000,2,1948000,0,0,0,0,0,0,400000,400000,0,0
20200316,06028P,智邦台新97售01,0.83,1.01,0.80,1.01,+0.16,18.82,714000,13,634580,0,0,0,0,0,0,314000,390000,-76000,-76000
20200316,06029P,聯發科台新96售02,,,,,0.00,0.00,0,0,0,0,0,0,0,0,0,0,0,0,0
20200316,06030P,友達兆豐96售02,2.17,2.17,2.17,2.17,-0.43,-16.54,16000,1,34720,0,0,0,0,0,0,16000,0,16000,16000
20200316,06031P,新光金兆豐96售02,,,,,0.00,0.00,0,0,0,0,0,0,0,0,0,0,0,0,0
20200316,06032P,健策群益97售03,,,,,0.00,0.00,0,0,0,0,0,0,0,0,0,0,0,0,0
20200316,06033P,可成凱基96售09,1.71,2.17,1.68,2.11,+0.18,9.33,746000,30,1484760,0,0,0,0,0,0,463000,283000,180000,180000
20200316,06034P,世芯凱基96售03,1.04,2.10,1.04,2.10,+0.54,34.62,907000,41,1517850,0,0,0,0,0,0,43000,825000,-782000,-782000
20200316,06035P,同欣電凱基96售03,0.92,1.12,0.92,1.12,+0.15,15.46,372000,14,387570,0,0,0,0,0,0,116000,256000,-140000,-140000
20200316,06036P,台表科凱基96售04,2.57,2.79,2.57,2.79,0.00,0.00,80000,6,212020,0,0,0,0,0,0,0,80000,-80000,-80000
20200316,06037P,超眾國票98售02,,,,,0.00,0.00,0,0,0,0,0,0,0,0,0,0,0,0,0
20200316,06038P,國泰金台新96售01,1.53,1.80,1.53,1.80,+0.26,16.88,514000,15,889650,0,0,0,0,0,0,65000,449000,-384000,-384000
20200316,06039P,亞光台新96售03,,,,,0.00,0.00,0,0,0,0,0,0,0,0,0,0,0,0,0
20200316,06040P,亞光康和96售03,,,,,0.00,0.00,0,0,0,0,0,0,0,0,0,0,0,0,0
20200316,06041P,全新永豐96售03,,,,,0.00,0.00,0,0,0,0,0,0,0,0,0,0,0,0,0
20200316,06042P,華新科永豐96售04,1.83,1.83,1.83,1.83,0.00,0.00,20000,2,36600,0,0,0,0,0,0,0,20000,-20000,-20000
20200316,06043P,創意永豐96售06,1.88,2.13,1.75,2.13,+0.26,13.9,42000,7,79580,0,0,0,0,0,0,4000,38000,-34000,-34000
20200316,06044P,同欣電永豐96售03,2.41,2.55,2.41,2.55,+0.30,13.33,32000,5,78200,0,0,0,0,0,0,25000,7000,18000,18000
20200316,06045P,臺股指永豐96售03,,,,,0.00,0.00,0,0,0,0,0,0,0,0,0,0,0,0,0
20200316,06046P,健策統一96售03,3.00,3.41,2.93,3.41,+0.45,15.2,55000,8,166250,0,0,0,0,0,0,47000,8000,39000,39000
20200316,06047P,聯發科富邦99售04,4.53,5.80,4.53,5.80,+1.59,37.77,24000,8,114160,0,0,0,0,0,0,17000,7000,10000,10000
20200316,06048P,大立光富邦96售05,,,,,0.00,0.00,0,0,0,0,0,0,0,0,0,0,0,0,0
20200316,06049P,創意亞東97售01,2.60,2.69,2.60,2.69,-0.44,-14.06,70000,3,182900,0,0,0,0,0,0,60000,10000,50000,50000
20200316,06050P,玉晶光國票98售01,,,,,0.00,0.00,0,0,0,0,0,0,0,0,0,0,0,0,0
20200316,06051P,嘉聯益國票97售04,,,,,0.00,0.00,0,0,0,0,0,0,0,0,0,0,0,0,0
20200316,06052P,台郡國票97售06,,,,,0.00,0.00,0,0,0,0,0,0,0,0,0,0,0,0,0
20200316,06053P,緯穎國票97售05,0.42,0.54,0.42,0.54,-0.15,-21.74,50000,5,23800,0,0,0,0,0,0,0,50000,-50000,-50000
20200316,06054P,臺股指中信9A售01,3.54,3.96,3.35,3.96,+0.42,11.86,21000,3,78350,0,0,0,0,0,0,1000,10000,-9000,-9000
20200316,06055P,華通凱基97售04,3.41,3.41,3.41,3.41,-0.19,-5.28,1000,1,3410,0,0,0,0,0,0,1000,0,1000,1000
20200316,06056P,台積電凱基98售02,3.24,3.60,3.24,3.60,+1.46,68.22,29000,4,99800,0,0,0,0,0,0,15000,14000,1000,1000
20200316,06057P,大立光凱基98售01,6.10,8.00,6.10,8.00,+1.05,15.11,52000,7,320800,0,0,0,0,0,0,1000,50000,-49000,-49000
20200316,06058P,玉晶光凱基97售04,2.72,3.10,2.72,3.10,+0.30,10.71,139000,6,389440,0,0,0,0,0,0,111000,28000,83000,83000
20200316,06059P,泰碩元大97售02,1.88,2.48,1.73,2.47,+0.40,19.32,238000,32,473370,0,0,0,0,0,0,75000,163000,-88000,-88000
20200316,06060P,玉晶光元大97售03,4.47,5.20,4.46,5.20,+0.65,14.29,156000,22,750300,0,0,0,0,0,0,73000,93000,-20000,-20000
20200316,06061P,訊芯統一97售01,,,,,0.00,0.00,0,0,0,0,0,0,0,0,0,0,0,0,0
20200316,06062P,宏達電元富97售01,4.03,4.30,4.03,4.30,+0.44,11.4,11000,2,44600,0,0,0,0,0,0,1000,10000,-9000,-9000
20200316,06063P,玉晶光元富97售01,4.66,4.99,4.66,4.99,+0.19,3.96,1138000,30,5634700,0,0,0,0,0,0,1003000,1135000,-132000,-132000
20200316,06064P,台積電台新98售01,2.47,3.20,2.47,3.20,+0.82,34.45,510000,52,1439900,0,0,0,0,0,0,485000,505000,-20000,-20000
20200316,06065P,大立光台新97售01,2.09,2.09,2.09,2.09,-0.75,-26.41,1000,1,2090,0,0,0,0,0,0,1000,0,1000,1000
20200316,06066P,群創台新98售01,1.74,1.96,1.74,1.96,-0.10,-4.85,50000,7,94840,0,0,0,0,0,0,6000,44000,-38000,-38000
20200316,06067P,華新科康和97售01,1.53,1.68,1.53,1.68,-0.06,-3.45,10000,2,15600,0,0,0,0,0,0,8000,10000,-2000,-2000
20200316,06068P,玉晶光康和97售01,1.70,1.88,1.69,1.88,+0.13,7.43,5000,3,8660,0,0,0,0,0,0,1000,4000,-3000,-3000
20200316,06069P,台積電永豐97售01,3.44,3.44,3.44,3.44,-0.05,-1.43,1000,1,3440,0,0,0,0,0,0,0,1000,-1000,-1000
20200316,06070P,漢唐永豐97售01,1.50,1.73,1.48,1.73,+0.21,13.82,47000,5,73530,0,0,0,0,0,0,0,47000,-47000,-47000
20200316,06071P,大立光永豐97售01,,,,,0.00,0.00,0,0,0,0,0,0,0,0,0,0,0,0,0
20200316,06072P,牧德永豐97售01,,,,,0.00,0.00,0,0,0,0,0,0,0,0,0,0,0,0,0
20200316,06073P,健策永豐97售01,2.83,3.21,2.64,3.21,+0.11,3.55,147000,16,433510,0,0,0,0,0,0,82000,105000,-23000,-23000
20200316,06074P,台積電凱基98售04,14.10,14.10,14.10,14.10,0.00,0.00,10000,1,141000,0,0,0,0,0,0,10000,0,10000,10000
20200316,06075P,智邦凱基97售02,0.74,0.81,0.74,0.81,-0.01,-1.22,66000,4,52590,0,0,0,0,0,0,0,66000,-66000,-66000
20200316,06076P,大立光凱基98售03,3.50,4.54,3.50,4.44,+1.32,42.31,39000,9,172760,0,0,0,0,0,0,27000,32000,-5000,-5000
20200316,06077P,GIS凱基97售02,3.17,3.36,3.10,3.36,-0.14,-4.0,38000,7,124280,0,0,0,0,0,0,0,38000,-38000,-38000
20200316,06078P,臺股指凱基9A售01,6.40,7.05,6.40,6.70,+0.50,8.06,16000,4,105950,0,0,0,0,0,0,8000,5000,3000,3000
20200316,06079P,燿華群益98售02,4.33,4.33,4.33,4.33,+0.44,11.31,10000,1,43300,0,0,0,0,0,0,10000,0,10000,10000
20200316,06080P,景碩群益98售02,2.38,2.38,2.38,2.38,-0.19,-7.39,1000,1,2380,0,0,0,0,0,0,0,1000,-1000,-1000
20200316,06081P,深中小元大97售02,0.47,0.62,0.44,0.62,+0.15,31.91,298000,18,161880,0,0,0,0,0,0,205000,93000,112000,112000
20200316,06082P,華通統一98售01,,,,,0.00,0.00,0,0,0,0,0,0,0,0,0,0,0,0,0
20200316,06083P,華通統一98售02,,,,,0.00,0.00,0,0,0,0,0,0,0,0,0,0,0,0,0
20200316,06084P,宏達電元富97售02,2.88,3.66,2.88,3.54,+0.34,10.62,47000,9,146730,0,0,0,0,0,0,5000,42000,-37000,-37000
20200316,06085P,義隆台新97售01,1.17,1.35,1.17,1.35,+0.13,10.66,115000,8,142950,0,0,0,0,0,0,23000,92000,-69000,-69000
20200316,06086P,台積電康和97售01,,,,,0.00,0.00,0,0,0,0,0,0,0,0,0,0,0,0,0
20200316,06087P,國巨永豐97售01,3.89,4.71,3.89,4.71,+0.54,12.95,50000,8,211220,0,0,0,0,0,0,22000,28000,-6000,-6000
20200316,06088P,建準永豐97售01,,,,,0.00,0.00,0,0,0,0,0,0,0,0,0,0,0,0,0
20200316,06089P,矽創永豐97售01,1.59,1.93,1.59,1.93,+0.13,7.22,78000,12,133820,0,0,0,0,0,0,11000,65000,-54000,-54000
20200316,06090P,旺宏統一97售06,,,,,0.00,0.00,0,0,0,0,0,0,0,0,0,0,0,0,0
20200316,06091P,華新科統一97售01,3.41,3.55,3.41,3.53,-0.36,-9.25,30000,4,103560,0,0,0,0,0,0,20000,0,20000,20000
20200316,06092P,嘉聯益統一97售01,2.02,2.02,2.02,2.02,+0.06,3.06,2000,1,4040,0,0,0,0,0,0,2000,0,2000,2000
20200316,06093P,華通元富97售03,5.95,6.85,5.95,6.85,+0.70,11.38,76000,7,480800,0,0,0,0,0,0,33000,43000,-10000,-10000
20200316,06094P,台達電中信97售01,1.86,2.18,1.86,2.04,+0.06,3.03,53000,7,104900,0,0,0,0,0,0,10000,43000,-33000,-33000
20200316,06095P,燿華永豐97售01,,,,,0.00,0.00,0,0,0,0,0,0,0,0,0,0,0,0,0
20200316,06096P,全新永豐97售02,,,,,0.00,0.00,0,0,0,0,0,0,0,0,0,0,0,0,0
20200316,06097P,茂林永豐97售01,1.17,1.40,1.17,1.40,+0.12,9.38,62000,8,75250,0,0,0,0,0,0,0,57000,-57000,-57000
20200316,06098P,T50反1日盛97售02,,,,,0.00,0.00,0,0,0,0,0,0,0,0,0,0,0,0,0
20200316,06099P,鴻海日盛97售03,5.45,6.25,5.45,6.25,-0.10,-1.57,51000,2,317950,0,0,0,0,0,0,51000,0,51000,51000
20200316,06100P,台積電日盛97售03,3.78,5.05,3.70,5.05,+1.84,57.32,70000,8,336860,0,0,0,0,0,0,65000,15000,50000,50000
20200316,06101P,聯發科日盛97售03,4.88,5.75,4.88,5.75,+1.39,31.88,11000,2,54550,0,0,0,0,0,0,11000,0,11000,11000
20200316,06102P,智邦凱基97售03,0.88,0.88,0.88,0.88,-0.25,-22.12,60000,1,52800,0,0,0,0,0,0,0,60000,-60000,-60000
20200316,06103P,漢唐凱基97售02,,,,,0.00,0.00,0,0,0,0,0,0,0,0,0,0,0,0,0
20200316,06104P,大立光凱基97售04,,,,,0.00,0.00,0,0,0,0,0,0,0,0,0,0,0,0,0
20200316,06105P,國巨國票98售02,9.70,9.70,9.70,9.70,+1.65,20.5,10000,1,97000,0,0,0,0,0,0,10000,10000,0,0
20200316,06106P,國巨群益97售02,6.95,6.95,6.95,6.95,0.00,0.00,1000,1,6950,0,0,0,0,0,0,1000,0,1000,1000
20200316,06107P,美律群益98售02,,,,,0.00,0.00,0,0,0,0,0,0,0,0,0,0,0,0,0
20200316,06108P,奇力新群益97售05,,,,,0.00,0.00,0,0,0,0,0,0,0,0,0,0,0,0,0
20200316,06109P,華新科群益97售05,,,,,0.00,0.00,0,0,0,0,0,0,0,0,0,0,0,0,0
20200316,06110P,國巨國泰98售02,5.15,5.15,5.15,5.15,+0.41,8.65,1000,1,5150,0,0,0,0,0,0,1000,0,1000,1000
20200316,06111P,上銀兆豐98售01,3.40,3.80,3.40,3.80,+0.78,25.83,14000,2,51600,0,0,0,0,0,0,14000,0,14000,14000
20200316,06112P,台積電兆豐97售01,6.80,8.35,6.80,8.35,-0.70,-7.73,204000,3,1392350,0,0,0,0,0,0,201000,3000,198000,198000
20200316,06113P,台積電群益97售01,8.05,9.70,8.05,9.70,+1.75,22.01,2000,2,17750,0,0,0,0,0,0,2000,0,2000,2000
20200316,06114P,台積電統一97售03,6.45,6.45,6.45,6.45,-0.50,-7.19,15000,1,96750,0,0,0,0,0,0,15000,0,15000,15000
20200316,06115P,台積電統一97售04,,,,,0.00,0.00,0,0,0,0,0,0,0,0,0,0,0,0,0
20200316,06116P,臺股指日盛97售01,,,,,0.00,0.00,0,0,0,0,0,0,0,0,0,0,0,0,0
20200316,06117P,臺股指日盛97售02,,,,,0.00,0.00,0,0,0,0,0,0,0,0,0,0,0,0,0
20200316,06118P,上証2X凱基98售03,3.61,4.03,3.54,4.03,+0.62,18.18,316000,18,1157670,0,0,0,0,0,0,0,298000,-298000,-298000
20200316,06119P,大立光凱基98售04,7.60,7.60,7.60,7.60,+0.30,4.11,2000,1,15200,0,0,0,0,0,0,2000,0,2000,2000
20200316,06120P,大立光凱基98售05,7.60,9.10,7.60,9.10,+0.45,5.2,29000,6,233500,0,0,0,0,0,0,19000,10000,9000,9000
20200316,06121P,同欣電凱基97售02,0.65,0.73,0.65,0.72,+0.08,12.5,347000,8,239410,0,0,0,0,0,0,60000,287000,-227000,-227000
20200316,06122P,亞光元大98售01,,,,,0.00,0.00,0,0,0,0,0,0,0,0,0,0,0,0,0
20200316,06123P,玉晶光元大97售04,1.95,2.16,1.95,2.16,+0.24,12.5,21000,4,43210,0,0,0,0,0,0,10000,21000,-11000,-11000
20200316,06124P,超眾元大97售03,2.12,2.12,2.12,2.12,+0.23,12.17,10000,1,21200,0,0,0,0,0,0,10000,0,10000,10000
20200316,06125P,楠梓電元富99售01,1.06,1.23,1.04,1.23,+0.02,1.65,200000,27,225730,0,0,0,0,0,0,33000,159000,-126000,-126000
20200316,06126P,凌陽元富97售02,,,,,0.00,0.00,0,0,0,0,0,0,0,0,0,0,0,0,0
20200316,06127P,泰碩元富97售01,1.48,1.94,1.28,1.92,+0.45,30.61,924000,72,1445370,0,0,0,0,0,0,321000,639000,-318000,-318000
20200316,06128P,玉晶光元富97售05,3.40,4.02,3.40,3.93,+0.18,4.8,78000,13,278970,0,0,0,0,0,0,26000,52000,-26000,-26000
20200316,06129P,玉晶光元富97售06,4.66,4.73,4.66,4.70,+0.06,1.29,30000,4,140720,0,0,0,0,0,0,6000,24000,-18000,-18000
20200316,06130P,玉晶光元富97售07,2.55,2.69,2.55,2.68,-0.16,-5.63,62000,5,163800,0,0,0,0,0,0,9000,53000,-44000,-44000
20200316,06131P,京鼎元富97售02,2.31,2.36,2.20,2.36,+0.03,1.29,46000,8,106490,0,0,0,0,0,0,16000,22000,-6000,-6000
20200316,06132P,正文元富97售01,1.57,1.97,1.57,1.87,+0.20,11.98,143000,25,253930,0,0,0,0,0,0,38000,105000,-67000,-67000
20200316,06133P,帆宣元富97售02,1.65,2.76,1.65,2.76,+0.30,12.2,222000,17,555980,0,0,0,0,0,0,150000,41000,109000,109000
20200316,06134P,緯穎元富97售03,0.40,0.49,0.40,0.49,+0.06,13.95,682000,71,295270,0,0,0,0,0,0,75000,546000,-471000,-471000
20200316,06135P,志超元富97售01,1.83,1.99,1.83,1.99,+0.03,1.53,11000,2,21730,0,0,0,0,0,0,0,11000,-11000,-11000
20200316,06136P,華新科國泰99售02,,,,,0.00,0.00,0,0,0,0,0,0,0,0,0,0,0,0,0
20200316,06137P,玉晶光永豐97售04,,,,,0.00,0.00,0,0,0,0,0,0,0,0,0,0,0,0,0
20200316,06138P,台積電中信99售01,1.57,1.57,1.57,1.57,-0.12,-7.1,10000,1,15700,0,0,0,0,0,0,10000,0,10000,10000
20200316,06139P,台積電中信99售02,1.41,1.56,1.41,1.56,+0.20,14.71,93000,12,136950,0,0,0,0,0,0,2000,87000,-85000,-85000
20200316,06140P,華新科群益97售06,,,,,0.00,0.00,0,0,0,0,0,0,0,0,0,0,0,0,0
20200316,06141P,大立光日盛97售01,,,,,0.00,0.00,0,0,0,0,0,0,0,0,0,0,0,0,0
20200316,06142P,台虹康和97售02,1.09,1.09,1.09,1.09,-0.09,-7.63,10000,1,10900,0,0,0,0,0,0,0,10000,-10000,-10000
20200316,06143P,鴻海永豐97售02,,,,,0.00,0.00,0,0,0,0,0,0,0,0,0,0,0,0,0
20200316,06144P,台光電永豐97售01,,,,,0.00,0.00,0,0,0,0,0,0,0,0,0,0,0,0,0
20200316,06145P,華新科永豐97售02,,,,,0.00,0.00,0,0,0,0,0,0,0,0,0,0,0,0,0
20200316,06146P,S&P反1元大97售03,0.11,0.13,0.11,0.11,+0.01,10.0,141000,15,17710,0,0,0,0,0,0,0,141000,-141000,-141000
20200316,06147P,國巨元大97售05,2.49,2.85,2.49,2.85,+0.26,10.04,115000,11,308760,0,0,0,0,0,0,60000,85000,-25000,-25000
20200316,06148P,台積電元大97售17,,,,,0.00,0.00,0,0,0,0,0,0,0,0,0,0,0,0,0
20200316,06149P,台積電元大97售18,,,,,0.00,0.00,0,0,0,0,0,0,0,0,0,0,0,0,0
20200316,06150P,奇力新元大97售06,2.04,2.37,2.04,2.37,+0.01,0.42,50000,2,105300,0,0,0,0,0,0,40000,10000,30000,30000
20200316,06151P,華新科元大97售07,2.34,2.77,2.34,2.77,+0.03,1.09,60000,6,159800,0,0,0,0,0,0,50000,60000,-10000,-10000
20200316,06152P,玉晶光元大98售06,2.15,2.50,2.15,2.48,+0.38,18.1,335000,35,803310,0,0,0,0,0,0,13000,332000,-319000,-319000
20200316,06153P,健策元大97售04,1.78,1.97,1.72,1.97,+0.21,11.93,62000,6,112070,0,0,0,0,0,0,47000,42000,5000,5000
20200316,06154P,超眾元大98售01,2.14,2.50,2.14,2.50,+0.37,17.37,321000,24,768860,0,0,0,0,0,0,153000,168000,-15000,-15000
20200316,06155P,智邦統一97售02,2.11,2.21,2.11,2.21,-0.24,-9.8,20000,2,43200,0,0,0,0,0,0,0,20000,-20000,-20000
20200316,06156P,大立光統一97售05,6.30,6.70,6.30,6.60,+0.90,15.79,69000,3,455500,0,0,0,0,0,0,67000,2000,65000,65000
20200316,06157P,聯鈞統一97售02,1.82,2.30,1.79,2.30,+0.45,24.32,35000,4,65500,0,0,0,0,0,0,30000,5000,25000,25000
20200316,06158P,玉晶光元富97售08,4.34,4.34,4.32,4.32,-0.19,-4.21,40000,2,173400,0,0,0,0,0,0,40000,0,40000,40000
20200316,06159P,牧德元富97售02,2.62,2.93,2.62,2.93,+0.44,17.67,175000,16,486560,0,0,0,0,0,0,0,175000,-175000,-175000
20200316,06160P,台達電群益97售01,3.87,4.16,3.87,4.16,+0.03,0.73,38000,6,151630,0,0,0,0,0,0,12000,8000,4000,4000
20200316,06161P,聯發科群益97售03,7.60,8.50,7.60,8.50,+1.50,21.43,4000,4,32450,0,0,0,0,0,0,0,4000,-4000,-4000
20200316,06162P,大立光群益97售02,2.29,3.15,2.24,3.13,+1.02,48.34,1279000,130,3288960,0,0,0,0,0,0,1249000,1249000,0,0
20200316,06163P,聯詠群益97售01,,,,,0.00,0.00,0,0,0,0,0,0,0,0,0,0,0,0,0
20200316,06164P,臺股指凱基97售04,,,,,0.00,0.00,0,0,0,0,0,0,0,0,0,0,0,0,0
20200316,06165P,臺股指凱基9A售03,5.45,6.80,5.45,6.70,+1.73,34.81,1538000,167,9627300,0,0,0,0,0,0,1435000,1534000,-99000,-99000
20200316,06166P,大立光國票98售01,,,,,0.00,0.00,0,0,0,0,0,0,0,0,0,0,0,0,0
20200316,06167P,欣興國票97售05,2.95,3.58,2.95,3.58,0.00,0.00,12000,2,41700,0,0,0,0,0,0,12000,0,12000,12000
20200316,06168P,台表科國票97售06,,,,,0.00,0.00,0,0,0,0,0,0,0,0,0,0,0,0,0
20200316,06169P,華新科元富97售02,4.01,4.76,4.01,4.76,+0.42,9.68,17000,3,71020,0,0,0,0,0,0,7000,10000,-3000,-3000
20200316,06170P,禾伸堂元富97售02,1.47,1.73,1.47,1.73,+0.17,10.9,742000,11,1137920,0,0,0,0,0,0,728000,14000,714000,714000
20200316,06171P,台積電統一97售06,,,,,0.00,0.00,0,0,0,0,0,0,0,0,0,0,0,0,0
20200316,06172P,台虹永豐97售02,,,,,0.00,0.00,0,0,0,0,0,0,0,0,0,0,0,0,0
20200316,06173P,華通元大97售02,2.36,2.80,2.36,2.80,+0.22,8.53,43000,7,108020,0,0,0,0,0,0,39000,24000,15000,15000
20200316,06174P,國巨元大97售07,3.07,3.54,3.07,3.54,+0.36,11.32,84000,8,269360,0,0,0,0,0,0,41000,43000,-2000,-2000
20200316,06175P,台積電元大97售21,8.25,10.80,8.25,10.80,+2.80,35.0,224000,15,2089200,0,0,0,0,0,0,189000,85000,104000,104000
20200316,06176P,台積電元大97售22,9.90,13.20,9.90,13.20,+4.20,46.67,210000,25,2452600,0,0,0,0,0,0,129000,151000,-22000,-22000
20200316,06177P,玉晶光元大98售07,2.38,2.73,2.38,2.73,0.00,0.00,62000,7,166960,0,0,0,0,0,0,10000,52000,-42000,-42000
20200316,06178P,大立光第一99售01,1.79,1.79,1.79,1.79,+0.06,3.47,1000,1,1790,0,0,0,0,0,0,1000,0,1000,1000
20200316,06179P,國巨群益97售04,6.55,6.55,6.55,6.55,+0.10,1.55,1000,1,6550,0,0,0,0,0,0,1000,0,1000,1000
20200316,06180P,禾伸堂群益97售01,,,,,0.00,0.00,0,0,0,0,0,0,0,0,0,0,0,0,0
20200316,06181P,國巨中信97售02,1.32,1.32,1.32,1.32,0.00,0.00,2000,1,2640,0,0,0,0,0,0,2000,0,2000,2000
20200316,06182P,群創兆豐97售03,,,,,0.00,0.00,0,0,0,0,0,0,0,0,0,0,0,0,0
20200316,06183P,大立光元大97售05,2.95,3.84,2.90,3.73,+0.95,34.17,539000,58,1986450,0,0,0,0,0,0,459000,510000,-51000,-51000
20200316,06184P,大立光元大97售06,4.37,5.00,4.37,5.00,+0.70,16.28,37000,7,171420,0,0,0,0,0,0,25000,22000,3000,3000
20200316,06185P,台表科元大97售05,2.95,2.97,2.95,2.97,-0.21,-6.6,30000,3,88800,0,0,0,0,0,0,0,30000,-30000,-30000
20200316,06186P,鴻海統一97售02,,,,,0.00,0.00,0,0,0,0,0,0,0,0,0,0,0,0,0
20200316,06187P,國巨統一97售05,,,,,0.00,0.00,0,0,0,0,0,0,0,0,0,0,0,0,0
20200316,06188P,大立光元富97售01,3.35,3.58,3.35,3.58,-0.19,-5.04,73000,5,254140,0,0,0,0,0,0,0,73000,-73000,-73000
20200316,06189P,華新科永豐97售03,1.83,2.22,1.83,2.22,+0.16,7.77,142000,13,274480,0,0,0,0,0,0,66000,76000,-10000,-10000
20200316,06190P,玉晶光永豐97售05,2.56,2.77,2.56,2.77,+0.43,18.38,40000,4,104500,0,0,0,0,0,0,0,40000,-40000,-40000
20200316,06191P,鴻海群益97售03,,,,,0.00,0.00,0,0,0,0,0,0,0,0,0,0,0,0,0
20200316,06192P,高股息中信98售01,3.53,3.54,3.53,3.54,+0.01,0.28,13000,3,45990,0,0,0,0,0,0,0,13000,-13000,-13000
20200316,06193P,台積電元富97售04,3.06,3.60,3.06,3.60,+0.71,24.57,807000,76,2690540,0,0,0,0,0,0,705000,671000,34000,34000
20200316,06194P,台積電元富97售05,3.81,4.69,3.81,4.42,+1.21,37.69,397000,48,1585890,0,0,0,0,0,0,342000,394000,-52000,-52000
20200316,06195P,台積電元富97售06,1.98,4.00,1.86,4.00,+2.07,107.25,47000,7,107950,0,0,0,0,0,0,36000,30000,6000,6000
20200316,06196P,元上證元大97售01,2.41,2.41,2.41,2.41,+0.27,12.62,10000,1,24100,0,0,0,0,0,0,10000,0,10000,10000
20200316,06197P,國巨元大97售08,1.78,2.09,1.78,2.09,+0.12,6.09,115000,14,227300,0,0,0,0,0,0,35000,100000,-65000,-65000
20200316,06198P,台積電元大98售06,2.87,3.19,2.87,3.19,+0.44,16.0,125000,10,376850,0,0,0,0,0,0,70000,55000,15000,15000
20200316,06199P,聯發科元大97售17,8.45,9.95,8.45,9.95,+2.25,29.22,107000,13,974700,0,0,0,0,0,0,34000,82000,-48000,-48000
20200316,06200P,聯發科元大97售18,9.70,10.30,9.70,10.30,+1.90,22.62,8000,2,78800,0,0,0,0,0,0,6000,2000,4000,4000
20200316,06201P,可成元大97售01,3.38,3.65,3.31,3.62,+0.18,5.23,215000,38,754060,0,0,0,0,0,0,70000,145000,-75000,-75000
20200316,06202P,大立光元大98售06,4.40,4.99,4.40,4.99,-0.56,-10.09,62000,8,295440,0,0,0,0,0,0,40000,52000,-12000,-12000
20200316,06203P,奇力新中信98售02,,,,,0.00,0.00,0,0,0,0,0,0,0,0,0,0,0,0,0
20200316,06204P,鴻海群益97售04,3.43,4.55,3.43,4.31,+0.98,29.43,71000,8,267210,0,0,0,0,0,0,60000,11000,49000,49000
20200316,06205P,台積電群益97售03,,,,,0.00,0.00,0,0,0,0,0,0,0,0,0,0,0,0,0
20200316,06206P,台積電凱基97售11,,,,,0.00,0.00,0,0,0,0,0,0,0,0,0,0,0,0,0
20200316,06207P,聯發科凱基97售07,5.45,6.95,5.45,6.95,+0.55,8.59,6000,2,40200,0,0,0,0,0,0,5000,1000,4000,4000
20200316,06208P,台郡凱基97售03,1.94,1.94,1.94,1.94,-0.22,-10.19,6000,1,11640,0,0,0,0,0,0,0,6000,-6000,-6000
20200316,06209P,旺宏統一97售07,,,,,0.00,0.00,0,0,0,0,0,0,0,0,0,0,0,0,0
20200316,06210P,元油反元大97售01,,,,,0.00,0.00,0,0,0,0,0,0,0,0,0,0,0,0,0
20200316,06211P,鴻海元大98售04,3.80,4.30,3.73,4.30,+0.90,26.47,331000,18,1268340,0,0,0,0,0,0,306000,38000,268000,268000
20200316,06212P,華新科元大97售11,2.82,3.20,2.82,3.20,+0.24,8.11,19000,5,56640,0,0,0,0,0,0,7000,12000,-5000,-5000
20200316,06213P,大立光元大98售07,4.81,5.80,4.81,5.75,+0.75,15.0,41000,10,211070,0,0,0,0,0,0,37000,15000,22000,22000
20200316,06214P,國巨國票98售04,4.36,4.36,4.36,4.36,-0.25,-5.42,20000,1,87200,0,0,0,0,0,0,20000,0,20000,20000
20200316,06215P,康控永豐97售02,,,,,0.00,0.00,0,0,0,0,0,0,0,0,0,0,0,0,0
20200316,06216P,上銀元富97售03,4.37,5.00,4.37,5.00,+1.26,33.69,41000,4,187400,0,0,0,0,0,0,41000,0,41000,41000
20200316,06217P,鴻海元富97售05,4.37,4.63,4.30,4.63,-0.37,-7.4,41000,5,183380,0,0,0,0,0,0,0,41000,-41000,-41000
20200316,06218P,鴻海元富97售06,,,,,0.00,0.00,0,0,0,0,0,0,0,0,0,0,0,0,0
20200316,06219P,國巨元富97售05,1.99,3.09,1.93,3.09,+0.96,45.07,1536000,66,3310640,0,0,0,0,0,0,1059000,1345000,-286000,-286000
20200316,06220P,廣宇元富97售02,4.70,4.88,4.70,4.79,-0.21,-4.2,25000,12,118670,0,0,0,0,0,0,25000,10000,15000,15000
20200316,06222P,致茂元富97售02,1.51,1.82,1.51,1.82,+0.04,2.25,1117000,26,1928440,0,0,0,0,0,0,933000,184000,749000,749000
20200316,06223P,漢唐元富97售02,1.91,2.19,1.84,2.16,+0.23,11.92,128000,13,250560,0,0,0,0,0,0,86000,42000,44000,44000
20200316,06224P,可成元富97售02,2.06,2.22,2.06,2.22,-0.17,-7.11,165000,11,352150,0,0,0,0,0,0,25000,140000,-115000,-115000
20200316,06225P,華新科元富97售04,3.01,3.77,3.01,3.67,+0.20,5.76,39000,9,136030,0,0,0,0,0,0,14000,25000,-11000,-11000
20200316,06226P,聯發科麥證97售03,,,,,0.00,0.00,0,0,0,0,0,0,0,0,0,0,0,0,0
20200316,06227P,大立光群益97售04,,,,,0.00,0.00,0,0,0,0,0,0,0,0,0,0,0,0,0
20200316,06228P,亞德客凱基97售04,1.53,1.53,1.22,1.29,-0.24,-15.69,289000,13,360200,0,0,0,0,0,0,105000,182000,-77000,-77000
20200316,06229P,欣興凱基97售07,2.44,3.23,2.30,3.23,+0.68,26.67,695000,73,1743860,0,0,0,0,0,0,210000,475000,-265000,-265000
20200316,06230P,亞德客永豐97售03,2.15,2.15,2.15,2.15,-0.07,-3.15,1000,1,2150,0,0,0,0,0,0,0,1000,-1000,-1000
20200316,06231P,台積電永豐97售05,,,,,0.00,0.00,0,0,0,0,0,0,0,0,0,0,0,0,0
20200316,06232P,智易永豐97售01,3.00,3.15,3.00,3.15,-0.02,-0.63,38000,4,116480,0,0,0,0,0,0,10000,28000,-18000,-18000
20200316,06233P,訊芯永豐97售03,,,,,0.00,0.00,0,0,0,0,0,0,0,0,0,0,0,0,0
20200316,06234P,亞德客元大97售02,2.10,2.33,2.10,2.33,-0.15,-6.05,55000,7,125060,0,0,0,0,0,0,0,55000,-55000,-55000
20200316,06235P,國巨元大97售12,2.01,2.20,2.01,2.20,+0.25,12.82,64000,10,136340,0,0,0,0,0,0,45000,59000,-14000,-14000
20200316,06236P,台積電元大97售25,,,,,0.00,0.00,0,0,0,0,0,0,0,0,0,0,0,0,0
20200316,06237P,台積電元大97售26,9.10,12.00,9.10,12.00,+3.50,41.18,771000,71,7906750,0,0,0,0,0,0,577000,551000,26000,26000
20200316,06238P,台積電元大98售07,10.20,12.40,10.00,12.40,+1.30,11.71,626000,60,6659100,0,0,0,0,0,0,315000,422000,-107000,-107000
20200316,06239P,奇力新元大97售08,4.59,4.80,4.59,4.80,-0.60,-11.11,8000,2,37770,0,0,0,0,0,0,3000,5000,-2000,-2000
20200316,06240P,奇力新元富97售03,2.13,2.42,2.13,2.42,-0.05,-2.02,73000,9,165220,0,0,0,0,0,0,0,73000,-73000,-73000
20200316,06241P,大立光元富9A售01,3.09,3.64,3.09,3.64,-0.10,-2.67,12000,2,42580,0,0,0,0,0,0,12000,0,12000,12000
20200316,06242P,大立光元富9A售02,,,,,0.00,0.00,0,0,0,0,0,0,0,0,0,0,0,0,0
20200316,06243P,亞光元富97售01,4.57,5.10,4.57,5.10,+0.54,11.84,50000,3,244430,0,0,0,0,0,0,21000,29000,-8000,-8000
20200316,06244P,智易元富97售02,2.05,2.09,2.01,2.09,+0.08,3.98,78000,6,162670,0,0,0,0,0,0,3000,75000,-72000,-72000
20200316,06245P,健策元富97售03,2.07,2.29,2.07,2.29,+0.24,11.71,17000,4,35880,0,0,0,0,0,0,0,17000,-17000,-17000
20200316,06246P,茂林元富97售03,2.44,3.00,2.44,3.00,+0.40,15.38,116000,14,302830,0,0,0,0,0,0,24000,114000,-90000,-90000
20200316,06247P,同欣電元富97售02,3.27,3.81,3.27,3.81,+0.26,7.32,176000,17,609050,0,0,0,0,0,0,41000,135000,-94000,-94000
20200316,06248P,國巨統一97售07,,,,,0.00,0.00,0,0,0,0,0,0,0,0,0,0,0,0,0
20200316,06249P,億光統一97售02,,,,,0.00,0.00,0,0,0,0,0,0,0,0,0,0,0,0,0
20200316,06250P,臺股指永昌97售02,,,,,0.00,0.00,0,0,0,0,0,0,0,0,0,0,0,0,0
20200316,06251P,臺股指永昌97售03,,,,,0.00,0.00,0,0,0,0,0,0,0,0,0,0,0,0,0
20200316,06252P,臺股指兆豐97售02,,,,,0.00,0.00,0,0,0,0,0,0,0,0,0,0,0,0,0
20200316,06253P,臺股指兆豐97售03,,,,,0.00,0.00,0,0,0,0,0,0,0,0,0,0,0,0,0
20200316,06254P,臺股指群益97售07,,,,,0.00,0.00,0,0,0,0,0,0,0,0,0,0,0,0,0
20200316,06255P,臺股指群益97售08,,,,,0.00,0.00,0,0,0,0,0,0,0,0,0,0,0,0,0
20200316,06256P,臺股指群益97售09,,,,,0.00,0.00,0,0,0,0,0,0,0,0,0,0,0,0,0
20200316,06257P,臺股指群益97售10,,,,,0.00,0.00,0,0,0,0,0,0,0,0,0,0,0,0,0
20200316,06258P,臺股指群益97售11,,,,,0.00,0.00,0,0,0,0,0,0,0,0,0,0,0,0,0
20200316,06259P,臺股指群益97售12,,,,,0.00,0.00,0,0,0,0,0,0,0,0,0,0,0,0,0
20200316,06260P,臺股指群益97售13,,,,,0.00,0.00,0,0,0,0,0,0,0,0,0,0,0,0,0
20200316,06261P,上銀凱基97售03,2.24,2.52,2.18,2.52,+0.03,1.2,42000,4,102160,0,0,0,0,0,0,0,42000,-42000,-42000
20200316,06262P,國巨凱基97售07,4.61,5.35,4.50,5.35,+1.05,24.42,402000,12,2040200,0,0,0,0,0,0,300000,402000,-102000,-102000
20200316,06263P,燿華凱基97售04,1.82,2.14,1.82,2.14,+0.40,22.99,42000,3,83160,0,0,0,0,0,0,0,42000,-42000,-42000
20200316,06264P,友達凱基98售06,2.50,2.57,2.50,2.57,+0.12,4.9,165000,2,417050,0,0,0,0,0,0,165000,0,165000,165000
20200316,06265P,美律凱基97售01,1.70,1.82,1.59,1.79,-0.17,-8.67,65000,6,109640,0,0,0,0,0,0,20000,45000,-25000,-25000
20200316,06266P,大立光凱基97售11,,,,,0.00,0.00,0,0,0,0,0,0,0,0,0,0,0,0,0
20200316,06267P,大立光凱基97售12,,,,,0.00,0.00,0,0,0,0,0,0,0,0,0,0,0,0,0
20200316,06268P,聯詠凱基97售02,,,,,0.00,0.00,0,0,0,0,0,0,0,0,0,0,0,0,0
20200316,06269P,群創凱基98售10,,,,,0.00,0.00,0,0,0,0,0,0,0,0,0,0,0,0,0
20200316,06270P,致伸凱基97售03,1.54,1.67,1.54,1.67,-0.25,-13.02,17000,3,27920,0,0,0,0,0,0,0,17000,-17000,-17000
20200316,06271P,彩晶凱基97售01,1.94,1.94,1.94,1.94,-0.19,-8.92,10000,2,19400,0,0,0,0,0,0,0,10000,-10000,-10000
20200316,06272P,台郡凱基97售04,,,,,0.00,0.00,0,0,0,0,0,0,0,0,0,0,0,0,0
20200316,06273P,台表科凱基97售04,2.83,3.25,2.50,3.25,+0.42,14.84,36000,7,98300,0,0,0,0,0,0,0,36000,-36000,-36000
20200316,06274P,臺股指凱基97售06,,,,,0.00,0.00,0,0,0,0,0,0,0,0,0,0,0,0,0
20200316,06275P,臺股指凱基97售07,,,,,0.00,0.00,0,0,0,0,0,0,0,0,0,0,0,0,0
20200316,06276P,臺股指凱基97售08,,,,,0.00,0.00,0,0,0,0,0,0,0,0,0,0,0,0,0
20200316,06277P,臺股指凱基97售09,,,,,0.00,0.00,0,0,0,0,0,0,0,0,0,0,0,0,0
20200316,06278P,臺股指凱基97售10,,,,,0.00,0.00,0,0,0,0,0,0,0,0,0,0,0,0,0
20200316,06279P,臺股指凱基97售11,,,,,0.00,0.00,0,0,0,0,0,0,0,0,0,0,0,0,0
20200316,06280P,臺股指凱基97售12,,,,,0.00,0.00,0,0,0,0,0,0,0,0,0,0,0,0,0
20200316,06281P,臺股指凱基97售13,,,,,0.00,0.00,0,0,0,0,0,0,0,0,0,0,0,0,0
20200316,06282P,聯鈞永豐97售02,,,,,0.00,0.00,0,0,0,0,0,0,0,0,0,0,0,0,0
20200316,06283P,祥碩永豐97售01,1.02,1.02,0.95,0.95,+0.05,5.56,3000,2,2990,0,0,0,0,0,0,1000,2000,-1000,-1000
20200316,06284P,台積電國票98售03,,,,,0.00,0.00,0,0,0,0,0,0,0,0,0,0,0,0,0
20200316,06285P,台積電國票98售04,5.85,6.75,5.85,6.75,+1.20,21.62,10000,3,63300,0,0,0,0,0,0,10000,0,10000,10000
20200316,06286P,世芯國票97售02,2.04,2.57,2.04,2.57,+0.35,15.77,43000,6,103290,0,0,0,0,0,0,37000,0,37000,37000
20200316,06287P,臺股指國票97售01,,,,,0.00,0.00,0,0,0,0,0,0,0,0,0,0,0,0,0
20200316,06288P,臺股指國票97售02,,,,,0.00,0.00,0,0,0,0,0,0,0,0,0,0,0,0,0
20200316,06289P,臺股指國票97售03,,,,,0.00,0.00,0,0,0,0,0,0,0,0,0,0,0,0,0
20200316,06290P,臺股指國票97售04,,,,,0.00,0.00,0,0,0,0,0,0,0,0,0,0,0,0,0
20200316,06291P,臺股指國票97售05,,,,,0.00,0.00,0,0,0,0,0,0,0,0,0,0,0,0,0
20200316,06292P,臺股指國票97售06,,,,,0.00,0.00,0,0,0,0,0,0,0,0,0,0,0,0,0
20200316,06293P,臺股指國票97售07,,,,,0.00,0.00,0,0,0,0,0,0,0,0,0,0,0,0,0
20200316,06294P,臺股指國票97售08,,,,,0.00,0.00,0,0,0,0,0,0,0,0,0,0,0,0,0
20200316,06295P,國巨元大97售14,1.94,2.44,1.94,2.43,+0.43,21.5,506000,58,1072720,0,0,0,0,0,0,53000,493000,-440000,-440000
20200316,06296P,燿華元大98售01,2.20,2.44,2.20,2.44,+0.30,14.02,13000,3,31300,0,0,0,0,0,0,13000,0,13000,13000
20200316,06297P,美律元大97售01,,,,,0.00,0.00,0,0,0,0,0,0,0,0,0,0,0,0,0
20200316,06298P,聯發科元大97售20,8.05,9.15,8.05,9.15,+0.30,3.39,38000,4,321600,0,0,0,0,0,0,28000,20000,8000,8000
20200316,06299P,可成元大97售04,5.70,5.70,5.70,5.70,-0.60,-9.52,2000,1,11400,0,0,0,0,0,0,0,2000,-2000,-2000
20200316,06300P,緯穎元大97售04,1.08,1.15,1.03,1.15,-0.28,-19.58,220000,22,244100,0,0,0,0,0,0,20000,200000,-180000,-180000
20200316,06301P,臺股指元大97售04,,,,,0.00,0.00,0,0,0,0,0,0,0,0,0,0,0,0,0
20200316,06302P,臺股指元大97售06,9.25,9.25,9.25,9.25,0.00,0.00,5000,1,46250,0,0,0,0,0,0,5000,0,5000,5000
20200316,06303P,臺股指元大97售09,,,,,0.00,0.00,0,0,0,0,0,0,0,0,0,0,0,0,0
20200316,06304P,臺股指元大97售10,11.40,11.80,11.40,11.80,0.00,0.00,26000,3,298600,0,0,0,0,0,0,26000,0,26000,26000
20200316,06305P,臺股指元大97售11,9.75,9.75,9.75,9.75,0.00,0.00,14000,1,136500,0,0,0,0,0,0,14000,0,14000,14000
20200316,06306P,臺股指元大97售12,,,,,0.00,0.00,0,0,0,0,0,0,0,0,0,0,0,0,0
20200316,06307P,聚陽元富97售02,1.53,1.73,1.50,1.70,+0.14,8.97,123000,20,192640,0,0,0,0,0,0,8000,115000,-107000,-107000
20200316,06308P,國巨元富97售06,2.95,3.75,2.95,3.75,+0.62,19.81,2203000,43,6794440,0,0,0,0,0,0,2155000,2163000,-8000,-8000
20200316,06309P,光罩元富97售03,2.41,2.53,2.37,2.53,-0.15,-5.6,92000,13,223290,0,0,0,0,0,0,8000,84000,-76000,-76000
20200316,06310P,精元元富97售02,2.29,2.87,2.29,2.82,+0.48,20.51,740000,14,1798190,0,0,0,0,0,0,45000,695000,-650000,-650000
20200316,06311P,嘉聯益元富97售02,1.83,2.19,1.77,2.19,+0.41,23.03,510000,25,1002200,0,0,0,0,0,0,64000,446000,-382000,-382000
20200316,06312P,樺漢元富97售02,2.03,2.38,2.00,2.38,+0.25,11.74,166000,14,371480,0,0,0,0,0,0,65000,141000,-76000,-76000
20200316,06313P,訊芯元富97售01,2.54,2.56,2.54,2.56,-0.10,-3.76,30000,3,76240,0,0,0,0,0,0,30000,30000,0,0
20200316,06314P,GIS元富97售02,1.99,2.11,1.99,2.11,-0.08,-3.65,21000,5,42590,0,0,0,0,0,0,21000,0,21000,21000
20200316,06315P,臺股指元富97售02,,,,,0.00,0.00,0,0,0,0,0,0,0,0,0,0,0,0,0
20200316,06316P,臺股指元富97售03,11.80,11.80,11.80,11.80,0.00,0.00,20000,1,236000,0,0,0,0,0,0,20000,0,20000,20000
20200316,06317P,臺股指元富97售04,,,,,0.00,0.00,0,0,0,0,0,0,0,0,0,0,0,0,0
20200316,06318P,臺股指元富97售05,,,,,0.00,0.00,0,0,0,0,0,0,0,0,0,0,0,0,0
20200316,06319P,臺股指元富97售06,,,,,0.00,0.00,0,0,0,0,0,0,0,0,0,0,0,0,0
20200316,06320P,上銀統一97售04,2.94,2.94,2.94,2.94,-0.03,-1.01,2000,1,5880,0,0,0,0,0,0,2000,0,2000,2000
20200316,06321P,台積電統一98售03,5.05,5.05,5.05,5.05,-1.60,-24.06,10000,1,50500,0,0,0,0,0,0,10000,0,10000,10000
20200316,06322P,超眾統一97售04,,,,,0.00,0.00,0,0,0,0,0,0,0,0,0,0,0,0,0
20200316,06323P,台郡統一97售01,,,,,0.00,0.00,0,0,0,0,0,0,0,0,0,0,0,0,0
20200316,06324P,TXFI0永昌99售02,,,,,0.00,0.00,0,0,0,0,0,0,0,0,0,0,0,0,0
20200316,06325P,TXFI0永昌99售03,,,,,0.00,0.00,0,0,0,0,0,0,0,0,0,0,0,0,0
20200316,06326P,鴻海中信01售01,1.50,1.68,1.50,1.66,+0.20,13.7,104000,11,163030,0,0,0,0,0,0,80000,10000,70000,70000
20200316,06327P,台積電中信01售01,1.86,2.09,1.86,2.09,+0.23,12.37,50000,5,97230,0,0,0,0,0,0,49000,1000,48000,48000
20200316,06328P,台積電中信01售02,1.39,1.55,1.36,1.50,+0.11,7.91,81000,7,117770,0,0,0,0,0,0,50000,0,50000,50000
20200316,06329P,大立光兆豐97售04,,,,,0.00,0.00,0,0,0,0,0,0,0,0,0,0,0,0,0
20200316,06330P,南亞科群益97售03,6.90,6.90,6.90,6.90,-0.90,-11.54,1000,1,6900,0,0,0,0,0,0,0,1000,-1000,-1000
20200316,06331P,南亞科群益97售04,,,,,0.00,0.00,0,0,0,0,0,0,0,0,0,0,0,0,0
20200316,06332P,世紀鋼群益98售01,0.90,1.00,0.90,1.00,+0.01,1.01,214000,25,199460,0,0,0,0,0,0,2000,212000,-210000,-210000
20200316,06333P,臺股指群益9C售02,,,,,0.00,0.00,0,0,0,0,0,0,0,0,0,0,0,0,0
20200316,06334P,臺股指群益9C售03,,,,,0.00,0.00,0,0,0,0,0,0,0,0,0,0,0,0,0
20200316,06335P,台積電麥證97售02,3.56,3.58,3.56,3.58,0.00,0.00,490000,21,1748400,0,490000,-490000,0,0,0,490000,490000,0,0
20200316,06336P,鴻海元大98售05,4.27,4.27,4.27,4.27,+0.01,0.23,10000,1,42700,0,0,0,0,0,0,10000,10000,0,0
20200316,06337P,祥碩元大97售05,1.59,1.88,1.57,1.88,+0.28,17.5,630000,36,1040100,0,0,0,0,0,0,488000,530000,-42000,-42000
20200316,06338P,亞德客統一97售02,2.61,2.76,2.48,2.76,-0.28,-9.21,34000,13,88730,0,0,0,0,0,0,13000,21000,-8000,-8000
20200316,06339P,上銀統一97售06,3.05,3.51,3.05,3.51,+0.52,17.39,16000,3,51020,0,0,0,0,0,0,6000,10000,-4000,-4000
20200316,06340P,鴻海統一98售06,,,,,0.00,0.00,0,0,0,0,0,0,0,0,0,0,0,0,0
20200316,06341P,大立光統一97售08,,,,,0.00,0.00,0,0,0,0,0,0,0,0,0,0,0,0,0
20200316,06342P,世芯統一98售01,1.45,1.61,1.45,1.61,+0.11,7.33,31000,3,45910,0,0,0,0,0,0,24000,6000,18000,18000
20200316,06343P,臺股指統一98售01,,,,,0.00,0.00,0,0,0,0,0,0,0,0,0,0,0,0,0
20200316,06344P,臺股指統一99售03,,,,,0.00,0.00,0,0,0,0,0,0,0,0,0,0,0,0,0
20200316,06345P,臺股指統一9A售01,10.10,10.10,10.10,10.10,-0.50,-4.72,1000,1,10100,0,0,0,0,0,0,1000,0,1000,1000
20200316,06346P,聯鈞元富97售02,0.88,1.01,0.85,1.00,+0.12,13.64,382000,28,355390,0,0,0,0,0,0,8000,370000,-362000,-362000
20200316,06347P,祥碩元富97售02,0.95,1.12,0.95,1.11,+0.16,16.84,551000,37,573170,0,0,0,0,0,0,184000,242000,-58000,-58000
20200316,06348P,鈺齊元富97售02,2.14,2.28,2.14,2.28,0.00,0.00,20000,2,44200,0,0,0,0,0,0,0,20000,-20000,-20000
20200316,06349P,臺股指台新99售01,,,,,0.00,0.00,0,0,0,0,0,0,0,0,0,0,0,0,0
20200316,06350P,臺股指台新99售02,6.00,6.50,6.00,6.50,0.00,0.00,3000,2,19000,0,0,0,0,0,0,3000,0,3000,3000
20200316,06351P,臺股指台新99售03,7.40,7.40,7.40,7.40,0.00,0.00,2000,1,14800,0,0,0,0,0,0,2000,0,2000,2000
20200316,06352P,臺股指富邦99售02,,,,,0.00,0.00,0,0,0,0,0,0,0,0,0,0,0,0,0
20200316,06353P,電子類富邦99售02,2.21,2.21,2.15,2.15,0.00,0.00,20000,2,43600,0,0,0,0,0,0,0,20000,-20000,-20000
20200316,06354P,大立光永豐97售04,4.66,4.66,4.66,4.66,-0.74,-13.7,5000,1,23300,0,0,0,0,0,0,0,5000,-5000,-5000
20200316,06355P,聯茂永豐97售02,,,,,0.00,0.00,0,0,0,0,0,0,0,0,0,0,0,0,0
20200316,06356P,啟碁永豐97售01,,,,,0.00,0.00,0,0,0,0,0,0,0,0,0,0,0,0,0
20200316,06357P,臺股指永豐97售03,,,,,0.00,0.00,0,0,0,0,0,0,0,0,0,0,0,0,0
20200316,06358P,力成中信97售02,1.21,1.40,1.21,1.40,+0.16,12.9,142000,11,187220,0,0,0,0,0,0,142000,0,142000,142000
20200316,06359P,上銀群益97售03,5.20,6.40,5.20,6.40,+1.35,26.73,48000,6,286600,0,0,0,0,0,0,22000,26000,-4000,-4000
20200316,06360P,台積電群益97售05,,,,,0.00,0.00,0,0,0,0,0,0,0,0,0,0,0,0,0
20200316,06361P,聯發科群益97售06,2.90,3.34,2.90,3.34,+0.04,1.21,47000,6,151980,0,0,0,0,0,0,47000,40000,7000,7000
20200316,06362P,臺股指麥證97售01,,,,,0.00,0.00,0,0,0,0,0,0,0,0,0,0,0,0,0
20200316,06363P,臺股指麥證97售02,,,,,0.00,0.00,0,0,0,0,0,0,0,0,0,0,0,0,0
20200316,06364P,鴻海凱基97售08,3.20,3.20,3.20,3.20,+0.47,17.22,20000,1,64000,0,0,0,0,0,0,20000,20000,0,0
20200316,06365P,鴻海凱基97售09,,,,,0.00,0.00,0,0,0,0,0,0,0,0,0,0,0,0,0
20200316,06366P,鴻海凱基97售10,6.50,6.50,6.50,6.50,-0.20,-2.99,20000,1,130000,0,0,0,0,0,0,20000,20000,0,0
20200316,06367P,台積電凱基97售14,3.20,3.20,3.20,3.20,-0.52,-13.98,10000,1,32000,0,0,0,0,0,0,10000,10000,0,0
20200316,06368P,台積電凱基97售15,8.80,9.05,8.80,9.05,+1.05,13.12,410000,41,3693000,0,0,0,0,0,0,410000,410000,0,0
20200316,06369P,台積電凱基97售16,6.75,8.75,6.75,8.75,+2.30,35.66,100000,6,795000,0,0,0,0,0,0,75000,25000,50000,50000
20200316,06370P,貿聯凱基97售03,2.12,2.37,2.12,2.37,+0.29,13.94,137000,6,319560,0,0,0,0,0,0,100000,37000,63000,63000
20200316,06371P,茂林國票98售04,3.41,3.77,3.41,3.77,+0.34,9.91,18000,4,62480,0,0,0,0,0,0,18000,0,18000,18000
20200316,06372P,聯發科元大97售21,6.75,7.55,6.75,7.55,0.00,0.00,34000,6,246200,0,0,0,0,0,0,13000,21000,-8000,-8000
20200316,06373P,聯發科元大97售22,7.10,8.35,7.10,8.35,+2.10,33.6,96000,12,704500,0,0,0,0,0,0,52000,44000,8000,8000
20200316,06374P,台表科元大97售06,3.09,3.16,3.09,3.16,-0.03,-0.94,6000,2,18750,0,0,0,0,0,0,0,6000,-6000,-6000
20200316,06375P,矽力元大97售06,1.52,1.93,1.45,1.93,+0.42,27.81,969000,130,1669750,0,0,0,0,0,0,50000,917000,-867000,-867000
20200316,06376P,上銀統一99售01,4.04,4.04,4.04,4.04,+0.03,0.75,2000,1,8080,0,0,0,0,0,0,0,2000,-2000,-2000
20200316,06377P,華通統一97售04,,,,,0.00,0.00,0,0,0,0,0,0,0,0,0,0,0,0,0
20200316,06378P,國巨統一97售08,4.66,5.50,4.66,5.50,+0.40,7.84,47000,2,252620,0,0,0,0,0,0,47000,0,47000,47000
20200316,06379P,群創統一97售05,2.36,2.63,2.34,2.63,-0.15,-5.4,50000,5,124700,0,0,0,0,0,0,50000,0,50000,50000
20200316,06380P,臺股指統一98售02,,,,,0.00,0.00,0,0,0,0,0,0,0,0,0,0,0,0,0
20200316,06381P,臺股指統一98售03,,,,,0.00,0.00,0,0,0,0,0,0,0,0,0,0,0,0,0
20200316,06382P,大毅元富97售02,1.31,1.64,1.29,1.64,+0.27,19.71,207000,22,291160,0,0,0,0,0,0,176000,31000,145000,145000
20200316,06383P,聯茂元富97售01,1.01,1.14,0.96,1.14,+0.11,10.68,653000,11,691160,0,0,0,0,0,0,499000,653000,-154000,-154000
20200316,06384P,訊芯元富97售03,,,,,0.00,0.00,0,0,0,0,0,0,0,0,0,0,0,0,0
20200316,06385P,聯發科永豐97售02,,,,,0.00,0.00,0,0,0,0,0,0,0,0,0,0,0,0,0
20200316,06386P,欣興永豐97售03,3.98,4.22,3.88,4.22,+0.12,2.93,25000,3,101400,0,0,0,0,0,0,10000,15000,-5000,-5000
20200316,06387P,緯穎永豐97售02,1.42,1.42,1.42,1.42,-0.42,-22.83,5000,1,7100,0,0,0,0,0,0,0,5000,-5000,-5000
20200316,06388P,鴻海兆豐97售04,,,,,0.00,0.00,0,0,0,0,0,0,0,0,0,0,0,0,0
20200316,06389P,聯發科兆豐97售01,3.47,3.47,3.47,3.47,-0.14,-3.88,10000,1,34700,0,0,0,0,0,0,10000,0,10000,10000
20200316,06390P,美律國票97售03,,,,,0.00,0.00,0,0,0,0,0,0,0,0,0,0,0,0,0
20200316,06391P,上銀中信97售03,1.98,2.15,1.98,2.15,+0.14,6.97,11000,2,22630,0,0,0,0,0,0,11000,0,11000,11000
20200316,06392P,T50反1元大9A售01,,,,,0.00,0.00,0,0,0,0,0,0,0,0,0,0,0,0,0
20200316,06393P,台積電元大97售27,7.50,9.40,7.50,9.35,+2.25,31.69,517000,44,4258350,0,0,0,0,0,0,358000,288000,70000,70000
20200316,06394P,台積電元大97售28,8.50,11.40,8.50,11.40,+2.45,27.37,287000,19,2835200,0,0,0,0,0,0,228000,89000,139000,139000
20200316,06395P,台積電元大97售29,10.10,13.60,10.00,13.30,+3.30,33.0,510000,47,5812700,0,0,0,0,0,0,232000,318000,-86000,-86000
20200316,06396P,新日興康和97售01,,,,,0.00,0.00,0,0,0,0,0,0,0,0,0,0,0,0,0
20200316,06397P,T50反1凱基9A售03,,,,,0.00,0.00,0,0,0,0,0,0,0,0,0,0,0,0,0
20200316,06398P,禾伸堂凱基97售02,1.23,1.38,1.21,1.38,+0.04,2.99,48000,6,61290,0,0,0,0,0,0,13000,35000,-22000,-22000
20200316,06399P,台表科凱基97售05,2.78,2.82,2.75,2.82,-0.37,-11.6,24000,3,66860,0,0,0,0,0,0,0,24000,-24000,-24000
20200316,06400P,鴻海元富97售12,9.05,9.20,9.00,9.15,-0.60,-6.15,56000,8,508600,0,0,0,0,0,0,0,56000,-56000,-56000
20200316,06401P,鴻海元富97售13,9.75,10.00,9.70,10.00,+0.10,1.01,32000,4,312000,0,0,0,0,0,0,0,32000,-32000,-32000
20200316,06402P,鴻海元富97售14,9.00,9.00,9.00,9.00,-0.70,-7.22,17000,2,153000,0,0,0,0,0,0,0,17000,-17000,-17000
20200316,06403P,鴻海元富97售15,4.90,5.20,4.87,5.20,+0.20,4.0,40000,4,199100,0,0,0,0,0,0,0,40000,-40000,-40000
20200316,06404P,鴻海元富97售16,9.70,9.70,9.70,9.70,0.00,0.00,10000,1,97000,0,0,0,0,0,0,0,10000,-10000,-10000
20200316,06405P,億光元富97售02,,,,,0.00,0.00,0,0,0,0,0,0,0,0,0,0,0,0,0
20200316,06406P,可成元富97售04,3.91,4.08,3.90,4.08,+0.09,2.26,82000,8,330690,0,0,0,0,0,0,0,82000,-82000,-82000
20200316,06407P,創意元富97售02,3.92,4.21,3.84,4.07,+0.25,6.54,243000,15,952360,0,0,0,0,0,0,36000,207000,-171000,-171000
20200316,06408P,聯茂元富97售02,1.11,1.28,1.10,1.28,+0.13,11.3,117000,6,136670,0,0,0,0,0,0,7000,110000,-103000,-103000
20200316,06409P,康友元富97售03,3.84,4.15,3.83,4.15,+0.49,13.39,40000,4,158900,0,0,0,0,0,0,0,40000,-40000,-40000
20200316,06410P,祥碩統一97售01,1.11,1.30,1.05,1.30,+0.28,27.45,107000,12,130010,0,0,0,0,0,0,57000,20000,37000,37000
20200316,06411P,晶相光永豐97售03,1.66,1.66,1.66,1.66,+0.05,3.11,10000,1,16600,0,0,0,0,0,0,10000,0,10000,10000
20200316,06412P,南亞科日盛97售01,2.36,2.70,2.36,2.70,+0.26,10.66,75000,7,195900,0,0,0,0,0,0,55000,0,55000,55000
20200316,06413P,聯發科凱基97售11,,,,,0.00,0.00,0,0,0,0,0,0,0,0,0,0,0,0,0
20200316,06414P,矽力凱基97售03,1.68,2.17,1.68,2.17,+0.36,19.89,312000,19,605830,0,0,0,0,0,0,3000,309000,-306000,-306000
20200316,06415P,台積電群益97售07,,,,,0.00,0.00,0,0,0,0,0,0,0,0,0,0,0,0,0
20200316,06416P,大立光群益97售06,3.74,5.90,3.74,5.90,+2.36,66.67,72000,9,314360,0,0,0,0,0,0,1000,71000,-70000,-70000
20200316,06417P,台積電兆豐97售03,2.51,2.51,2.51,2.51,-0.24,-8.73,5000,1,12550,0,0,0,0,0,0,0,5000,-5000,-5000
20200316,06418P,T50反1統一9A售02,0.25,0.25,0.16,0.16,-0.09,-36.0,261000,7,47470,0,0,0,0,0,0,0,0,0,0
20200316,06419P,國巨統一97售09,,,,,0.00,0.00,0,0,0,0,0,0,0,0,0,0,0,0,0
20200316,06420P,大立光統一98售06,,,,,0.00,0.00,0,0,0,0,0,0,0,0,0,0,0,0,0
20200316,06421P,嘉澤統一97售02,,,,,0.00,0.00,0,0,0,0,0,0,0,0,0,0,0,0,0
20200316,06422P,勤誠統一98售01,,,,,0.00,0.00,0,0,0,0,0,0,0,0,0,0,0,0,0
20200316,06423P,亞光台新97售01,,,,,0.00,0.00,0,0,0,0,0,0,0,0,0,0,0,0,0
20200316,06424P,大成鋼永豐97售01,,,,,0.00,0.00,0,0,0,0,0,0,0,0,0,0,0,0,0
20200316,06425P,TPK永豐97售02,,,,,0.00,0.00,0,0,0,0,0,0,0,0,0,0,0,0,0
20200316,06426P,T50正2元大9B售01,1.14,1.26,1.14,1.26,+0.15,13.51,362000,38,441830,0,0,0,0,0,0,0,347000,-347000,-347000
20200316,06427P,鴻海元大97售13,4.58,4.82,4.58,4.82,+0.51,11.83,69000,3,318180,0,0,0,0,0,0,50000,9000,41000,41000
20200316,06428P,國巨元大97售17,2.59,2.89,2.53,2.89,+0.17,6.25,102000,13,274020,0,0,0,0,0,0,35000,97000,-62000,-62000
20200316,06429P,大立光元大97售15,,,,,0.00,0.00,0,0,0,0,0,0,0,0,0,0,0,0,0
20200316,06430P,大立光元大97售16,6.35,7.60,6.35,7.60,-0.25,-3.18,20000,4,134250,0,0,0,0,0,0,15000,5000,10000,10000
20200316,06431P,新日興元大97售05,4.14,4.14,4.14,4.14,-0.37,-8.2,1000,1,4140,0,0,0,0,0,0,1000,0,1000,1000
20200316,06432P,上銀群益98售01,,,,,0.00,0.00,0,0,0,0,0,0,0,0,0,0,0,0,0
20200316,06433P,大立光群益99售01,,,,,0.00,0.00,0,0,0,0,0,0,0,0,0,0,0,0,0
20200316,06434P,超眾群益98售02,2.45,2.68,2.45,2.68,+0.24,9.84,100000,10,256500,0,0,0,0,0,0,0,100000,-100000,-100000
20200316,06435P,臺股指群益98售02,,,,,0.00,0.00,0,0,0,0,0,0,0,0,0,0,0,0,0
20200316,06436P,台光電國票98售04,,,,,0.00,0.00,0,0,0,0,0,0,0,0,0,0,0,0,0
20200316,06437P,玉晶光國票99售01,,,,,0.00,0.00,0,0,0,0,0,0,0,0,0,0,0,0,0
20200316,06438P,玉晶光國票99售02,,,,,0.00,0.00,0,0,0,0,0,0,0,0,0,0,0,0,0
20200316,06439P,上銀凱基98售02,2.67,2.75,2.67,2.71,+0.10,3.83,48000,3,130160,0,0,0,0,0,0,20000,48000,-28000,-28000
20200316,06440P,台積電凱基98售07,3.73,4.05,3.73,4.05,+0.26,6.86,11000,2,44230,0,0,0,0,0,0,11000,0,11000,11000
20200316,06441P,台積電凱基98售08,4.52,5.35,4.52,5.35,+1.34,33.42,215000,13,979920,0,0,0,0,0,0,192000,211000,-19000,-19000
20200316,06443P,台積電凱基99售01,12.60,12.60,12.60,12.60,-1.30,-9.35,12000,2,151200,0,0,0,0,0,0,12000,12000,0,0
20200316,06444P,大立光凱基98售08,7.20,7.20,7.20,7.20,+1.20,20.0,50000,1,360000,0,0,0,0,0,0,50000,0,50000,50000
20200316,06445P,大立光凱基98售09,4.22,4.27,4.22,4.27,-0.73,-14.6,86000,4,364920,0,0,0,0,0,0,0,86000,-86000,-86000
20200316,06446P,大立光凱基98售10,,,,,0.00,0.00,0,0,0,0,0,0,0,0,0,0,0,0,0
20200316,06447P,上銀元大98售01,3.77,3.77,3.77,3.77,+0.06,1.62,5000,1,18850,0,0,0,0,0,0,5000,0,5000,5000
20200316,06448P,華通元大99售01,2.48,2.68,2.48,2.68,+0.09,3.47,60000,7,155100,0,0,0,0,0,0,30000,50000,-20000,-20000
20200316,06449P,台積電元大98售09,7.95,8.65,7.95,8.45,+1.50,21.58,25000,4,209650,0,0,0,0,0,0,25000,0,25000,25000
20200316,06450P,聯發科元大98售03,4.87,5.15,4.78,4.92,+0.38,8.37,105000,11,516740,0,0,0,0,0,0,74000,31000,43000,43000
20200316,06451P,聯發科元大98售04,9.20,10.50,9.20,10.50,+0.40,3.96,48000,6,451450,0,0,0,0,0,0,33000,15000,18000,18000
20200316,06452P,大立光元大98售08,,,,,0.00,0.00,0,0,0,0,0,0,0,0,0,0,0,0,0
20200316,06453P,群創元大9B售02,2.57,2.57,2.57,2.57,-0.23,-8.21,1000,1,2570,0,0,0,0,0,0,1000,0,1000,1000
20200316,06454P,緯穎元大98售04,1.10,1.25,1.06,1.25,+0.11,9.65,751000,76,857060,0,0,0,0,0,0,122000,629000,-507000,-507000
20200316,06455P,上銀統一99售03,,,,,0.00,0.00,0,0,0,0,0,0,0,0,0,0,0,0,0
20200316,06456P,聯發科統一98售03,2.62,2.76,2.62,2.76,+0.48,21.05,73000,2,201060,0,0,0,0,0,0,70000,3000,67000,67000
20200316,06457P,玉晶光統一98售02,,,,,0.00,0.00,0,0,0,0,0,0,0,0,0,0,0,0,0
20200316,06458P,玉晶光統一9A售02,,,,,0.00,0.00,0,0,0,0,0,0,0,0,0,0,0,0,0
20200316,06459P,亞德客元富98售01,3.71,3.98,3.63,3.98,-0.21,-5.01,804000,18,3023540,0,0,0,0,0,0,34000,770000,-736000,-736000
20200316,06460P,亞德客元富98售02,3.14,3.17,3.14,3.17,-0.47,-12.91,50000,4,158000,0,0,0,0,0,0,10000,40000,-30000,-30000
20200316,06461P,玉晶光國泰9A售01,3.03,3.27,2.97,3.27,+0.37,12.76,119000,11,362290,0,0,0,0,0,0,10000,109000,-99000,-99000
20200316,06462P,鴻海富邦98售01,,,,,0.00,0.00,0,0,0,0,0,0,0,0,0,0,0,0,0
20200316,06463P,大立光富邦9A售01,,,,,0.00,0.00,0,0,0,0,0,0,0,0,0,0,0,0,0
20200316,06464P,台光電亞東99售01,,,,,0.00,0.00,0,0,0,0,0,0,0,0,0,0,0,0,0
20200316,06465P,國巨統一98售04,,,,,0.00,0.00,0,0,0,0,0,0,0,0,0,0,0,0,0
20200316,06466P,台積電統一9B售01,1.83,1.83,1.80,1.80,-0.19,-9.55,30000,2,54600,0,0,0,0,0,0,30000,0,30000,30000
20200316,06467P,旺宏統一98售01,2.65,2.65,2.65,2.65,-0.34,-11.37,1000,1,2650,0,0,0,0,0,0,1000,0,1000,1000
20200316,06468P,華新科統一98售02,,,,,0.00,0.00,0,0,0,0,0,0,0,0,0,0,0,0,0
20200316,06469P,臺股指凱基99售09,3.81,4.53,3.81,4.41,+0.67,17.91,15000,6,62510,0,0,0,0,0,0,7000,8000,-1000,-1000
20200316,06470P,臺股指凱基99售10,3.92,4.14,3.74,4.14,+0.79,23.58,47000,9,187390,0,0,0,0,0,0,9000,38000,-29000,-29000
20200316,06471P,臺股指凱基99售11,3.10,3.80,3.10,3.80,+0.68,21.79,73000,34,254770,0,0,0,0,0,0,21000,45000,-24000,-24000
20200316,06472P,道瓊銀元大98售03,2.07,2.08,1.99,2.00,+0.36,21.95,80000,5,161700,0,0,0,0,0,0,80000,40000,40000,40000
20200316,06473P,鴻海元大99售03,4.06,4.56,4.06,4.50,-0.34,-7.02,30000,3,131200,0,0,0,0,0,0,20000,30000,-10000,-10000
20200316,06474P,鴻海富邦98售03,1.71,1.71,1.65,1.68,+0.23,15.86,82000,3,138360,0,0,0,0,0,0,2000,82000,-80000,-80000
20200316,06475P,牧德永豐98售03,2.38,3.02,2.38,3.00,+0.27,9.89,75000,8,212450,0,0,0,0,0,0,10000,65000,-55000,-55000
20200316,06476P,臺股指永豐98售01,3.21,3.21,3.21,3.21,-0.16,-4.75,5000,1,16050,0,0,0,0,0,0,5000,0,5000,5000
20200316,06477P,緯穎國票99售02,1.35,1.35,1.35,1.35,+0.02,1.5,1000,1,1350,0,0,0,0,0,0,0,1000,-1000,-1000
20200316,06478P,臺股指日盛9A售01,,,,,0.00,0.00,0,0,0,0,0,0,0,0,0,0,0,0,0
20200316,06479P,聯發科中信99售02,0.96,1.05,0.94,1.05,+0.13,14.13,98000,23,97740,0,0,0,0,0,0,6000,92000,-86000,-86000
20200316,06480P,上銀凱基98售04,,,,,0.00,0.00,0,0,0,0,0,0,0,0,0,0,0,0,0
20200316,06481P,台積電凱基98售12,6.95,7.20,6.95,7.20,+0.50,7.46,100000,2,707500,0,0,0,0,0,0,100000,100000,0,0
20200316,06482P,台積電凱基98售13,3.14,4.13,3.14,4.13,+1.25,43.4,206000,12,728240,0,0,0,0,0,0,106000,100000,6000,6000
20200316,06483P,聯發科凱基98售10,4.84,4.84,4.84,4.84,-0.41,-7.81,2000,1,9680,0,0,0,0,0,0,2000,0,2000,2000
20200316,06484P,聯發科凱基98售11,,,,,0.00,0.00,0,0,0,0,0,0,0,0,0,0,0,0,0
20200316,06485P,玉晶光群益9A售02,,,,,0.00,0.00,0,0,0,0,0,0,0,0,0,0,0,0,0
20200316,06486P,麗豐元大98售02,1.57,1.68,1.56,1.67,-0.02,-1.18,131000,17,210780,0,0,0,0,0,0,52000,79000,-27000,-27000
20200316,06487P,聯發科統一99售02,,,,,0.00,0.00,0,0,0,0,0,0,0,0,0,0,0,0,0
20200316,06488P,台積電元富98售05,3.26,4.52,3.26,4.52,+1.26,38.65,791000,66,3128110,0,0,0,0,0,0,680000,571000,109000,109000
20200316,06489P,台積電元富98售06,2.65,2.87,2.65,2.87,+0.95,49.48,130000,6,349700,0,0,0,0,0,0,90000,40000,50000,50000
20200316,06490P,鴻海富邦99售02,1.13,1.33,1.13,1.33,+0.22,19.82,470000,20,612130,0,0,0,0,0,0,385000,265000,120000,120000
20200316,06491P,台積電富邦99售02,1.45,1.46,1.45,1.46,-0.06,-3.95,12000,2,17420,0,0,0,0,0,0,0,12000,-12000,-12000
20200316,06492P,上銀永豐98售01,,,,,0.00,0.00,0,0,0,0,0,0,0,0,0,0,0,0,0
20200316,06493P,聯發科永豐98售02,2.18,2.69,2.18,2.44,+0.42,20.79,60000,4,142620,0,0,0,0,0,0,25000,35000,-10000,-10000
20200316,06494P,鴻海永昌98售03,4.43,4.43,4.43,4.43,+0.01,0.23,6000,1,26580,0,0,0,0,0,0,0,6000,-6000,-6000
20200316,06495P,華新科亞東9A售01,3.91,3.91,3.82,3.82,0.00,0.00,70000,2,268300,0,0,0,0,0,0,60000,70000,-10000,-10000
20200316,06496P,台灣50日盛98售01,5.15,7.00,5.15,7.00,+2.00,40.0,107000,24,674050,0,0,0,0,0,0,56000,0,56000,56000
20200316,06497P,大立光凱基98售11,,,,,0.00,0.00,0,0,0,0,0,0,0,0,0,0,0,0,0
20200316,06498P,臺股指元大9A售03,6.65,8.00,6.65,8.00,+1.35,20.3,57000,8,411450,0,0,0,0,0,0,27000,30000,-3000,-3000
20200316,06499P,臺股指元大9A售04,,,,,0.00,0.00,0,0,0,0,0,0,0,0,0,0,0,0,0
20200316,06500P,臺股指元大9A售05,5.55,5.55,5.55,5.55,+0.05,0.91,1000,1,5550,0,0,0,0,0,0,1000,0,1000,1000
20200316,06501P,臺股指元大9A售06,6.35,6.35,6.35,6.35,0.00,0.00,30000,1,190500,0,0,0,0,0,0,30000,0,30000,30000
20200316,06502P,A50中信98售01,0.78,0.78,0.78,0.78,+0.08,11.43,30000,1,23400,0,0,0,0,0,0,0,30000,-30000,-30000
20200316,06503P,臺股指中信9A售02,1.74,2.02,1.73,2.02,+0.30,17.44,324000,41,611310,0,0,0,0,0,0,12000,241000,-229000,-229000
20200316,06504P,麗豐國票99售02,,,,,0.00,0.00,0,0,0,0,0,0,0,0,0,0,0,0,0
20200316,06505P,康控國票99售02,3.19,3.61,3.19,3.61,+0.31,9.39,147000,3,506860,0,0,0,0,0,0,147000,0,147000,147000
20200316,06506P,台郡國票99售02,1.07,1.07,1.07,1.07,-0.01,-0.93,9000,1,9630,0,0,0,0,0,0,9000,0,9000,9000
20200316,06507P,台表科國票99售01,1.77,1.77,1.69,1.69,-0.18,-9.63,20000,2,34600,0,0,0,0,0,0,0,20000,-20000,-20000
20200316,06508P,台灣50統一98售01,2.10,3.60,2.10,3.60,+1.00,38.46,124000,12,303560,0,0,0,0,0,0,57000,0,57000,57000
20200316,06509P,鴻海群益98售03,4.03,4.03,4.03,4.03,-0.12,-2.89,5000,1,20150,0,0,0,0,0,0,5000,0,5000,5000
20200316,06510P,燿華永豐98售03,2.67,3.04,2.65,3.04,+0.40,15.15,30000,4,81650,0,0,0,0,0,0,5000,25000,-20000,-20000
20200316,06511P,元油2X中信9B售01,,,,,0.00,0.00,0,0,0,0,0,0,0,0,0,0,0,0,0
20200316,06512P,元油2X凱基9B售01,,,,,0.00,0.00,0,0,0,0,0,0,0,0,0,0,0,0,0
20200316,06513P,鴻海凱基98售10,2.01,2.30,1.99,2.30,+0.40,21.05,76000,7,163180,0,0,0,0,0,0,56000,46000,10000,10000
20200316,06514P,國巨凱基98售05,2.87,3.63,2.86,3.63,+0.43,13.44,283000,24,915520,0,0,0,0,0,0,55000,228000,-173000,-173000
20200316,06515P,國巨凱基98售06,3.45,3.79,3.39,3.78,0.00,0.00,157000,8,591940,0,0,0,0,0,0,150000,157000,-7000,-7000
20200316,06516P,國巨凱基98售08,2.39,2.67,2.39,2.67,+0.37,16.09,26000,4,63220,0,0,0,0,0,0,22000,4000,18000,18000
20200316,06517P,國巨凱基98售09,3.43,3.43,3.42,3.42,+0.47,15.93,60000,4,205650,0,0,0,0,0,0,60000,60000,0,0
20200316,06518P,奇力新兆豐99售01,,,,,0.00,0.00,0,0,0,0,0,0,0,0,0,0,0,0,0
20200316,06519P,元油2X元大98售03,,,,,0.00,0.00,0,0,0,0,0,0,0,0,0,0,0,0,0
20200316,06520P,元油2X元大98售04,,,,,0.00,0.00,0,0,0,0,0,0,0,0,0,0,0,0,0
20200316,06521P,矽力元大98售01,3.11,3.83,3.11,3.73,+0.50,15.48,352000,44,1234660,0,0,0,0,0,0,12000,302000,-290000,-290000
20200316,06522P,元油2X群益9B售03,4.93,4.93,4.93,4.93,0.00,0.00,10000,1,49300,0,0,0,0,0,0,10000,10000,0,0
20200316,06523P,台積電麥證98售02,,,,,0.00,0.00,0,0,0,0,0,0,0,0,0,0,0,0,0
20200316,06524P,臺股指麥證98售02,7.55,8.20,7.55,8.10,+1.00,14.08,5000,4,40150,5000,0,5000,0,0,0,5000,0,5000,5000
20200316,06525P,上証2X國泰99售01,1.63,1.78,1.63,1.70,+0.11,6.92,100000,4,168760,0,0,0,0,0,0,98000,2000,96000,96000
20200316,06526P,元油2X永豐98售03,,,,,0.00,0.00,0,0,0,0,0,0,0,0,0,0,0,0,0
20200316,06527P,T50正2富邦9C售01,,,,,0.00,0.00,0,0,0,0,0,0,0,0,0,0,0,0,0
20200316,06528P,台積電富邦99售03,1.21,1.48,1.09,1.48,+0.02,1.37,53000,11,66970,0,0,0,0,0,0,10000,37000,-27000,-27000
20200316,06529P,貿聯富邦99售03,1.46,1.63,1.46,1.63,+0.13,8.67,561000,8,876550,0,0,0,0,0,0,60000,501000,-441000,-441000
20200316,06530P,元油2X元富98售13,,,,,0.00,0.00,0,0,0,0,0,0,0,0,0,0,0,0,0
20200316,06531P,元油2X元富98售14,,,,,0.00,0.00,0,0,0,0,0,0,0,0,0,0,0,0,0
20200316,06532P,友達元富98售04,2.57,2.57,2.57,2.57,-0.23,-8.21,5000,1,12850,0,0,0,0,0,0,0,5000,-5000,-5000
20200316,06533P,上証2X中信9B售01,1.00,1.14,1.00,1.14,+0.05,4.59,278000,17,299780,0,0,0,0,0,0,92000,186000,-94000,-94000
20200316,06534P,聯發科群益98售04,3.09,3.09,3.09,3.09,+0.64,26.12,10000,1,30900,0,0,0,0,0,0,0,10000,-10000,-10000
20200316,06535P,可成群益99售02,,,,,0.00,0.00,0,0,0,0,0,0,0,0,0,0,0,0,0
20200316,06536P,臺股指群益98售04,10.40,11.00,10.40,11.00,+2.10,23.6,10000,5,106400,0,0,0,0,0,0,10000,0,10000,10000
20200316,06537P,華通凱基98售04,2.53,2.94,2.53,2.94,+0.30,11.36,111000,14,286060,0,0,0,0,0,0,0,111000,-111000,-111000
20200316,06538P,國巨凱基98售11,3.37,4.22,3.34,4.22,+1.00,31.06,125000,22,459510,0,0,0,0,0,0,0,125000,-125000,-125000
20200316,06539P,聯發科凱基98售12,2.83,3.35,2.83,3.35,+0.66,24.54,27000,7,83170,0,0,0,0,0,0,20000,7000,13000,13000
20200316,06540P,聯發科凱基98售13,5.15,5.90,5.15,5.90,-0.25,-4.07,13000,3,71100,0,0,0,0,0,0,5000,8000,-3000,-3000
20200316,06541P,元油2X國票9A售02,,,,,0.00,0.00,0,0,0,0,0,0,0,0,0,0,0,0,0
20200316,06542P,台光電國票98售05,,,,,0.00,0.00,0,0,0,0,0,0,0,0,0,0,0,0,0
20200316,06543P,鴻海元大98售08,4.29,4.68,4.16,4.68,+0.89,23.48,136000,15,613440,0,0,0,0,0,0,136000,131000,5000,5000
20200316,06544P,鴻海元大98售09,,,,,0.00,0.00,0,0,0,0,0,0,0,0,0,0,0,0,0
20200316,06545P,致茂元大98售01,3.67,4.38,3.67,4.38,-0.18,-3.95,21000,4,82120,0,0,0,0,0,0,10000,11000,-1000,-1000
20200316,06546P,聯發科元大98售05,5.15,5.70,5.05,5.70,-0.05,-0.87,83000,8,443150,0,0,0,0,0,0,43000,40000,3000,3000
20200316,06547P,大立光元大98售09,6.00,6.00,6.00,6.00,-1.35,-18.37,10000,2,60000,0,0,0,0,0,0,10000,0,10000,10000
20200316,06548P,大立光元大98售10,,,,,0.00,0.00,0,0,0,0,0,0,0,0,0,0,0,0,0
20200316,06549P,大立光元大98售11,3.87,3.87,3.87,3.87,-0.05,-1.28,10000,2,38700,0,0,0,0,0,0,10000,0,10000,10000
20200316,06550P,健策元大99售01,1.80,1.99,1.77,1.99,+0.21,11.8,357000,35,660190,0,0,0,0,0,0,285000,337000,-52000,-52000
20200316,06551P,貿聯元大98售05,3.67,3.90,3.67,3.90,+0.07,1.83,33000,6,127250,0,0,0,0,0,0,23000,10000,13000,13000
20200316,06552P,茂林元大99售02,2.39,2.76,2.37,2.76,+0.39,16.46,329000,22,804670,0,0,0,0,0,0,264000,65000,199000,199000
20200316,06553P,訊芯元大98售05,,,,,0.00,0.00,0,0,0,0,0,0,0,0,0,0,0,0,0
20200316,06554P,臺股指元大99售06,6.60,7.85,6.60,7.85,+1.40,21.71,550000,71,3941150,0,0,0,0,0,0,403000,518000,-115000,-115000
20200316,06555P,臺股指元大99售07,7.90,8.80,7.90,8.80,+1.20,15.79,138000,20,1159500,0,0,0,0,0,0,4000,134000,-130000,-130000
20200316,06556P,臺股指元大99售08,9.70,10.30,9.55,10.30,-0.90,-8.04,50000,13,492400,0,0,0,0,0,0,0,50000,-50000,-50000
20200316,06557P,台積電兆豐98售02,2.39,3.28,2.31,3.22,+0.97,43.11,2444000,40,6575500,0,0,0,0,0,0,2300000,2284000,16000,16000
20200316,06558P,旺宏元富98售02,7.75,7.75,7.75,7.75,+0.20,2.65,9000,1,69750,0,0,0,0,0,0,0,9000,-9000,-9000
20200316,06559P,玉晶光元富98售02,3.93,3.93,3.93,3.93,-0.15,-3.68,1000,1,3930,0,0,0,0,0,0,0,1000,-1000,-1000
20200316,06560P,台積電統一98售07,2.67,2.76,2.67,2.76,+0.36,15.0,4000,2,10860,0,0,0,0,0,0,0,4000,-4000,-4000
20200316,06561P,台灣50國泰9A售01,,,,,0.00,0.00,0,0,0,0,0,0,0,0,0,0,0,0,0
20200316,06562P,台積電國泰99售02,,,,,0.00,0.00,0,0,0,0,0,0,0,0,0,0,0,0,0
20200316,06563P,元油2X富邦02售02,,,,,0.00,0.00,0,0,0,0,0,0,0,0,0,0,0,0,0
20200316,06564P,國巨富邦9A售04,1.30,1.45,1.30,1.45,+0.20,16.0,110000,15,156480,0,0,0,0,0,0,0,109000,-109000,-109000
20200316,06565P,元油2X永豐9A售01,,,,,0.00,0.00,0,0,0,0,0,0,0,0,0,0,0,0,0
20200316,06566P,華通永豐98售03,2.41,2.81,2.36,2.81,+0.23,8.91,87000,12,223400,0,0,0,0,0,0,62000,85000,-23000,-23000
20200316,06567P,鴻海永豐98售02,,,,,0.00,0.00,0,0,0,0,0,0,0,0,0,0,0,0,0
20200316,06568P,國巨永豐98售05,2.70,2.70,2.70,2.70,+0.20,8.0,10000,1,27000,0,0,0,0,0,0,10000,0,10000,10000
20200316,06569P,可成永豐98售01,1.96,2.16,1.96,2.16,+0.15,7.46,280000,38,577030,0,0,0,0,0,0,19000,257000,-238000,-238000
20200316,06570P,大立光永豐98售01,,,,,0.00,0.00,0,0,0,0,0,0,0,0,0,0,0,0,0
20200316,06571P,欣興永豐98售03,1.82,2.37,1.82,2.37,+0.35,17.33,81000,10,164620,0,0,0,0,0,0,10000,81000,-71000,-71000
20200316,06572P,台積電永昌99售01,2.59,3.50,2.59,3.40,+0.81,31.27,168000,9,506180,0,0,0,0,0,0,159000,10000,149000,149000
20200316,06573P,台積電永昌99售02,1.62,2.14,1.62,2.12,+0.49,30.06,116000,9,223900,0,0,0,0,0,0,94000,40000,54000,54000
20200316,06574P,大立光永昌99售01,,,,,0.00,0.00,0,0,0,0,0,0,0,0,0,0,0,0,0
20200316,06575P,大立光永昌99售02,,,,,0.00,0.00,0,0,0,0,0,0,0,0,0,0,0,0,0
20200316,06576P,台光電群益98售03,2.59,2.59,2.59,2.59,-0.12,-4.43,3000,1,7770,0,0,0,0,0,0,0,3000,-3000,-3000
20200316,06577P,聯發科日盛9A售02,3.38,3.61,3.25,3.61,+0.48,15.34,21000,4,71460,0,0,0,0,0,0,21000,0,21000,21000
20200316,06578P,華新科國票98售02,7.40,7.40,7.40,7.40,-0.80,-9.76,1000,1,7400,0,0,0,0,0,0,0,1000,-1000,-1000
20200316,06579P,臺股指麥證98售03,4.65,5.30,4.65,5.30,-1.95,-26.9,16000,3,81300,16000,0,16000,0,0,0,16000,0,16000,16000
20200316,06580P,元油2X凱基9A售06,,,,,0.00,0.00,0,0,0,0,0,0,0,0,0,0,0,0,0
20200316,06581P,南亞科凱基98售04,3.74,4.44,3.73,4.44,+0.79,21.64,127000,21,507880,0,0,0,0,0,0,23000,104000,-81000,-81000
20200316,06582P,可成凱基98售06,3.08,3.08,3.08,3.08,-0.40,-11.49,5000,1,15400,0,0,0,0,0,0,0,5000,-5000,-5000
20200316,06583P,可成凱基98售07,3.36,3.36,3.36,3.36,-0.75,-18.25,10000,1,33600,0,0,0,0,0,0,0,10000,-10000,-10000
20200316,06584P,欣興凱基98售03,1.87,2.22,1.87,2.22,+0.24,12.12,53000,6,110610,0,0,0,0,0,0,28000,53000,-25000,-25000
20200316,06585P,鴻海元大99售04,4.34,4.34,4.34,4.34,0.00,0.00,9000,1,39060,0,0,0,0,0,0,9000,9000,0,0
20200316,06586P,鴻海元大9C售01,4.33,4.62,4.29,4.62,0.00,0.00,60000,6,266900,0,0,0,0,0,0,60000,60000,0,0
20200316,06587P,國巨元大98售13,5.40,6.30,5.40,6.25,+0.25,4.17,167000,7,1016650,0,0,0,0,0,0,167000,30000,137000,137000
20200316,06588P,台積電元大98售11,6.60,8.35,6.60,8.35,+1.55,22.79,272000,24,1967700,0,0,0,0,0,0,140000,182000,-42000,-42000
20200316,06589P,台積電元大98售12,5.95,7.15,5.95,7.15,+1.45,25.44,394000,37,2546850,0,0,0,0,0,0,123000,321000,-198000,-198000
20200316,06590P,大立光元大98售13,4.16,4.16,4.16,4.16,-0.94,-18.43,10000,2,41600,0,0,0,0,0,0,10000,0,10000,10000
20200316,06591P,大立光元大98售14,4.27,4.27,4.27,4.27,0.00,0.00,10000,1,42700,0,0,0,0,0,0,10000,10000,0,0
20200316,06592P,欣興元大98售04,5.35,5.35,5.35,5.35,0.00,0.00,10000,1,53500,0,0,0,0,0,0,10000,10000,0,0
20200316,06593P,欣興元大98售05,3.77,4.31,3.77,4.31,+0.49,12.83,23000,3,95210,0,0,0,0,0,0,10000,23000,-13000,-13000
20200316,06594P,立積元大98售01,2.09,2.61,2.09,2.61,+0.40,18.1,244000,23,548840,0,0,0,0,0,0,150000,202000,-52000,-52000
20200316,06595P,祥碩元大98售03,2.80,3.12,2.77,3.12,+0.35,12.64,246000,26,721230,0,0,0,0,0,0,50000,246000,-196000,-196000
20200316,06596P,元油2X富邦02售03,,,,,0.00,0.00,0,0,0,0,0,0,0,0,0,0,0,0,0
20200316,06597P,國巨富邦9A售05,1.76,1.96,1.76,1.96,+0.04,2.08,72000,4,139440,0,0,0,0,0,0,72000,0,72000,72000
20200316,06598P,奇力新永豐98售02,,,,,0.00,0.00,0,0,0,0,0,0,0,0,0,0,0,0,0
20200316,06599P,宏達電永豐98售02,,,,,0.00,0.00,0,0,0,0,0,0,0,0,0,0,0,0,0
20200316,06600P,貿聯永豐98售01,2.09,2.44,2.06,2.44,+0.14,6.09,6000,5,13730,0,0,0,0,0,0,2000,4000,-2000,-2000
20200316,06601P,臺股指永豐98售04,,,,,0.00,0.00,0,0,0,0,0,0,0,0,0,0,0,0,0
20200316,06602P,國巨統一99售02,2.46,2.46,2.46,2.46,+0.04,1.65,1000,1,2460,0,0,0,0,0,0,0,1000,-1000,-1000
20200316,06603P,立積統一99售01,,,,,0.00,0.00,0,0,0,0,0,0,0,0,0,0,0,0,0
20200316,06604P,聯發科元富02售02,2.06,2.32,2.06,2.32,+0.30,14.85,152000,12,334200,0,0,0,0,0,0,72000,150000,-78000,-78000
20200316,06605P,玉晶光元富98售03,3.83,3.86,3.83,3.86,-0.19,-4.69,20000,2,76900,0,0,0,0,0,0,0,20000,-20000,-20000
20200316,06606P,訊芯元富98售02,2.50,2.91,2.50,2.85,+0.10,3.64,787000,18,2116410,0,0,0,0,0,0,765000,771000,-6000,-6000
20200316,06607P,友達台新98售02,,,,,0.00,0.00,0,0,0,0,0,0,0,0,0,0,0,0,0
20200316,06608P,立積群益99售02,1.40,1.60,1.38,1.60,+0.19,13.48,47000,8,72180,0,0,0,0,0,0,0,47000,-47000,-47000
20200316,06609P,元油2X凱基9B售06,,,,,0.00,0.00,0,0,0,0,0,0,0,0,0,0,0,0,0
20200316,06610P,台積電凱基9A售03,3.70,4.42,3.70,4.42,-0.17,-3.7,14000,2,56120,0,0,0,0,0,0,8000,6000,2000,2000
20200316,06611P,祥碩國票98售01,,,,,0.00,0.00,0,0,0,0,0,0,0,0,0,0,0,0,0
20200316,06612P,元油2X富邦9B售03,,,,,0.00,0.00,0,0,0,0,0,0,0,0,0,0,0,0,0
20200316,06613P,華新科富邦9A售03,1.61,1.73,1.61,1.73,0.00,0.00,21000,3,35130,0,0,0,0,0,0,10000,11000,-1000,-1000
20200316,06614P,祥碩永豐98售03,1.51,1.67,1.48,1.67,+0.17,11.33,84000,8,135550,0,0,0,0,0,0,0,74000,-74000,-74000
20200316,06615P,鴻海元大9C售02,3.45,3.94,3.45,3.94,+0.30,8.24,296000,21,1118050,0,0,0,0,0,0,229000,139000,90000,90000
20200316,06616P,國巨元大98售15,4.91,5.70,4.91,5.70,+0.45,8.57,41000,5,225410,0,0,0,0,0,0,41000,40000,1000,1000
20200316,06617P,智邦元大98售03,1.46,1.58,1.42,1.58,+0.14,9.72,465000,41,695220,0,0,0,0,0,0,272000,455000,-183000,-183000
20200316,06618P,智邦元大98售04,1.30,1.30,1.27,1.27,-0.27,-17.53,29000,4,37160,0,0,0,0,0,0,16000,13000,3000,3000
20200316,06619P,聯發科元大98售06,4.37,5.05,4.37,5.05,+1.11,28.17,67000,8,305940,0,0,0,0,0,0,50000,47000,3000,3000
20200316,06620P,聯發科元大98售07,4.71,4.71,4.71,4.71,-0.34,-6.73,20000,1,94200,0,0,0,0,0,0,20000,0,20000,20000
20200316,06621P,欣興元大98售06,4.91,5.60,4.91,5.60,0.00,0.00,12000,2,65820,0,0,0,0,0,0,10000,12000,-2000,-2000
20200316,06622P,牧德元大98售01,2.02,2.02,2.02,2.02,+0.08,4.12,30000,3,60600,0,0,0,0,0,0,30000,30000,0,0
20200316,06623P,立積元大98售04,2.88,3.45,2.88,3.44,+0.52,17.81,145000,14,473640,0,0,0,0,0,0,61000,134000,-73000,-73000
20200316,06624P,訊芯元大98售06,2.33,2.46,2.33,2.46,0.00,0.00,7000,3,16570,0,0,0,0,0,0,2000,5000,-3000,-3000
20200316,06625P,華新科統一98售03,,,,,0.00,0.00,0,0,0,0,0,0,0,0,0,0,0,0,0
20200316,06626P,大立光統一9A售01,,,,,0.00,0.00,0,0,0,0,0,0,0,0,0,0,0,0,0
20200316,06627P,華新科元富99售01,2.89,2.89,2.89,2.89,-0.18,-5.86,5000,1,14450,0,0,0,0,0,0,0,5000,-5000,-5000
20200316,06628P,訊芯元富98售03,1.71,1.71,1.71,1.71,0.00,0.00,1000,1,1710,0,0,0,0,0,0,1000,0,1000,1000
20200316,06629P,台灣50第一98售01,,,,,0.00,0.00,0,0,0,0,0,0,0,0,0,0,0,0,0
20200316,06630P,國巨群益98售08,,,,,0.00,0.00,0,0,0,0,0,0,0,0,0,0,0,0,0
20200316,06631P,玉晶光群益9A售03,,,,,0.00,0.00,0,0,0,0,0,0,0,0,0,0,0,0,0
20200316,06632P,創意群益98售03,4.17,4.17,4.17,4.17,+0.09,2.21,3000,1,12510,0,0,0,0,0,0,3000,0,3000,3000
20200316,06633P,國巨國票99售01,,,,,0.00,0.00,0,0,0,0,0,0,0,0,0,0,0,0,0
20200316,06634P,欣興國票98售02,,,,,0.00,0.00,0,0,0,0,0,0,0,0,0,0,0,0,0
20200316,06635P,聯發科凱基98售15,,,,,0.00,0.00,0,0,0,0,0,0,0,0,0,0,0,0,0
20200316,06636P,可成凱基98售08,2.98,3.16,2.98,3.16,-0.35,-9.97,103000,3,317120,0,0,0,0,0,0,100000,103000,-3000,-3000
20200316,06637P,大立光凱基98售15,3.50,4.61,3.50,4.61,+0.37,8.73,59000,9,228310,0,0,0,0,0,0,15000,50000,-35000,-35000
20200316,06638P,鴻海統一99售02,,,,,0.00,0.00,0,0,0,0,0,0,0,0,0,0,0,0,0
20200316,06639P,訊芯元富98售04,,,,,0.00,0.00,0,0,0,0,0,0,0,0,0,0,0,0,0
20200316,06640P,國巨兆豐99售02,1.68,2.21,1.68,2.21,-0.03,-1.34,53000,6,103470,0,0,0,0,0,0,52000,0,52000,52000
20200316,06641P,智邦兆豐99售01,1.04,1.13,1.03,1.13,-0.06,-5.04,85000,4,89750,0,0,0,0,0,0,20000,65000,-45000,-45000
20200316,06642P,可成兆豐98售01,1.71,1.71,1.64,1.65,-0.27,-14.06,103000,9,174800,0,0,0,0,0,0,3000,100000,-97000,-97000
20200316,06643P,大立光兆豐98售01,,,,,0.00,0.00,0,0,0,0,0,0,0,0,0,0,0,0,0
20200316,06644P,亞德客元大98售03,3.59,3.91,3.48,3.91,-0.14,-3.46,135000,19,508130,0,0,0,0,0,0,10000,135000,-125000,-125000
20200316,06645P,上銀元大98售05,3.44,3.59,3.44,3.59,+0.46,14.7,12000,3,42330,0,0,0,0,0,0,5000,7000,-2000,-2000
20200316,06646P,國巨元大98售16,3.87,4.33,3.79,4.33,+0.29,7.18,166000,20,665550,0,0,0,0,0,0,135000,151000,-16000,-16000
20200316,06647P,台積電元大98售13,5.80,6.85,5.75,6.85,+0.90,15.13,288000,18,1808950,0,0,0,0,0,0,207000,120000,87000,87000
20200316,06648P,華邦電元大98售03,2.17,2.79,2.17,2.78,+0.35,14.4,101000,14,256170,0,0,0,0,0,0,15000,81000,-66000,-66000
20200316,06649P,聯發科元大98售08,3.91,4.54,3.82,4.54,+0.89,24.38,141000,17,571800,0,0,0,0,0,0,106000,75000,31000,31000
20200316,06650P,聯發科元大98售09,2.68,3.17,2.62,3.17,+0.44,16.12,155000,21,432160,0,0,0,0,0,0,114000,141000,-27000,-27000
20200316,06651P,華新科元大99售09,2.33,2.63,2.31,2.63,+0.05,1.94,155000,22,378310,0,0,0,0,0,0,91000,105000,-14000,-14000
20200316,06652P,長榮航元大98售01,1.61,1.80,1.61,1.79,+0.31,20.95,1173000,63,1979820,0,0,0,0,0,0,430000,287000,143000,143000
20200316,06653P,美食元大98售02,2.31,2.66,2.31,2.66,+0.36,15.65,507000,57,1271570,0,0,0,0,0,0,34000,473000,-439000,-439000
20200316,06654P,欣興元大98售08,4.23,4.58,4.23,4.58,+0.25,5.77,12000,2,54260,0,0,0,0,0,0,10000,12000,-2000,-2000
20200316,06655P,TPK元大98售02,2.23,2.30,2.23,2.30,+0.20,9.52,30000,4,67600,0,0,0,0,0,0,10000,30000,-20000,-20000
20200316,06656P,GIS元大98售02,2.99,3.30,2.99,3.30,-0.18,-5.17,35000,10,114200,0,0,0,0,0,0,0,35000,-35000,-35000
20200316,06657P,寶成元大98售01,3.62,3.79,3.61,3.79,+0.32,9.22,67000,8,246690,0,0,0,0,0,0,15000,52000,-37000,-37000
20200316,06658P,台灣50富邦9C售01,6.80,7.90,6.75,7.90,+1.85,30.58,248000,11,1692500,0,0,0,0,0,0,248000,0,248000,248000
20200316,06659P,T50正2富邦9A售01,,,,,0.00,0.00,0,0,0,0,0,0,0,0,0,0,0,0,0
20200316,06660P,大立光富邦9B售03,2.13,2.60,2.12,2.60,+0.48,22.64,48000,9,110190,0,0,0,0,0,0,15000,23000,-8000,-8000
20200316,06661P,玉晶光永豐98售05,1.94,1.94,1.94,1.94,+0.07,3.74,10000,1,19400,0,0,0,0,0,0,10000,0,10000,10000
20200316,06662P,玉晶光中信9A售01,0.83,0.96,0.76,0.96,+0.13,15.66,947000,62,803300,0,0,0,0,0,0,9000,937000,-928000,-928000
20200316,06663P,鴻海兆豐98售03,2.63,2.63,2.63,2.63,+0.43,19.55,20000,1,52600,0,0,0,0,0,0,20000,20000,0,0
20200316,06664P,聯發科兆豐98售02,1.94,2.06,1.94,2.06,-0.15,-6.79,12000,2,24480,0,0,0,0,0,0,12000,0,12000,12000
20200316,06665P,欣興兆豐99售01,1.62,1.89,1.57,1.89,+0.24,14.55,139000,14,234750,0,0,0,0,0,0,2000,137000,-135000,-135000
20200316,06666P,台積電日盛9A售02,,,,,0.00,0.00,0,0,0,0,0,0,0,0,0,0,0,0,0
20200316,06667P,鴻海凱基98售11,2.80,3.10,2.80,3.10,+0.82,35.96,642000,10,1951820,0,0,0,0,0,0,602000,641000,-39000,-39000
20200316,06668P,祥碩凱基98售02,1.63,1.89,1.62,1.88,+0.27,16.77,788000,37,1413240,0,0,0,0,0,0,70000,707000,-637000,-637000
20200316,06669P,緯穎凱基98售05,1.13,1.22,1.13,1.22,-0.34,-21.79,399000,12,475000,0,0,0,0,0,0,0,399000,-399000,-399000
20200316,06670P,鴻海群益98售06,4.87,4.87,4.87,4.87,+0.70,16.79,50000,1,243500,0,0,0,0,0,0,50000,0,50000,50000
20200316,06671P,台積電群益98售04,6.00,6.00,6.00,6.00,0.00,0.00,10000,1,60000,0,0,0,0,0,0,10000,0,10000,10000
20200316,06672P,聯發科群益98售05,,,,,0.00,0.00,0,0,0,0,0,0,0,0,0,0,0,0,0
20200316,06673P,大立光群益98售01,,,,,0.00,0.00,0,0,0,0,0,0,0,0,0,0,0,0,0
20200316,06674P,祥碩群益98售02,1.89,2.19,1.88,2.16,+0.26,13.68,136000,24,269820,0,0,0,0,0,0,105000,15000,90000,90000
20200316,06675P,國巨國票99售02,,,,,0.00,0.00,0,0,0,0,0,0,0,0,0,0,0,0,0
20200316,06676P,華新科國票98售03,,,,,0.00,0.00,0,0,0,0,0,0,0,0,0,0,0,0,0
20200316,06677P,牧德國票98售02,,,,,0.00,0.00,0,0,0,0,0,0,0,0,0,0,0,0,0
20200316,06678P,大立光統一99售01,,,,,0.00,0.00,0,0,0,0,0,0,0,0,0,0,0,0,0
20200316,06679P,旺宏元大98售09,2.89,3.28,2.89,3.28,0.00,0.00,156000,17,490240,0,0,0,0,0,0,80000,156000,-76000,-76000
20200316,06680P,智邦元大98售06,2.10,2.35,2.10,2.33,+0.13,5.91,494000,43,1091150,0,0,0,0,0,0,386000,464000,-78000,-78000
20200316,06681P,致茂元大98售02,4.64,4.64,4.64,4.64,-0.66,-12.45,9000,1,41760,0,0,0,0,0,0,0,9000,-9000,-9000
20200316,06682P,玉晶光元大99售08,4.84,5.40,4.80,5.35,+0.71,15.3,702000,124,3491550,0,0,0,0,0,0,40000,672000,-632000,-632000
20200316,06683P,訊芯元大98售07,2.22,2.22,2.22,2.22,-0.07,-3.06,46000,2,102120,0,0,0,0,0,0,36000,46000,-10000,-10000
20200316,06684P,緯穎元大98售06,1.62,1.75,1.61,1.73,+0.02,1.17,180000,21,303550,0,0,0,0,0,0,70000,100000,-30000,-30000
20200316,06685P,鴻海國泰9A售01,2.96,2.96,2.96,2.96,+0.09,3.14,10000,1,29600,0,0,0,0,0,0,0,10000,-10000,-10000
20200316,06686P,麗豐永豐98售02,,,,,0.00,0.00,0,0,0,0,0,0,0,0,0,0,0,0,0
20200316,06687P,A50正2中信9A售01,1.07,1.07,1.07,1.07,-0.03,-2.73,10000,1,10700,0,0,0,0,0,0,0,10000,-10000,-10000
20200316,06688P,鴻海中信02售01,1.84,1.97,1.84,1.97,+0.03,1.55,36000,4,69730,0,0,0,0,0,0,30000,0,30000,30000
20200316,06689P,鴻海中信9C售02,1.47,1.47,1.47,1.47,-0.13,-8.12,1000,1,1470,0,0,0,0,0,0,0,1000,-1000,-1000
20200316,06690P,玉晶光群益9A售05,5.55,5.95,5.55,5.95,+0.20,3.48,30000,3,170500,0,0,0,0,0,0,0,30000,-30000,-30000
20200316,06691P,臺股指群益9C售05,,,,,0.00,0.00,0,0,0,0,0,0,0,0,0,0,0,0,0
20200316,06692P,瑞昱凱基98售03,2.36,2.59,2.34,2.59,+0.32,14.1,111000,9,268610,0,0,0,0,0,0,80000,31000,49000,49000
20200316,06693P,臺股指凱基98售01,,,,,0.00,0.00,0,0,0,0,0,0,0,0,0,0,0,0,0
20200316,06694P,臺股指凱基99售13,9.00,9.00,9.00,9.00,-1.10,-10.89,3000,2,27000,0,0,0,0,0,0,0,0,0,0
20200316,06695P,群創兆豐98售04,,,,,0.00,0.00,0,0,0,0,0,0,0,0,0,0,0,0,0
20200316,06696P,台灣50國票99售01,9.45,9.45,9.45,9.45,+0.45,5.0,4000,1,37800,0,0,0,0,0,0,4000,0,4000,4000
20200316,06697P,台積電國票99售05,,,,,0.00,0.00,0,0,0,0,0,0,0,0,0,0,0,0,0
20200316,06698P,玉晶光國票99售05,,,,,0.00,0.00,0,0,0,0,0,0,0,0,0,0,0,0,0
20200316,06699P,台積電統一98售11,,,,,0.00,0.00,0,0,0,0,0,0,0,0,0,0,0,0,0
20200316,06700P,臺股指統一99售05,,,,,0.00,0.00,0,0,0,0,0,0,0,0,0,0,0,0,0
20200316,06701P,臺股指統一99售06,,,,,0.00,0.00,0,0,0,0,0,0,0,0,0,0,0,0,0
20200316,06702P,智邦元富98售01,1.84,1.99,1.84,1.99,-0.18,-8.29,513000,14,964970,0,0,0,0,0,0,419000,506000,-87000,-87000
20200316,06703P,新日興元富98售02,,,,,0.00,0.00,0,0,0,0,0,0,0,0,0,0,0,0,0
20200316,06704P,玉晶光元富98售05,4.12,4.28,4.12,4.28,0.00,0.00,27000,4,113830,0,0,0,0,0,0,0,27000,-27000,-27000
20200316,06705P,臻鼎元富98售03,5.30,5.55,5.00,5.55,+0.25,4.72,111000,12,586700,0,0,0,0,0,0,60000,51000,9000,9000
20200316,06706P,智原台新98售02,1.78,1.83,1.78,1.83,-0.01,-0.54,50000,4,90500,0,0,0,0,0,0,20000,30000,-10000,-10000
20200316,06707P,臺股指台新99售04,14.00,17.00,13.90,17.00,-0.10,-0.58,22000,4,312900,0,0,0,0,0,0,22000,0,22000,22000
20200316,06708P,臺股指台新99售05,,,,,0.00,0.00,0,0,0,0,0,0,0,0,0,0,0,0,0
20200316,06709P,臺股指台新99售06,,,,,0.00,0.00,0,0,0,0,0,0,0,0,0,0,0,0,0
20200316,06710P,臺股指台新99售07,,,,,0.00,0.00,0,0,0,0,0,0,0,0,0,0,0,0,0
20200316,06711P,臺股指台新99售08,20.00,20.00,20.00,20.00,-5.80,-22.48,1000,1,20000,0,0,0,0,0,0,1000,0,1000,1000
20200316,06712P,臺股指台新99售09,,,,,0.00,0.00,0,0,0,0,0,0,0,0,0,0,0,0,0
20200316,06713P,臺股指富邦99售04,,,,,0.00,0.00,0,0,0,0,0,0,0,0,0,0,0,0,0
20200316,06714P,台積電元大98售15,6.75,7.85,6.75,7.85,+1.40,21.71,332000,29,2427800,0,0,0,0,0,0,220000,159000,61000,61000
20200316,06715P,台積電元大99售04,3.64,4.29,3.64,4.26,+0.68,18.99,429000,17,1695340,0,0,0,0,0,0,417000,10000,407000,407000
20200316,06716P,台積電元大9A售02,6.50,8.00,6.50,7.95,+0.95,13.57,364000,35,2561150,0,0,0,0,0,0,181000,220000,-39000,-39000
20200316,06717P,可成元大98售09,5.95,6.00,5.95,6.00,-0.85,-12.41,13000,2,77850,0,0,0,0,0,0,13000,0,13000,13000
20200316,06718P,聯詠元大98售01,6.15,6.70,6.15,6.70,-0.20,-2.9,93000,10,613100,0,0,0,0,0,0,0,93000,-93000,-93000
20200316,06719P,台灣50群益9A售01,12.80,13.50,12.60,13.50,+1.90,16.38,113000,10,1464500,0,0,0,0,0,0,23000,90000,-67000,-67000
20200316,06720P,智邦亞東99售01,,,,,0.00,0.00,0,0,0,0,0,0,0,0,0,0,0,0,0
20200316,06721P,臺股指中信9A售03,2.48,2.48,2.45,2.48,+0.06,2.48,21000,4,51780,0,0,0,0,0,0,21000,0,21000,21000
20200316,06722P,臺股指中信9A售04,5.80,5.95,5.80,5.95,+0.98,19.72,171000,18,1002350,0,0,0,0,0,0,171000,171000,0,0
20200316,06723P,台灣50麥證99售01,,,,,0.00,0.00,0,0,0,0,0,0,0,0,0,0,0,0,0
20200316,06724P,台灣50國票98售01,11.80,11.80,11.40,11.40,-3.80,-25.0,31000,2,353800,0,0,0,0,0,0,31000,0,31000,31000
20200316,06725P,聯電元富98售01,2.25,2.38,2.25,2.33,-0.11,-4.51,157000,18,358450,0,0,0,0,0,0,107000,50000,57000,57000
20200316,06726P,欣興元富98售04,3.69,4.51,3.67,4.40,+0.60,15.79,197000,29,764990,0,0,0,0,0,0,77000,120000,-43000,-43000
20200316,06727P,台光電元大98售05,2.20,2.20,2.20,2.20,+0.04,1.85,30000,3,66000,0,0,0,0,0,0,0,30000,-30000,-30000
20200316,06728P,全新元大98售03,2.74,2.80,2.74,2.80,+0.07,2.56,40000,4,110800,0,0,0,0,0,0,0,40000,-40000,-40000
20200316,06729P,聯詠元大98售03,5.65,6.30,5.65,6.30,0.00,0.00,13000,3,77450,0,0,0,0,0,0,2000,11000,-9000,-9000
20200316,06730P,祥碩元大98售07,3.73,4.08,3.69,4.08,+0.39,10.57,389000,45,1492050,0,0,0,0,0,0,104000,345000,-241000,-241000
20200316,06731P,聯茂元大98售05,2.48,2.85,2.48,2.85,+0.28,10.89,120000,16,327590,0,0,0,0,0,0,10000,110000,-100000,-100000
20200316,06732P,台灣50日盛9A售01,4.82,4.82,4.82,4.82,+0.01,0.21,5000,1,24100,0,0,0,0,0,0,5000,0,5000,5000
20200316,06733P,鴻海凱基99售02,2.54,2.91,2.54,2.91,+0.46,18.78,65000,8,181900,0,0,0,0,0,0,25000,60000,-35000,-35000
20200316,06734P,智邦凱基98售05,1.62,1.82,1.55,1.82,+0.10,5.81,117000,17,191590,0,0,0,0,0,0,18000,117000,-99000,-99000
20200316,06735P,奇力新凱基98售07,,,,,0.00,0.00,0,0,0,0,0,0,0,0,0,0,0,0,0
20200316,06736P,新日興凱基98售03,1.40,1.55,1.38,1.55,+0.02,1.31,122000,5,180680,0,0,0,0,0,0,0,122000,-122000,-122000
20200316,06737P,台郡凱基98售07,1.49,1.49,1.49,1.49,-0.07,-4.49,10000,1,14900,0,0,0,0,0,0,0,10000,-10000,-10000
20200316,06738P,瑞昱兆豐98售02,1.41,1.59,1.41,1.54,+0.22,16.67,1026000,27,1517780,0,0,0,0,0,0,17000,1004000,-987000,-987000
20200316,06739P,聯詠兆豐98售02,1.43,1.56,1.38,1.56,+0.10,6.85,55000,6,81200,0,0,0,0,0,0,20000,35000,-15000,-15000
20200316,06740P,台灣50國泰9A售02,4.04,4.36,4.03,4.36,+0.89,25.65,578000,59,2349160,0,0,0,0,0,0,0,532000,-532000,-532000
20200316,06741P,台積電富邦98售04,4.66,4.66,4.66,4.66,+0.75,19.18,40000,1,186400,0,0,0,0,0,0,40000,0,40000,40000
20200316,06742P,可成富邦99售02,3.45,3.45,3.45,3.45,-0.34,-8.97,3000,1,10350,0,0,0,0,0,0,3000,0,3000,3000
20200316,06743P,創意永豐98售03,2.45,2.58,2.45,2.58,-0.22,-7.86,32000,4,81200,0,0,0,0,0,0,0,32000,-32000,-32000
20200316,06744P,嘉聯益永豐98售03,,,,,0.00,0.00,0,0,0,0,0,0,0,0,0,0,0,0,0
20200316,06745P,台積電群益98售05,8.45,11.20,8.20,11.20,-0.10,-0.88,4000,3,36050,0,0,0,0,0,0,4000,0,4000,4000
20200316,06746P,聯發科群益99售02,,,,,0.00,0.00,0,0,0,0,0,0,0,0,0,0,0,0,0
20200316,06747P,大立光群益99售04,,,,,0.00,0.00,0,0,0,0,0,0,0,0,0,0,0,0,0
20200316,06748P,智邦台新98售02,1.82,2.02,1.82,2.01,+0.12,6.35,77000,9,151910,0,0,0,0,0,0,0,77000,-77000,-77000
20200316,06749P,技嘉元富98售03,4.53,4.89,4.41,4.89,+0.48,10.88,104000,14,477920,0,0,0,0,0,0,63000,41000,22000,22000
20200316,06750P,聯發科元富02售03,2.38,2.70,2.38,2.70,+0.36,15.38,138000,14,343790,0,0,0,0,0,0,24000,114000,-90000,-90000
20200316,06751P,旺宏凱基98售10,2.80,3.27,2.80,3.27,+0.12,3.81,91000,9,279230,0,0,0,0,0,0,73000,38000,35000,35000
20200316,06752P,訊芯凱基98售05,2.25,2.34,2.25,2.34,-0.11,-4.49,23000,2,52380,0,0,0,0,0,0,23000,23000,0,0
20200316,06753P,智邦富邦98售03,,,,,0.00,0.00,0,0,0,0,0,0,0,0,0,0,0,0,0
20200316,06754P,台積電永豐98售03,,,,,0.00,0.00,0,0,0,0,0,0,0,0,0,0,0,0,0
20200316,06755P,大立光永豐98售03,,,,,0.00,0.00,0,0,0,0,0,0,0,0,0,0,0,0,0
20200316,06756P,臺股指永豐98售05,,,,,0.00,0.00,0,0,0,0,0,0,0,0,0,0,0,0,0
20200316,06757P,台灣50元大9B售01,3.24,3.90,3.06,3.80,+0.82,27.52,2270000,313,8165660,0,0,0,0,0,0,1453000,2050000,-597000,-597000
20200316,06758P,鴻海元大98售10,6.55,6.55,6.45,6.55,+1.20,22.43,40000,4,261000,0,0,0,0,0,0,20000,40000,-20000,-20000
20200316,06759P,台積電元大98售17,4.81,5.95,4.81,5.95,+1.01,20.45,187000,16,1031860,0,0,0,0,0,0,92000,105000,-13000,-13000
20200316,06760P,台積電元大98售18,3.20,3.86,3.15,3.86,+0.81,26.56,1061000,108,3663320,0,0,0,0,0,0,352000,783000,-431000,-431000
20200316,06761P,台積電元大99售05,4.18,4.85,4.18,4.85,+0.79,19.46,308000,23,1405190,0,0,0,0,0,0,160000,195000,-35000,-35000
20200316,06762P,智邦元大98售11,2.87,3.01,2.87,3.01,-0.38,-11.21,12000,2,35840,0,0,0,0,0,0,0,12000,-12000,-12000
20200316,06763P,技嘉元大98售05,5.75,6.00,5.75,6.00,-0.25,-4.0,17000,2,100250,0,0,0,0,0,0,7000,10000,-3000,-3000
20200316,06764P,聯發科元大98售11,7.25,7.95,7.25,7.95,+0.35,4.61,11000,2,80450,0,0,0,0,0,0,1000,10000,-9000,-9000
20200316,06765P,欣興元大98售11,4.17,4.17,4.17,4.17,-0.23,-5.23,3000,1,12510,0,0,0,0,0,0,0,3000,-3000,-3000
20200316,06766P,玉晶光元大99售10,2.10,2.33,2.10,2.33,+0.25,12.02,69000,9,150710,0,0,0,0,0,0,32000,47000,-15000,-15000
20200316,06767P,台積電永昌99售03,9.70,9.70,9.70,9.70,+1.30,15.48,10000,1,97000,0,0,0,0,0,0,10000,10000,0,0
20200316,06768P,臺股指永昌98售02,,,,,0.00,0.00,0,0,0,0,0,0,0,0,0,0,0,0,0
20200316,06769P,臺股指永昌98售03,,,,,0.00,0.00,0,0,0,0,0,0,0,0,0,0,0,0,0
20200316,06770P,台灣50第一9C售01,,,,,0.00,0.00,0,0,0,0,0,0,0,0,0,0,0,0,0
20200316,06771P,台灣50中信02售01,3.43,3.56,3.39,3.56,-0.24,-6.32,12000,8,41360,0,0,0,0,0,0,10000,0,10000,10000
20200316,06772P,國巨中信99售01,1.63,1.95,1.63,1.95,+0.20,11.43,247000,11,437060,0,0,0,0,0,0,237000,0,237000,237000
20200316,06773P,台灣50兆豐9A售01,2.53,2.97,2.53,2.97,+0.35,13.36,22000,5,60980,0,0,0,0,0,0,22000,12000,10000,10000
20200316,06774P,臺股指兆豐98售02,,,,,0.00,0.00,0,0,0,0,0,0,0,0,0,0,0,0,0
20200316,06775P,臺股指兆豐98售03,,,,,0.00,0.00,0,0,0,0,0,0,0,0,0,0,0,0,0
20200316,06776P,鴻海元大99售05,5.60,5.60,5.55,5.55,0.00,0.00,20000,2,111500,0,0,0,0,0,0,20000,20000,0,0
20200316,06777P,鴻海元大99售06,6.40,7.20,6.40,7.00,+1.05,17.65,43000,6,300900,0,0,0,0,0,0,23000,40000,-17000,-17000
20200316,06778P,台積電元大99售06,4.05,4.81,3.99,4.65,+0.78,20.16,321000,35,1408130,0,0,0,0,0,0,149000,219000,-70000,-70000
20200316,06779P,智邦元大98售12,2.92,3.12,2.92,3.12,-0.59,-15.9,21000,3,63520,0,0,0,0,0,0,0,21000,-21000,-21000
20200316,06780P,義隆元大98售02,,,,,0.00,0.00,0,0,0,0,0,0,0,0,0,0,0,0,0
20200316,06781P,大立光元大98售19,,,,,0.00,0.00,0,0,0,0,0,0,0,0,0,0,0,0,0
20200316,06782P,大立光元大99售07,3.33,3.98,3.32,3.91,+0.66,20.31,139000,23,509250,0,0,0,0,0,0,81000,57000,24000,24000
20200316,06783P,亞光元大98售03,4.12,4.74,4.12,4.74,+0.58,13.94,19000,7,83060,0,0,0,0,0,0,1000,18000,-17000,-17000
20200316,06784P,臺股指元大98售01,,,,,0.00,0.00,0,0,0,0,0,0,0,0,0,0,0,0,0
20200316,06785P,臺股指元大98售02,,,,,0.00,0.00,0,0,0,0,0,0,0,0,0,0,0,0,0
20200316,06786P,臺股指元大98售03,,,,,0.00,0.00,0,0,0,0,0,0,0,0,0,0,0,0,0
20200316,06787P,臺股指元大98售04,,,,,0.00,0.00,0,0,0,0,0,0,0,0,0,0,0,0,0
20200316,06788P,臺股指元大98售05,8.70,8.70,8.70,8.70,+1.85,27.01,2000,1,17400,0,0,0,0,0,0,0,2000,-2000,-2000
20200316,06789P,鴻海凱基98售12,4.62,4.62,4.62,4.62,-0.58,-11.15,1000,1,4620,0,0,0,0,0,0,1000,0,1000,1000
20200316,06790P,台積電凱基9A售04,2.94,2.94,1.74,2.74,-0.26,-8.67,258000,34,565190,0,0,0,0,0,0,134000,72000,62000,62000
20200316,06791P,聯發科凱基98售16,2.53,3.03,2.44,3.03,+0.61,25.21,147000,17,390340,0,0,0,0,0,0,74000,147000,-73000,-73000
20200316,06792P,臺股指凱基98售02,11.00,15.30,11.00,15.30,+1.20,8.51,9000,3,122400,0,0,0,0,0,0,6000,0,6000,6000
20200316,06793P,臺股指凱基98售03,,,,,0.00,0.00,0,0,0,0,0,0,0,0,0,0,0,0,0
20200316,06794P,臺股指凱基98售04,,,,,0.00,0.00,0,0,0,0,0,0,0,0,0,0,0,0,0
20200316,06795P,臺股指凱基98售05,,,,,0.00,0.00,0,0,0,0,0,0,0,0,0,0,0,0,0
20200316,06796P,臺股指凱基98售06,,,,,0.00,0.00,0,0,0,0,0,0,0,0,0,0,0,0,0
20200316,06797P,臺股指凱基98售07,,,,,0.00,0.00,0,0,0,0,0,0,0,0,0,0,0,0,0
20200316,06798P,臺股指凱基98售08,,,,,0.00,0.00,0,0,0,0,0,0,0,0,0,0,0,0,0
20200316,06799P,臺股指凱基98售09,,,,,0.00,0.00,0,0,0,0,0,0,0,0,0,0,0,0,0
20200316,06800P,台灣50群益9A售02,6.20,7.45,6.20,7.45,+1.65,28.45,164000,5,1100100,0,0,0,0,0,0,164000,0,164000,164000
20200316,06801P,技嘉群益99售02,3.18,3.18,3.18,3.18,-0.26,-7.56,5000,1,15900,0,0,0,0,0,0,5000,0,5000,5000
20200316,06802P,緯穎群益98售03,2.23,2.45,2.23,2.45,+0.12,5.15,12000,12,28190,0,0,0,0,0,0,7000,2000,5000,5000
20200316,06803P,臺股指群益98售09,,,,,0.00,0.00,0,0,0,0,0,0,0,0,0,0,0,0,0
20200316,06804P,臺股指群益98售10,,,,,0.00,0.00,0,0,0,0,0,0,0,0,0,0,0,0,0
20200316,06805P,臺股指群益98售11,,,,,0.00,0.00,0,0,0,0,0,0,0,0,0,0,0,0,0
20200316,06806P,臺股指群益98售12,,,,,0.00,0.00,0,0,0,0,0,0,0,0,0,0,0,0,0
20200316,06807P,臺股指群益98售13,,,,,0.00,0.00,0,0,0,0,0,0,0,0,0,0,0,0,0
20200316,06808P,電子類群益98售02,,,,,0.00,0.00,0,0,0,0,0,0,0,0,0,0,0,0,0
20200316,06809P,電子類群益98售03,,,,,0.00,0.00,0,0,0,0,0,0,0,0,0,0,0,0,0
20200316,06810P,國巨統一99售03,2.90,2.90,2.90,2.90,0.00,0.00,2000,1,5800,0,0,0,0,0,0,0,2000,-2000,-2000
20200316,06811P,聯發科統一98售06,,,,,0.00,0.00,0,0,0,0,0,0,0,0,0,0,0,0,0
20200316,06812P,台灣50元富9C售01,4.12,5.10,4.04,4.99,+1.15,29.95,570000,65,2641700,0,0,0,0,0,0,537000,468000,69000,69000
20200316,06813P,友訊元富98售03,,,,,0.00,0.00,0,0,0,0,0,0,0,0,0,0,0,0,0
20200316,06814P,臺股指元富98售03,,,,,0.00,0.00,0,0,0,0,0,0,0,0,0,0,0,0,0
20200316,06815P,臺股指元富98售04,,,,,0.00,0.00,0,0,0,0,0,0,0,0,0,0,0,0,0
20200316,06816P,臺股指元富98售05,,,,,0.00,0.00,0,0,0,0,0,0,0,0,0,0,0,0,0
20200316,06817P,臺股指元富98售06,,,,,0.00,0.00,0,0,0,0,0,0,0,0,0,0,0,0,0
20200316,06818P,臺股指元富98售07,,,,,0.00,0.00,0,0,0,0,0,0,0,0,0,0,0,0,0
20200316,06819P,臺股指元富98售08,,,,,0.00,0.00,0,0,0,0,0,0,0,0,0,0,0,0,0
20200316,06820P,臺股指元富98售09,,,,,0.00,0.00,0,0,0,0,0,0,0,0,0,0,0,0,0
20200316,06821P,臺股指元富98售10,,,,,0.00,0.00,0,0,0,0,0,0,0,0,0,0,0,0,0
20200316,06822P,上銀富邦99售03,2.59,2.87,2.58,2.87,+0.36,14.34,168000,7,442420,0,0,0,0,0,0,61000,107000,-46000,-46000
20200316,06823P,台灣50永豐98售02,,,,,0.00,0.00,0,0,0,0,0,0,0,0,0,0,0,0,0
20200316,06824P,台灣50國票99售02,,,,,0.00,0.00,0,0,0,0,0,0,0,0,0,0,0,0,0
20200316,06825P,臺股指國票98售01,,,,,0.00,0.00,0,0,0,0,0,0,0,0,0,0,0,0,0
20200316,06826P,臺股指國票98售02,,,,,0.00,0.00,0,0,0,0,0,0,0,0,0,0,0,0,0
20200316,06827P,臺股指國票98售03,,,,,0.00,0.00,0,0,0,0,0,0,0,0,0,0,0,0,0
20200316,06828P,臺股指國票98售04,,,,,0.00,0.00,0,0,0,0,0,0,0,0,0,0,0,0,0
20200316,06829P,臺股指國票98售05,,,,,0.00,0.00,0,0,0,0,0,0,0,0,0,0,0,0,0
20200316,06830P,臺股指國票98售06,,,,,0.00,0.00,0,0,0,0,0,0,0,0,0,0,0,0,0
20200316,06831P,臺股指國票98售07,,,,,0.00,0.00,0,0,0,0,0,0,0,0,0,0,0,0,0
20200316,06832P,玉晶光凱基98售03,1.85,2.01,1.84,2.01,+0.06,3.08,376000,14,726450,0,0,0,0,0,0,213000,363000,-150000,-150000
20200316,06833P,矽力群益99售01,1.79,1.79,1.79,1.79,+0.19,11.88,4000,2,7160,0,0,0,0,0,0,0,4000,-4000,-4000
20200316,06834P,訊芯群益99售02,2.75,2.75,2.70,2.70,-0.18,-6.25,17000,3,46150,0,0,0,0,0,0,0,17000,-17000,-17000
20200316,06835P,台灣50國票9A售01,8.75,10.10,8.75,10.10,-0.40,-3.81,16000,3,142600,0,0,0,0,0,0,1000,15000,-14000,-14000
20200316,06836P,玉晶光國票99售06,,,,,0.00,0.00,0,0,0,0,0,0,0,0,0,0,0,0,0
20200316,06837P,上銀統一9A售02,2.37,2.37,2.37,2.37,+0.14,6.28,70000,1,165900,0,0,0,0,0,0,70000,0,70000,70000
20200316,06838P,台積電統一99售05,,,,,0.00,0.00,0,0,0,0,0,0,0,0,0,0,0,0,0
20200316,06839P,玉晶光統一9A售05,2.09,2.48,2.09,2.48,+0.29,13.24,33000,6,76590,0,0,0,0,0,0,2000,31000,-29000,-29000
20200316,06840P,臺股指統一98售04,,,,,0.00,0.00,0,0,0,0,0,0,0,0,0,0,0,0,0
20200316,06841P,臺股指統一9A售02,,,,,0.00,0.00,0,0,0,0,0,0,0,0,0,0,0,0,0
20200316,06842P,臺股指統一9A售03,5.35,5.35,5.35,5.35,-0.25,-4.46,4000,1,21400,0,0,0,0,0,0,4000,0,4000,4000
20200316,06843P,鴻海元大98售11,4.06,4.33,4.04,4.33,+0.03,0.7,147000,12,622820,0,0,0,0,0,0,127000,97000,30000,30000
20200316,06844P,智邦元大98售13,3.51,3.83,3.49,3.83,-0.09,-2.3,83000,15,294450,0,0,0,0,0,0,5000,78000,-73000,-73000
20200316,06845P,億光元大98售02,3.31,3.60,3.31,3.60,+0.08,2.27,22000,3,76240,0,0,0,0,0,0,10000,12000,-2000,-2000
20200316,06846P,美律元大98售05,3.80,4.02,3.80,4.02,-0.01,-0.25,30000,3,116900,0,0,0,0,0,0,0,30000,-30000,-30000
20200316,06847P,奇力新元大98售05,2.43,2.77,2.39,2.77,-0.04,-1.42,65000,8,164300,0,0,0,0,0,0,20000,45000,-25000,-25000
20200316,06848P,聯詠元大98售04,4.91,5.30,4.91,5.15,-0.20,-3.74,28000,4,140940,0,0,0,0,0,0,5000,23000,-18000,-18000
20200316,06849P,欣興元大98售12,4.51,4.76,4.51,4.76,0.00,0.00,20000,2,92700,0,0,0,0,0,0,10000,20000,-10000,-10000
20200316,06850P,聯茂元大98售06,2.74,2.90,2.74,2.90,+0.11,3.94,42000,5,116200,0,0,0,0,0,0,0,42000,-42000,-42000
20200316,06851P,鈺齊元大98售01,2.41,2.63,2.41,2.63,+0.11,4.37,62000,8,152600,0,0,0,0,0,0,0,62000,-62000,-62000
20200316,06852P,臺股指元大98售11,2.04,2.33,2.04,2.33,+0.26,12.56,44000,10,95580,0,0,0,0,0,0,5000,34000,-29000,-29000
20200316,06853P,華擎元富98售03,4.00,4.18,4.00,4.18,+0.02,0.48,29000,4,120230,0,0,0,0,0,0,29000,0,29000,29000
20200316,06854P,鴻海富邦99售05,,,,,0.00,0.00,0,0,0,0,0,0,0,0,0,0,0,0,0
20200316,06855P,聯發科富邦9A售01,2.75,3.22,2.75,3.22,+0.55,20.6,263000,14,766580,0,0,0,0,0,0,247000,16000,231000,231000
20200316,06856P,台灣50永豐99售03,5.75,5.75,5.75,5.75,0.00,0.00,50000,1,287500,0,0,0,0,0,0,50000,0,50000,50000
20200316,06857P,超眾永豐98售02,1.71,1.88,1.71,1.88,+0.05,2.73,38000,4,67340,0,0,0,0,0,0,5000,33000,-28000,-28000
20200316,06858P,道瓊指中信9B售01,3.42,3.42,3.25,3.25,+0.08,2.52,38000,7,124710,0,0,0,0,0,0,3000,20000,-17000,-17000
20200316,06859P,元金2X中信9C售01,1.25,1.25,1.25,1.25,+0.16,14.68,1000,1,1250,0,0,0,0,0,0,0,1000,-1000,-1000
20200316,06860P,台灣50兆豐98售01,4.13,6.00,4.13,6.00,+1.94,47.78,102000,10,477390,0,0,0,0,0,0,87000,10000,77000,77000
20200316,06861P,台積電國票99售08,,,,,0.00,0.00,0,0,0,0,0,0,0,0,0,0,0,0,0
20200316,06862P,大立光凱基98售16,2.52,2.81,2.52,2.81,-0.29,-9.35,186000,4,488040,0,0,0,0,0,0,76000,186000,-110000,-110000
20200316,06863P,欣興凱基98售05,2.52,2.78,2.52,2.78,+0.33,13.47,30000,5,79510,0,0,0,0,0,0,18000,30000,-12000,-12000
20200316,06864P,健策凱基98售01,,,,,0.00,0.00,0,0,0,0,0,0,0,0,0,0,0,0,0
20200316,06865P,亞德客元大98售04,6.45,6.60,6.45,6.60,-0.10,-1.49,14000,2,90900,0,0,0,0,0,0,10000,14000,-4000,-4000
20200316,06866P,聯發科元大98售13,5.95,7.25,5.90,7.25,+0.40,5.84,175000,18,1080750,0,0,0,0,0,0,35000,160000,-125000,-125000
20200316,06867P,訊芯元大98售08,3.03,3.50,3.03,3.43,+0.10,3.0,112000,7,378770,0,0,0,0,0,0,105000,102000,3000,3000
20200316,06868P,電子類元大99售01,3.42,4.02,3.37,4.02,+0.87,27.62,243000,25,868140,0,0,0,0,0,0,107000,114000,-7000,-7000
20200316,06869P,金融類元大99售01,1.90,2.02,1.90,2.02,+0.19,10.38,471000,13,904010,0,0,0,0,0,0,391000,80000,311000,311000
20200316,06870P,台灣50群益9A售03,8.85,10.00,8.85,10.00,+2.30,29.87,36000,2,341600,0,0,0,0,0,0,36000,0,36000,36000
20200316,06871P,元油2X群益98售04,,,,,0.00,0.00,0,0,0,0,0,0,0,0,0,0,0,0,0
20200316,06872P,亞德客元富98售04,3.01,3.29,2.89,3.29,-0.22,-6.27,354000,28,1048060,0,0,0,0,0,0,41000,313000,-272000,-272000
20200316,06873P,嘉晶元富98售02,1.16,1.34,1.12,1.34,-0.23,-14.65,987000,56,1167860,0,0,0,0,0,0,916000,881000,35000,35000
20200316,06874P,台積電台新98售02,2.71,2.94,2.71,2.94,-0.53,-15.27,1008000,3,2733980,0,0,0,0,0,0,10000,1008000,-998000,-998000
20200316,06875P,台灣50永昌9A售02,4.77,5.80,4.77,5.80,-0.55,-8.66,100000,6,514800,0,0,0,0,0,0,100000,50000,50000,50000
20200316,06876P,台灣50兆豐9B售01,3.60,4.84,3.60,4.70,+0.17,3.75,34000,7,158530,0,0,0,0,0,0,34000,32000,2000,2000
20200316,06877P,台積電兆豐98售04,3.00,4.00,2.74,3.35,+0.72,27.38,467000,45,1345570,0,0,0,0,0,0,408000,270000,138000,138000
20200316,06878P,台灣50日盛9B售01,1.95,2.27,1.95,2.27,+0.15,7.08,130000,13,288000,0,0,0,0,0,0,130000,110000,20000,20000
20200316,06879P,長榮航凱基98售02,1.50,1.78,1.50,1.77,+0.32,22.07,1183000,78,1926800,0,0,0,0,0,0,47000,1025000,-978000,-978000
20200316,06880P,鈺齊凱基98售03,1.44,1.60,1.44,1.60,+0.18,12.68,58000,3,84760,0,0,0,0,0,0,0,58000,-58000,-58000
20200316,06881P,國巨群益98售10,,,,,0.00,0.00,0,0,0,0,0,0,0,0,0,0,0,0,0
20200316,06882P,聯發科群益98售07,,,,,0.00,0.00,0,0,0,0,0,0,0,0,0,0,0,0,0
20200316,06883P,聯茂群益98售03,2.54,2.54,2.54,2.54,+0.04,1.6,1000,1,2540,0,0,0,0,0,0,1000,0,1000,1000
20200316,06884P,台郡群益98售03,3.20,3.40,3.20,3.40,+0.02,0.59,10000,3,33120,0,0,0,0,0,0,1000,9000,-8000,-8000
20200316,06885P,國巨國票99售06,11.70,11.70,11.70,11.70,-0.20,-1.68,10000,1,117000,0,0,0,0,0,0,10000,0,10000,10000
20200316,06886P,旺宏元大99售07,4.83,5.40,4.83,5.40,-0.15,-2.7,45000,7,227530,0,0,0,0,0,0,44000,32000,12000,12000
20200316,06887P,華新科元大98售04,7.40,8.05,7.15,8.00,0.00,0.00,60000,8,454050,0,0,0,0,0,0,0,60000,-60000,-60000
20200316,06888P,日月光元大98售02,7.35,7.35,7.35,7.35,-0.20,-2.65,28000,5,205800,0,0,0,0,0,0,0,28000,-28000,-28000
20200316,06889P,臺股指元大98售13,2.20,2.42,2.19,2.37,+0.22,10.23,208000,27,478980,0,0,0,0,0,0,45000,163000,-118000,-118000
20200316,06890P,金融類元大98售02,1.17,1.26,1.17,1.26,+0.13,11.5,115000,16,143620,0,0,0,0,0,0,0,115000,-115000,-115000
20200316,06891P,緯穎富邦99售03,0.80,0.80,0.72,0.80,-0.05,-5.88,156000,9,116640,0,0,0,0,0,0,20000,136000,-116000,-116000
20200316,06892P,聯鈞元富98售01,2.88,3.18,2.86,3.15,-0.06,-1.87,85000,18,251590,0,0,0,0,0,0,46000,39000,7000,7000
20200316,06893P,致新元富98售02,3.15,3.18,3.15,3.18,+0.04,1.27,12000,2,38100,0,0,0,0,0,0,10000,2000,8000,8000
20200316,06894P,鈺齊元富98售03,2.44,2.79,2.44,2.79,+0.41,17.23,166000,12,446810,0,0,0,0,0,0,5000,161000,-156000,-156000
20200316,06895P,台灣50統一9A售01,2.79,2.79,2.79,2.79,-0.59,-17.46,1000,1,2790,0,0,0,0,0,0,0,1000,-1000,-1000
20200316,06896P,信邦中信98售01,1.54,1.76,1.54,1.66,+0.05,3.11,72000,19,113680,0,0,0,0,0,0,71000,1000,70000,70000
20200316,06897P,FBVIX群益01售01,0.72,0.72,0.71,0.71,-0.05,-6.58,96000,4,69020,0,0,0,0,0,0,95000,1000,94000,94000
20200316,06898P,FBVIX群益9C售03,1.01,1.01,1.00,1.00,-0.05,-4.76,633000,9,639130,0,0,0,0,0,0,310000,323000,-13000,-13000
20200316,06899P,嘉澤群益98售01,,,,,0.00,0.00,0,0,0,0,0,0,0,0,0,0,0,0,0
20200316,06900P,FBVIX國票12售01,0.45,0.45,0.45,0.45,-0.02,-4.26,2000,1,900,0,0,0,0,0,0,2000,0,2000,2000
20200316,06901P,亞德客凱基98售02,1.70,1.89,1.60,1.89,-0.01,-0.53,204000,24,343400,0,0,0,0,0,0,80000,118000,-38000,-38000
20200316,06902P,聯電凱基98售02,1.87,1.95,1.87,1.95,-0.10,-4.88,70000,3,131700,0,0,0,0,0,0,60000,10000,50000,50000
20200316,06903P,技嘉凱基98售04,,,,,0.00,0.00,0,0,0,0,0,0,0,0,0,0,0,0,0
20200316,06904P,TPK凱基98售03,1.56,1.56,1.56,1.56,-0.10,-6.02,20000,1,31200,0,0,0,0,0,0,20000,0,20000,20000
20200316,06905P,上証2X國泰99售02,,,,,0.00,0.00,0,0,0,0,0,0,0,0,0,0,0,0,0
20200316,06906P,國巨國泰99售01,4.00,4.00,4.00,4.00,-0.21,-4.99,1000,1,4000,0,0,0,0,0,0,1000,0,1000,1000
20200316,06907P,華新科國泰99售05,,,,,0.00,0.00,0,0,0,0,0,0,0,0,0,0,0,0,0
20200316,06908P,健策國泰99售02,2.83,2.83,2.83,2.83,-0.14,-4.71,10000,1,28300,0,0,0,0,0,0,10000,0,10000,10000
20200316,06909P,元油2X元大98售22,,,,,0.00,0.00,0,0,0,0,0,0,0,0,0,0,0,0,0
20200316,06910P,元油2X元大98售23,,,,,0.00,0.00,0,0,0,0,0,0,0,0,0,0,0,0,0
20200316,06911P,鴻海元大99售09,3.91,4.18,3.86,4.18,-0.02,-0.48,66000,7,266280,0,0,0,0,0,0,66000,66000,0,0
20200316,06912P,台光電元大99售02,3.67,3.87,3.67,3.87,-0.15,-3.73,22000,3,82900,0,0,0,0,0,0,10000,12000,-2000,-2000
20200316,06913P,聯發科元大98售14,5.80,5.80,5.80,5.80,+0.40,7.41,20000,2,116000,0,0,0,0,0,0,20000,20000,0,0
20200316,06914P,南茂元大98售03,3.58,3.63,3.58,3.63,+0.01,0.28,7000,2,25360,0,0,0,0,0,0,1000,6000,-5000,-5000
20200316,06915P,晶技元富98售02,1.27,1.40,1.12,1.40,+0.07,5.26,808000,54,1004240,0,0,0,0,0,0,115000,606000,-491000,-491000
20200316,06916P,聯鈞元富98售02,4.23,4.29,4.19,4.29,+0.17,4.13,6000,4,25490,0,0,0,0,0,0,3000,3000,0,0
20200316,06917P,聯電亞東99售01,1.98,1.98,1.98,1.98,-0.10,-4.81,10000,1,19800,0,0,0,0,0,0,10000,0,10000,10000
20200316,06918P,嘉聯益亞東99售01,2.37,2.37,2.37,2.37,0.00,0.00,50000,2,118500,0,0,0,0,0,0,49000,50000,-1000,-1000
20200316,06919P,臺股指日盛98售02,,,,,0.00,0.00,0,0,0,0,0,0,0,0,0,0,0,0,0
20200316,06920P,台灣50凱基9A售01,4.65,5.00,4.65,5.00,0.00,0.00,86000,11,423490,0,0,0,0,0,0,84000,82000,2000,2000
20200316,06921P,台光電凱基98售06,2.28,2.30,2.28,2.30,+0.03,1.32,20000,2,45800,0,0,0,0,0,0,0,20000,-20000,-20000
20200316,06922P,元上證群益9C售01,,,,,0.00,0.00,0,0,0,0,0,0,0,0,0,0,0,0,0
20200316,06923P,鴻海群益98售09,,,,,0.00,0.00,0,0,0,0,0,0,0,0,0,0,0,0,0
20200316,06924P,台積電群益98售07,4.51,5.60,4.51,5.60,-0.20,-3.45,31000,5,156490,0,0,0,0,0,0,21000,10000,11000,11000
20200316,06925P,致茂群益9A售02,,,,,0.00,0.00,0,0,0,0,0,0,0,0,0,0,0,0,0
20200316,06926P,可成群益9A售04,7.20,7.20,7.00,7.00,0.00,0.00,11000,3,78600,0,0,0,0,0,0,0,11000,-11000,-11000
20200316,06927P,台灣50元大9B售03,6.70,6.70,6.15,6.15,-0.90,-12.77,15000,2,97750,0,0,0,0,0,0,5000,10000,-5000,-5000
20200316,06928P,鴻海元大99售10,3.19,3.63,3.19,3.63,+0.23,6.76,144000,14,498920,0,0,0,0,0,0,95000,74000,21000,21000
20200316,06929P,鴻海元大99售11,3.48,3.88,3.48,3.88,0.00,0.00,74000,8,275950,0,0,0,0,0,0,69000,74000,-5000,-5000
20200316,06930P,台積電元大98售19,5.35,6.75,5.35,6.75,+1.15,20.54,262000,28,1571800,0,0,0,0,0,0,125000,207000,-82000,-82000
20200316,06931P,大立光元大98售20,,,,,0.00,0.00,0,0,0,0,0,0,0,0,0,0,0,0,0
20200316,06932P,大立光元大98售21,5.05,5.35,5.05,5.35,0.00,0.00,90000,9,467500,0,0,0,0,0,0,90000,90000,0,0
20200316,06933P,禾伸堂元大98售03,2.73,3.04,2.64,3.04,+0.26,9.35,87000,22,245710,0,0,0,0,0,0,24000,61000,-37000,-37000
20200316,06934P,聯鈞元大98售03,3.03,3.25,3.03,3.25,-0.10,-2.99,37000,4,115250,0,0,0,0,0,0,10000,27000,-17000,-17000
20200316,06935P,神達元大98售02,4.27,4.64,4.12,4.64,+0.48,11.54,55000,5,234420,0,0,0,0,0,0,44000,11000,33000,33000
20200316,06936P,瑞儀元大98售01,4.77,4.78,4.66,4.71,-0.34,-6.73,163000,20,770440,0,0,0,0,0,0,49000,114000,-65000,-65000
20200316,06937P,GIS元大98售03,,,,,0.00,0.00,0,0,0,0,0,0,0,0,0,0,0,0,0
20200316,06938P,南電元大98售03,4.95,5.35,4.95,5.25,0.00,0.00,19000,4,97350,0,0,0,0,0,0,0,19000,-19000,-19000
20200316,06939P,國巨永豐98售09,3.87,3.97,3.87,3.97,+0.36,9.97,2000,2,7840,0,0,0,0,0,0,2000,0,2000,2000
20200316,06940P,旺宏永豐98售05,2.34,2.34,2.34,2.34,-0.17,-6.77,2000,1,4680,0,0,0,0,0,0,0,2000,-2000,-2000
20200316,06941P,國巨統一98售07,,,,,0.00,0.00,0,0,0,0,0,0,0,0,0,0,0,0,0
20200316,06942P,台灣50台新02售01,3.12,3.40,3.12,3.40,-0.40,-10.53,13000,7,42350,0,0,0,0,0,0,8000,3000,5000,5000
20200316,06943P,致茂元富98售03,3.24,3.72,3.24,3.72,-0.03,-0.8,78000,12,265600,0,0,0,0,0,0,66000,12000,54000,54000
20200316,06944P,健鼎元富98售02,3.26,3.42,3.14,3.42,+0.11,3.32,72000,6,233140,0,0,0,0,0,0,65000,7000,58000,58000
20200316,06945P,國巨群益99售04,8.30,8.30,8.30,8.30,0.00,0.00,1000,1,8300,0,0,0,0,0,0,0,1000,-1000,-1000
20200316,06946P,T50正2元大9C售01,7.90,8.45,7.80,8.45,+1.55,22.46,90000,9,729500,0,0,0,0,0,0,0,90000,-90000,-90000
20200316,06947P,FBVIX元大01售01,,,,,0.00,0.00,0,0,0,0,0,0,0,0,0,0,0,0,0
20200316,06948P,FBVIX元大01售02,,,,,0.00,0.00,0,0,0,0,0,0,0,0,0,0,0,0,0
20200316,06949P,台表科元大99售01,3.65,4.03,3.65,4.03,+0.05,1.26,26000,5,97220,0,0,0,0,0,0,12000,14000,-2000,-2000
20200316,06950P,鴻海統一9B售02,1.39,1.39,1.39,1.39,+0.11,8.59,1000,1,1390,0,0,0,0,0,0,0,1000,-1000,-1000
20200316,06951P,台積電統一9B售02,1.25,1.48,1.25,1.48,+0.08,5.71,21000,6,27940,0,0,0,0,0,0,7000,12000,-5000,-5000
20200316,06952P,大立光統一9A售03,2.03,2.13,2.03,2.13,-0.12,-5.33,42000,6,89210,0,0,0,0,0,0,0,42000,-42000,-42000
20200316,06953P,景碩統一9A售01,,,,,0.00,0.00,0,0,0,0,0,0,0,0,0,0,0,0,0
20200316,06954P,大立光元富99售01,4.63,5.30,4.63,5.30,+0.49,10.19,65000,5,317020,0,0,0,0,0,0,10000,55000,-45000,-45000
20200316,06955P,臻鼎元富99售01,4.02,4.06,3.71,4.06,+0.17,4.37,160000,6,632000,0,0,0,0,0,0,130000,30000,100000,100000
20200316,06956P,國巨日盛99售04,,,,,0.00,0.00,0,0,0,0,0,0,0,0,0,0,0,0,0
20200316,06957P,FBVIX凱基01售01,0.60,0.61,0.58,0.60,-0.05,-7.69,21000,9,12510,0,0,0,0,0,0,9000,11000,-2000,-2000
20200316,06958P,FBVIX凱基9C售02,0.85,0.85,0.81,0.81,-0.08,-8.99,186000,5,152620,0,0,0,0,0,0,181000,5000,176000,176000
20200316,06959P,鴻海凱基9A售02,2.53,2.64,2.53,2.64,+0.53,25.12,52000,2,131780,0,0,0,0,0,0,0,52000,-52000,-52000
20200316,06960P,國巨凱基99售08,3.60,3.60,3.60,3.60,0.00,0.00,1000,1,3600,0,0,0,0,0,0,1000,0,1000,1000
20200316,06961P,台積電凱基99售05,2.12,2.41,2.06,2.41,+0.35,16.99,1134000,51,2592420,0,0,0,0,0,0,1012000,1097000,-85000,-85000
20200316,06962P,華新科永豐99售01,1.99,2.32,1.95,2.32,+0.17,7.91,102000,6,202910,0,0,0,0,0,0,81000,21000,60000,60000
20200316,06963P,鴻海凱基99售04,2.18,2.38,2.18,2.38,+0.23,10.7,62000,8,138600,0,0,0,0,0,0,59000,62000,-3000,-3000
20200316,06964P,臺股指凱基9B售01,7.10,8.30,6.95,8.30,+1.60,23.88,214000,22,1636100,0,0,0,0,0,0,64000,190000,-126000,-126000
20200316,06965P,台積電台新99售02,2.11,2.74,2.11,2.74,+0.75,37.69,580000,9,1551760,0,0,0,0,0,0,575000,539000,36000,36000
20200316,06966P,健策台新9A售02,2.19,2.40,2.12,2.40,+0.08,3.45,913000,25,2116270,0,0,0,0,0,0,20000,893000,-873000,-873000
20200316,06967P,台郡台新99售02,1.66,1.66,1.66,1.66,-0.13,-7.26,13000,1,21580,0,0,0,0,0,0,0,13000,-13000,-13000
20200316,06968P,元油2X元大99售08,,,,,0.00,0.00,0,0,0,0,0,0,0,0,0,0,0,0,0
20200316,06969P,上銀元大99售02,2.34,2.91,2.34,2.91,+0.54,22.78,56000,9,150570,0,0,0,0,0,0,10000,46000,-36000,-36000
20200316,06970P,旺宏元大99售08,1.45,1.71,1.45,1.71,+0.21,14.0,705000,76,1053480,0,0,0,0,0,0,121000,700000,-579000,-579000
20200316,06971P,台光電元大99售03,1.37,1.44,1.34,1.44,-0.01,-0.69,117000,5,159380,0,0,0,0,0,0,104000,13000,91000,91000
20200316,06972P,聯發科元大99售04,,,,,0.00,0.00,0,0,0,0,0,0,0,0,0,0,0,0,0
20200316,06973P,臺股指元大9A售11,7.90,8.75,7.90,8.75,+0.45,5.42,20000,2,166500,0,0,0,0,0,0,10000,10000,0,0
20200316,06974P,臺股指元大9A售12,9.50,9.70,9.50,9.70,-1.90,-16.38,20000,2,192000,0,0,0,0,0,0,20000,20000,0,0
20200316,06975P,臺股指元大9A售13,,,,,0.00,0.00,0,0,0,0,0,0,0,0,0,0,0,0,0
20200316,06976P,臺股指元大9A售14,,,,,0.00,0.00,0,0,0,0,0,0,0,0,0,0,0,0,0
20200316,06977P,臺股指元大9A售15,5.35,6.60,5.35,6.60,+1.50,29.41,25000,6,152550,0,0,0,0,0,0,2000,23000,-21000,-21000
20200316,06978P,聯發科富邦9B售02,1.52,1.71,1.52,1.71,+0.21,14.0,122000,9,189980,0,0,0,0,0,0,87000,35000,52000,52000
20200316,06979P,台灣50永豐9A售02,,,,,0.00,0.00,0,0,0,0,0,0,0,0,0,0,0,0,0
20200316,06980P,緯穎永豐99售02,1.65,1.76,1.63,1.71,-0.34,-16.59,149000,18,251670,0,0,0,0,0,0,5000,144000,-139000,-139000
20200316,06981P,台灣50麥證99售02,6.20,6.20,6.20,6.20,+1.05,20.39,10000,1,62000,0,10000,-10000,0,0,0,0,10000,-10000,-10000
20200316,06982P,義隆凱基99售02,1.36,1.47,1.34,1.47,+0.07,5.0,188000,10,271890,0,0,0,0,0,0,10000,178000,-168000,-168000
20200316,06983P,台積電國泰9A售02,,,,,0.00,0.00,0,0,0,0,0,0,0,0,0,0,0,0,0
20200316,06984P,上銀富邦9B售01,2.67,2.78,2.67,2.78,+0.06,2.21,158000,7,431690,0,0,0,0,0,0,60000,98000,-38000,-38000
20200316,06985P,華新科富邦9C售02,,,,,0.00,0.00,0,0,0,0,0,0,0,0,0,0,0,0,0
20200316,06986P,台積電台新9A售01,1.98,2.22,1.98,2.22,+0.46,26.14,1008000,3,1998240,0,0,0,0,0,0,1008000,998000,10000,10000
20200316,06987P,鴻海元富99售08,3.69,3.97,3.66,3.97,+0.46,13.11,1757000,32,6652760,0,0,0,0,0,0,1176000,1747000,-571000,-571000
20200316,06988P,鴻海元富99售09,4.43,4.93,4.40,4.84,+0.41,9.26,51000,14,235240,0,0,0,0,0,0,0,51000,-51000,-51000
20200316,06989P,鴻海元富99售10,4.83,4.97,4.83,4.97,+0.88,21.52,50000,8,245210,0,0,0,0,0,0,0,50000,-50000,-50000
20200316,06990P,康友元富99售03,3.63,4.07,3.63,4.07,+0.47,13.06,97000,7,365110,0,0,0,0,0,0,47000,50000,-3000,-3000
20200316,06991P,矽創群益99售01,2.45,2.45,2.45,2.45,+0.01,0.41,4000,1,9800,0,0,0,0,0,0,4000,0,4000,4000
20200316,06992P,玉晶光日盛9B售01,1.51,1.83,1.51,1.83,+0.23,14.37,135000,21,240470,0,0,0,0,0,0,4000,129000,-125000,-125000
20200316,06993P,鴻海凱基99售05,1.91,2.02,1.90,2.02,+0.20,10.99,90000,8,175700,0,0,0,0,0,0,30000,80000,-50000,-50000
20200316,06994P,台光電凱基99售02,1.62,1.71,1.62,1.71,-0.07,-3.93,68000,4,113160,0,0,0,0,0,0,28000,40000,-12000,-12000
20200316,06995P,臺股指凱基99售16,2.91,3.50,2.91,3.50,+0.65,22.81,126000,22,412680,0,0,0,0,0,0,4000,122000,-118000,-118000
20200316,06996P,臺股指凱基99售17,2.19,2.65,2.12,2.65,+0.53,25.0,1527000,165,3492600,0,0,0,0,0,0,912000,1136000,-224000,-224000
20200316,06997P,台灣50中信03售01,2.50,3.30,2.50,3.30,+0.85,34.69,33000,12,90120,0,0,0,0,0,0,4000,21000,-17000,-17000
20200316,06998P,S&P正2中信9B售01,2.54,2.64,2.52,2.61,+0.24,10.13,88000,11,228510,0,0,0,0,0,0,1000,87000,-86000,-86000
20200316,06999P,玉晶光國票9B售01,,,,,0.00,0.00,0,0,0,0,0,0,0,0,0,0,0,0,0
20200316,07000P,T50反1元大99售03,0.70,0.72,0.61,0.61,-0.14,-18.67,592000,25,396690,0,10000,-10000,0,0,0,479000,113000,366000,356000
20200316,07001P,國巨元大99售12,2.09,2.52,2.09,2.52,+0.22,9.57,1081000,117,2452040,0,0,0,0,0,0,652000,1059000,-407000,-407000
20200316,07002P,鴻海兆豐99售04,1.57,1.57,1.57,1.57,+0.21,15.44,10000,1,15700,0,0,0,0,0,0,10000,10000,0,0
20200316,07003P,聯發科兆豐99售02,1.73,1.92,1.73,1.92,+0.37,23.87,22000,3,39990,0,0,0,0,0,0,10000,12000,-2000,-2000
20200316,07004P,大立光兆豐9A售01,1.13,1.43,1.12,1.14,+0.03,2.7,235000,12,294240,0,0,0,0,0,0,135000,115000,20000,20000
20200316,07005P,台積電統一9B售05,1.38,1.43,1.37,1.43,+0.09,6.72,23000,3,32730,0,0,0,0,0,0,23000,0,23000,23000
20200316,07006P,旺宏統一9B售03,1.08,1.28,1.08,1.28,+0.12,10.34,20000,6,23800,0,0,0,0,0,0,10000,10000,0,0
20200316,07007P,台灣50台新01售02,,,,,0.00,0.00,0,0,0,0,0,0,0,0,0,0,0,0,0
20200316,07008P,台郡中信99售02,1.41,1.41,1.38,1.38,-0.10,-6.76,46000,5,64280,0,0,0,0,0,0,46000,0,46000,46000
20200316,07009P,臺股指中信9B售01,2.28,2.82,2.24,2.81,+0.53,23.25,95000,19,241090,0,0,0,0,0,0,7000,17000,-10000,-10000
20200316,07010P,T50正2凱基9C售01,2.87,3.14,2.75,3.14,+0.35,12.54,715000,24,2041110,0,0,0,0,0,0,21000,694000,-673000,-673000
20200316,07011P,宏達電凱基99售02,2.04,2.47,2.02,2.45,+0.31,14.49,494000,18,1046660,0,0,0,0,0,0,0,494000,-494000,-494000
20200316,07012P,智邦群益9A售01,1.30,1.50,1.29,1.45,+0.05,3.57,150000,14,216880,0,0,0,0,0,0,22000,120000,-98000,-98000
20200316,07013P,玉晶光群益9A售06,5.40,5.40,5.40,5.40,-0.35,-6.09,5000,1,27000,0,0,0,0,0,0,0,5000,-5000,-5000
20200316,07014P,華通元大99售04,2.28,2.65,2.24,2.65,+0.20,8.16,203000,24,501950,0,0,0,0,0,0,11000,190000,-179000,-179000
20200316,07015P,國巨元大99售13,2.03,2.36,2.00,2.36,+0.32,15.69,596000,60,1317360,0,5000,-5000,0,0,0,404000,360000,44000,39000
20200316,07016P,聯發科元大99售10,6.75,6.75,6.75,6.75,-0.60,-8.16,20000,2,135000,0,0,0,0,0,0,20000,20000,0,0
20200316,07017P,台灣50元富9B售02,4.26,5.30,4.26,5.30,+1.24,30.54,32000,9,150370,0,0,0,0,0,0,23000,19000,4000,4000
20200316,07018P,台灣50統一9B售01,4.11,4.85,4.11,4.85,0.00,0.00,20000,2,89600,0,0,0,0,0,0,10000,10000,0,0
20200316,07019P,鴻海台新99售01,3.31,3.63,3.31,3.63,+0.04,1.11,2127000,37,7196270,0,0,0,0,0,0,2120000,2127000,-7000,-7000
20200316,07020P,玉晶光台新99售02,2.76,3.16,2.76,3.13,+0.27,9.44,540000,56,1575950,0,0,0,0,0,0,482000,538000,-56000,-56000
20200316,07021P,台積電富邦9C售02,2.70,2.90,2.70,2.90,+0.20,7.41,20000,3,56000,0,0,0,0,0,0,19000,0,19000,19000
20200316,07022P,嘉晶永豐99售02,1.61,1.78,1.57,1.76,+0.14,8.64,177000,16,292760,0,0,0,0,0,0,63000,114000,-51000,-51000
20200316,07023P,南電永豐99售02,,,,,0.00,0.00,0,0,0,0,0,0,0,0,0,0,0,0,0
20200316,07024P,臺股指永豐99售02,,,,,0.00,0.00,0,0,0,0,0,0,0,0,0,0,0,0,0
20200316,07025P,玉晶光凱基99售01,1.81,2.61,1.79,2.61,+0.86,49.14,1798000,83,3434280,0,0,0,0,0,0,200000,1797000,-1597000,-1597000
20200316,07026P,超眾凱基99售03,1.89,2.11,1.82,2.11,+0.22,11.64,430000,13,837600,0,0,0,0,0,0,260000,170000,90000,90000
20200316,07027P,台積電群益99售04,5.20,6.20,5.20,6.20,+0.15,2.48,8000,2,44600,0,0,0,0,0,0,8000,0,8000,8000
20200316,07028P,大立光群益99售06,,,,,0.00,0.00,0,0,0,0,0,0,0,0,0,0,0,0,0
20200316,07029P,緯穎群益99售02,,,,,0.00,0.00,0,0,0,0,0,0,0,0,0,0,0,0,0
20200316,07030P,鈺齊群益99售01,2.29,2.31,2.29,2.31,-0.04,-1.7,20000,2,46000,0,0,0,0,0,0,0,20000,-20000,-20000
20200316,07031P,台灣50中信03售02,1.75,2.10,1.68,2.10,+0.56,36.36,34000,10,66480,0,0,0,0,0,0,5000,4000,1000,1000
20200316,07032P,聯發科統一9C售02,1.28,1.32,1.28,1.32,+0.05,3.94,6000,2,7880,0,0,0,0,0,0,5000,0,5000,5000
20200316,07033P,大立光統一9B售03,,,,,0.00,0.00,0,0,0,0,0,0,0,0,0,0,0,0,0
20200316,07034P,大立光元富99售03,2.89,3.09,2.89,3.09,-0.20,-6.08,80000,5,244600,0,0,0,0,0,0,0,80000,-80000,-80000
20200316,07035P,大立光元富99售04,5.35,5.95,5.35,5.95,+0.15,2.59,55000,6,320250,0,0,0,0,0,0,7000,48000,-41000,-41000
20200316,07036P,台灣50台新9C售01,,,,,0.00,0.00,0,0,0,0,0,0,0,0,0,0,0,0,0
20200316,07037P,台積電台新99售03,2.38,2.62,2.38,2.62,-0.31,-10.58,601000,13,1442620,0,0,0,0,0,0,600000,601000,-1000,-1000
20200316,07038P,華新科台新99售01,2.83,3.29,2.83,3.29,-0.12,-3.52,1245000,11,3970640,0,0,0,0,0,0,1230000,1215000,15000,15000
20200316,07039P,南電台新99售01,2.68,2.76,2.68,2.76,-0.19,-6.44,14000,2,38320,0,0,0,0,0,0,14000,0,14000,14000
20200316,07040P,台灣50元大9C售02,5.30,6.65,5.00,6.65,+1.65,33.0,90000,13,518300,0,0,0,0,0,0,60000,59000,1000,1000
20200316,07041P,T50反1元大9C售01,,,,,0.00,0.00,0,0,0,0,0,0,0,0,0,0,0,0,0
20200316,07042P,T50反1元大9C售02,,,,,0.00,0.00,0,0,0,0,0,0,0,0,0,0,0,0,0
20200316,07043P,國巨元大99售14,5.70,6.80,5.70,6.80,+0.55,8.8,53000,8,344350,0,0,0,0,0,0,45000,48000,-3000,-3000
20200316,07044P,台積電元大99售13,6.85,8.30,6.70,7.90,+1.85,30.58,290000,26,2157000,0,0,0,0,0,0,80000,240000,-160000,-160000
20200316,07045P,上銀國票9A售01,,,,,0.00,0.00,0,0,0,0,0,0,0,0,0,0,0,0,0
20200316,07046P,大立光富邦9C售03,1.22,1.41,1.22,1.40,+0.19,15.7,80000,14,106610,0,0,0,0,0,0,15000,52000,-37000,-37000
20200316,07047P,S&P500中信9B售02,2.26,2.26,2.26,2.26,+0.24,11.88,10000,1,22600,0,0,0,0,0,0,0,10000,-10000,-10000
20200316,07048P,台積電中信03售01,2.25,2.27,2.25,2.27,+0.16,7.58,2000,2,4520,0,0,0,0,0,0,1000,1000,0,0
20200316,07049P,聯發科中信99售03,2.04,2.20,2.04,2.20,-0.20,-8.33,30000,3,63100,0,0,0,0,0,0,20000,20000,0,0
20200316,07050P,宏達電中信9B售01,1.62,1.62,1.62,1.62,+0.22,15.71,5000,1,8100,0,0,0,0,0,0,0,5000,-5000,-5000
20200316,07051P,大立光中信99售02,,,,,0.00,0.00,0,0,0,0,0,0,0,0,0,0,0,0,0
20200316,07052P,臺股指中信9C售02,,,,,0.00,0.00,0,0,0,0,0,0,0,0,0,0,0,0,0
20200316,07053P,台灣50兆豐01售01,2.75,3.19,2.75,3.19,+0.60,23.17,29000,5,83490,0,0,0,0,0,0,24000,0,24000,24000
20200316,07054P,華新科兆豐99售04,2.41,2.78,2.25,2.75,+0.19,7.42,46000,7,112600,0,0,0,0,0,0,10000,30000,-20000,-20000
20200316,07055P,景碩群益9A售02,,,,,0.00,0.00,0,0,0,0,0,0,0,0,0,0,0,0,0
20200316,07056P,臺股指麥證99售02,,,,,0.00,0.00,0,0,0,0,0,0,0,0,0,0,0,0,0
20200316,07057P,大立光康和9B售02,,,,,0.00,0.00,0,0,0,0,0,0,0,0,0,0,0,0,0
20200316,07058P,台積電凱基9A售07,2.81,3.20,2.77,3.20,+0.53,19.85,559000,17,1583700,0,0,0,0,0,0,290000,549000,-259000,-259000
20200316,07059P,華通國票9A售02,,,,,0.00,0.00,0,0,0,0,0,0,0,0,0,0,0,0,0
20200316,07060P,台表科國票9A售01,2.21,2.41,2.21,2.41,+0.25,11.57,40000,19,92460,0,0,0,0,0,0,24000,11000,13000,13000
20200316,07061P,台積電元大99售14,7.60,8.05,7.60,8.05,-0.90,-10.06,60000,6,472000,0,0,0,0,0,0,40000,60000,-20000,-20000
20200316,07062P,台積電元大99售15,2.34,2.87,2.33,2.87,+0.68,31.05,108000,13,279570,0,0,0,0,0,0,80000,88000,-8000,-8000
20200316,07063P,臺股指元大9A售24,9.60,10.70,9.45,10.70,+1.45,15.68,27000,7,259900,0,0,0,0,0,0,21000,6000,15000,15000
20200316,07064P,臺股指元大9A售25,7.95,8.85,7.95,8.85,+0.45,5.36,487000,57,4083950,0,0,0,0,0,0,466000,462000,4000,4000
20200316,07065P,臺股指元大9A售26,13.20,14.80,13.20,14.80,+1.70,12.98,824000,88,11680700,0,0,0,0,0,0,766000,818000,-52000,-52000
20200316,07066P,台灣50台新9B售01,,,,,0.00,0.00,0,0,0,0,0,0,0,0,0,0,0,0,0
20200316,07067P,旺宏台新99售02,1.58,1.85,1.57,1.83,+0.05,2.81,217000,10,365700,0,0,0,0,0,0,2000,215000,-213000,-213000
20200316,07068P,欣興台新99售01,,,,,0.00,0.00,0,0,0,0,0,0,0,0,0,0,0,0,0
20200316,07069P,欣興元富99售02,5.55,5.75,5.55,5.75,+0.55,10.58,39000,4,216650,0,0,0,0,0,0,0,39000,-39000,-39000
20200316,07070P,晶相光元富99售01,3.51,4.03,3.49,4.03,+0.30,8.04,43000,7,156850,0,0,0,0,0,0,23000,20000,3000,3000
20200316,07071P,立積元富99售01,2.28,2.55,2.28,2.55,+0.14,5.81,18000,5,43760,0,0,0,0,0,0,7000,11000,-4000,-4000
20200316,07072P,元油2X凱基9C售01,,,,,0.00,0.00,0,0,0,0,0,0,0,0,0,0,0,0,0
20200316,07073P,臺股指中信9B售02,2.72,3.78,2.72,3.78,+1.22,47.66,79000,11,281860,0,0,0,0,0,0,0,16000,-16000,-16000
20200316,07074P,FBVIX凱基9A售01,1.18,1.18,1.07,1.11,-0.07,-5.93,1408000,73,1538800,0,0,0,0,0,0,454000,246000,208000,208000
20200316,07075P,FBVIX凱基9C售04,0.98,0.98,0.92,0.93,-0.05,-5.1,695000,19,647740,0,0,0,0,0,0,85000,600000,-515000,-515000
20200316,07076P,鴻海凱基9A售08,3.68,3.84,3.68,3.83,0.00,0.00,131000,7,493130,0,0,0,0,0,0,53000,131000,-78000,-78000
20200316,07077P,緯穎凱基99售01,1.44,1.55,1.44,1.54,-0.01,-0.65,298000,17,444440,0,0,0,0,0,0,40000,258000,-218000,-218000
20200316,07078P,鴻海群益99售02,4.12,4.40,4.12,4.40,-0.01,-0.23,3000,2,12640,0,0,0,0,0,0,0,2000,-2000,-2000
20200316,07079P,台積電群益99售06,7.55,8.05,7.55,7.90,-1.35,-14.59,16000,3,126800,0,0,0,0,0,0,0,16000,-16000,-16000
20200316,07080P,健策群益9A售01,,,,,0.00,0.00,0,0,0,0,0,0,0,0,0,0,0,0,0
20200316,07081P,南電群益9A售01,2.07,2.07,2.07,2.07,-0.08,-3.72,3000,2,6210,0,0,0,0,0,0,0,3000,-3000,-3000
20200316,07082P,美律元大99售06,1.45,1.45,1.45,1.45,-0.10,-6.45,10000,1,14500,0,0,0,0,0,0,0,10000,-10000,-10000
20200316,07083P,台積電統一9A售06,1.66,1.66,1.66,1.66,+0.36,27.69,125000,1,207500,0,0,0,0,0,0,125000,0,125000,125000
20200316,07084P,S&P正2元富9B售02,1.73,1.88,1.73,1.88,+0.26,16.05,244000,30,437800,0,0,0,0,0,0,0,236000,-236000,-236000
20200316,07085P,超眾元富9C售01,3.64,3.77,3.64,3.70,-0.09,-2.37,80000,5,298600,0,0,0,0,0,0,0,80000,-80000,-80000
20200316,07086P,力成元富9C售01,,,,,0.00,0.00,0,0,0,0,0,0,0,0,0,0,0,0,0
20200316,07087P,聯發科台新99售02,1.64,2.04,1.64,1.93,+0.40,26.14,1247000,17,2226570,0,0,0,0,0,0,1138000,1107000,31000,31000
20200316,07088P,訊芯永豐99售02,1.40,1.55,1.40,1.55,+0.07,4.73,14000,2,21100,0,0,0,0,0,0,10000,4000,6000,6000
20200316,07089P,臺指2X中信01售01,2.18,2.53,2.18,2.53,0.00,0.00,51000,6,116470,0,0,0,0,0,0,0,51000,-51000,-51000
20200316,07090P,台灣50凱基01售01,5.10,5.85,5.10,5.85,+0.50,9.35,58000,6,332300,0,0,0,0,0,0,8000,50000,-42000,-42000
20200316,07091P,SGBR2X凱基9A售02,,,,,0.00,0.00,0,0,0,0,0,0,0,0,0,0,0,0,0
20200316,07092P,上銀凱基99售03,2.34,2.91,2.34,2.91,+0.34,13.23,282000,11,720160,0,0,0,0,0,0,0,282000,-282000,-282000
20200316,07093P,台積電凱基99售07,2.61,2.77,2.60,2.77,-0.15,-5.14,127000,10,339360,0,0,0,0,0,0,0,127000,-127000,-127000
20200316,07094P,華通國票9A售03,2.20,2.59,2.20,2.59,+0.24,10.21,21000,3,53900,0,0,0,0,0,0,1000,20000,-19000,-19000
20200316,07095P,台灣50元大9C售03,,,,,0.00,0.00,0,0,0,0,0,0,0,0,0,0,0,0,0
20200316,07096P,元石油元大9C售05,,,,,0.00,0.00,0,0,0,0,0,0,0,0,0,0,0,0,0
20200316,07097P,元油2X元大9C售09,,,,,0.00,0.00,0,0,0,0,0,0,0,0,0,0,0,0,0
20200316,07098P,台積電元大99售18,2.13,2.38,2.06,2.38,-0.10,-4.03,70000,7,160000,0,0,0,0,0,0,40000,70000,-30000,-30000
20200316,07099P,台積電元大99售19,5.45,6.50,5.30,6.50,-0.25,-3.7,400000,41,2410000,0,0,0,0,0,0,40000,380000,-340000,-340000
20200316,07100P,華航元大99售01,1.44,1.49,1.44,1.49,+0.11,7.97,500000,52,737250,0,0,0,0,0,0,20000,420000,-400000,-400000
20200316,07101P,台郡元大99售06,1.66,1.76,1.66,1.76,+0.06,3.53,13000,2,21880,0,0,0,0,0,0,10000,13000,-3000,-3000
20200316,07102P,南電元大99售03,4.51,4.51,4.51,4.51,-0.22,-4.65,2000,1,9020,0,0,0,0,0,0,0,2000,-2000,-2000
20200316,07103P,南電元大99售04,4.38,4.81,4.38,4.81,0.00,0.00,15000,2,67850,0,0,0,0,0,0,0,15000,-15000,-15000
20200316,07104P,聯發科元富99售04,2.57,3.21,2.52,3.21,+0.45,16.3,37000,8,106770,0,0,0,0,0,0,36000,1000,35000,35000
20200316,07105P,大毅元富99售02,1.40,1.58,1.40,1.58,+0.04,2.6,53000,10,75620,0,0,0,0,0,0,33000,20000,13000,13000
20200316,07106P,國巨統一9B售05,1.26,1.32,1.26,1.32,-0.07,-5.04,6000,2,7620,0,0,0,0,0,0,0,0,0,0
20200316,07107P,臺股指統一99售07,3.16,3.16,3.16,3.16,-0.10,-3.07,40000,1,126400,0,0,0,0,0,0,40000,0,40000,40000
20200316,07108P,FBVIX台新99售02,0.87,0.87,0.87,0.87,-0.04,-4.4,11000,1,9570,0,0,0,0,0,0,11000,0,11000,11000
20200316,07109P,聯發科中信9B售02,,,,,0.00,0.00,0,0,0,0,0,0,0,0,0,0,0,0,0
20200316,07110P,台灣50群益9B售03,,,,,0.00,0.00,0,0,0,0,0,0,0,0,0,0,0,0,0
20200316,07111P,台積電群益99售08,3.57,4.43,3.57,4.43,0.00,0.00,16000,5,67680,0,0,0,0,0,0,0,16000,-16000,-16000
20200316,07112P,聯發科群益99售05,,,,,0.00,0.00,0,0,0,0,0,0,0,0,0,0,0,0,0
20200316,07113P,台積電兆豐99售03,1.79,2.58,1.79,2.58,+0.75,40.98,2847000,62,6424740,0,0,0,0,0,0,2515000,2764000,-249000,-249000
20200316,07114P,旺宏兆豐9A售01,2.22,2.22,2.22,2.22,0.00,0.00,31000,2,68820,0,0,0,0,0,0,31000,31000,0,0
20200316,07115P,T50反1日盛9C售02,,,,,0.00,0.00,0,0,0,0,0,0,0,0,0,0,0,0,0
20200316,07116P,台灣50麥證9A售02,,,,,0.00,0.00,0,0,0,0,0,0,0,0,0,0,0,0,0
20200316,07117P,SGBR2X凱基9C售01,1.84,1.89,1.84,1.89,0.00,0.00,15000,2,27850,0,0,0,0,0,0,0,15000,-15000,-15000
20200316,07118P,台積電凱基99售09,2.62,3.10,2.57,3.00,+0.29,10.7,3203000,52,8769660,0,0,0,0,0,0,912000,3201000,-2289000,-2289000
20200316,07119P,台積電凱基9A售08,1.14,1.75,1.14,1.65,+0.55,50.0,1460000,47,2063770,0,0,0,0,0,0,170000,1269000,-1099000,-1099000
20200316,07120P,聯發科凱基99售09,3.69,3.74,3.69,3.74,0.00,0.00,953000,4,3537220,0,0,0,0,0,0,0,953000,-953000,-953000
20200316,07121P,華新科凱基99售03,2.07,2.33,2.07,2.33,0.00,0.00,2337000,47,5175820,0,0,0,0,0,0,1145000,2337000,-1192000,-1192000
20200316,07122P,欣興凱基99售05,3.45,3.87,3.43,3.87,0.00,0.00,165000,11,577950,0,0,0,0,0,0,0,165000,-165000,-165000
20200316,07123P,鴻海元大99售23,2.77,3.04,2.77,3.00,0.00,0.00,50000,6,146800,0,0,0,0,0,0,49000,50000,-1000,-1000
20200316,07124P,台積電元大99售21,2.02,2.43,1.98,2.43,+0.34,16.27,231000,36,505750,0,0,0,0,0,0,163000,128000,35000,35000
20200316,07125P,台積電元大99售22,5.05,5.85,5.05,5.85,+0.35,6.36,47000,5,268350,0,0,0,0,0,0,47000,40000,7000,7000
20200316,07126P,台積電元大99售23,2.35,2.63,2.35,2.63,+0.01,0.38,90000,9,225500,0,0,0,0,0,0,70000,90000,-20000,-20000
20200316,07127P,精元元大99售01,3.65,3.65,3.65,3.65,0.00,0.00,10000,1,36500,0,0,0,0,0,0,10000,10000,0,0
20200316,07128P,大毅元大99售04,1.19,1.33,1.18,1.33,+0.14,11.76,71000,10,88120,0,0,0,0,0,0,15000,66000,-51000,-51000
20200316,07129P,華新科元大99售14,,,,,0.00,0.00,0,0,0,0,0,0,0,0,0,0,0,0,0
20200316,07130P,台郡元大9B售01,,,,,0.00,0.00,0,0,0,0,0,0,0,0,0,0,0,0,0
20200316,07131P,緯穎元大99售06,3.97,4.39,3.96,4.39,+0.25,6.04,49000,7,204930,0,0,0,0,0,0,14000,39000,-25000,-25000
20200316,07132P,臺股指元大99售11,,,,,0.00,0.00,0,0,0,0,0,0,0,0,0,0,0,0,0
20200316,07133P,臺股指元大9A售27,6.00,6.10,6.00,6.00,-0.55,-8.4,24000,4,144800,0,0,0,0,0,0,0,24000,-24000,-24000
20200316,07134P,臺股指元大9A售28,4.75,4.75,4.75,4.75,0.00,0.00,5000,1,23750,0,0,0,0,0,0,0,5000,-5000,-5000
20200316,07135P,臺股指元大9A售29,5.80,5.80,5.80,5.80,0.00,0.00,2000,1,11600,0,0,0,0,0,0,0,2000,-2000,-2000
20200316,07136P,T50反1台新01售01,,,,,0.00,0.00,0,0,0,0,0,0,0,0,0,0,0,0,0
20200316,07137P,大立光中信9B售01,,,,,0.00,0.00,0,0,0,0,0,0,0,0,0,0,0,0,0
20200316,07138P,台灣50群益9B售04,6.75,6.80,6.75,6.80,+3.20,88.89,11000,2,74300,0,0,0,0,0,0,0,11000,-11000,-11000
20200316,07139P,元油2X群益9C售06,,,,,0.00,0.00,0,0,0,0,0,0,0,0,0,0,0,0,0
20200316,07140P,台灣50日盛99售01,,,,,0.00,0.00,0,0,0,0,0,0,0,0,0,0,0,0,0
20200316,07141P,台灣50國票9A售03,,,,,0.00,0.00,0,0,0,0,0,0,0,0,0,0,0,0,0
20200316,07142P,台灣50元大01售01,,,,,0.00,0.00,0,0,0,0,0,0,0,0,0,0,0,0,0
20200316,07143P,FBVIX元大99售02,,,,,0.00,0.00,0,0,0,0,0,0,0,0,0,0,0,0,0
20200316,07144P,FBVIX元大99售03,,,,,0.00,0.00,0,0,0,0,0,0,0,0,0,0,0,0,0
20200316,07145P,為升元大99售03,2.11,2.51,2.11,2.51,+0.19,8.19,55000,8,131620,0,0,0,0,0,0,0,55000,-55000,-55000
20200316,07146P,瑞昱元大99售02,3.21,3.31,3.15,3.31,+1.02,44.54,170000,18,553000,0,0,0,0,0,0,0,170000,-170000,-170000
20200316,07147P,高鐵元大99售01,,,,,0.00,0.00,0,0,0,0,0,0,0,0,0,0,0,0,0
20200316,07148P,富邦金元大99售01,3.34,3.62,3.34,3.62,+1.18,48.36,27000,5,93140,0,0,0,0,0,0,0,27000,-27000,-27000
20200316,07149P,健鼎元大99售03,,,,,0.00,0.00,0,0,0,0,0,0,0,0,0,0,0,0,0
20200316,07150P,和碩元大99售01,,,,,0.00,0.00,0,0,0,0,0,0,0,0,0,0,0,0,0
20200316,07151P,台灣50統一9B售04,,,,,0.00,0.00,0,0,0,0,0,0,0,0,0,0,0,0,0
20200316,07152P,臺股指元富99售08,,,,,0.00,0.00,0,0,0,0,0,0,0,0,0,0,0,0,0
20200316,07153P,臺股指元富99售09,,,,,0.00,0.00,0,0,0,0,0,0,0,0,0,0,0,0,0
20200316,07154P,台灣50群益94售01,0.04,0.11,0.04,0.11,+0.08,266.67,601000,18,56450,0,0,0,0,0,0,0,0,0,0
20200316,07155P,臺股指元富99售10,,,,,0.00,0.00,0,0,0,0,0,0,0,0,0,0,0,0,0
20200316,07156P,臺股指元富99售11,,,,,0.00,0.00,0,0,0,0,0,0,0,0,0,0,0,0,0
20200316,07157P,臺股指元富99售12,,,,,0.00,0.00,0,0,0,0,0,0,0,0,0,0,0,0,0
20200316,07158P,FBVIX國泰9C售01,,,,,0.00,0.00,0,0,0,0,0,0,0,0,0,0,0,0,0
20200316,07159P,台積電永豐99售04,1.51,1.52,1.49,1.49,+0.45,43.27,32000,4,48180,0,0,0,0,0,0,0,32000,-32000,-32000
20200316,07240P,台灣50台新94售01,0.08,0.50,0.08,0.50,+0.32,177.78,119000,5,55740,0,0,0,0,0,0,111000,0,111000,111000
20200316,07480P,FBVIX凱基94售01,0.15,0.15,0.09,0.11,-0.04,-26.67,800000,35,90440,0,0,0,0,0,0,0,290000,-290000,-290000
20200316,07554P,玉晶光元大9A售06,,,,,0.00,0.00,0,0,0,0,0,0,0,0,0,0,0,0,0
20200316,07866P,上証2X國票97售01,0.12,0.12,0.12,0.12,+0.05,71.43,5000,1,600,0,0,0,0,0,0,0,0,0,0
20200316,08070P,晶技國泰9C售02,,,,,0.00,0.00,0,0,0,0,0,0,0,0,0,0,0,0,0
20200316,08100P,台灣50元富95售01,0.22,0.27,0.20,0.27,+0.07,35.0,537000,26,124240,0,0,0,0,0,0,10000,90000,-80000,-80000
20200316,08163P,T50正2中信95售01,0.33,0.45,0.33,0.45,+0.27,150.0,47000,7,16030,0,0,0,0,0,0,0,46000,-46000,-46000
20200316,08164P,滬深2X中信95售04,0.03,0.06,0.03,0.06,0.00,0.00,110000,3,4800,0,0,0,0,0,0,60000,0,60000,60000
20200316,08213P,台光電統一9B售03,,,,,0.00,0.00,0,0,0,0,0,0,0,0,0,0,0,0,0
20200316,08217P,T50反1凱基96售02,,,,,0.00,0.00,0,0,0,0,0,0,0,0,0,0,0,0,0
20200316,08218P,滬深2X凱基96售01,0.54,0.68,0.53,0.68,+0.18,36.0,106000,8,62430,0,0,0,0,0,0,40000,50000,-10000,-10000
20200316,08416P,T50反1元大9C售07,,,,,0.00,0.00,0,0,0,0,0,0,0,0,0,0,0,0,0
20200316,08447P,緯穎永豐9C售02,0.26,0.31,0.26,0.31,+0.06,24.0,677000,17,181710,0,0,0,0,0,0,160000,0,160000,160000
20200316,08484P,台灣50中信96售01,0.58,0.80,0.57,0.71,+0.13,22.41,880000,26,554470,0,0,0,0,0,0,150000,0,150000,150000
20200316,08506P,台灣50中信96售02,0.31,0.50,0.31,0.50,-0.01,-1.96,34000,3,15290,0,0,0,0,0,0,9000,0,9000,9000
20200316,08519P,台灣50元大9C售46,,,,,0.00,0.00,0,0,0,0,0,0,0,0,0,0,0,0,0
20200316,08525P,台灣50凱基96售02,0.43,0.43,0.43,0.43,+0.04,10.26,11000,1,4730,0,0,0,0,0,0,11000,0,11000,11000
20200316,08539P,元油2X國票99售01,3.18,3.28,3.18,3.22,+0.22,7.33,17000,3,54960,0,0,0,0,0,0,12000,0,12000,12000
20200316,08570P,台灣50凱基96售03,0.22,0.30,0.22,0.30,+0.13,76.47,238000,26,60050,0,0,0,0,0,0,0,238000,-238000,-238000
20200316,08591P,台光電凱基9C售02,,,,,0.00,0.00,0,0,0,0,0,0,0,0,0,0,0,0,0
20200316,08592P,聯發科凱基01售06,0.01,0.01,0.01,0.01,0.00,0.00,150000,1,1500,0,0,0,0,0,0,0,0,0,0
20200316,08599P,台表科元大9C售11,,,,,0.00,0.00,0,0,0,0,0,0,0,0,0,0,0,0,0
20200316,08602P,台灣50凱基96售04,0.76,1.25,0.73,1.05,+0.51,94.44,1217000,124,1080870,0,0,0,0,0,0,1070000,995000,75000,75000
20200316,08609P,世紀鋼永豐9C售03,0.50,0.50,0.20,0.22,-0.33,-60.0,339000,39,76300,0,0,0,0,0,0,0,320000,-320000,-320000
20200316,08612P,嘉晶凱基9C售03,,,,,0.00,0.00,0,0,0,0,0,0,0,0,0,0,0,0,0
20200316,08613P,同欣電凱基9C售04,,,,,0.00,0.00,0,0,0,0,0,0,0,0,0,0,0,0,0
20200316,08614P,聯發科統一9C售18,,,,,0.00,0.00,0,0,0,0,0,0,0,0,0,0,0,0,0
20200316,08617P,緯創元富9C售03,,,,,0.00,0.00,0,0,0,0,0,0,0,0,0,0,0,0,0
20200316,08625P,台灣50凱基96售05,0.90,1.43,0.80,1.39,+0.64,85.33,1283000,122,1267870,0,0,0,0,0,0,1070000,1097000,-27000,-27000
20200316,08631P,臺股指麥證9C售06,,,,,0.00,0.00,0,0,0,0,0,0,0,0,0,0,0,0,0
20200316,08637P,台灣50中信96售03,1.29,1.60,1.22,1.60,+0.46,40.35,1471000,101,2088790,0,0,0,0,0,0,0,20000,-20000,-20000
20200316,08653P,台灣50凱基96售07,1.30,1.98,0.91,1.54,+0.31,25.2,158000,13,186150,0,0,0,0,0,0,153000,0,153000,153000
20200316,08663P,台灣50元大96售01,1.19,1.85,0.96,1.85,+1.05,131.25,573000,22,751250,0,0,0,0,0,0,235000,0,235000,235000
20200316,08671P,友訊國票01售01,0.29,0.40,0.29,0.40,+0.23,135.29,32000,2,12690,0,0,0,0,0,0,0,0,0,0
20200316,08672P,聯發科統一01售09,0.30,0.30,0.30,0.30,+0.02,7.14,5000,1,1500,0,0,0,0,0,0,0,0,0,0
20200316,08674P,嘉晶元富07售02,1.16,1.84,1.07,1.80,+0.80,80.0,630000,38,1058390,0,0,0,0,0,0,519000,0,519000,519000
20200316,08679P,台灣50元大01售15,0.45,1.21,0.45,1.09,+0.64,142.22,2564000,250,2106840,0,0,0,0,0,0,1990000,1796000,194000,194000
20200316,08703P,華碩凱基01售02,0.22,0.28,0.22,0.28,+0.06,27.27,162000,5,43640,0,0,0,0,0,0,100000,62000,38000,38000
20200316,08714P,華碩元富01售03,0.73,1.07,0.68,0.98,+0.44,81.48,2016000,204,1643630,0,0,0,0,0,0,1913000,1823000,90000,90000
20200316,08749P,鴻海台新01售02,,,,,0.00,0.00,0,0,0,0,0,0,0,0,0,0,0,0,0
20200316,08750P,台灣50群益01售04,0.01,0.01,0.01,0.01,0.00,0.00,10000,10,100,0,0,0,0,0,0,0,0,0,0
20200316,08751P,友達群益01售01,,,,,0.00,0.00,0,0,0,0,0,0,0,0,0,0,0,0,0
20200316,08795P,聯發科凱基01售11,0.36,0.36,0.33,0.35,+0.04,12.9,213000,4,74590,0,0,0,0,0,0,0,10000,-10000,-10000
20200316,08801P,聯發科元大01售13,0.19,0.19,0.17,0.17,+0.01,6.25,401000,2,68190,0,0,0,0,0,0,401000,0,401000,401000
20200316,08818P,台灣50元大97售01,0.51,0.86,0.45,0.85,+0.34,66.67,2538000,190,1776630,0,5000,-5000,0,0,0,1000,0,1000,-4000
20200316,08852P,台灣50台新01售01,1.20,1.56,1.15,1.55,+0.33,27.05,919000,46,1277850,0,0,0,0,0,0,537000,1000,536000,536000
20200316,08859P,大立光元富94售02,,,,,0.00,0.00,0,0,0,0,0,0,0,0,0,0,0,0,0
20200316,08864P,台積電中信95售03,0.03,0.03,0.03,0.03,+0.01,50.0,7000,2,210,0,0,0,0,0,0,0,7000,-7000,-7000
20200316,08865P,台積電中信95售04,0.01,0.03,0.01,0.03,+0.01,50.0,850000,10,20000,0,0,0,0,0,0,0,0,0,0
20200316,08897P,鴻海凱基94售02,0.33,0.57,0.33,0.57,+0.23,67.65,220000,17,91600,0,0,0,0,0,0,70000,150000,-80000,-80000
20200316,08966P,臻鼎元富94售02,0.50,0.70,0.50,0.70,+0.15,27.27,63000,5,32900,0,0,0,0,0,0,54000,9000,45000,45000
20200316,08986P,上銀凱基93售02,,,,,0.00,0.00,0,0,0,0,0,0,0,0,0,0,0,0,0
20200316,08994P,臺股指統一93售01,,,,,0.00,0.00,0,0,0,0,0,0,0,0,0,0,0,0,0
20200316,08995P,臺股指統一93售02,0.53,1.20,0.53,1.20,-0.24,-16.67,25000,5,18210,0,0,0,0,0,0,20000,0,20000,20000
20200316,08998P,台灣50國泰93售01,0.05,0.23,0.05,0.22,+0.04,22.22,462000,8,99780,0,0,0,0,0,0,462000,0,462000,462000
20200316,1101,台泥,40.25,40.25,38.85,38.85,-1.40,-3.48,20548943,7705,811674382,5642000,14196909,-8554909,29000,22000,7000,1767000,644000,1123000,-7424909
20200316,1101B,台泥乙特,51.90,53.80,51.90,53.80,-0.10,-0.19,99074,54,5267844,0,0,0,0,0,0,18000,21000,-3000,-3000
20200316,1102,亞泥,41.00,41.00,39.80,39.80,-1.20,-2.93,13706288,5530,548372466,6081960,11077431,-4995471,308000,15000,293000,1689000,334000,1355000,-3347471
20200316,1103,嘉泥,16.25,16.60,15.80,15.80,-0.50,-3.07,1932469,1192,31016963,609000,843000,-234000,0,16000,-16000,0,215000,-215000,-465000
20200316,1104,環泥,16.00,16.00,15.50,15.70,-0.30,-1.88,785184,378,12282130,103000,171000,-68000,0,2000,-2000,0,0,0,-70000
20200316,1108,幸福,6.59,6.60,6.46,6.46,-0.15,-2.27,114000,49,744590,1000,18000,-17000,0,0,0,0,0,0,-17000
20200316,1109,信大,15.40,15.40,14.65,14.70,-0.80,-5.16,806400,388,12124310,71000,355000,-284000,0,5000,-5000,2000,3000,-1000,-290000
20200316,1110,東泥,15.60,15.60,15.20,15.50,-0.25,-1.59,37000,19,571700,0,1000,-1000,0,0,0,0,0,0,-1000
20200316,1201,味全,18.60,18.75,17.85,17.90,-0.70,-3.76,1990618,992,36267824,258000,451000,-193000,0,0,0,4000,15000,-11000,-204000
20200316,1203,味王,25.65,25.65,25.20,25.35,-0.30,-1.17,170258,97,4313817,1000,23000,-22000,0,0,0,0,0,0,-22000
20200316,1210,大成,36.00,36.50,35.50,35.80,-0.20,-0.56,3243789,1734,116804891,395000,1415000,-1020000,0,5000,-5000,2000,153000,-151000,-1176000
20200316,1213,大飲,5.01,5.35,5.00,5.35,-0.10,-1.83,38002,16,196290,0,0,0,0,0,0,0,0,0,0
20200316,1215,卜蜂,56.40,56.40,53.50,53.50,-0.90,-1.65,1282466,975,69984582,161000,323000,-162000,0,2000,-2000,0,32000,-32000,-196000
20200316,1216,統一,67.60,68.20,66.00,66.30,-1.90,-2.79,15121759,6300,1011918374,8555080,11939321,-3384241,105000,16000,89000,41000,508000,-467000,-3762241
20200316,1217,愛之味,6.20,6.26,6.16,6.16,+0.01,0.16,2471719,853,15300561,237000,369000,-132000,0,0,0,0,0,0,-132000
20200316,1218,泰山,21.45,21.50,20.40,20.50,-0.55,-2.61,982637,548,20614366,129000,332000,-203000,0,0,0,0,0,0,-203000
20200316,1219,福壽,17.50,17.90,17.50,17.90,0.00,0.00,71228,56,1260901,3000,11000,-8000,0,0,0,0,0,0,-8000
20200316,1220,台榮,9.79,9.80,9.53,9.78,-0.02,-0.2,103000,51,997150,0,6000,-6000,0,0,0,0,5000,-5000,-11000
20200316,1225,福懋油,29.25,30.50,28.85,30.40,-0.15,-0.49,115312,106,3442631,9000,21000,-12000,0,0,0,0,0,0,-12000
20200316,1227,佳格,56.60,56.70,54.00,54.20,-2.50,-4.41,2117158,1716,116422199,1108000,1181465,-73465,1000,7000,-6000,1000,136000,-135000,-214465
20200316,1229,聯華,34.00,34.00,33.10,33.20,-0.80,-2.35,2999622,1967,100314114,443000,511000,-68000,2000,11000,-9000,0,151000,-151000,-228000
20200316,1231,聯華食,36.40,36.40,35.50,35.50,-0.90,-2.47,440792,350,15788152,38000,84000,-46000,0,0,0,0,0,0,-46000
20200316,1232,大統益,110.00,110.00,105.50,106.00,-4.00,-3.64,310438,338,33203304,28000,38000,-10000,0,1000,-1000,0,0,0,-11000
20200316,1233,天仁,34.70,35.00,33.90,34.05,-0.65,-1.87,62123,60,2125056,2000,11000,-9000,0,0,0,0,0,0,-9000
20200316,1234,黑松,30.95,30.95,29.90,29.90,-1.10,-3.55,118452,81,3583460,2000,25000,-23000,0,0,0,0,0,0,-23000
20200316,1235,興泰,25.70,25.70,23.40,23.70,+0.20,0.85,25507,21,636363,0,0,0,0,0,0,0,1000,-1000,-1000
20200316,1236,宏亞,11.75,11.75,11.30,11.30,-0.30,-2.59,36000,16,415600,0,0,0,0,0,0,0,1000,-1000,-1000
20200316,1256,鮮活果汁-KY,182.50,182.50,176.00,182.50,0.00,0.00,150281,221,26927830,42000,37250,4750,0,0,0,0,0,0,4750
20200316,1301,台塑,80.70,81.00,78.00,78.20,-2.40,-2.98,11464248,6300,909920137,3460000,7269553,-3809553,24000,23000,1000,152000,688000,-536000,-4344553
20200316,1303,南亞,61.50,61.50,58.60,58.80,-2.60,-4.23,11753137,5760,699468480,4075000,8405631,-4330631,29000,18000,11000,28000,618000,-590000,-4909631
20200316,1304,台聚,10.25,10.25,9.98,10.00,-0.45,-4.31,2053173,734,20709190,155000,638000,-483000,0,7000,-7000,0,0,0,-490000
20200316,1305,華夏,16.75,16.75,15.25,15.50,-1.10,-6.63,2628836,1251,41950464,387000,454000,-67000,0,2000,-2000,0,3000,-3000,-72000
20200316,1307,三芳,18.15,18.20,17.50,17.50,-0.65,-3.58,402980,205,7200390,17000,62000,-45000,0,0,0,0,0,0,-45000
20200316,1308,亞聚,14.20,14.20,13.50,13.65,-0.35,-2.5,2031877,1017,27973839,283000,220000,63000,0,0,0,0,12000,-12000,51000
20200316,1309,台達化,8.40,8.40,7.96,8.01,-0.30,-3.61,1233209,409,10003396,105000,320000,-215000,0,0,0,0,0,0,-215000
20200316,1310,台苯,15.50,15.50,14.50,14.60,-0.95,-6.11,4352363,1899,64471025,300000,1500000,-1200000,0,9000,-9000,4000,142000,-138000,-1347000
20200316,1312,國喬,13.00,13.25,12.75,12.95,+0.10,0.78,6581255,2173,85545865,2496000,1458000,1038000,0,3000,-3000,8000,34000,-26000,1009000
20200316,1312A,國喬特,,,,,0.00,0.00,0,0,0,0,0,0,0,0,0,0,0,0,0
20200316,1313,聯成,8.21,8.44,8.11,8.23,+0.07,0.86,2577919,869,21356188,377000,589000,-212000,0,6000,-6000,0,0,0,-218000
20200316,1314,中石化,7.00,7.04,6.85,6.92,-0.13,-1.84,18257393,4544,126239789,1802000,4087000,-2285000,8000,0,8000,25000,972000,-947000,-3224000
20200316,1315,達新,43.95,44.40,42.35,42.35,-1.65,-3.75,722782,365,31305963,58000,161000,-103000,0,2000,-2000,0,0,0,-105000
20200316,1316,上曜,9.90,9.92,9.02,9.05,-0.85,-8.59,1429787,591,13399778,241000,218000,23000,0,0,0,0,8000,-8000,15000
20200316,1319,東陽,33.40,33.60,31.55,31.55,-1.75,-5.26,2087662,1410,67387962,337000,742000,-405000,0,2000,-2000,13000,95000,-82000,-489000
20200316,1321,大洋,25.25,25.25,23.50,24.05,-1.30,-5.13,449000,173,10941600,34000,84000,-50000,0,0,0,5000,10000,-5000,-55000
20200316,1323,永裕,30.00,30.95,29.05,29.95,-0.05,-0.17,288047,162,8480935,3000,45000,-42000,0,0,0,0,1000,-1000,-43000
20200316,1324,地球,7.78,8.20,7.78,7.98,+0.20,2.57,61002,22,487976,0,0,0,0,0,0,0,0,0,0
20200316,1325,恆大,36.00,38.10,36.00,38.10,+3.45,9.96,15617790,6784,586636520,1731000,505000,1226000,0,0,0,28000,0,28000,1254000
20200316,1326,台化,72.30,72.30,69.10,69.20,-3.10,-4.29,13046155,6670,912455976,2546000,9303248,-6757248,116000,16000,100000,623000,600000,23000,-6634248
20200316,1337,再生-KY,3.84,3.99,3.79,3.86,+0.04,1.05,608316,350,2347314,13000,18000,-5000,0,0,0,4000,6000,-2000,-7000
20200316,1338,廣華-KY,43.65,45.00,41.05,41.15,-2.40,-5.51,272205,215,11519260,119000,48000,71000,0,0,0,2000,0,2000,73000
20200316,1339,昭輝,38.10,39.10,35.70,35.85,-3.15,-8.08,350000,270,13129850,68000,100000,-32000,0,0,0,1000,15000,-14000,-46000
20200316,1340,勝悅-KY,10.00,10.00,9.21,9.35,-0.65,-6.5,439324,357,4153588,30000,72000,-42000,0,0,0,0,1000,-1000,-43000
20200316,1341,富林-KY,56.50,59.50,56.50,59.50,+3.00,5.31,2026,28,117534,0,0,0,0,0,0,0,0,0,0
20200316,1402,遠東新,23.80,23.85,23.05,23.25,-0.65,-2.72,13209678,5425,308200817,3724000,6512439,-2788439,12000,1746000,-1734000,486000,599000,-113000,-4635439
20200316,1409,新纖,10.30,10.45,10.00,10.05,-0.30,-2.9,3743029,1037,38335940,375000,801000,-426000,0,0,0,1000000,222000,778000,352000
20200316,1410,南染,29.50,29.50,27.85,27.85,-0.45,-1.59,56750,22,1587609,40000,2000,38000,0,0,0,0,0,0,38000
20200316,1413,宏洲,7.15,7.22,7.10,7.10,0.00,0.00,133800,53,958216,6000,0,6000,0,0,0,0,0,0,6000
20200316,1414,東和,5.65,5.75,5.64,5.64,-0.10,-1.74,284016,120,1614265,5000,25000,-20000,0,0,0,0,13000,-13000,-33000
20200316,1416,廣豐,11.15,11.25,10.40,10.90,-0.25,-2.24,451333,249,5006377,0,43000,-43000,0,0,0,0,1000,-1000,-44000
20200316,1417,嘉裕,8.53,8.53,8.10,8.18,-0.35,-4.1,233426,238,1929125,10000,23000,-13000,0,0,0,0,0,0,-13000
20200316,1418,東華,6.17,6.58,6.17,6.58,+0.17,2.65,5397,26,33581,0,0,0,0,0,0,1000,0,1000,1000
20200316,1419,新紡,38.35,38.90,37.80,38.90,+0.55,1.43,4000,4,153400,0,1000,-1000,0,0,0,0,0,0,-1000
20200316,1423,利華,8.67,9.29,8.67,9.08,-0.32,-3.4,227023,86,2025837,5000,9000,-4000,0,0,0,0,0,0,-4000
20200316,1432,大魯閣,4.70,4.73,4.51,4.51,-0.17,-3.63,171425,65,792851,0,8000,-8000,0,0,0,0,1000,-1000,-9000
20200316,1434,福懋,30.00,30.10,29.25,29.60,+0.80,2.78,4343254,2514,129286709,981000,1841000,-860000,5000,0,5000,0,260000,-260000,-1115000
20200316,1435,中福,7.01,7.28,6.80,6.94,-0.20,-2.8,860046,256,6047102,347000,56000,291000,0,0,0,0,0,0,291000
20200316,1436,華友聯,36.85,37.40,36.35,36.90,-0.95,-2.51,38135,34,1407081,2000,9000,-7000,0,0,0,0,0,0,-7000
20200316,1437,勤益控,19.75,19.75,18.75,18.75,-1.00,-5.06,493274,190,9350586,58000,51000,7000,0,0,0,0,4000,-4000,3000
20200316,1438,裕豐,10.90,10.90,10.10,10.10,0.00,0.00,29762,13,314158,0,0,0,0,0,0,0,0,0,0
20200316,1439,中和,31.35,31.55,30.25,30.40,-1.30,-4.1,489546,186,15164120,325000,91000,234000,0,0,0,0,0,0,234000
20200316,1440,南紡,8.72,8.76,8.47,8.47,-0.24,-2.76,1951159,744,16821415,556000,441000,115000,0,0,0,0,18000,-18000,97000
20200316,1441,大東,7.40,7.80,6.90,7.02,-0.36,-4.88,264005,153,1900103,6000,13000,-7000,0,0,0,0,0,0,-7000
20200316,1442,名軒,15.90,15.90,15.30,15.60,-0.45,-2.8,439843,188,6854141,4000,167000,-163000,0,16000,-16000,0,8000,-8000,-187000
20200316,1443,立益,8.90,9.08,8.56,8.95,-0.02,-0.22,438007,78,3841626,1000,18000,-17000,0,0,0,0,0,0,-17000
20200316,1444,力麗,7.34,7.34,7.12,7.18,-0.15,-2.05,1712315,598,12408266,368000,407000,-39000,0,0,0,0,5000,-5000,-44000
20200316,1445,大宇,6.69,6.69,6.40,6.50,+0.08,1.25,49993,27,328104,1000,5000,-4000,0,0,0,0,1000,-1000,-5000
20200316,1446,宏和,24.20,24.45,22.50,22.90,-1.35,-5.57,544420,241,12649552,78000,57000,21000,0,0,0,0,5000,-5000,16000
20200316,1447,力鵬,5.43,5.43,5.22,5.27,-0.13,-2.41,1685113,414,8961332,40000,266000,-226000,0,0,0,0,13000,-13000,-239000
20200316,1449,佳和,11.50,11.50,10.20,10.30,-0.40,-3.74,631967,262,6716406,46000,164000,-118000,0,0,0,0,0,0,-118000
20200316,1451,年興,18.00,18.00,17.70,17.75,-0.60,-3.27,204068,156,3638457,1000,35000,-34000,0,0,0,0,0,0,-34000
20200316,1452,宏益,17.80,17.80,16.90,16.95,-0.50,-2.87,500243,345,8624911,12000,114000,-102000,0,0,0,0,0,0,-102000
20200316,1453,大將,7.00,7.00,6.90,6.98,-0.11,-1.55,32542,29,225977,0,1000,-1000,0,0,0,0,0,0,-1000
20200316,1454,台富,6.85,6.85,6.67,6.74,-0.04,-0.59,175576,61,1180724,2000,20000,-18000,0,0,0,0,0,0,-18000
20200316,1455,集盛,5.57,5.57,5.25,5.25,-0.32,-5.75,1986819,457,10628281,155000,298000,-143000,0,0,0,0,3000,-3000,-146000
20200316,1456,怡華,7.67,7.67,6.82,6.83,-0.74,-9.78,73689,29,520175,0,0,0,0,0,0,0,0,0,0
20200316,1457,宜進,11.55,11.60,10.40,10.70,-0.80,-6.96,1088113,413,11920198,191000,141000,50000,0,0,0,0,0,0,50000
20200316,1459,聯發,6.18,6.19,6.03,6.10,-0.10,-1.61,87035,28,536752,0,2000,-2000,0,0,0,0,0,0,-2000
20200316,1460,宏遠,6.09,6.16,5.70,5.90,-0.17,-2.8,1349782,532,8052762,188000,245000,-57000,0,0,0,0,0,0,-57000
20200316,1463,強盛,11.20,11.30,11.10,11.10,-0.10,-0.89,242878,123,2721783,2000,41000,-39000,0,0,0,3000,1000,2000,-37000
20200316,1464,得力,19.65,20.00,19.00,19.05,-0.40,-2.06,1728948,723,33636900,178000,398000,-220000,0,7000,-7000,1000,0,1000,-226000
20200316,1465,偉全,14.10,14.75,14.10,14.45,+0.35,2.48,300441,134,4312148,121000,24000,97000,0,0,0,0,0,0,97000
20200316,1466,聚隆,6.48,6.48,6.19,6.25,-0.23,-3.55,253434,71,1588339,1000,20000,-19000,0,0,0,2000,1000,1000,-18000
20200316,1467,南緯,6.47,7.12,6.34,7.11,+0.63,9.72,1657976,351,11608727,0,52000,-52000,0,0,0,0,0,0,-52000
20200316,1468,昶和,9.08,9.08,9.00,9.00,+0.12,1.35,11000,9,99680,0,0,0,0,0,0,0,0,0,0
20200316,1470,大統新創,18.30,18.30,18.30,18.30,0.00,0.00,2000,2,36600,0,0,0,0,0,0,0,0,0,0
20200316,1471,首利,1.63,1.70,1.63,1.70,-0.05,-2.86,36843,56,61580,0,0,0,0,0,0,0,0,0,0
20200316,1472,三洋紡,17.40,17.40,17.40,17.40,-1.90,-9.84,117073,49,2037069,0,0,0,0,0,0,0,0,0,0
20200316,1473,台南,24.20,25.30,24.20,24.60,+0.85,3.58,662000,324,16405800,34000,249000,-215000,0,0,0,0,1000,-1000,-216000
20200316,1474,弘裕,8.09,8.83,8.01,8.83,+0.80,9.96,678000,216,5856070,1000,20000,-19000,0,0,0,1000,2000,-1000,-20000
20200316,1475,本盟,7.28,7.28,7.00,7.00,+0.29,4.32,5000,4,35810,0,0,0,0,0,0,0,0,0,0
20200316,1476,儒鴻,275.50,280.50,262.00,263.50,-18.50,-6.56,2145334,1976,578475510,1214000,585204,628796,1000,81000,-80000,16000,111571,-95571,453225
20200316,1477,聚陽,120.00,120.00,110.50,113.50,-6.50,-5.42,3603893,2548,411444195,421000,1619159,-1198159,0,1000,-1000,484000,100000,384000,-815159
20200316,1503,士電,40.00,40.20,40.00,40.05,+0.55,1.39,318059,132,12732760,32000,38000,-6000,0,0,0,0,39000,-39000,-45000
20200316,1504,東元,24.20,24.85,24.20,24.50,-0.15,-0.61,9685553,2281,238160854,1186000,8319000,-7133000,4000,4000,0,501000,281000,220000,-6913000
20200316,1506,正道,10.95,11.05,9.65,10.55,-0.05,-0.47,78011,47,811760,0,3000,-3000,0,0,0,0,0,0,-3000
20200316,1507,永大,56.00,56.20,53.70,56.00,+0.60,1.08,142300,149,7835000,89000,38000,51000,0,0,0,0,20000,-20000,31000
20200316,1512,瑞利,3.26,3.45,3.25,3.25,-0.20,-5.8,76001,47,251340,0,17000,-17000,0,0,0,0,0,0,-17000
20200316,1513,中興電,22.30,22.95,22.05,22.20,-0.15,-0.67,3841475,1297,85812089,358000,786000,-428000,0,4000,-4000,18000,34000,-16000,-448000
20200316,1514,亞力,16.70,16.75,15.80,15.85,-0.95,-5.65,2137591,975,34713120,120000,741000,-621000,0,0,0,0,10000,-10000,-631000
20200316,1515,力山,45.50,47.75,45.00,45.60,+0.70,1.56,3391003,1986,157383991,1438000,468000,970000,0,0,0,31000,25000,6000,976000
20200316,1516,川飛,14.50,14.95,14.40,14.40,-0.20,-1.37,63193,53,921956,5000,7000,-2000,0,0,0,0,0,0,-2000
20200316,1517,利奇,7.43,7.48,7.09,7.24,-0.63,-8.01,442520,158,3204323,0,43000,-43000,0,0,0,0,0,0,-43000
20200316,1519,華城,25.60,25.80,24.00,24.20,-1.20,-4.72,1718209,892,42890977,161000,485000,-324000,0,50000,-50000,0,0,0,-374000
20200316,1521,大億,57.20,57.50,56.70,56.70,-0.30,-0.53,57582,61,3289174,0,6000,-6000,0,0,0,0,0,0,-6000
20200316,1522,堤維西,20.10,20.30,19.20,19.40,-0.55,-2.76,777762,390,15314535,132000,217000,-85000,0,4000,-4000,0,3000,-3000,-92000
20200316,1524,耿鼎,8.08,8.09,7.93,7.94,-0.03,-0.38,249016,93,1994000,2000,11000,-9000,0,0,0,0,0,0,-9000
20200316,1525,江申,43.30,43.30,40.05,41.95,-0.15,-0.36,45308,47,1882518,0,2000,-2000,0,0,0,0,0,0,-2000
20200316,1526,日馳,15.25,15.90,15.25,15.35,+0.10,0.66,389280,267,6020680,90000,63000,27000,0,0,0,0,5000,-5000,22000
20200316,1527,鑽全,40.90,41.20,39.10,39.20,-1.20,-2.97,935591,710,37388451,106000,415000,-309000,0,4000,-4000,0,0,0,-313000
20200316,1528,恩德,6.31,6.35,5.95,6.23,-0.07,-1.11,582598,422,3556203,7000,11000,-4000,0,0,0,0,13000,-13000,-17000
20200316,1529,樂士,13.75,13.90,12.40,13.05,-0.70,-5.09,101695,62,1349013,0,5000,-5000,0,0,0,11000,0,11000,6000
20200316,1530,亞崴,27.20,27.80,27.05,27.05,-0.15,-0.55,17380,11,474322,0,0,0,0,0,0,0,0,0,0
20200316,1531,高林股,11.40,11.40,10.50,11.00,0.00,0.00,266000,123,2904400,0,90000,-90000,0,0,0,0,0,0,-90000
20200316,1532,勤美,24.70,24.80,24.20,24.30,+0.10,0.41,530085,270,12988160,89000,98000,-9000,0,0,0,0,0,0,-9000
20200316,1533,車王電,26.00,26.00,24.55,25.05,-0.90,-3.47,100080,91,2541903,14000,38000,-24000,0,0,0,0,0,0,-24000
20200316,1535,中宇,28.80,29.85,28.80,29.05,+0.35,1.22,107308,51,3132193,2000,9000,-7000,0,0,0,0,0,0,-7000
20200316,1536,和大,93.20,93.20,90.00,90.60,-2.40,-2.58,2244750,1494,205675250,338000,1133273,-795273,0,0,0,1000,53000,-52000,-847273
20200316,1537,廣隆,138.50,140.00,135.00,135.00,-3.00,-2.17,314764,242,42946782,43000,31000,12000,0,2000,-2000,0,0,0,10000
20200316,1538,正峰新,,,,,0.00,0.00,356,31,1263,0,0,0,0,0,0,0,0,0,0
20200316,1539,巨庭,14.35,14.60,13.60,13.65,-0.70,-4.88,140155,86,1987208,4000,9000,-5000,0,0,0,0,0,0,-5000
20200316,1540,喬福,16.10,16.10,15.80,15.90,-0.20,-1.24,218063,134,3467307,2000,34000,-32000,0,0,0,0,0,0,-32000
20200316,1541,錩泰,32.00,32.00,30.30,30.35,+0.20,0.66,101000,67,3128800,4000,9000,-5000,0,0,0,0,0,0,-5000
20200316,1558,伸興,122.00,123.50,120.00,120.00,-1.00,-0.83,340328,244,41269677,37000,94000,-57000,0,0,0,0,10000,-10000,-67000
20200316,1560,中砂,52.80,52.80,50.70,50.80,-2.00,-3.79,798199,560,41470048,104000,425000,-321000,0,2000,-2000,0,5000,-5000,-328000
20200316,1568,倉佑,14.00,14.00,13.50,13.70,+0.10,0.74,276000,134,3785850,15000,35000,-20000,0,0,0,0,4000,-4000,-24000
20200316,1582,信錦,71.60,72.00,70.50,70.60,-2.20,-3.02,798210,673,56823423,173000,187000,-14000,0,0,0,1000,20000,-19000,-33000
20200316,1583,程泰,53.00,53.00,53.00,53.00,+0.20,0.38,12300,6,651750,0,0,0,0,0,0,0,0,0,0
20200316,1587,吉茂,11.20,11.60,11.00,11.35,-0.10,-0.87,25000,16,281700,0,0,0,0,0,0,0,0,0,0
20200316,1589,永冠-KY,53.00,53.50,50.50,50.50,-2.50,-4.72,981150,433,50828650,47000,393000,-346000,0,0,0,22000,15000,7000,-339000
20200316,1590,亞德客-KY,415.50,430.00,399.50,399.50,-4.50,-1.11,2808352,2327,1167064052,1238532,1430148,-191616,208000,0,208000,32000,66000,-34000,-17616
20200316,1592,英瑞-KY,11.40,11.65,10.70,11.65,0.00,0.00,1121015,539,12453425,67000,63000,4000,0,0,0,0,0,0,4000
20200316,1598,岱宇,34.00,36.80,34.00,36.80,+3.15,9.36,1169104,620,40933290,136000,44000,92000,0,0,0,0,75000,-75000,17000
20200316,1603,華電,28.60,29.50,28.40,28.40,-0.10,-0.35,230218,159,6648685,13000,29000,-16000,0,0,0,0,0,0,-16000
20200316,1604,聲寶,16.55,16.85,16.30,16.60,+0.05,0.3,797335,364,13217828,50000,283000,-233000,0,6000,-6000,0,0,0,-239000
20200316,1605,華新,11.35,11.35,10.90,10.90,-0.30,-2.68,15843438,3096,174980286,2848000,8769000,-5921000,8000,0,8000,5985000,463000,5522000,-391000
20200316,1608,華榮,7.40,7.44,7.16,7.16,-0.19,-2.59,276987,130,2002075,42000,52000,-10000,0,0,0,0,3000,-3000,-13000
20200316,1609,大亞,8.51,8.57,8.12,8.12,-0.28,-3.33,2583827,883,21420507,296000,652000,-356000,1000,0,1000,0,18000,-18000,-373000
20200316,1611,中電,11.95,12.00,11.40,11.80,-0.20,-1.67,826868,571,9655101,30000,173000,-143000,0,0,0,0,0,0,-143000
20200316,1612,宏泰,9.40,9.40,9.06,9.15,-0.24,-2.56,509002,173,4710918,0,149000,-149000,0,0,0,0,6000,-6000,-155000
20200316,1614,三洋電,27.10,27.25,26.10,26.10,-0.75,-2.79,102025,57,2710857,1000,26000,-25000,0,0,0,0,0,0,-25000
20200316,1615,大山,18.50,18.70,17.85,17.85,-0.35,-1.92,178311,73,3240648,4000,24000,-20000,0,0,0,0,0,0,-20000
20200316,1616,億泰,4.15,4.15,3.90,3.97,-0.15,-3.64,63054,34,250034,0,0,0,0,0,0,0,0,0,0
20200316,1617,榮星,9.75,9.75,9.51,9.74,-0.01,-0.1,17000,13,165030,0,0,0,0,0,0,0,0,0,0
20200316,1618,合機,7.24,7.24,7.03,7.10,-0.07,-0.98,114850,46,821566,0,27000,-27000,0,0,0,0,0,0,-27000
20200316,1626,艾美特-KY,23.30,23.70,21.50,22.85,-0.70,-2.97,895902,362,20101625,160000,45000,115000,0,0,0,0,0,0,115000
20200316,1701,中化,18.35,18.70,17.95,18.00,-0.20,-1.1,2997828,1418,54893176,206000,573000,-367000,0,0,0,0,8000,-8000,-375000
20200316,1702,南僑,41.80,41.80,40.60,40.65,-1.15,-2.75,435354,363,17851581,57000,113000,-56000,0,2000,-2000,1000,2000,-1000,-59000
20200316,1707,葡萄王,208.50,218.50,208.50,210.00,+1.00,0.48,2156568,1809,460290212,623000,774000,-151000,388000,0,388000,17000,51000,-34000,203000
20200316,1708,東鹼,22.45,22.65,22.00,22.30,-0.15,-0.67,409195,263,9123016,18000,44000,-26000,0,0,0,0,4000,-4000,-30000
20200316,1709,和益,12.10,12.40,11.75,11.90,-0.10,-0.83,1675566,650,20161874,80000,222000,-142000,0,0,0,0,0,0,-142000
20200316,1710,東聯,17.20,17.20,16.55,16.55,-0.70,-4.06,1771398,1018,29692390,140000,496000,-356000,0,0,0,0,138000,-138000,-494000
20200316,1711,永光,13.55,13.70,13.20,13.25,-0.25,-1.85,969155,459,13093994,21000,139000,-118000,0,0,0,0,15000,-15000,-133000
20200316,1712,興農,17.45,17.65,17.00,17.00,-0.50,-2.86,2148501,982,37081131,134000,667000,-533000,0,2000,-2000,0,0,0,-535000
20200316,1713,國化,16.50,16.50,16.20,16.25,-0.55,-3.27,68467,40,1116106,1000,9000,-8000,0,0,0,0,0,0,-8000
20200316,1714,和桐,6.10,6.27,6.00,6.00,-0.10,-1.64,6822756,1940,41884938,477000,2132000,-1655000,0,0,0,0,17000,-17000,-1672000
20200316,1717,長興,23.35,23.35,22.90,22.90,-0.70,-2.97,1353398,677,31129404,70000,439000,-369000,0,0,0,0,183000,-183000,-552000
20200316,1718,中纖,6.03,6.05,5.78,5.78,-0.23,-3.83,3343862,1143,19732503,656000,747000,-91000,0,0,0,0,0,0,-91000
20200316,1720,生達,30.85,31.40,30.10,30.90,+0.05,0.16,526306,357,16281736,90000,87000,3000,0,0,0,0,4000,-4000,-1000
20200316,1721,三晃,9.20,9.20,9.09,9.13,-0.01,-0.11,396070,115,3615983,75000,37000,38000,0,0,0,0,5000,-5000,33000
20200316,1722,台肥,42.05,42.20,41.25,41.50,+0.25,0.61,5175777,2637,215555313,1242000,1123400,118600,0,1000,-1000,0,170000,-170000,-52400
20200316,1723,中碳,100.00,100.50,99.00,99.80,-0.70,-0.7,606412,484,60543298,58000,178000,-120000,0,0,0,1000,34000,-33000,-153000
20200316,1724,台硝,11.80,11.80,11.05,11.60,-0.20,-1.69,44002,28,495724,1000,1000,0,0,0,0,0,0,0,0
20200316,1725,元禎,13.00,13.20,12.90,12.90,-0.25,-1.9,35998,52,468370,0,7000,-7000,0,0,0,1000,0,1000,-6000
20200316,1726,永記,65.00,65.50,64.80,65.00,+0.20,0.31,39196,39,2547540,9000,3000,6000,0,0,0,0,0,0,6000
20200316,1727,中華化,9.26,9.50,9.18,9.18,-0.40,-4.18,232199,105,2146936,0,9000,-9000,0,0,0,0,0,0,-9000
20200316,1730,花仙子,57.50,59.00,56.00,56.60,+1.00,1.8,1554532,1227,89307226,337000,205000,132000,0,0,0,0,85000,-85000,47000
20200316,1731,美吾華,12.35,12.65,12.20,12.35,+0.15,1.23,1147919,537,14254939,178000,140000,38000,0,0,0,0,0,0,38000
20200316,1732,毛寶,22.50,24.65,22.50,24.65,+2.20,9.8,722414,396,17202484,8000,0,8000,0,0,0,0,0,0,8000
20200316,1733,五鼎,21.10,21.50,20.75,20.85,-0.25,-1.18,664402,387,14037592,97000,122000,-25000,0,0,0,9000,16000,-7000,-32000
20200316,1734,杏輝,17.70,18.10,17.55,17.55,-0.15,-0.85,1117746,603,19950411,131000,99000,32000,0,0,0,0,0,0,32000
20200316,1735,日勝化,15.65,16.05,15.65,16.00,-0.05,-0.31,13232,14,210641,0,0,0,0,0,0,0,0,0,0
20200316,1736,喬山,55.90,55.90,49.60,50.30,-3.50,-6.51,1969000,1355,103712594,506000,677000,-171000,0,11000,-11000,11000,43000,-32000,-214000
20200316,1737,臺鹽,29.65,29.65,28.90,29.00,-0.65,-2.19,428691,322,12530815,42000,93000,-51000,0,0,0,0,0,0,-51000
20200316,1760,寶齡富錦,69.90,71.00,65.50,66.00,-3.90,-5.58,663719,537,45517754,120000,84000,36000,0,0,0,0,2000,-2000,34000
20200316,1762,中化生,34.20,36.45,34.00,34.05,-0.10,-0.29,3692296,2541,130024919,227000,662000,-435000,0,0,0,0,35000,-35000,-470000
20200316,1773,勝一,90.00,90.00,87.00,87.00,-2.50,-2.79,261003,234,22953559,12000,110000,-98000,0,0,0,0,0,0,-98000
20200316,1776,展宇,17.00,17.00,16.40,17.00,+0.05,0.29,15857,15,265197,0,1000,-1000,0,0,0,0,0,0,-1000
20200316,1783,和康生,18.40,18.40,17.20,17.20,-0.75,-4.18,300200,207,5279874,4000,22000,-18000,0,0,0,0,0,0,-18000
20200316,1786,科妍,45.00,45.80,44.25,44.25,-0.60,-1.34,446038,335,19949528,73000,85000,-12000,0,0,0,8000,9000,-1000,-13000
20200316,1789,神隆,28.20,29.50,27.00,27.00,-0.20,-0.74,11021871,6283,311674317,1014000,1967075,-953075,0,590000,-590000,0,47000,-47000,-1590075
20200316,1795,美時,72.50,73.00,65.30,65.30,-7.20,-9.93,5891529,4262,394818044,1373000,311000,1062000,0,1002000,-1002000,1000,0,1000,61000
20200316,1802,台玻,8.36,8.36,8.00,8.00,-0.37,-4.42,2080554,756,16853103,135000,721000,-586000,0,0,0,0,270000,-270000,-856000
20200316,1805,寶徠,8.75,8.80,7.92,7.92,-0.88,-10.0,27999,18,232911,0,0,0,0,0,0,0,0,0,0
20200316,1806,冠軍,5.09,5.11,4.73,4.80,-0.30,-5.88,409410,135,2013858,3000,19000,-16000,0,0,0,0,10000,-10000,-26000
20200316,1808,潤隆,53.30,53.30,49.90,50.50,-2.80,-5.25,519989,356,26511931,115828,98000,17828,0,0,0,0,52000,-52000,-34172
20200316,1809,中釉,8.17,8.20,7.63,7.64,-0.55,-6.72,888523,332,7004964,184000,179000,5000,0,0,0,0,0,0,5000
20200316,1810,和成,6.37,6.37,6.00,6.08,-0.25,-3.95,770350,216,4789259,2000,116000,-114000,0,0,0,0,7000,-7000,-121000
20200316,1817,凱撒衛,28.20,28.45,27.95,28.10,+0.10,0.36,152000,111,4264050,20000,15000,5000,0,0,0,0,2000,-2000,3000
20200316,1902,台紙,20.25,20.30,20.20,20.20,-0.05,-0.25,1554091,323,31450426,19000,509000,-490000,0,5000,-5000,0,5000,-5000,-500000
20200316,1903,士紙,27.90,28.65,27.90,28.35,-0.45,-1.56,19915,44,560818,0,1000,-1000,0,0,0,0,0,0,-1000
20200316,1904,正隆,21.35,21.65,21.00,21.00,-0.30,-1.41,6815039,3638,145019969,1045000,1787000,-742000,1710000,310000,1400000,1000,173000,-172000,486000
20200316,1905,華紙,7.14,7.24,7.00,7.01,-0.13,-1.82,1905979,596,13483893,82000,695000,-613000,0,0,0,0,23000,-23000,-636000
20200316,1906,寶隆,12.10,12.40,11.85,11.85,-0.65,-5.2,410027,254,4964755,5000,157000,-152000,0,0,0,0,0,0,-152000
20200316,1907,永豐餘,11.50,11.55,11.10,11.15,-0.30,-2.62,3450254,1219,39207383,305000,1098000,-793000,0,26000,-26000,0,185000,-185000,-1004000
20200316,1909,榮成,13.55,13.90,12.65,12.75,-0.75,-5.56,16552735,5193,217788861,2535000,6760000,-4225000,61000,4000,57000,10000,286000,-276000,-4444000
20200316,2002,中鋼,20.20,20.25,20.00,20.00,-0.20,-0.99,31513002,11505,632969927,9288000,19222060,-9934060,36000,31000,5000,101000,1614000,-1513000,-11442060
20200316,2002A,中鋼特,53.00,53.00,52.20,52.20,-1.20,-2.25,135100,75,7105029,0,0,0,0,0,0,6000,3000,3000,3000
20200316,2006,東和鋼鐵,22.20,22.65,22.10,22.30,+0.15,0.68,3431083,1861,77059696,627000,692381,-65381,2000,2000,0,1000,166000,-165000,-230381
20200316,2007,燁興,3.69,3.69,3.53,3.53,-0.17,-4.59,143711,39,511476,0,0,0,0,0,0,0,0,0,0
20200316,2008,高興昌,12.35,12.35,12.20,12.20,-0.10,-0.81,413650,29,5078315,0,16000,-16000,0,0,0,0,0,0,-16000
20200316,2009,第一銅,6.48,6.57,6.23,6.33,-0.47,-6.91,532400,208,3422277,9000,35000,-26000,0,0,0,0,2000,-2000,-28000
20200316,2010,春源,9.28,9.32,9.06,9.07,-0.21,-2.26,828759,256,7566142,33000,130000,-97000,0,0,0,0,0,0,-97000
20200316,2012,春雨,17.50,18.00,17.50,17.50,0.00,0.00,31001,18,546467,0,0,0,0,0,0,0,0,0,0
20200316,2013,中鋼構,19.30,19.65,19.30,19.30,+0.05,0.26,433651,284,8412108,34000,36000,-2000,0,0,0,0,0,0,-2000
20200316,2014,中鴻,7.23,7.24,6.75,6.75,-0.40,-5.59,5268894,1654,36864308,961000,1569000,-608000,0,0,0,0,225000,-225000,-833000
20200316,2015,豐興,50.00,50.40,49.70,49.75,-0.20,-0.4,642106,368,32019622,286000,330000,-44000,0,3000,-3000,0,101000,-101000,-148000
20200316,2017,官田鋼,6.71,6.90,6.50,6.50,-0.30,-4.41,1483081,210,9943293,14000,57000,-43000,0,0,0,0,991237,-991237,-1034237
20200316,2020,美亞,14.30,14.80,14.30,14.60,-0.05,-0.34,292138,146,4244752,60000,31000,29000,0,0,0,0,0,0,29000
20200316,2022,聚亨,3.79,3.86,3.72,3.72,+0.01,0.27,549443,208,2067228,6000,62000,-56000,0,0,0,0,4000,-4000,-60000
20200316,2023,燁輝,8.52,8.52,8.32,8.35,-0.17,-2.0,2762461,1005,23264589,380000,536000,-156000,0,0,0,0,35000,-35000,-191000
20200316,2024,志聯,12.30,12.35,12.15,12.30,0.00,0.00,146222,52,1798155,1000,10000,-9000,0,0,0,0,0,0,-9000
20200316,2025,千興,1.61,1.61,1.50,1.51,-0.10,-6.21,152015,26,229282,0,0,0,0,0,0,0,0,0,0
20200316,2027,大成鋼,28.45,28.70,28.00,28.05,-0.35,-1.23,6995778,3079,198487203,1112000,2255000,-1143000,0,0,0,2566000,300000,2266000,1123000
20200316,2028,威致,9.19,9.30,8.50,8.50,-0.50,-5.56,54103,27,496724,0,0,0,0,0,0,0,0,0,0
20200316,2029,盛餘,17.70,17.70,17.20,17.20,-0.40,-2.27,268001,125,4641818,6000,63000,-57000,0,0,0,0,0,0,-57000
20200316,2030,彰源,9.38,9.80,9.38,9.40,+0.02,0.21,426402,188,4024060,51000,108000,-57000,0,0,0,0,0,0,-57000
20200316,2031,新光鋼,24.30,24.35,23.20,23.20,-0.90,-3.73,1749310,794,41381543,412000,299000,113000,0,1000,-1000,36000,149000,-113000,-1000
20200316,2032,新鋼,7.50,7.50,6.67,7.37,-0.03,-0.41,147675,40,1058767,3000,7000,-4000,0,0,0,0,0,0,-4000
20200316,2033,佳大,8.10,8.10,7.90,7.99,-0.10,-1.24,64000,23,511970,2000,3000,-1000,0,0,0,0,0,0,-1000
20200316,2034,允強,23.10,23.85,23.10,23.60,-0.45,-1.87,1004960,504,23711952,216030,105000,111030,0,0,0,0,2000,-2000,109030
20200316,2038,海光,5.65,5.67,5.50,5.57,-0.43,-7.17,201249,109,1123648,8000,10000,-2000,0,0,0,0,0,0,-2000
20200316,2049,上銀,240.00,243.00,219.00,219.00,-21.50,-8.94,3595312,3003,827270764,1067960,1463866,-395906,100000,156480,-56480,68000,370000,-302000,-754386
20200316,2059,川湖,328.00,328.00,303.00,305.50,-14.00,-4.38,234610,224,72939464,25000,147000,-122000,6000,1000,5000,2000,8000,-6000,-123000
20200316,2062,橋椿,17.35,18.00,16.55,16.55,-1.40,-7.8,439289,276,7507602,55000,12000,43000,0,0,0,0,0,0,43000
20200316,2069,運錩,13.85,14.00,13.60,13.70,-0.15,-1.08,206000,77,2845600,6000,10000,-4000,0,0,0,0,0,0,-4000
20200316,2101,南港,38.50,40.65,37.05,40.65,+2.15,5.58,6037525,2380,237165257,549000,2012000,-1463000,0,0,0,111000,132000,-21000,-1484000
20200316,2102,泰豐,9.97,10.10,9.60,9.75,-0.25,-2.5,1637123,668,16229312,177000,295000,-118000,0,0,0,0,0,0,-118000
20200316,2103,台橡,17.70,17.70,17.00,17.25,-0.55,-3.09,2041872,1153,35312973,412000,424000,-12000,0,0,0,0,103000,-103000,-115000
20200316,2104,國際中橡,22.80,23.00,22.05,22.10,-0.70,-3.07,4359419,2073,97809017,1208000,1012000,196000,0,1000,-1000,25000,87000,-62000,133000
20200316,2105,正新,36.20,36.20,34.90,34.90,-1.10,-3.06,6231581,3285,220169156,1094829,3697206,-2602377,0,2000,-2000,14000,166000,-152000,-2756377
20200316,2106,建大,27.65,27.70,27.25,27.50,-0.15,-0.54,1185542,500,32569765,174000,236000,-62000,0,2000,-2000,0,114000,-114000,-178000
20200316,2107,厚生,15.65,15.65,15.15,15.20,-0.40,-2.56,558239,255,8533909,26000,250000,-224000,0,16000,-16000,0,1000,-1000,-241000
20200316,2108,南帝,25.00,25.25,24.50,24.90,+0.05,0.2,1101994,688,27381581,123000,423000,-300000,0,5000,-5000,0,17000,-17000,-322000
20200316,2109,華豐,11.40,11.80,10.80,10.80,-0.70,-6.09,456840,133,5165373,28000,22000,6000,0,0,0,0,0,0,6000
20200316,2114,鑫永銓,74.30,75.00,74.30,74.30,+0.10,0.13,114909,74,8567728,2000,12000,-10000,0,0,0,0,0,0,-10000
20200316,2115,六暉-KY,35.00,35.00,34.50,34.50,-0.30,-0.86,38099,29,1319420,0,0,0,0,0,0,0,0,0,0
20200316,2201,裕隆,17.70,18.10,17.00,17.00,-0.60,-3.41,5589682,2362,97540736,727000,2126000,-1399000,0,0,0,19000,186000,-167000,-1566000
20200316,2204,中華,30.55,30.65,29.30,29.40,-1.30,-4.23,767245,449,23021240,154000,147000,7000,0,0,0,0,108000,-108000,-101000
20200316,2206,三陽工業,20.20,20.30,19.90,20.25,-0.05,-0.25,1843826,647,37160648,271000,225000,46000,0,0,0,0,16000,-16000,30000
20200316,2207,和泰車,488.00,488.00,439.50,439.50,-48.50,-9.94,862088,806,391167072,360240,556618,-196378,6000,1000,5000,0,53000,-53000,-244378
20200316,2208,台船,18.80,19.35,18.00,18.00,-1.30,-6.74,1760007,763,32872576,299000,209000,90000,0,0,0,0,9000,-9000,81000
20200316,2227,裕日車,233.00,233.50,227.00,227.50,-5.50,-2.36,123777,130,28433710,5000,37000,-32000,1000,2000,-1000,0,0,0,-33000
20200316,2228,劍麟,75.80,75.90,71.80,72.20,-1.70,-2.3,641209,522,47673251,128000,189000,-61000,0,2000,-2000,0,0,0,-63000
20200316,2231,為升,144.00,145.50,129.50,129.50,-14.00,-9.76,2240763,2009,303593953,528000,395000,133000,0,87495,-87495,10000,93196,-83196,-37691
20200316,2233,宇隆,50.60,51.10,48.75,49.10,-1.40,-2.77,504565,459,24979444,94000,77000,17000,0,0,0,0,0,0,17000
20200316,2236,百達-KY,16.05,16.05,16.00,16.00,-0.35,-2.14,47213,20,756114,0,0,0,0,0,0,0,0,0,0
20200316,2239,英利-KY,57.30,58.50,55.00,55.40,-4.30,-7.2,141160,112,8065460,18000,27000,-9000,0,0,0,3000,0,3000,-6000
20200316,2243,宏旭-KY,10.60,11.00,10.25,10.60,-0.35,-3.2,35000,19,373000,0,2000,-2000,0,0,0,0,0,0,-2000
20200316,2301,光寶科,41.00,41.50,40.35,40.35,-0.95,-2.3,9471199,5496,388181149,3701494,7745351,-4043857,50000,2000,48000,1221000,410000,811000,-3184857
20200316,2302,麗正,5.47,5.56,5.36,5.44,-0.06,-1.09,169001,64,925405,18000,0,18000,0,0,0,0,0,0,18000
20200316,2303,聯電,14.00,14.10,13.75,13.90,-0.15,-1.07,81036386,9086,1125189057,64600000,61479904,3120096,277000,38000,239000,1422000,1350000,72000,3431096
20200316,2305,全友,4.57,4.60,4.28,4.35,-0.23,-5.02,296325,109,1335127,0,20000,-20000,0,0,0,0,0,0,-20000
20200316,2308,台達電,122.00,122.00,116.00,118.00,-2.00,-1.67,10533723,5593,1251792984,4284000,8050015,-3766015,6000,5000,1000,106000,359000,-253000,-4018015
20200316,2312,金寶,11.30,11.35,10.50,10.50,-0.75,-6.67,5527780,1584,59957181,509000,2435000,-1926000,0,8000,-8000,5000,115000,-110000,-2044000
20200316,2313,華通,32.60,32.95,29.70,29.70,-2.35,-7.33,26637814,10733,837549519,3948000,8400000,-4452000,238000,236000,2000,721000,1699000,-978000,-5428000
20200316,2314,台揚,17.40,17.40,15.70,15.70,-1.70,-9.77,1911713,975,31531672,351000,230000,121000,0,0,0,0,13000,-13000,108000
20200316,2316,楠梓電,27.85,28.75,26.35,26.35,-1.45,-5.22,4779547,2171,131865162,703000,1249000,-546000,0,0,0,27000,33000,-6000,-552000
20200316,2317,鴻海,73.90,74.30,71.10,71.10,-3.50,-4.69,65223917,32325,4720458460,17686577,36673363,-18986786,20000,38000,-18000,1207000,4337000,-3130000,-22134786
20200316,2321,東訊,1.35,1.35,1.26,1.26,-0.13,-9.35,49847,15,64946,0,0,0,0,0,0,0,0,0,0
20200316,2323,中環,6.50,6.77,6.35,6.45,+0.01,0.16,22126572,4571,145375613,6034000,4733000,1301000,0,0,0,288000,296000,-8000,1293000
20200316,2324,仁寶,17.10,17.15,16.75,16.75,-0.35,-2.05,21320738,7294,360664682,4779888,15391054,-10611166,10000,0,10000,3315000,359000,2956000,-7645166
20200316,2327,國巨,320.00,330.50,290.50,290.50,-29.50,-9.22,25494123,18251,7942862793,4566793,4323877,242916,0,185000,-185000,533000,914000,-381000,-323084
20200316,2328,廣宇,16.85,16.85,16.05,16.30,-0.25,-1.51,1864853,1027,30609280,247000,514000,-267000,0,8000,-8000,37000,157000,-120000,-395000
20200316,2329,華泰,10.25,10.55,9.69,9.82,-0.38,-3.73,4589746,1342,46417120,937000,1013000,-76000,0,12000,-12000,2000,83000,-81000,-169000
20200316,2330,台積電,285.00,291.00,275.50,276.50,-13.50,-4.66,103933228,51292,29343288916,25930495,67797107,-41866612,299000,124000,175000,1549000,6762981,-5213981,-46905593
20200316,2331,精英,9.39,9.39,8.53,8.78,-0.69,-7.29,2052018,728,17840955,98000,802000,-704000,0,0,0,7000,4000,3000,-701000
20200316,2332,友訊,10.35,10.50,9.71,9.89,-0.41,-3.98,8823629,1855,88558456,1880000,1674000,206000,0,0,0,3000,850000,-847000,-641000
20200316,2337,旺宏,29.35,30.20,27.20,27.20,-1.90,-6.53,67385870,23842,1938915331,10813000,21819000,-11006000,85000,1134000,-1049000,696000,1467000,-771000,-12826000
20200316,2338,光罩,25.40,26.15,23.80,24.15,-0.85,-3.4,7827632,3944,196304217,947000,1372000,-425000,0,6000,-6000,12000,103000,-91000,-522000
20200316,2340,光磊,17.80,17.80,16.75,16.85,-0.70,-3.99,2549493,1395,43818463,377000,883000,-506000,0,2000,-2000,33000,211000,-178000,-686000
20200316,2342,茂矽,25.95,26.50,23.25,23.25,-2.55,-9.88,10747584,5627,266350515,1140000,2175000,-1035000,0,0,0,0,0,0,-1035000
20200316,2344,華邦電,13.70,13.95,12.45,12.50,-1.10,-8.09,46813292,11991,612094294,10222000,19461351,-9239351,9000,2079000,-2070000,553000,2587000,-2034000,-13343351
20200316,2345,智邦,168.50,172.50,163.00,163.00,-6.00,-3.55,6361189,4450,1067628618,2367889,2588459,-220570,90000,3000,87000,147000,401000,-254000,-387570
20200316,2347,聯強,34.70,35.10,34.30,34.30,+0.55,1.63,7803632,2993,271441635,2068000,5012886,-2944886,0,6000,-6000,1584000,220000,1364000,-1586886
20200316,2348,海悅,48.10,48.60,45.90,46.05,-2.05,-4.26,494078,330,23186853,60000,164000,-104000,0,0,0,28000,8000,20000,-84000
20200316,2349,錸德,4.20,4.28,3.96,3.97,-0.18,-4.34,5972871,1410,24463434,574000,1495000,-921000,0,0,0,0,0,0,-921000
20200316,2351,順德,43.90,45.35,42.75,42.75,-2.00,-4.47,1015420,739,45263600,281000,255000,26000,0,334000,-334000,6000,71000,-65000,-373000
20200316,2352,佳世達,16.20,16.50,15.80,15.85,-0.15,-0.94,5995590,2271,96416662,1251000,1294000,-43000,5000,13000,-8000,115000,502000,-387000,-438000
20200316,2353,宏碁,13.90,14.10,13.25,13.50,-0.30,-2.17,17253703,5331,234614365,4163000,8510000,-4347000,0,3000,-3000,278000,649000,-371000,-4721000
20200316,2354,鴻準,53.30,53.30,51.40,52.00,-1.30,-2.44,4949042,2618,257627253,1243328,2436447,-1193119,3000,2000,1000,14000,175000,-161000,-1353119
20200316,2355,敬鵬,24.90,24.90,23.25,23.25,-1.50,-6.06,1780238,797,42466912,233000,824000,-591000,0,0,0,2000,48000,-46000,-637000
20200316,2356,英業達,21.20,21.20,20.25,20.35,-0.85,-4.01,9804879,3362,202093471,3128000,7187431,-4059431,9000,0,9000,2686000,389000,2297000,-1753431
20200316,2357,華碩,184.50,191.00,182.50,185.00,-5.00,-2.63,3407192,2575,635387100,1586000,2896051,-1310051,410000,2000,408000,243000,28000,215000,-687051
20200316,2358,廷鑫,11.80,11.80,10.65,11.10,-0.70,-5.93,387734,159,4293247,52000,31000,21000,0,0,0,0,5000,-5000,16000
20200316,2359,所羅門,16.05,16.70,15.85,16.05,-0.25,-1.53,1130982,423,18515752,221000,320000,-99000,0,0,0,1000,1000,0,-99000
20200316,2360,致茂,129.00,129.00,113.50,114.00,-10.50,-8.43,2777757,2004,329441176,1462000,1058607,403393,0,303000,-303000,43000,129000,-86000,14393
20200316,2362,藍天,28.10,28.20,27.20,27.20,-0.80,-2.86,862048,518,23628852,108000,362000,-254000,0,1000,-1000,6000,64000,-58000,-313000
20200316,2363,矽統,6.50,6.61,6.06,6.06,-0.39,-6.05,2387056,896,15086520,457000,636000,-179000,0,0,0,0,0,0,-179000
20200316,2364,倫飛,1.53,1.53,1.51,1.51,-0.09,-5.62,62524,54,94777,0,0,0,0,0,0,0,0,0,0
20200316,2365,昆盈,6.05,6.05,5.80,5.80,-0.18,-3.01,1229740,255,7313200,398000,102000,296000,0,0,0,0,0,0,296000
20200316,2367,燿華,21.00,21.30,18.90,18.90,-2.10,-10.0,18925275,6673,380371643,4914000,6653000,-1739000,0,7000,-7000,26000,96000,-70000,-1816000
20200316,2368,金像電,21.40,21.90,19.80,19.80,-2.05,-9.38,126848081,40430,2670078327,12325000,17379000,-5054000,6374000,0,6374000,716000,372000,344000,1664000
20200316,2369,菱生,9.54,9.69,8.84,8.85,-0.69,-7.23,3330387,1041,30792078,351000,924000,-573000,0,0,0,1000,36000,-35000,-608000
20200316,2371,大同,18.30,18.65,17.50,18.05,-0.25,-1.37,8967386,2696,161087373,1451000,4541000,-3090000,0,0,0,132000,190000,-58000,-3148000
20200316,2373,震旦行,86.00,86.00,82.70,84.10,-1.10,-1.29,48026,48,4026882,1000,4000,-3000,0,0,0,0,15000,-15000,-18000
20200316,2374,佳能,11.70,11.95,11.45,11.60,-0.10,-0.85,473587,404,5542789,4000,49000,-45000,0,0,0,0,1000,-1000,-46000
20200316,2375,凱美,30.10,30.70,28.95,29.50,+0.80,2.79,5831784,3277,174313937,2380000,982000,1398000,0,0,0,0,13000,-13000,1385000
20200316,2376,技嘉,45.10,45.80,43.75,43.75,-1.25,-2.78,4714585,2650,211608139,843000,1982000,-1139000,253000,7000,246000,1064000,251000,813000,-80000
20200316,2377,微星,80.00,80.20,76.70,76.70,-2.90,-3.64,3843299,2549,301325716,972000,2697462,-1725462,450000,3000,447000,732000,153000,579000,-699462
20200316,2379,瑞昱,198.00,201.00,187.00,187.00,-14.50,-7.2,7348777,4835,1425092576,2455572,5501380,-3045808,158000,2000,156000,57000,214000,-157000,-3046808
20200316,2380,虹光,3.39,3.52,3.39,3.48,+0.02,0.58,72008,141,247355,0,0,0,0,0,0,0,0,0,0
20200316,2382,廣達,60.00,60.30,57.30,57.30,-3.30,-5.45,16417272,7484,971519009,3636000,12021560,-8385560,109000,6000,103000,2859000,669000,2190000,-6092560
20200316,2383,台光電,108.50,110.50,104.50,104.50,-4.50,-4.13,4064281,2568,436792724,820000,1047000,-227000,0,1000,-1000,112000,183000,-71000,-299000
20200316,2385,群光,79.20,79.60,78.60,78.60,-1.00,-1.26,4428364,2510,349453891,1468994,3248250,-1779256,1000,2000,-1000,643000,94000,549000,-1231256
20200316,2387,精元,31.35,32.30,28.15,28.20,-3.05,-9.76,4374640,2161,130221445,567000,1068000,-501000,0,0,0,35000,147000,-112000,-613000
20200316,2388,威盛,21.90,22.50,19.85,20.00,-1.95,-8.88,1291728,745,27253842,521000,295000,226000,0,0,0,0,0,0,226000
20200316,2390,云辰,7.46,7.60,6.63,6.73,-0.63,-8.56,1853877,840,12983290,555000,328000,227000,0,0,0,0,2000,-2000,225000
20200316,2392,正崴,29.40,29.40,27.70,27.80,-0.65,-2.28,5056966,3144,144203434,734000,779000,-45000,0,8000,-8000,47000,487000,-440000,-493000
20200316,2393,億光,27.80,27.80,25.85,25.85,-1.05,-3.9,2400558,1425,63970915,239000,1233325,-994325,0,0,0,18000,99000,-81000,-1075325
20200316,2395,研華,260.00,263.50,238.00,238.00,-23.50,-8.99,1964887,1600,485485880,1015000,1767771,-752771,3000,1000,2000,2000,17000,-15000,-765771
20200316,2397,友通,68.90,70.30,66.50,66.50,-2.40,-3.48,91040,77,6213560,9000,12000,-3000,0,0,0,0,4000,-4000,-7000
20200316,2399,映泰,8.13,8.30,7.77,7.80,-0.32,-3.94,1209001,343,9738857,382000,355000,27000,0,0,0,17000,0,17000,44000
20200316,2401,凌陽,9.10,9.30,8.75,8.81,-0.29,-3.19,1975392,837,17734218,324000,565000,-241000,0,0,0,64000,134000,-70000,-311000
20200316,2402,毅嘉,11.25,11.35,10.05,10.05,-1.05,-9.46,2168015,852,22901198,609000,186000,423000,0,194000,-194000,0,1000,-1000,228000
20200316,2404,漢唐,160.00,162.00,152.00,152.00,-6.50,-4.1,2351065,1781,367928904,533030,560000,-26970,0,1000,-1000,384000,81600,302400,274430
20200316,2405,浩鑫,7.61,7.61,7.06,7.16,-0.39,-5.17,1594255,603,11698880,355000,286000,69000,0,0,0,0,0,0,69000
20200316,2406,國碩,10.25,10.50,9.45,9.52,0.00,0.00,1990173,879,19843920,108000,331000,-223000,0,0,0,0,0,0,-223000
20200316,2408,南亞科,63.30,64.30,58.60,59.20,-3.70,-5.88,17321014,9529,1053845421,5256000,7390902,-2134902,30000,2782000,-2752000,1205000,920000,285000,-4601902
20200316,2409,友達,7.80,7.97,7.52,7.58,-0.11,-1.43,95530771,16541,738634280,23002250,44072908,-21070658,22000,6520000,-6498000,1493000,2778000,-1285000,-28853658
20200316,2412,中華電,106.50,107.00,105.00,105.00,-1.00,-0.94,16463671,7028,1734459698,6975000,7134867,-159867,292000,19000,273000,11000,667000,-656000,-542867
20200316,2413,環科,11.10,11.40,9.91,9.93,-0.77,-7.2,319001,141,3302801,11000,21000,-10000,0,0,0,0,0,0,-10000
20200316,2414,精技,21.30,21.30,20.80,20.85,-0.30,-1.42,373750,212,7866287,117000,101000,16000,0,0,0,0,3000,-3000,13000
20200316,2415,錩新,13.45,13.75,13.35,13.45,+0.05,0.37,244027,131,3297160,0,31000,-31000,0,0,0,0,0,0,-31000
20200316,2417,圓剛,9.21,9.82,9.10,9.17,+0.24,2.69,6623012,2692,63316058,785000,1405000,-620000,0,0,0,1000,1000,0,-620000
20200316,2419,仲琦,21.00,21.20,18.85,18.85,-2.05,-9.81,2126714,776,41874601,144000,278000,-134000,0,0,0,0,22000,-22000,-156000
20200316,2420,新巨,31.00,31.00,29.90,29.90,-0.75,-2.45,675240,481,20422363,6000,270000,-264000,0,0,0,0,15000,-15000,-279000
20200316,2421,建準,33.25,35.00,33.10,33.10,+0.20,0.61,3041067,1989,101797012,1688000,1956000,-268000,0,0,0,1000,35000,-34000,-302000
20200316,2423,固緯,22.75,23.50,21.90,21.95,-0.80,-3.52,474124,325,10622065,75000,145000,-70000,0,0,0,6000,0,6000,-64000
20200316,2424,隴華,22.00,22.00,22.00,22.00,0.00,0.00,2000,2,44000,0,0,0,0,0,0,0,0,0,0
20200316,2425,承啟,25.10,25.70,24.75,25.25,+0.15,0.6,747518,378,18848252,196000,388000,-192000,0,0,0,0,0,0,-192000
20200316,2426,鼎元,10.15,10.50,9.63,9.80,-0.45,-4.39,1351086,646,13517625,209000,499000,-290000,0,0,0,0,34000,-34000,-324000
20200316,2427,三商電,10.00,10.00,9.00,9.74,-0.26,-2.6,1034010,136,9724517,70000,28000,42000,0,0,0,0,0,0,42000
20200316,2428,興勤,72.60,74.40,70.00,70.00,-3.50,-4.76,563331,485,40530301,188000,325000,-137000,0,2000,-2000,2000,15000,-13000,-152000
20200316,2429,銘旺科,22.05,22.95,19.35,19.35,-2.10,-9.79,583000,365,11995600,71000,75000,-4000,0,0,0,0,0,0,-4000
20200316,2430,燦坤,13.60,13.75,13.40,13.60,+0.25,1.87,239414,123,3257770,2000,53000,-51000,0,0,0,0,5000,-5000,-56000
20200316,2431,聯昌,6.98,7.18,6.57,6.62,-0.33,-4.75,305001,118,2081407,28000,49000,-21000,0,0,0,0,0,0,-21000
20200316,2433,互盛電,48.10,48.10,47.25,47.25,-0.85,-1.77,313280,261,14916368,16000,62000,-46000,0,0,0,0,15000,-15000,-61000
20200316,2434,統懋,6.29,6.30,6.00,6.30,+0.01,0.16,86784,19,543604,0,0,0,0,0,0,0,0,0,0
20200316,2436,偉詮電,22.50,22.65,21.25,21.25,-0.85,-3.85,2124741,1380,46804057,141000,297000,-156000,0,0,0,1000,17000,-16000,-172000
20200316,2438,翔耀,5.37,5.71,5.37,5.50,+0.13,2.42,13154,8,71509,0,0,0,0,0,0,0,0,0,0
20200316,2439,美律,129.50,131.50,125.00,125.00,-4.00,-3.1,3348658,2489,427206063,505000,908000,-403000,0,218000,-218000,594000,332000,262000,-359000
20200316,2440,太空梭,7.60,7.60,7.50,7.50,0.00,0.00,9000,6,68080,0,0,0,0,0,0,0,0,0,0
20200316,2441,超豐,42.05,42.15,39.95,40.15,-2.25,-5.31,1311645,930,53576520,124000,617000,-493000,1000,6000,-5000,14000,79000,-65000,-563000
20200316,2442,新美齊,7.14,7.14,6.65,6.81,-0.34,-4.76,2517447,782,17258267,522000,794000,-272000,0,0,0,0,26000,-26000,-298000
20200316,2443,億麗,2.78,2.79,2.70,2.70,0.00,0.00,154020,81,419834,0,15000,-15000,0,0,0,0,0,0,-15000
20200316,2444,兆勁,15.25,16.40,15.20,15.60,+0.40,2.63,2303331,461,36178179,80000,74000,6000,0,0,0,0,0,0,6000
20200316,2448,晶電,28.45,29.00,27.00,27.00,-1.50,-5.26,31419867,13772,882718678,4110000,10608261,-6498261,1110000,0,1110000,610000,1200000,-590000,-5978261
20200316,2449,京元電子,30.60,32.45,30.20,30.50,+0.10,0.33,17067486,8439,533055705,6499000,6203130,295870,122000,11000,111000,1670000,519000,1151000,1557870
20200316,2450,神腦,27.60,27.60,26.70,27.55,0.00,0.00,279429,188,7565922,26000,52000,-26000,0,0,0,0,24000,-24000,-50000
20200316,2451,創見,75.00,75.00,73.00,73.00,-2.00,-2.67,1527008,968,112991484,227000,923131,-696131,0,1000,-1000,797000,58000,739000,41869
20200316,2453,凌群,12.95,13.30,12.70,12.80,-0.10,-0.78,512000,252,6614250,108000,153000,-45000,0,0,0,0,0,0,-45000
20200316,2454,聯發科,333.00,342.50,320.00,320.00,-21.00,-6.16,12157253,8087,4020202713,3803843,5868786,-2064943,205000,4000,201000,137000,799000,-662000,-2525943
20200316,2455,全新,83.20,84.00,74.20,74.20,-8.20,-9.95,4755027,3079,371861325,1498000,1172000,326000,16000,1000,15000,75000,503000,-428000,-87000
20200316,2456,奇力新,90.00,92.70,82.50,82.50,-8.50,-9.34,11260145,7824,985873535,1130000,3777000,-2647000,0,126000,-126000,39000,112000,-73000,-2846000
20200316,2457,飛宏,6.58,6.68,6.11,6.17,-0.40,-6.09,725821,315,4625513,100000,161000,-61000,0,0,0,0,0,0,-61000
20200316,2458,義隆,77.10,79.10,75.00,75.00,-2.10,-2.72,5084285,3568,391447875,638000,2162000,-1524000,118000,1000,117000,81000,164000,-83000,-1490000
20200316,2459,敦吉,37.65,37.65,36.75,36.75,-0.90,-2.39,190095,138,7036409,14000,42000,-28000,0,0,0,0,8000,-8000,-36000
20200316,2460,建通,8.36,8.36,7.70,7.70,-0.24,-3.02,25630,43,198994,0,2000,-2000,0,0,0,0,0,0,-2000
20200316,2461,光群雷,13.40,13.50,12.60,13.00,0.00,0.00,1575001,584,20533514,218000,330000,-112000,0,0,0,0,0,0,-112000
20200316,2462,良得電,27.00,27.00,25.00,25.35,-1.70,-6.28,148510,113,3815749,4000,20000,-16000,0,0,0,0,2000,-2000,-18000
20200316,2464,盟立,29.40,29.75,29.05,29.10,+0.10,0.34,982059,567,28893471,180000,169000,11000,0,1000,-1000,0,83000,-83000,-73000
20200316,2465,麗臺,7.40,7.40,6.64,6.70,-0.67,-9.09,300695,154,2084363,1000,0,1000,0,0,0,0,0,0,1000
20200316,2466,冠西電,32.80,32.80,32.35,32.55,-0.20,-0.61,41332,30,1347206,2000,6000,-4000,0,0,0,1000,0,1000,-3000
20200316,2467,志聖,26.05,26.40,25.25,25.30,-0.90,-3.44,1219444,815,31266941,106000,592000,-486000,0,0,0,1000,14000,-13000,-499000
20200316,2468,華經,13.00,13.10,12.65,12.75,-0.05,-0.39,188129,111,2412181,7000,22000,-15000,0,0,0,0,0,0,-15000
20200316,2471,資通,17.25,17.45,16.95,17.25,0.00,0.00,277535,149,4739223,9000,16000,-7000,0,0,0,0,0,0,-7000
20200316,2472,立隆電,30.10,30.45,28.10,28.10,-1.85,-6.18,490869,304,14318215,91000,159000,-68000,0,1000,-1000,39000,17000,22000,-47000
20200316,2474,可成,193.50,194.00,186.50,187.00,-3.50,-1.84,5628436,3914,1073428968,3448337,2719712,728625,44000,8000,36000,110000,274000,-164000,600625
20200316,2476,鉅祥,18.30,18.90,17.15,17.65,-0.85,-4.59,383928,240,6882570,23000,135000,-112000,0,0,0,0,0,0,-112000
20200316,2477,美隆電,18.00,18.80,17.80,18.45,+0.50,2.79,203000,122,3692150,39000,29000,10000,0,0,0,1000,19000,-18000,-8000
20200316,2478,大毅,58.30,61.70,53.50,53.50,-4.90,-8.39,13533749,8473,783812906,2801000,3659000,-858000,0,0,0,45000,126000,-81000,-939000
20200316,2480,敦陽科,56.50,56.60,54.50,54.50,-2.10,-3.71,2089396,1402,115830318,133000,907000,-774000,0,2000,-2000,1000,41000,-40000,-816000
20200316,2481,強茂,20.00,20.30,17.90,17.90,-1.95,-9.82,5369802,2778,101398810,1173000,1174000,-1000,0,0,0,25000,41000,-16000,-17000
20200316,2482,連宇,11.15,11.15,10.30,10.50,-0.65,-5.83,420181,182,4490791,8000,12000,-4000,0,0,0,0,0,0,-4000
20200316,2483,百容,17.50,17.50,17.00,17.00,0.00,0.00,171000,119,2932850,4000,11000,-7000,0,0,0,0,4000,-4000,-11000
20200316,2484,希華,17.20,17.25,16.25,16.45,-0.65,-3.8,1008811,573,16920899,67000,305000,-238000,0,0,0,1000,0,1000,-237000
20200316,2485,兆赫,14.05,14.35,13.25,13.25,-0.80,-5.69,1403599,838,19264332,307000,264000,43000,0,0,0,0,78000,-78000,-35000
20200316,2486,一詮,6.05,6.05,5.50,5.69,-0.29,-4.85,542883,248,3164881,28000,125000,-97000,0,0,0,0,1000,-1000,-98000
20200316,2488,漢平,27.50,27.50,26.50,26.50,-1.00,-3.64,326370,289,8831455,21000,120000,-99000,0,0,0,0,0,0,-99000
20200316,2489,瑞軒,7.49,7.55,7.10,7.17,-0.25,-3.37,1926921,909,14136071,423000,411000,12000,0,0,0,19000,100000,-81000,-69000
20200316,2491,吉祥全,8.20,8.49,7.62,7.62,-0.68,-8.19,320220,51,2563380,0,6000,-6000,0,0,0,0,0,0,-6000
20200316,2492,華新科,168.00,175.00,156.50,156.50,-11.50,-6.85,22424098,14870,3716377017,3780256,4573792,-793536,0,128000,-128000,779000,784000,-5000,-926536
20200316,2493,揚博,25.60,25.65,24.90,24.90,-0.70,-2.73,478310,260,12095109,9000,108000,-99000,0,0,0,0,6000,-6000,-105000
20200316,2495,普安,11.15,11.15,10.85,10.90,-0.15,-1.36,246045,106,2697667,9000,43000,-34000,0,0,0,0,0,0,-34000
20200316,2496,卓越,55.30,55.30,52.10,55.00,-0.50,-0.9,149210,119,7974140,1000,19000,-18000,0,0,0,0,2000,-2000,-20000
20200316,2497,怡利電,15.15,15.50,14.65,14.65,-0.40,-2.66,109200,72,1634080,2000,12000,-10000,0,0,0,0,0,0,-10000
20200316,2498,宏達電,29.75,30.25,27.00,27.00,-2.75,-9.24,12927572,6012,368229291,2278000,2352000,-74000,0,0,0,200000,412000,-212000,-286000
20200316,2499,東貝,7.07,7.34,6.61,6.80,-0.28,-3.95,4026368,1348,28146291,328000,646000,-318000,0,0,0,0,0,0,-318000
20200316,2501,國建,17.80,18.00,17.40,17.70,-0.30,-1.67,841657,582,14889106,73000,332000,-259000,0,0,0,0,191000,-191000,-450000
20200316,2504,國產,11.00,11.15,10.20,10.25,-0.60,-5.53,11589018,3367,124173523,1749000,2275000,-526000,0,0,0,48000,118000,-70000,-596000
20200316,2505,國揚,15.20,15.25,14.00,14.00,-1.25,-8.2,2222492,705,31760388,125000,919000,-794000,0,0,0,0,115000,-115000,-909000
20200316,2506,太設,9.42,9.89,9.42,9.69,-0.06,-0.62,128554,72,1244327,1000,12000,-11000,0,0,0,0,10000,-10000,-21000
20200316,2509,全坤建,19.10,20.00,18.60,20.00,0.00,0.00,145699,101,2816610,0,8000,-8000,0,0,0,0,0,0,-8000
20200316,2511,太子,9.65,9.65,9.34,9.43,-0.23,-2.38,1342912,474,12742141,301000,340000,-39000,0,0,0,0,30000,-30000,-69000
20200316,2514,龍邦,13.15,13.15,12.20,12.30,-1.00,-7.52,996919,384,12662810,1000,135000,-134000,0,0,0,0,13000,-13000,-147000
20200316,2515,中工,6.08,6.11,5.71,5.74,-0.30,-4.97,9497445,1920,55802441,1256000,1005000,251000,0,0,0,3000,29000,-26000,225000
20200316,2516,新建,4.61,4.61,4.40,4.47,-0.13,-2.83,295069,74,1327355,3000,15000,-12000,0,0,0,0,0,0,-12000
20200316,2520,冠德,21.85,21.95,21.20,21.30,-0.35,-1.62,8716154,1121,187022151,1118000,746000,372000,0,0,0,35000,254000,-219000,153000
20200316,2524,京城,26.40,28.25,26.40,28.25,+2.55,9.92,840081,279,23637720,47000,63000,-16000,0,6000,-6000,0,0,0,-22000
20200316,2527,宏璟,18.35,18.35,17.70,17.95,-0.25,-1.37,273000,118,4902200,11000,27000,-16000,0,0,0,37000,8000,29000,13000
20200316,2528,皇普,18.80,18.80,18.25,18.50,-0.60,-3.14,264979,103,4915765,19000,26000,-7000,0,0,0,3000,3000,0,-7000
20200316,2530,華建,16.15,16.30,15.85,16.30,0.00,0.00,94400,72,1519777,1000,5000,-4000,0,0,0,0,0,0,-4000
20200316,2534,宏盛,16.45,17.00,16.35,16.35,-0.60,-3.54,1584900,854,26421803,477000,290000,187000,0,0,0,0,4000,-4000,183000
20200316,2535,達欣工,20.35,20.45,19.90,19.95,-0.55,-2.68,2603050,1027,52433603,176000,688000,-512000,0,1000,-1000,7000,2000,5000,-508000
20200316,2536,宏普,21.40,22.00,21.40,21.55,+0.05,0.23,922050,261,20016075,81000,181000,-100000,0,0,0,0,3000,-3000,-103000
20200316,2537,聯上發,7.39,7.40,6.88,6.99,-0.30,-4.12,3905502,1292,27594060,607000,1007000,-400000,0,0,0,0,0,0,-400000
20200316,2538,基泰,9.38,9.38,9.01,9.07,-0.30,-3.2,852759,373,7795379,36000,226000,-190000,0,0,0,7000,0,7000,-183000
20200316,2539,櫻花建,29.85,29.90,29.00,29.25,+0.05,0.17,246799,116,7209871,9000,7000,2000,0,0,0,0,0,0,2000
20200316,2540,愛山林,21.00,21.00,21.00,21.00,-0.35,-1.64,10017,2,210347,0,0,0,0,0,0,0,0,0,0
20200316,2542,興富發,40.30,40.30,39.95,40.05,-0.35,-0.87,4541545,2434,181932596,1902000,1931000,-29000,0,0,0,103000,257000,-154000,-183000
20200316,2543,皇昌,6.80,7.00,6.63,7.00,+0.20,2.94,6001,4,40836,0,0,0,0,0,0,0,0,0,0
20200316,2545,皇翔,31.70,31.70,30.05,30.30,-1.30,-4.11,556500,294,16999599,10000,228000,-218000,0,0,0,0,0,0,-218000
20200316,2546,根基,36.10,36.10,34.35,35.35,-0.75,-2.08,412664,266,14369940,12000,137000,-125000,0,0,0,0,5000,-5000,-130000
20200316,2547,日勝生,8.60,8.70,8.20,8.20,-0.38,-4.43,1643593,693,13955287,336000,277000,59000,0,0,0,53000,7000,46000,105000
20200316,2548,華固,88.20,89.90,87.80,88.60,-0.30,-0.34,2010565,1433,178488854,615000,633000,-18000,50000,4000,46000,69000,88000,-19000,9000
20200316,2597,潤弘,56.80,56.80,55.50,55.60,-0.90,-1.59,86500,79,4845600,0,17000,-17000,0,0,0,1000,16000,-15000,-32000
20200316,2601,益航,8.10,8.18,7.75,7.94,-0.11,-1.37,7875965,572,62613755,305000,689000,-384000,0,12000,-12000,0,0,0,-396000
20200316,2603,長榮,10.50,10.50,9.86,9.86,-0.59,-5.65,29131448,6630,293858976,3857000,8240755,-4383755,11000,18000,-7000,7000,858000,-851000,-5241755
20200316,2605,新興,11.85,11.85,11.30,11.35,-0.50,-4.22,1950061,708,22404727,71000,541000,-470000,0,4000,-4000,0,12000,-12000,-486000
20200316,2606,裕民,26.85,27.10,26.00,26.00,-1.15,-4.24,2435279,1606,64304321,367000,260000,107000,2000,3000,-1000,2000,98000,-96000,10000
20200316,2607,榮運,12.50,12.60,12.05,12.25,-0.25,-2.0,1336549,356,16487346,231000,285000,-54000,0,0,0,0,25000,-25000,-79000
20200316,2608,嘉里大榮,36.50,36.55,35.00,35.05,-1.10,-3.04,480043,360,17108079,36000,204000,-168000,0,0,0,0,41000,-41000,-209000
20200316,2609,陽明,5.51,5.66,5.20,5.20,-0.48,-8.45,4091953,1033,22102979,270000,138000,132000,0,0,0,0,0,0,132000
20200316,2610,華航,7.28,7.28,6.98,6.98,-0.30,-4.12,26999376,6795,189812346,3308000,7967000,-4659000,13000,29000,-16000,3000,1046000,-1043000,-5718000
20200316,2611,志信,6.33,6.62,6.33,6.34,+0.02,0.32,112500,47,722687,1000,8000,-7000,0,0,0,0,0,0,-7000
20200316,2612,中航,22.20,22.20,21.30,21.60,0.00,0.00,451526,277,9752451,42000,115000,-73000,0,0,0,0,0,0,-73000
20200316,2613,中櫃,11.40,11.70,11.10,11.35,-0.30,-2.58,92279,78,1046084,1000,10000,-9000,0,0,0,0,1000,-1000,-10000
20200316,2614,東森,11.05,11.50,10.70,10.80,-0.25,-2.26,3998783,1439,44287205,387000,515000,-128000,0,0,0,0,0,0,-128000
20200316,2615,萬海,15.15,15.15,14.30,14.30,-0.80,-5.3,2545075,1057,37146225,228000,966271,-738271,5000,5000,0,0,180000,-180000,-918271
20200316,2616,山隆,28.10,28.10,27.55,27.70,-0.10,-0.36,188950,269,5241050,7000,33000,-26000,0,0,0,0,0,0,-26000
20200316,2617,台航,13.75,13.80,13.50,13.50,-0.20,-1.46,730800,324,9976449,33000,257000,-224000,0,0,0,0,0,0,-224000
20200316,2618,長榮航,10.75,10.80,10.05,10.05,-0.70,-6.51,26441153,7521,271621832,3977000,6303000,-2326000,11000,717900,-706900,284000,2261000,-1977000,-5009900
20200316,2630,亞航,14.30,14.30,12.95,13.55,-0.75,-5.24,87000,59,1159450,2000,1000,1000,0,0,0,0,1000,-1000,0
20200316,2633,台灣高鐵,29.70,30.00,29.60,29.60,-0.10,-0.34,8876578,4052,264426205,1785000,4286648,-2501648,6000,3000,3000,45000,317000,-272000,-2770648
20200316,2634,漢翔,27.70,28.00,27.30,27.45,-0.20,-0.72,3944270,1831,108576166,258000,1248161,-990161,2000,1000,1000,0,19000,-19000,-1008161
20200316,2636,台驊投控,19.50,20.20,19.50,20.00,-0.20,-0.99,441579,231,8764680,11000,41000,-30000,0,0,0,0,2000,-2000,-32000
20200316,2637,慧洋-KY,24.75,24.75,23.65,23.85,-0.95,-3.83,2308338,1038,55513757,257000,607000,-350000,1000,0,1000,470000,73000,397000,48000
20200316,2642,宅配通,26.00,26.30,25.00,25.00,-1.00,-3.85,1060537,617,26961957,155000,136000,19000,0,0,0,0,0,0,19000
20200316,2701,萬企,11.70,11.75,11.30,11.35,-0.40,-3.4,159634,67,1836811,1000,20000,-19000,0,0,0,0,0,0,-19000
20200316,2702,華園,12.75,13.00,12.30,12.30,-0.55,-4.28,234883,167,2955406,78000,29000,49000,0,0,0,0,0,0,49000
20200316,2704,國賓,23.60,24.90,23.45,23.55,-0.05,-0.21,324100,137,7671284,35000,58000,-23000,0,0,0,143000,0,143000,120000
20200316,2705,六福,10.35,10.40,10.10,10.10,-0.20,-1.94,168575,189,1721034,0,14000,-14000,0,0,0,0,1000,-1000,-15000
20200316,2706,第一店,13.40,13.40,13.00,13.05,-0.35,-2.61,255441,115,3339798,6000,25000,-19000,0,0,0,0,0,0,-19000
20200316,2707,晶華,135.00,136.00,130.00,130.00,-8.00,-5.8,611994,489,81317208,57000,171000,-114000,0,31228,-31228,0,29000,-29000,-174228
20200316,2712,遠雄來,34.95,37.05,34.95,37.05,+0.10,0.27,2003,4,72111,1000,1000,0,0,0,0,0,0,0,0
20200316,2722,夏都,21.50,21.50,20.00,20.15,-1.85,-8.41,33000,28,669050,2000,0,2000,0,0,0,0,0,0,2000
20200316,2723,美食-KY,76.90,77.60,69.70,69.90,-7.00,-9.1,2963812,2310,215965960,469000,1702823,-1233823,1000,0,1000,0,26000,-26000,-1258823
20200316,2727,王品,63.30,63.30,60.70,60.70,-2.80,-4.41,617427,624,37880035,54000,131000,-77000,0,33000,-33000,0,0,0,-110000
20200316,2731,雄獅,65.00,65.00,61.00,61.00,-4.90,-7.44,299300,260,18519169,24000,64000,-40000,0,0,0,0,0,0,-40000
20200316,2739,寒舍,21.50,21.50,20.40,20.60,-1.15,-5.29,68474,54,1421799,0,3000,-3000,0,0,0,0,0,0,-3000
20200316,2748,雲品,40.00,40.00,38.75,39.00,-1.10,-2.74,140000,107,5491950,7000,15000,-8000,0,11000,-11000,0,0,0,-19000
20200316,2801,彰銀,22.00,22.00,21.05,21.20,-1.05,-4.72,14986455,4677,324129870,4403000,9262293,-4859293,23000,34000,-11000,51000,882000,-831000,-5701293
20200316,2809,京城銀,30.90,30.90,29.10,29.10,-2.85,-8.92,7679983,3318,230284696,966000,1962000,-996000,2000,789000,-787000,50000,915000,-865000,-2648000
20200316,2812,台中銀,11.10,11.10,10.75,10.75,-0.45,-4.02,16274635,5807,177387425,1050000,4261070,-3211070,0,8000,-8000,30000,611000,-581000,-3800070
20200316,2816,旺旺保,18.50,18.50,17.40,17.55,-0.75,-4.1,457360,181,8106522,9000,140000,-131000,0,0,0,0,0,0,-131000
20200316,2820,華票,14.35,14.40,13.95,14.05,-0.30,-2.09,2457486,1188,34571166,449000,768000,-319000,0,0,0,4000,189000,-185000,-504000
20200316,2823,中壽,18.85,18.85,17.30,17.30,-1.40,-7.49,35682432,11010,636886012,8107000,19813792,-11706792,11000,13000,-2000,135000,745000,-610000,-12318792
20200316,2832,台產,18.80,19.20,18.65,18.75,-0.60,-3.1,616602,301,11596163,7000,151000,-144000,0,0,0,0,0,0,-144000
20200316,2834,臺企銀,10.30,10.30,10.00,10.00,-0.30,-2.91,47873855,10731,482587479,4936000,17328567,-12392567,15000,3000,12000,36000,1027000,-991000,-13371567
20200316,2836,高雄銀,9.11,9.16,8.87,8.96,-0.26,-2.82,1458834,469,13129000,91000,547000,-456000,0,0,0,6000,0,6000,-450000
20200316,2838,聯邦銀,10.15,10.20,9.93,9.96,-0.19,-1.87,3621311,1178,36273062,380000,1073000,-693000,0,0,0,6000,412000,-406000,-1099000
20200316,2838A,聯邦銀甲特,53.80,53.80,52.30,53.30,-0.60,-1.11,746907,292,39355787,0,8000,-8000,0,0,0,24000,23000,1000,-7000
20200316,2841,台開,5.85,5.85,5.68,5.68,-0.12,-2.07,3851380,1102,22109298,317000,1402000,-1085000,0,0,0,0,15000,-15000,-1100000
20200316,2845,遠東銀,10.40,10.40,9.98,10.00,-0.50,-4.76,14264862,3020,143967211,983000,2394000,-1411000,7000,3000,4000,11000,486000,-475000,-1882000
20200316,2849,安泰銀,13.65,13.90,13.10,13.30,-0.35,-2.56,263452,135,3533278,13000,120000,-107000,0,0,0,0,8000,-8000,-115000
20200316,2850,新產,34.20,34.50,32.70,32.70,-1.45,-4.25,817038,646,27183336,78000,288000,-210000,0,0,0,2000,0,2000,-208000
20200316,2851,中再保,17.90,17.90,17.00,17.05,-0.80,-4.48,755844,454,13066324,28000,287451,-259451,0,0,0,0,2000,-2000,-261451
20200316,2852,第一保,12.25,12.25,11.80,12.00,-0.25,-2.04,191058,105,2282814,5000,89000,-84000,0,0,0,0,6000,-6000,-90000
20200316,2855,統一證,12.00,12.00,11.60,11.60,-0.40,-3.33,1411186,521,16626502,69000,768000,-699000,0,24000,-24000,0,0,0,-723000
20200316,2867,三商壽,9.70,9.77,9.17,9.29,-0.48,-4.91,8031116,2092,75398262,1086000,2410000,-1324000,0,0,0,0,399000,-399000,-1723000
20200316,2880,華南金,19.40,19.40,18.75,18.75,-0.80,-4.09,36149413,14120,684715959,7607000,16863983,-9256983,27000,44000,-17000,39000,964000,-925000,-10198983
20200316,2881,富邦金,39.95,39.95,38.00,38.05,-1.60,-4.04,38573225,12498,1494282167,24213000,28736991,-4523991,24000,350000,-326000,74000,1036000,-962000,-5811991
20200316,2881A,富邦特,64.20,64.20,63.30,63.80,-0.60,-0.93,527621,173,33554345,34000,90000,-56000,0,0,0,84000,0,84000,28000
20200316,2881B,富邦金乙特,63.90,63.90,62.50,63.20,-1.10,-1.71,412076,144,26153051,0,0,0,0,0,0,39000,28000,11000,11000
20200316,2882,國泰金,36.70,36.70,35.70,35.80,-1.20,-3.24,36139465,14036,1302986990,9902118,20383075,-10480957,29000,37000,-8000,20000,2694000,-2674000,-13162957
20200316,2882A,國泰特,63.20,63.20,62.60,62.80,-0.80,-1.26,649775,668,40889869,0,0,0,0,0,0,16000,3000,13000,13000
20200316,2882B,國泰金乙特,63.10,63.10,62.30,63.10,-0.60,-0.94,335506,124,21020273,37000,0,37000,0,0,0,24000,22000,2000,39000
20200316,2883,開發金,8.18,8.24,7.92,7.93,-0.36,-4.34,44385543,8937,355252295,10350000,22296159,-11946159,34000,18000,16000,33000,1312000,-1279000,-13209159
20200316,2884,玉山金,26.05,26.20,25.20,25.20,-1.30,-4.91,88087851,31879,2258031391,13439110,32270252,-18831142,26000,32000,-6000,372000,1476000,-1104000,-19941142
20200316,2885,元大金,17.20,17.20,16.45,16.45,-0.95,-5.46,39235720,8060,659246238,11973000,30791608,-18818608,27000,32000,-5000,774000,37000,737000,-18086608
20200316,2886,兆豐金,29.10,29.55,29.00,29.00,-1.00,-3.33,54477197,14832,1592797134,11840000,34301434,-22461434,31000,44000,-13000,1888000,977000,911000,-21563434
20200316,2887,台新金,12.95,13.00,12.50,12.55,-0.60,-4.56,56425079,16745,716927322,11985000,21195505,-9210505,24000,24000,0,28000,850000,-822000,-10032505
20200316,2887E,台新戊特,54.20,54.20,53.50,53.50,-1.50,-2.73,304966,157,16410479,0,0,0,0,0,0,9000,0,9000,9000
20200316,2887F,台新戊特二,53.30,53.30,51.90,51.90,-1.40,-2.63,250198,100,13107770,0,0,0,0,0,0,0,0,0,0
20200316,2888,新光金,8.35,8.35,8.01,8.03,-0.33,-3.95,74646244,11746,605118861,12503000,30136879,-17633879,300000,10000,290000,690000,1389000,-699000,-18042879
20200316,2888A,新光金甲特,45.00,45.00,44.55,44.60,-0.40,-0.89,751219,213,33658211,0,0,0,0,0,0,0,40000,-40000,-40000
20200316,2889,國票金,10.00,10.05,9.86,9.96,-0.24,-2.35,7099748,3150,70656732,559000,2103000,-1544000,0,9000,-9000,21000,433000,-412000,-1965000
20200316,2890,永豐金,11.25,11.25,10.65,10.70,-0.60,-5.31,32201764,6963,349447808,7995075,22824018,-14828943,26000,36000,-10000,29000,607000,-578000,-15416943
20200316,2891,中信金,19.50,19.50,19.00,19.05,-0.60,-3.05,104731939,26681,2011321104,40196000,74706427,-34510427,43000,61000,-18000,63000,1358000,-1295000,-35823427
20200316,2891B,中信金乙特,64.40,65.50,63.30,65.50,-0.40,-0.61,178610,105,11541206,22000,0,22000,0,0,0,2000,19000,-17000,5000
20200316,2891C,中信金丙特,61.50,61.80,61.40,61.70,-0.60,-0.96,161331,122,9927616,0,0,0,0,0,0,7000,9000,-2000,-2000
20200316,2892,第一金,21.05,21.05,20.10,20.10,-1.05,-4.96,42932804,16088,873693841,7285000,19858393,-12573393,28000,35000,-7000,28000,830000,-802000,-13382393
20200316,2897,王道銀行,6.40,6.49,6.01,6.13,-0.46,-6.98,3895396,953,23899960,107000,613000,-506000,5000,0,5000,13000,221000,-208000,-709000
20200316,2897A,王道銀甲特,10.30,10.30,10.00,10.00,-0.35,-3.38,1432000,201,14417850,0,0,0,0,0,0,573000,0,573000,573000
20200316,2901,欣欣,23.10,23.10,22.25,23.00,-0.25,-1.08,16201,16,369471,1000,1000,0,0,0,0,0,0,0,0
20200316,2903,遠百,21.00,21.15,20.80,21.05,+0.05,0.24,1725372,620,36197517,280000,516000,-236000,0,0,0,0,190000,-190000,-426000
20200316,2904,匯僑,19.25,19.25,18.95,19.05,-0.20,-1.04,128210,95,2448740,0,8000,-8000,0,0,0,2000,0,2000,-6000
20200316,2905,三商,17.60,17.65,16.70,17.00,-0.70,-3.95,1503193,598,25679181,114000,460000,-346000,0,0,0,0,0,0,-346000
20200316,2906,高林,10.15,10.15,9.86,9.86,-0.29,-2.86,55200,29,554100,1000,6000,-5000,0,0,0,0,0,0,-5000
20200316,2908,特力,19.45,19.45,18.90,19.25,-0.15,-0.77,272719,139,5234981,4000,44000,-40000,0,0,0,0,0,0,-40000
20200316,2910,統領,25.25,26.10,23.85,26.10,+2.35,9.89,37000,23,926200,1000,3000,-2000,0,0,0,0,0,0,-2000
20200316,2911,麗嬰房,6.30,6.30,6.01,6.23,-0.07,-1.11,402985,188,2450607,4000,30000,-26000,0,0,0,0,5000,-5000,-31000
20200316,2912,統一超,273.50,274.00,271.00,274.00,+0.50,0.18,2292792,1580,625392870,1376039,1634176,-258137,53000,2000,51000,1000,96000,-95000,-302137
20200316,2913,農林,13.70,13.95,13.50,13.65,-0.30,-2.15,1000496,398,13663957,200000,271000,-71000,0,0,0,2000,3000,-1000,-72000
20200316,2915,潤泰全,65.50,65.60,64.50,65.40,-0.70,-1.06,2929509,1704,190575285,852000,1256000,-404000,0,2000,-2000,932000,124000,808000,402000
20200316,2923,鼎固-KY,21.80,21.80,21.45,21.45,-0.15,-0.69,64117,36,1379878,0,8000,-8000,0,0,0,0,0,0,-8000
20200316,2929,淘帝-KY,59.20,60.20,58.60,58.60,-0.60,-1.01,879222,724,52215198,278000,255000,23000,0,0,0,0,4000,-4000,19000
20200316,2936,客思達-KY,15.55,15.55,14.75,14.80,-1.55,-9.48,79000,41,1180850,5000,0,5000,0,0,0,0,1000,-1000,4000
20200316,2939,凱羿-KY,90.50,90.50,87.10,87.10,-3.00,-3.33,34010,33,3011779,0,17000,-17000,0,0,0,0,0,0,-17000
20200316,3002,歐格,9.10,9.28,8.90,8.91,+0.08,0.91,136121,76,1232521,5000,16000,-11000,0,0,0,0,1000,-1000,-12000
20200316,3003,健和興,34.00,34.35,31.65,32.60,-1.00,-2.98,868228,560,28850224,330000,189000,141000,0,202000,-202000,1000,15000,-14000,-75000
20200316,3004,豐達科,60.30,60.30,52.80,52.80,-5.80,-9.9,791431,629,43934364,92000,92000,0,0,0,0,0,0,0,0
20200316,3005,神基,47.80,48.50,46.55,47.20,0.00,0.00,3413187,1391,163604105,497000,2226000,-1729000,0,2000,-2000,1403000,101000,1302000,-429000
20200316,3006,晶豪科,31.10,31.20,28.40,28.50,-2.00,-6.56,4600119,2376,136294391,391000,1464000,-1073000,0,0,0,81000,553000,-472000,-1545000
20200316,3008,大立光,3985.00,4020.00,3710.00,3725.00,-335.00,-8.25,1176019,1634,4539706250,309000,686614,-377614,7211,10000,-2789,5000,53000,-48000,-428403
20200316,3010,華立,49.35,49.45,48.15,48.15,-1.20,-2.43,464282,388,22510631,35000,280000,-245000,0,3000,-3000,1000,9000,-8000,-256000
20200316,3011,今皓,4.44,4.44,4.21,4.30,-0.10,-2.27,193002,70,832928,0,2000,-2000,0,0,0,0,0,0,-2000
20200316,3013,晟銘電,11.60,11.60,11.20,11.40,0.00,0.00,423010,179,4803164,4000,118000,-114000,0,0,0,1000,0,1000,-113000
20200316,3014,聯陽,42.70,43.40,40.50,40.50,-3.05,-7.0,4039147,2598,169033627,306000,1514000,-1208000,0,5000,-5000,35000,86000,-51000,-1264000
20200316,3015,全漢,17.25,17.25,16.80,16.80,-0.60,-3.45,265687,145,4515769,22000,103000,-81000,0,0,0,0,7000,-7000,-88000
20200316,3016,嘉晶,52.00,53.20,49.20,49.50,-2.40,-4.62,12950889,8217,668546469,1145000,997000,148000,0,0,0,144000,278000,-134000,14000
20200316,3017,奇鋐,30.40,31.25,28.60,28.75,-1.45,-4.8,10961444,5655,329864423,2460000,1909000,551000,339000,1000,338000,29000,81000,-52000,837000
20200316,3018,同開,18.00,18.55,16.60,16.60,-1.80,-9.78,1014314,506,17661450,211000,150000,61000,0,0,0,0,0,0,61000
20200316,3019,亞光,68.90,69.50,62.00,62.00,-6.00,-8.82,5088511,3411,334596934,832000,1325000,-493000,20000,0,20000,75000,437000,-362000,-835000
20200316,3021,鴻名,12.60,12.75,12.45,12.55,-0.20,-1.57,48700,34,613015,1000,2000,-1000,0,0,0,0,1000,-1000,-2000
20200316,3022,威強電,39.20,39.20,35.05,35.05,-3.85,-9.9,2178520,739,77156920,174000,39000,135000,0,0,0,0,8000,-8000,127000
20200316,3023,信邦,108.00,111.50,104.00,104.00,-7.00,-6.31,2524019,1897,269866972,579000,1713600,-1134600,190000,0,190000,3000,91000,-88000,-1032600
20200316,3024,憶聲,6.62,6.81,6.55,6.65,+0.04,0.61,467462,89,3089491,15000,58000,-43000,0,0,0,0,0,0,-43000
20200316,3025,星通,16.00,16.30,15.25,15.25,-0.95,-5.86,216019,111,3406038,12000,31000,-19000,0,0,0,1000,0,1000,-18000
20200316,3026,禾伸堂,94.80,95.70,88.50,88.50,-6.30,-6.65,5802481,4010,536196533,489000,1231000,-742000,0,0,0,40000,127000,-87000,-829000
20200316,3027,盛達,6.57,6.80,6.10,6.30,-0.29,-4.4,303609,126,1929478,3000,13000,-10000,0,0,0,0,4000,-4000,-14000
20200316,3028,增你強,18.35,18.35,17.85,17.85,-0.55,-2.99,674929,468,12158611,14000,133000,-119000,0,0,0,1000,1000,0,-119000
20200316,3029,零壹,28.45,29.15,28.05,28.20,-0.20,-0.7,1874380,1195,53670278,334000,438000,-104000,0,0,0,1000,0,1000,-103000
20200316,3030,德律,47.35,47.85,45.00,45.00,-2.30,-4.86,998650,778,46067324,123000,548000,-425000,0,4000,-4000,7000,40000,-33000,-462000
20200316,3031,佰鴻,11.65,11.80,10.80,10.85,-0.80,-6.87,424134,225,4768896,84000,166000,-82000,0,0,0,0,0,0,-82000
20200316,3032,偉訓,22.55,22.70,21.95,21.95,-0.50,-2.23,280101,125,6200277,26000,32000,-6000,0,0,0,2000,9000,-7000,-13000
20200316,3033,威健,14.85,14.85,13.80,13.80,-0.90,-6.12,1430738,927,20386782,63000,192000,-129000,0,0,0,0,0,0,-129000
20200316,3034,聯詠,180.00,183.00,171.50,171.50,-7.00,-3.92,5326445,3538,943757930,2322987,2683189,-360202,10000,14000,-4000,224000,149000,75000,-289202
20200316,3035,智原,34.60,35.85,32.50,32.70,-1.85,-5.35,6055889,3711,208889364,2021000,1479000,542000,0,0,0,70000,172000,-102000,440000
20200316,3036,文曄,36.80,37.05,35.55,35.55,-1.25,-3.4,1635331,832,58900091,118000,299000,-181000,2000,9000,-7000,131000,77000,54000,-134000
20200316,3037,欣興,31.30,31.85,28.40,28.40,-3.05,-9.7,36863881,15742,1110098733,8200731,6938000,1262731,0,2104000,-2104000,193000,1632000,-1439000,-2280269
20200316,3038,全台,13.80,14.15,13.40,13.45,-0.20,-1.47,2021095,947,27863234,227000,384000,-157000,0,0,0,4000,0,4000,-153000
20200316,3040,遠見,25.65,27.10,25.65,26.20,+0.55,2.14,131791,114,3478473,1000,16000,-15000,0,0,0,0,0,0,-15000
20200316,3041,揚智,16.10,16.15,14.25,14.30,-1.50,-9.49,6141179,3064,91858110,579000,2204000,-1625000,0,0,0,0,0,0,-1625000
20200316,3042,晶技,44.50,46.40,43.80,44.00,+1.00,2.33,17991501,10450,810910844,5997000,2913000,3084000,0,626000,-626000,158000,679000,-521000,1937000
20200316,3043,科風,1.65,1.65,1.65,1.65,+0.03,1.85,145457,36,239966,0,0,0,0,0,0,0,0,0,0
20200316,3044,健鼎,97.00,97.80,92.30,93.10,-3.80,-3.92,2171954,1736,206322610,1074000,1499454,-425454,0,1000,-1000,5000,97000,-92000,-518454
20200316,3045,台灣大,104.50,104.50,103.00,103.50,-1.50,-1.43,4853727,2562,501888711,1998144,3219352,-1221208,8000,8000,0,6000,311000,-305000,-1526208
20200316,3046,建碁,9.51,9.51,8.57,8.57,-0.88,-9.31,178311,67,1641439,5000,7000,-2000,0,0,0,0,0,0,-2000
20200316,3047,訊舟,7.17,7.30,6.83,6.85,-0.35,-4.86,899915,314,6355789,95000,105000,-10000,0,0,0,0,1000,-1000,-11000
20200316,3048,益登,13.85,14.30,13.35,13.50,+0.10,0.75,2274401,1143,31331566,136000,863000,-727000,0,0,0,0,18000,-18000,-745000
20200316,3049,和鑫,9.19,9.53,9.00,9.12,+0.05,0.55,10963574,3588,102057068,2921000,2591000,330000,0,17000,-17000,22000,41000,-19000,294000
20200316,3050,鈺德,9.23,9.23,8.78,8.83,-0.37,-4.02,676045,260,6080302,27000,78000,-51000,0,0,0,0,0,0,-51000
20200316,3051,力特,3.26,3.44,3.25,3.34,+0.09,2.77,527802,118,1752003,0,0,0,0,0,0,0,0,0,0
20200316,3052,夆典,9.48,9.54,8.71,9.03,-0.45,-4.75,1682215,546,15445860,753000,486000,267000,0,0,0,0,0,0,267000
20200316,3054,立萬利,23.40,24.25,22.95,23.80,-0.30,-1.24,18003,21,421172,2000,2000,0,0,0,0,0,1000,-1000,-1000
20200316,3055,蔚華科,25.60,25.70,25.15,25.30,-0.30,-1.17,185754,135,4715861,32000,44000,-12000,0,0,0,0,37000,-37000,-49000
20200316,3056,總太,25.90,25.95,24.15,24.70,-1.85,-6.97,2876448,1402,71772260,137000,1046000,-909000,0,10000,-10000,15000,46000,-31000,-950000
20200316,3057,喬鼎,4.90,4.99,4.75,4.77,-0.15,-3.05,206046,91,1001229,0,3000,-3000,0,0,0,0,0,0,-3000
20200316,3058,立德,5.86,5.86,5.63,5.70,-0.13,-2.23,197347,99,1125734,4000,10000,-6000,0,0,0,0,0,0,-6000
20200316,3059,華晶科,17.80,18.05,17.60,17.65,-0.35,-1.94,1729262,781,30885000,182000,363000,-181000,0,0,0,0,7000,-7000,-188000
20200316,3060,銘異,12.70,13.10,12.05,12.20,-0.45,-3.56,2230200,1092,27892964,262000,776000,-514000,0,0,0,0,10000,-10000,-524000
20200316,3062,建漢,13.00,13.30,12.20,12.25,-0.80,-6.13,1687973,826,21416545,256000,483000,-227000,0,0,0,0,12000,-12000,-239000
20200316,3090,日電貿,42.00,42.50,39.50,39.50,-2.30,-5.5,2754250,1981,112951010,353000,1303000,-950000,0,0,0,8000,19000,-11000,-961000
20200316,3094,聯傑,16.65,17.00,15.70,16.00,-0.90,-5.33,435020,280,7111470,26000,131000,-105000,0,0,0,0,0,0,-105000
20200316,3130,一零四,146.50,146.50,143.50,143.50,-3.00,-2.05,14001,14,2030660,0,2000,-2000,0,0,0,0,0,0,-2000
20200316,3149,正達,5.74,6.20,5.74,5.80,+0.06,1.05,532030,226,3117337,17000,41000,-24000,0,0,0,0,0,0,-24000
20200316,3164,景岳,22.15,22.20,20.90,21.15,-1.25,-5.58,189000,111,4062000,1000,21000,-20000,0,0,0,0,0,0,-20000
20200316,3167,大量,37.05,38.05,34.20,34.25,-3.75,-9.87,701030,256,24780215,13000,30000,-17000,0,0,0,0,2000,-2000,-19000
20200316,3189,景碩,42.75,42.75,39.00,39.00,-3.75,-8.77,6358876,3908,257940340,729000,3162000,-2433000,0,500000,-500000,132000,237000,-105000,-3038000
20200316,3209,全科,17.60,17.90,17.30,17.35,-0.10,-0.57,805655,483,14192078,51000,122000,-71000,0,0,0,0,1000,-1000,-72000
20200316,3229,晟鈦,9.96,10.15,9.75,10.00,-0.40,-3.85,68000,44,671840,0,0,0,0,0,0,0,0,0,0
20200316,3231,緯創,23.05,23.15,22.10,22.15,-0.85,-3.7,16437960,8225,369901511,3667467,11633143,-7965676,73000,9000,64000,1891000,1121000,770000,-7131676
20200316,3257,虹冠電,48.65,48.65,45.65,48.10,+0.05,0.1,591254,312,27668279,63000,39000,24000,0,0,0,0,0,0,24000
20200316,3266,昇陽,13.40,13.40,12.75,12.95,-0.45,-3.36,137000,27,1776800,0,3000,-3000,0,0,0,0,1000,-1000,-4000
20200316,3296,勝德,11.85,12.45,11.85,12.45,+0.05,0.4,70000,42,848500,1000,0,1000,0,0,0,3000,0,3000,4000
20200316,3305,昇貿,19.90,19.90,19.05,19.55,-0.15,-0.76,110473,90,2134254,6000,30000,-24000,0,0,0,0,0,0,-24000
20200316,3308,聯德,4.54,4.54,4.50,4.54,0.00,0.00,32000,6,145000,0,0,0,0,0,0,0,0,0,0
20200316,3311,閎暉,23.10,23.10,22.00,22.30,-0.75,-3.25,115151,221,2594872,12000,42000,-30000,0,0,0,0,0,0,-30000
20200316,3312,弘憶股,11.85,12.05,11.65,11.70,0.00,0.00,722178,329,8552310,124000,143000,-19000,0,0,0,0,0,0,-19000
20200316,3321,同泰,8.23,8.60,8.23,8.23,-0.91,-9.96,1194347,360,9882321,67000,22000,45000,0,10000,-10000,0,60000,-60000,-25000
20200316,3338,泰碩,86.00,88.70,76.60,77.00,-8.00,-9.41,16705857,11700,1391166627,1601000,1427000,174000,8000,146000,-138000,169000,322000,-153000,-117000
20200316,3346,麗清,22.20,22.20,19.60,19.70,-1.30,-6.19,192000,137,3845550,23000,21000,2000,0,0,0,0,0,0,2000
20200316,3356,奇偶,22.10,22.60,20.55,20.80,-1.30,-5.88,318361,245,6845402,53000,47000,6000,0,0,0,0,0,0,6000
20200316,3376,新日興,117.00,118.50,107.00,109.00,-8.00,-6.84,3484663,2140,394655747,1112000,1663107,-551107,109000,1000,108000,28000,132000,-104000,-547107
20200316,3380,明泰,18.00,18.30,17.30,17.30,-0.50,-2.81,3550395,1544,63549049,227000,858000,-631000,0,0,0,245000,159000,86000,-545000
20200316,3383,新世紀,4.39,4.65,4.38,4.38,-0.48,-9.88,46403,20,205393,0,0,0,0,0,0,0,0,0,0
20200316,3406,玉晶光,410.00,421.00,373.50,373.50,-41.50,-10.0,10482597,8493,4168936447,1437000,1686000,-249000,0,80000,-80000,281000,568000,-287000,-616000
20200316,3413,京鼎,122.00,125.00,110.50,111.00,-9.00,-7.5,3595433,2715,423371996,1370000,444000,926000,0,275000,-275000,4000,321000,-317000,334000
20200316,3416,融程電,52.20,52.20,50.70,51.50,-0.50,-0.96,154000,74,7929700,1000,41000,-40000,0,0,0,1000,1000,0,-40000
20200316,3419,譁裕,11.95,11.95,10.65,10.65,-1.00,-8.58,689017,341,7751975,196000,98000,98000,0,0,0,0,0,0,98000
20200316,3432,台端,10.00,10.00,9.72,9.72,-0.28,-2.8,192500,67,1889140,2000,9000,-7000,0,0,0,0,0,0,-7000
20200316,3437,榮創,13.10,13.25,11.95,12.10,-0.90,-6.92,1323255,629,16545036,212000,412000,-200000,0,0,0,0,0,0,-200000
20200316,3443,創意,190.00,194.50,181.50,181.50,-4.50,-2.42,1948819,1462,368639877,446000,401000,45000,0,0,0,14000,23000,-9000,36000
20200316,3450,聯鈞,62.60,64.00,59.00,59.00,-3.50,-5.6,7444317,4813,461119623,1267000,2457000,-1190000,615000,0,615000,11000,211000,-200000,-775000
20200316,3454,晶睿,72.10,73.10,70.00,70.10,-1.80,-2.5,222911,204,15914881,35000,71000,-36000,0,1000,-1000,0,8000,-8000,-45000
20200316,3481,群創,6.30,6.45,6.01,6.02,-0.25,-3.99,144402213,23063,896596376,32290000,51781287,-19491287,0,4833000,-4833000,847000,3894000,-3047000,-27371287
20200316,3494,誠研,3.77,3.77,3.41,3.42,-0.35,-9.28,253612,119,905771,1000,1000,0,0,0,0,0,0,0,0
20200316,3501,維熹,41.50,42.00,41.05,41.05,-0.20,-0.48,219557,174,9080589,18000,39000,-21000,0,0,0,0,0,0,-21000
20200316,3504,揚明光,54.50,56.70,50.50,50.50,-5.60,-9.98,1702019,1087,89338608,529000,114000,415000,1000,0,1000,0,24000,-24000,392000
20200316,3515,華擎,87.50,91.50,84.50,84.50,-1.60,-1.86,3164835,2616,278036175,356000,872000,-516000,303000,4000,299000,103000,40000,63000,-154000
20200316,3518,柏騰,22.60,23.25,21.20,21.20,-1.05,-4.72,652018,435,14642330,117000,163000,-46000,0,0,0,0,0,0,-46000
20200316,3528,安馳,36.40,36.40,35.10,35.75,-0.70,-1.92,99235,75,3524283,3000,9000,-6000,0,0,0,0,2000,-2000,-8000
20200316,3530,晶相光,88.10,90.70,80.90,80.90,-8.90,-9.91,3256738,2349,278473044,502000,612000,-110000,0,0,0,7000,82000,-75000,-185000
20200316,3532,台勝科,139.50,143.00,134.00,134.00,-5.00,-3.6,3172518,2237,439900394,436000,977048,-541048,1000,0,1000,740000,5000,735000,194952
20200316,3533,嘉澤,249.50,253.00,225.50,225.50,-25.00,-9.98,1216413,994,290822164,302000,491000,-189000,33000,1000,32000,23000,38000,-15000,-172000
20200316,3535,晶彩科,13.10,13.45,11.90,11.90,-1.15,-8.81,1671515,777,21281081,583000,254000,329000,0,0,0,0,0,0,329000
20200316,3536,誠創,3.95,3.95,3.95,3.95,0.00,0.00,1057,4,4174,0,0,0,0,0,0,1000,0,1000,1000
20200316,3545,敦泰,27.10,28.80,25.90,26.30,-0.35,-1.31,9826017,4213,266704126,821000,2726000,-1905000,0,0,0,0,30000,-30000,-1935000
20200316,3550,聯穎,10.90,10.90,10.30,10.45,-0.25,-2.34,139733,106,1475898,0,8000,-8000,0,0,0,0,0,0,-8000
20200316,3557,嘉威,47.90,47.90,42.80,42.80,-3.95,-8.45,530120,350,23497600,16000,212000,-196000,0,0,0,0,0,0,-196000
20200316,3563,牧德,300.00,305.00,274.50,274.50,-30.50,-10.0,1919270,1772,551043020,132000,934000,-802000,0,6000,-6000,22000,42000,-20000,-828000
20200316,3576,聯合再生,5.36,5.49,5.01,5.01,-0.33,-6.18,10795376,2288,56510368,988000,1116000,-128000,0,0,0,0,0,0,-128000
20200316,3583,辛耘,43.20,43.55,40.20,40.30,-2.45,-5.73,504647,369,21081777,107000,182000,-75000,0,0,0,0,0,0,-75000
20200316,3588,通嘉,23.40,24.30,22.10,22.45,-1.40,-5.87,485221,280,11084332,112000,99000,13000,0,0,0,0,0,0,13000
20200316,3591,艾笛森,9.20,9.26,8.72,8.72,-0.48,-5.22,276010,109,2499180,8000,20000,-12000,0,0,0,0,1000,-1000,-13000
20200316,3593,力銘,8.48,8.49,8.15,8.39,-0.10,-1.18,108133,56,892344,0,20000,-20000,0,0,0,0,0,0,-20000
20200316,3596,智易,64.70,66.10,61.80,62.00,-2.40,-3.73,2914020,2018,186718043,809000,755000,54000,0,2000,-2000,59000,55000,4000,56000
20200316,3605,宏致,20.50,20.60,19.10,19.10,-1.20,-5.91,1465996,668,28940870,433000,247000,186000,0,0,0,0,39000,-39000,147000
20200316,3607,谷崧,10.95,10.95,9.88,9.88,-0.92,-8.52,251023,149,2551792,8000,23000,-15000,0,0,0,0,0,0,-15000
20200316,3617,碩天,83.00,83.70,79.50,79.70,-3.30,-3.98,514894,335,41730120,65000,116000,-51000,0,3000,-3000,2000,6000,-4000,-58000
20200316,3622,洋華,15.20,15.75,15.20,15.60,+0.10,0.65,456532,217,7100837,107000,136000,-29000,0,0,0,0,0,0,-29000
20200316,3645,達邁,32.00,32.40,29.20,29.20,-3.20,-9.88,2358667,1686,70887574,567000,269000,298000,0,0,0,0,11000,-11000,287000
20200316,3653,健策,157.50,165.00,149.50,149.50,-11.00,-6.85,5103429,3398,805029850,955000,723000,232000,48000,50000,-2000,20000,130000,-110000,120000
20200316,3661,世芯-KY,191.00,196.00,171.50,173.00,-16.50,-8.71,11151540,8268,2060483000,1678000,1718000,-40000,112000,70000,42000,41000,186000,-145000,-143000
20200316,3665,貿聯-KY,164.50,166.50,151.50,153.50,-10.00,-6.12,2516835,1951,400846666,747000,691000,56000,16000,153000,-137000,142000,144000,-2000,-83000
20200316,3669,圓展,26.80,27.80,26.50,27.80,+2.50,9.88,2287419,962,63001448,33000,120000,-87000,0,0,0,0,50000,-50000,-137000
20200316,3673,TPK-KY,39.15,39.80,36.55,37.00,-2.05,-5.25,3993651,2563,152445865,1092000,1300648,-208648,0,0,0,58000,187000,-129000,-337648
20200316,3679,新至陞,52.00,52.00,48.30,48.40,-3.50,-6.74,150600,130,7465939,9000,45000,-36000,0,0,0,0,6000,-6000,-42000
20200316,3682,亞太電,6.00,6.07,5.85,5.87,-0.08,-1.34,6795358,1937,40495357,354000,1358571,-1004571,0,0,0,0,0,0,-1004571
20200316,3686,達能,3.56,3.56,3.33,3.33,-0.36,-9.76,1575770,395,5266227,4000,3000,1000,0,0,0,0,0,0,1000
20200316,3694,海華,13.15,13.40,11.90,13.20,0.00,0.00,449000,230,5624550,9000,34000,-25000,0,0,0,0,3000,-3000,-28000
20200316,3698,隆達,12.55,12.65,11.50,11.85,-0.60,-4.82,1807323,847,21910823,442000,516000,-74000,0,0,0,20000,175000,-155000,-229000
20200316,3701,大眾控,12.50,12.75,11.95,12.75,-0.50,-3.77,43000,26,531396,0,0,0,0,0,0,0,0,0,0
20200316,3702,大聯大,37.60,37.80,36.40,36.45,-1.15,-3.06,5696985,3107,209720764,2043000,4352268,-2309268,4000,3000,1000,1812000,189000,1623000,-685268
20200316,3702A,大聯大甲特,50.20,50.20,49.35,49.45,-0.55,-1.1,1273131,361,63329476,44000,7000,37000,0,0,0,20000,0,20000,57000
20200316,3703,欣陸,10.60,10.60,10.20,10.20,-0.30,-2.86,666800,282,6899309,29000,242000,-213000,0,0,0,0,0,0,-213000
20200316,3704,合勤控,12.40,12.60,11.10,11.15,-1.15,-9.35,4574524,1526,53487260,1257000,598000,659000,0,0,0,0,1000,-1000,658000
20200316,3705,永信,41.60,41.75,40.60,40.60,-1.40,-3.33,637242,415,26197933,43000,152000,-109000,0,0,0,0,0,0,-109000
20200316,3706,神達,28.70,29.20,27.75,27.75,-1.20,-4.15,15808519,7910,450731918,2215000,4666920,-2451920,507000,787000,-280000,85000,233000,-148000,-2879920
20200316,3708,上緯投控,62.10,63.90,59.40,59.50,-2.60,-4.19,867423,848,53357633,121000,178000,-57000,0,0,0,0,29000,-29000,-86000
20200316,3711,日月光投控,60.50,61.00,59.30,59.30,-1.70,-2.79,18705449,7183,1122436610,5731000,13632143,-7901143,10000,11000,-1000,67000,425000,-358000,-8260143
20200316,3712,永崴投控,12.55,12.65,11.90,12.00,-0.40,-3.23,551349,338,6770962,112000,133000,-21000,0,0,0,0,6000,-6000,-27000
20200316,4104,佳醫,50.70,51.50,50.50,50.60,0.00,0.00,474951,381,24144804,67000,48000,19000,0,1000,-1000,0,19000,-19000,-1000
20200316,4106,雃博,21.90,23.25,21.60,21.70,+0.30,1.4,1071100,731,23859350,203000,137000,66000,0,0,0,0,0,0,66000
20200316,4108,懷特,14.55,14.90,13.75,13.85,-0.60,-4.15,395041,258,5688125,0,28000,-28000,0,0,0,0,0,0,-28000
20200316,4119,旭富,109.00,113.00,103.00,103.00,-4.00,-3.74,4092319,3085,444138176,504000,1068000,-564000,1000,11000,-10000,67000,82000,-15000,-589000
20200316,4133,亞諾法,31.60,33.65,31.60,33.65,+3.05,9.97,3220681,1540,107235963,109000,179000,-70000,0,0,0,0,0,0,-70000
20200316,4137,麗豐-KY,170.50,175.00,165.50,165.50,-2.50,-1.49,868638,768,147772684,159000,190000,-31000,0,0,0,3000,5000,-2000,-33000
20200316,4141,龍燈-KY,13.45,13.55,12.75,12.90,-0.45,-3.37,1376314,201,18319003,26000,23000,3000,0,0,0,0,0,0,3000
20200316,4142,國光生,28.85,30.95,28.85,30.20,+1.85,6.53,33599178,14950,1013233820,3513000,1571878,1941122,0,0,0,60000,328000,-268000,1673122
20200316,4144,康聯-KY,25.70,25.70,23.25,24.85,-0.95,-3.68,202881,153,4953675,2000,15000,-13000,0,0,0,0,0,0,-13000
20200316,4148,全宇生技-KY,25.20,25.90,22.60,22.60,-2.35,-9.42,117000,97,2905650,19000,8000,11000,0,0,0,1000,0,1000,12000
20200316,4155,訊映,27.80,27.80,25.85,26.45,-0.55,-2.04,989530,588,26653397,185000,245000,-60000,0,0,0,0,2000,-2000,-62000
20200316,4164,承業醫,32.80,33.60,32.15,32.15,-0.15,-0.46,528486,339,17387436,100000,99000,1000,0,1000,-1000,5000,4000,1000,1000
20200316,4190,佐登-KY,75.80,75.80,69.60,69.80,-3.80,-5.16,558031,423,40746032,189000,96000,93000,0,0,0,6000,16000,-10000,83000
20200316,4306,炎洲,9.99,10.00,9.60,9.75,-0.24,-2.4,1097838,397,10815397,77000,220000,-143000,0,0,0,14000,6000,8000,-135000
20200316,4414,如興,9.16,9.16,8.72,8.90,-0.35,-3.78,2596364,756,23113335,167000,693000,-526000,0,0,0,0,0,0,-526000
20200316,4426,利勤,30.00,30.40,28.80,28.80,-1.45,-4.79,932107,691,27504723,206000,258000,-52000,0,0,0,0,0,0,-52000
20200316,4438,廣越,123.00,123.00,118.50,120.00,-2.00,-1.64,139220,112,16770120,11000,9000,2000,0,0,0,2000,1000,1000,3000
20200316,4439,冠星-KY,140.00,142.00,133.00,133.00,-13.00,-8.9,52000,49,7134500,1000,1000,0,0,0,0,0,0,0,0
20200316,4526,東台,13.50,13.50,12.60,12.75,-0.75,-5.56,348412,196,4511972,3000,41000,-38000,0,0,0,0,2000,-2000,-40000
20200316,4532,瑞智,17.30,17.50,16.60,16.65,-1.05,-5.93,1042600,477,17785108,57000,180000,-123000,0,0,0,0,13000,-13000,-136000
20200316,4536,拓凱,108.50,108.50,102.00,102.00,-4.50,-4.23,317300,284,33059300,29000,94000,-65000,0,26000,-26000,0,5000,-5000,-96000
20200316,4540,全球傳動,44.00,44.00,40.40,40.60,-3.20,-7.31,374055,308,15805246,61000,106000,-45000,0,0,0,0,0,0,-45000
20200316,4545,銘鈺,22.75,23.40,22.75,22.75,-2.50,-9.9,988000,518,22552950,3000,9000,-6000,0,0,0,0,1000,-1000,-7000
20200316,4551,智伸科,122.50,124.00,112.00,112.00,-9.00,-7.44,542100,416,63777400,273000,149000,124000,0,0,0,20000,14000,6000,130000
20200316,4552,力達-KY,26.70,27.30,26.00,26.00,-0.45,-1.7,419719,236,11229744,57000,59000,-2000,0,0,0,0,13000,-13000,-15000
20200316,4555,氣立,44.10,45.05,42.80,42.80,-1.40,-3.17,48000,45,2104400,2000,4000,-2000,0,0,0,0,0,0,-2000
20200316,4557,永新-KY,63.60,64.00,63.20,63.20,0.00,0.00,98889,90,6276907,2000,11000,-9000,0,0,0,0,1000,-1000,-10000
20200316,4560,強信-KY,44.50,44.50,43.20,43.40,-0.80,-1.81,54000,49,2359650,41000,28000,13000,0,0,0,0,0,0,13000
20200316,4562,穎漢,20.00,20.05,19.45,19.70,-1.75,-8.16,12000,12,237200,3000,2000,1000,0,0,0,0,0,0,1000
20200316,4564,元翎,28.50,29.00,27.65,27.65,-0.55,-1.95,1051241,661,29736209,187000,379000,-192000,0,0,0,0,0,0,-192000
20200316,4566,時碩工業,37.55,38.20,34.30,34.30,-3.25,-8.66,432200,285,15661450,48000,64000,-16000,0,0,0,1000,0,1000,-15000
20200316,4571,鈞興-KY,54.00,54.00,48.95,48.95,-5.35,-9.85,27000,23,1353650,4000,1000,3000,0,0,0,1000,0,1000,4000
20200316,4572,駐龍,88.80,88.80,81.80,85.80,-1.20,-1.38,148040,98,12329463,7000,32000,-25000,0,0,0,0,0,0,-25000
20200316,4576,大銀微系統,64.60,64.70,59.80,60.00,-4.50,-6.98,327418,293,20185902,51000,41000,10000,0,0,0,0,0,0,10000
20200316,4581,光隆精密-KY,37.50,37.50,35.20,35.20,-1.80,-4.86,128000,87,4621000,0,9000,-9000,0,0,0,0,0,0,-9000
20200316,4720,德淵,12.25,12.45,11.80,11.90,-0.10,-0.83,519035,264,6301616,11000,43000,-32000,0,0,0,0,0,0,-32000
20200316,4722,國精化,25.10,25.50,25.10,25.35,+0.25,1.0,237112,140,5989685,1000,22000,-21000,0,0,0,1000,7000,-6000,-27000
20200316,4725,信昌化,8.50,8.57,8.00,8.03,-0.42,-4.97,1209000,403,10020400,70000,137000,-67000,0,0,0,0,0,0,-67000
20200316,4737,華廣,76.00,76.00,70.20,70.90,-4.90,-6.46,184101,142,13403760,11000,66000,-55000,0,0,0,2000,0,2000,-53000
20200316,4739,康普,45.45,46.00,41.50,41.80,-3.45,-7.62,683962,516,30475704,207000,132000,75000,0,0,0,0,19000,-19000,56000
20200316,4746,台耀,51.10,53.90,49.20,49.20,+0.20,0.41,11893075,7447,619638183,542000,453000,89000,440000,212000,228000,0,14000,-14000,303000
20200316,4755,三福化,42.85,42.85,41.50,42.05,-0.80,-1.87,31000,26,1303750,0,5000,-5000,0,0,0,1000,5000,-4000,-9000
20200316,4763,材料-KY,104.00,105.50,98.00,98.00,-6.00,-5.77,827440,580,83661296,104000,163000,-59000,0,0,0,4000,15000,-11000,-70000
20200316,4764,雙鍵,60.90,60.90,59.00,60.00,-1.00,-1.64,48145,29,2886700,3000,9000,-6000,0,0,0,0,0,0,-6000
20200316,4766,南寶,127.00,128.50,120.50,122.00,-5.00,-3.94,314950,290,39448400,165000,196000,-31000,0,0,0,9000,0,9000,-22000
20200316,4807,日成-KY,27.00,27.00,23.90,25.70,-0.85,-3.2,145036,133,3607444,4000,5000,-1000,0,0,0,0,0,0,-1000
20200316,4904,遠傳,62.50,62.80,60.90,60.90,-1.60,-2.56,7703250,4425,473548299,3152000,4032882,-880882,7000,5000,2000,5000,457000,-452000,-1330882
20200316,4906,正文,20.00,20.25,18.40,18.75,-1.20,-6.02,3028850,1357,58638370,804000,588000,216000,0,0,0,47000,56000,-9000,207000
20200316,4912,聯德控股-KY,62.70,64.80,59.00,59.30,-6.10,-9.33,459192,281,28134728,51000,18000,33000,0,0,0,0,0,0,33000
20200316,4915,致伸,41.50,42.10,40.00,40.00,-1.00,-2.44,3278075,1976,135519805,1488000,1022000,466000,0,2000,-2000,6000,43000,-37000,427000
20200316,4916,事欣科,26.60,26.65,24.85,25.10,-1.05,-4.02,830322,521,21483623,118000,59000,59000,0,0,0,0,1000,-1000,58000
20200316,4919,新唐,35.80,35.80,32.25,32.25,-2.75,-7.86,1630446,1075,55314368,280000,237000,43000,1000,1000,0,13000,58000,-45000,-2000
20200316,4927,泰鼎-KY,49.80,50.50,46.55,46.55,-2.90,-5.86,7000093,3848,339742782,689000,2158000,-1469000,436000,0,436000,36000,338000,-302000,-1335000
20200316,4930,燦星網,8.95,8.95,8.11,8.17,-0.83,-9.22,445159,133,3787230,4000,8000,-4000,0,0,0,0,0,0,-4000
20200316,4934,太極,12.80,13.05,11.70,11.70,-1.05,-8.24,3732172,1440,46525610,503000,752000,-249000,0,0,0,0,0,0,-249000
20200316,4935,茂林-KY,100.00,103.00,91.80,91.80,-10.20,-10.0,7133414,5022,696857103,857000,1650000,-793000,184000,100000,84000,5000,132000,-127000,-836000
20200316,4938,和碩,55.00,55.50,52.60,52.60,-2.70,-4.88,8685163,4474,467410839,2558449,6781028,-4222579,5000,11000,-6000,846000,259000,587000,-3641579
20200316,4942,嘉彰,29.40,29.50,28.00,28.90,-0.50,-1.7,580200,441,16656659,42000,333000,-291000,0,7000,-7000,7000,7000,0,-298000
20200316,4943,康控-KY,110.00,111.50,97.70,97.70,-10.80,-9.95,3747902,2873,386444407,811000,375000,436000,0,0,0,4000,78000,-74000,362000
20200316,4952,凌通,27.50,29.00,27.00,27.25,-0.75,-2.68,520600,363,14480500,39000,81000,-42000,0,0,0,0,2000,-2000,-44000
20200316,4956,光鋐,9.78,9.99,9.10,9.10,-0.63,-6.47,635109,310,6104732,61000,63000,-2000,0,0,0,1000,0,1000,-1000
20200316,4958,臻鼎-KY,88.20,95.30,87.80,87.80,-3.60,-3.94,12458038,6938,1133145511,3793000,6783362,-2990362,43000,146000,-103000,343000,620000,-277000,-3370362
20200316,4960,誠美材,5.39,5.39,4.46,4.46,-0.49,-9.9,1859650,379,8567637,0,10000,-10000,0,0,0,0,0,0,-10000
20200316,4961,天鈺,25.70,26.00,23.90,24.05,-1.15,-4.56,1013127,559,25294953,257000,196000,61000,0,0,0,4000,0,4000,65000
20200316,4967,十銓,39.80,40.70,36.20,36.20,-4.00,-9.95,9010899,4695,342883842,957000,1420000,-463000,0,0,0,28000,25000,3000,-460000
20200316,4968,立積,135.00,140.50,122.00,122.00,-13.50,-9.96,4956500,3577,646725000,982000,561000,421000,3000,0,3000,1000,62000,-61000,363000
20200316,4976,佳凌,17.20,17.65,15.40,15.40,-1.70,-9.94,1522359,785,24635426,443000,205000,238000,0,0,0,0,14000,-14000,224000
20200316,4977,眾達-KY,101.00,104.00,92.70,92.70,-10.30,-10.0,3412168,2511,337327606,339000,497000,-158000,38000,0,38000,46000,46000,0,-120000
20200316,4989,榮科,16.20,16.55,14.70,14.70,-1.50,-9.26,238047,167,3696955,18000,43000,-25000,0,0,0,0,0,0,-25000
20200316,4994,傳奇,51.80,53.30,46.85,46.85,-3.35,-6.67,675540,519,34521183,153000,122000,31000,0,0,0,1000,28000,-27000,4000
20200316,4999,鑫禾,33.50,33.50,32.35,32.40,-0.45,-1.37,65236,81,2135509,3000,23000,-20000,0,0,0,0,6000,-6000,-26000
20200316,5007,三星,47.00,47.25,45.15,46.95,-1.05,-2.19,208224,170,9565760,3000,47000,-44000,0,0,0,0,0,0,-44000
20200316,5203,訊連,106.00,109.00,99.00,99.60,-6.90,-6.48,2015805,1496,208238797,822000,719000,103000,10000,0,10000,8000,26000,-18000,95000
20200316,5215,科嘉-KY,49.90,54.00,49.05,49.05,-0.95,-1.9,967028,712,49822936,123000,182000,-59000,207000,0,207000,1000,2000,-1000,147000
20200316,5225,東科-KY,23.15,23.90,22.00,22.00,0.00,0.00,669000,458,15416398,165000,202000,-37000,0,0,0,1000,2000,-1000,-38000
20200316,5234,達興材料,76.00,76.00,74.10,74.10,-0.40,-0.54,401611,282,30015270,36000,120000,-84000,0,1000,-1000,1000,8000,-7000,-92000
20200316,5243,乙盛-KY,27.00,27.20,26.05,26.10,-1.10,-4.04,637430,329,16946081,160000,153000,7000,0,0,0,0,0,0,7000
20200316,5258,虹堡,19.80,19.80,17.85,17.85,-1.95,-9.85,585050,329,10879087,154000,71000,83000,0,0,0,0,0,0,83000
20200316,5264,鎧勝-KY,31.75,32.50,30.15,31.00,-0.70,-2.21,1704875,1185,53454042,742000,532000,210000,0,0,0,4000,41000,-37000,173000
20200316,5269,祥碩,740.00,757.00,684.00,684.00,-57.00,-7.69,1404635,1313,1019568150,238000,283000,-45000,77000,0,77000,10000,64000,-54000,-22000
20200316,5283,禾聯碩,93.60,95.50,93.00,93.00,+0.60,0.65,335136,283,31450920,17000,38000,-21000,0,0,0,3000,12000,-9000,-30000
20200316,5284,jpp-KY,38.80,39.50,38.55,38.65,-3.30,-7.87,27250,29,1058300,2000,4000,-2000,0,0,0,0,0,0,-2000
20200316,5285,界霖,44.25,44.50,40.60,40.60,-3.60,-8.14,545105,268,23272987,80000,92000,-12000,0,0,0,0,8000,-8000,-20000
20200316,5288,豐祥-KY,102.00,102.00,96.90,97.00,-4.50,-4.43,175522,164,17438420,27000,111020,-84020,0,0,0,2000,0,2000,-82020
20200316,5305,敦南,39.50,39.75,39.15,39.25,0.00,0.00,632529,336,24879133,100000,241000,-141000,0,0,0,0,16000,-16000,-157000
20200316,5388,中磊,62.50,63.30,61.40,62.20,-0.10,-0.16,1519200,1100,94864059,686000,535000,151000,0,3000,-3000,3000,50000,-47000,101000
20200316,5434,崇越,93.00,94.30,89.90,89.90,-2.40,-2.6,1367931,1031,125341168,177000,586000,-409000,0,1000,-1000,9000,30000,-21000,-431000
20200316,5469,瀚宇博,33.15,33.90,31.40,31.55,-1.60,-4.83,5635608,2928,184759170,1394000,2180000,-786000,0,8000,-8000,14000,28000,-14000,-808000
20200316,5471,松翰,33.60,35.95,33.60,34.20,+1.25,3.79,14796526,8818,517386810,1292000,1676000,-384000,0,0,0,0,26000,-26000,-410000
20200316,5484,慧友,7.80,7.80,7.15,7.50,0.00,0.00,174030,69,1308351,0,0,0,0,0,0,0,0,0,0
20200316,5515,建國,8.44,8.45,8.35,8.42,-0.02,-0.24,288980,176,2430832,14000,36000,-22000,0,0,0,0,0,0,-22000
20200316,5519,隆大,12.05,12.15,11.90,11.90,0.00,0.00,947162,381,11384867,47000,162000,-115000,0,0,0,0,0,0,-115000
20200316,5521,工信,7.24,7.24,6.68,6.68,-0.62,-8.49,2223943,619,15427644,172000,288000,-116000,0,0,0,0,0,0,-116000
20200316,5522,遠雄,35.10,35.15,33.95,34.00,-0.95,-2.72,1455028,935,50179319,477000,361000,116000,0,0,0,0,221000,-221000,-105000
20200316,5525,順天,18.50,18.70,17.90,18.00,-0.50,-2.7,185075,98,3351000,6000,22000,-16000,0,0,0,0,0,0,-16000
20200316,5531,鄉林,8.09,8.09,7.70,7.80,-0.05,-0.64,862259,464,6757659,262000,280000,-18000,0,0,0,0,0,0,-18000
20200316,5533,皇鼎,14.30,14.55,14.25,14.55,+0.35,2.46,139433,39,2015528,0,10000,-10000,0,0,0,0,0,0,-10000
20200316,5534,長虹,74.00,74.90,72.80,73.20,-0.30,-0.41,710309,543,52374707,169000,196000,-27000,0,2000,-2000,0,53000,-53000,-82000
20200316,5538,東明-KY,27.40,27.65,27.40,27.65,+0.15,0.55,20000,8,548300,1000,0,1000,0,0,0,0,0,0,1000
20200316,5607,遠雄港,18.70,19.20,18.40,18.40,+0.05,0.27,2333051,897,43800858,582000,186000,396000,0,0,0,9000,20000,-11000,385000
20200316,5608,四維航,5.97,5.97,5.50,5.65,-0.34,-5.68,599752,275,3394320,12000,61000,-49000,0,0,0,0,8000,-8000,-57000
20200316,5706,鳳凰,29.80,29.95,28.45,28.45,-1.35,-4.53,188414,161,5499598,36000,12000,24000,0,0,0,0,0,0,24000
20200316,5871,中租-KY,96.50,96.50,93.20,94.00,-3.40,-3.49,9021499,5761,855605596,4600000,4741634,-141634,36000,5000,31000,32000,178000,-146000,-256634
20200316,5876,上海商銀,42.20,42.20,39.50,39.60,-2.60,-6.16,13291136,7056,536394534,2731000,5556339,-2825339,0,13000,-13000,294000,438524,-144524,-2982863
20200316,5880,合庫金,18.65,18.80,18.15,18.15,-0.80,-4.22,46237829,17755,850538735,8162000,20410635,-12248635,29000,26000,3000,23000,853000,-830000,-13075635
20200316,5906,台南-KY,18.30,18.35,17.05,17.40,-1.20,-6.45,57407,46,997241,1000,8000,-7000,0,0,0,0,0,0,-7000
20200316,5907,大洋-KY,18.65,18.65,17.50,17.50,-0.50,-2.78,557113,247,10139545,36000,99000,-63000,0,0,0,0,0,0,-63000
20200316,6005,群益證,8.65,8.70,8.52,8.52,-0.18,-2.07,3335150,1156,28806928,269000,1215000,-946000,0,19000,-19000,0,0,0,-965000
20200316,6024,群益期,36.95,37.00,35.00,35.40,-1.55,-4.19,964807,616,34655188,67000,143000,-76000,0,0,0,0,0,0,-76000
20200316,6108,競國,20.15,20.75,19.50,19.50,-0.65,-3.23,496233,348,9824853,35000,266000,-231000,0,0,0,0,17000,-17000,-248000
20200316,6112,聚碩,34.50,34.50,33.10,33.25,-0.95,-2.78,877215,599,29580485,93000,130000,-37000,0,0,0,1000,2000,-1000,-38000
20200316,6115,鎰勝,40.20,41.20,39.95,39.95,-0.25,-0.62,288167,221,11583464,29000,62000,-33000,0,0,0,1000,21000,-20000,-53000
20200316,6116,彩晶,5.93,5.98,5.47,5.49,-0.37,-6.31,32610073,6097,186615457,7475000,15393016,-7918016,0,0,0,147000,749000,-602000,-8520016
20200316,6117,迎廣,14.05,14.05,12.60,12.60,-1.25,-9.03,41000,19,533550,0,0,0,0,0,0,0,0,0,0
20200316,6120,達運,10.50,10.85,10.15,10.20,-0.30,-2.86,2061131,866,21599885,275000,381000,-106000,0,0,0,0,53000,-53000,-159000
20200316,6128,上福,25.30,25.55,25.05,25.35,+0.05,0.2,142020,93,3585860,7000,19000,-12000,0,0,0,0,0,0,-12000
20200316,6131,鈞泰,3.49,3.49,3.49,3.49,0.00,0.00,34358,17,119802,0,0,0,0,0,0,0,0,0,0
20200316,6133,金橋,6.60,6.94,6.60,6.94,+0.10,1.46,94000,31,631430,0,2000,-2000,0,0,0,0,0,0,-2000
20200316,6136,富爾特,17.50,17.70,16.90,17.00,-0.50,-2.86,448321,256,7688967,34000,53000,-19000,0,0,0,1000,6000,-5000,-24000
20200316,6139,亞翔,23.60,24.00,22.90,23.10,-0.45,-1.91,679557,397,15859554,181000,303000,-122000,0,10000,-10000,1000,21000,-20000,-152000
20200316,6141,柏承,14.80,15.60,14.45,14.45,-0.55,-3.67,1459042,660,21952951,375000,263000,112000,0,0,0,0,0,0,112000
20200316,6142,友勁,4.76,5.22,4.76,4.84,-0.38,-7.28,805139,183,3940809,4000,0,4000,0,0,0,100000,0,100000,104000
20200316,6152,百一,5.01,5.01,4.47,4.60,-0.36,-7.26,867491,195,3991902,27000,17000,10000,0,0,0,0,0,0,10000
20200316,6153,嘉聯益,26.55,27.25,24.20,24.20,-2.25,-8.51,7909320,3720,202923226,1939000,2262000,-323000,0,0,0,100000,236000,-136000,-459000
20200316,6155,鈞寶,19.90,20.35,18.50,18.55,-1.25,-6.31,597133,420,11650242,99000,252000,-153000,0,0,0,8000,0,8000,-145000
20200316,6164,華興,5.56,5.73,5.15,5.40,-0.15,-2.7,509947,144,2747972,5000,13000,-8000,0,0,0,0,3000,-3000,-11000
20200316,6165,捷泰,17.60,18.25,17.50,17.70,+0.10,0.57,512238,239,9074705,62000,100000,-38000,0,0,0,0,0,0,-38000
20200316,6166,凌華,54.70,56.80,54.30,55.90,+0.50,0.9,910511,585,50966109,430711,296000,134711,0,1000,-1000,0,1000,-1000,132711
20200316,6168,宏齊,11.65,11.80,10.90,11.00,-0.50,-4.35,972028,437,11085708,21000,178000,-157000,0,0,0,0,32000,-32000,-189000
20200316,6172,互億,18.55,19.55,18.50,19.10,+0.30,1.6,183000,58,3507400,4000,8000,-4000,0,0,0,0,0,0,-4000
20200316,6176,瑞儀,83.50,86.00,83.50,84.50,+2.50,3.05,4550860,3247,385960847,2083000,1184000,899000,165000,4000,161000,730000,180000,550000,1610000
20200316,6177,達麗,24.55,24.90,24.10,24.35,-0.20,-0.81,485508,282,11914010,77000,110000,-33000,0,0,0,0,0,0,-33000
20200316,6183,關貿,38.90,39.90,38.50,38.60,-0.10,-0.26,317525,218,12415165,28000,89000,-61000,0,0,0,0,5000,-5000,-66000
20200316,6184,大豐電,38.55,38.70,37.70,38.00,-0.40,-1.04,188447,123,7155142,4000,31000,-27000,0,0,0,0,0,0,-27000
20200316,6189,豐藝,31.00,31.00,30.40,30.45,-0.55,-1.77,594239,405,18193504,24000,73000,-49000,0,0,0,3000,46000,-43000,-92000
20200316,6191,精成科,12.60,12.75,11.85,11.85,-0.60,-4.82,3004829,1015,36779172,402000,1151000,-749000,0,6000,-6000,0,2000,-2000,-757000
20200316,6192,巨路,59.10,59.70,57.60,57.60,-1.50,-2.54,265927,227,15586066,61000,96000,-35000,0,1000,-1000,1000,0,1000,-35000
20200316,6196,帆宣,63.30,63.70,57.50,57.80,-3.90,-6.32,2207300,1478,134233440,211000,637000,-426000,0,0,0,9000,29000,-20000,-446000
20200316,6197,佳必琪,25.50,25.60,24.05,24.05,-0.95,-3.8,449250,286,11179950,48000,74000,-26000,0,0,0,8000,0,8000,-18000
20200316,6201,亞弘電,32.95,33.00,32.40,32.80,-0.10,-0.3,141000,101,4636800,2000,17000,-15000,0,0,0,1000,1000,0,-15000
20200316,6202,盛群,61.10,64.20,61.10,61.80,+1.20,1.98,3550344,2549,221543383,1216000,737000,479000,279000,1000,278000,0,223000,-223000,534000
20200316,6205,詮欣,20.40,20.40,19.90,19.95,+0.15,0.76,109012,64,2188110,1000,6000,-5000,0,0,0,0,0,0,-5000
20200316,6206,飛捷,63.10,64.00,61.10,61.30,-2.10,-3.31,391300,320,24341630,59000,188000,-129000,0,1000,-1000,0,29000,-29000,-159000
20200316,6209,今國光,18.80,19.20,17.10,17.20,-1.50,-8.02,1458427,863,26581901,484000,291000,193000,0,0,0,0,0,0,193000
20200316,6213,聯茂,123.00,131.00,118.00,118.00,-12.00,-9.23,8543530,5160,1059783798,855000,1305829,-450829,249000,471000,-222000,1173000,423000,750000,77171
20200316,6214,精誠,75.00,76.00,74.00,74.50,+0.10,0.13,1332208,996,99530049,492000,520000,-28000,0,3000,-3000,36000,19000,17000,-14000
20200316,6215,和椿,11.85,11.85,11.00,11.00,-0.85,-7.17,373815,195,4240124,10000,21000,-11000,0,0,0,11000,0,11000,0
20200316,6216,居易,25.30,25.30,25.00,25.00,-0.30,-1.19,192591,152,4834767,1000,7000,-6000,0,0,0,0,0,0,-6000
20200316,6224,聚鼎,55.00,55.00,52.50,53.00,-1.30,-2.39,280200,234,15026893,39000,73000,-34000,0,1000,-1000,7000,5000,2000,-33000
20200316,6225,天瀚,,,,,0.00,0.00,1,1,2,0,0,0,0,0,0,0,0,0,0
20200316,6226,光鼎,5.98,6.36,5.95,6.33,+0.54,9.33,1908002,667,11971769,226000,118000,108000,0,0,0,0,0,0,108000
20200316,6230,超眾,187.50,192.00,168.00,168.00,-18.00,-9.68,2528607,1840,452388976,893000,302000,591000,0,2000,-2000,32000,56000,-24000,565000
20200316,6235,華孚,9.25,9.25,8.33,8.41,-0.84,-9.08,545537,263,4792208,33000,64000,-31000,0,0,0,0,1000,-1000,-32000
20200316,6239,力成,88.00,89.00,85.00,85.80,-2.90,-3.27,5393242,3738,466526030,1573000,3918601,-2345601,2000,3000,-1000,18000,174000,-156000,-2502601
20200316,6243,迅杰,6.90,7.70,6.80,6.85,-0.15,-2.14,127866,104,903966,0,5000,-5000,0,0,0,0,0,0,-5000
20200316,6251,定穎,14.25,14.70,13.20,13.20,-0.80,-5.71,9524117,2946,133083490,1220000,2231000,-1011000,0,10000,-10000,205000,630000,-425000,-1446000
20200316,6257,矽格,33.20,33.60,31.60,31.85,-1.35,-4.07,5310610,2991,173331820,432000,2386000,-1954000,0,7000,-7000,194000,195000,-1000,-1962000
20200316,6269,台郡,96.80,99.60,94.00,94.00,-3.80,-3.89,6594977,4174,638322624,1464000,2306000,-842000,26000,848000,-822000,120000,188000,-68000,-1732000
20200316,6271,同欣電,115.00,117.00,107.00,107.50,-8.50,-7.33,4575990,2890,508958913,532000,1333000,-801000,72000,200000,-128000,750000,166000,584000,-345000
20200316,6277,宏正,81.00,81.00,79.00,79.00,-1.30,-1.62,284255,210,22589876,31000,60000,-29000,0,0,0,0,18000,-18000,-47000
20200316,6278,台表科,76.50,78.80,69.10,69.80,-6.00,-7.92,6714849,4699,496003576,1910000,1199000,711000,80000,161000,-81000,2000,66000,-64000,566000
20200316,6281,全國電,65.00,65.00,62.70,62.70,-2.30,-3.54,385787,284,24517993,15000,47000,-32000,0,0,0,0,9000,-9000,-41000
20200316,6282,康舒,18.85,19.20,18.15,18.25,-0.55,-2.93,3334038,1541,62524398,774000,1342000,-568000,0,13000,-13000,22000,116000,-94000,-675000
20200316,6283,淳安,16.55,17.35,15.10,15.10,-1.50,-9.04,524082,300,8594645,127000,77000,50000,0,0,0,0,0,0,50000
20200316,6285,啟碁,57.60,58.00,55.10,55.50,-2.10,-3.65,2376704,1756,133482963,329000,742000,-413000,0,0,0,126000,86000,40000,-373000
20200316,6288,聯嘉,19.05,19.40,17.10,17.25,-1.70,-8.97,2236005,972,40166704,704000,396000,308000,0,0,0,26000,11000,15000,323000
20200316,6289,華上,1.80,1.81,1.80,1.80,-0.07,-3.74,54500,71,98113,0,0,0,0,0,0,0,0,0,0
20200316,6405,悅城,12.05,12.05,11.50,11.70,-0.35,-2.9,48000,31,566950,2000,3000,-1000,0,0,0,0,0,0,-1000
20200316,6409,旭隼,631.00,642.00,607.00,607.00,-34.00,-5.3,427681,232,269618453,399500,386000,13500,0,0,0,0,8000,-8000,5500
20200316,6412,群電,50.50,50.90,49.30,50.40,+0.40,0.8,1059650,690,52801065,263000,513000,-250000,0,0,0,0,5000,-5000,-255000
20200316,6414,樺漢,182.50,184.00,165.00,165.00,-17.50,-9.59,1330812,1081,231016476,198060,516000,-317940,0,0,0,40000,49000,-9000,-326940
20200316,6415,矽力-KY,938.00,984.00,864.00,864.00,-96.00,-10.0,1266719,1245,1155574216,531000,634000,-103000,1000,18000,-17000,1000,35000,-34000,-154000
20200316,6416,瑞祺電通,119.00,125.50,113.50,114.00,-5.50,-4.6,9444336,7031,1137661304,498000,577000,-79000,423000,0,423000,212000,151000,61000,405000
20200316,6431,光麗-KY,20.30,20.70,20.10,20.70,+0.45,2.22,48000,33,972500,2000,0,2000,0,0,0,0,0,0,2000
20200316,6442,光聖,36.90,37.20,35.90,35.90,-0.70,-1.91,109450,66,4022155,1000,16000,-15000,0,0,0,0,0,0,-15000
20200316,6443,元晶,5.45,5.45,5.01,5.01,-0.30,-5.65,1664077,532,8667474,78000,268000,-190000,0,0,0,0,0,0,-190000
20200316,6449,鈺邦,26.70,26.85,24.50,24.50,-2.20,-8.24,544443,298,13858634,100000,91000,9000,0,0,0,0,0,0,9000
20200316,6451,訊芯-KY,94.60,98.00,86.30,87.00,-7.00,-7.45,2134904,1703,196755386,601000,690000,-89000,0,0,0,18000,72000,-54000,-143000
20200316,6452,康友-KY,169.00,171.50,153.00,153.00,-17.00,-10.0,3381518,2314,543713007,906000,240000,666000,0,0,0,8000,291717,-283717,382283
20200316,6456,GIS-KY,75.90,78.70,73.70,73.80,+0.20,0.27,6111060,4249,465570562,2016000,1261000,755000,0,0,0,10000,44000,-34000,721000
20200316,6464,台數科,116.50,116.50,111.00,111.00,-0.50,-0.45,5000,3,561000,0,0,0,0,0,0,0,0,0,0
20200316,6477,安集,18.15,18.25,17.70,17.70,-0.35,-1.94,519000,190,9371050,27000,129000,-102000,0,0,0,0,9000,-9000,-111000
20200316,6491,晶碩,111.00,111.50,103.00,103.00,-8.00,-7.21,303958,257,32559674,35000,64000,-29000,0,0,0,0,0,0,-29000
20200316,6504,南六,136.00,145.00,136.00,145.00,+13.00,9.85,2526167,1915,360969715,393000,138000,255000,0,0,0,0,0,0,255000
20200316,6505,台塑化,73.40,73.40,70.00,70.00,-2.90,-3.98,8222876,5446,579568652,1757000,3134547,-1377547,157000,824000,-667000,7000,551000,-544000,-2588547
20200316,6525,捷敏-KY,49.55,50.20,47.50,47.60,-2.40,-4.8,335074,245,16346736,64000,115000,-51000,0,0,0,0,0,0,-51000
20200316,6531,愛普,100.00,104.50,90.10,90.10,-8.10,-8.25,6268526,4474,619896541,873000,805000,68000,0,0,0,48000,41000,7000,75000
20200316,6533,晶心科,85.40,86.50,77.00,77.00,-8.40,-9.84,889580,735,73060981,276000,157000,119000,0,0,0,0,5000,-5000,114000
20200316,6541,泰福-KY,35.20,36.00,32.45,32.60,-3.35,-9.32,745100,422,25622870,136000,98000,38000,0,0,0,0,0,0,38000
20200316,6552,易華電,55.10,55.50,49.05,49.05,-5.25,-9.67,1203300,930,63039600,462000,118000,344000,0,0,0,14000,7000,7000,351000
20200316,6558,興能高,40.70,41.70,36.55,36.55,-4.05,-9.98,3624331,2470,137747597,1027000,539000,488000,0,212000,-212000,0,0,0,276000
20200316,6573,虹揚-KY,18.00,18.40,17.00,18.00,-0.10,-0.55,84270,66,1504285,7000,6000,1000,0,0,0,0,0,0,1000
20200316,6579,研揚,63.00,63.00,62.00,62.10,-0.60,-0.96,73050,64,4563485,3000,9000,-6000,0,0,0,0,0,0,-6000
20200316,6581,鋼聯,61.90,61.90,59.50,59.80,-2.70,-4.32,39025,37,2338307,1000,4000,-3000,0,0,0,0,0,0,-3000
20200316,6582,申豐,72.70,75.40,70.00,73.90,+1.90,2.64,705130,621,51415968,108000,63000,45000,0,0,0,0,1000,-1000,44000
20200316,6591,動力-KY,38.00,38.00,35.00,35.00,-1.50,-4.11,419005,307,15351741,83000,149000,-66000,0,0,0,0,1000,-1000,-67000
20200316,6592,和潤企業,64.50,64.80,63.50,63.60,-0.30,-0.47,2366899,1535,151720115,220000,124000,96000,0,0,0,0,0,0,96000
20200316,6605,帝寶,45.30,45.95,45.10,45.10,-0.50,-1.1,127033,108,5741597,7000,39000,-32000,0,1000,-1000,0,0,0,-33000
20200316,6625,必應,30.10,30.90,30.10,30.10,-3.30,-9.88,120519,101,3635671,0,0,0,0,0,0,0,0,0,0
20200316,6641,基士德-KY,58.50,58.50,53.80,54.20,-2.60,-4.58,53146,44,2904730,2000,19000,-17000,0,0,0,0,0,0,-17000
20200316,6655,科定,32.60,35.00,32.60,34.05,+0.05,0.15,38000,25,1291150,1000,2000,-1000,0,0,0,1000,0,1000,0
20200316,6666,羅麗芬-KY,104.50,107.00,100.00,100.00,-5.50,-5.21,148677,153,15403700,29000,11000,18000,0,0,0,0,2000,-2000,16000
20200316,6668,中揚光,62.60,63.80,56.50,56.50,-6.20,-9.89,1414150,944,84965935,261000,231000,30000,0,0,0,0,0,0,30000
20200316,6669,緯穎,680.00,708.00,661.00,661.00,-37.00,-5.3,2712240,2547,1865398600,869000,1098295,-229295,117000,0,117000,47000,145000,-98000,-210295
20200316,6670,復盛應用,153.50,157.00,147.00,147.50,-6.50,-4.22,769460,608,115948800,174000,436000,-262000,0,0,0,0,23000,-23000,-285000
20200316,6671,三能-KY,32.65,32.70,32.00,32.45,-0.55,-1.67,23000,17,744200,0,2000,-2000,0,0,0,0,0,0,-2000
20200316,6672,騰輝電子-KY,75.50,75.90,72.50,72.90,+0.40,0.55,1173109,927,87164666,186000,277000,-91000,0,0,0,0,0,0,-91000
20200316,6674,鋐寶科技,23.45,23.45,19.35,19.35,-2.15,-10.0,173318,104,3484778,6000,5000,1000,0,0,0,2000,2000,0,1000
20200316,6698,旭暉應材,53.40,55.60,48.40,48.60,-4.80,-8.99,311500,233,15872949,19000,31000,-12000,0,0,0,0,10000,-10000,-22000
20200316,6706,惠特,80.00,81.40,75.00,75.50,-6.20,-7.59,1078470,849,84596065,50000,281000,-231000,20000,0,20000,0,0,0,-211000
20200316,6715,嘉基,79.00,79.90,73.00,73.10,-7.80,-9.64,362000,263,28071400,22000,93000,-71000,0,0,0,0,26000,-26000,-97000
20200316,8011,台通,13.00,13.00,12.05,12.35,-0.80,-6.08,768019,425,9611747,74000,65000,9000,0,0,0,1000,0,1000,10000
20200316,8016,矽創,132.00,136.50,121.50,123.00,-10.00,-7.52,4063424,3041,523191924,975000,1332000,-357000,20000,1000,19000,8000,42000,-34000,-372000
20200316,8021,尖點,17.55,17.70,17.00,17.00,-0.60,-3.41,1372353,591,23698832,68000,795000,-727000,0,0,0,10000,14000,-4000,-731000
20200316,8028,昇陽半導體,47.50,49.45,44.90,44.90,-2.60,-5.47,2837004,2003,133646230,878000,454000,424000,0,0,0,66000,37000,29000,453000
20200316,8033,雷虎,7.72,8.00,7.65,7.65,-0.07,-0.91,280782,149,2196453,0,3000,-3000,0,0,0,0,0,0,-3000
20200316,8039,台虹,44.40,45.45,41.75,42.40,-1.90,-4.29,3528912,2116,154532122,551000,1486000,-935000,0,0,0,9000,109000,-100000,-1035000
20200316,8046,南電,47.20,47.80,43.55,43.70,-3.00,-6.42,8104528,4460,370169814,2358222,2895000,-536778,44000,0,44000,46000,265000,-219000,-711778
20200316,8070,長華,149.00,149.00,140.00,140.00,-6.00,-4.11,186105,195,26592700,50000,92000,-42000,0,2000,-2000,11000,10000,1000,-43000
20200316,8072,陞泰,20.15,20.50,20.05,20.40,+0.35,1.75,172452,139,3500575,0,7000,-7000,0,0,0,0,2000,-2000,-9000
20200316,8081,致新,100.00,103.00,94.30,95.00,-6.00,-5.94,1769800,1375,173773300,271000,517000,-246000,0,1000,-1000,23000,21000,2000,-245000
20200316,8101,華冠,4.48,4.48,3.96,4.00,-0.39,-8.88,931123,314,3848056,95000,165000,-70000,0,0,0,0,0,0,-70000
20200316,8103,瀚荃,20.30,20.35,19.25,19.25,-0.70,-3.51,194040,104,3838466,0,32000,-32000,0,0,0,16000,0,16000,-16000
20200316,8104,錸寶,31.60,31.60,29.00,29.35,-2.25,-7.12,302152,214,9152460,101000,29000,72000,0,0,0,0,2000,-2000,70000
20200316,8105,凌巨,9.40,9.40,8.66,8.66,-0.49,-5.36,2140332,802,19213390,371000,862000,-491000,0,0,0,0,41000,-41000,-532000
20200316,8110,華東,8.21,8.30,7.73,7.73,-0.46,-5.62,1784259,666,14342730,298000,656000,-358000,0,16000,-16000,68000,37000,31000,-343000
20200316,8112,至上,31.65,31.90,30.85,31.20,-0.25,-0.79,5648936,3016,177174238,1641000,1289000,352000,0,6000,-6000,33000,63000,-30000,316000
20200316,8114,振樺電,78.60,78.60,75.40,75.70,-2.40,-3.07,229180,186,17568636,39000,20000,19000,0,4000,-4000,0,0,0,15000
20200316,8131,福懋科,35.50,35.75,33.25,33.25,-2.25,-6.34,1462550,895,49971889,127000,710000,-583000,1000,3000,-2000,12000,42000,-30000,-615000
20200316,8150,南茂,27.30,27.45,25.50,25.50,-1.45,-5.38,7809306,3751,207453156,1607000,2308000,-701000,0,0,0,23000,389000,-366000,-1067000
20200316,8163,達方,29.35,30.30,28.00,28.50,-0.75,-2.56,2194753,1495,64170332,717000,632000,85000,1000,188000,-187000,6000,7000,-1000,-103000
20200316,8201,無敵,8.49,8.49,7.85,7.94,-0.26,-3.17,59760,40,477542,2000,7000,-5000,0,0,0,0,0,0,-5000
20200316,8210,勤誠,76.60,78.50,73.00,73.30,-2.60,-3.43,1521722,1098,116024665,311000,617000,-306000,100000,2000,98000,29000,48000,-19000,-227000
20200316,8213,志超,28.75,28.75,27.75,27.95,-0.55,-1.93,1252985,663,35409671,173000,483000,-310000,0,6000,-6000,1000,7000,-6000,-322000
20200316,8215,明基材,14.20,14.55,13.15,13.15,-1.05,-7.39,2967504,1235,40974956,336000,773000,-437000,0,5000,-5000,0,11000,-11000,-453000
20200316,8222,寶一,15.00,15.00,13.95,14.00,-1.45,-9.39,254318,191,3597329,1000,8000,-7000,0,0,0,0,0,0,-7000
20200316,8249,菱光,17.90,18.00,17.35,17.35,-0.55,-3.07,283866,168,5013953,5000,60000,-55000,0,0,0,0,0,0,-55000
20200316,8261,富鼎,20.25,20.55,18.50,18.60,-1.65,-8.15,474329,346,9231507,149000,101000,48000,0,0,0,0,0,0,48000
20200316,8271,宇瞻,40.00,40.75,36.90,36.90,-3.45,-8.55,3914190,2647,151565924,175000,1401000,-1226000,0,0,0,27000,30000,-3000,-1229000
20200316,8341,日友,214.00,217.50,210.50,212.00,0.00,0.00,467025,589,100119350,224000,210000,14000,7000,0,7000,0,14000,-14000,7000
20200316,8367,建新國際,22.45,23.05,22.05,22.10,-0.35,-1.56,101100,54,2256500,0,27000,-27000,0,0,0,0,6000,-6000,-33000
20200316,8374,羅昇,16.60,16.60,15.60,15.90,-1.05,-6.19,134856,90,2165930,1000,7000,-6000,0,0,0,0,0,0,-6000
20200316,8404,百和興業-KY,33.30,33.30,29.70,30.50,-2.50,-7.58,965390,531,29809050,173000,139000,34000,0,0,0,0,0,0,34000
20200316,8411,福貞-KY,10.30,10.50,10.10,10.20,-0.40,-3.77,233962,94,2404898,0,21000,-21000,0,0,0,0,0,0,-21000
20200316,8422,可寧衛,141.50,141.50,138.00,139.50,-2.00,-1.41,426140,469,59626100,82035,117000,-34965,0,2000,-2000,0,37000,-37000,-73965
20200316,8427,基勝-KY,38.55,39.95,37.50,37.50,-3.40,-8.31,5000,5,193400,1000,0,1000,0,0,0,0,0,0,1000
20200316,8429,金麗-KY,7.43,7.50,6.90,7.15,-0.35,-4.67,839755,346,6086906,9000,84000,-75000,0,0,0,0,6000,-6000,-81000
20200316,8442,威宏-KY,48.95,48.95,47.00,48.40,-0.60,-1.22,24000,24,1148650,4000,3000,1000,0,0,0,0,0,0,1000
20200316,8443,阿瘦,8.90,9.15,8.80,8.93,+0.08,0.9,35355,55,316306,1000,5000,-4000,0,0,0,0,0,0,-4000
20200316,8454,富邦媒,320.00,323.00,303.50,303.50,-17.00,-5.3,300534,297,93474836,136000,144000,-8000,1000,0,1000,1000,19000,-18000,-25000
20200316,8462,柏文,146.00,152.00,138.00,142.50,-4.50,-3.06,332283,496,47998252,39000,53361,-14361,0,0,0,0,0,0,-14361
20200316,8463,潤泰材,34.30,37.00,34.20,35.05,+1.35,4.01,629084,472,22230924,172000,156000,16000,0,0,0,0,0,0,16000
20200316,8464,億豐,205.00,208.00,198.50,200.00,-6.00,-2.91,1834911,1407,370159298,1103900,1004000,99900,1000,45000,-44000,0,40000,-40000,15900
20200316,8466,美吉吉-KY,60.10,61.30,60.10,61.30,-1.30,-2.08,38041,25,2318337,1000,3000,-2000,0,0,0,0,0,0,-2000
20200316,8467,波力-KY,40.50,42.65,40.50,41.55,-1.45,-3.37,32007,25,1341142,0,2000,-2000,0,0,0,0,0,0,-2000
20200316,8473,山林水,38.65,38.75,37.50,38.55,-0.10,-0.26,189763,142,7220606,5000,28000,-23000,0,0,0,0,0,0,-23000
20200316,8478,東哥遊艇,33.50,33.50,29.10,29.30,-3.00,-9.29,154040,114,4591986,2000,2000,0,0,0,0,0,0,0,0
20200316,8480,泰昇-KY,125.50,126.00,121.00,121.00,-2.50,-2.02,63143,57,7810517,25000,19000,6000,0,0,0,0,0,0,6000
20200316,8481,政伸,51.30,52.10,51.30,52.00,-1.70,-3.17,12000,10,623200,1000,0,1000,0,0,0,0,0,0,1000
20200316,8482,商億-KY,127.50,129.50,124.50,124.50,-3.00,-2.35,163000,81,20655500,92000,62000,30000,0,0,0,0,0,0,30000
20200316,8488,吉源-KY,12.25,13.30,12.25,13.05,-0.35,-2.61,7000,6,91150,0,1000,-1000,0,0,0,0,0,0,-1000
20200316,8497,格威傳媒,68.20,68.20,68.00,68.00,-0.20,-0.29,105000,73,7142200,6000,9000,-3000,0,0,0,0,36000,-36000,-39000
20200316,8499,鼎炫-KY,75.60,75.60,69.00,69.40,-6.20,-8.2,202200,169,14500680,41000,48000,-7000,0,0,0,0,0,0,-7000
20200316,8926,台汽電,30.80,30.80,29.75,29.75,-1.15,-3.72,3321670,1777,99844023,457000,592000,-135000,1000,11000,-10000,0,190000,-190000,-335000
20200316,8940,新天地,8.90,9.58,8.90,9.40,+0.19,2.06,49254,21,464543,0,0,0,0,0,0,0,1000,-1000,-1000
20200316,8996,高力,54.80,55.70,49.80,49.80,-5.50,-9.95,4609400,3109,240359050,731000,1069000,-338000,0,383000,-383000,0,12000,-12000,-733000
20200316,9103,美德醫療-DR,4.10,4.23,4.00,4.23,+0.38,9.87,11772516,1484,49094311,193000,71000,122000,0,0,0,2000,0,2000,124000
20200316,910322,康師傅-DR,26.70,26.70,25.55,25.55,-1.00,-3.77,19000,8,501400,0,9000,-9000,0,0,0,0,0,0,-9000
20200316,910482,聖馬丁-DR,0.28,0.29,0.27,0.28,-0.01,-3.45,131496,17,35903,0,0,0,0,0,0,0,0,0,0
20200316,9105,泰金寶-DR,2.60,2.80,2.60,2.61,-0.03,-1.14,7320118,1452,19498071,532000,1369000,-837000,0,0,0,0,0,0,-837000
20200316,910861,神州-DR,6.80,6.80,6.60,6.60,-0.15,-2.22,4000,4,26600,0,0,0,0,0,0,0,0,0,0
20200316,9110,越南控-DR,1.44,1.45,1.34,1.40,-0.08,-5.41,407000,64,564870,45000,0,45000,0,0,0,0,0,0,45000
20200316,911608,明輝-DR,1.07,1.07,1.03,1.04,-0.09,-7.96,87000,18,89990,0,0,0,0,0,0,0,0,0,0
20200316,911616,杜康-DR,0.76,0.77,0.75,0.76,0.00,0.00,242000,43,183090,2000,2000,0,0,0,0,0,0,0,0
20200316,911622,泰聚亨-DR,10.90,10.90,10.90,10.90,0.00,0.00,1000,1,10900,0,0,0,0,0,0,0,0,0,0
20200316,911868,同方友友-DR,0.90,0.91,0.90,0.91,+0.03,3.41,84001,16,75730,21000,0,21000,0,0,0,0,0,0,21000
20200316,912000,晨訊科-DR,1.64,1.64,1.64,1.64,0.00,0.00,2000,1,3280,0,0,0,0,0,0,0,0,0,0
20200316,912398,友佳-DR,3.15,3.15,3.15,3.15,+0.25,8.62,1000,1,3150,0,0,0,0,0,0,0,0,0,0
20200316,9136,巨騰-DR,5.80,6.10,5.80,6.10,+0.10,1.67,272000,65,1622820,94000,3000,91000,0,0,0,2000,1000,1000,92000
20200316,9188,精熙-DR,2.77,2.77,2.73,2.74,-0.03,-1.08,70000,14,193460,0,0,0,0,0,0,0,0,0,0
20200316,9802,鈺齊-KY,93.20,93.20,84.10,85.90,-7.50,-8.03,3688401,2692,320701387,1587000,1061000,526000,0,612000,-612000,8000,70000,-62000,-148000
20200316,9902,台火,7.68,7.85,7.56,7.61,-0.05,-0.65,163079,91,1250986,8000,29000,-21000,0,0,0,0,8000,-8000,-29000
20200316,9904,寶成,28.10,28.20,27.40,27.40,-0.90,-3.18,11008857,5059,306188061,3122000,6926235,-3804235,7000,8000,-1000,31000,518000,-487000,-4292235
20200316,9905,大華,20.40,20.40,19.80,19.90,-0.45,-2.21,323892,235,6477694,3000,51000,-48000,0,0,0,0,1000,-1000,-49000
20200316,9906,欣巴巴,15.10,16.30,15.10,16.00,-0.30,-1.84,47058,39,741084,8000,0,8000,0,0,0,0,0,0,8000
20200316,9907,統一實,9.20,9.20,8.91,8.91,-0.29,-3.15,2533682,781,22874868,275000,311000,-36000,0,0,0,0,8000,-8000,-44000
20200316,9908,大台北,29.20,29.25,28.75,29.00,-0.50,-1.69,679177,286,19730934,47000,67000,-20000,0,0,0,4000,40000,-36000,-56000
20200316,9910,豐泰,137.00,137.00,131.50,132.50,-7.50,-5.36,2497745,1822,334745085,1221000,1517495,-296495,0,151400,-151400,25000,69000,-44000,-491895
20200316,9911,櫻花,41.95,42.00,40.60,40.60,-1.35,-3.22,744280,614,30640954,234000,443000,-209000,0,2000,-2000,2000,3000,-1000,-212000
20200316,9912,偉聯,7.00,7.04,6.96,7.04,-0.43,-5.76,25202,32,176561,0,7000,-7000,0,0,0,1000,1000,0,-7000
20200316,9914,美利達,131.50,131.50,119.50,119.50,-13.00,-9.81,3063670,2386,381315410,768000,1468000,-700000,0,303000,-303000,26000,37000,-11000,-1014000
20200316,9917,中保科,84.70,84.70,83.00,83.20,-1.50,-1.77,382638,420,32061655,75000,106000,-31000,0,2000,-2000,0,39000,-39000,-72000
20200316,9918,欣天然,34.40,34.40,31.50,32.50,+0.80,2.52,20007,23,662338,0,0,0,0,0,0,0,0,0,0
20200316,9919,康那香,17.30,18.95,17.25,18.95,+1.70,9.86,19657975,7340,365373824,3729000,669000,3060000,0,0,0,0,0,0,3060000
20200316,9921,巨大,141.00,141.00,133.00,133.00,-11.00,-7.64,2675401,1928,367596635,815000,2060649,-1245649,1000,18000,-17000,3000,43000,-40000,-1302649
20200316,9924,福興,38.70,38.80,38.00,38.00,-0.70,-1.81,411160,322,15723612,75000,198000,-123000,0,0,0,0,30000,-30000,-153000
20200316,9925,新保,34.95,34.95,34.10,34.20,-0.75,-2.15,372235,275,12865829,16000,52000,-36000,0,0,0,0,12000,-12000,-48000
20200316,9926,新海,39.20,39.80,39.20,39.35,-0.05,-0.13,29087,28,1143251,0,3000,-3000,0,0,0,10000,0,10000,7000
20200316,9927,泰銘,28.80,28.80,28.05,28.10,-0.70,-2.43,231151,146,6568090,5000,91000,-86000,0,0,0,0,1000,-1000,-87000
20200316,9928,中視,,,,,0.00,0.00,402,4,1525,0,0,0,0,0,0,0,0,0,0
20200316,9929,秋雨,11.00,11.60,10.40,11.45,+0.10,0.88,47802,35,522681,0,0,0,0,0,0,0,0,0,0
20200316,9930,中聯資源,42.90,42.90,41.20,41.40,-1.50,-3.5,277395,214,11635790,21000,46000,-25000,0,0,0,0,2000,-2000,-27000
20200316,9931,欣高,33.65,34.00,33.65,34.00,-0.10,-0.29,39152,20,1330801,0,2000,-2000,0,0,0,0,0,0,-2000
20200316,9933,中鼎,31.00,31.00,29.80,29.90,-0.90,-2.92,2929226,1851,88741942,1145000,1875000,-730000,0,0,0,0,103000,-103000,-833000
20200316,9934,成霖,12.90,12.95,12.35,12.35,-0.70,-5.36,1142359,656,14404590,15000,601000,-586000,0,6000,-6000,0,27000,-27000,-619000
20200316,9935,慶豐富,26.50,27.25,25.80,25.80,-0.65,-2.46,1684377,830,44471030,384000,387000,-3000,0,0,0,0,0,0,-3000
20200316,9937,全國,39.80,41.50,39.80,41.00,+1.10,2.76,55001,41,2223841,1000,0,1000,0,0,0,0,0,0,1000
20200316,9938,百和,59.50,59.90,53.70,55.00,-4.50,-7.56,3245447,2183,180626122,710000,694218,15782,0,823000,-823000,21000,267000,-246000,-1053218
20200316,9939,宏全,50.10,50.10,48.00,48.00,-2.10,-4.19,2284664,1320,112378312,687000,484000,203000,0,2000,-2000,21000,294000,-273000,-72000
20200316,9940,信義,25.65,25.90,25.10,25.60,0.00,0.00,660066,451,16775872,54000,120000,-66000,0,0,0,0,68000,-68000,-134000
20200316,9941,裕融,91.60,91.60,88.80,88.80,-2.50,-2.74,822614,776,73762107,98000,207000,-109000,0,0,0,0,53000,-53000,-162000
20200316,9941A,裕融甲特,52.70,52.70,52.00,52.30,-0.90,-1.69,197000,95,10309500,0,0,0,0,0,0,10000,17000,-7000,-7000
20200316,9942,茂順,59.70,60.40,59.70,60.10,+0.40,0.67,167185,131,10042073,24000,26000,-2000,0,0,0,0,0,0,-2000
20200316,9943,好樂迪,59.30,59.30,56.10,56.20,-3.10,-5.23,868105,683,49623485,19000,87000,-68000,0,0,0,0,0,0,-68000
20200316,9944,新麗,16.00,17.05,15.70,16.35,+0.70,4.47,2661056,1425,44085477,480000,175000,305000,0,0,0,0,0,0,305000
20200316,9945,潤泰新,37.40,37.50,35.80,35.90,-1.55,-4.14,3278854,2083,119714344,659000,1232000,-573000,0,3000,-3000,10000,274000,-264000,-840000
20200316,9946,三發地產,15.70,16.20,15.40,15.40,0.00,0.00,2733010,1126,42955998,483000,768000,-285000,0,0,0,0,0,0,-285000
20200316,9955,佳龍,14.30,14.70,13.40,13.60,-1.25,-8.42,2776875,1042,37905711,489000,91000,398000,0,0,0,0,1000,-1000,397000
20200316,9958,世紀鋼,85.50,87.70,83.60,83.60,-0.80,-0.95,22599304,14344,1937038392,1709000,1093000,616000,1269000,0,1269000,213000,998000,-785000,1100000
20200316,00679B,元大美債20年,51.00,51.35,50.70,50.95,+2.48,5.12,1721000,850,87643800,0,7000,-7000,0,0,0,719000,93000,626000,619000
20200316,00687B,國泰20年美債,52.40,53.85,52.40,52.95,+2.10,4.13,632000,129,33538600,0,0,0,0,0,0,546000,100000,446000,446000
20200316,00694B,富邦美債1-3,41.00,41.00,40.84,40.85,0.00,0.0,347000,23,14204320,0,0,0,0,0,0,308000,311000,-3000,-3000
20200316,00695B,富邦美債7-10,41.69,42.18,41.69,42.09,+0.43,1.03,485000,64,20450190,0,0,0,0,0,0,422000,365000,57000,57000
20200316,00696B,富邦美債20年,54.30,54.50,52.90,53.30,+2.40,4.72,693000,88,36948750,0,6000,-6000,0,0,0,627000,402000,225000,219000
20200316,00697B,元大美債7-10,44.31,44.98,44.31,44.66,+0.08,0.18,178000,41,7957640,0,0,0,0,0,0,152000,103000,49000,49000
20200316,00718B,富邦中國政策債,19.70,19.70,19.50,19.63,-0.09,-0.46,567000,45,11132440,0,0,0,0,0,0,507000,376000,131000,131000
20200316,00719B,元大美債1-3,32.52,32.52,32.33,32.48,-0.05,-0.15,292000,24,9469640,0,0,0,0,0,0,102000,162000,-60000,-60000
20200316,00720B,元大投資級公司債,42.01,42.50,42.00,42.05,+0.35,0.84,323000,124,13590480,0,0,0,0,0,0,174000,100000,74000,74000
20200316,00721B,元大中國債3-5,45.29,45.29,45.28,45.29,-0.13,-0.29,107000,9,4845030,0,0,0,0,0,0,100000,101000,-1000,-1000
20200316,00722B,群益15年IG電信債,45.60,46.32,45.60,46.20,+0.05,0.11,265000,45,12236410,6000,0,6000,0,0,0,181000,102000,79000,85000
20200316,00723B,群益15年IG科技債,43.57,44.10,43.57,43.70,-0.50,-1.13,128000,16,5622130,25000,0,25000,0,0,0,101000,101000,0,25000
20200316,00724B,群益10年IG金融債,40.70,40.96,40.02,40.55,-0.45,-1.1,134000,27,5430590,0,0,0,0,0,0,109000,102000,7000,7000
20200316,00725B,國泰投資級公司債,42.43,42.43,41.65,41.70,+0.94,2.31,155000,37,6464920,0,2000,-2000,0,0,0,113000,109000,4000,2000
20200316,00726B,國泰5Y+新興債,42.42,42.42,41.99,42.10,+0.10,0.24,112000,14,4715590,3000000,0,3000000,0,0,0,112000,3100000,-2988000,12000
20200316,00727B,國泰1-5Y高收債,38.20,39.20,37.50,38.61,+1.11,2.96,140000,27,5402620,0,0,0,0,0,0,132000,103000,29000,29000
20200316,00734B,台新JPM新興債,20.80,20.83,20.24,20.26,-0.36,-1.75,1053000,44,21373090,0,0,0,0,0,0,983000,828000,155000,155000
20200316,00740B,富邦全球投等債,45.48,45.48,44.06,44.06,+1.51,3.55,190000,17,8521060,0,0,0,0,0,0,166000,162000,4000,4000
20200316,00741B,富邦全球高收債,37.73,37.73,37.16,37.16,-0.59,-1.56,142000,15,5322000,0,0,0,0,0,0,128000,127000,1000,1000
20200316,00744B,國泰中國政金債5+,41.77,41.77,41.77,41.77,-0.43,-1.02,100000,2,4177000,0,0,0,0,0,0,100000,100000,0,0
20200316,00745B,富邦中政債0-1,39.56,39.60,39.56,39.60,0.00,0.0,51000,3,2019560,0,0,0,0,0,0,50000,51000,-1000,-1000
20200316,00746B,富邦A級公司債,44.55,45.37,44.45,45.34,+0.90,2.03,79000,19,3574520,0,0,0,0,0,0,50000,66000,-16000,-16000
20200316,00747B,FH中國政策債,52.05,52.05,51.90,51.95,0.00,0.0,112000,5,5827850,0,0,0,0,0,0,112000,100000,12000,12000
20200316,00748B,凱基中國債3-10,41.82,41.82,41.82,41.82,-0.12,-0.29,100000,2,4182000,0,0,0,0,0,0,100000,100000,0,0
20200316,00749B,凱基新興債10+,45.20,45.20,45.20,45.20,+0.95,2.15,100000,2,4520000,0,0,0,0,0,0,100000,100000,0,0
20200316,00750B,凱基科技債10+,45.79,45.79,45.79,45.79,0.00,0.0,100000,2,4579000,0,0,0,0,0,0,100000,100000,0,0
20200316,00751B,元大AAA至A公司債,46.00,46.50,46.00,46.37,+0.77,1.69,615000,318,28485160,0,0,0,0,0,0,160000,194000,-34000,-34000
20200316,00754B,群益AAA-AA公司債,48.36,48.36,47.20,47.20,-0.20,-0.42,105000,7,4958930,0,0,0,0,0,0,101000,105000,-4000,-4000
20200316,00755B,群益15年IG公用債,44.80,45.96,44.07,44.88,+0.08,0.18,158000,33,7057610,37000,0,37000,0,0,0,106000,106000,0,37000
20200316,00756B,群益15年EM主權債,47.00,47.00,45.42,46.10,-0.10,-0.22,118000,11,5444780,0,0,0,0,0,0,112000,105000,7000,7000
20200316,00758B,FH能源債,54.00,55.30,54.00,55.30,+1.00,1.84,103000,5,5683750,0,0,0,0,0,0,101000,103000,-2000,-2000
20200316,00759B,FH製藥債,71.65,71.65,71.65,71.65,-1.05,-1.44,101000,3,7236650,0,0,0,0,0,0,101000,101000,0,0
20200316,00760B,FH新興企業債,62.80,62.80,62.80,62.80,+0.50,0.8,101000,3,6342800,0,0,0,0,0,0,101000,101000,0,0
20200316,00761B,國泰A級公司債,47.12,48.18,47.12,47.41,+0.35,0.74,128000,24,6092490,0,0,0,0,0,0,111000,100000,11000,11000
20200316,00764B,群益25年美債,54.00,54.50,53.65,54.40,+2.30,4.41,135000,32,7335550,0,0,0,0,0,0,102158,123000,-20842,-20842
20200316,00765B,群益中國政金債,40.19,40.45,40.19,40.45,0.00,0.0,103000,4,4165760,0,0,0,0,0,0,103000,100000,3000,3000
20200316,00768B,FH20年美債,82.20,82.30,79.95,82.30,0.00,0.0,111000,13,9125300,0,0,0,0,0,0,101000,111000,-10000,-10000
20200316,00769B,FH中國信用債,62.00,62.00,62.00,62.00,+0.70,1.14,100000,2,6200000,0,0,0,0,0,0,100000,100000,0,0
20200316,00772B,中信高評級公司債,45.40,46.45,45.20,46.45,+1.25,2.77,328000,43,14941630,0,0,0,0,0,0,267000,247000,20000,20000
20200316,00773B,中信優先金融債,44.98,44.98,44.36,44.79,-0.20,-0.44,455000,61,20337290,0,0,0,0,0,0,417000,295000,122000,122000
20200316,00777B,凱基AAA至A公司債,45.69,45.70,45.69,45.70,+0.01,0.02,101000,3,4614700,0,0,0,0,0,0,100000,100000,0,0
20200316,00778B,凱基金融債20+,44.28,44.28,44.28,44.28,0.00,0.0,100000,2,4428000,0,0,0,0,0,0,100000,100000,0,0
20200316,00779B,凱基美債25+,54.35,55.40,54.35,55.40,+2.30,4.33,101000,3,5594350,0,0,0,0,0,0,100000,100000,0,0
20200316,00780B,國泰A級金融債,42.55,42.55,41.30,41.30,-0.53,-1.27,101000,3,4172550,0,1000,-1000,0,0,0,101000,100000,1000,0
20200316,00781B,國泰A級科技債,45.90,46.81,45.90,46.50,+0.60,1.31,109000,11,5066400,0,0,0,0,0,0,108000,100000,8000,8000
20200316,00782B,國泰A級公用債,46.41,46.41,45.24,45.24,+1.23,2.79,2000,2,91650,0,1000,-1000,0,0,0,1000,1000,0,-1000
20200316,00784B,富邦中國投等債,40.54,40.54,40.50,40.50,-0.50,-1.22,202000,3,8181080,0,0,0,0,0,0,200000,202000,-2000,-2000
20200316,00785B,富邦金融投等債,41.74,41.74,41.63,41.70,-0.62,-1.47,204000,5,8506750,0,0,0,0,0,0,200000,204000,-4000,-4000
20200316,00786B,元大10年IG銀行債,40.07,40.15,40.03,40.07,+0.60,1.52,213000,15,8535750,0,0,0,0,0,0,203000,200000,3000,3000
20200316,00787B,元大10年IG醫療債,43.65,44.40,43.65,43.70,+0.05,0.11,170000,60,7441440,0,0,0,0,0,0,141000,100000,41000,41000
20200316,00788B,元大10年IG電能債,41.95,42.71,41.59,41.70,+0.20,0.48,654000,23,27276570,0,0,0,0,500000,-500000,650000,140000,510000,10000
20200316,00789B,FH公司債A3,67.15,68.95,67.15,68.95,+1.80,2.68,103000,5,6918250,0,0,0,0,0,0,103000,103000,0,0
20200316,00790B,FH次順位IG金融債,63.00,63.00,63.00,63.00,+0.40,0.64,100000,2,6300000,0,0,0,0,0,0,100000,100000,0,0
20200316,00791B,FH美元信用債1-5Y,59.60,59.60,59.60,59.60,+0.40,0.68,100000,2,5960000,0,0,0,0,0,0,100000,100000,0,0
20200316,00792B,群益A級公司債,44.36,44.36,44.00,44.00,+0.19,0.43,101000,3,4444360,0,0,0,0,0,0,101000,101000,0,0
20200316,00793B,群益AAA-A醫療債,45.83,45.90,45.83,45.90,+0.64,1.41,101000,3,4635830,0,0,0,0,0,0,101000,101000,0,0
20200316,00794B,群益7+中國政金債,40.80,40.85,40.50,40.50,+0.02,0.05,102000,4,4131650,0,0,0,0,0,0,101000,102000,-1000,-1000
20200316,00795B,中信美國公債20年,51.00,51.60,51.00,51.50,+2.08,4.21,414000,114,21189300,0,10000,-10000,0,0,0,378000,241000,137000,127000
20200316,00796B,中信中國債7-10,39.98,40.10,39.98,40.10,-0.04,-0.1,240000,6,9615600,0,0,0,0,0,0,240000,240000,0,0
20200316,00797B,中信中國美元IG債,41.28,41.32,41.22,41.29,-0.64,-1.53,259000,10,10694260,0,0,0,0,0,0,247000,240000,7000,7000
20200316,00798B,國泰中企A級債7+,44.24,44.24,42.77,42.77,-1.81,-4.06,102000,4,4364010,0,0,0,0,0,0,102000,102000,0,0
20200316,00799B,國泰A級醫療債,46.92,46.92,44.80,44.93,+0.26,0.58,111000,13,5018100,0,0,0,0,0,0,105000,100000,5000,5000
20200316,00831B,新光美債1-3,40.48,40.48,40.48,40.48,-0.05,-0.12,50000,2,2024000,0,0,0,0,0,0,50000,50000,0,0
20200316,00832B,新光美債20+,52.55,52.55,52.55,52.55,+1.75,3.44,50000,2,2627500,0,0,0,0,0,0,50000,50000,0,0
20200316,00833B,第一金美債20+,49.43,50.30,49.30,50.30,+1.41,2.88,113000,14,5574540,0,0,0,0,0,0,105000,110000,-5000,-5000
20200316,00834B,第一金金融債10+,41.80,41.80,41.80,41.80,-0.44,-1.04,100000,2,4180000,0,0,0,0,0,0,100000,100000,0,0
20200316,00835B,第一金科技債10+,43.20,43.20,43.20,43.20,-0.28,-0.64,100000,2,4320000,0,0,0,0,0,0,100000,100000,0,0
20200316,00836B,永豐10年A公司債,42.24,42.24,42.24,42.24,0.00,0.0,100000,4,4224000,0,0,0,0,0,0,100000,100000,0,0
20200316,00837B,永豐15年金融債,42.02,42.54,42.02,42.49,+0.51,1.21,171000,42,7215230,0,0,0,0,0,0,103000,166000,-63000,-63000
20200316,00838B,永豐7-10年中國債,39.76,39.76,39.76,39.76,-0.14,-0.35,100000,2,3976000,0,0,0,0,0,0,100000,100000,0,0
20200316,00839B,凱基醫療保健債,43.27,43.27,43.27,43.27,0.00,0.0,100000,2,4327000,0,0,0,0,0,0,100000,100000,0,0
20200316,00840B,凱基IG精選15+,41.18,41.18,41.18,41.18,0.00,0.0,100000,2,4118000,0,0,0,0,0,0,100000,100000,0,0
20200316,00841B,凱基AAA-AA公司債,41.85,41.85,41.85,41.85,0.00,0.0,100000,2,4185000,0,0,0,0,0,0,100000,100000,0,0
20200316,00842B,台新美元銀行債,39.65,39.86,39.52,39.52,+0.57,1.46,100000,10,3954560,0,0,0,0,0,0,100000,74000,26000,26000
20200316,00843B,台新中國政策債,39.79,39.79,39.79,39.79,-0.14,-0.35,100000,2,3979000,0,0,0,0,0,0,100000,100000,0,0
20200316,00844B,新光15年IG金融債,39.25,39.25,39.25,39.25,+0.69,1.79,2000,2,78500,0,0,0,0,0,0,2000,2000,0,0
20200316,00845B,富邦新興投等債,37.10,37.10,36.50,36.50,-0.69,-1.86,311000,10,11475700,0,0,0,0,0,0,304000,304000,0,0
20200316,00846B,富邦歐洲銀行債,37.88,37.88,37.75,37.80,-0.50,-1.31,401000,5,15147880,0,0,0,0,0,0,400000,401000,-1000,-1000
20200316,00847B,中信美國市政債,42.48,42.73,41.70,42.60,+0.12,0.28,238000,48,10089850,0,0,0,0,0,0,225000,131000,94000,94000
20200316,00848B,中信新興亞洲債,38.74,38.82,38.74,38.82,-0.73,-1.85,249000,8,9665460,0,0,0,0,0,0,249000,240000,9000,9000
20200316,00849B,中信EM主權債0-5,39.14,39.25,39.14,39.25,+0.12,0.31,252000,9,9889680,0,0,0,0,0,0,252000,240000,12000,12000
20200316,00853B,統一美債10年Aa-A,37.78,37.78,37.78,37.78,+0.78,2.11,1000,1,37780,0,0,0,0,0,0,1000,0,1000,1000
20200316,00854B,富邦全球保險債,39.24,39.24,39.08,39.08,-0.45,-1.14,201000,3,7855240,0,0,0,0,0,0,200000,201000,-1000,-1000
20200316,00855B,富邦全球能源債,33.06,33.60,32.98,33.58,+0.26,0.78,428000,10,14341620,0,0,0,0,0,0,420000,428000,-8000,-8000
20200316,00856B,永豐1-3年美公債,39.85,39.85,39.85,39.85,-0.12,-0.3,100000,2,3985000,0,0,0,0,0,0,100000,100000,0,0
20200316,00857B,永豐20年美公債,45.04,45.31,45.03,45.31,+1.41,3.21,140000,21,6314960,0,0,0,0,0,0,140000,100000,40000,40000
20200316,00858,永豐美國500大,17.65,17.68,17.64,17.65,+0.32,1.85,122000,12,2156290,0,0,0,0,0,0,116000,100000,16000,16000
20200316,00859B,群益0-1年美債,39.57,39.64,39.57,39.57,0.00,0.0,106000,7,4197490,0,0,0,0,0,0,101000,100000,1000,1000
20200316,00860B,群益1-5年IG債,39.33,39.33,38.36,39.10,+0.38,0.98,105000,7,4103510,0,0,0,0,0,0,105000,101000,4000,4000
20200316,00862B,中信投資級公司債,39.10,39.48,39.00,39.48,-0.02,-0.05,302000,34,11887960,0,0,0,0,0,0,290000,247000,43000,43000
20200316,00863B,中信全球電信債,39.29,40.60,39.29,40.60,+0.62,1.55,253000,12,10188440,0,0,0,0,0,0,247000,245000,2000,2000
20200316,00864B,中信美國公債0-1,39.78,39.82,39.78,39.80,+0.02,0.05,257000,17,10227340,0,0,0,0,0,0,240000,251000,-11000,-11000
20200316,00867B,新光A-BBB電信債,40.20,40.20,40.20,40.20,+0.55,1.39,2000,2,80400,0,0,0,0,0,0,2000,2000,0,0
20200316,00868B,FT1-3年美公債,40.23,40.55,40.23,40.55,+0.04,0.1,101000,3,4095230,0,0,0,0,0,0,101000,100000,1000,1000
20200316,00869B,FT10-25年公司債,38.39,38.39,38.39,38.39,+0.37,0.97,100000,2,3839000,0,0,0,0,0,0,100000,100000,0,0
20200316,00870B,元大15年EM主權債,38.00,38.00,37.74,37.94,-0.01,-0.03,434000,18,16448610,0,0,0,0,0,0,428000,402000,26000,26000
20200316,00871B,元大中國政金債,39.78,39.82,39.77,39.82,-0.13,-0.33,208000,8,8278200,0,0,0,0,0,0,206000,200000,6000,6000
20200316,00872B,凱基美債1-3,41.26,41.26,41.15,41.15,+0.34,0.83,101000,3,4156260,0,0,0,0,0,0,101000,101000,0,0
20200316,00873B,凱基新興債1-5,40.04,40.04,39.10,39.10,-0.40,-1.01,101000,3,3950040,0,0,0,0,0,0,101000,100000,1000,1000
20200316,00874B,凱基BBB公司債15+,37.33,37.33,37.33,37.33,+0.67,1.83,100000,2,3733000,0,0,0,0,0,0,100000,100000,0,0
20200316,1240,茂生農經,43.80,43.80,41.80,42.80,-2.55,-5.62,236000,153,9970950,9000,3000,6000,0,0,0,0,0,0,6000
20200316,1258,其祥-KY,11.75,11.75,10.60,10.65,-1.10,-9.36,126000,61,1362750,3000,4000,-1000,0,0,0,0,0,0,-1000
20200316,1259,安心,64.20,64.50,64.00,64.10,-0.90,-1.38,29000,24,1862000,1000,0,1000,0,0,0,0,0,0,1000
20200316,1264,德麥,202.50,204.00,199.00,200.00,-2.50,-1.23,45000,45,9050500,0,16000,-16000,0,0,0,0,0,0,-16000
20200316,1268,漢來美食,103.00,104.00,102.00,102.50,-0.50,-0.49,55000,43,5667000,0,9000,-9000,0,0,0,0,1000,-1000,-10000
20200316,1333,恩得利,1.81,1.99,1.81,1.99,-0.02,-1.0,25000,6,47590,0,0,0,0,0,0,0,0,0,0
20200316,1336,台翰,13.45,13.75,13.30,13.40,+0.10,0.75,272000,119,3683200,1000,22000,-21000,0,0,0,0,0,0,-21000
20200316,1565,精華,319.50,320.00,311.50,313.00,-2.50,-0.79,282000,258,89354500,17263,43000,-25737,0,0,0,1000,2000,-1000,-26737
20200316,1569,濱川,14.60,14.70,13.15,13.30,-1.10,-7.64,1193000,592,16462900,92000,75000,17000,0,294993,-294993,9000,0,9000,-268993
20200316,1570,力肯,12.25,12.25,12.00,12.20,-0.25,-2.01,45000,22,544200,0,0,0,0,0,0,1000,0,1000,1000
20200316,1580,新麥,90.80,90.80,87.50,87.50,-2.20,-2.45,313000,251,27602100,3000,106000,-103000,0,0,0,0,0,0,-103000
20200316,1584,精剛,8.10,8.10,7.60,7.61,-0.37,-4.64,77000,48,595030,4000,3000,1000,0,0,0,0,0,0,1000
20200316,1586,和勤,36.00,36.10,34.45,35.30,-0.75,-2.08,671000,200,23661000,1000,37000,-36000,0,0,0,0,0,0,-36000
20200316,1591,駿吉-KY,21.25,21.25,18.70,19.20,-1.55,-7.47,108000,65,2060500,0,8000,-8000,0,0,0,0,0,0,-8000
20200316,1593,祺驊,42.50,42.60,41.70,42.00,-0.50,-1.18,57000,42,2397500,4000,0,4000,0,0,0,0,0,0,4000
20200316,1595,川寶,30.25,30.25,27.65,27.80,+0.25,0.91,69000,53,1944000,0,0,0,0,0,0,1000,1000,0,0
20200316,1597,直得,74.20,76.50,67.90,68.00,-6.20,-8.36,852000,608,60927700,52000,130000,-78000,0,0,0,0,1000,-1000,-79000
20200316,1599,宏佳騰,28.20,29.35,28.20,29.20,-0.45,-1.52,172000,101,4942950,24000,0,24000,0,0,0,0,0,0,24000
20200316,1742,台蠟,18.85,19.20,17.80,18.75,+0.30,1.63,464000,209,8670450,45000,11000,34000,0,0,0,0,0,0,34000
20200316,1752,南光,36.50,36.70,34.80,35.00,-0.90,-2.51,1017000,539,36447550,174000,120000,54000,0,0,0,0,26000,-26000,28000
20200316,1777,生泰,73.00,77.90,72.70,73.60,+1.00,1.38,332000,274,24795200,3000,12000,-9000,0,0,0,0,1000,-1000,-10000
20200316,1781,合世,8.22,9.40,8.22,9.35,+0.46,5.17,224000,114,2063630,0,0,0,0,0,0,0,0,0,0
20200316,1784,訊聯,30.10,30.75,28.00,28.00,-2.00,-6.67,624000,337,18310600,23000,13000,10000,0,0,0,0,0,0,10000
20200316,1785,光洋科,18.20,18.60,17.50,17.50,-1.10,-5.91,1926000,707,34613400,33000,245000,-212000,0,0,0,0,4000,-4000,-216000
20200316,1788,杏昌,102.50,104.00,101.00,101.50,-1.00,-0.98,87000,56,8863000,1000,13000,-12000,0,0,0,7000,0,7000,-5000
20200316,1796,金穎生技,24.00,24.10,24.00,24.10,-1.45,-5.68,2000,2,48100,0,0,0,0,0,0,0,0,0,0
20200316,1799,易威,9.11,10.35,9.11,10.00,+0.56,5.93,792000,362,7993840,3000,3000,0,0,0,0,0,8000,-8000,-8000
20200316,1813,寶利徠,20.95,21.00,20.55,20.65,-0.25,-1.2,80000,63,1665850,10000,1000,9000,0,0,0,0,0,0,9000
20200316,1815,富喬,9.51,9.65,9.05,9.22,+0.02,0.22,2118000,809,19804840,110000,458000,-348000,0,0,0,32000,34000,-2000,-350000
20200316,2035,唐榮,38.85,39.40,38.85,39.40,+1.60,4.23,14000,8,549300,0,0,0,0,0,0,0,0,0,0
20200316,2061,風青,8.02,8.15,8.00,8.00,-0.88,-9.91,184000,49,1478910,10000,0,10000,0,0,0,0,0,0,10000
20200316,2063,世鎧,36.80,36.90,36.55,36.55,+0.05,0.14,58000,32,2126200,0,1000,-1000,0,0,0,5000,0,5000,4000
20200316,2064,晉椿,10.05,10.90,10.05,10.80,+0.15,1.41,11000,8,117550,0,0,0,0,0,0,0,0,0,0
20200316,2065,世豐,50.40,50.80,49.20,49.20,-0.80,-1.6,303000,212,15064700,7000,61085,-54085,0,0,0,0,0,0,-54085
20200316,2066,世德,49.00,49.00,47.50,47.50,-4.00,-7.77,77000,49,3704500,0,2000,-2000,0,0,0,0,0,0,-2000
20200316,2067,嘉鋼,8.20,8.50,8.02,8.49,-0.33,-3.74,35000,18,289450,0,0,0,0,0,0,1000,1000,0,0
20200316,2070,精湛,23.60,26.50,23.55,26.50,+0.55,2.12,63000,45,1526250,3000,0,3000,0,0,0,0,0,0,3000
20200316,2221,大甲,24.15,24.30,23.90,23.90,-0.25,-1.04,46000,33,1107900,0,0,0,0,0,0,0,0,0,0
20200316,2230,泰茂,9.71,9.71,9.27,9.50,-0.80,-7.77,464000,167,4405290,0,1000,-1000,0,0,0,0,0,0,-1000
20200316,2235,謚源,44.10,44.55,40.00,44.50,+0.50,1.14,143000,92,6008900,8000,7000,1000,0,0,0,0,0,0,1000
20200316,2596,綠意,17.85,18.70,17.60,18.00,+0.15,0.84,109000,58,1944750,0,1000,-1000,0,0,0,0,2000,-2000,-3000
20200316,2640,大車隊,69.00,69.00,67.00,67.00,-2.40,-3.46,67000,60,4539900,1000,14000,-13000,0,0,0,0,0,0,-13000
20200316,2641,正德,5.72,5.98,5.72,5.74,-0.36,-5.9,305000,77,1768270,0,0,0,0,0,0,0,0,0,0
20200316,2643,捷迅,33.10,33.85,32.20,32.30,-0.50,-1.52,19000,18,625450,2000,2000,0,0,0,0,0,0,0,0
20200316,2718,晶悅,14.25,14.25,14.20,14.20,-1.40,-8.97,5000,4,71050,0,0,0,0,0,0,0,0,0,0
20200316,2719,燦星旅,4.75,5.37,4.75,5.37,+0.38,7.62,6000,5,29270,0,0,0,0,0,0,0,0,0,0
20200316,2724,富驛-KY,2.97,2.97,2.61,2.61,-0.28,-9.69,5000,2,14490,0,0,0,0,0,0,0,0,0,0
20200316,2726,雅茗-KY,51.50,53.00,49.00,51.50,0.00,0.0,105000,64,5318200,0,0,0,0,0,0,0,0,0,0
20200316,2729,瓦城,217.00,217.00,203.50,203.50,-10.00,-4.68,118000,90,24446000,7000,17000,-10000,0,0,0,2000,3000,-1000,-11000
20200316,2732,六角,121.50,126.00,116.00,116.00,-5.50,-4.53,1739000,1319,210386500,88000,159000,-71000,0,0,0,11000,68000,-57000,-128000
20200316,2734,易飛網,9.00,9.50,8.79,9.25,-0.51,-5.23,76000,46,679030,0,0,0,0,0,0,1000,0,1000,1000
20200316,2736,高野,12.50,12.60,12.25,12.60,-0.05,-0.4,79000,38,979050,0,0,0,0,0,0,0,0,0,0
20200316,2740,天蔥,10.70,10.80,10.40,10.75,-0.80,-6.93,15000,10,158750,0,0,0,0,0,0,0,0,0,0
20200316,2743,山富,13.25,13.45,12.50,13.10,-0.50,-3.68,148000,56,1878950,0,0,0,0,0,0,0,0,0,0
20200316,2745,五福,14.90,14.90,14.50,14.50,-0.40,-2.68,14000,14,204700,0,0,0,0,0,0,0,0,0,0
20200316,2752,豆府,100.00,101.00,99.00,99.00,,0.00,38000,33,3784500,0,7000,-7000,0,0,0,0,0,0,-7000
20200316,2916,滿心,16.10,16.20,16.10,16.20,-0.60,-3.57,20000,11,323500,1000,0,1000,0,0,0,0,0,0,1000
20200316,2924,東凌-KY,,,,,,0.00,0,0,0,0,0,0,0,0,0,0,0,0,0
20200316,2926,誠品生活,81.00,81.00,77.50,77.60,-2.70,-3.36,34000,30,2673200,0,0,0,0,0,0,0,0,0,0
20200316,2928,紅馬-KY,34.75,37.00,33.45,34.50,-0.95,-2.68,391000,235,13694050,135000,11000,124000,0,0,0,0,20000,-20000,104000
20200316,2937,集雅社,21.70,22.00,21.70,22.00,+1.00,4.76,20000,6,436400,0,0,0,0,0,0,0,0,0,0
20200316,3064,泰偉,13.00,13.00,13.00,13.00,-1.00,-7.14,3000,2,39000,0,0,0,0,0,0,0,0,0,0
20200316,3066,李洲,,,,,,0.00,0,0,0,0,0,0,0,0,0,0,0,0,0
20200316,3067,全域,39.80,44.70,39.80,44.25,+0.25,0.57,47000,40,2053850,0,0,0,0,0,0,0,6000,-6000,-6000
20200316,3071,協禧,14.25,14.35,14.00,14.15,+0.05,0.35,238000,113,3366300,14000,1000,13000,0,0,0,0,6000,-6000,7000
20200316,3073,凱柏實業,,,,,,0.00,0,0,0,0,0,0,0,0,0,0,0,0,0
20200316,3078,僑威,19.20,19.20,18.80,18.80,-0.20,-1.05,681000,357,12945100,60000,151000,-91000,0,0,0,0,0,0,-91000
20200316,3081,聯亞,235.00,239.00,225.00,225.00,-4.50,-1.96,1119000,939,260412500,476000,218000,258000,257000,0,257000,3000,23000,-20000,495000
20200316,3083,網龍,48.30,52.70,47.50,48.10,+0.05,0.1,1767000,1290,88064200,305000,200000,105000,0,0,0,26000,11000,15000,120000
20200316,3085,新零售,3.00,3.00,2.60,2.60,-0.22,-7.8,61000,11,161080,0,0,0,0,0,0,0,0,0,0
20200316,3086,華義,15.10,15.10,14.75,14.75,-1.60,-9.79,19000,12,282350,0,0,0,0,0,0,0,0,0,0
20200316,3088,艾訊,52.50,52.50,51.00,51.00,-1.10,-2.11,455000,348,23486800,5000,111000,-106000,0,0,0,0,0,0,-106000
20200316,3089,元炬,18.50,19.00,17.10,18.95,-0.05,-0.26,58000,36,1031750,0,0,0,0,0,0,0,0,0,0
20200316,3092,鴻碩,30.00,30.45,29.95,30.05,+0.10,0.33,348000,206,10481500,22000,54009,-32009,0,0,0,0,0,0,-32009
20200316,3093,港建,24.95,24.95,23.65,23.65,+0.05,0.21,19000,14,455750,0,0,0,0,0,0,0,0,0,0
20200316,3095,及成,1.87,1.87,1.87,1.87,+0.04,2.19,6000,4,11220,0,0,0,0,0,0,0,0,0,0
20200316,3105,穩懋,248.00,255.00,235.50,236.00,-13.50,-5.41,13938000,10150,3441535000,3181520,4654698,-1473178,516000,113000,403000,210000,433000,-223000,-1293178
20200316,3114,好德,19.90,20.00,19.55,19.60,-0.40,-2.0,320000,146,6322800,20000,0,20000,0,0,0,0,0,0,20000
20200316,3115,寶島極,10.90,10.95,9.90,9.90,-1.00,-9.17,15000,11,152330,0,0,0,0,0,0,0,0,0,0
20200316,3118,進階,27.10,29.00,26.85,26.85,-0.60,-2.19,523000,398,14565400,8000,8000,0,0,0,0,13000,5000,8000,8000
20200316,3122,笙泉,9.50,9.78,9.00,9.00,-0.34,-3.64,91000,54,849580,0,0,0,0,0,0,0,1000,-1000,-1000
20200316,3128,昇銳,11.75,12.05,11.70,11.70,-0.05,-0.43,93000,54,1103650,0,0,0,0,0,0,0,0,0,0
20200316,3131,弘塑,195.00,195.00,175.00,175.50,-11.50,-6.15,1059000,947,194975000,70000,125000,-55000,0,217000,-217000,12000,18000,-6000,-278000
20200316,3141,晶宏,19.10,19.30,17.20,17.20,-1.90,-9.95,1261000,599,22567700,60000,31000,29000,0,236000,-236000,3000,0,3000,-204000
20200316,3144,新揚科,21.20,21.30,19.30,19.50,-1.20,-5.8,582000,295,11715500,61000,111000,-50000,0,0,0,0,1000,-1000,-51000
20200316,3147,大綜,25.80,26.80,25.80,26.30,+0.10,0.38,185000,117,4860950,25000,0,25000,0,0,0,1000,1000,0,25000
20200316,3152,璟德,227.00,235.00,214.00,216.00,-19.00,-8.09,679000,633,152810500,95000,151000,-56000,0,54000,-54000,7000,43000,-36000,-146000
20200316,3162,精確,7.83,7.83,7.83,7.83,0.00,0.0,2000,1,15660,0,0,0,0,0,0,0,0,0,0
20200316,3163,波若威,30.60,31.20,27.80,27.90,-2.80,-9.12,1065000,640,31169100,204000,132000,72000,0,0,0,1000,4000,-3000,69000
20200316,3169,亞信,27.70,27.70,27.00,27.00,-0.70,-2.53,134000,78,3652150,9000,16000,-7000,0,0,0,0,0,0,-7000
20200316,3171,新洲,11.20,11.25,10.40,10.75,-0.40,-3.59,35000,23,380700,0,0,0,0,0,0,0,1000,-1000,-1000
20200316,3176,基亞,44.20,45.35,41.20,41.95,-1.95,-4.44,754000,460,33246650,10000,7000,3000,0,0,0,3000,0,3000,6000
20200316,3178,公準,38.00,38.05,34.00,34.05,-3.70,-9.8,982000,710,35427100,24000,55000,-31000,0,0,0,0,0,0,-31000
20200316,3188,鑫龍騰,13.30,14.00,13.30,14.00,-0.15,-1.06,46000,27,623150,1000,0,1000,0,0,0,0,1000,-1000,0
20200316,3191,和進,51.20,53.00,49.30,49.30,-0.70,-1.4,1024000,537,51923750,18000,102000,-84000,0,0,0,0,0,0,-84000
20200316,3202,樺晟,16.70,16.90,14.60,14.60,-1.60,-9.88,3023000,873,44805050,182000,50000,132000,0,0,0,0,0,0,132000
20200316,3205,佰研,36.25,36.85,32.65,32.65,-3.60,-9.93,308000,206,10610750,43000,10000,33000,0,0,0,0,0,0,33000
20200316,3206,志豐,26.20,26.45,24.60,24.60,-1.40,-5.38,212000,140,5428300,18000,32000,-14000,0,0,0,0,0,0,-14000
20200316,3207,耀勝,10.20,10.35,10.15,10.15,-0.80,-7.31,29000,11,296550,5000,0,5000,0,0,0,0,0,0,5000
20200316,3211,順達,61.70,63.00,60.00,60.10,-1.60,-2.59,2075000,1477,127392600,103000,553000,-450000,0,0,0,16000,29000,-13000,-463000
20200316,3213,茂訊,39.50,39.90,39.00,39.05,-0.05,-0.13,191000,98,7526150,1000,14000,-13000,0,0,0,0,0,0,-13000
20200316,3217,優群,69.90,73.00,66.60,68.00,-0.20,-0.29,8956000,5895,630993800,490000,913000,-423000,176000,0,176000,155000,193000,-38000,-285000
20200316,3218,大學光,64.70,65.60,58.00,59.10,-4.90,-7.66,2213000,1490,137425100,475000,132000,343000,0,0,0,16000,131000,-115000,228000
20200316,3221,台嘉碩,19.50,19.75,17.30,17.35,-1.85,-9.64,1536000,820,28173900,152000,101000,51000,0,0,0,2000,0,2000,53000
20200316,3224,三顧,40.55,40.55,38.00,38.55,-1.50,-3.75,308000,186,11916250,12000,20000,-8000,0,0,0,0,0,0,-8000
20200316,3226,至寶電,52.50,52.70,52.50,52.50,+0.10,0.19,10000,8,525500,0,0,0,0,0,0,0,0,0,0
20200316,3227,原相,155.00,161.50,145.00,145.00,-14.50,-9.09,12465000,9184,1916454000,726000,2098000,-1372000,18000,0,18000,346000,499000,-153000,-1507000
20200316,3228,金麗科,32.90,34.00,29.65,30.00,-2.90,-8.81,637000,348,20127500,19000,80000,-61000,0,0,0,3000,0,3000,-58000
20200316,3230,錦明,4.70,4.70,4.27,4.27,-0.47,-9.92,123000,40,530200,0,0,0,0,0,0,0,0,0,0
20200316,3232,昱捷,16.55,16.60,16.00,16.00,-0.15,-0.93,160000,114,2607750,1000,0,1000,0,0,0,0,0,0,1000
20200316,3234,光環,28.45,28.90,25.50,25.50,-2.80,-9.89,2538000,1422,68490900,237000,304000,-67000,0,0,0,0,0,0,-67000
20200316,3236,千如,15.45,15.70,15.20,15.20,-0.10,-0.65,350000,178,5371100,1000,44000,-43000,0,0,0,0,0,0,-43000
20200316,3252,海灣,12.15,12.70,12.00,12.60,-0.30,-2.33,342000,54,4170100,0,0,0,0,0,0,1000,1000,0,0
20200316,3259,鑫創,11.20,11.20,10.10,10.50,-0.35,-3.23,71000,44,753550,3000,0,3000,0,0,0,1000,1000,0,3000
20200316,3260,威剛,57.50,59.80,53.90,53.90,-4.30,-7.39,8071000,4829,459194800,492000,901000,-409000,227000,844000,-617000,416000,450000,-34000,-1060000
20200316,3264,欣銓,23.70,23.95,22.20,22.35,-1.45,-6.09,6019000,2776,138111050,189000,2539000,-2350000,333000,0,333000,46000,34000,12000,-2005000
20200316,3265,台星科,22.30,22.80,21.90,21.90,-0.05,-0.23,759000,429,16865250,11000,114000,-103000,0,0,0,0,0,0,-103000
20200316,3268,海德威,10.30,10.40,10.00,10.40,-0.20,-1.89,41000,18,417450,0,0,0,0,0,0,0,0,0,0
20200316,3272,東碩,19.75,19.95,18.90,18.90,-1.10,-5.5,155000,83,3019300,1000,6000,-5000,0,0,0,1000,0,1000,-4000
20200316,3276,宇環,6.57,6.57,6.00,6.00,-0.57,-8.68,58000,18,363780,0,0,0,0,0,0,0,0,0,0
20200316,3284,太普高,12.50,12.55,12.20,12.55,-0.25,-1.95,112000,38,1396750,0,1000,-1000,0,0,0,0,0,0,-1000
20200316,3285,微端,13.30,13.50,12.75,13.50,+0.45,3.45,187000,100,2473150,0,0,0,0,0,0,2000,2000,0,0
20200316,3287,廣寰科,6.61,6.80,6.42,6.66,+0.05,0.76,59000,41,390660,0,0,0,0,0,0,0,1000,-1000,-1000
20200316,3288,點晶,,,,,,0.00,0,0,0,0,0,0,0,0,0,0,0,0,0
20200316,3289,宜特,35.50,35.80,32.20,32.50,-2.60,-7.41,974000,662,33419600,82000,85000,-3000,0,0,0,0,0,0,-3000
20200316,3290,東浦,11.90,11.90,11.35,11.35,-0.50,-4.22,321000,129,3729600,9000,26000,-17000,0,0,0,6000,0,6000,-11000
20200316,3293,鈊象,570.00,583.00,514.00,515.00,-55.00,-9.65,5210000,4710,2881492000,211000,1044956,-833956,259000,0,259000,30000,149000,-119000,-693956
20200316,3294,英濟,12.00,12.00,11.50,11.90,-0.15,-1.24,185000,62,2200500,3000,3000,0,0,0,0,1000,0,1000,1000
20200316,3297,杭特,10.50,10.50,10.30,10.30,-0.05,-0.48,35000,12,365000,0,0,0,0,0,0,0,0,0,0
20200316,3303,岱稜,21.80,22.00,21.00,21.60,0.00,0.0,546000,160,11707000,3000,0,3000,0,0,0,0,9000,-9000,-6000
20200316,3306,鼎天,15.95,16.00,15.50,15.50,-0.40,-2.52,80000,32,1263100,0,0,0,0,0,0,0,0,0,0
20200316,3310,佳穎,31.10,31.10,29.35,30.95,-0.10,-0.32,79000,50,2391900,0,4000,-4000,0,0,0,0,0,0,-4000
20200316,3313,斐成,11.00,11.00,10.55,10.55,-1.15,-9.83,335000,112,3573500,0,0,0,0,0,0,6000,4000,2000,2000
20200316,3317,尼克森,34.80,35.60,31.60,31.65,-2.35,-6.91,1566000,969,52066300,174000,259000,-85000,0,0,0,0,31000,-31000,-116000
20200316,3322,建舜電,6.05,6.05,5.43,5.43,-0.56,-9.35,198000,75,1118060,0,0,0,0,0,0,0,0,0,0
20200316,3323,加百裕,20.95,21.60,20.25,20.40,-1.50,-6.85,402000,249,8386050,22000,28000,-6000,0,0,0,0,0,0,-6000
20200316,3324,雙鴻,130.00,133.00,116.00,116.00,-12.50,-9.73,6430000,4340,796798500,716000,476000,240000,0,0,0,12000,58000,-46000,194000
20200316,3325,旭品,9.81,10.05,9.81,9.88,+0.39,4.11,162000,62,1612190,0,0,0,0,0,0,0,0,0,0
20200316,3332,幸康,,,,,,0.00,0,0,0,0,0,0,0,0,0,0,0,0,0
20200316,3339,泰谷,3.21,3.21,3.21,3.21,-0.31,-8.81,1000,1,3210,0,0,0,0,0,0,0,0,0,0
20200316,3354,律勝,10.90,11.10,9.90,9.90,-1.00,-9.17,205000,109,2119920,3000,1000,2000,0,0,0,0,0,0,2000
20200316,3360,尚立,12.50,12.50,11.50,11.80,-0.55,-4.45,549000,255,6592000,28000,26000,2000,0,0,0,0,0,0,2000
20200316,3362,先進光,27.55,28.75,24.75,24.75,-2.75,-10.0,639000,409,16830400,141000,58000,83000,0,0,0,0,1000,-1000,82000
20200316,3363,上詮,20.30,20.80,19.20,19.25,-0.95,-4.7,1093000,487,21717000,58000,152000,-94000,0,0,0,0,1000,-1000,-95000
20200316,3372,典範,7.36,8.00,7.36,7.84,-0.15,-1.88,352000,108,2691540,4000,0,4000,0,0,0,0,0,0,4000
20200316,3373,熱映,40.60,43.60,40.60,43.60,+3.95,9.96,1233000,523,52388850,3000,0,3000,0,0,0,0,26000,-26000,-23000
20200316,3374,精材,64.80,65.00,59.90,59.90,-6.60,-9.92,4728000,1577,293437400,185000,144000,41000,0,533000,-533000,130000,0,130000,-362000
20200316,3379,彬台,8.90,8.98,8.70,8.98,+0.08,0.9,23000,11,202880,0,0,0,0,0,0,0,0,0,0
20200316,3388,崇越電,61.10,61.20,59.10,59.10,-1.90,-3.11,233000,150,13948900,0,6000,-6000,0,0,0,0,0,0,-6000
20200316,3390,旭軟,15.00,15.00,13.10,13.10,-1.40,-9.66,453000,152,6317850,28000,0,28000,0,0,0,0,0,0,28000
20200316,3402,漢科,25.65,25.65,25.00,25.10,-0.50,-1.95,255000,161,6425550,6000,12000,-6000,0,0,0,0,0,0,-6000
20200316,3426,台興,29.35,30.15,29.35,30.15,+0.95,3.25,3000,2,88850,0,0,0,0,0,0,0,0,0,0
20200316,3434,哲固,11.85,11.85,11.15,11.15,-0.60,-5.11,33000,13,382500,0,0,0,0,0,0,0,0,0,0
20200316,3438,類比科,26.90,27.50,24.25,24.25,-2.65,-9.85,848000,547,21604500,65000,73000,-8000,0,0,0,12000,2000,10000,2000
20200316,3441,聯一光,22.40,23.00,22.00,22.00,-0.30,-1.35,187000,117,4178800,0,2000,-2000,0,0,0,0,0,0,-2000
20200316,3444,利機,40.90,41.20,39.10,39.20,-0.30,-0.76,1729000,1123,69514700,0,47000,-47000,0,0,0,0,0,0,-47000
20200316,3455,由田,42.50,42.75,39.30,39.35,-2.70,-6.42,592000,398,24038300,51000,39000,12000,0,0,0,2000,1000,1000,13000
20200316,3465,進泰電子,31.50,32.00,30.90,30.90,+0.10,0.32,36000,14,1134700,0,0,0,0,0,0,0,0,0,0
20200316,3466,致振,15.40,16.35,14.45,14.55,-1.50,-9.35,58000,35,869550,0,1000,-1000,0,0,0,0,0,0,-1000
20200316,3479,安勤,60.50,63.90,59.00,59.00,-1.50,-2.48,1479000,862,89931700,34000,355000,-321000,0,0,0,29000,27000,2000,-319000
20200316,3483,力致,39.50,40.50,36.25,36.40,-1.55,-4.08,2090000,1442,79808500,435000,446000,-11000,0,0,0,9000,7000,2000,-9000
20200316,3484,崧騰,23.60,23.65,22.90,22.90,-0.60,-2.55,142000,81,3319900,1000,4000,-3000,0,0,0,0,0,0,-3000
20200316,3489,森寶,9.06,9.31,8.90,9.00,-0.03,-0.33,166000,105,1505530,0,0,0,0,0,0,0,0,0,0
20200316,3490,單井,15.80,16.15,15.30,15.65,-0.25,-1.57,305000,167,4783050,4000,30000,-26000,0,0,0,0,0,0,-26000
20200316,3491,昇達科,67.00,67.30,64.50,64.50,-2.30,-3.44,580000,439,38068900,22000,119000,-97000,0,0,0,0,11000,-11000,-108000
20200316,3492,長盛,13.85,14.40,13.85,13.85,0.00,0.0,36000,17,500500,0,8000,-8000,0,0,0,0,0,0,-8000
20200316,3498,陽程,22.70,23.40,22.20,22.30,-0.40,-1.76,325000,153,7360600,8000,49000,-41000,0,0,0,0,0,0,-41000
20200316,3499,環天科,9.72,10.10,9.67,9.82,+0.10,1.03,182000,93,1798740,8000,4000,4000,0,0,0,0,0,0,4000
20200316,3508,位速,17.35,17.35,15.25,15.50,-1.40,-8.28,1030000,496,16609900,127000,72000,55000,0,0,0,5000,0,5000,60000
20200316,3511,矽瑪,23.60,24.50,22.20,22.25,-2.40,-9.74,1119000,568,26008400,318000,63000,255000,0,0,0,0,0,0,255000
20200316,3512,皇龍,24.15,26.30,24.15,25.80,0.00,0.0,52000,28,1321050,0,0,0,0,0,0,0,0,0,0
20200316,3516,亞帝歐,10.50,10.55,10.05,10.15,-0.30,-2.87,124000,28,1277200,0,1000,-1000,0,0,0,0,0,0,-1000
20200316,3520,振維,8.49,8.49,8.00,8.34,0.00,0.0,134000,59,1088170,0,14000,-14000,0,0,0,0,1000,-1000,-15000
20200316,3521,鴻翊,11.80,12.15,11.00,11.00,-0.95,-7.95,199000,86,2307200,0,12000,-12000,0,0,0,1000,2000,-1000,-13000
20200316,3522,御頂,14.80,15.05,14.05,15.05,0.00,0.0,170000,105,2490400,0,0,0,0,0,0,2000,0,2000,2000
20200316,3523,迎輝,10.50,10.50,10.10,10.10,-0.05,-0.49,42000,21,430850,0,0,0,0,0,0,4000,0,4000,4000
20200316,3526,凡甲,73.10,75.20,70.90,71.50,-0.90,-1.24,4690000,3232,343716800,263000,310000,-47000,0,0,0,161000,239000,-78000,-125000
20200316,3527,聚積,85.00,86.00,79.70,80.80,-5.30,-6.16,902000,715,74519900,136000,116000,20000,100000,0,100000,0,4000,-4000,116000
20200316,3529,力旺,232.00,237.50,211.50,218.00,-17.00,-7.23,1089000,869,242956500,106000,33000,73000,5000,189000,-184000,218000,189000,29000,-82000
20200316,3531,先益,20.95,20.95,20.60,20.60,-0.85,-3.96,31000,20,642750,0,3000,-3000,0,0,0,0,0,0,-3000
20200316,3537,堡達,28.20,28.20,27.05,27.20,-0.40,-1.45,327000,161,9034600,5000,33000,-28000,0,0,0,0,0,0,-28000
20200316,3540,曜越,20.00,20.00,18.90,19.50,-0.15,-0.76,344000,187,6790950,0,24000,-24000,0,0,0,0,0,0,-24000
20200316,3541,西柏,66.90,67.20,64.00,64.00,-2.40,-3.61,281000,208,18431900,3000,33000,-30000,0,0,0,0,0,0,-30000
20200316,3546,宇峻,81.30,88.50,76.90,77.50,-3.00,-3.73,3427000,2565,282144900,630000,294000,336000,0,0,0,35000,74000,-39000,297000
20200316,3548,兆利,70.40,70.60,67.00,67.00,-3.00,-4.29,972000,621,66318600,16000,440000,-424000,0,0,0,2000,16000,-14000,-438000
20200316,3551,世禾,34.00,35.00,32.60,32.60,-1.40,-4.12,560000,318,18853750,34000,184000,-150000,0,0,0,16000,2000,14000,-136000
20200316,3552,同致,42.00,42.85,37.80,37.80,-4.20,-10.0,1375000,921,54047600,92000,63000,29000,0,0,0,3000,10000,-7000,22000
20200316,3555,重鵬,27.20,27.20,24.55,24.55,-1.85,-7.01,2000,2,51750,0,0,0,0,0,0,0,0,0,0
20200316,3556,禾瑞亞,43.10,43.65,41.75,41.80,-1.30,-3.02,276000,201,11709400,0,102000,-102000,0,0,0,0,0,0,-102000
20200316,3558,神準,94.20,94.20,90.00,90.00,-4.90,-5.16,267000,217,24551700,6000,93000,-87000,0,0,0,0,1000,-1000,-88000
20200316,3564,其陽,25.25,25.90,24.20,24.20,-1.50,-5.84,50000,35,1224000,0,2000,-2000,0,0,0,1000,0,1000,-1000
20200316,3567,逸昌,21.40,21.95,20.85,20.85,-0.65,-3.02,126000,70,2662150,0,6000,-6000,0,0,0,0,0,0,-6000
20200316,3570,大塚,88.00,88.00,82.00,82.00,-6.10,-6.92,85000,78,7166200,0,4000,-4000,0,0,0,2000,0,2000,-2000
20200316,3577,泓格,29.60,31.40,29.30,29.30,-0.20,-0.68,40000,33,1196350,0,0,0,0,0,0,0,0,0,0
20200316,3580,友威科,19.00,19.40,17.80,18.00,-0.80,-4.26,259000,151,4837500,7000,24000,-17000,0,0,0,0,0,0,-17000
20200316,3581,博磊,14.95,14.95,13.05,13.15,-1.30,-9.0,115000,52,1543950,0,0,0,0,0,0,4000,0,4000,4000
20200316,3587,閎康,59.00,59.60,55.00,55.80,-3.10,-5.26,481000,379,27601600,12000,80000,-68000,0,0,0,0,6000,-6000,-74000
20200316,3594,磐儀,20.35,20.35,19.35,19.35,-0.55,-2.76,104000,68,2049800,0,0,0,0,0,0,0,0,0,0
20200316,3597,映興,14.10,15.10,14.00,15.10,-0.35,-2.27,206000,123,2994100,4000,1000,3000,0,0,0,0,18886,-18886,-15886
20200316,3609,東林,23.55,24.00,23.15,23.40,-0.05,-0.21,309000,190,7278150,94000,0,94000,0,0,0,0,0,0,94000
20200316,3611,鼎翰,179.00,179.50,175.00,175.00,-7.50,-4.11,150000,126,26587000,1000,59000,-58000,0,0,0,0,0,0,-58000
20200316,3615,安可,12.00,12.40,11.25,12.10,-0.40,-3.2,293000,128,3478600,4000,10000,-6000,0,0,0,4000,8000,-4000,-10000
20200316,3623,富晶通,16.40,16.40,16.00,16.00,-0.40,-2.44,50000,40,804500,0,2000,-2000,0,0,0,0,0,0,-2000
20200316,3624,光頡,22.25,22.80,20.35,20.35,-2.20,-9.76,1969000,1034,42711850,315000,213000,102000,0,0,0,2000,29000,-27000,75000
20200316,3625,西勝,13.15,13.15,12.40,12.55,+0.05,0.4,278000,145,3504650,47000,22000,25000,0,0,0,0,26000,-26000,-1000
20200316,3628,盈正,27.20,27.80,26.50,26.90,-0.20,-0.74,38000,25,1028850,0,0,0,0,0,0,0,0,0,0
20200316,3629,地心引力,64.00,64.00,64.00,64.00,0.00,0.0,1000,1,64000,0,0,0,0,0,0,0,0,0,0
20200316,3630,新鉅科,51.40,52.80,47.75,48.05,-1.45,-2.93,4177000,2537,209798650,212000,513000,-301000,0,0,0,25000,15000,10000,-291000
20200316,3631,晟楠,45.60,45.60,40.30,40.80,-2.70,-6.21,245000,159,10345550,1000,4000,-3000,0,0,0,0,0,0,-3000
20200316,3632,研勤,8.50,8.50,7.80,7.80,-0.05,-0.64,78000,65,621200,0,0,0,0,0,0,0,0,0,0
20200316,3642,駿熠電,17.40,17.40,16.65,16.85,-1.05,-5.87,142000,77,2394700,0,2000,-2000,0,0,0,4000,0,4000,2000
20200316,3646,艾恩特,14.20,14.20,13.60,13.95,-1.15,-7.62,78000,59,1080900,0,0,0,0,0,0,1000,0,1000,1000
20200316,3652,精聯,15.50,15.50,14.30,14.30,-1.55,-9.78,114000,63,1671850,0,0,0,0,0,0,1000,0,1000,1000
20200316,3663,鑫科,16.60,16.60,15.50,15.50,-1.10,-6.63,119000,49,1906150,3000,0,3000,0,0,0,5000,0,5000,8000
20200316,3664,安瑞-KY,9.73,9.73,9.50,9.50,+0.17,1.82,7000,2,66960,0,0,0,0,0,0,0,0,0,0
20200316,3666,光耀,13.60,14.10,13.00,13.50,0.00,0.0,113000,48,1516850,0,0,0,0,0,0,1000,3000,-2000,-2000
20200316,3672,康聯訊,13.00,13.45,12.75,12.75,-0.95,-6.93,12000,9,154950,0,0,0,0,0,0,0,0,0,0
20200316,3675,德微,38.00,38.00,36.20,36.20,-1.80,-4.74,28000,24,1033850,0,0,0,0,0,0,1000,0,1000,1000
20200316,3680,家登,129.50,135.00,117.00,117.00,-12.50,-9.65,3011000,2156,372810500,345000,145000,200000,0,0,0,0,5000,-5000,195000
20200316,3684,榮昌,34.10,34.10,32.95,33.10,-1.00,-2.93,49000,38,1632250,1000,5000,-4000,0,0,0,0,0,0,-4000
20200316,3685,元創精密,17.40,19.05,17.15,17.15,-1.85,-9.74,171000,74,3017000,0,0,0,0,0,0,1000,0,1000,1000
20200316,3687,歐買尬,29.10,30.50,29.10,29.40,+0.35,1.2,241000,171,7177500,35000,76000,-41000,0,0,0,0,12000,-12000,-53000
20200316,3689,湧德,19.50,19.90,18.65,18.65,-0.85,-4.36,117000,69,2242550,4000,20000,-16000,0,0,0,0,1000,-1000,-17000
20200316,3691,碩禾,94.60,96.20,85.30,85.30,-9.40,-9.93,653000,529,58396200,53000,79000,-26000,0,0,0,0,32000,-32000,-58000
20200316,3693,營邦,29.40,31.30,28.80,28.80,-2.50,-7.99,62000,45,1866150,0,0,0,0,0,0,0,0,0,0
20200316,3707,漢磊,26.55,27.70,25.40,25.40,-1.40,-5.22,16108000,8101,430832400,1237000,403000,834000,0,0,0,52000,41000,11000,845000
20200316,3709,鑫聯大投控,19.20,19.20,19.20,19.20,-0.30,-1.54,2000,2,38400,0,0,0,0,0,0,0,0,0,0
20200316,3710,連展投控,5.16,5.26,5.10,5.20,+0.19,3.79,1055000,332,5443180,200000,30000,170000,0,0,0,25000,45000,-20000,150000
20200316,3713,新晶投控,12.00,12.95,11.90,12.50,+0.70,5.93,141000,55,1762000,0,0,0,0,0,0,0,0,0,0
20200316,4102,永日,18.70,20.55,18.65,20.55,+1.85,9.89,1944000,678,39372200,2000,0,2000,0,0,0,1000,9000,-8000,-6000
20200316,4105,東洋,65.30,65.30,63.10,63.30,-1.40,-2.16,613000,415,39505000,32000,132000,-100000,0,0,0,0,6000,-6000,-106000
20200316,4107,邦特,104.00,104.00,96.00,96.10,-8.40,-8.04,778000,663,76905400,37000,228000,-191000,0,0,0,0,20000,-20000,-211000
20200316,4109,加捷生醫,14.25,14.30,13.25,13.25,-1.45,-9.86,1176000,408,15731100,9000,1000,8000,0,0,0,0,0,0,8000
20200316,4111,濟生,22.20,23.25,22.20,23.10,+1.00,4.52,243000,192,5548050,19000,2000,17000,0,0,0,0,5000,-5000,12000
20200316,4113,聯上,11.75,11.80,11.45,11.55,+0.20,1.76,1084000,352,12609950,101000,110000,-9000,0,0,0,0,0,0,-9000
20200316,4114,健喬,19.55,19.70,19.05,19.10,-0.45,-2.3,630000,344,12226800,60000,74000,-14000,0,0,0,0,0,0,-14000
20200316,4116,明基醫,28.80,29.35,27.50,27.60,-0.95,-3.33,82000,60,2323100,0,0,0,0,0,0,0,0,0,0
20200316,4120,友華,44.00,44.00,42.60,42.75,-1.15,-2.62,107000,67,4616400,0,11000,-11000,0,0,0,0,0,0,-11000
20200316,4121,優盛,14.10,15.70,14.10,14.80,+0.35,2.42,3158000,1539,47193300,2000,0,2000,0,0,0,0,25000,-25000,-23000
20200316,4123,晟德,44.80,44.80,40.70,41.45,-2.15,-4.93,1648000,1114,70296300,80000,237000,-157000,0,0,0,15000,37000,-22000,-179000
20200316,4126,太醫,66.30,69.00,65.00,65.00,-3.00,-4.41,515000,409,34149600,49000,139000,-90000,0,0,0,0,0,0,-90000
20200316,4127,天良,9.60,9.94,9.55,9.86,+0.35,3.68,328000,214,3190640,12000,0,12000,0,0,0,0,6000,-6000,6000
20200316,4128,中天,13.00,13.20,12.70,12.80,-0.40,-3.03,1243000,424,15954200,0,43000,-43000,0,0,0,0,0,0,-43000
20200316,4129,聯合,31.30,31.50,28.70,28.75,-2.55,-8.15,751000,457,21988900,31000,20000,11000,0,541000,-541000,0,0,0,-530000
20200316,4129A,聯合甲特,49.80,49.80,48.00,48.05,-1.75,-3.51,151000,83,7404600,0,0,0,0,0,0,0,0,0,0
20200316,4130,健亞,20.75,21.05,20.20,20.20,-0.60,-2.88,347000,151,7132950,1000,40000,-39000,0,0,0,1000,0,1000,-38000
20200316,4131,晶宇,4.76,4.89,4.57,4.57,-0.50,-9.86,37000,20,172090,0,0,0,0,0,0,0,0,0,0
20200316,4138,曜亞,45.30,46.65,45.30,45.45,+0.15,0.33,64000,53,2921000,0,5000,-5000,0,0,0,0,0,0,-5000
20200316,4139,馬光-KY,32.10,33.40,31.90,32.95,+1.00,3.13,74000,64,2440500,0,0,0,0,0,0,0,0,0,0
20200316,4147,中裕,70.90,73.50,67.50,67.80,-0.30,-0.44,2052000,1472,143895000,281000,83000,198000,0,0,0,0,0,0,198000
20200316,4152,台微體,61.30,61.50,61.00,61.40,+0.20,0.33,62000,41,3797900,3000,0,3000,0,0,0,0,0,0,3000
20200316,4153,鈺緯,20.20,20.20,18.10,18.10,-2.00,-9.95,221000,138,4200600,0,4000,-4000,0,0,0,0,0,0,-4000
20200316,4154,康樂-KY,26.50,27.05,26.10,26.65,-0.05,-0.19,14000,11,370200,0,0,0,0,0,0,0,0,0,0
20200316,4157,太景*-KY,16.10,16.40,14.60,14.65,-1.55,-9.57,6109000,2242,94660950,1115000,154000,961000,0,0,0,42000,233000,-191000,770000
20200316,4160,創源,26.95,26.95,25.35,26.20,+0.85,3.35,32000,24,832900,0,6000,-6000,0,0,0,0,0,0,-6000
20200316,4161,聿新科,29.10,29.65,28.35,28.35,-0.70,-2.41,138000,104,3983750,7000,35000,-28000,0,0,0,0,0,0,-28000
20200316,4162,智擎,47.50,48.75,44.35,44.35,-3.15,-6.63,819000,524,38081650,52000,181000,-129000,0,0,0,2000,0,2000,-127000
20200316,4163,鐿鈦,101.50,102.50,99.20,99.30,-3.20,-3.12,303000,202,30409100,1000,60000,-59000,0,0,0,0,0,0,-59000
20200316,4167,展旺,23.20,25.10,23.20,23.45,+0.30,1.3,5546000,2883,133795050,40000,635000,-595000,0,0,0,30000,0,30000,-565000
20200316,4168,醣聯,15.95,16.15,14.70,14.85,-1.10,-6.9,229000,109,3496450,2000,2000,0,0,0,0,1000,0,1000,1000
20200316,4171,瑞基,63.50,69.80,63.50,69.80,+6.30,9.92,709000,529,47974900,0,4000,-4000,0,0,0,1000,7000,-6000,-10000
20200316,4173,久裕,18.35,18.55,17.80,17.85,-0.65,-3.51,678000,376,12287950,7000,27000,-20000,0,0,0,0,0,0,-20000
20200316,4174,浩鼎,88.30,88.60,79.80,79.80,-8.80,-9.93,931000,652,77107800,47000,46000,1000,0,0,0,0,0,0,1000
20200316,4175,杏一,66.80,67.40,66.50,66.50,-0.50,-0.75,97000,83,6485600,7000,8000,-1000,0,0,0,0,0,0,-1000
20200316,4183,福永生技,16.00,16.00,16.00,16.00,-0.20,-1.23,3000,3,48000,0,0,0,0,0,0,0,0,0,0
20200316,4188,安克,14.65,15.10,14.20,14.20,-1.55,-9.84,220000,117,3192550,0,5000,-5000,0,0,0,0,0,0,-5000
20200316,4192,杏國,22.20,22.90,21.80,21.80,-1.80,-7.63,70000,46,1556100,0,3000,-3000,0,0,0,0,0,0,-3000
20200316,4198,環瑞醫,3.53,3.58,3.39,3.42,-0.31,-8.31,76000,30,266330,0,0,0,0,0,0,0,0,0,0
20200316,4205,中華食,78.00,78.00,75.10,75.50,-2.50,-3.21,173000,158,13223800,0,7000,-7000,0,0,0,0,0,0,-7000
20200316,4207,環泰,8.73,8.73,8.50,8.60,+0.18,2.14,122000,39,1046040,0,0,0,0,0,0,0,0,0,0
20200316,4303,信立,18.45,18.80,18.45,18.80,0.00,0.0,13000,11,242600,3000,0,3000,0,0,0,0,1000,-1000,2000
20200316,4304,勝昱,7.47,7.47,6.26,6.94,-0.01,-0.14,15000,7,95790,0,0,0,0,0,0,0,0,0,0
20200316,4305,世坤,32.40,32.45,32.00,32.00,-0.40,-1.23,10000,9,322250,0,0,0,0,0,0,0,0,0,0
20200316,4401,東隆興,30.60,30.60,27.55,27.55,-3.05,-9.97,748000,459,20953700,4000,4000,0,0,44000,-44000,0,1000,-1000,-45000
20200316,4402,福大,3.92,3.98,3.65,3.98,+0.06,1.53,80000,35,305200,7000,1000,6000,0,0,0,0,0,0,6000
20200316,4406,新昕纖,9.02,9.35,9.02,9.30,+0.28,3.1,13000,9,119260,0,0,0,0,0,0,0,0,0,0
20200316,4413,飛寶企業,13.95,13.95,13.05,13.85,-0.65,-4.48,11000,9,148900,0,1000,-1000,0,0,0,0,0,0,-1000
20200316,4416,三圓,77.00,77.00,77.00,77.00,0.00,0.0,2000,1,154000,0,0,0,0,0,0,0,0,0,0
20200316,4417,金洲,30.00,30.00,29.20,29.35,-0.65,-2.17,104000,68,3057550,0,18000,-18000,0,0,0,0,0,0,-18000
20200316,4419,元勝,6.00,6.00,6.00,6.00,+0.20,3.45,5000,3,30000,0,0,0,0,0,0,0,0,0,0
20200316,4420,光明,24.80,24.80,23.00,23.00,-2.00,-8.0,125000,92,2976550,2000,24000,-22000,0,0,0,4000,0,4000,-18000
20200316,4429,聚紡,34.70,34.80,34.00,34.80,+0.05,0.14,67000,41,2306700,0,0,0,0,0,0,0,0,0,0
20200316,4430,耀億,23.45,23.70,22.90,22.90,-2.50,-9.84,1148000,473,26600100,7000,4000,3000,0,0,0,0,0,0,3000
20200316,4432,銘旺實,12.85,13.05,12.10,12.10,-1.30,-9.7,212000,78,2675300,0,1000,-1000,0,0,0,0,0,0,-1000
20200316,4433,興采,24.85,26.55,23.50,23.50,-1.35,-5.43,250000,170,6131650,7000,12000,-5000,0,0,0,4000,3000,1000,-4000
20200316,4502,健信,44.05,44.05,41.80,41.80,-1.80,-4.13,111000,77,4715950,12000,14000,-2000,0,0,0,0,0,0,-2000
20200316,4503,金雨,18.85,18.90,17.85,18.45,-1.00,-5.14,44000,25,816700,0,4000,-4000,0,0,0,0,0,0,-4000
20200316,4506,崇友,56.80,56.80,53.60,54.70,-2.10,-3.7,164000,127,8977900,67000,42000,25000,0,0,0,15000,0,15000,40000
20200316,4510,高鋒,8.21,8.21,8.00,8.10,+0.10,1.25,129000,51,1041000,0,5000,-5000,0,0,0,0,0,0,-5000
20200316,4513,福裕,8.12,8.13,7.54,7.54,+0.14,1.89,416000,45,3335410,0,0,0,0,0,0,0,1000,-1000,-1000
20200316,4523,永彰,22.90,22.90,21.20,21.25,-0.35,-1.62,47000,31,1032800,0,3000,-3000,0,0,0,0,0,0,-3000
20200316,4527,方土霖,22.20,22.20,21.70,22.20,0.00,0.0,232000,69,5127800,0,0,0,0,0,0,0,0,0,0
20200316,4528,江興鍛,36.90,37.20,33.80,36.00,-0.60,-1.64,355000,223,12464650,7000,11000,-4000,0,57000,-57000,0,0,0,-61000
20200316,4529,淳紳,9.80,9.80,8.81,8.81,-0.97,-9.92,176000,112,1623080,0,0,0,0,0,0,1000,0,1000,1000
20200316,4530,宏易,10.10,10.15,10.10,10.15,+0.05,0.5,20000,7,202650,0,0,0,0,0,0,0,0,0,0
20200316,4533,協易機,9.61,10.50,9.52,10.40,+0.40,4.0,271000,114,2683630,0,7000,-7000,0,0,0,6000,6000,0,-7000
20200316,4534,慶騰,6.20,6.20,5.72,5.89,-0.02,-0.34,128000,45,759290,0,0,0,0,0,0,0,0,0,0
20200316,4535,至興,23.40,23.70,23.40,23.40,-0.10,-0.43,20000,18,469600,0,3000,-3000,0,0,0,0,0,0,-3000
20200316,4538,大詠城,14.00,14.00,14.00,14.00,-0.25,-1.75,20000,6,280000,0,0,0,0,0,0,0,0,0,0
20200316,4541,晟田,17.00,17.90,16.60,16.85,-0.90,-5.07,289000,166,4942800,0,2000,-2000,0,0,0,3000,3000,0,-2000
20200316,4542,科嶠,20.75,22.50,20.65,22.05,-0.55,-2.43,24000,15,506000,0,0,0,0,0,0,0,0,0,0
20200316,4543,萬在,13.85,13.85,13.40,13.40,-1.45,-9.76,103000,52,1388250,2000,2000,0,0,0,0,0,0,0,0
20200316,4549,桓達,68.20,68.20,66.00,67.40,-1.20,-1.75,47000,38,3130300,2000,0,2000,0,0,0,0,0,0,2000
20200316,4550,長佳,26.20,27.00,25.35,25.60,-0.20,-0.78,293000,160,7642350,11000,10000,1000,0,0,0,0,0,0,1000
20200316,4554,橙的,16.75,16.95,15.50,15.50,-1.25,-7.46,18000,14,295150,0,0,0,0,0,0,1000,2000,-1000,-1000
20200316,4556,旭然,29.50,30.50,29.00,29.50,-1.35,-4.38,43000,33,1264400,0,0,0,0,0,0,0,0,0,0
20200316,4561,健椿,18.90,19.90,18.90,19.90,-0.90,-4.33,58000,44,1128800,6000,4000,2000,0,0,0,0,0,0,2000
20200316,4563,百德,41.00,41.00,39.50,39.60,-1.50,-3.65,83000,63,3312200,5000,0,5000,0,0,0,0,0,0,5000
20200316,4568,科際精密,46.00,47.50,46.00,46.00,-1.50,-3.16,17000,16,784700,0,0,0,0,0,0,1000,0,1000,1000
20200316,4580,捷流閥業,80.00,80.90,79.00,79.00,-0.20,-0.25,48000,48,3831700,0,2000,-2000,0,0,0,0,3000,-3000,-5000
20200316,4609,唐鋒,8.68,8.68,8.31,8.31,-0.59,-6.63,24000,9,204140,0,1000,-1000,0,0,0,0,0,0,-1000
20200316,4702,中美實,9.50,9.50,9.00,9.06,-0.89,-8.94,31000,17,282930,0,0,0,0,0,0,0,0,0,0
20200316,4706,大恭,16.65,16.65,15.60,15.65,-1.10,-6.57,196000,87,3112050,3000,0,3000,0,0,0,0,0,0,3000
20200316,4707,磐亞,12.95,13.75,12.95,13.05,+0.25,1.95,9369000,3499,125129300,897000,456000,441000,0,0,0,1000,0,1000,442000
20200316,4711,永純,12.10,12.10,11.60,11.60,-0.50,-4.13,46000,23,550100,0,0,0,0,0,0,1000,0,1000,1000
20200316,4712,南璋,8.25,8.25,7.80,8.00,-0.25,-3.03,51000,20,407670,2000,0,2000,0,0,0,1000,1000,0,2000
20200316,4714,永捷,12.30,12.40,12.00,12.10,-0.15,-1.22,428000,212,5208200,23000,75000,-52000,0,0,0,3000,12000,-9000,-61000
20200316,4716,大立,14.25,15.25,14.25,14.60,+0.15,1.04,341000,57,4927050,0,0,0,0,0,0,0,0,0,0
20200316,4721,美琪瑪,42.15,42.40,38.80,38.90,-3.25,-7.71,523000,415,21220800,53000,79000,-26000,0,0,0,0,0,0,-26000
20200316,4726,永昕,19.00,19.00,17.40,17.40,-0.65,-3.6,264000,137,4751250,0,11000,-11000,0,0,0,0,8000,-8000,-19000
20200316,4728,雙美,61.50,62.00,58.10,59.50,-2.00,-3.25,282000,206,16745000,2000,146000,-144000,0,0,0,14000,27000,-13000,-157000
20200316,4729,熒茂,8.51,8.60,8.50,8.51,-0.39,-4.38,15000,11,127790,0,0,0,0,0,0,1000,0,1000,1000
20200316,4735,豪展,50.60,53.80,50.40,51.10,+1.60,3.23,2833000,1947,148108600,470000,146000,324000,15000,0,15000,0,0,0,339000
20200316,4736,泰博,140.50,149.00,140.00,143.00,+3.00,2.14,2310000,1799,334501000,389000,80000,309000,141000,0,141000,128000,149000,-21000,429000
20200316,4741,泓瀚,24.90,26.20,24.20,24.20,-0.70,-2.81,60000,21,1489000,0,0,0,0,0,0,1000,0,1000,1000
20200316,4743,合一,26.70,26.80,25.00,25.40,-1.10,-4.15,644000,389,16604100,0,107000,-107000,0,0,0,0,0,0,-107000
20200316,4744,皇將,33.90,33.90,30.95,32.40,-1.60,-4.71,660000,381,21190800,10000,144000,-134000,0,0,0,16000,12000,4000,-130000
20200316,4745,合富-KY,30.95,30.95,29.45,29.50,-0.80,-2.64,179000,103,5351200,3000,3000,0,0,0,0,0,0,0,0
20200316,4747,強生,37.35,38.15,37.05,37.55,+0.25,0.67,41000,28,1537250,0,0,0,0,0,0,0,0,0,0
20200316,4754,國碳科,52.00,52.00,47.00,47.00,-1.00,-2.08,17000,10,832500,0,0,0,0,0,0,0,0,0,0
20200316,4760,勤凱,47.90,49.25,47.20,47.20,-0.70,-1.46,272000,220,13125750,43000,3000,40000,0,0,0,0,0,0,40000
20200316,4767,誠泰科技,20.30,20.30,20.30,20.30,-0.65,-3.1,2000,2,40600,0,0,0,0,0,0,0,0,0,0
20200316,4803,VHQ-KY,82.00,83.00,73.70,73.80,-7.90,-9.67,776000,600,60217100,60000,158000,-98000,0,0,0,52000,128000,-76000,-174000
20200316,4804,大略-KY,7.58,7.58,6.98,6.98,-0.60,-7.92,18000,14,130780,0,0,0,0,0,0,0,0,0,0
20200316,4806,昇華,7.50,8.23,7.50,8.15,+0.65,8.67,10000,10,80350,0,0,0,0,0,0,0,0,0,0
20200316,4903,聯光通,13.60,14.05,13.20,13.25,-0.90,-6.36,442000,251,6030900,2000,36000,-34000,0,0,0,0,0,0,-34000
20200316,4905,台聯電,46.85,46.85,44.45,44.45,-4.85,-9.84,24000,15,1091650,0,0,0,0,0,0,0,0,0,0
20200316,4907,富宇,20.60,20.90,20.40,20.55,+0.15,0.74,52000,38,1070100,0,10000,-10000,0,0,0,0,0,0,-10000
20200316,4908,前鼎,29.85,30.40,27.00,27.65,-1.35,-4.66,1664000,1026,48656850,141000,270000,-129000,0,0,0,21000,23000,-2000,-131000
20200316,4909,新復興,13.80,14.25,13.00,13.00,-0.80,-5.8,267000,117,3624400,0,0,0,0,0,0,6000,5000,1000,1000
20200316,4911,德英,28.80,28.80,28.80,28.80,+2.00,7.46,1000,1,28800,0,0,0,0,0,0,0,0,0,0
20200316,4924,欣厚-KY,7.01,7.01,6.70,6.70,-0.24,-3.46,10000,8,68870,5000,5000,0,0,0,0,0,0,0,0
20200316,4931,新盛力,24.00,24.95,21.60,21.60,-2.40,-10.0,570000,335,13001450,64000,8000,56000,0,0,0,0,0,0,56000
20200316,4933,友輝,18.20,19.20,18.20,18.70,0.00,0.0,235000,117,4398050,3000,31000,-28000,0,0,0,0,0,0,-28000
20200316,4939,亞電,10.15,10.35,9.87,9.95,-0.40,-3.86,719000,310,7201020,46000,17000,29000,0,0,0,0,0,0,29000
20200316,4944,兆遠,14.35,14.80,13.15,13.15,-1.45,-9.93,928000,419,12733050,9000,90000,-81000,0,0,0,0,0,0,-81000
20200316,4946,辣椒,22.25,22.25,21.00,21.00,+0.75,3.7,170000,118,3634700,0,1000,-1000,0,0,0,0,0,0,-1000
20200316,4947,昂寶-KY,220.50,220.50,218.00,218.50,-1.50,-0.68,298000,222,65290000,13000,38000,-25000,0,0,0,0,50000,-50000,-75000
20200316,4950,牧東,6.42,6.42,6.38,6.38,-0.55,-7.94,11000,3,70470,0,0,0,0,0,0,0,0,0,0
20200316,4953,緯軟,67.60,68.30,61.20,61.40,-6.30,-9.31,1211000,847,79177200,144000,120000,24000,169000,164000,5000,0,2000,-2000,27000
20200316,4966,譜瑞-KY,581.00,626.00,580.00,585.00,-5.00,-0.85,2254000,2054,1371093000,250000,627570,-377570,16000,81000,-65000,18000,44000,-26000,-468570
20200316,4971,IET-KY,41.00,41.15,37.60,37.80,-2.15,-5.38,280000,179,10852300,57000,38000,19000,0,0,0,0,0,0,19000
20200316,4972,湯石照明,28.30,29.00,28.20,28.30,+0.10,0.35,126000,69,3599100,1000,8000,-7000,0,0,0,1000,1000,0,-7000
20200316,4973,廣穎,24.85,25.25,22.25,22.50,-2.05,-8.35,2055000,1160,48927800,435000,129000,306000,0,0,0,5000,0,5000,311000
20200316,4974,亞泰,48.00,48.25,44.40,44.50,-2.70,-5.72,941000,699,43460000,104000,193000,-89000,0,32000,-32000,0,32000,-32000,-153000
20200316,4979,華星光,15.30,16.50,14.05,14.05,-1.55,-9.94,3309000,1282,48038550,115000,115000,0,0,0,0,7000,0,7000,7000
20200316,4987,科誠,52.00,52.00,51.50,51.50,-1.00,-1.9,30000,28,1552000,0,0,0,0,0,0,0,0,0,0
20200316,4991,環宇-KY,50.10,52.00,45.20,45.20,-4.80,-9.6,1310000,906,62966150,219000,146000,73000,0,180000,-180000,3000,27000,-24000,-131000
20200316,4995,晶達,42.25,42.95,42.00,42.00,-0.30,-0.71,23000,22,974200,0,7000,-7000,0,0,0,0,0,0,-7000
20200316,5009,榮剛,14.70,14.70,14.15,14.25,-0.70,-4.68,1492000,430,21437600,9000,143000,-134000,0,0,0,0,0,0,-134000
20200316,5011,久陽,,,,,,0.00,0,0,0,0,0,0,0,0,0,0,0,0,0
20200316,5013,強新,24.00,24.10,23.10,23.95,-0.05,-0.21,65000,28,1554150,0,0,0,0,0,0,0,0,0,0
20200316,5014,建錩,6.84,7.08,6.60,6.60,-0.24,-3.51,452000,308,3039160,21000,21000,0,0,0,0,0,0,0,0
20200316,5015,華祺,31.70,31.70,30.55,30.60,-1.40,-4.38,86000,60,2636900,0,0,0,0,0,0,0,0,0,0
20200316,5016,松和,27.00,27.00,26.10,26.30,-0.20,-0.75,98000,30,2595150,0,7000,-7000,0,0,0,0,0,0,-7000
20200316,5102,富強,14.50,14.50,14.45,14.45,-0.05,-0.34,32000,17,463800,0,0,0,0,0,0,0,0,0,0
20200316,5201,凱衛,27.75,27.85,26.60,26.90,-0.85,-3.06,72000,49,1954050,3000,6000,-3000,0,0,0,1000,2000,-1000,-4000
20200316,5202,力新,11.20,12.00,10.80,12.00,+0.05,0.42,44000,30,489300,1000,0,1000,0,0,0,0,0,0,1000
20200316,5205,中茂,,,,,,0.00,0,0,0,0,0,0,0,0,0,0,0,0,0
20200316,5206,坤悅,13.85,14.00,13.45,13.70,0.00,0.0,339000,165,4686700,52000,51000,1000,0,0,0,0,0,0,1000
20200316,5209,新鼎,49.60,49.65,48.60,48.80,-2.20,-4.31,77000,60,3776750,0,0,0,0,0,0,0,0,0,0
20200316,5210,寶碩,5.05,5.20,4.99,4.99,0.00,0.0,76000,39,383320,0,7000,-7000,0,0,0,0,0,0,-7000
20200316,5211,蒙恬,13.75,13.75,12.65,12.65,-0.65,-4.89,41000,17,536100,0,1000,-1000,0,0,0,0,1000,-1000,-2000
20200316,5212,凌網,51.50,51.90,48.50,49.05,-2.95,-5.67,217000,172,10866000,4000,17000,-13000,0,0,0,15000,0,15000,2000
20200316,5213,亞昕,15.15,15.15,14.65,14.95,-0.25,-1.64,361000,185,5363900,21000,10000,11000,0,0,0,0,2000,-2000,9000
20200316,5220,萬達光電,23.70,23.70,22.85,22.85,-0.65,-2.77,74000,53,1703600,0,0,0,0,0,0,5000,0,5000,5000
20200316,5223,安力-KY,28.00,28.00,26.40,26.45,-1.30,-4.68,56000,44,1514400,0,12000,-12000,0,0,0,0,0,0,-12000
20200316,5227,立凱-KY,10.00,10.15,9.60,9.60,-0.20,-2.04,873000,388,8596300,31000,140000,-109000,0,0,0,0,0,0,-109000
20200316,5230,雷笛克光學,19.20,20.50,18.80,19.15,-0.80,-4.01,139000,87,2674800,0,0,0,0,0,0,0,0,0,0
20200316,5245,智晶,32.00,33.90,29.35,29.35,-2.15,-6.83,830000,587,26175350,10000,116000,-106000,0,0,0,4000,0,4000,-102000
20200316,5251,天鉞電,9.55,9.70,9.50,9.51,+0.01,0.11,56000,23,537810,0,1000,-1000,0,0,0,0,0,0,-1000
20200316,5263,智崴,113.00,115.00,106.50,106.50,-11.50,-9.75,360000,301,38965000,16000,33000,-17000,0,5000,-5000,0,1000,-1000,-23000
20200316,5272,笙科,17.45,17.85,16.00,16.00,-1.75,-9.86,385000,235,6444200,61000,19000,42000,0,0,0,0,2000,-2000,40000
20200316,5274,信驊,977.00,1030.00,908.00,908.00,-92.00,-9.2,572000,528,555581000,243000,250000,-7000,22000,0,22000,19000,20000,-1000,14000
20200316,5276,達輝-KY,8.54,8.54,8.53,8.53,+0.20,2.4,5000,5,42660,0,0,0,0,0,0,0,0,0,0
20200316,5278,尚凡,116.00,118.00,106.00,106.00,-10.00,-8.62,77000,75,8680000,0,6000,-6000,0,0,0,2000,0,2000,-4000
20200316,5281,大峽谷-KY,18.00,18.35,17.80,17.85,-0.55,-2.99,94000,40,1701800,0,5000,-5000,0,0,0,0,0,0,-5000
20200316,5287,數字,195.00,198.00,193.50,194.00,0.00,0.0,77000,71,15045000,19000,32000,-13000,0,0,0,0,0,0,-13000
20200316,5289,宜鼎,158.50,166.00,155.50,157.50,-1.00,-0.63,2026000,1412,324891000,54000,495480,-441480,18000,0,18000,21000,39000,-18000,-441480
20200316,5291,邑昇,19.20,19.20,17.55,17.60,-1.90,-9.74,1311000,587,23594600,118000,6000,112000,0,0,0,0,1000,-1000,111000
20200316,5299,杰力,85.50,86.70,77.80,78.40,-5.90,-7.0,773000,634,63142400,45000,32000,13000,0,165000,-165000,0,2000,-2000,-154000
20200316,5301,寶得利,8.80,8.80,8.36,8.59,-0.35,-3.91,87000,37,750720,0,4000,-4000,0,0,0,0,1000,-1000,-5000
20200316,5302,太欣,5.84,5.84,5.45,5.52,-0.02,-0.36,408000,159,2276910,55000,56000,-1000,0,0,0,0,0,0,-1000
20200316,5304,鼎創達,1.91,1.91,1.89,1.89,-0.21,-10.0,48000,14,90970,0,0,0,0,0,0,0,0,0,0
20200316,5306,桂盟,82.60,82.60,80.00,80.00,-2.60,-3.15,68000,61,5532300,2000,20000,-18000,0,0,0,0,0,0,-18000
20200316,5309,系統電,14.30,14.70,13.35,13.35,-1.15,-7.93,2655000,1032,36789500,1000,552000,-551000,0,0,0,0,0,0,-551000
20200316,5310,天剛,15.30,15.60,13.80,14.70,0.00,0.0,55000,23,782250,0,0,0,0,0,0,0,0,0,0
20200316,5312,寶島科,57.50,57.90,57.00,57.50,-1.00,-1.71,58000,47,3330100,0,0,0,0,0,0,0,0,0,0
20200316,5314,世紀,5.87,5.87,5.12,5.47,-0.21,-3.7,10000,7,52310,0,0,0,0,0,0,0,0,0,0
20200316,5315,光聯,11.95,12.00,11.35,11.75,-0.20,-1.67,582000,232,6732800,6000,49000,-43000,0,0,0,0,0,0,-43000
20200316,5321,友銓,21.70,21.70,19.00,20.00,-0.85,-4.08,53000,41,1048750,1000,1000,0,0,0,0,1000,0,1000,1000
20200316,5324,士開,7.54,7.57,7.35,7.35,-0.22,-2.91,110000,47,821690,0,1000,-1000,0,0,0,0,26000,-26000,-27000
20200316,5328,華容,6.80,6.93,6.21,6.21,-0.49,-7.31,857000,329,5676020,35000,131000,-96000,0,0,0,0,3000,-3000,-99000
20200316,5340,建榮,30.50,31.70,27.25,28.00,-2.15,-7.13,1239000,742,36264200,137000,168000,-31000,0,0,0,3000,243000,-240000,-271000
20200316,5344,立衛,6.71,7.20,6.71,6.75,+0.04,0.6,76000,47,524800,0,1000,-1000,0,0,0,0,0,0,-1000
20200316,5345,天揚,5.19,5.19,4.45,4.98,+0.07,1.43,15000,8,68410,0,0,0,0,0,0,0,0,0,0
20200316,5347,世界,70.30,70.40,66.60,67.00,-3.00,-4.29,6687000,3891,458948600,1329000,3732949,-2403949,0,0,0,74000,129000,-55000,-2458949
20200316,5348,系通,6.70,7.45,6.70,7.45,+0.11,1.5,12000,7,83090,0,0,0,0,0,0,0,0,0,0
20200316,5349,先豐,17.90,18.55,17.10,17.10,-1.85,-9.76,4245000,1896,75633200,97000,249000,-152000,0,0,0,4000,87000,-83000,-235000
20200316,5351,鈺創,5.09,5.15,5.01,5.01,-0.07,-1.38,730000,289,3695230,4000,0,4000,0,0,0,0,0,0,4000
20200316,5353,台林,17.25,17.25,15.55,16.30,+0.45,2.84,114000,60,1838450,0,0,0,0,0,0,2000,2000,0,0
20200316,5355,佳總,4.00,4.00,3.70,3.73,-0.19,-4.85,411000,60,1549490,31000,0,31000,0,0,0,0,0,0,31000
20200316,5356,協益,24.30,24.30,23.75,23.95,-0.15,-0.62,234000,135,5619200,1000,30000,-29000,0,0,0,0,0,0,-29000
20200316,5364,力麗店,13.65,13.95,13.65,13.90,+1.20,9.45,7000,6,96900,0,0,0,0,0,0,0,0,0,0
20200316,5371,中光電,31.30,31.30,29.50,29.75,-0.25,-0.83,1415000,885,42912650,220000,411000,-191000,0,0,0,2000,0,2000,-189000
20200316,5381,合正,3.05,3.08,3.05,3.06,-0.12,-3.77,24000,10,73480,0,0,0,0,0,0,0,0,0,0
20200316,5383,金利,17.15,17.15,15.55,15.60,-1.60,-9.3,60000,34,968450,0,0,0,0,0,0,3000,3000,0,0
20200316,5386,青雲,25.55,26.15,23.15,23.15,-2.05,-8.13,152000,110,3671500,7000,13000,-6000,0,0,0,0,0,0,-6000
20200316,5392,應華,22.65,22.65,20.35,20.35,-2.25,-9.96,993000,548,20925800,54000,51000,3000,0,0,0,0,0,0,3000
20200316,5398,慕康生醫,25.70,27.00,25.50,26.25,+1.70,6.92,232000,103,6123600,1000,0,1000,0,0,0,0,1000,-1000,0
20200316,5403,中菲,42.20,42.95,41.50,41.75,-0.40,-0.95,170000,134,7146550,2000,27000,-25000,0,0,0,0,0,0,-25000
20200316,5410,國眾,16.50,16.95,16.20,16.20,-0.10,-0.61,508000,270,8404650,10000,22000,-12000,0,0,0,0,0,0,-12000
20200316,5425,台半,39.80,40.20,36.00,36.05,-3.95,-9.88,1868000,1173,70642150,103000,597000,-494000,0,0,0,60000,68000,-8000,-502000
20200316,5426,振發,10.10,10.30,10.10,10.30,-0.10,-0.96,98000,32,1003100,3000,0,3000,0,0,0,1000,0,1000,4000
20200316,5432,達威,15.55,15.85,15.20,15.85,+0.50,3.26,66000,48,1021100,0,0,0,0,0,0,0,0,0,0
20200316,5438,東友,12.50,14.00,12.15,13.65,+0.85,6.64,898000,363,11900600,3000,5000,-2000,0,0,0,10000,0,10000,8000
20200316,5439,高技,33.50,33.70,32.10,32.10,-1.00,-3.02,473000,264,15542100,25000,115000,-90000,26000,0,26000,0,0,0,-64000
20200316,5443,均豪,14.30,14.30,13.20,13.20,-0.50,-3.65,822000,340,11280700,130000,34000,96000,0,0,0,6000,20000,-14000,82000
20200316,5450,寶聯通,13.80,13.90,13.20,13.25,-0.35,-2.57,79000,41,1081150,0,3000,-3000,0,0,0,0,0,0,-3000
20200316,5452,佶優,5.12,5.29,4.90,5.08,-0.18,-3.42,250000,78,1267020,0,0,0,0,0,0,0,0,0,0
20200316,5455,昇益,,,,,,0.00,0,0,0,0,0,0,0,0,0,0,0,0,0
20200316,5457,宣德,68.90,69.70,62.30,62.30,-6.90,-9.97,4564000,2677,300701800,517000,1043000,-526000,20000,0,20000,41000,105000,-64000,-570000
20200316,5460,同協,11.30,11.30,10.55,10.60,-0.30,-2.75,129000,46,1371400,0,0,0,0,0,0,0,0,0,0
20200316,5464,霖宏,11.40,11.60,11.30,11.30,-0.10,-0.88,78000,32,893400,0,0,0,0,0,0,0,0,0,0
20200316,5465,富驊,9.60,9.79,8.89,9.25,-0.12,-1.28,106000,26,973690,0,0,0,0,0,0,0,0,0,0
20200316,5468,凱鈺,11.05,11.35,11.05,11.35,-0.60,-5.02,7000,3,79150,0,0,0,0,0,0,0,0,0,0
20200316,5474,聰泰,56.10,57.90,55.00,55.00,0.00,0.0,273000,193,15373200,8000,18000,-10000,0,0,0,5000,0,5000,-5000
20200316,5475,德宏,2.38,2.40,2.34,2.34,-0.26,-10.0,153000,40,361680,0,0,0,0,0,0,0,0,0,0
20200316,5478,智冠,68.50,69.50,67.10,67.10,-1.40,-2.04,235000,185,16035600,17000,80000,-63000,0,0,0,4000,0,4000,-59000
20200316,5481,新華,11.70,11.70,10.75,11.30,-0.40,-3.42,506000,137,5673100,0,27000,-27000,0,0,0,0,0,0,-27000
20200316,5483,中美晶,91.60,93.50,85.90,86.50,-5.20,-5.67,12466000,7240,1121845400,685000,2939331,-2254331,109000,0,109000,1365000,687000,678000,-1467331
20200316,5487,通泰,33.00,33.00,30.65,30.65,-2.15,-6.55,120000,53,3870850,3000,5000,-2000,0,0,0,0,0,0,-2000
20200316,5488,松普,4.24,4.24,3.95,3.98,-0.26,-6.13,664000,141,2682480,0,0,0,0,0,0,0,0,0,0
20200316,5489,彩富,30.35,30.35,30.00,30.00,-0.35,-1.15,95000,49,2856500,0,22000,-22000,0,0,0,0,0,0,-22000
20200316,5490,同亨,23.80,23.80,21.05,21.05,-2.30,-9.85,709000,387,15435800,94000,22000,72000,0,0,0,0,34000,-34000,38000
20200316,5493,三聯,35.65,35.95,34.80,34.80,-1.20,-3.33,218000,119,7728200,26000,8000,18000,0,0,0,5000,0,5000,23000
20200316,5498,凱崴,8.59,8.64,8.00,8.02,-0.53,-6.2,1056000,306,8715100,97000,88000,9000,0,0,0,19000,0,19000,28000
20200316,5508,永信建,29.50,29.55,29.10,29.10,-0.35,-1.19,137000,93,4022550,4000,6000,-2000,0,0,0,0,0,0,-2000
20200316,5511,德昌,29.20,29.20,28.50,28.65,-0.45,-1.55,124000,65,3552000,0,34000,-34000,0,0,0,0,0,0,-34000
20200316,5512,力麒,8.37,8.47,8.16,8.16,-0.21,-2.51,1018000,340,8394470,20000,297000,-277000,0,0,0,0,0,0,-277000
20200316,5514,三豐,17.20,17.40,17.00,17.40,+0.20,1.16,70000,23,1200450,0,0,0,0,0,0,0,0,0,0
20200316,5516,雙喜,13.40,13.80,13.40,13.40,-0.60,-4.29,12000,7,161300,0,0,0,0,0,0,0,0,0,0
20200316,5520,力泰,29.30,29.30,29.30,29.30,0.00,0.0,1000,1,29300,0,0,0,0,0,0,0,0,0,0
20200316,5523,豐謙,9.28,9.30,8.80,9.22,-0.07,-0.75,175000,43,1586560,0,0,0,0,0,0,0,0,0,0
20200316,5529,志嘉,7.40,7.40,7.01,7.01,-0.34,-4.63,415000,124,2952780,1000,37000,-36000,0,0,0,0,0,0,-36000
20200316,5530,龍巖,53.50,55.00,53.10,53.30,-0.20,-0.37,394000,228,21187200,19000,35000,-16000,0,0,0,0,0,0,-16000
20200316,5536,聖暉,185.00,185.50,179.50,180.00,-5.00,-2.7,772000,638,140645000,39000,205000,-166000,0,0,0,10000,22000,-12000,-178000
20200316,5543,崇佑-KY,21.00,21.00,20.60,21.00,+1.30,6.6,532000,27,11170550,0,0,0,0,0,0,0,0,0,0
20200316,5601,台聯櫃,26.25,26.25,26.25,26.25,0.00,0.0,1000,1,26250,0,0,0,0,0,0,0,0,0,0
20200316,5603,陸海,9.80,9.99,9.60,9.99,-0.01,-0.1,31000,16,302030,2000,0,2000,0,0,0,0,0,0,2000
20200316,5604,中連貨,44.10,44.10,42.85,42.85,+2.75,6.86,720000,256,31696600,0,0,0,0,0,0,0,0,0,0
20200316,5609,中菲行,23.55,23.55,22.65,22.65,-1.05,-4.43,721000,350,16670600,18000,56000,-38000,0,0,0,0,1000,-1000,-39000
20200316,5701,劍湖山,1.28,1.39,1.28,1.38,-0.02,-1.43,30000,14,39780,0,0,0,0,0,0,0,0,0,0
20200316,5703,亞都,,,,,,0.00,0,0,0,0,0,0,0,0,0,0,0,0,0
20200316,5704,老爺知,,,,,,0.00,0,0,0,0,0,0,0,0,0,0,0,0,0
20200316,5820,日盛金,8.95,8.98,8.74,8.82,-0.18,-2.0,4175000,1388,36817710,69000,795000,-726000,0,0,0,0,125000,-125000,-851000
20200316,5864,致和證,7.85,7.85,7.50,7.79,-0.03,-0.38,84000,48,649400,0,0,0,0,0,0,0,0,0,0
20200316,5878,台名,44.30,44.50,44.00,44.50,-0.15,-0.34,54000,36,2382850,3000,0,3000,0,0,0,0,0,0,3000
20200316,5902,德記,,,,,,0.00,0,0,0,0,0,0,0,0,0,0,0,0,0
20200316,5903,全家,208.00,208.50,207.50,208.00,0.00,0.0,180000,140,37435000,19000,128000,-109000,0,0,0,0,5000,-5000,-114000
20200316,5904,寶雅,429.00,446.00,414.00,414.00,-30.00,-6.76,166000,155,70959000,77000,67000,10000,20000,0,20000,4000,39000,-35000,-5000
20200316,5905,南仁湖,7.82,7.83,7.40,7.40,-0.40,-5.13,887000,365,6766400,41000,305000,-264000,0,0,0,0,0,0,-264000
20200316,6015,宏遠證,5.89,5.89,5.68,5.75,0.00,0.0,402000,86,2300610,0,0,0,0,0,0,0,0,0,0
20200316,6016,康和證,6.72,6.72,6.52,6.59,-0.07,-1.05,1077000,327,7115420,212000,242000,-30000,0,0,0,0,0,0,-30000
20200316,6020,大展證,12.30,12.30,12.00,12.10,-0.20,-1.63,44000,11,530500,0,0,0,0,0,0,0,0,0,0
20200316,6021,大慶證,13.45,13.80,13.10,13.75,-0.05,-0.36,625000,114,8325150,0,46000,-46000,0,0,0,0,0,0,-46000
20200316,6023,元大期,49.20,49.60,48.75,49.10,0.00,0.0,295000,197,14516750,0,46000,-46000,0,0,0,0,2000,-2000,-48000
20200316,6026,福邦證,7.50,7.50,7.32,7.33,-0.17,-2.27,266000,122,1969870,0,61000,-61000,0,0,0,0,0,0,-61000
20200316,6101,寬魚國際,25.20,28.30,25.20,27.45,0.00,0.0,89000,44,2356600,1000,0,1000,0,0,0,1000,1000,0,1000
20200316,6103,合邦,,,,,,0.00,0,0,0,0,0,0,0,0,0,0,0,0,0
20200316,6104,創惟,29.50,29.50,28.00,28.20,0.00,0.0,1011000,606,28972750,45000,174000,-129000,0,0,0,0,0,0,-129000
20200316,6109,亞元,9.18,9.20,9.00,9.00,-0.19,-2.07,103000,31,932550,0,9000,-9000,0,0,0,0,3000,-3000,-12000
20200316,6111,大宇資,63.10,65.70,58.40,58.40,-6.40,-9.88,2023000,1499,122724100,111000,82000,29000,0,0,0,3000,5000,-2000,27000
20200316,6113,亞矽,4.79,4.89,4.24,4.59,-0.11,-2.34,45000,31,206700,0,0,0,0,0,0,0,0,0,0
20200316,6114,久威,22.40,22.50,21.55,21.85,-0.15,-0.68,89000,40,1957400,1000,2000,-1000,0,0,0,0,0,0,-1000
20200316,6118,建達,7.55,7.55,7.10,7.13,-0.33,-4.42,132000,62,964720,14000,14000,0,0,0,0,0,0,0,0
20200316,6121,新普,266.00,274.50,256.00,256.00,-15.50,-5.71,1328000,1176,350942500,618000,722000,-104000,0,0,0,1000,21000,-20000,-124000
20200316,6122,擎邦,14.10,14.15,12.95,12.95,-1.10,-7.83,1344000,622,18247900,8000,160000,-152000,0,0,0,46000,0,46000,-106000
20200316,6123,上奇,36.70,37.40,36.50,36.55,-0.05,-0.14,407000,248,14940600,12000,55000,-43000,0,0,0,0,0,0,-43000
20200316,6124,業強,28.25,29.30,25.25,25.25,-2.80,-9.98,109000,70,2972550,25000,29000,-4000,0,0,0,3000,3000,0,-4000
20200316,6125,廣運,14.50,14.95,14.10,14.35,+0.25,1.77,3799000,1595,54748600,169000,349000,-180000,0,0,0,0,0,0,-180000
20200316,6126,信音,11.85,12.20,11.70,11.70,-0.30,-2.5,480000,169,5721050,2000,88000,-86000,0,0,0,0,0,0,-86000
20200316,6127,九豪,13.05,13.35,12.20,12.20,-0.85,-6.51,1135000,623,14579450,57000,219000,-162000,0,0,0,0,0,0,-162000
20200316,6129,普誠,5.70,5.76,5.46,5.47,-0.22,-3.87,566000,210,3174630,50000,85000,-35000,0,0,0,0,0,0,-35000
20200316,6130,星寶國際,24.25,24.25,23.20,23.20,-1.05,-4.33,4000,2,95950,0,0,0,0,0,0,0,0,0,0
20200316,6134,萬旭,6.50,6.50,6.00,6.00,-0.41,-6.4,61000,27,372660,0,0,0,0,0,0,0,0,0,0
20200316,6138,茂達,63.40,64.70,57.90,58.10,-5.50,-8.65,1505000,1071,91182300,87000,209000,-122000,20000,249000,-229000,10000,53000,-43000,-394000
20200316,6140,訊達,9.99,10.40,9.10,9.44,-0.19,-1.97,48000,26,463500,0,5000,-5000,0,0,0,0,0,0,-5000
20200316,6143,振曜,29.50,29.80,28.70,28.80,-0.20,-0.69,403000,218,11754750,4000,46000,-42000,0,0,0,0,0,0,-42000
20200316,6144,得利影,6.02,6.53,5.98,6.53,-0.11,-1.66,9000,4,54570,0,0,0,0,0,0,0,0,0,0
20200316,6146,耕興,175.50,175.50,159.00,160.50,-16.00,-9.07,352000,255,57628000,183000,123000,60000,8000,0,8000,0,3000,-3000,65000
20200316,6147,頎邦,54.60,55.30,53.20,53.60,-1.00,-1.83,3286000,1776,177767800,420000,1106000,-686000,0,40000,-40000,212000,173000,39000,-687000
20200316,6148,驊宏資,8.18,8.25,8.02,8.06,-0.39,-4.62,120000,46,979300,0,5000,-5000,0,0,0,3000,0,3000,-2000
20200316,6150,撼訊,42.40,42.80,38.70,38.70,-4.30,-10.0,1028000,758,41230500,106000,52000,54000,0,0,0,0,0,0,54000
20200316,6151,晉倫,16.85,17.30,16.80,17.30,+0.10,0.58,125000,62,2124100,0,0,0,0,0,0,1000,0,1000,1000
20200316,6154,順發,11.70,12.00,11.70,11.90,+0.25,2.15,47000,30,554150,0,0,0,0,0,0,0,0,0,0
20200316,6156,松上,9.94,9.94,9.76,9.76,+0.05,0.51,133000,65,1310200,0,0,0,0,0,0,0,0,0,0
20200316,6158,禾昌,18.10,18.40,16.65,16.65,-1.85,-10.0,251000,175,4323100,28000,28000,0,0,0,0,0,0,0,0
20200316,6160,欣技,12.75,12.75,11.50,11.50,-1.25,-9.8,273000,163,3227350,0,0,0,0,0,0,0,0,0,0
20200316,6161,捷波,16.65,16.65,15.40,15.50,+0.15,0.98,266000,112,4226200,0,30000,-30000,0,0,0,0,3000,-3000,-33000
20200316,6163,華電網,12.45,12.45,11.85,11.85,-0.45,-3.66,580000,175,7095200,0,11000,-11000,0,0,0,1000,0,1000,-10000
20200316,6167,久正,5.50,5.50,5.22,5.22,-0.29,-5.26,445000,123,2394240,0,46000,-46000,0,0,0,0,0,0,-46000
20200316,6169,昱泉,33.90,34.90,31.00,31.00,-2.90,-8.55,168000,119,5529450,2000,4000,-2000,0,0,0,5000,0,5000,3000
20200316,6170,統振,13.05,13.80,11.90,11.90,-1.30,-9.85,1765000,696,21966200,357000,204000,153000,0,0,0,0,0,0,153000
20200316,6171,亞銳士,15.00,15.00,14.10,14.60,-0.55,-3.63,217000,117,3130250,54000,0,54000,0,0,0,0,0,0,54000
20200316,6173,信昌電,47.25,48.50,43.80,43.80,-3.40,-7.2,4328000,2947,200226800,586000,742000,-156000,0,122000,-122000,60000,113000,-53000,-331000
20200316,6174,安碁,10.80,10.80,10.60,10.70,-0.15,-1.38,9000,8,95700,0,0,0,0,0,0,0,0,0,0
20200316,6175,立敦,16.05,16.05,14.55,14.55,-1.50,-9.35,335000,173,5020850,5000,12000,-7000,0,0,0,2000,1000,1000,-6000
20200316,6179,亞通,29.00,30.00,27.55,28.45,-0.25,-0.87,281000,95,8163100,0,0,0,0,0,0,0,0,0,0
20200316,6180,橘子,45.00,46.10,44.05,45.00,+0.50,1.12,2108000,1293,95196350,96000,229000,-133000,0,0,0,0,0,0,-133000
20200316,6182,合晶,28.15,28.60,26.45,26.45,-1.45,-5.2,8605000,4461,236986700,534000,1149000,-615000,0,0,0,95000,320000,-225000,-840000
20200316,6185,幃翔,11.00,11.75,11.00,11.25,-0.55,-4.66,2294000,798,25683550,397000,55000,342000,0,0,0,0,12000,-12000,330000
20200316,6186,新潤,22.70,24.00,21.90,24.00,+1.30,5.73,893000,458,20201000,57000,75000,-18000,0,0,0,10000,3000,7000,-11000
20200316,6187,萬潤,35.60,35.60,32.25,32.30,-3.00,-8.5,645000,380,21792250,19000,65000,-46000,0,0,0,0,5000,-5000,-51000
20200316,6188,廣明,25.20,25.70,23.80,23.90,-1.30,-5.16,2202000,1193,54468550,250000,266000,-16000,0,0,0,0,58000,-58000,-74000
20200316,6190,萬泰科,14.50,14.50,14.25,14.30,-0.10,-0.69,358000,138,5155200,1000,89000,-88000,0,0,0,0,0,0,-88000
20200316,6194,育富,22.25,22.50,21.90,22.30,+0.05,0.22,47000,32,1043600,0,4000,-4000,0,0,0,0,0,0,-4000
20200316,6195,詩肯,30.05,30.05,29.50,29.50,-0.85,-2.8,93000,78,2761200,1000,1000,0,0,0,0,0,0,0,0
20200316,6198,凌泰,,,,,,0.00,0,0,0,0,0,0,0,0,0,0,0,0,0
20200316,6199,天品,13.90,13.90,13.90,13.90,+0.90,6.92,1000,1,13900,0,0,0,0,0,0,0,0,0,0
20200316,006201,元大富櫃50,11.80,11.80,11.14,11.14,-0.61,-5.19,295000,144,3361410,0,0,0,0,50000,-50000,45000,43000,2000,-48000
20200316,6203,海韻電,37.30,37.45,35.20,35.20,-1.80,-4.86,642000,415,23281250,18000,150000,-132000,0,0,0,5000,0,5000,-127000
20200316,6204,艾華,20.50,21.10,19.05,20.10,-0.80,-3.83,27000,16,550400,0,0,0,0,0,0,0,0,0,0
20200316,6207,雷科,19.10,19.45,18.95,19.00,-0.25,-1.3,296000,148,5633100,13000,9000,4000,0,0,0,0,0,0,4000
20200316,6208,日揚,23.50,23.60,22.40,22.55,-0.95,-4.04,474000,276,10845000,0,73000,-73000,0,0,0,0,0,0,-73000
20200316,6210,慶生,41.70,42.15,41.05,41.90,+0.25,0.6,273000,205,11342700,3000,33000,-30000,0,0,0,0,0,0,-30000
20200316,6212,理銘,45.00,46.00,45.00,46.00,0.00,0.0,8000,4,363000,0,0,0,0,0,0,0,0,0,0
20200316,6217,中探針,24.25,24.85,22.80,22.80,-1.15,-4.8,569000,399,13630550,70000,48000,22000,0,0,0,5000,4000,1000,23000
20200316,6218,豪勉,17.40,17.40,17.00,17.25,-0.15,-0.86,78000,47,1334900,0,2000,-2000,0,0,0,0,0,0,-2000
20200316,6219,富旺,13.50,13.95,13.45,13.45,+0.10,0.75,2411000,447,32885050,25000,35000,-10000,0,0,0,14000,10000,4000,-6000
20200316,6220,岳豐,17.45,17.50,16.60,16.70,-0.55,-3.19,868000,300,14877050,10000,28000,-18000,0,0,0,13000,5000,8000,-10000
20200316,6221,晉泰,41.30,41.30,39.60,40.20,-0.30,-0.74,33000,25,1329650,0,2000,-2000,0,0,0,0,1000,-1000,-3000
20200316,6222,上揚,,,,,,0.00,0,0,0,0,0,0,0,0,0,0,0,0,0
20200316,6223,旺矽,57.50,57.80,54.00,54.00,-3.00,-5.26,1611000,1064,90127900,119000,531000,-412000,217000,0,217000,93000,47000,46000,-149000
20200316,6227,茂綸,17.20,17.20,16.60,16.90,-0.25,-1.46,85000,54,1432900,0,0,0,0,0,0,0,0,0,0
20200316,6228,全譜,6.58,6.58,6.17,6.19,-0.33,-5.06,51000,19,324690,0,0,0,0,0,0,0,0,0,0
20200316,6229,研通,11.65,11.75,11.10,11.20,-0.70,-5.88,36000,23,412750,0,0,0,0,0,0,2000,0,2000,2000
20200316,6231,系微,52.60,52.70,47.45,47.45,-5.25,-9.96,889000,456,43741850,66000,77000,-11000,0,0,0,0,0,0,-11000
20200316,6233,旺玖,8.47,8.57,7.63,7.63,-0.84,-9.92,1295000,464,10388990,220000,53000,167000,0,0,0,0,0,0,167000
20200316,6234,高僑,21.85,22.75,21.30,21.40,-0.15,-0.7,457000,274,10001100,10000,51000,-41000,0,0,0,0,0,0,-41000
20200316,6236,康呈,,,,,,0.00,0,0,0,0,0,0,0,0,0,0,0,0,0
20200316,6237,驊訊,12.30,12.30,11.00,11.00,-1.20,-9.84,349000,176,3944300,4000,5000,-1000,0,0,0,0,70000,-70000,-71000
20200316,6238,勝麗,129.00,130.50,118.00,118.00,-10.00,-7.81,1351000,955,168674000,431000,290000,141000,0,0,0,10000,79000,-69000,72000
20200316,6240,松崗,12.55,12.55,11.30,11.45,-1.10,-8.76,97000,60,1112250,18000,2000,16000,0,0,0,2000,2000,0,16000
20200316,6241,易通展,11.00,11.25,10.50,10.60,-0.30,-2.75,48000,22,520900,0,0,0,0,0,0,0,0,0,0
20200316,6242,立康,,,,,,0.00,0,0,0,0,0,0,0,0,0,0,0,0,0
20200316,6244,茂迪,5.24,5.38,4.90,4.90,-0.29,-5.59,2759000,831,14225920,244000,252000,-8000,0,0,0,0,0,0,-8000
20200316,6245,立端,44.70,45.20,41.55,42.30,-1.85,-4.19,1490000,855,64270400,158000,264000,-106000,0,388000,-388000,57000,6000,51000,-443000
20200316,6246,臺龍,7.95,8.02,7.51,7.75,-0.48,-5.83,21000,16,165030,0,0,0,0,0,0,0,0,0,0
20200316,6247,淇譽電,8.70,8.70,8.00,8.00,-0.65,-7.51,19000,16,157720,0,0,0,0,0,0,0,0,0,0
20200316,6248,沛波,25.55,26.40,25.55,26.40,-0.10,-0.38,6000,6,155450,0,0,0,0,0,0,0,0,0,0
20200316,6259,百徽,2.35,2.35,2.35,2.35,+0.10,4.44,4000,2,9400,0,0,0,0,0,0,0,0,0,0
20200316,6261,久元,46.55,46.55,44.10,44.10,-2.65,-5.67,1026000,705,46328850,114000,506000,-392000,0,0,0,0,4000,-4000,-396000
20200316,6263,普萊德,60.60,60.60,58.10,58.40,-2.40,-3.95,333000,252,19682000,6000,43000,-37000,0,0,0,0,0,0,-37000
20200316,6264,富裔,5.58,5.58,5.58,5.58,0.00,0.0,2000,1,11160,0,0,0,0,0,0,0,0,0,0
20200316,6265,方土昶,5.89,5.89,5.35,5.68,-0.16,-2.74,169000,70,953840,0,0,0,0,0,0,0,0,0,0
20200316,6266,泰詠,17.80,18.10,17.05,17.15,-0.55,-3.11,654000,314,11440500,9000,25000,-16000,0,0,0,0,0,0,-16000
20200316,6270,倍微,13.45,13.70,13.30,13.45,-0.20,-1.47,258000,89,3443600,0,2000,-2000,0,0,0,0,0,0,-2000
20200316,6274,台燿,109.00,111.00,105.00,109.50,-0.50,-0.45,2477000,1826,268861500,409000,724000,-315000,111000,0,111000,53000,163000,-110000,-314000
20200316,6275,元山,13.70,13.80,12.95,13.00,-0.60,-4.41,460000,185,6105050,15000,7000,8000,0,0,0,0,4000,-4000,4000
20200316,6276,安鈦克,12.85,12.85,11.20,11.20,-1.20,-9.68,530000,285,6195100,36000,25000,11000,0,0,0,7000,0,7000,18000
20200316,6279,胡連,67.40,67.50,62.00,62.80,-4.20,-6.27,559000,385,36374800,141000,133000,8000,0,0,0,3000,11000,-8000,0
20200316,6284,佳邦,24.95,25.45,23.00,23.00,-1.95,-7.82,1113000,622,26859650,69000,244000,-175000,0,0,0,1000,4000,-3000,-178000
20200316,6287,元隆,1.40,1.40,1.39,1.39,+0.01,0.72,14000,3,19560,0,0,0,0,0,0,0,0,0,0
20200316,6290,良維,48.30,48.30,44.40,44.40,-2.60,-5.53,2567000,1422,120471700,175000,493000,-318000,115000,62000,53000,1000,17000,-16000,-281000
20200316,6291,沛亨,12.40,14.35,12.40,13.50,+0.05,0.37,18000,10,233850,0,0,0,0,0,0,0,0,0,0
20200316,6292,迅德,37.00,37.00,35.10,35.10,-1.45,-3.97,493000,327,17816350,5000,20000,-15000,0,0,0,1000,0,1000,-14000
20200316,6294,智基,96.50,96.50,92.90,93.00,-2.10,-2.21,70000,61,6573200,1000,1000,0,0,0,0,0,0,0,0
20200316,6404,通訊-KY,2.97,3.23,2.74,3.22,+0.25,8.42,23000,23,69150,0,0,0,0,0,0,0,0,0,0
20200316,6411,晶焱,84.10,85.90,79.60,80.20,-4.50,-5.31,1743000,1383,143002000,113000,226000,-113000,0,200000,-200000,17000,25000,-8000,-321000
20200316,6417,韋僑,55.90,56.10,53.80,55.50,-0.40,-0.72,90000,34,4961100,0,0,0,0,0,0,0,0,0,0
20200316,6418,詠昇,12.60,12.80,12.50,12.80,-0.20,-1.54,12000,10,150650,0,0,0,0,0,0,1000,0,1000,1000
20200316,6419,京晨科,14.90,14.90,13.70,14.15,-1.00,-6.6,41000,34,583950,0,0,0,0,0,0,0,0,0,0
20200316,6425,易發,19.50,19.50,19.05,19.20,-0.95,-4.71,67000,30,1285300,0,0,0,0,0,0,0,0,0,0
20200316,6426,統新,101.00,107.00,93.60,93.60,-10.40,-10.0,1172000,1005,115769900,152000,51000,101000,0,116000,-116000,7000,15000,-8000,-23000
20200316,6432,今展科,25.95,26.60,24.65,24.70,-1.40,-5.36,396000,203,10178850,3000,87008,-84008,0,0,0,0,0,0,-84008
20200316,6435,大中,78.90,82.00,73.70,74.00,-4.90,-6.21,348000,283,27104800,13000,64000,-51000,0,0,0,0,3000,-3000,-54000
20200316,6438,迅得,48.00,48.00,42.30,42.40,-3.80,-8.23,1734000,974,77494200,478000,166000,312000,0,511000,-511000,5000,0,5000,-194000
20200316,6441,廣錠,60.40,62.70,55.50,56.10,-4.30,-7.12,1102000,717,65824300,103000,64000,39000,0,0,0,0,0,0,39000
20200316,6446,藥華藥,85.00,85.00,74.10,74.10,-8.20,-9.96,1115000,785,86670900,43000,32000,11000,0,147000,-147000,0,0,0,-136000
20200316,6457,紘康,44.95,48.00,44.95,46.90,+1.95,4.34,1215000,709,57447300,0,0,0,0,0,0,0,0,0,0
20200316,6461,益得,16.00,16.20,14.40,14.50,-1.45,-9.09,278000,155,4178350,11000,2000,9000,0,0,0,0,0,0,9000
20200316,6462,神盾,162.50,169.00,148.50,148.50,-16.00,-9.73,4031000,2923,627474500,419000,220000,199000,0,179000,-179000,14000,25000,-11000,9000
20200316,6465,威潤,42.90,43.80,42.40,43.55,-0.45,-1.02,19000,19,815750,0,0,0,0,0,0,1000,1000,0,0
20200316,6469,大樹,79.40,79.50,76.30,77.60,-2.10,-2.63,177000,127,13826400,4000,30000,-26000,0,0,0,0,0,0,-26000
20200316,6470,宇智,34.70,34.85,31.65,32.35,-2.00,-5.82,248000,168,8335550,9000,16000,-7000,0,0,0,2000,0,2000,-5000
20200316,6472,保瑞,147.50,151.50,138.00,138.50,-11.50,-7.67,1404000,1130,203287500,47000,53000,-6000,0,321000,-321000,12000,85000,-73000,-400000
20200316,6482,弘煜科,27.00,27.00,26.50,26.55,-2.85,-9.69,106000,73,2816400,0,5000,-5000,0,0,0,0,0,0,-5000
20200316,6485,點序,28.10,28.10,26.50,26.55,-1.55,-5.52,118000,94,3193150,2000,38000,-36000,0,0,0,0,0,0,-36000
20200316,6486,互動,70.30,70.60,69.10,70.00,+5.80,9.03,1166000,769,81980400,72000,57000,15000,0,0,0,1000,11000,-10000,5000
20200316,6488,環球晶,346.00,355.50,322.00,322.00,-32.00,-9.04,7192000,5657,2451582500,705414,1332595,-627181,4000,0,4000,234000,240000,-6000,-629181
20200316,6492,生華科,57.30,57.30,53.20,55.00,-2.50,-4.35,64000,52,3531800,0,6000,-6000,0,0,0,0,0,0,-6000
20200316,6494,九齊,28.50,30.00,28.20,28.60,+0.50,1.78,453000,321,13118950,6000,67000,-61000,0,0,0,0,0,0,-61000
20200316,6496,科懋,29.70,30.35,29.20,29.25,-0.50,-1.68,101000,71,3013000,0,0,0,0,0,0,2000,3000,-1000,-1000
20200316,6497,亞獅康-KY,3.97,4.50,3.97,4.13,-0.27,-6.14,290000,59,1179650,0,0,0,0,0,0,0,0,0,0
20200316,6499,益安,43.20,43.20,39.95,40.00,-3.85,-8.78,269000,163,11013300,10000,0,10000,0,0,0,0,0,0,10000
20200316,6506,雙邦,16.70,17.00,16.45,16.70,0.00,0.0,224000,104,3732100,15000,4000,11000,0,0,0,0,3000,-3000,8000
20200316,6508,惠光,27.70,27.70,27.00,27.00,-0.50,-1.82,285000,169,7776200,0,17000,-17000,0,0,0,0,0,0,-17000
20200316,6509,聚和,16.30,16.45,15.75,15.90,-0.40,-2.45,795000,315,12836250,4000,96000,-92000,0,0,0,0,0,0,-92000
20200316,6510,精測,726.00,740.00,686.00,686.00,-42.00,-5.77,895000,875,643502000,240000,237000,3000,7000,0,7000,7000,27000,-20000,-10000
20200316,6512,啟發電,13.00,13.40,12.20,12.70,-0.30,-2.31,12000,11,151050,0,0,0,0,0,0,0,0,0,0
20200316,6514,芮特-KY,46.55,47.70,44.05,44.05,-2.40,-5.17,63000,60,2862400,7000,13000,-6000,0,0,0,6000,0,6000,0
20200316,6516,勤崴國際,87.00,87.00,81.50,82.50,-5.00,-5.71,107000,83,8880500,0,0,0,0,0,0,0,0,0,0
20200316,6523,達爾膚,53.10,54.50,50.50,50.60,-2.60,-4.89,758000,582,40100900,211000,248000,-37000,0,0,0,5000,0,5000,-32000
20200316,6527,明達醫,49.20,52.90,47.80,49.00,-0.15,-0.31,125000,104,6262300,11000,2000,9000,0,0,0,0,0,0,9000
20200316,6530,創威,17.00,17.00,15.90,15.90,-1.30,-7.56,73000,57,1188050,0,0,0,0,0,0,6000,0,6000,6000
20200316,6532,瑞耘,35.00,36.00,32.70,32.90,-1.80,-5.19,927000,652,31824050,86000,129000,-43000,0,0,0,0,0,0,-43000
20200316,6535,順藥,27.35,27.85,26.20,26.25,-0.60,-2.23,139000,105,3771350,1000,4000,-3000,0,0,0,0,2000,-2000,-5000
20200316,6538,倉和,257.50,276.50,257.50,257.50,-28.50,-9.97,1146000,868,302111500,26000,30000,-4000,0,0,0,1000,0,1000,-3000
20200316,6542,隆中,46.00,46.00,41.85,41.85,-4.65,-10.0,74000,41,3152850,0,7000,-7000,0,0,0,0,0,0,-7000
20200316,6547,高端疫苗,39.95,42.05,39.10,42.05,+3.80,9.93,3324000,1312,137502450,44000,10000,34000,0,0,0,0,5000,-5000,29000
20200316,6548,長科*,24.15,24.40,21.70,21.85,-2.25,-9.34,545000,269,12518200,43000,265000,-222000,0,0,0,10000,0,10000,-212000
20200316,6556,勝品,44.10,45.90,44.10,45.75,+1.40,3.16,17000,11,756950,0,0,0,0,0,0,0,0,0,0
20200316,6560,欣普羅,28.40,28.40,27.25,27.25,-1.15,-4.05,51000,47,1400350,0,0,0,0,0,0,0,0,0,0
20200316,6561,是方,257.50,270.00,253.00,261.00,+11.50,4.61,1265000,1167,334633500,56000,69000,-13000,63000,0,63000,5000,14000,-9000,41000
20200316,6568,宏觀,113.00,114.50,105.00,105.50,-5.50,-4.95,119000,99,13049500,3000,17000,-14000,0,0,0,1000,0,1000,-13000
20200316,6569,醫揚,157.00,160.00,156.00,158.00,+1.50,0.96,65000,57,10239000,2000,2000,0,0,0,0,0,0,0,0
20200316,6570,維田,30.60,31.60,30.60,31.60,+0.85,2.76,11000,11,340100,0,0,0,0,0,0,0,0,0,0
20200316,6574,霈方,,,,,,0.00,0,0,0,0,0,0,0,0,0,0,0,0,0
20200316,6576,逸達,45.05,49.05,44.00,44.50,-0.95,-2.09,139000,110,6354900,10000,2000,8000,0,0,0,0,0,0,8000
20200316,6577,勁豐,60.00,61.50,58.80,61.00,+1.10,1.84,31000,29,1864200,0,0,0,0,0,0,0,0,0,0
20200316,6578,達邦蛋白,19.10,19.20,18.75,18.80,-0.70,-3.59,61000,48,1156550,0,0,0,0,0,0,0,0,0,0
20200316,6589,台康生技,31.20,33.00,30.30,30.70,+0.40,1.32,2263000,1362,71840850,62000,155000,-93000,0,0,0,0,0,0,-93000
20200316,6590,普鴻,29.40,29.55,29.05,29.15,-0.30,-1.02,18000,10,526100,8000,0,8000,0,0,0,0,0,0,8000
20200316,6593,台灣銘板,22.50,23.00,22.50,23.00,-1.95,-7.82,84000,68,1890500,0,0,0,0,0,0,0,0,0,0
20200316,6594,展匯科,17.90,17.90,16.85,16.85,-0.55,-3.16,10000,10,173100,0,0,0,0,0,0,0,0,0,0
20200316,6596,寬宏藝術,44.50,45.30,44.50,45.30,0.00,0.0,108000,94,4827200,22000,0,22000,0,0,0,0,0,0,22000
20200316,6603,富強鑫,9.19,9.44,8.75,8.92,0.00,0.0,75000,40,675830,0,7000,-7000,0,0,0,0,0,0,-7000
20200316,6609,瀧澤科,24.00,24.25,22.05,22.05,-1.90,-7.93,259000,143,5989600,0,7000,-7000,0,0,0,5000,0,5000,-2000
20200316,6612,奈米醫材,65.60,66.50,63.10,63.10,-3.20,-4.83,235000,201,15302500,7000,39000,-32000,0,0,0,0,0,0,-32000
20200316,6613,朋億,144.00,146.50,142.50,142.50,-4.00,-2.73,84000,71,12138000,2000,13000,-11000,0,0,0,0,0,0,-11000
20200316,6615,慧智,61.00,61.00,58.70,58.70,0.00,0.0,31000,30,1842100,0,1000,-1000,0,0,0,0,0,0,-1000
20200316,6616,特昇-KY,31.60,31.60,28.25,28.25,-3.10,-9.89,72000,55,2067650,0,0,0,0,0,0,0,0,0,0
20200316,6624,萬年清,38.60,38.70,36.15,36.65,-2.15,-5.54,29000,20,1097450,0,0,0,0,0,0,0,0,0,0
20200316,6629,泰金-KY,46.00,48.00,46.00,47.90,+0.25,0.52,13000,12,619850,0,0,0,0,0,0,0,0,0,0
20200316,6640,均華,36.50,36.80,36.10,36.60,-0.70,-1.88,16000,13,582300,0,0,0,0,0,0,0,0,0,0
20200316,6642,富致,31.50,31.65,31.50,31.50,0.00,0.0,10000,8,315400,0,0,0,0,0,0,0,0,0,0
20200316,6643,M31,230.00,236.00,208.00,208.00,-23.00,-9.96,669000,581,143700000,77000,16000,61000,0,126000,-126000,0,9000,-9000,-74000
20200316,6649,台生材,26.50,26.55,24.30,24.30,-2.10,-7.95,36000,21,939450,0,1000,-1000,0,0,0,0,1000,-1000,-2000
20200316,6654,天正國際,42.80,43.00,40.35,41.30,-1.10,-2.59,66000,55,2708400,3000,0,3000,0,0,0,0,0,0,3000
20200316,6662,樂斯科,29.00,30.20,29.00,30.00,+1.00,3.45,41000,31,1224950,0,0,0,0,0,0,0,29000,-29000,-29000
20200316,6664,群翊,52.60,54.20,51.60,51.70,-0.40,-0.77,150000,116,7862500,1000,35000,-34000,0,0,0,0,0,0,-34000
20200316,6667,信紘科,65.00,68.00,59.50,59.50,-6.10,-9.3,790000,649,50353300,37000,59000,-22000,0,0,0,0,0,0,-22000
20200316,6679,鈺太,125.00,138.00,124.50,132.00,+5.00,3.94,2446000,1558,320645000,141000,510000,-369000,0,176000,-176000,93000,50000,43000,-502000
20200316,6680,鑫創電子,54.20,56.50,54.20,56.50,-2.90,-4.88,4000,3,222700,0,0,0,0,0,0,0,0,0,0
20200316,6683,雍智科技,160.50,167.50,150.00,150.00,-15.50,-9.37,534000,485,84818500,25000,45000,-20000,0,0,0,3000,50000,-47000,-67000
20200316,6690,安碁資訊,113.00,117.00,106.50,108.00,-8.00,-6.9,152000,139,17077000,4000,12000,-8000,0,0,0,0,0,0,-8000
20200316,6697,東捷資訊,32.40,32.40,30.80,31.00,-1.55,-4.76,32000,26,998250,0,4000,-4000,0,0,0,0,0,0,-4000
20200316,6803,崑鼎,202.00,203.50,199.00,199.50,-5.50,-2.68,135000,99,27098500,4000,11000,-7000,0,0,0,0,3000,-3000,-10000
20200316,7402,邑錡,29.90,29.90,28.20,28.20,-2.05,-6.78,4000,4,115800,0,0,0,0,0,0,0,0,0,0
20200316,8024,佑華,8.88,8.88,8.21,8.21,-0.47,-5.41,81000,39,680850,5000,3000,2000,0,0,0,1000,0,1000,3000
20200316,8027,鈦昇,23.95,24.15,22.50,24.10,+0.10,0.42,334000,130,7740450,0,19000,-19000,0,0,0,0,1000,-1000,-20000
20200316,8032,光菱,22.25,22.70,22.25,22.45,-0.20,-0.88,13000,10,291350,0,0,0,0,0,0,0,0,0,0
20200316,8034,榮群,18.70,19.15,16.95,17.20,-1.50,-8.02,2857000,1143,51332400,103000,302000,-199000,0,0,0,0,0,0,-199000
20200316,8038,長園科,32.20,33.50,31.00,31.50,-1.30,-3.96,118000,85,3819800,0,3000,-3000,0,0,0,1000,0,1000,-2000
20200316,8040,九暘,16.80,17.20,14.90,14.90,-1.65,-9.97,1792000,858,28322100,202000,250000,-48000,0,0,0,8000,0,8000,-40000
20200316,8042,金山電,32.00,32.00,29.40,29.60,+0.40,1.37,344000,172,10317450,14000,8000,6000,0,0,0,5000,0,5000,11000
20200316,8043,蜜望實,21.20,21.60,19.60,19.60,-1.55,-7.33,447000,302,9252350,32000,57000,-25000,0,0,0,0,0,0,-25000
20200316,8044,網家,81.00,84.20,76.50,76.60,-3.90,-4.84,1103000,905,89210800,64000,163900,-99900,0,26000,-26000,2000,33000,-31000,-156900
20200316,8047,星雲,10.25,10.45,9.82,10.15,+0.20,2.01,18000,15,182790,0,0,0,0,0,0,0,2000,-2000,-2000
20200316,8048,德勝,30.00,30.00,28.95,29.30,-0.50,-1.68,148000,101,4332250,2000,7000,-5000,0,0,0,2000,1000,1000,-4000
20200316,8049,晶采,18.00,18.00,17.60,17.85,+1.10,6.57,1150000,674,20513900,1000,34000,-33000,0,0,0,0,0,0,-33000
20200316,8050,廣積,39.25,39.70,37.40,37.40,-1.85,-4.71,295000,181,11289400,13000,35000,-22000,0,0,0,4000,0,4000,-18000
20200316,8054,安國,11.75,12.00,11.65,11.75,-0.10,-0.84,277000,61,3248950,0,3000,-3000,0,0,0,0,0,0,-3000
20200316,8059,凱碩,14.10,14.20,13.05,13.05,-0.80,-5.78,254000,132,3495900,5000,74000,-69000,0,0,0,0,0,0,-69000
20200316,8064,東捷,13.45,13.65,12.80,12.80,-0.60,-4.48,548000,300,7198900,2000,81000,-79000,0,0,0,0,0,0,-79000
20200316,8066,來思達,61.00,62.50,60.10,60.80,+1.60,2.7,111000,103,6796200,14000,7000,7000,0,0,0,3000,0,3000,10000
20200316,8067,志旭,7.78,7.98,6.93,7.35,-0.35,-4.55,47000,24,342820,0,0,0,0,0,0,0,0,0,0
20200316,8068,全達,34.85,37.00,34.35,36.40,+1.30,3.7,304000,166,10869800,28000,1000,27000,0,0,0,0,0,0,27000
20200316,8069,元太,25.20,25.30,23.00,23.70,-1.30,-5.2,7563000,3255,180979600,937000,2810000,-1873000,0,0,0,1069000,78000,991000,-882000
20200316,8071,能率網通,10.90,10.90,10.15,10.50,-0.30,-2.78,277000,136,2917600,0,6000,-6000,0,0,0,0,0,0,-6000
20200316,8074,鉅橡,15.30,15.30,15.05,15.05,-0.25,-1.63,195000,66,2964300,0,0,0,0,0,0,0,0,0,0
20200316,8076,伍豐,26.80,27.00,25.80,26.20,-0.60,-2.24,1214000,486,31837500,29000,180000,-151000,0,0,0,1000,2000,-1000,-152000
20200316,8077,洛碁,,,,,,0.00,0,0,0,0,0,0,0,0,0,0,0,0,0
20200316,8080,永利聯合,3.02,3.02,3.02,3.02,-0.24,-7.36,9000,5,27180,0,0,0,0,0,0,0,0,0,0
20200316,8083,瑞穎,140.50,140.50,137.00,138.00,-2.00,-1.43,62000,45,8585500,0,1000,-1000,0,0,0,0,0,0,-1000
20200316,8084,巨虹,22.20,23.00,22.20,23.00,+1.20,5.5,19000,14,431550,0,0,0,0,0,0,0,3000,-3000,-3000
20200316,8085,福華,3.30,3.58,3.29,3.40,-0.06,-1.73,319000,72,1068750,0,1000,-1000,0,0,0,0,0,0,-1000
20200316,8086,宏捷科,82.90,84.70,75.20,75.60,-7.90,-9.46,11395000,7582,907604900,1730000,647000,1083000,0,332000,-332000,26000,335000,-309000,442000
20200316,8087,華鎂鑫,6.65,6.66,6.40,6.60,-0.23,-3.37,6000,6,39390,0,0,0,0,0,0,0,0,0,0
20200316,8088,品安,25.50,26.10,23.70,23.75,-1.75,-6.86,2708000,1530,67513800,74000,235000,-161000,0,0,0,1000,0,1000,-160000
20200316,8091,翔名,53.50,54.30,51.50,51.80,-1.30,-2.45,164000,118,8584700,1000,40000,-39000,0,0,0,0,0,0,-39000
20200316,8092,建暐,6.02,6.50,6.01,6.01,-0.09,-1.48,39000,20,241960,0,0,0,0,0,0,0,0,0,0
20200316,8093,保銳,4.41,4.73,4.32,4.73,-0.06,-1.25,117000,50,508620,1000,0,1000,0,0,0,0,0,0,1000
20200316,8096,擎亞,9.16,9.21,8.63,8.63,-0.46,-5.06,755000,292,6736040,6000,45000,-39000,0,0,0,0,0,0,-39000
20200316,8097,常珵,11.85,12.05,11.80,12.05,-0.15,-1.23,26000,18,309100,0,0,0,0,0,0,0,0,0,0
20200316,8099,大世科,15.10,15.25,15.05,15.05,-0.25,-1.63,58000,45,877350,0,0,0,0,0,0,0,0,0,0
20200316,8107,大億金茂,16.65,16.65,16.20,16.30,-0.15,-0.91,64000,38,1048850,0,7000,-7000,0,0,0,0,0,0,-7000
20200316,8109,博大,60.40,60.80,58.70,58.80,-1.60,-2.65,224000,126,13369100,0,109500,-109500,0,0,0,0,0,0,-109500
20200316,8111,立碁,6.72,6.81,6.47,6.61,-0.09,-1.34,135000,52,901880,0,0,0,0,0,0,0,0,0,0
20200316,8121,越峰,9.61,9.98,9.26,9.31,-0.19,-2.0,399000,158,3883210,5000,16000,-11000,0,0,0,3000,0,3000,-8000
20200316,8147,正淩,27.80,27.80,26.00,26.00,-0.35,-1.33,26000,22,692750,0,0,0,0,0,0,0,0,0,0
20200316,8155,博智,143.00,151.00,141.00,144.00,+2.00,1.41,9448000,7286,1381382000,318000,524000,-206000,420000,0,420000,307000,288000,19000,233000
20200316,8171,天宇,11.50,12.65,11.40,12.50,+0.95,8.23,1017000,405,12400300,10000,4000,6000,0,0,0,0,0,0,6000
20200316,8176,智捷,8.43,8.43,7.94,8.00,-0.12,-1.48,240000,104,1929770,7000,40000,-33000,0,0,0,0,0,0,-33000
20200316,8182,加高,24.30,24.30,22.70,22.70,-0.70,-2.99,1228000,582,28867150,32000,198000,-166000,0,0,0,0,0,0,-166000
20200316,8183,精星,13.85,14.10,13.05,13.05,-0.75,-5.43,1007000,426,13705850,95000,229000,-134000,0,0,0,0,0,0,-134000
20200316,8234,新漢,20.65,20.65,19.90,20.15,-0.50,-2.42,337000,110,6805000,9000,24000,-15000,0,0,0,0,2000,-2000,-17000
20200316,8240,華宏,20.30,20.30,19.55,19.55,-0.70,-3.46,120000,73,2381200,0,13000,-13000,0,0,0,4000,0,4000,-9000
20200316,8255,朋程,85.00,85.20,81.80,82.10,-3.10,-3.64,495000,325,41024700,3000,66000,-63000,0,0,0,0,4000,-4000,-67000
20200316,8277,商丞,5.38,5.65,5.20,5.20,-0.16,-2.99,183000,63,966430,0,5000,-5000,0,0,0,0,0,0,-5000
20200316,8279,生展,93.90,94.00,87.00,87.50,-6.40,-6.82,102000,82,9226200,1000,1000,0,0,0,0,0,0,0,0
20200316,8287,英格爾,2.57,2.76,2.57,2.76,+0.25,9.96,106000,28,286780,0,0,0,0,0,0,0,0,0,0
20200316,8289,泰藝,10.10,10.65,10.00,10.00,-0.25,-2.44,505000,221,5202600,0,28000,-28000,0,0,0,0,6000,-6000,-34000
20200316,8291,尚茂,2.26,2.69,2.26,2.69,+0.24,9.8,7000,5,16250,0,0,0,0,0,0,0,0,0,0
20200316,8299,群聯,265.50,270.50,251.00,251.00,-17.00,-6.34,3235000,2667,838793500,456100,732000,-275900,0,121000,-121000,119000,209000,-90000,-486900
20200316,8342,益張,45.30,45.30,42.50,42.50,-2.45,-5.45,51000,32,2192450,0,0,0,0,0,0,0,0,0,0
20200316,8349,恒耀,49.30,49.30,46.70,46.70,-3.30,-6.6,132000,83,6333700,0,18000,-18000,0,0,0,2000,0,2000,-16000
20200316,8349A,恒耀甲特,46.60,46.60,45.00,45.10,-1.50,-3.22,132000,92,6033250,0,0,0,0,0,0,0,0,0,0
20200316,8354,冠好,16.50,16.55,16.10,16.50,-0.45,-2.65,29000,19,474500,0,0,0,0,0,0,1000,0,1000,1000
20200316,8358,金居,32.10,32.90,30.95,31.00,-0.95,-2.97,5463000,2782,175000700,628000,866000,-238000,0,0,0,56000,48000,8000,-230000
20200316,8383,千附,31.50,31.80,30.80,30.95,-0.45,-1.43,389000,253,12117250,1000,24000,-23000,0,0,0,0,0,0,-23000
20200316,8390,金益鼎,14.50,14.50,13.70,13.80,-0.95,-6.44,388000,215,5463250,3000,43000,-40000,0,0,0,5000,7000,-2000,-42000
20200316,8401,白紗科,10.40,10.65,10.20,10.35,-0.05,-0.48,88000,29,910550,0,0,0,0,0,0,0,0,0,0
20200316,8403,盛弘,30.60,32.30,30.35,30.60,+0.45,1.49,3659000,2242,114383350,145000,361000,-216000,0,0,0,0,129000,-129000,-345000
20200316,8406,金可-KY,137.00,140.50,133.00,135.00,0.00,0.0,709000,604,97631500,231000,183000,48000,0,0,0,3000,12000,-9000,39000
20200316,8409,商之器,14.90,16.15,14.90,16.15,+1.45,9.86,221000,127,3466200,49000,2000,47000,0,0,0,2000,3000,-1000,46000
20200316,8410,森田,22.20,23.45,22.20,23.45,+0.10,0.43,5000,5,114800,0,0,0,0,0,0,0,0,0,0
20200316,8415,大國鋼,27.50,27.55,27.00,27.50,0.00,0.0,1023000,191,27849500,57000,31000,26000,0,0,0,0,0,0,26000
20200316,8416,實威,105.00,106.50,103.50,103.50,-4.00,-3.72,34000,30,3567500,0,1000,-1000,0,0,0,0,0,0,-1000
20200316,8418,捷必勝-KY,14.25,14.35,13.10,13.70,-0.40,-2.84,33000,26,447900,0,1000,-1000,0,0,0,1000,1000,0,-1000
20200316,8420,明揚,23.10,23.10,23.00,23.00,-0.55,-2.34,77000,22,1772100,0,0,0,0,0,0,0,0,0,0
20200316,8421,旭源,9.69,9.70,9.50,9.50,-0.19,-1.96,64000,21,618760,0,0,0,0,0,0,0,0,0,0
20200316,8423,保綠-KY,17.10,18.00,17.10,18.00,-1.00,-5.26,8000,6,138750,0,0,0,0,0,0,0,0,0,0
20200316,8424,惠普,49.00,49.00,47.55,48.05,-0.70,-1.44,51000,35,2460450,0,1000,-1000,0,0,0,0,0,0,-1000
20200316,8426,紅木-KY,15.85,15.85,15.00,15.75,-0.10,-0.63,28000,21,427150,0,0,0,0,0,0,0,0,0,0
20200316,8431,匯鑽科,38.60,39.40,35.90,35.90,-3.95,-9.91,413000,286,15297250,7000,65000,-58000,0,0,0,0,0,0,-58000
20200316,8432,東生華,74.00,75.40,72.60,73.10,-0.80,-1.08,7000,7,515500,0,1000,-1000,0,0,0,0,0,0,-1000
20200316,8433,弘帆,41.00,41.50,39.20,39.60,-0.80,-1.98,49000,38,1978700,0,2000,-2000,0,0,0,0,0,0,-2000
20200316,8435,鉅邁,51.50,52.00,50.80,50.80,-0.60,-1.17,111000,62,5700800,42000,3000,39000,0,0,0,0,0,0,39000
20200316,8436,大江,176.00,180.50,172.50,174.50,-0.50,-0.29,2623000,2023,463879500,459000,363000,96000,420000,5000,415000,14000,19000,-5000,506000
20200316,8437,大地-KY,186.50,190.50,186.00,189.00,+3.00,1.61,38000,37,7126500,10000,10000,0,3000,0,3000,1000,0,1000,4000
20200316,8440,綠電,12.00,12.45,12.00,12.35,+0.05,0.41,18000,16,219850,0,0,0,0,0,0,0,0,0,0
20200316,8444,綠河-KY,52.00,52.00,47.00,47.00,-5.20,-9.96,95000,41,4499250,0,0,0,0,0,0,0,0,0,0
20200316,8446,華研,96.50,97.00,90.10,90.60,-6.40,-6.6,335000,278,31141400,57600,87000,-29400,0,0,0,2000,1000,1000,-28400
20200316,8450,霹靂,25.85,25.85,24.30,24.70,-0.45,-1.79,39000,26,967700,0,0,0,0,0,0,1000,1000,0,0
20200316,8455,大拓-KY,19.10,19.10,18.65,18.65,-0.70,-3.62,14000,8,264100,0,0,0,0,0,0,0,0,0,0
20200316,8472,夠麻吉,23.70,23.70,23.10,23.30,+0.15,0.65,31000,18,721000,0,0,0,0,0,0,0,0,0,0
20200316,8476,台境,24.50,24.90,22.50,22.85,-1.75,-7.11,188000,115,4473000,0,1000,-1000,0,0,0,8000,0,8000,7000
20200316,8477,創業家,31.50,31.50,30.50,30.50,-0.10,-0.33,98000,46,3036350,0,3000,-3000,0,0,0,0,0,0,-3000
20200316,8489,三貝德,61.40,65.90,60.40,60.40,+0.20,0.33,1655000,1453,104700400,31000,179000,-148000,0,202900,-202900,6000,5000,1000,-349900
20200316,8905,裕國,14.05,14.05,13.45,13.45,-0.55,-3.93,210000,83,2890300,0,0,0,0,0,0,6000,0,6000,6000
20200316,8906,花王,13.40,14.60,13.35,14.60,+1.25,9.36,41000,33,570000,3000,0,3000,0,0,0,0,2000,-2000,1000
20200316,8908,欣雄,44.50,44.95,44.00,44.00,-0.50,-1.12,91000,45,4039800,0,1000,-1000,0,0,0,0,0,0,-1000
20200316,8916,光隆,39.60,40.75,39.00,39.30,+0.30,0.77,287000,163,11368400,0,30000,-30000,0,0,0,0,6000,-6000,-36000
20200316,8916A,光隆甲特,51.90,51.90,51.20,51.40,-0.70,-1.34,75000,47,3862400,0,0,0,0,0,0,14000,7000,7000,7000
20200316,8917,欣泰,50.80,51.50,50.60,51.50,+0.50,0.98,6000,6,307000,0,0,0,0,0,0,0,0,0,0
20200316,8921,沈氏,14.20,14.20,14.20,14.20,-0.05,-0.35,1000,1,14200,0,0,0,0,0,0,0,0,0,0
20200316,8923,時報,14.15,14.25,14.00,14.00,-0.15,-1.06,23000,11,322750,0,0,0,0,0,0,0,0,0,0
20200316,8924,大田,31.15,31.70,30.05,30.20,-0.80,-2.58,653000,365,20248750,90000,81000,9000,0,0,0,19000,0,19000,28000
20200316,8927,北基,14.50,14.50,14.50,14.50,0.00,0.0,5000,1,72500,0,0,0,0,0,0,0,0,0,0
20200316,8928,鉅明,25.00,25.35,24.50,24.80,+0.10,0.4,274000,156,6820350,37000,12000,25000,0,0,0,0,0,0,25000
20200316,8929,富堡,20.15,20.15,19.50,19.50,-0.65,-3.23,45000,34,890850,0,0,0,0,0,0,0,0,0,0
20200316,8930,青鋼,10.65,10.70,10.55,10.55,-0.25,-2.31,76000,31,806400,0,2000,-2000,0,0,0,0,0,0,-2000
20200316,8931,大汽電,27.05,27.65,26.05,27.00,-0.80,-2.88,47000,33,1259250,0,0,0,0,0,0,1000,1000,0,0
20200316,8932,宏大,10.60,10.60,10.30,10.50,-0.50,-4.55,24000,13,250550,0,0,0,0,0,0,3000,0,3000,3000
20200316,8933,愛地雅,4.75,4.75,4.24,4.24,-0.47,-9.98,267000,50,1190170,0,0,0,0,0,0,0,0,0,0
20200316,8934,衡平,34.00,34.00,34.00,34.00,-1.00,-2.86,1000,1,34000,0,0,0,0,0,0,0,0,0,0
20200316,8935,邦泰,7.50,7.78,7.50,7.60,-0.25,-3.18,67000,31,507580,0,0,0,0,0,0,1000,0,1000,1000
20200316,8936,國統,14.15,14.15,12.75,12.90,-1.25,-8.83,2737000,1171,35586600,74000,19000,55000,0,474000,-474000,0,0,0,-419000
20200316,8937,合騏,13.00,13.50,12.80,12.80,-0.75,-5.54,25000,12,324050,0,2000,-2000,0,0,0,0,0,0,-2000
20200316,8938,明安,31.40,31.50,30.55,30.85,+0.05,0.16,272000,164,8387350,2000,33000,-31000,0,24000,-24000,0,0,0,-55000
20200316,8941,關中,39.50,39.50,37.00,37.00,+0.05,0.14,10000,8,378800,0,0,0,0,0,0,0,0,0,0
20200316,8942,森鉅,57.00,57.00,54.80,55.00,-1.80,-3.17,355000,226,19757400,37000,27000,10000,0,0,0,0,9000,-9000,1000
20200316,9949,琉園,12.05,12.15,11.40,11.65,-0.30,-2.51,44000,36,515050,0,0,0,0,0,0,0,0,0,0
20200316,9950,萬國通,10.80,10.85,10.80,10.80,0.00,0.0,21000,6,227050,0,0,0,0,0,0,0,0,0,0
20200316,9951,皇田,61.80,62.00,57.00,58.00,-3.70,-6.0,604000,449,36046700,75000,58000,17000,0,45000,-45000,2000,0,2000,-26000
20200316,9960,邁達康,27.30,28.40,26.10,28.40,-0.10,-0.35,25000,23,684200,0,0,0,0,0,0,1000,1000,0,0
20200316,9962,有益,7.90,8.06,7.63,7.85,-0.23,-2.85,31000,20,245730,0,0,0,0,0,0,0,0,0,0
20200316,020001,富邦存股雙十N,4.55,4.58,4.39,4.39,-0.22,-4.77,1535000,112,6928610,0,0,0,0,0,0,941000,469000,472000,472000
20200316,020003,統一漲升股利150N,9.11,9.11,9.11,9.11,-0.21,-2.25,20000,1,182200,0,0,0,0,0,0,0,20000,-20000,-20000
20200316,020009,群益A50綠碳N,,,,,,0.00,0,0,0,0,0,0,0,0,0,0,0,0,0
20200316,020010,永昌富櫃200N,8.80,8.84,8.69,8.69,-0.12,-1.36,8000,8,70240,0,0,0,0,0,0,4000,3000,1000,1000
20200316,020013,元富亞洲高股息N,12.50,12.50,12.27,12.27,+0.35,2.94,4000,4,49400,0,0,0,0,0,0,2000,2000,0,0
20200316,020014,元大富櫃200N,4.06,4.11,3.89,3.90,-0.16,-3.94,142000,57,570520,0,0,0,0,0,0,54000,77000,-23000,-23000
20200316,72174P,同致中信93售01,0.64,0.74,0.64,0.74,+0.22,42.31,20000,2,13800,0,0,0,0,0,0,20000,0,20000,20000
20200316,72259P,環球晶中信93售01,,,,,,0.00,0,0,0,0,0,0,0,0,0,0,0,0,0
20200316,72339P,頎邦群益93售01,,,,,,0.00,0,0,0,0,0,0,0,0,0,0,0,0,0
20200316,72340P,穩懋凱基93售06,,,,,,0.00,0,0,0,0,0,0,0,0,0,0,0,0,0
20200316,72345P,大江富邦93售02,,,,,,0.00,0,0,0,0,0,0,0,0,0,0,0,0,0
20200316,72356P,雙鴻凱基93售02,0.07,0.07,0.07,0.07,+0.05,250.0,10000,1,700,0,0,0,0,0,0,10000,0,10000,10000
20200316,72358P,譜瑞凱基93售01,,,,,,0.00,0,0,0,0,0,0,0,0,0,0,0,0,0
20200316,72360P,雙鴻國泰93售01,,,,,,0.00,0,0,0,0,0,0,0,0,0,0,0,0,0
20200316,72365P,神盾統一93售01,,,,,,0.00,0,0,0,0,0,0,0,0,0,0,0,0,0
20200316,72366P,力旺凱基93售01,,,,,,0.00,0,0,0,0,0,0,0,0,0,0,0,0,0
20200316,72372P,神盾群益93售01,1.08,1.08,1.08,1.08,+0.19,21.35,3000,1,3240,0,3000,-3000,0,0,0,3000,0,3000,0
20200316,72379P,廣明國泰93售02,,,,,,0.00,0,0,0,0,0,0,0,0,0,0,0,0,0
20200316,72390P,穩懋國泰94售01,,,,,,0.00,0,0,0,0,0,0,0,0,0,0,0,0,0
20200316,72402P,中美晶兆豐94售01,,,,,,0.00,0,0,0,0,0,0,0,0,0,0,0,0,0
20200316,72422P,穩懋凱基93售11,,,,,,0.00,0,0,0,0,0,0,0,0,0,0,0,0,0
20200316,72424P,力旺群益93售02,,,,,,0.00,0,0,0,0,0,0,0,0,0,0,0,0,0
20200316,72426P,宣德群益93售02,,,,,,0.00,0,0,0,0,0,0,0,0,0,0,0,0,0
20200316,72430P,中美晶國票93售01,,,,,,0.00,0,0,0,0,0,0,0,0,0,0,0,0,0
20200316,72431P,穩懋富邦93售05,,,,,,0.00,0,0,0,0,0,0,0,0,0,0,0,0,0
20200316,72436P,威剛群益93售02,,,,,,0.00,0,0,0,0,0,0,0,0,0,0,0,0,0
20200316,72438P,威剛國泰93售02,,,,,,0.00,0,0,0,0,0,0,0,0,0,0,0,0,0
20200316,72444P,穩懋中信94售01,,,,,,0.00,0,0,0,0,0,0,0,0,0,0,0,0,0
20200316,72446P,穩懋凱基93售13,,,,,,0.00,0,0,0,0,0,0,0,0,0,0,0,0,0
20200316,72455P,穩懋中信94售03,0.46,0.46,0.44,0.45,+0.05,12.5,21000,3,9360,0,0,0,0,0,0,0,21000,-21000,-21000
20200316,72456P,信驊凱基93售03,,,,,,0.00,0,0,0,0,0,0,0,0,0,0,0,0,0
20200316,72458P,雙鴻國泰93售03,,,,,,0.00,0,0,0,0,0,0,0,0,0,0,0,0,0
20200316,72472P,穩懋國票94售01,,,,,,0.00,0,0,0,0,0,0,0,0,0,0,0,0,0
20200316,72476P,台半中信95售01,0.89,1.01,0.89,1.01,+0.34,50.75,13000,2,12770,0,0,0,0,0,0,3000,0,3000,3000
20200316,72487P,穩懋亞東94售01,0.40,0.40,0.40,0.40,-0.73,-64.6,10000,1,4000,0,0,0,0,0,0,10000,0,10000,10000
20200316,72488P,中美晶國票94售01,,,,,,0.00,0,0,0,0,0,0,0,0,0,0,0,0,0
20200316,72490P,廣明凱基94售02,4.00,4.01,4.00,4.01,+0.10,2.56,20000,2,80100,0,0,0,0,0,0,0,20000,-20000,-20000
20200316,72501P,大江富邦95售01,1.51,1.52,1.51,1.52,-0.01,-0.65,51000,2,77400,0,0,0,0,0,0,0,51000,-51000,-51000
20200316,72510P,原相群益96售02,0.10,0.11,0.10,0.10,+0.01,11.11,90000,4,9100,0,0,0,0,0,0,20000,0,20000,20000
20200316,72511P,台燿統一93售03,,,,,,0.00,0,0,0,0,0,0,0,0,0,0,0,0,0
20200316,72512P,信驊元富93售02,,,,,,0.00,0,0,0,0,0,0,0,0,0,0,0,0,0
20200316,72513P,原相永豐93售03,,,,,,0.00,0,0,0,0,0,0,0,0,0,0,0,0,0
20200316,72514P,優群永豐93售03,,,,,,0.00,0,0,0,0,0,0,0,0,0,0,0,0,0
20200316,72515P,建榮國票93售01,,,,,,0.00,0,0,0,0,0,0,0,0,0,0,0,0,0
20200316,72516P,台燿元大93售05,,,,,,0.00,0,0,0,0,0,0,0,0,0,0,0,0,0
20200316,72517P,大江凱基93售09,,,,,,0.00,0,0,0,0,0,0,0,0,0,0,0,0,0
20200316,72518P,昂寶康和93售01,,,,,,0.00,0,0,0,0,0,0,0,0,0,0,0,0,0
20200316,72519P,晶焱群益93售04,,,,,,0.00,0,0,0,0,0,0,0,0,0,0,0,0,0
20200316,72520P,台燿台新93售02,,,,,,0.00,0,0,0,0,0,0,0,0,0,0,0,0,0
20200316,72521P,台燿國票93售01,,,,,,0.00,0,0,0,0,0,0,0,0,0,0,0,0,0
20200316,72522P,大江元大93售06,,,,,,0.00,0,0,0,0,0,0,0,0,0,0,0,0,0
20200316,72523P,穩懋凱基93售17,,,,,,0.00,0,0,0,0,0,0,0,0,0,0,0,0,0
20200316,72524P,穩懋永豐93售02,,,,,,0.00,0,0,0,0,0,0,0,0,0,0,0,0,0
20200316,72525P,新普凱基93售03,,,,,,0.00,0,0,0,0,0,0,0,0,0,0,0,0,0
20200316,72526P,廣明永豐93售02,,,,,,0.00,0,0,0,0,0,0,0,0,0,0,0,0,0
20200316,72527P,神盾國票93售02,,,,,,0.00,0,0,0,0,0,0,0,0,0,0,0,0,0
20200316,72528P,大田永豐93售02,1.24,1.24,1.24,1.24,-0.19,-13.29,36000,1,44640,0,0,0,0,0,0,36000,0,36000,36000
20200316,72529P,信驊永豐93售01,,,,,,0.00,0,0,0,0,0,0,0,0,0,0,0,0,0
20200316,72530P,環球晶兆豐93售02,,,,,,0.00,0,0,0,0,0,0,0,0,0,0,0,0,0
20200316,72531P,環球晶群益93售03,,,,,,0.00,0,0,0,0,0,0,0,0,0,0,0,0,0
20200316,72532P,穩懋國泰93售02,,,,,,0.00,0,0,0,0,0,0,0,0,0,0,0,0,0
20200316,72533P,中美晶元富94售01,,,,,,0.00,0,0,0,0,0,0,0,0,0,0,0,0,0
20200316,72534P,金居元富94售01,,,,,,0.00,0,0,0,0,0,0,0,0,0,0,0,0,0
20200316,72535P,雙鴻群益95售01,1.36,1.36,1.36,1.36,+0.06,4.62,1000,1,1360,0,0,0,0,0,0,0,1000,-1000,-1000
20200316,72536P,網龍國票93售01,,,,,,0.00,0,0,0,0,0,0,0,0,0,0,0,0,0
20200316,72537P,大江永豐93售06,,,,,,0.00,0,0,0,0,0,0,0,0,0,0,0,0,0
20200316,72538P,碩禾永豐93售01,,,,,,0.00,0,0,0,0,0,0,0,0,0,0,0,0,0
20200316,72539P,環球晶元大93售12,,,,,,0.00,0,0,0,0,0,0,0,0,0,0,0,0,0
20200316,72540P,世界國票93售01,,,,,,0.00,0,0,0,0,0,0,0,0,0,0,0,0,0
20200316,72541P,精華國票93售01,,,,,,0.00,0,0,0,0,0,0,0,0,0,0,0,0,0
20200316,72542P,環球晶元富94售01,0.50,0.52,0.45,0.52,+0.14,36.84,22000,3,11260,0,0,0,0,0,0,18000,2000,16000,16000
20200316,72543P,環球晶元大93售13,,,,,,0.00,0,0,0,0,0,0,0,0,0,0,0,0,0
20200316,72544P,中美晶永豐93售04,,,,,,0.00,0,0,0,0,0,0,0,0,0,0,0,0,0
20200316,72545P,緯軟永豐93售02,,,,,,0.00,0,0,0,0,0,0,0,0,0,0,0,0,0
20200316,72546P,新普元大93售04,,,,,,0.00,0,0,0,0,0,0,0,0,0,0,0,0,0
20200316,72547P,廣明元大93售04,,,,,,0.00,0,0,0,0,0,0,0,0,0,0,0,0,0
20200316,72548P,大江統一96售01,,,,,,0.00,0,0,0,0,0,0,0,0,0,0,0,0,0
20200316,72549P,穩懋統一94售03,,,,,,0.00,0,0,0,0,0,0,0,0,0,0,0,0,0
20200316,72550P,聯亞國票94售02,,,,,,0.00,0,0,0,0,0,0,0,0,0,0,0,0,0
20200316,72551P,金居國泰94售02,1.03,1.03,1.03,1.03,0.00,0.0,50000,1,51500,0,0,0,0,0,0,0,50000,-50000,-50000
20200316,72552P,良維永豐93售02,,,,,,0.00,0,0,0,0,0,0,0,0,0,0,0,0,0
20200316,72553P,金居永豐93售02,,,,,,0.00,0,0,0,0,0,0,0,0,0,0,0,0,0
20200316,72554P,神盾永豐93售04,2.50,2.50,2.50,2.50,+0.34,15.74,26000,1,65000,0,0,0,0,0,0,26000,0,26000,26000
20200316,72555P,環球晶凱基94售02,,,,,,0.00,0,0,0,0,0,0,0,0,0,0,0,0,0
20200316,72556P,環球晶元富95售01,0.33,0.41,0.30,0.41,+0.10,32.26,320000,8,112350,0,0,0,0,0,0,320000,0,320000,320000
20200316,72557P,晶焱元大94售01,,,,,,0.00,0,0,0,0,0,0,0,0,0,0,0,0,0
20200316,72558P,聯亞元大94售02,,,,,,0.00,0,0,0,0,0,0,0,0,0,0,0,0,0
20200316,72559P,由田永豐94售01,,,,,,0.00,0,0,0,0,0,0,0,0,0,0,0,0,0
20200316,72560P,佳邦永豐94售01,0.87,0.89,0.87,0.89,-0.19,-17.59,110000,2,97100,0,0,0,0,0,0,110000,0,110000,110000
20200316,72561P,昇達科永豐94售01,,,,,,0.00,0,0,0,0,0,0,0,0,0,0,0,0,0
20200316,72562P,原相永豐94售01,,,,,,0.00,0,0,0,0,0,0,0,0,0,0,0,0,0
20200316,72563P,晶焱永豐94售01,0.35,0.36,0.35,0.36,0.00,0.0,100000,2,35500,0,0,0,0,0,0,100000,0,100000,100000
20200316,72564P,新普永豐94售01,,,,,,0.00,0,0,0,0,0,0,0,0,0,0,0,0,0
20200316,72565P,台燿兆豐94售01,0.64,0.64,0.55,0.57,-0.06,-9.52,44000,13,26680,0,0,0,0,0,0,44000,0,44000,44000
20200316,72566P,大江群益94售03,,,,,,0.00,0,0,0,0,0,0,0,0,0,0,0,0,0
20200316,72567P,神盾群益94售03,,,,,,0.00,0,0,0,0,0,0,0,0,0,0,0,0,0
20200316,72568P,新普群益96售01,0.73,0.73,0.73,0.73,+0.11,17.74,16000,1,11680,0,0,0,0,0,0,0,16000,-16000,-16000
20200316,72569P,大學光元大94售04,0.07,0.13,0.07,0.12,+0.02,20.0,133000,14,16460,0,0,0,0,0,0,33000,100000,-67000,-67000
20200316,72570P,環球晶元大94售01,,,,,,0.00,0,0,0,0,0,0,0,0,0,0,0,0,0
20200316,72571P,鐿鈦永豐94售02,,,,,,0.00,0,0,0,0,0,0,0,0,0,0,0,0,0
20200316,72572P,網家元富96售02,2.58,2.58,2.58,2.58,-0.14,-5.15,2000,1,5160,0,0,0,0,0,0,0,2000,-2000,-2000
20200316,72573P,原相亞東94售01,,,,,,0.00,0,0,0,0,0,0,0,0,0,0,0,0,0
20200316,72574P,環球晶永豐94售01,,,,,,0.00,0,0,0,0,0,0,0,0,0,0,0,0,0
20200316,72575P,環球晶元富95售02,0.52,0.54,0.52,0.54,+0.20,58.82,30000,2,15800,0,0,0,0,0,0,30000,0,30000,30000
20200316,72576P,緯軟元大94售05,,,,,,0.00,0,0,0,0,0,0,0,0,0,0,0,0,0
20200316,72577P,環球晶元大94售03,,,,,,0.00,0,0,0,0,0,0,0,0,0,0,0,0,0
20200316,72578P,雙鴻元大95售01,1.48,1.96,1.48,1.96,+0.37,23.27,29000,6,50070,0,0,0,0,0,0,10000,19000,-9000,-9000
20200316,72579P,穩懋元大94售02,0.61,0.61,0.51,0.51,+0.07,15.91,20000,2,11200,0,0,0,0,0,0,0,20000,-20000,-20000
20200316,72580P,台燿凱基94售02,,,,,,0.00,0,0,0,0,0,0,0,0,0,0,0,0,0
20200316,72581P,穩懋元大94售03,1.01,1.32,1.00,1.32,+0.12,10.0,70000,5,76550,0,0,0,0,0,0,40000,30000,10000,10000
20200316,72582P,櫃200群益94售01,0.97,0.97,0.97,0.97,-0.42,-30.22,1000,1,970,0,0,0,0,0,0,0,1000,-1000,-1000
20200316,72583P,聯亞國票95售02,,,,,,0.00,0,0,0,0,0,0,0,0,0,0,0,0,0
20200316,72584P,大江永豐94售01,,,,,,0.00,0,0,0,0,0,0,0,0,0,0,0,0,0
20200316,72585P,宏捷科永豐94售01,,,,,,0.00,0,0,0,0,0,0,0,0,0,0,0,0,0
20200316,72586P,宏捷科國泰95售02,0.42,0.58,0.41,0.58,+0.15,34.88,1668000,67,876780,0,0,0,0,0,0,4000,1644000,-1640000,-1640000
20200316,72587P,宏捷科國票95售01,1.03,1.40,0.95,1.40,+0.35,33.33,447000,33,499660,0,0,0,0,0,0,264000,30000,234000,234000
20200316,72588P,大江凱基94售05,2.48,2.48,2.48,2.48,+0.10,4.2,10000,1,24800,0,0,0,0,0,0,10000,0,10000,10000
20200316,72589P,櫃200第一94售02,,,,,,0.00,0,0,0,0,0,0,0,0,0,0,0,0,0
20200316,72590P,聯亞永豐94售01,,,,,,0.00,0,0,0,0,0,0,0,0,0,0,0,0,0
20200316,72591P,神盾元大95售04,,,,,,0.00,0,0,0,0,0,0,0,0,0,0,0,0,0
20200316,72592P,環球晶元大94售06,0.06,0.07,0.06,0.07,+0.05,250.0,30000,3,1900,0,0,0,0,0,0,0,30000,-30000,-30000
20200316,72593P,聯亞元大94售03,,,,,,0.00,0,0,0,0,0,0,0,0,0,0,0,0,0
20200316,72594P,雙鴻國泰96售03,1.89,1.89,1.89,1.89,-0.14,-6.9,5000,1,9450,0,0,0,0,0,0,5000,0,5000,5000
20200316,72595P,大江富邦96售01,,,,,,0.00,0,0,0,0,0,0,0,0,0,0,0,0,0
20200316,72596P,環球晶凱基94售04,,,,,,0.00,0,0,0,0,0,0,0,0,0,0,0,0,0
20200316,72597P,晟德凱基94售02,,,,,,0.00,0,0,0,0,0,0,0,0,0,0,0,0,0
20200316,72598P,中美晶群益94售02,,,,,,0.00,0,0,0,0,0,0,0,0,0,0,0,0,0
20200316,72599P,台燿群益94售01,,,,,,0.00,0,0,0,0,0,0,0,0,0,0,0,0,0
20200316,72600P,櫃200永昌94售03,,,,,,0.00,0,0,0,0,0,0,0,0,0,0,0,0,0
20200316,72601P,信昌電永豐94售02,,,,,,0.00,0,0,0,0,0,0,0,0,0,0,0,0,0
20200316,72602P,中美晶兆豐95售01,,,,,,0.00,0,0,0,0,0,0,0,0,0,0,0,0,0
20200316,72603P,櫃200富邦94售05,,,,,,0.00,0,0,0,0,0,0,0,0,0,0,0,0,0
20200316,72604P,櫃200富邦94售06,,,,,,0.00,0,0,0,0,0,0,0,0,0,0,0,0,0
20200316,72605P,凡甲統一94售02,0.50,0.51,0.50,0.51,+0.01,2.0,20000,2,10100,0,0,0,0,0,0,0,20000,-20000,-20000
20200316,72606P,聯亞凱基94售03,,,,,,0.00,0,0,0,0,0,0,0,0,0,0,0,0,0
20200316,72607P,元太元大94售02,1.29,1.35,1.29,1.35,-0.09,-6.25,11000,2,14250,0,0,0,0,0,0,1000,10000,-9000,-9000
20200316,72608P,大江台新94售02,,,,,,0.00,0,0,0,0,0,0,0,0,0,0,0,0,0
20200316,72609P,環球晶台新94售01,0.34,0.34,0.34,0.34,0.00,0.0,4000,1,1360,0,0,0,0,0,0,4000,0,4000,4000
20200316,72610P,中美晶凱基94售02,0.51,0.74,0.51,0.72,+0.13,22.03,92000,5,59390,0,0,0,0,0,0,32000,60000,-28000,-28000
20200316,72611P,雙鴻凱基96售02,1.84,2.05,1.84,2.03,+0.26,14.69,56000,13,105560,0,0,0,0,0,0,26000,46000,-20000,-20000
20200316,72612P,環球晶永豐94售03,0.37,0.42,0.37,0.42,+0.14,50.0,30000,3,12000,0,0,0,0,0,0,0,30000,-30000,-30000
20200316,72613P,緯軟群益95售01,,,,,,0.00,0,0,0,0,0,0,0,0,0,0,0,0,0
20200316,72614P,台燿元大94售02,,,,,,0.00,0,0,0,0,0,0,0,0,0,0,0,0,0
20200316,72615P,晶焱元大95售02,1.22,1.33,1.22,1.33,+0.08,6.4,20000,3,26050,0,0,0,0,0,0,0,20000,-20000,-20000
20200316,72616P,環球晶元大94售07,,,,,,0.00,0,0,0,0,0,0,0,0,0,0,0,0,0
20200316,72617P,原相兆豐95售01,0.10,0.14,0.10,0.14,+0.04,40.0,1061000,36,120520,0,0,0,0,0,0,0,1061000,-1061000,-1061000
20200316,72618P,台燿元大94售05,,,,,,0.00,0,0,0,0,0,0,0,0,0,0,0,0,0
20200316,72619P,環球晶元大94售08,,,,,,0.00,0,0,0,0,0,0,0,0,0,0,0,0,0
20200316,72620P,雙鴻元大94售01,6.30,6.30,6.30,6.30,+0.50,8.62,2000,1,12600,0,0,0,0,0,0,0,0,0,0
20200316,72621P,台燿凱基94售03,,,,,,0.00,0,0,0,0,0,0,0,0,0,0,0,0,0
20200316,72622P,聯亞凱基94售04,0.44,0.50,0.44,0.48,-0.06,-11.11,91000,5,41600,0,0,0,0,0,0,6000,85000,-79000,-79000
20200316,72623P,穩懋富邦96售02,1.12,1.22,1.10,1.17,+0.04,3.54,90000,32,105610,0,0,0,0,0,0,60000,20000,40000,40000
20200316,72624P,櫃200第一96售02,,,,,,0.00,0,0,0,0,0,0,0,0,0,0,0,0,0
20200316,72625P,雙鴻永豐94售02,2.77,3.29,2.77,3.29,+0.33,11.15,5000,5,14790,0,0,0,0,0,0,3000,2000,1000,1000
20200316,72626P,環球晶兆豐95售03,,,,,,0.00,0,0,0,0,0,0,0,0,0,0,0,0,0
20200316,72627P,新鉅科康和94售02,,,,,,0.00,0,0,0,0,0,0,0,0,0,0,0,0,0
20200316,72628P,宏捷科群益94售02,0.95,1.10,0.95,1.10,+0.12,12.24,32000,4,31300,0,0,0,0,0,0,2000,30000,-28000,-28000
20200316,72629P,安勤統一94售02,,,,,,0.00,0,0,0,0,0,0,0,0,0,0,0,0,0
20200316,72630P,中美晶凱基94售04,0.75,0.75,0.75,0.75,+0.01,1.35,10000,1,7500,0,0,0,0,0,0,0,10000,-10000,-10000
20200316,72631P,台燿元大94售07,,,,,,0.00,0,0,0,0,0,0,0,0,0,0,0,0,0
20200316,72632P,環球晶元大94售12,,,,,,0.00,0,0,0,0,0,0,0,0,0,0,0,0,0
20200316,72633P,聯亞元大95售02,0.67,0.79,0.65,0.79,-0.09,-10.23,557000,43,383270,0,0,0,0,0,0,202000,355000,-153000,-153000
20200316,72634P,環球晶元富94售05,0.82,0.93,0.80,0.93,+0.03,3.33,71000,5,61160,0,0,0,0,0,0,71000,0,71000,71000
20200316,72635P,安勤統一94售03,,,,,,0.00,0,0,0,0,0,0,0,0,0,0,0,0,0
20200316,72636P,安勤統一94售04,,,,,,0.00,0,0,0,0,0,0,0,0,0,0,0,0,0
20200316,72637P,穩懋永豐94售02,1.30,1.57,1.26,1.57,-0.84,-34.85,23000,5,33840,0,0,0,0,0,0,1000,22000,-21000,-21000
20200316,72638P,中美晶元富95售03,0.78,1.06,0.78,1.01,+0.21,26.25,43000,4,41110,0,0,0,0,0,0,33000,10000,23000,23000
20200316,72639P,台燿元富94售02,0.70,0.70,0.70,0.70,0.00,0.0,30000,1,21000,0,0,0,0,0,0,30000,0,30000,30000
20200316,72640P,元太凱基94售02,,,,,,0.00,0,0,0,0,0,0,0,0,0,0,0,0,0
20200316,72641P,環球晶群益94售06,,,,,,0.00,0,0,0,0,0,0,0,0,0,0,0,0,0
20200316,72642P,台燿永豐94售02,0.87,0.99,0.85,0.85,-0.06,-6.59,53000,4,47470,0,0,0,0,0,0,30000,23000,7000,7000
20200316,72643P,神盾永豐94售02,4.17,4.17,4.17,4.17,+0.49,13.32,10000,1,41700,0,0,0,0,0,0,0,10000,-10000,-10000
20200316,72644P,台燿元大94售08,,,,,,0.00,0,0,0,0,0,0,0,0,0,0,0,0,0
20200316,72645P,環球晶國票94售01,,,,,,0.00,0,0,0,0,0,0,0,0,0,0,0,0,0
20200316,72646P,穩懋統一94售05,2.57,2.67,2.57,2.67,-0.78,-22.61,20000,2,52400,0,0,0,0,0,0,20000,0,20000,20000
20200316,72647P,中美晶凱基94售05,0.49,0.49,0.49,0.49,+0.12,32.43,24000,1,11760,0,0,0,0,0,0,0,24000,-24000,-24000
20200316,72648P,聯亞凱基94售05,,,,,,0.00,0,0,0,0,0,0,0,0,0,0,0,0,0
20200316,72649P,大江元富94售02,3.21,3.21,3.21,3.21,-0.39,-10.83,10000,1,32100,0,0,0,0,0,0,10000,0,10000,10000
20200316,72650P,威剛永豐94售03,,,,,,0.00,0,0,0,0,0,0,0,0,0,0,0,0,0
20200316,72651P,世界元大94售01,0.64,0.67,0.64,0.67,+0.08,13.56,20000,3,13250,0,0,0,0,0,0,10000,10000,0,0
20200316,72652P,環球晶元大94售17,1.08,1.21,1.08,1.21,+0.48,65.75,15000,2,16850,0,0,0,0,0,0,0,15000,-15000,-15000
20200316,72653P,宣德永豐94售02,,,,,,0.00,0,0,0,0,0,0,0,0,0,0,0,0,0
20200316,72654P,環球晶中信94售02,0.31,0.50,0.31,0.50,+0.12,31.58,71000,6,24850,0,0,0,0,0,0,0,71000,-71000,-71000
20200316,72655P,穩懋統一96售03,2.80,2.80,2.80,2.80,-0.09,-3.11,5000,1,14000,0,0,0,0,0,0,0,5000,-5000,-5000
20200316,72656P,台燿元富94售05,1.56,1.67,1.43,1.46,-0.09,-5.81,46000,13,68930,0,0,0,0,0,0,46000,0,46000,46000
20200316,72657P,環球晶元富94售06,0.90,1.00,0.90,1.00,-0.11,-9.91,35000,3,32670,0,0,0,0,0,0,35000,0,35000,35000
20200316,72658P,建榮國票95售03,,,,,,0.00,0,0,0,0,0,0,0,0,0,0,0,0,0
20200316,72659P,穩懋元大94售11,,,,,,0.00,0,0,0,0,0,0,0,0,0,0,0,0,0
20200316,72660P,穩懋統一94售08,,,,,,0.00,0,0,0,0,0,0,0,0,0,0,0,0,0
20200316,72661P,穩懋中信96售01,1.27,1.27,1.27,1.27,-0.33,-20.62,1000,1,1270,0,0,0,0,0,0,0,1000,-1000,-1000
20200316,72662P,穩懋中信98售01,1.00,1.13,1.00,1.13,-0.07,-5.83,12000,3,13170,0,0,0,0,0,0,3000,9000,-6000,-6000
20200316,72663P,神盾元富96售01,,,,,,0.00,0,0,0,0,0,0,0,0,0,0,0,0,0
20200316,72664P,精華元富94售02,,,,,,0.00,0,0,0,0,0,0,0,0,0,0,0,0,0
20200316,72665P,聯亞元富94售02,,,,,,0.00,0,0,0,0,0,0,0,0,0,0,0,0,0
20200316,72666P,神盾元大94售06,,,,,,0.00,0,0,0,0,0,0,0,0,0,0,0,0,0
20200316,72667P,台燿凱基94售06,1.58,1.58,1.58,1.58,-0.02,-1.25,40000,1,63200,0,0,0,0,0,0,40000,0,40000,40000
20200316,72668P,網龍康和94售01,1.46,1.59,1.46,1.59,+0.02,1.27,7000,2,10870,0,0,0,0,0,0,0,7000,-7000,-7000
20200316,72669P,原相凱基95售01,0.19,0.33,0.19,0.33,+0.13,65.0,155000,12,45960,0,0,0,0,0,0,25000,130000,-105000,-105000
20200316,72670P,環球晶凱基95售02,1.49,2.08,1.49,2.06,+0.42,25.61,60000,6,114150,0,0,0,0,0,0,50000,60000,-10000,-10000
20200316,72671P,穩懋元富95售04,1.28,1.50,1.28,1.50,+0.08,5.63,186000,15,256870,0,0,0,0,0,0,60000,101000,-41000,-41000
20200316,72672P,穩懋國票96售01,,,,,,0.00,0,0,0,0,0,0,0,0,0,0,0,0,0
20200316,72673P,穩懋國泰96售01,,,,,,0.00,0,0,0,0,0,0,0,0,0,0,0,0,0
20200316,72674P,環球晶富邦97售02,0.65,0.82,0.62,0.82,+0.11,15.49,274000,20,208340,5000,0,5000,0,0,0,222000,21000,201000,206000
20200316,72675P,環球晶凱基95售03,0.36,0.45,0.35,0.45,+0.13,40.62,19000,3,8170,0,0,0,0,0,0,2000,17000,-15000,-15000
20200316,72676P,金居元大95售03,,,,,,0.00,0,0,0,0,0,0,0,0,0,0,0,0,0
20200316,72677P,中美晶永豐95售02,,,,,,0.00,0,0,0,0,0,0,0,0,0,0,0,0,0
20200316,72678P,穩懋永豐95售01,,,,,,0.00,0,0,0,0,0,0,0,0,0,0,0,0,0
20200316,72679P,譜瑞中信95售02,,,,,,0.00,0,0,0,0,0,0,0,0,0,0,0,0,0
20200316,72680P,穩懋元大95售01,3.07,3.07,3.07,3.07,-1.28,-29.43,30000,3,92100,0,0,0,0,0,0,30000,30000,0,0
20200316,72681P,合晶永豐95售01,,,,,,0.00,0,0,0,0,0,0,0,0,0,0,0,0,0
20200316,72682P,良維永豐95售01,2.37,2.49,2.37,2.49,+0.16,6.87,20000,3,48700,0,0,0,0,0,0,10000,10000,0,0
20200316,72683P,碩禾永豐95售02,1.02,1.06,1.02,1.06,+0.10,10.42,3000,2,3140,0,0,0,0,0,0,0,2000,-2000,-2000
20200316,72684P,大江國票96售02,,,,,,0.00,0,0,0,0,0,0,0,0,0,0,0,0,0
20200316,72685P,中美晶元富95售05,0.66,0.66,0.66,0.66,-0.16,-19.51,20000,1,13200,0,0,0,0,0,0,20000,0,20000,20000
20200316,72686P,新普群益97售03,1.20,1.50,1.20,1.50,+0.25,20.0,610000,7,807290,0,0,0,0,0,0,510000,100000,410000,410000
20200316,72687P,譜瑞元大95售03,0.64,0.73,0.56,0.73,-0.01,-1.35,650000,68,415470,0,0,0,0,0,0,80000,570000,-490000,-490000
20200316,72688P,環球晶凱基95售05,1.94,2.72,1.94,2.70,+0.47,21.08,324000,18,712100,0,0,0,0,0,0,206000,168000,38000,38000
20200316,72689P,環宇國票96售01,2.17,2.17,2.17,2.17,+0.03,1.4,10000,1,21700,0,0,0,0,0,0,0,10000,-10000,-10000
20200316,72690P,聯亞台新95售02,,,,,,0.00,0,0,0,0,0,0,0,0,0,0,0,0,0
20200316,72691P,穩懋台新95售01,2.24,2.58,2.24,2.58,+0.28,12.17,58000,4,145300,0,0,0,0,0,0,4000,54000,-50000,-50000
20200316,72692P,中美晶群益95售01,1.12,1.12,1.12,1.12,-0.08,-6.67,10000,1,11200,0,0,0,0,0,0,10000,0,10000,10000
20200316,72693P,環球晶凱基95售07,0.58,0.79,0.54,0.78,+0.48,160.0,55000,5,37700,0,0,0,0,0,0,30000,55000,-25000,-25000
20200316,72694P,櫃200元大95售02,,,,,,0.00,0,0,0,0,0,0,0,0,0,0,0,0,0
20200316,72695P,穩懋元大95售03,,,,,,0.00,0,0,0,0,0,0,0,0,0,0,0,0,0
20200316,72696P,穩懋兆豐95售02,0.75,0.85,0.65,0.80,+0.06,8.11,150000,13,114460,0,0,0,0,0,0,60000,72000,-12000,-12000
20200316,72697P,穩懋亞東96售01,,,,,,0.00,0,0,0,0,0,0,0,0,0,0,0,0,0
20200316,72698P,環球晶凱基95售08,,,,,,0.00,0,0,0,0,0,0,0,0,0,0,0,0,0
20200316,72699P,大江元大95售03,,,,,,0.00,0,0,0,0,0,0,0,0,0,0,0,0,0
20200316,72700P,中美晶元大95售03,0.43,0.45,0.41,0.45,-0.02,-4.26,104000,5,45720,0,0,0,0,0,0,94000,10000,84000,84000
20200316,72701P,穩懋元大95售05,3.32,3.99,3.25,3.99,-0.54,-11.92,162000,18,552890,0,0,0,0,0,0,62000,160000,-98000,-98000
20200316,72702P,精華元富95售02,3.34,3.34,3.34,3.34,-0.12,-3.47,3000,1,10020,0,0,0,0,0,0,3000,0,3000,3000
20200316,72703P,聯亞群益96售01,,,,,,0.00,0,0,0,0,0,0,0,0,0,0,0,0,0
20200316,72704P,大江國票96售03,,,,,,0.00,0,0,0,0,0,0,0,0,0,0,0,0,0
20200316,72705P,原相永豐95售01,0.19,0.20,0.19,0.20,-0.03,-13.04,130000,2,25900,0,0,0,0,0,0,130000,0,130000,130000
20200316,72706P,環球晶國泰96售02,1.46,1.84,1.33,1.84,+0.45,32.37,2378000,80,3658170,0,0,0,0,0,0,1443000,1480000,-37000,-37000
20200316,72707P,中美晶國票96售02,0.59,0.59,0.59,0.59,-0.05,-7.81,136000,1,80240,0,0,0,0,0,0,136000,0,136000,136000
20200316,72708P,環球晶群益95售03,1.54,1.70,1.54,1.70,+0.21,14.09,15000,3,24450,0,0,0,0,0,0,15000,0,15000,15000
20200316,72709P,新鉅科康和95售01,2.11,2.18,2.11,2.18,-0.28,-11.38,13000,2,27780,0,0,0,0,0,0,8000,0,8000,8000
20200316,72710P,神盾元大95售06,,,,,,0.00,0,0,0,0,0,0,0,0,0,0,0,0,0
20200316,72711P,櫃200永昌96售05,,,,,,0.00,0,0,0,0,0,0,0,0,0,0,0,0,0
20200316,72712P,環球晶元大95售11,0.74,0.92,0.72,0.92,+0.24,35.29,240000,23,201320,0,0,0,0,0,0,130000,145000,-15000,-15000
20200316,72713P,櫃200元大96售01,,,,,,0.00,0,0,0,0,0,0,0,0,0,0,0,0,0
20200316,72714P,櫃200元大96售02,,,,,,0.00,0,0,0,0,0,0,0,0,0,0,0,0,0
20200316,72715P,雙鴻統一95售01,,,,,,0.00,0,0,0,0,0,0,0,0,0,0,0,0,0
20200316,72716P,穩懋統一96售04,2.98,2.98,2.98,2.98,-1.25,-29.55,5000,1,14900,0,0,0,0,0,0,0,5000,-5000,-5000
20200316,72717P,穩懋元富95售07,,,,,,0.00,0,0,0,0,0,0,0,0,0,0,0,0,0
20200316,72718P,穩懋元富95售08,1.75,2.11,1.75,2.11,-0.48,-18.53,18000,10,34910,0,0,0,0,0,0,10000,18000,-8000,-8000
20200316,72719P,原相亞東96售02,0.24,0.24,0.24,0.24,-0.02,-7.69,100000,1,24000,0,0,0,0,0,0,0,100000,-100000,-100000
20200316,72720P,元太元大95售03,2.45,2.87,2.45,2.87,+0.08,2.87,6000,2,15120,0,0,0,0,0,0,1000,5000,-4000,-4000
20200316,72721P,宣德永豐95售02,,,,,,0.00,0,0,0,0,0,0,0,0,0,0,0,0,0
20200316,72722P,穩懋統一95售01,,,,,,0.00,0,0,0,0,0,0,0,0,0,0,0,0,0
20200316,72723P,穩懋統一95售02,,,,,,0.00,0,0,0,0,0,0,0,0,0,0,0,0,0
20200316,72724P,威剛凱基95售01,0.10,0.13,0.10,0.13,+0.08,160.0,61000,5,6530,0,0,0,0,0,0,0,61000,-61000,-61000
20200316,72725P,環球晶元大95售13,0.68,1.01,0.63,1.00,+0.32,47.06,60000,7,51900,0,0,0,0,0,0,50000,50000,0,0
20200316,72726P,穩懋元大95售08,3.47,3.92,3.47,3.92,-1.18,-23.14,54000,6,192480,0,0,0,0,0,0,30000,54000,-24000,-24000
20200316,72727P,雙鴻康和95售01,,,,,,0.00,0,0,0,0,0,0,0,0,0,0,0,0,0
20200316,72728P,穩懋元大95售09,3.57,4.18,3.55,4.18,-0.51,-10.87,82000,9,302580,0,0,0,0,0,0,80000,82000,-2000,-2000
20200316,72729P,櫃200富邦95售04,,,,,,0.00,0,0,0,0,0,0,0,0,0,0,0,0,0
20200316,72730P,櫃200富邦95售05,,,,,,0.00,0,0,0,0,0,0,0,0,0,0,0,0,0
20200316,72731P,櫃200富邦95售06,0.53,0.85,0.53,0.85,0.00,0.0,7000,7,4670,0,0,0,0,0,0,7000,0,7000,7000
20200316,72732P,櫃200T永昌96售05,2.21,2.21,2.21,2.21,+0.16,7.8,5000,1,11050,0,0,0,0,0,0,0,5000,-5000,-5000
20200316,72733P,櫃200凱基96售01,5.45,6.75,5.40,6.70,-0.30,-4.29,224000,13,1326400,0,0,0,0,0,0,0,224000,-224000,-224000
20200316,72734P,櫃200凱基96售02,3.43,4.77,3.43,4.77,+0.50,11.71,55000,8,206600,0,0,0,0,0,0,12000,43000,-31000,-31000
20200316,72735P,穩懋元大95售10,,,,,,0.00,0,0,0,0,0,0,0,0,0,0,0,0,0
20200316,72736P,穩懋元大95售11,3.43,4.15,3.26,3.82,+0.04,1.06,91000,10,323940,0,0,0,0,0,0,82000,89000,-7000,-7000
20200316,72737P,櫃200富邦9A售03,,,,,,0.00,0,0,0,0,0,0,0,0,0,0,0,0,0
20200316,72738P,櫃200富邦9A售04,,,,,,0.00,0,0,0,0,0,0,0,0,0,0,0,0,0
20200316,72739P,中美晶永豐95售04,1.01,1.05,1.01,1.05,-0.06,-5.41,30000,3,31100,0,0,0,0,0,0,30000,30000,0,0
20200316,72740P,中美晶元大95售05,1.37,1.37,1.24,1.31,+0.33,33.67,189000,5,237160,0,0,0,0,0,0,189000,40000,149000,149000
20200316,72741P,良維元大95售03,,,,,,0.00,0,0,0,0,0,0,0,0,0,0,0,0,0
20200316,72742P,雙鴻元大95售03,2.68,3.15,2.68,3.15,+0.44,16.24,15000,3,44640,0,0,0,0,0,0,10000,2000,8000,8000
20200316,72743P,群聯永豐95售02,1.40,1.44,1.40,1.43,+0.17,13.49,50000,5,71200,0,0,0,0,0,0,10000,50000,-40000,-40000
20200316,72744P,神盾元大95售07,3.10,3.10,3.10,3.10,+0.46,17.42,9000,1,27900,0,0,0,0,0,0,9000,0,9000,9000
20200316,72745P,威剛國票96售01,0.29,0.34,0.29,0.34,+0.01,3.03,225000,11,72400,0,0,0,0,0,0,210000,0,210000,210000
20200316,72746P,大江富邦97售02,,,,,,0.00,0,0,0,0,0,0,0,0,0,0,0,0,0
20200316,72747P,櫃200T永昌9C售05,,,,,,0.00,0,0,0,0,0,0,0,0,0,0,0,0,0
20200316,72748P,穩懋康和95售01,1.05,1.05,1.05,1.05,+0.06,6.06,20000,1,21000,0,0,0,0,0,0,0,20000,-20000,-20000
20200316,72749P,金居元大95售04,1.73,1.85,1.73,1.85,+0.05,2.78,4000,2,7160,0,0,0,0,0,0,0,4000,-4000,-4000
20200316,72750P,精華元大95售04,,,,,,0.00,0,0,0,0,0,0,0,0,0,0,0,0,0
20200316,72751P,元太中信95售02,1.07,1.07,1.07,1.07,-0.02,-1.83,65000,1,69550,0,0,0,0,0,0,65000,0,65000,65000
20200316,72752P,環球晶凱基96售02,1.00,1.18,0.97,1.18,+0.33,38.82,170000,8,178070,0,0,0,0,0,0,45000,165000,-120000,-120000
20200316,72753P,新普永豐95售02,1.27,1.57,1.27,1.57,+0.10,6.8,25000,2,37750,0,0,0,0,0,0,5000,20000,-15000,-15000
20200316,72754P,大江群益95售02,,,,,,0.00,0,0,0,0,0,0,0,0,0,0,0,0,0
20200316,72755P,精華凱基95售02,,,,,,0.00,0,0,0,0,0,0,0,0,0,0,0,0,0
20200316,72756P,穩懋凱基95售02,1.78,2.02,1.76,2.02,-0.18,-8.18,31000,3,57180,0,0,0,0,0,0,0,31000,-31000,-31000
20200316,72757P,精華統一95售01,,,,,,0.00,0,0,0,0,0,0,0,0,0,0,0,0,0
20200316,72758P,環球晶凱基95售14,0.72,0.72,0.72,0.72,+0.49,213.04,10000,1,7200,0,0,0,0,0,0,10000,10000,0,0
20200316,72759P,精華永豐95售03,2.73,2.73,2.71,2.71,-0.34,-11.15,25000,2,68050,0,0,0,0,0,0,15000,10000,5000,5000
20200316,72760P,精測元大95售01,2.24,2.59,2.24,2.59,-0.54,-17.25,49000,4,114860,0,0,0,0,0,0,30000,19000,11000,11000
20200316,72761P,中美晶富邦96售01,0.21,0.21,0.21,0.21,-0.03,-12.5,5000,1,1050,0,0,0,0,0,0,0,5000,-5000,-5000
20200316,72762P,穩懋富邦97售02,0.89,1.10,0.89,1.04,+0.09,9.47,544000,51,538830,0,0,0,0,0,0,296000,219000,77000,77000
20200316,72763P,精測中信96售01,1.66,1.66,1.60,1.63,-0.42,-20.49,7000,7,11370,0,0,0,0,0,0,7000,0,7000,7000
20200316,72764P,中美晶凱基96售02,0.34,0.49,0.34,0.49,+0.14,40.0,102000,5,42690,0,0,0,0,0,0,0,102000,-102000,-102000
20200316,72765P,精測國泰97售01,1.48,1.63,1.48,1.61,+0.11,7.33,227000,32,341540,0,0,0,0,0,0,135000,202000,-67000,-67000
20200316,72766P,中美晶富邦97售01,0.36,0.45,0.36,0.45,+0.08,21.62,110000,3,44800,0,0,0,0,0,0,110000,0,110000,110000
20200316,72767P,精測康和96售01,1.40,1.49,1.40,1.49,+0.09,6.43,40000,2,56900,0,0,0,0,0,0,0,40000,-40000,-40000
20200316,72768P,精測凱基96售02,1.31,1.46,1.30,1.44,+0.07,5.11,1344000,9,1870290,0,0,0,0,0,0,627000,1217000,-590000,-590000
20200316,72769P,雙鴻兆豐97售01,,,,,,0.00,0,0,0,0,0,0,0,0,0,0,0,0,0
20200316,72770P,精測永豐96售03,,,,,,0.00,0,0,0,0,0,0,0,0,0,0,0,0,0
20200316,72771P,鈊象元大96售01,0.08,0.14,0.07,0.14,+0.04,40.0,303000,32,28720,0,0,0,0,0,0,15000,288000,-273000,-273000
20200316,72772P,同致國票97售01,3.11,3.11,3.11,3.11,+0.18,6.14,10000,1,31100,0,0,0,0,0,0,0,10000,-10000,-10000
20200316,72773P,鈊象國票96售01,0.13,0.13,0.13,0.13,+0.03,30.0,113000,5,14690,0,0,0,0,0,0,0,0,0,0
20200316,72774P,精測群益96售02,,,,,,0.00,0,0,0,0,0,0,0,0,0,0,0,0,0
20200316,72775P,精測統一96售02,2.18,2.18,2.16,2.17,-0.03,-1.36,200000,20,435300,0,0,0,0,0,0,0,200000,-200000,-200000
20200316,72776P,精測凱基96售05,1.06,1.17,1.06,1.17,-0.07,-5.65,8000,2,9030,0,0,0,0,0,0,3000,5000,-2000,-2000
20200316,72777P,櫃200凱基96售04,,,,,,0.00,0,0,0,0,0,0,0,0,0,0,0,0,0
20200316,72778P,櫃200凱基96售05,,,,,,0.00,0,0,0,0,0,0,0,0,0,0,0,0,0
20200316,72779P,鈊象凱基96售02,,,,,,0.00,0,0,0,0,0,0,0,0,0,0,0,0,0
20200316,72780P,鈊象台新96售01,0.08,0.11,0.08,0.11,+0.04,57.14,726000,13,58340,0,0,0,0,0,0,0,726000,-726000,-726000
20200316,72781P,鈊象永豐96售02,,,,,,0.00,0,0,0,0,0,0,0,0,0,0,0,0,0
20200316,72782P,鈊象康和96售01,0.23,0.27,0.22,0.27,+0.08,42.11,588000,7,134420,0,0,0,0,0,0,0,588000,-588000,-588000
20200316,72783P,鈊象群益96售01,0.13,0.30,0.13,0.28,+0.10,55.56,1019000,18,168610,0,0,0,0,0,0,39000,948000,-909000,-909000
20200316,72784P,精測統一96售03,,,,,,0.00,0,0,0,0,0,0,0,0,0,0,0,0,0
20200316,72785P,鈊象元富96售02,0.12,0.20,0.11,0.20,+0.01,5.26,516000,10,69680,0,0,0,0,0,0,91000,425000,-334000,-334000
20200316,72786P,聯亞國票97售02,,,,,,0.00,0,0,0,0,0,0,0,0,0,0,0,0,0
20200316,72787P,精測永豐96售05,,,,,,0.00,0,0,0,0,0,0,0,0,0,0,0,0,0
20200316,72788P,群聯群益96售03,1.66,1.66,1.66,1.66,+0.39,30.71,10000,1,16600,0,0,0,0,0,0,10000,10000,0,0
20200316,72789P,精測群益96售03,,,,,,0.00,0,0,0,0,0,0,0,0,0,0,0,0,0
20200316,72790P,精華群益96售01,,,,,,0.00,0,0,0,0,0,0,0,0,0,0,0,0,0
20200316,72791P,精測凱基96售06,0.97,1.18,0.96,1.18,+0.10,9.26,304000,14,322610,0,0,0,0,0,0,140000,164000,-24000,-24000
20200316,72792P,穩懋國票96售04,,,,,,0.00,0,0,0,0,0,0,0,0,0,0,0,0,0
20200316,72793P,穩懋兆豐96售03,1.37,1.58,1.37,1.58,+0.28,21.54,55000,4,83780,0,0,0,0,0,0,55000,0,55000,55000
20200316,72794P,穩懋兆豐97售01,1.10,1.25,0.99,1.21,+0.11,10.0,140000,29,155420,0,0,0,0,0,0,25000,115000,-90000,-90000
20200316,72795P,鈊象元大96售02,0.09,0.12,0.08,0.12,+0.03,33.33,321000,14,35210,0,0,0,0,0,0,201000,120000,81000,81000
20200316,72796P,穩懋統一97售02,2.23,2.23,2.23,2.23,+0.17,8.25,20000,1,44600,0,0,0,0,0,0,20000,0,20000,20000
20200316,72797P,鈊象統一97售01,0.17,0.17,0.17,0.17,+0.02,13.33,1000,1,170,0,0,0,0,0,0,0,0,0,0
20200316,72798P,穩懋凱基96售08,1.18,1.61,1.18,1.61,+0.28,21.05,123000,24,171520,0,0,0,0,0,0,44000,68000,-24000,-24000
20200316,72799P,世界永豐96售01,,,,,,0.00,0,0,0,0,0,0,0,0,0,0,0,0,0
20200316,72800P,鈊象元富96售03,0.16,0.25,0.16,0.25,-0.02,-7.41,1112000,12,206810,0,0,0,0,0,0,30000,1082000,-1052000,-1052000
20200316,72801P,中美晶元大96售01,1.04,1.31,0.99,1.28,+0.24,23.08,897000,67,980050,0,0,0,0,0,0,650000,874000,-224000,-224000
20200316,72802P,世界元大96售04,2.26,2.50,2.26,2.50,-0.25,-9.09,23000,3,56120,0,0,0,0,0,0,5000,18000,-13000,-13000
20200316,72803P,中美晶中信98售01,0.79,0.82,0.79,0.81,+0.21,35.0,34000,4,27340,0,0,0,0,0,0,0,34000,-34000,-34000
20200316,72804P,世界中信96售02,1.07,1.10,1.07,1.10,-0.03,-2.65,169000,4,183780,0,0,0,0,0,0,0,169000,-169000,-169000
20200316,72805P,鈊象元富96售04,0.14,0.23,0.14,0.23,-0.05,-17.86,2217000,22,398630,0,0,0,0,0,0,20000,2197000,-2177000,-2177000
20200316,72806P,世界康和96售02,1.13,1.24,1.13,1.24,+0.25,25.25,13000,4,15010,0,0,0,0,0,0,0,13000,-13000,-13000
20200316,72807P,網龍群益98售02,1.76,1.96,1.76,1.96,+0.01,0.51,6000,2,11560,0,0,0,0,0,0,1000,5000,-4000,-4000
20200316,72808P,力旺康和96售01,1.69,1.69,1.69,1.69,+0.12,7.64,10000,1,16900,0,0,0,0,0,0,0,10000,-10000,-10000
20200316,72809P,聯亞元富96售01,,,,,,0.00,0,0,0,0,0,0,0,0,0,0,0,0,0
20200316,72810P,雙鴻元富96售02,,,,,,0.00,0,0,0,0,0,0,0,0,0,0,0,0,0
20200316,72811P,鈊象元富96售05,0.14,0.18,0.14,0.18,-0.04,-18.18,20000,2,3200,0,0,0,0,0,0,10000,10000,0,0
20200316,72812P,世界統一96售01,1.61,1.61,1.61,1.61,+0.18,12.59,4000,1,6440,0,0,0,0,0,0,0,4000,-4000,-4000
20200316,72813P,宣德統一97售01,1.08,1.33,1.08,1.33,+0.05,3.91,6000,2,7230,0,0,0,0,0,0,3000,3000,0,0
20200316,72814P,世界群益98售03,2.41,2.41,2.41,2.41,+0.27,12.62,5000,1,12050,0,0,0,0,0,0,0,5000,-5000,-5000
20200316,72815P,宣德元大96售05,2.34,2.86,2.34,2.86,+0.49,20.68,141000,11,347460,0,0,0,0,0,0,126000,141000,-15000,-15000
20200316,72816P,信昌電國票97售02,,,,,,0.00,0,0,0,0,0,0,0,0,0,0,0,0,0
20200316,72817P,網龍國票97售03,,,,,,0.00,0,0,0,0,0,0,0,0,0,0,0,0,0
20200316,72818P,櫃200第一96售05,,,,,,0.00,0,0,0,0,0,0,0,0,0,0,0,0,0
20200316,72819P,櫃200第一96售06,,,,,,0.00,0,0,0,0,0,0,0,0,0,0,0,0,0
20200316,72820P,中美晶兆豐97售01,1.16,1.32,1.12,1.31,+0.16,13.91,305000,12,377190,0,0,0,0,0,0,206000,299000,-93000,-93000
20200316,72821P,櫃200永昌97售02,,,,,,0.00,0,0,0,0,0,0,0,0,0,0,0,0,0
20200316,72822P,櫃200永昌97售03,,,,,,0.00,0,0,0,0,0,0,0,0,0,0,0,0,0
20200316,72823P,櫃200永昌99售04,,,,,,0.00,0,0,0,0,0,0,0,0,0,0,0,0,0
20200316,72824P,櫃200永昌99售05,,,,,,0.00,0,0,0,0,0,0,0,0,0,0,0,0,0
20200316,72825P,緯軟永豐96售01,2.55,2.55,2.55,2.55,+0.01,0.39,5000,2,12750,0,0,0,0,0,0,0,5000,-5000,-5000
20200316,72826P,穩懋統一96售11,,,,,,0.00,0,0,0,0,0,0,0,0,0,0,0,0,0
20200316,72827P,穩懋統一96售12,,,,,,0.00,0,0,0,0,0,0,0,0,0,0,0,0,0
20200316,72828P,新普凱基96售01,1.17,1.40,1.10,1.40,+0.02,1.45,565000,25,738590,0,0,0,0,0,0,30000,535000,-505000,-505000
20200316,72829P,神盾群益98售02,1.45,1.73,1.45,1.73,+0.21,13.82,171000,18,274480,0,0,0,0,0,0,73000,55000,18000,18000
20200316,72830P,櫃200永昌9B售02,,,,,,0.00,0,0,0,0,0,0,0,0,0,0,0,0,0
20200316,72831P,櫃200永昌9B售03,5.00,5.00,5.00,5.00,+0.45,9.89,1000,1,5000,0,0,0,0,0,0,0,0,0,0
20200316,72832P,櫃200永昌9C售04,2.99,3.37,2.96,3.37,+0.27,8.71,81000,9,246370,0,0,0,0,0,0,1000,70000,-69000,-69000
20200316,72833P,櫃200永昌9C售05,,,,,,0.00,0,0,0,0,0,0,0,0,0,0,0,0,0
20200316,72834P,威剛元富99售01,1.40,1.52,1.40,1.48,+0.06,4.23,20000,11,29040,0,0,0,0,0,0,10000,10000,0,0
20200316,72835P,環球晶中信9A售01,1.06,1.29,1.06,1.29,+0.26,25.24,282000,29,323430,0,0,0,0,0,0,0,252000,-252000,-252000
20200316,72836P,聯亞永豐96售02,1.68,1.68,1.68,1.68,-0.18,-9.68,10000,1,16800,0,0,0,0,0,0,0,10000,-10000,-10000
20200316,72837P,雙鴻永豐96售01,,,,,,0.00,0,0,0,0,0,0,0,0,0,0,0,0,0
20200316,72838P,M31元大96售03,2.37,2.86,2.37,2.86,+0.54,23.28,23000,4,55100,0,0,0,0,0,0,2000,21000,-19000,-19000
20200316,72839P,世界元富96售03,,,,,,0.00,0,0,0,0,0,0,0,0,0,0,0,0,0
20200316,72840P,聖暉統一97售01,0.85,0.85,0.85,0.85,-0.17,-16.67,30000,3,25500,0,0,0,0,0,0,30000,0,30000,30000
20200316,72841P,環球晶凱基96售09,1.52,2.04,1.52,2.04,+0.53,35.1,283000,21,494800,0,0,0,0,0,0,94000,233000,-139000,-139000
20200316,72842P,宣德永豐96售02,,,,,,0.00,0,0,0,0,0,0,0,0,0,0,0,0,0
20200316,72843P,精測永豐96售11,,,,,,0.00,0,0,0,0,0,0,0,0,0,0,0,0,0
20200316,72844P,精測國泰97售03,2.68,2.90,2.61,2.90,-0.19,-6.15,29000,7,78110,0,0,0,0,0,0,3000,26000,-23000,-23000
20200316,72845P,精測元大96售05,2.95,3.19,2.95,3.19,+0.10,3.24,27000,5,82310,0,0,0,0,0,0,17000,10000,7000,7000
20200316,72846P,穩懋元大96售08,1.61,1.93,1.54,1.84,+0.07,3.95,196000,19,325840,0,0,0,0,0,0,135000,181000,-46000,-46000
20200316,72847P,鈊象元大96售05,0.25,0.42,0.25,0.42,+0.11,35.48,208000,26,61370,0,0,0,0,0,0,63000,145000,-82000,-82000
20200316,72848P,信驊康和96售01,0.68,0.80,0.65,0.77,+0.06,8.45,147000,20,105650,0,0,0,0,0,0,10000,52000,-42000,-42000
20200316,72849P,櫃200永昌98售03,,,,,,0.00,0,0,0,0,0,0,0,0,0,0,0,0,0
20200316,72850P,櫃200永昌98售04,,,,,,0.00,0,0,0,0,0,0,0,0,0,0,0,0,0
20200316,72851P,佳邦永豐96售02,,,,,,0.00,0,0,0,0,0,0,0,0,0,0,0,0,0
20200316,72852P,信昌電永豐96售01,,,,,,0.00,0,0,0,0,0,0,0,0,0,0,0,0,0
20200316,72853P,穩懋元大96售09,1.72,2.07,1.67,1.91,-0.02,-1.04,220000,23,405400,0,0,0,0,0,0,143000,215000,-72000,-72000
20200316,72854P,勝麗國票97售02,1.36,1.36,1.36,1.36,-0.05,-3.55,3000,1,4080,0,0,0,0,0,0,3000,0,3000,3000
20200316,72855P,精測元大96售06,2.45,2.70,2.45,2.70,+0.21,8.43,22000,4,58300,0,0,0,0,0,0,19000,2000,17000,17000
20200316,72856P,閎康統一96售01,2.53,2.62,2.53,2.62,-0.03,-1.13,7000,2,18250,0,0,0,0,0,0,6000,1000,5000,5000
20200316,72857P,聯亞凱基96售02,1.58,1.87,1.58,1.87,-0.31,-14.22,59000,6,102840,0,0,0,0,0,0,1000,58000,-57000,-57000
20200316,72858P,直得永豐96售02,1.66,1.79,1.66,1.79,+0.23,14.74,4000,2,6770,0,0,0,0,0,0,1000,3000,-2000,-2000
20200316,72859P,原相永豐96售02,0.36,0.53,0.36,0.49,+0.09,22.5,177000,9,75250,0,0,0,0,0,0,102000,75000,27000,27000
20200316,72860P,環球晶永豐96售01,1.30,1.59,1.30,1.55,-0.24,-13.41,100000,6,143300,0,0,0,0,0,0,50000,50000,0,0
20200316,72861P,精測群益96售07,,,,,,0.00,0,0,0,0,0,0,0,0,0,0,0,0,0
20200316,72862P,力旺國票96售01,4.04,4.51,4.04,4.51,+0.36,8.67,15000,2,62950,0,0,0,0,0,0,10000,5000,5000,5000
20200316,72863P,群聯元大96售05,3.30,3.82,3.19,3.82,+0.06,1.6,240000,29,836880,0,0,0,0,0,0,66000,225000,-159000,-159000
20200316,72864P,良維永豐96售04,,,,,,0.00,0,0,0,0,0,0,0,0,0,0,0,0,0
20200316,72865P,聯亞國票97售03,,,,,,0.00,0,0,0,0,0,0,0,0,0,0,0,0,0
20200316,72866P,原相台新96售01,0.42,0.44,0.42,0.44,-0.03,-6.38,30000,3,12900,0,0,0,0,0,0,30000,0,30000,30000
20200316,72867P,頎邦元富96售03,1.66,1.77,1.66,1.77,+0.08,4.73,101000,9,174860,0,0,0,0,0,0,31000,70000,-39000,-39000
20200316,72868P,頎邦永豐96售01,1.86,1.98,1.86,1.98,-0.31,-13.54,10000,2,19200,0,0,0,0,0,0,5000,5000,0,0
20200316,72869P,頎邦元大96售01,3.27,3.27,3.27,3.27,-0.26,-7.37,7000,1,22890,0,0,0,0,0,0,0,7000,-7000,-7000
20200316,72870P,頎邦群益97售03,,,,,,0.00,0,0,0,0,0,0,0,0,0,0,0,0,0
20200316,72871P,鈊象國票97售02,0.14,0.30,0.14,0.27,+0.12,80.0,651000,39,137810,0,0,0,0,0,0,398000,0,398000,398000
20200316,72872P,大江永豐96售04,,,,,,0.00,0,0,0,0,0,0,0,0,0,0,0,0,0
20200316,72873P,穩懋凱基96售14,2.09,2.09,2.09,2.09,-0.23,-9.91,20000,1,41800,0,0,0,0,0,0,0,20000,-20000,-20000
20200316,72874P,台燿元富96售01,2.51,2.51,2.37,2.39,-0.06,-2.45,30000,9,72800,0,0,0,0,0,0,30000,0,30000,30000
20200316,72875P,碩禾台新97售02,1.33,1.47,1.33,1.47,+0.16,12.21,14000,4,18850,0,0,0,0,0,0,13000,1000,12000,12000
20200316,72876P,頎邦康和96售02,1.46,1.46,1.46,1.46,-0.15,-9.32,29000,1,42340,0,0,0,0,0,0,0,29000,-29000,-29000
20200316,72877P,環球晶統一96售03,,,,,,0.00,0,0,0,0,0,0,0,0,0,0,0,0,0
20200316,72878P,穩懋統一96售13,2.18,2.51,2.04,2.51,+0.12,5.02,48000,11,102590,0,0,0,0,0,0,6000,42000,-36000,-36000
20200316,72879P,環球晶中信96售03,1.58,1.65,1.58,1.65,0.00,0.0,20000,2,32300,0,0,0,0,0,0,0,20000,-20000,-20000
20200316,72880P,台燿凱基96售04,,,,,,0.00,0,0,0,0,0,0,0,0,0,0,0,0,0
20200316,72881P,穩懋凱基96售15,1.56,2.04,1.49,2.04,+0.13,6.81,270000,29,442870,0,0,0,0,0,0,71000,199000,-128000,-128000
20200316,72882P,威剛國票96售02,1.18,1.68,1.18,1.68,+0.42,33.33,8000,5,11020,0,0,0,0,0,0,3000,0,3000,3000
20200316,72883P,雍智國泰97售01,1.87,2.15,1.87,2.15,+0.25,13.16,90000,8,175550,0,0,0,0,0,0,40000,50000,-10000,-10000
20200316,72884P,中美晶元富97售01,1.53,1.94,1.52,1.90,+0.34,21.79,353000,45,586150,0,0,0,0,0,0,229000,328000,-99000,-99000
20200316,72885P,晶焱永豐97售02,1.46,1.46,1.46,1.46,-0.17,-10.43,10000,1,14600,0,0,0,0,0,0,10000,0,10000,10000
20200316,72886P,旺矽康和97售01,1.80,1.80,1.80,1.80,+0.11,6.51,6000,1,10800,0,0,0,0,0,0,0,6000,-6000,-6000
20200316,72887P,威剛康和97售01,0.94,1.09,0.94,1.09,+0.12,12.37,81000,3,79140,0,0,0,0,0,0,0,81000,-81000,-81000
20200316,72888P,中美晶中信99售01,,,,,,0.00,0,0,0,0,0,0,0,0,0,0,0,0,0
20200316,72889P,合晶永豐97售02,3.22,3.22,3.22,3.22,+0.23,7.69,5000,1,16100,0,0,0,0,0,0,0,5000,-5000,-5000
20200316,72890P,金居永豐97售01,3.51,3.51,3.51,3.51,-0.30,-7.87,12000,1,42120,0,0,0,0,0,0,12000,0,12000,12000
20200316,72891P,優群永豐97售02,0.66,0.79,0.62,0.77,+0.03,4.05,101000,25,71740,0,0,0,0,0,0,28000,67000,-39000,-39000
20200316,72892P,精測康和97售01,,,,,,0.00,0,0,0,0,0,0,0,0,0,0,0,0,0
20200316,72893P,櫃200群益97售03,,,,,,0.00,0,0,0,0,0,0,0,0,0,0,0,0,0
20200316,72894P,中美晶凱基97售03,1.01,1.05,1.01,1.05,+0.10,10.53,360000,3,377200,0,0,0,0,0,0,360000,360000,0,0
20200316,72895P,穩懋日盛97售03,2.61,3.07,2.58,3.00,-0.42,-12.28,60000,8,156760,0,0,0,0,0,0,48000,12000,36000,36000
20200316,72896P,廣明永豐97售02,,,,,,0.00,0,0,0,0,0,0,0,0,0,0,0,0,0
20200316,72897P,璟德永豐97售01,2.24,2.44,2.24,2.44,+0.30,14.02,11000,3,24840,0,0,0,0,0,0,0,11000,-11000,-11000
20200316,72898P,雙鴻國票98售01,,,,,,0.00,0,0,0,0,0,0,0,0,0,0,0,0,0
20200316,72899P,中美晶群益97售02,1.30,1.41,1.30,1.41,-0.08,-5.37,12000,2,15820,0,0,0,0,0,0,0,12000,-12000,-12000
20200316,72900P,聯亞群益97售01,3.83,3.83,3.83,3.83,-0.47,-10.93,10000,1,38300,0,0,0,0,0,0,0,0,0,0
20200316,72901P,穩懋統一97售04,,,,,,0.00,0,0,0,0,0,0,0,0,0,0,0,0,0
20200316,72902P,精測元富97售01,2.84,2.84,2.83,2.84,-0.12,-4.05,32000,4,90700,0,0,0,0,0,0,3000,29000,-26000,-26000
20200316,72903P,中美晶國票97售03,,,,,,0.00,0,0,0,0,0,0,0,0,0,0,0,0,0
20200316,72904P,大江群益97售03,,,,,,0.00,0,0,0,0,0,0,0,0,0,0,0,0,0
20200316,72905P,穩懋國泰98售01,2.12,2.56,2.05,2.53,+0.36,16.59,1208000,27,2789820,0,0,0,0,0,0,562000,1196000,-634000,-634000
20200316,72906P,穩懋國泰99售01,1.90,2.23,1.81,2.22,+0.22,11.0,667000,19,1280090,0,0,0,0,0,0,389000,653000,-264000,-264000
20200316,72907P,穩懋兆豐98售01,2.73,3.05,2.60,2.98,+0.25,9.16,52000,9,141620,0,0,0,0,0,0,0,52000,-52000,-52000
20200316,72908P,原相永豐97售01,0.58,0.80,0.58,0.80,+0.20,33.33,275000,18,176940,0,0,0,0,0,0,46000,228000,-182000,-182000
20200316,72909P,穩懋永豐97售01,1.53,1.53,1.53,1.53,-1.07,-41.15,7000,1,10710,0,0,0,0,0,0,7000,7000,0,0
20200316,72910P,穩懋統一99售02,,,,,,0.00,0,0,0,0,0,0,0,0,0,0,0,0,0
20200316,72911P,穩懋元大97售05,2.88,3.56,2.80,3.28,-0.74,-18.41,178000,18,541040,0,0,0,0,0,0,138000,175000,-37000,-37000
20200316,72912P,原相中信99售02,1.06,1.19,1.06,1.19,+0.15,14.42,60000,5,67500,0,0,0,0,0,0,60000,0,60000,60000
20200316,72913P,旺矽統一97售02,1.82,1.82,1.82,1.82,-0.05,-2.67,2000,1,3640,0,0,0,0,0,0,2000,0,2000,2000
20200316,72914P,穩懋元大97售06,2.65,3.16,2.54,3.05,-0.12,-3.79,211000,18,593470,0,0,0,0,0,0,196000,191000,5000,5000
20200316,72915P,中美晶凱基97售06,1.66,1.87,1.66,1.82,+0.36,24.66,291000,6,530660,0,0,0,0,0,0,280000,291000,-11000,-11000
20200316,72916P,穩懋凱基97售04,1.59,1.84,1.50,1.81,-0.17,-8.59,79000,9,135720,0,0,0,0,0,0,62000,17000,45000,45000
20200316,72917P,網龍國票98售01,,,,,,0.00,0,0,0,0,0,0,0,0,0,0,0,0,0
20200316,72918P,環球晶元富97售02,2.11,2.58,2.07,2.58,+0.57,28.36,355000,37,807620,0,0,0,0,0,0,180000,285000,-105000,-105000
20200316,72919P,聯亞元富97售02,,,,,,0.00,0,0,0,0,0,0,0,0,0,0,0,0,0
20200316,72920P,雙鴻元富97售02,1.87,2.30,1.84,2.30,+0.38,19.79,54000,19,116320,0,0,0,0,0,0,54000,0,54000,54000
20200316,72921P,雙鴻元大98售01,1.66,1.66,1.66,1.66,-0.16,-8.79,10000,1,16600,0,0,0,0,0,0,10000,0,10000,10000
20200316,72922P,原相亞東99售01,1.03,1.34,1.00,1.34,+0.23,20.72,253000,31,279430,0,0,0,0,0,0,200000,14000,186000,186000
20200316,72923P,台燿永豐97售01,1.58,1.61,1.50,1.50,0.00,0.0,83000,9,130090,0,0,0,0,0,0,31000,52000,-21000,-21000
20200316,72924P,精測凱基97售05,,,,,,0.00,0,0,0,0,0,0,0,0,0,0,0,0,0
20200316,72925P,鈊象凱基97售02,0.29,0.46,0.26,0.45,+0.13,40.62,1219000,41,388100,0,0,0,0,0,0,612000,605000,7000,7000
20200316,72926P,精華元大97售02,5.55,5.90,5.55,5.90,+0.05,0.85,43000,8,243750,0,0,0,0,0,0,30000,33000,-3000,-3000
20200316,72927P,大江元富97售02,,,,,,0.00,0,0,0,0,0,0,0,0,0,0,0,0,0
20200316,72928P,宜鼎元富97售02,1.03,1.03,0.95,0.99,-0.02,-1.98,329000,39,332030,0,0,0,0,0,0,47000,242000,-195000,-195000
20200316,72929P,信驊元富97售02,1.50,1.97,1.50,1.96,+0.40,25.64,240000,35,381620,0,0,0,0,0,0,0,236000,-236000,-236000
20200316,72930P,威剛元富97售03,1.70,2.10,1.70,2.10,+0.35,20.0,285000,21,536150,0,0,0,0,0,0,53000,232000,-179000,-179000
20200316,72931P,新普元富97售02,2.15,2.45,2.15,2.43,+0.09,3.85,197000,24,466230,0,0,0,0,0,0,150000,47000,103000,103000
20200316,72932P,網家元富97售02,1.67,1.92,1.67,1.91,+0.11,6.11,56000,7,100910,0,0,0,0,0,0,5000,51000,-46000,-46000
20200316,72933P,碩禾永豐97售01,2.06,2.12,2.06,2.12,+0.08,3.92,14000,3,29540,0,0,0,0,0,0,12000,2000,10000,10000
20200316,72934P,晟德永豐97售01,,,,,,0.00,0,0,0,0,0,0,0,0,0,0,0,0,0
20200316,72935P,鈊象永豐97售03,,,,,,0.00,0,0,0,0,0,0,0,0,0,0,0,0,0
20200316,72936P,鈊象元富97售03,0.45,0.68,0.33,0.68,+0.23,51.11,1587000,96,805080,0,0,0,0,0,0,604000,705000,-101000,-101000
20200316,72937P,櫃200元大99售01,,,,,,0.00,0,0,0,0,0,0,0,0,0,0,0,0,0
20200316,72938P,櫃200元大99售02,3.74,3.74,3.74,3.74,-0.42,-10.1,20000,2,74800,0,0,0,0,0,0,0,20000,-20000,-20000
20200316,72939P,網龍元大97售02,6.60,6.60,6.60,6.60,-0.65,-8.97,1000,1,6600,0,0,0,0,0,0,0,1000,-1000,-1000
20200316,72940P,環球晶群益97售04,2.94,3.00,2.94,3.00,+0.43,16.73,9000,2,26700,0,0,0,0,0,0,4000,5000,-1000,-1000
20200316,72941P,環球晶統一97售03,2.26,2.26,2.26,2.26,-0.29,-11.37,5000,1,11300,0,0,0,0,0,0,5000,0,5000,5000
20200316,72942P,群聯元富97售01,4.13,4.79,4.06,4.79,+0.08,1.7,139000,14,617300,0,0,0,0,0,0,56000,83000,-27000,-27000
20200316,72943P,雙鴻元富97售03,3.11,3.76,3.07,3.69,+0.43,13.19,131000,22,413110,0,0,0,0,0,0,131000,0,131000,131000
20200316,72944P,信昌電元富97售01,4.39,4.71,4.39,4.71,+0.36,8.28,40000,4,182000,0,0,0,0,0,0,0,40000,-40000,-40000
20200316,72945P,大江永豐97售04,,,,,,0.00,0,0,0,0,0,0,0,0,0,0,0,0,0
20200316,72946P,穩懋富邦99售02,1.63,1.90,1.60,1.90,+0.12,6.74,510000,68,867960,0,0,0,0,0,0,111000,409000,-298000,-298000
20200316,72947P,環球晶凱基97售08,3.26,3.79,3.26,3.77,+0.17,4.72,79000,11,284810,0,0,0,0,0,0,72000,67000,5000,5000
20200316,72948P,大江元大97售06,2.05,2.05,2.05,2.05,+0.02,0.99,4000,2,8200,0,0,0,0,0,0,2000,2000,0,0
20200316,72949P,環球晶永豐97售02,,,,,,0.00,0,0,0,0,0,0,0,0,0,0,0,0,0
20200316,72950P,中美晶元富97售02,2.23,2.69,2.23,2.61,+0.14,5.67,136000,19,329620,0,0,0,0,0,0,83000,133000,-50000,-50000
20200316,72951P,宣德元富97售02,2.44,2.82,2.44,2.77,+0.35,14.46,90000,28,232860,0,0,0,0,0,0,21000,69000,-48000,-48000
20200316,72952P,群聯元富97售02,5.75,6.30,5.75,6.30,+0.05,0.8,88000,10,519400,0,0,0,0,0,0,20000,68000,-48000,-48000
20200316,72953P,環球晶元富97售05,3.16,3.64,3.12,3.64,+0.60,19.74,103000,13,336160,0,0,0,0,0,0,68000,55000,13000,13000
20200316,72954P,穩懋元富97售05,3.79,4.57,3.79,4.57,-0.58,-11.26,307000,8,1374240,0,0,0,0,0,0,5000,302000,-297000,-297000
20200316,72955P,中美晶元大98售02,1.72,2.00,1.71,1.96,+0.21,12.0,949000,47,1671920,0,0,0,0,0,0,941000,443000,498000,498000
20200316,72956P,信驊元大98售01,1.68,1.87,1.60,1.87,+0.16,9.36,87000,15,151160,0,0,0,0,0,0,38000,45000,-7000,-7000
20200316,72957P,精測元富98售01,3.59,3.69,3.59,3.69,-0.44,-10.65,49000,7,178260,0,0,0,0,0,0,0,49000,-49000,-49000
20200316,72958P,威剛元大98售03,1.28,1.49,1.28,1.49,+0.20,15.5,235000,23,319990,0,0,0,0,0,0,139000,168000,-29000,-29000
20200316,72959P,大江永豐98售02,,,,,,0.00,0,0,0,0,0,0,0,0,0,0,0,0,0
20200316,72960P,中美晶永豐98售01,1.40,1.48,1.40,1.45,+0.22,17.89,50000,5,71800,0,0,0,0,0,0,40000,50000,-10000,-10000
20200316,72961P,環球晶國泰99售01,2.66,2.88,2.66,2.88,+0.40,16.13,106000,5,291080,0,0,0,0,0,0,76000,90000,-14000,-14000
20200316,72962P,鈊象元富98售01,0.75,1.08,0.70,1.07,+0.28,35.44,3111000,223,2629630,0,0,0,0,0,0,634000,1894000,-1260000,-1260000
20200316,72963P,環球晶凱基98售03,3.35,4.08,3.35,4.06,+0.51,14.37,190000,9,734700,0,0,0,0,0,0,90000,180000,-90000,-90000
20200316,72964P,環球晶元大98售05,4.28,5.10,4.25,5.05,+0.89,21.39,285000,14,1266100,0,0,0,0,0,0,236000,99000,137000,137000
20200316,72965P,環球晶元大98售06,3.50,4.25,3.50,4.25,+0.73,20.74,145000,15,567770,0,0,0,0,0,0,130000,65000,65000,65000
20200316,72966P,環球晶元大98售07,2.70,3.20,2.70,3.17,+0.43,15.69,103000,11,311270,0,0,0,0,0,0,88000,60000,28000,28000
20200316,72967P,精測國泰9A售02,2.34,2.44,2.24,2.38,-0.34,-12.5,54000,7,126010,0,0,0,0,0,0,43000,31000,12000,12000
20200316,72968P,大江元富98售03,4.06,4.14,4.06,4.14,-0.10,-2.36,58000,3,238680,0,0,0,0,0,0,58000,0,58000,58000
20200316,72969P,精測元大98售03,4.77,4.77,4.76,4.76,-0.54,-10.19,14000,2,66740,0,0,0,0,0,0,10000,14000,-4000,-4000
20200316,72970P,原相永豐98售01,1.40,1.61,1.40,1.60,+0.25,18.52,40000,7,63330,0,0,0,0,0,0,14000,26000,-12000,-12000
20200316,72971P,穩懋凱基98售05,2.61,2.65,2.60,2.60,+0.19,7.88,45000,3,117750,0,0,0,0,0,0,0,45000,-45000,-45000
20200316,72972P,大江元富98售04,2.87,2.93,2.83,2.83,-0.08,-2.75,31000,4,89110,0,0,0,0,0,0,20000,11000,9000,9000
20200316,72973P,大江富邦9A售03,,,,,,0.00,0,0,0,0,0,0,0,0,0,0,0,0,0
20200316,72974P,精測元大98售04,1.62,1.79,1.62,1.79,+0.09,5.29,176000,22,294520,0,0,0,0,0,0,35000,151000,-116000,-116000
20200316,72975P,緯軟元大9A售01,1.21,1.22,1.21,1.21,+0.01,0.83,321000,33,391410,0,0,0,0,0,0,0,321000,-321000,-321000
20200316,72976P,環球晶元大98售08,4.27,5.85,4.20,5.85,+1.67,39.95,76000,8,371650,0,0,0,0,0,0,70000,46000,24000,24000
20200316,72977P,晶焱永豐98售02,1.39,1.45,1.39,1.45,+0.02,1.4,63000,7,88850,0,0,0,0,0,0,0,63000,-63000,-63000
20200316,72978P,新鉅科元大98售02,3.85,4.27,3.85,4.27,+0.02,0.47,129000,6,546180,0,0,0,0,0,0,103000,26000,77000,77000
20200316,72979P,聯亞元大98售02,3.76,3.76,3.76,3.76,-0.13,-3.34,10000,1,37600,0,0,0,0,0,0,0,10000,-10000,-10000
20200316,72980P,穩懋元大98售03,5.70,6.50,5.55,6.15,-0.45,-6.82,59000,6,345050,0,0,0,0,0,0,55000,59000,-4000,-4000
20200316,72981P,聯亞凱基98售03,1.52,1.56,1.51,1.56,-0.08,-4.88,165000,7,253020,0,0,0,0,0,0,0,165000,-165000,-165000
20200316,72982P,精測元大98售05,2.90,3.12,2.90,3.12,-0.28,-8.24,71000,8,209800,0,0,0,0,0,0,11000,60000,-49000,-49000
20200316,72983P,穩懋元大98售04,5.85,6.60,5.75,6.45,-1.30,-16.77,105000,11,642250,0,0,0,0,0,0,75000,75000,0,0
20200316,72984P,威剛永豐98售02,,,,,,0.00,0,0,0,0,0,0,0,0,0,0,0,0,0
20200316,72985P,群聯元富98售03,3.07,3.57,3.05,3.57,+0.02,0.56,102000,10,331940,0,0,0,0,0,0,46000,56000,-10000,-10000
20200316,72986P,環球晶元大98售11,3.89,4.75,3.87,4.75,+0.70,17.28,76000,14,332060,0,0,0,0,0,0,76000,50000,26000,26000
20200316,72987P,環球晶元大98售12,4.67,5.30,4.67,5.30,+0.77,17.0,67000,8,336440,0,0,0,0,0,0,67000,40000,27000,27000
20200316,72988P,聯亞元大98售03,2.19,2.27,2.19,2.27,-0.33,-12.69,38000,4,85620,0,0,0,0,0,0,0,38000,-38000,-38000
20200316,72989P,信昌電永豐98售02,,,,,,0.00,0,0,0,0,0,0,0,0,0,0,0,0,0
20200316,72990P,環球晶凱基98售06,3.17,4.02,2.98,4.00,+0.99,32.89,249000,14,910650,0,0,0,0,0,0,159000,229000,-70000,-70000
20200316,72991P,穩懋凱基98售08,3.32,3.32,3.25,3.25,+0.24,7.97,10000,2,32850,0,0,0,0,0,0,0,10000,-10000,-10000
20200316,72992P,穩懋永豐98售02,2.25,2.25,2.25,2.25,-0.90,-28.57,20000,1,45000,0,0,0,0,0,0,20000,20000,0,0
20200316,72993P,穩懋元富98售01,3.67,4.23,3.61,4.23,-0.07,-1.63,535000,13,2168560,0,0,0,0,0,0,20000,535000,-515000,-515000
20200316,72994P,穩懋元富98售02,3.58,4.00,3.58,4.00,+0.20,5.26,97000,5,384460,0,0,0,0,0,0,2000,95000,-93000,-93000
20200316,72995P,雙鴻兆豐99售02,0.93,1.16,0.93,1.16,+0.18,18.37,1216000,33,1266190,0,0,0,0,0,0,884000,292000,592000,592000
20200316,72996P,力旺元富98售02,4.50,5.15,4.48,5.15,+0.55,11.96,83000,8,386440,0,0,0,0,0,0,42000,41000,1000,1000
20200316,72997P,精測台新98售02,1.56,1.74,1.52,1.74,+0.12,7.41,26000,6,40200,0,0,0,0,0,0,2000,23000,-21000,-21000
20200316,72998P,穩懋台新98售01,2.22,2.41,2.20,2.38,+0.17,7.69,289000,5,644580,0,0,0,0,0,0,250000,289000,-39000,-39000
20200316,72999P,環球晶群益98售03,,,,,,0.00,0,0,0,0,0,0,0,0,0,0,0,0,0
20200316,73000P,穩懋富邦99售03,2.89,3.23,2.85,3.23,+0.26,8.75,61000,5,178230,0,0,0,0,0,0,46000,15000,31000,31000
20200316,73001P,譜瑞元大98售05,5.75,6.25,5.75,6.25,+0.05,0.81,5000,4,30000,0,0,0,0,0,0,2000,3000,-1000,-1000
20200316,73002P,精測元富98售03,2.33,2.39,2.33,2.39,-0.54,-18.43,100000,4,238800,0,0,0,0,0,0,0,100000,-100000,-100000
20200316,73003P,神盾群益9A售04,1.86,2.01,1.86,2.01,+0.26,14.86,74000,9,140490,0,0,0,0,0,0,0,74000,-74000,-74000
20200316,73004P,譜瑞台新99售01,2.01,2.25,2.01,2.25,-0.03,-1.32,255000,17,559040,0,0,0,0,0,0,2000,253000,-251000,-251000
20200316,73005P,中美晶元大98售07,2.69,2.81,2.67,2.76,+0.08,2.99,76000,11,207540,0,0,0,0,0,0,50000,76000,-26000,-26000
20200316,73006P,聯亞元大98售04,3.02,3.14,3.02,3.14,-0.33,-9.51,21000,3,65020,0,0,0,0,0,0,0,21000,-21000,-21000
20200316,73007P,中美晶元富98售01,1.92,1.92,1.92,1.92,-0.01,-0.52,20000,1,38400,0,0,0,0,0,0,20000,0,20000,20000
20200316,73008P,合晶元富98售02,2.76,2.79,2.76,2.79,+0.09,3.33,30000,3,83200,0,0,0,0,0,0,30000,0,30000,30000
20200316,73009P,原相元富98售02,2.20,2.53,2.20,2.53,+0.35,16.06,257000,11,598460,0,0,0,0,0,0,47000,210000,-163000,-163000
20200316,73010P,勝麗元富98售01,2.87,3.15,2.84,3.11,+0.05,1.63,56000,7,164360,0,0,0,0,0,0,40000,16000,24000,24000
20200316,73011P,原相台新98售01,1.46,1.66,1.46,1.66,+0.20,13.7,23000,5,35470,0,0,0,0,0,0,13000,0,13000,13000
20200316,73012P,威剛統一98售02,1.55,1.68,1.55,1.62,+0.07,4.52,9000,3,14810,0,0,0,0,0,0,4000,5000,-1000,-1000
20200316,73013P,中美晶群益98售05,2.90,2.90,2.90,2.90,-0.18,-5.84,10000,1,29000,0,0,0,0,0,0,10000,0,10000,10000
20200316,73014P,環球晶國泰9A售02,3.85,3.85,3.82,3.82,+0.52,15.76,44000,3,169320,0,0,0,0,0,0,40000,44000,-4000,-4000
20200316,73015P,碩禾元大99售04,,,,,,0.00,0,0,0,0,0,0,0,0,0,0,0,0,0
20200316,73016P,精測元大98售06,4.60,4.95,4.60,4.95,+0.06,1.23,19000,5,89870,0,0,0,0,0,0,10000,9000,1000,1000
20200316,73017P,環球晶統一99售05,,,,,,0.00,0,0,0,0,0,0,0,0,0,0,0,0,0
20200316,73018P,威剛國票99售02,,,,,,0.00,0,0,0,0,0,0,0,0,0,0,0,0,0
20200316,73019P,穩懋國泰99售02,2.63,2.80,2.50,2.80,+0.10,3.7,52000,6,134640,0,0,0,0,0,0,25000,52000,-27000,-27000
20200316,73020P,穩懋亞東98售02,,,,,,0.00,0,0,0,0,0,0,0,0,0,0,0,0,0
20200316,73021P,原相元大99售02,1.50,1.70,1.48,1.70,+0.19,12.58,480000,50,758320,0,0,0,0,0,0,162000,317000,-155000,-155000
20200316,73022P,台燿中信9A售02,1.48,1.51,1.48,1.51,+0.11,7.86,20000,2,29900,0,0,0,0,0,0,0,20000,-20000,-20000
20200316,73023P,新普中信9C售01,1.07,1.15,1.07,1.15,+0.05,4.55,30000,2,32900,0,0,0,0,0,0,10000,0,10000,10000
20200316,73024P,譜瑞中信9C售01,0.96,0.96,0.96,0.96,+0.02,2.13,11000,2,10560,0,0,0,0,0,0,0,11000,-11000,-11000
20200316,73025P,譜瑞凱基98售03,1.80,1.98,1.70,1.95,+0.07,3.72,305000,31,539090,0,0,0,0,0,0,16000,299000,-283000,-283000
20200316,73026P,泰博永豐98售02,1.58,1.65,1.58,1.65,-0.04,-2.37,55000,8,89520,0,0,0,0,0,0,0,55000,-55000,-55000
20200316,73027P,雙鴻元大9A售02,1.61,1.62,1.59,1.61,+0.03,1.9,224000,25,361660,0,0,0,0,0,0,10000,224000,-214000,-214000
20200316,73028P,中美晶統一9B售01,1.06,1.06,1.06,1.06,-0.08,-7.02,9000,1,9540,0,0,0,0,0,0,9000,0,9000,9000
20200316,73029P,中美晶凱基99售06,2.21,2.44,2.21,2.44,-0.05,-2.01,115000,4,278650,0,0,0,0,0,0,115000,110000,5000,5000
20200316,73030P,大江群益99售01,,,,,,0.00,0,0,0,0,0,0,0,0,0,0,0,0,0
20200316,73031P,宏捷科康和99售02,1.70,2.04,1.66,2.03,+0.23,12.78,321000,11,550730,0,0,0,0,0,0,0,321000,-321000,-321000
20200316,73032P,雙鴻群益9B售01,1.41,1.50,1.40,1.44,+0.11,8.27,34000,6,48730,0,0,0,0,0,0,20000,34000,-14000,-14000
20200316,73033P,宏捷科國票99售01,3.88,3.88,3.88,3.88,+1.03,36.14,1000,1,3880,0,0,0,0,0,0,0,1000,-1000,-1000
20200316,73034P,大江富邦9B售01,1.23,1.24,1.23,1.24,-0.03,-2.36,26000,3,32080,0,0,0,0,0,0,26000,0,26000,26000
20200316,73035P,中美晶台新99售01,,,,,,0.00,0,0,0,0,0,0,0,0,0,0,0,0,0
20200316,73036P,鈊象永豐99售02,1.16,1.51,1.08,1.51,+0.30,24.79,343000,60,437920,0,0,0,0,0,0,9000,200000,-191000,-191000
20200316,73037P,海韻電元富99售02,2.19,2.34,2.19,2.34,+0.08,3.54,60000,6,134600,0,0,0,0,0,0,10000,50000,-40000,-40000
20200316,73038P,中美晶台新99售02,2.54,2.63,2.54,2.63,+0.17,6.91,38000,2,99580,0,0,0,0,0,0,4000,34000,-30000,-30000
20200316,73039P,原相台新99售01,,,,,,0.00,0,0,0,0,0,0,0,0,0,0,0,0,0
20200316,73040P,穩懋凱基99售04,1.75,2.02,1.73,2.00,+0.17,9.29,351000,25,635150,0,0,0,0,0,0,125000,226000,-101000,-101000
20200316,73041P,穩懋統一9B售02,1.01,1.25,0.98,1.25,-0.05,-3.85,295000,33,328550,0,0,0,0,0,0,38000,245000,-207000,-207000
20200316,73042P,原相元大99售04,3.13,3.69,3.11,3.69,+0.55,17.52,130000,18,430810,0,0,0,0,0,0,100000,30000,70000,70000
20200316,73043P,穩懋元大99售04,4.22,4.80,4.00,4.50,-1.40,-23.73,63000,7,272530,0,0,0,0,0,0,40000,63000,-23000,-23000
20200316,73044P,原相國票9A售01,3.08,3.10,3.08,3.10,+0.11,3.68,25000,3,77400,0,0,0,0,0,0,25000,0,25000,25000
20200316,73045P,雙鴻國票9A售02,1.79,2.10,1.77,2.10,+0.26,14.13,49000,9,91030,0,0,0,0,0,0,38000,10000,28000,28000
20200316,73046P,神盾群益9A售05,2.41,2.61,2.41,2.61,+0.31,13.48,81000,10,204080,0,0,0,0,0,0,0,81000,-81000,-81000
20200316,73047P,宏捷科元富9C售03,2.32,2.57,2.32,2.57,+0.23,9.83,15000,3,37550,0,0,0,0,0,0,4000,11000,-7000,-7000
20200316,73048P,中美晶中信9B售01,1.01,1.12,1.01,1.12,+0.04,3.7,42000,5,46820,0,0,0,0,0,0,2000,40000,-38000,-38000
20200316,73049P,宏捷科元大99售05,1.31,1.52,1.29,1.52,+0.17,12.59,414000,50,587810,0,0,0,0,0,0,30000,384000,-354000,-354000
20200316,73050P,雍智元大99售02,1.17,1.24,1.17,1.24,+0.07,5.98,49000,6,58320,0,0,0,0,0,0,0,49000,-49000,-49000
20200316,73051P,台燿元富9C售02,4.20,4.21,4.20,4.21,+0.16,3.95,20000,2,84100,0,0,0,0,0,0,10000,10000,0,0
20200316,73052P,原相統一99售03,1.34,1.34,1.33,1.33,-0.03,-2.21,35000,2,46850,0,0,0,0,0,0,35000,0,35000,35000
20200316,73053P,原相統一9A售02,1.01,1.06,1.01,1.06,-0.06,-5.36,20000,2,20700,0,0,0,0,0,0,20000,0,20000,20000
20200316,73054P,穩懋元大99售08,2.20,2.50,2.15,2.44,+0.08,3.39,721000,93,1643040,0,3000,-3000,0,0,0,136000,707000,-571000,-574000
20200316,73055P,信驊永豐99售03,1.36,1.54,1.29,1.54,+0.17,12.41,614000,63,854130,0,0,0,0,0,0,10000,584000,-574000,-574000
20200316,73056P,原相永豐99售02,1.35,1.45,1.32,1.44,-0.02,-1.37,62000,10,85110,0,0,0,0,0,0,3000,59000,-56000,-56000
20200316,73057P,環球晶兆豐99售02,1.98,2.14,1.95,2.03,+0.13,6.84,203000,10,421360,0,0,0,0,0,0,20000,183000,-163000,-163000
20200316,73058P,原相統一9B售02,1.14,1.14,1.14,1.14,-0.07,-5.79,10000,1,11400,0,0,0,0,0,0,10000,0,10000,10000
20200316,73059P,鈊象元大99售05,1.94,2.28,1.94,2.28,+0.41,21.93,79000,10,168850,0,0,0,0,0,0,16000,79000,-63000,-63000
20200316,73060P,環球晶凱基99售06,2.33,2.50,2.33,2.50,+1.07,74.83,265000,9,622900,0,0,0,0,0,0,150000,265000,-115000,-115000
20200316,73061P,群聯元大9A售01,1.57,1.57,1.57,1.57,+0.26,19.85,2000,1,3140,0,0,0,0,0,0,0,2000,-2000,-2000
20200316,73062P,群聯凱基99售02,,,,,,0.00,0,0,0,0,0,0,0,0,0,0,0,0,0
20200316,702038,中光電台新97購01,,,,,,0.00,0,0,0,0,0,0,0,0,0,0,0,0,0
20200316,702039,群聯台新97購01,4.48,4.53,3.12,3.12,-1.53,-32.9,333000,48,1251910,0,0,0,0,0,0,43000,277000,-234000,-234000
20200316,702968,金可群益93購01,,,,,,0.00,0,0,0,0,0,0,0,0,0,0,0,0,0
20200316,702972,富喬群益93購01,,,,,,0.00,0,0,0,0,0,0,0,0,0,0,0,0,0
20200316,703531,昇達科群益94購01,,,,,,0.00,0,0,0,0,0,0,0,0,0,0,0,0,0
20200316,703576,由田群益94購01,,,,,,0.00,0,0,0,0,0,0,0,0,0,0,0,0,0
20200316,704122,中光電元大94購01,,,,,,0.00,0,0,0,0,0,0,0,0,0,0,0,0,0
20200316,704248,神盾元大93購01,,,,,,0.00,0,0,0,0,0,0,0,0,0,0,0,0,0
20200316,704310,大宇資元大93購01,,,,,,0.00,0,0,0,0,0,0,0,0,0,0,0,0,0
20200316,704322,雙鴻凱基93購01,,,,,,0.00,0,0,0,0,0,0,0,0,0,0,0,0,0
20200316,704390,三貝德元大93購01,,,,,,0.00,0,0,0,0,0,0,0,0,0,0,0,0,0
20200316,704391,碩禾元大93購01,0.16,0.16,0.16,0.16,-0.09,-36.0,10000,1,1600,0,0,0,0,0,0,10000,0,10000,10000
20200316,704428,緯軟元大93購01,,,,,,0.00,0,0,0,0,0,0,0,0,0,0,0,0,0
20200316,704444,原相中信95購01,,,,,,0.00,0,0,0,0,0,0,0,0,0,0,0,0,0
20200316,704460,創惟元大94購01,,,,,,0.00,0,0,0,0,0,0,0,0,0,0,0,0,0
20200316,704484,元太中信95購01,,,,,,0.00,0,0,0,0,0,0,0,0,0,0,0,0,0
20200316,704518,聯亞元富94購01,,,,,,0.00,0,0,0,0,0,0,0,0,0,0,0,0,0
20200316,704521,神盾元大94購01,,,,,,0.00,0,0,0,0,0,0,0,0,0,0,0,0,0
20200316,704522,緯軟元大94購01,,,,,,0.00,0,0,0,0,0,0,0,0,0,0,0,0,0
20200316,704589,由田元大94購01,,,,,,0.00,0,0,0,0,0,0,0,0,0,0,0,0,0
20200316,704640,大宇資群益94購01,,,,,,0.00,0,0,0,0,0,0,0,0,0,0,0,0,0
20200316,704667,波若威群益94購01,,,,,,0.00,0,0,0,0,0,0,0,0,0,0,0,0,0
20200316,704712,三貝德群益94購01,,,,,,0.00,0,0,0,0,0,0,0,0,0,0,0,0,0
20200316,704718,神盾元大94購02,,,,,,0.00,0,0,0,0,0,0,0,0,0,0,0,0,0
20200316,704751,VHQ群益94購01,,,,,,0.00,0,0,0,0,0,0,0,0,0,0,0,0,0
20200316,704777,碩禾群益94購01,,,,,,0.00,0,0,0,0,0,0,0,0,0,0,0,0,0
20200316,704853,由田國票93購02,,,,,,0.00,0,0,0,0,0,0,0,0,0,0,0,0,0
20200316,704856,原相富邦93購01,,,,,,0.00,0,0,0,0,0,0,0,0,0,0,0,0,0
20200316,704867,大江凱基93購02,,,,,,0.00,0,0,0,0,0,0,0,0,0,0,0,0,0
20200316,704868,大江凱基93購03,,,,,,0.00,0,0,0,0,0,0,0,0,0,0,0,0,0
20200316,704869,大江凱基93購04,,,,,,0.00,0,0,0,0,0,0,0,0,0,0,0,0,0
20200316,704873,穩懋凱基93購07,,,,,,0.00,0,0,0,0,0,0,0,0,0,0,0,0,0
20200316,704874,穩懋凱基93購08,0.27,0.29,0.13,0.13,+0.03,30.0,68000,7,15200,0,0,0,0,0,0,18000,50000,-32000,-32000
20200316,704875,穩懋中信95購01,0.54,0.54,0.39,0.39,-0.09,-18.75,125000,12,61220,0,0,0,0,0,0,88000,74000,14000,14000
20200316,704878,六角國泰93購01,,,,,,0.00,0,0,0,0,0,0,0,0,0,0,0,0,0
20200316,704879,晟德富邦93購01,,,,,,0.00,0,0,0,0,0,0,0,0,0,0,0,0,0
20200316,704885,精測兆豐93購01,,,,,,0.00,0,0,0,0,0,0,0,0,0,0,0,0,0
20200316,704888,神盾中信94購01,,,,,,0.00,0,0,0,0,0,0,0,0,0,0,0,0,0
20200316,704896,聯亞凱基93購02,,,,,,0.00,0,0,0,0,0,0,0,0,0,0,0,0,0
20200316,704900,頎邦凱基93購01,,,,,,0.00,0,0,0,0,0,0,0,0,0,0,0,0,0
20200316,704901,頎邦凱基93購02,,,,,,0.00,0,0,0,0,0,0,0,0,0,0,0,0,0
20200316,704903,廣明國泰93購01,,,,,,0.00,0,0,0,0,0,0,0,0,0,0,0,0,0
20200316,704910,鈺太元大93購01,,,,,,0.00,0,0,0,0,0,0,0,0,0,0,0,0,0
20200316,704912,宜鼎兆豐93購01,,,,,,0.00,0,0,0,0,0,0,0,0,0,0,0,0,0
20200316,704924,宏捷科元大93購02,0.17,0.18,0.16,0.16,+0.06,60.0,70000,7,11600,0,0,0,0,0,0,10000,60000,-50000,-50000
20200316,704925,原相亞東93購01,,,,,,0.00,0,0,0,0,0,0,0,0,0,0,0,0,0
20200316,704933,晟德兆豐93購01,,,,,,0.00,0,0,0,0,0,0,0,0,0,0,0,0,0
20200316,704938,大江凱基93購05,,,,,,0.00,0,0,0,0,0,0,0,0,0,0,0,0,0
20200316,704947,聯亞凱基93購03,,,,,,0.00,0,0,0,0,0,0,0,0,0,0,0,0,0
20200316,704948,穩懋凱基93購09,,,,,,0.00,0,0,0,0,0,0,0,0,0,0,0,0,0
20200316,704949,大江凱基93購06,,,,,,0.00,0,0,0,0,0,0,0,0,0,0,0,0,0
20200316,704953,神盾凱基93購01,,,,,,0.00,0,0,0,0,0,0,0,0,0,0,0,0,0
20200316,704955,環球晶凱基93購01,,,,,,0.00,0,0,0,0,0,0,0,0,0,0,0,0,0
20200316,704956,聯亞凱基93購04,,,,,,0.00,0,0,0,0,0,0,0,0,0,0,0,0,0
20200316,704957,頎邦凱基93購03,,,,,,0.00,0,0,0,0,0,0,0,0,0,0,0,0,0
20200316,704958,台半統一93購01,,,,,,0.00,0,0,0,0,0,0,0,0,0,0,0,0,0
20200316,704960,M31元大93購01,,,,,,0.00,0,0,0,0,0,0,0,0,0,0,0,0,0
20200316,704970,合晶國泰93購01,,,,,,0.00,0,0,0,0,0,0,0,0,0,0,0,0,0
20200316,704980,穩懋統一93購01,,,,,,0.00,0,0,0,0,0,0,0,0,0,0,0,0,0
20200316,704982,伍豐凱基93購01,,,,,,0.00,0,0,0,0,0,0,0,0,0,0,0,0,0
20200316,704990,穩懋凱基93購10,,,,,,0.00,0,0,0,0,0,0,0,0,0,0,0,0,0
20200316,704992,鐿鈦凱基93購01,,,,,,0.00,0,0,0,0,0,0,0,0,0,0,0,0,0
20200316,704999,神盾元大94購03,,,,,,0.00,0,0,0,0,0,0,0,0,0,0,0,0,0
20200316,705010,穩懋中信95購02,0.32,0.41,0.32,0.37,+0.05,15.62,131000,7,45360,0,0,0,0,0,0,110000,21000,89000,89000
20200316,705011,中美晶統一93購01,,,,,,0.00,0,0,0,0,0,0,0,0,0,0,0,0,0
20200316,705012,穩懋統一93購02,,,,,,0.00,0,0,0,0,0,0,0,0,0,0,0,0,0
20200316,705016,智擎凱基93購01,,,,,,0.00,0,0,0,0,0,0,0,0,0,0,0,0,0
20200316,705017,精華凱基93購01,,,,,,0.00,0,0,0,0,0,0,0,0,0,0,0,0,0
20200316,705018,精華凱基93購02,,,,,,0.00,0,0,0,0,0,0,0,0,0,0,0,0,0
20200316,705020,譜瑞凱基93購02,0.46,0.65,0.40,0.40,+0.11,37.93,338000,36,189520,0,0,0,0,0,0,80000,328000,-248000,-248000
20200316,705022,穩懋亞東93購01,,,,,,0.00,0,0,0,0,0,0,0,0,0,0,0,0,0
20200316,705042,雙鴻群益93購01,,,,,,0.00,0,0,0,0,0,0,0,0,0,0,0,0,0
20200316,705046,雙鴻凱基93購03,,,,,,0.00,0,0,0,0,0,0,0,0,0,0,0,0,0
20200316,705054,鴻碩國泰93購01,,,,,,0.00,0,0,0,0,0,0,0,0,0,0,0,0,0
20200316,705055,雙鴻國泰93購02,,,,,,0.00,0,0,0,0,0,0,0,0,0,0,0,0,0
20200316,705056,穩懋富邦93購03,,,,,,0.00,0,0,0,0,0,0,0,0,0,0,0,0,0
20200316,705059,宏捷科群益93購01,0.12,0.12,0.12,0.12,-0.04,-25.0,50000,5,6000,0,0,0,0,0,0,0,50000,-50000,-50000
20200316,705060,大宇資元大94購01,,,,,,0.00,0,0,0,0,0,0,0,0,0,0,0,0,0
20200316,705063,神盾元大93購03,,,,,,0.00,0,0,0,0,0,0,0,0,0,0,0,0,0
20200316,705082,雙鴻元大93購02,,,,,,0.00,0,0,0,0,0,0,0,0,0,0,0,0,0
20200316,705084,六角國票93購01,0.01,0.01,0.01,0.01,-0.01,-50.0,100000,1,1000,0,0,0,0,0,0,100000,0,100000,100000
20200316,705088,保瑞國泰93購01,,,,,,0.00,0,0,0,0,0,0,0,0,0,0,0,0,0
20200316,705097,聚積凱基93購01,,,,,,0.00,0,0,0,0,0,0,0,0,0,0,0,0,0
20200316,705107,碩禾國泰93購01,,,,,,0.00,0,0,0,0,0,0,0,0,0,0,0,0,0
20200316,705144,晶焱兆豐94購01,0.02,0.02,0.02,0.02,-0.02,-50.0,162000,3,3240,0,0,0,0,0,0,152000,10000,142000,142000
20200316,705149,神盾群益94購01,,,,,,0.00,0,0,0,0,0,0,0,0,0,0,0,0,0
20200316,705158,美琪瑪國泰94購01,,,,,,0.00,0,0,0,0,0,0,0,0,0,0,0,0,0
20200316,705164,原相富邦94購01,,,,,,0.00,0,0,0,0,0,0,0,0,0,0,0,0,0
20200316,705174,神盾元大95購01,0.11,0.12,0.06,0.06,-0.05,-45.45,4258000,430,356290,0,0,0,0,0,0,20000,4238000,-4218000,-4218000
20200316,705181,昇達科國泰94購01,,,,,,0.00,0,0,0,0,0,0,0,0,0,0,0,0,0
20200316,705203,緯軟元大95購01,0.02,0.02,0.02,0.02,0.00,0.0,10000,2,200,0,0,0,0,0,0,0,4000,-4000,-4000
20200316,705285,原相元大94購01,1.53,1.73,1.00,1.00,-0.72,-41.86,109000,14,164960,0,0,0,0,0,0,101000,8000,93000,93000
20200316,705287,緯軟元大94購02,,,,,,0.00,0,0,0,0,0,0,0,0,0,0,0,0,0
20200316,705299,宏觀元大94購01,,,,,,0.00,0,0,0,0,0,0,0,0,0,0,0,0,0
20200316,705308,大江群益94購01,,,,,,0.00,0,0,0,0,0,0,0,0,0,0,0,0,0
20200316,705319,金居元大94購01,,,,,,0.00,0,0,0,0,0,0,0,0,0,0,0,0,0
20200316,705335,上詮元大94購01,,,,,,0.00,0,0,0,0,0,0,0,0,0,0,0,0,0
20200316,705353,六角元大93購02,,,,,,0.00,0,0,0,0,0,0,0,0,0,0,0,0,0
20200316,705356,神盾元大94購04,,,,,,0.00,0,0,0,0,0,0,0,0,0,0,0,0,0
20200316,705372,中美晶群益93購01,,,,,,0.00,0,0,0,0,0,0,0,0,0,0,0,0,0
20200316,705373,優群群益94購01,1.07,1.09,1.01,1.09,-0.14,-11.38,15000,3,15530,0,0,0,0,0,0,15000,0,15000,15000
20200316,705376,力旺凱基93購02,,,,,,0.00,0,0,0,0,0,0,0,0,0,0,0,0,0
20200316,705378,直得凱基93購01,,,,,,0.00,0,0,0,0,0,0,0,0,0,0,0,0,0
20200316,705383,璟德凱基93購01,,,,,,0.00,0,0,0,0,0,0,0,0,0,0,0,0,0
20200316,705390,聚積兆豐93購01,,,,,,0.00,0,0,0,0,0,0,0,0,0,0,0,0,0
20200316,705400,良維國泰93購01,,,,,,0.00,0,0,0,0,0,0,0,0,0,0,0,0,0
20200316,705401,穩懋國泰93購01,0.01,0.01,0.01,0.01,-0.01,-50.0,10000,1,100,0,0,0,0,0,0,10000,0,10000,10000
20200316,705402,智擎中信93購01,,,,,,0.00,0,0,0,0,0,0,0,0,0,0,0,0,0
20200316,705409,威剛富邦94購01,1.00,1.00,1.00,1.00,-0.26,-20.63,2000,2,2000,0,0,0,0,0,0,0,2000,-2000,-2000
20200316,705410,M31元大93購03,,,,,,0.00,0,0,0,0,0,0,0,0,0,0,0,0,0
20200316,705416,六角兆豐93購01,,,,,,0.00,0,0,0,0,0,0,0,0,0,0,0,0,0
20200316,705419,威剛群益93購01,,,,,,0.00,0,0,0,0,0,0,0,0,0,0,0,0,0
20200316,705420,新普群益94購01,0.83,0.83,0.83,0.83,-0.44,-34.65,5000,1,4150,0,0,0,0,0,0,0,5000,-5000,-5000
20200316,705427,威剛統一94購01,,,,,,0.00,0,0,0,0,0,0,0,0,0,0,0,0,0
20200316,705429,M31凱基93購01,,,,,,0.00,0,0,0,0,0,0,0,0,0,0,0,0,0
20200316,705430,上詮凱基93購01,,,,,,0.00,0,0,0,0,0,0,0,0,0,0,0,0,0
20200316,705431,禾昌凱基93購01,,,,,,0.00,0,0,0,0,0,0,0,0,0,0,0,0,0
20200316,705433,威剛凱基93購01,2.50,2.50,2.50,2.50,+0.70,38.89,56000,1,140000,0,0,0,0,0,0,56000,0,56000,56000
20200316,705437,穩懋凱基93購12,,,,,,0.00,0,0,0,0,0,0,0,0,0,0,0,0,0
20200316,705439,合晶國票93購01,,,,,,0.00,0,0,0,0,0,0,0,0,0,0,0,0,0
20200316,705441,原相國票94購01,2.34,2.44,2.29,2.29,-0.09,-3.78,162000,34,379280,0,0,0,0,0,0,162000,0,162000,162000
20200316,705442,大江國泰93購01,,,,,,0.00,0,0,0,0,0,0,0,0,0,0,0,0,0
20200316,705443,威剛國泰93購01,,,,,,0.00,0,0,0,0,0,0,0,0,0,0,0,0,0
20200316,705444,環球晶富邦94購01,,,,,,0.00,0,0,0,0,0,0,0,0,0,0,0,0,0
20200316,705445,環球晶麥證93購01,,,,,,0.00,0,0,0,0,0,0,0,0,0,0,0,0,0
20200316,705448,環球晶元富93購01,1.76,1.91,1.74,1.91,+0.33,20.89,101000,3,179210,0,0,0,0,0,0,101000,0,101000,101000
20200316,705450,環球晶兆豐93購01,,,,,,0.00,0,0,0,0,0,0,0,0,0,0,0,0,0
20200316,705452,三貝德元大93購03,,,,,,0.00,0,0,0,0,0,0,0,0,0,0,0,0,0
20200316,705461,頎邦群益94購01,0.01,0.01,0.01,0.01,-0.02,-66.67,100000,1,1000,0,0,0,0,0,0,100000,0,100000,100000
20200316,705463,立端亞東93購01,,,,,,0.00,0,0,0,0,0,0,0,0,0,0,0,0,0
20200316,705464,環球晶亞東93購01,,,,,,0.00,0,0,0,0,0,0,0,0,0,0,0,0,0
20200316,705475,穩懋麥證93購02,,,,,,0.00,0,0,0,0,0,0,0,0,0,0,0,0,0
20200316,705478,群聯兆豐93購01,,,,,,0.00,0,0,0,0,0,0,0,0,0,0,0,0,0
20200316,705479,聯亞兆豐93購02,,,,,,0.00,0,0,0,0,0,0,0,0,0,0,0,0,0
20200316,705482,M31中信93購01,,,,,,0.00,0,0,0,0,0,0,0,0,0,0,0,0,0
20200316,705487,直得凱基93購02,,,,,,0.00,0,0,0,0,0,0,0,0,0,0,0,0,0
20200316,705488,威剛凱基94購01,1.61,1.61,1.12,1.12,-0.20,-15.15,120000,2,137340,0,0,0,0,0,0,120000,0,120000,120000
20200316,705490,博智凱基93購01,,,,,,0.00,0,0,0,0,0,0,0,0,0,0,0,0,0
20200316,705492,群聯亞東94購01,,,,,,0.00,0,0,0,0,0,0,0,0,0,0,0,0,0
20200316,705497,建榮永豐94購01,,,,,,0.00,0,0,0,0,0,0,0,0,0,0,0,0,0
20200316,705503,保瑞國泰98購01,0.38,0.38,0.31,0.31,-0.06,-16.22,340000,6,122350,0,0,0,0,0,0,270000,50000,220000,220000
20200316,705504,威剛國泰93購03,,,,,,0.00,0,0,0,0,0,0,0,0,0,0,0,0,0
20200316,705505,博智國泰93購01,,,,,,0.00,0,0,0,0,0,0,0,0,0,0,0,0,0
20200316,705506,台燿統一93購01,,,,,,0.00,0,0,0,0,0,0,0,0,0,0,0,0,0
20200316,705507,由田統一94購01,,,,,,0.00,0,0,0,0,0,0,0,0,0,0,0,0,0
20200316,705510,穩懋中信94購02,,,,,,0.00,0,0,0,0,0,0,0,0,0,0,0,0,0
20200316,705513,信驊凱基93購01,0.87,0.87,0.60,0.60,-0.59,-49.58,7000,2,5820,0,0,0,0,0,0,6000,1000,5000,5000
20200316,705514,信驊凱基93購02,,,,,,0.00,0,0,0,0,0,0,0,0,0,0,0,0,0
20200316,705516,穩懋凱基93購14,,,,,,0.00,0,0,0,0,0,0,0,0,0,0,0,0,0
20200316,705518,環球晶元富93購02,1.47,1.71,1.41,1.41,-0.21,-12.96,138000,4,209630,0,0,0,0,0,0,130000,8000,122000,122000
20200316,705519,鐿鈦國票93購01,,,,,,0.00,0,0,0,0,0,0,0,0,0,0,0,0,0
20200316,705523,威剛國泰94購01,,,,,,0.00,0,0,0,0,0,0,0,0,0,0,0,0,0
20200316,705524,中美晶富邦93購01,,,,,,0.00,0,0,0,0,0,0,0,0,0,0,0,0,0
20200316,705525,昇達科富邦94購01,,,,,,0.00,0,0,0,0,0,0,0,0,0,0,0,0,0
20200316,705526,神盾富邦93購01,,,,,,0.00,0,0,0,0,0,0,0,0,0,0,0,0,0
20200316,705549,神盾麥證93購01,0.01,0.01,0.01,0.01,-0.04,-80.0,5000,1,50,5000,0,5000,0,0,0,5000,0,5000,5000
20200316,705554,神盾兆豐93購01,,,,,,0.00,0,0,0,0,0,0,0,0,0,0,0,0,0
20200316,705558,旺矽群益93購01,,,,,,0.00,0,0,0,0,0,0,0,0,0,0,0,0,0
20200316,705565,原相元大93購01,,,,,,0.00,0,0,0,0,0,0,0,0,0,0,0,0,0
20200316,705566,晶焱元大93購03,,,,,,0.00,0,0,0,0,0,0,0,0,0,0,0,0,0
20200316,705571,大宇資凱基94購01,,,,,,0.00,0,0,0,0,0,0,0,0,0,0,0,0,0
20200316,705573,宜鼎凱基93購01,1.83,2.10,1.83,2.10,+1.15,121.05,60000,2,112500,0,0,0,0,0,0,50000,10000,40000,40000
20200316,705574,是方凱基93購01,0.30,0.41,0.25,0.26,+0.03,13.04,732000,77,253460,0,0,0,0,0,0,3000,709000,-706000,-706000
20200316,705578,群翊國泰93購01,,,,,,0.00,0,0,0,0,0,0,0,0,0,0,0,0,0
20200316,705579,大江富邦94購01,,,,,,0.00,0,0,0,0,0,0,0,0,0,0,0,0,0
20200316,705580,昂寶富邦95購01,0.97,0.97,0.97,0.97,+0.01,1.04,10000,1,9700,0,0,0,0,0,0,10000,0,10000,10000
20200316,705581,群聯富邦93購01,,,,,,0.00,0,0,0,0,0,0,0,0,0,0,0,0,0
20200316,705583,雙鴻中信94購01,,,,,,0.00,0,0,0,0,0,0,0,0,0,0,0,0,0
20200316,705585,神盾國票94購01,,,,,,0.00,0,0,0,0,0,0,0,0,0,0,0,0,0
20200316,705586,泰博國泰93購01,,,,,,0.00,0,0,0,0,0,0,0,0,0,0,0,0,0
20200316,705587,神盾國泰94購01,,,,,,0.00,0,0,0,0,0,0,0,0,0,0,0,0,0
20200316,705588,大江富邦94購02,,,,,,0.00,0,0,0,0,0,0,0,0,0,0,0,0,0
20200316,705590,神盾永豐93購01,,,,,,0.00,0,0,0,0,0,0,0,0,0,0,0,0,0
20200316,705597,雙鴻元大93購03,,,,,,0.00,0,0,0,0,0,0,0,0,0,0,0,0,0
20200316,705608,威剛元富95購01,,,,,,0.00,0,0,0,0,0,0,0,0,0,0,0,0,0
20200316,705609,神盾國票94購02,,,,,,0.00,0,0,0,0,0,0,0,0,0,0,0,0,0
20200316,705611,昂寶國泰94購01,1.36,1.36,1.36,1.36,+0.53,63.86,40000,1,54400,0,0,0,0,0,0,40000,0,40000,40000
20200316,705612,網龍國泰94購01,,,,,,0.00,0,0,0,0,0,0,0,0,0,0,0,0,0
20200316,705613,晶焱兆豐93購01,,,,,,0.00,0,0,0,0,0,0,0,0,0,0,0,0,0
20200316,705617,良維元大93購02,,,,,,0.00,0,0,0,0,0,0,0,0,0,0,0,0,0
20200316,705627,宏捷科永豐93購01,1.63,1.63,1.41,1.41,+0.09,6.82,21000,4,31830,0,0,0,0,0,0,19000,2000,17000,17000
20200316,705629,建榮永豐94購02,,,,,,0.00,0,0,0,0,0,0,0,0,0,0,0,0,0
20200316,705636,譜瑞凱基94購01,1.26,1.74,1.26,1.71,+0.45,35.71,172000,23,275590,0,0,0,0,0,0,28000,158000,-130000,-130000
20200316,705640,雙鴻元大93購04,,,,,,0.00,0,0,0,0,0,0,0,0,0,0,0,0,0
20200316,705641,中美晶國泰93購01,,,,,,0.00,0,0,0,0,0,0,0,0,0,0,0,0,0
20200316,705642,泰博國泰93購02,,,,,,0.00,0,0,0,0,0,0,0,0,0,0,0,0,0
20200316,705643,環球晶國泰93購03,,,,,,0.00,0,0,0,0,0,0,0,0,0,0,0,0,0
20200316,705661,大江群益95購01,,,,,,0.00,0,0,0,0,0,0,0,0,0,0,0,0,0
20200316,705662,保瑞群益94購01,,,,,,0.00,0,0,0,0,0,0,0,0,0,0,0,0,0
20200316,705663,環球晶群益94購01,,,,,,0.00,0,0,0,0,0,0,0,0,0,0,0,0,0
20200316,705664,原相麥證94購01,4.37,4.53,4.21,4.21,-0.22,-4.97,197000,12,835170,197000,0,197000,0,0,0,197000,0,197000,197000
20200316,705667,建榮國泰94購01,,,,,,0.00,0,0,0,0,0,0,0,0,0,0,0,0,0
20200316,705668,勝麗國泰94購01,,,,,,0.00,0,0,0,0,0,0,0,0,0,0,0,0,0
20200316,705669,鈺太國泰94購01,,,,,,0.00,0,0,0,0,0,0,0,0,0,0,0,0,0
20200316,705670,建榮國票94購01,,,,,,0.00,0,0,0,0,0,0,0,0,0,0,0,0,0
20200316,705679,鈺太永豐94購01,,,,,,0.00,0,0,0,0,0,0,0,0,0,0,0,0,0
20200316,705683,建榮統一95購01,,,,,,0.00,0,0,0,0,0,0,0,0,0,0,0,0,0
20200316,705684,建榮統一96購01,,,,,,0.00,0,0,0,0,0,0,0,0,0,0,0,0,0
20200316,705685,建榮統一96購02,,,,,,0.00,0,0,0,0,0,0,0,0,0,0,0,0,0
20200316,705690,威剛元大94購01,0.90,0.90,0.70,0.72,+0.07,10.77,50000,5,39000,0,0,0,0,0,0,10000,40000,-30000,-30000
20200316,705695,建榮國票95購01,,,,,,0.00,0,0,0,0,0,0,0,0,0,0,0,0,0
20200316,705696,鈺太國票95購01,0.36,0.36,0.36,0.36,+0.02,5.88,3000,1,1080,0,0,0,0,0,0,3000,0,3000,3000
20200316,705698,保瑞國泰95購01,0.58,0.61,0.45,0.45,-0.14,-23.73,496000,4,294310,0,0,0,0,0,0,496000,0,496000,496000
20200316,705701,建榮永豐95購01,,,,,,0.00,0,0,0,0,0,0,0,0,0,0,0,0,0
20200316,705702,宣德富邦95購01,0.18,0.18,0.18,0.18,-0.20,-52.63,5000,1,900,0,0,0,0,0,0,0,5000,-5000,-5000
20200316,705706,建榮群益94購01,,,,,,0.00,0,0,0,0,0,0,0,0,0,0,0,0,0
20200316,705710,同致元大94購01,,,,,,0.00,0,0,0,0,0,0,0,0,0,0,0,0,0
20200316,705712,邦特中信94購01,,,,,,0.00,0,0,0,0,0,0,0,0,0,0,0,0,0
20200316,705720,雙鴻永豐94購01,,,,,,0.00,0,0,0,0,0,0,0,0,0,0,0,0,0
20200316,705727,緯軟兆豐94購01,,,,,,0.00,0,0,0,0,0,0,0,0,0,0,0,0,0
20200316,705730,群聯元富96購01,0.09,0.09,0.09,0.09,0.00,0.0,10000,2,900,0,0,0,0,0,0,0,0,0,0
20200316,705735,信昌電國泰94購01,,,,,,0.00,0,0,0,0,0,0,0,0,0,0,0,0,0
20200316,705736,建榮國泰95購01,,,,,,0.00,0,0,0,0,0,0,0,0,0,0,0,0,0
20200316,705740,榮剛中信94購01,,,,,,0.00,0,0,0,0,0,0,0,0,0,0,0,0,0
20200316,705741,富喬統一96購01,,,,,,0.00,0,0,0,0,0,0,0,0,0,0,0,0,0
20200316,705742,穩懋統一94購01,,,,,,0.00,0,0,0,0,0,0,0,0,0,0,0,0,0
20200316,705743,三貝德元大94購01,,,,,,0.00,0,0,0,0,0,0,0,0,0,0,0,0,0
20200316,705744,宣德元大95購01,,,,,,0.00,0,0,0,0,0,0,0,0,0,0,0,0,0
20200316,705750,群聯兆豐94購01,,,,,,0.00,0,0,0,0,0,0,0,0,0,0,0,0,0
20200316,705756,緯軟國泰94購01,,,,,,0.00,0,0,0,0,0,0,0,0,0,0,0,0,0
20200316,705760,光頡凱基94購01,,,,,,0.00,0,0,0,0,0,0,0,0,0,0,0,0,0
20200316,705763,穩懋凱基94購01,,,,,,0.00,0,0,0,0,0,0,0,0,0,0,0,0,0
20200316,705767,環球晶元大95購01,3.68,3.68,3.68,3.68,-1.67,-31.21,10000,1,36800,0,0,0,0,0,0,0,10000,-10000,-10000
20200316,705775,宜鼎群益96購01,1.69,1.69,1.69,1.69,+0.19,12.67,10000,1,16900,0,0,0,0,0,0,0,10000,-10000,-10000
20200316,705776,原相群益96購01,,,,,,0.00,0,0,0,0,0,0,0,0,0,0,0,0,0
20200316,705781,群聯統一95購01,,,,,,0.00,0,0,0,0,0,0,0,0,0,0,0,0,0
20200316,705784,穩懋統一94購02,,,,,,0.00,0,0,0,0,0,0,0,0,0,0,0,0,0
20200316,705787,榮剛元大94購01,,,,,,0.00,0,0,0,0,0,0,0,0,0,0,0,0,0
20200316,705788,緯軟元大96購01,,,,,,0.00,0,0,0,0,0,0,0,0,0,0,0,0,0
20200316,705791,大江凱基94購01,,,,,,0.00,0,0,0,0,0,0,0,0,0,0,0,0,0
20200316,705799,聯亞凱基94購01,,,,,,0.00,0,0,0,0,0,0,0,0,0,0,0,0,0
20200316,705800,穩懋凱基94購02,,,,,,0.00,0,0,0,0,0,0,0,0,0,0,0,0,0
20200316,705801,宏捷科國泰94購01,0.62,0.70,0.62,0.63,+0.13,26.0,174000,7,114520,0,0,0,0,0,0,160000,14000,146000,146000
20200316,705802,金居富邦95購01,,,,,,0.00,0,0,0,0,0,0,0,0,0,0,0,0,0
20200316,705803,原相富邦97購01,2.73,2.99,2.23,2.23,-0.14,-5.91,57000,24,155370,0,0,0,0,0,0,21000,10000,11000,11000
20200316,705804,晶焱富邦95購01,,,,,,0.00,0,0,0,0,0,0,0,0,0,0,0,0,0
20200316,705805,環球晶富邦97購01,1.06,1.13,0.70,0.70,-0.26,-27.08,111000,8,105400,0,0,0,0,0,0,109000,2000,107000,107000
20200316,705810,原相兆豐94購01,,,,,,0.00,0,0,0,0,0,0,0,0,0,0,0,0,0
20200316,705811,晶焱兆豐94購02,,,,,,0.00,0,0,0,0,0,0,0,0,0,0,0,0,0
20200316,705820,昇達科群益94購02,,,,,,0.00,0,0,0,0,0,0,0,0,0,0,0,0,0
20200316,705826,立端亞東94購01,,,,,,0.00,0,0,0,0,0,0,0,0,0,0,0,0,0
20200316,705831,建榮永豐94購03,,,,,,0.00,0,0,0,0,0,0,0,0,0,0,0,0,0
20200316,705838,上詮凱基94購01,,,,,,0.00,0,0,0,0,0,0,0,0,0,0,0,0,0
20200316,705845,廣明凱基94購01,,,,,,0.00,0,0,0,0,0,0,0,0,0,0,0,0,0
20200316,705846,台燿統一95購01,,,,,,0.00,0,0,0,0,0,0,0,0,0,0,0,0,0
20200316,705847,環球晶統一99購01,2.40,2.40,1.75,1.75,-0.68,-27.98,70000,23,139420,0,0,0,0,0,0,5000,65000,-60000,-60000
20200316,705848,禾昌元富96購01,0.01,0.01,0.01,0.01,0.00,0.0,20000,1,200,0,0,0,0,0,0,20000,0,20000,20000
20200316,705869,穩懋元大96購01,0.76,0.89,0.64,0.64,-0.14,-17.95,263000,30,210570,0,0,0,0,0,0,88000,181000,-93000,-93000
20200316,705872,M31國泰94購01,,,,,,0.00,0,0,0,0,0,0,0,0,0,0,0,0,0
20200316,705873,大江國泰94購01,,,,,,0.00,0,0,0,0,0,0,0,0,0,0,0,0,0
20200316,705876,宏捷科元大94購01,0.13,0.13,0.13,0.13,-0.04,-23.53,1000,1,130,0,0,0,0,0,0,1000,1000,0,0
20200316,705877,旺矽元大94購01,,,,,,0.00,0,0,0,0,0,0,0,0,0,0,0,0,0
20200316,705881,M31凱基94購01,,,,,,0.00,0,0,0,0,0,0,0,0,0,0,0,0,0
20200316,705886,廣明凱基94購03,,,,,,0.00,0,0,0,0,0,0,0,0,0,0,0,0,0
20200316,705889,昇達科兆豐94購01,,,,,,0.00,0,0,0,0,0,0,0,0,0,0,0,0,0
20200316,705894,新普群益94購02,,,,,,0.00,0,0,0,0,0,0,0,0,0,0,0,0,0
20200316,705900,保瑞國票94購01,,,,,,0.00,0,0,0,0,0,0,0,0,0,0,0,0,0
20200316,705901,建榮國票95購02,,,,,,0.00,0,0,0,0,0,0,0,0,0,0,0,0,0
20200316,705903,穩懋國票94購02,,,,,,0.00,0,0,0,0,0,0,0,0,0,0,0,0,0
20200316,705904,六角富邦97購01,,,,,,0.00,0,0,0,0,0,0,0,0,0,0,0,0,0
20200316,705905,昇達科富邦97購01,,,,,,0.00,0,0,0,0,0,0,0,0,0,0,0,0,0
20200316,705906,大江凱基94購02,,,,,,0.00,0,0,0,0,0,0,0,0,0,0,0,0,0
20200316,705910,廣明凱基94購04,,,,,,0.00,0,0,0,0,0,0,0,0,0,0,0,0,0
20200316,705912,昇達科國票94購01,,,,,,0.00,0,0,0,0,0,0,0,0,0,0,0,0,0
20200316,705921,建榮永豐94購04,,,,,,0.00,0,0,0,0,0,0,0,0,0,0,0,0,0
20200316,705924,大江元富96購01,0.04,0.04,0.04,0.04,0.00,0.0,3000,1,120,0,0,0,0,0,0,0,3000,-3000,-3000
20200316,705926,六角台新94購01,,,,,,0.00,0,0,0,0,0,0,0,0,0,0,0,0,0
20200316,705927,原相台新94購01,6.70,7.15,4.19,4.19,-3.06,-42.21,132000,35,851890,0,0,0,0,0,0,119000,13000,106000,106000
20200316,705930,建榮群益94購02,,,,,,0.00,0,0,0,0,0,0,0,0,0,0,0,0,0
20200316,705934,大江凱基94購03,,,,,,0.00,0,0,0,0,0,0,0,0,0,0,0,0,0
20200316,705937,中美晶元富95購01,1.77,1.77,1.35,1.35,-0.32,-19.16,60000,4,99600,0,0,0,0,0,0,50000,10000,40000,40000
20200316,705939,良維兆豐94購01,,,,,,0.00,0,0,0,0,0,0,0,0,0,0,0,0,0
20200316,705943,神盾群益94購02,,,,,,0.00,0,0,0,0,0,0,0,0,0,0,0,0,0
20200316,705944,台燿元大94購01,,,,,,0.00,0,0,0,0,0,0,0,0,0,0,0,0,0
20200316,705947,建榮元大94購01,,,,,,0.00,0,0,0,0,0,0,0,0,0,0,0,0,0
20200316,705948,原相元大94購02,2.82,2.82,1.70,1.70,-0.99,-36.8,12000,2,31600,0,0,0,0,0,0,10000,2000,8000,8000
20200316,705952,旺矽國票94購01,,,,,,0.00,0,0,0,0,0,0,0,0,0,0,0,0,0
20200316,705953,勝麗國票94購01,,,,,,0.00,0,0,0,0,0,0,0,0,0,0,0,0,0
20200316,705954,網龍國泰95購01,,,,,,0.00,0,0,0,0,0,0,0,0,0,0,0,0,0
20200316,705955,聯亞國泰95購01,,,,,,0.00,0,0,0,0,0,0,0,0,0,0,0,0,0
20200316,705961,建榮永豐94購05,,,,,,0.00,0,0,0,0,0,0,0,0,0,0,0,0,0
20200316,705966,聯亞元大94購01,,,,,,0.00,0,0,0,0,0,0,0,0,0,0,0,0,0
20200316,705969,皇田國泰95購01,,,,,,0.00,0,0,0,0,0,0,0,0,0,0,0,0,0
20200316,705970,大江凱基94購04,,,,,,0.00,0,0,0,0,0,0,0,0,0,0,0,0,0
20200316,705972,建榮凱基94購01,,,,,,0.00,0,0,0,0,0,0,0,0,0,0,0,0,0
20200316,705974,優群麥證94購01,0.96,1.07,0.92,0.99,+0.07,7.61,20000,7,19600,15000,5000,10000,0,0,0,15000,5000,10000,10000
20200316,705987,先豐凱基93購02,,,,,,0.00,0,0,0,0,0,0,0,0,0,0,0,0,0
20200316,705988,合晶凱基93購03,,,,,,0.00,0,0,0,0,0,0,0,0,0,0,0,0,0
20200316,705989,皇田凱基93購04,,,,,,0.00,0,0,0,0,0,0,0,0,0,0,0,0,0
20200316,705990,群聯凱基93購04,,,,,,0.00,0,0,0,0,0,0,0,0,0,0,0,0,0
20200316,705991,穩懋凱基93購16,,,,,,0.00,0,0,0,0,0,0,0,0,0,0,0,0,0
20200316,705992,信驊元富93購01,1.03,1.03,1.03,1.03,-0.50,-32.68,4000,1,4120,0,0,0,0,0,0,4000,0,4000,4000
20200316,705993,良維兆豐94購02,,,,,,0.00,0,0,0,0,0,0,0,0,0,0,0,0,0
20200316,705994,環球晶台新95購01,,,,,,0.00,0,0,0,0,0,0,0,0,0,0,0,0,0
20200316,705995,鈺太台新93購01,,,,,,0.00,0,0,0,0,0,0,0,0,0,0,0,0,0
20200316,705996,台燿康和93購01,,,,,,0.00,0,0,0,0,0,0,0,0,0,0,0,0,0
20200316,705997,朋億康和93購01,,,,,,0.00,0,0,0,0,0,0,0,0,0,0,0,0,0
20200316,705998,聯亞康和93購01,,,,,,0.00,0,0,0,0,0,0,0,0,0,0,0,0,0
20200316,705999,均豪群益93購01,,,,,,0.00,0,0,0,0,0,0,0,0,0,0,0,0,0
20200316,706000,廣明群益93購02,,,,,,0.00,0,0,0,0,0,0,0,0,0,0,0,0,0
20200316,706001,譜瑞第一93購01,,,,,,0.00,0,0,0,0,0,0,0,0,0,0,0,0,0
20200316,706002,大江永豐93購04,,,,,,0.00,0,0,0,0,0,0,0,0,0,0,0,0,0
20200316,706003,神盾國票95購01,,,,,,0.00,0,0,0,0,0,0,0,0,0,0,0,0,0
20200316,706004,台燿國泰94購01,0.08,0.08,0.08,0.08,+0.02,33.33,10000,1,800,0,0,0,0,0,0,0,10000,-10000,-10000
20200316,706005,中美晶元大95購01,2.91,3.12,2.80,2.92,-0.18,-5.81,57000,10,170030,0,0,0,0,0,0,46000,47000,-1000,-1000
20200316,706006,台燿元大93購04,,,,,,0.00,0,0,0,0,0,0,0,0,0,0,0,0,0
20200316,706007,金居元大94購02,,,,,,0.00,0,0,0,0,0,0,0,0,0,0,0,0,0
20200316,706008,鐿鈦元大93購01,,,,,,0.00,0,0,0,0,0,0,0,0,0,0,0,0,0
20200316,706009,宜鼎統一93購01,,,,,,0.00,0,0,0,0,0,0,0,0,0,0,0,0,0
20200316,706010,穩懋統一93購07,,,,,,0.00,0,0,0,0,0,0,0,0,0,0,0,0,0
20200316,706011,大宇資凱基93購01,,,,,,0.00,0,0,0,0,0,0,0,0,0,0,0,0,0
20200316,706012,佳邦凱基93購02,,,,,,0.00,0,0,0,0,0,0,0,0,0,0,0,0,0
20200316,706013,泰博凱基93購02,,,,,,0.00,0,0,0,0,0,0,0,0,0,0,0,0,0
20200316,706014,神盾凱基93購05,,,,,,0.00,0,0,0,0,0,0,0,0,0,0,0,0,0
20200316,706015,僑威凱基93購01,,,,,,0.00,0,0,0,0,0,0,0,0,0,0,0,0,0
20200316,706016,優群凱基93購01,0.39,0.39,0.39,0.39,+0.12,44.44,10000,1,3900,0,0,0,0,0,0,10000,0,10000,10000
20200316,706017,環球晶凱基93購13,,,,,,0.00,0,0,0,0,0,0,0,0,0,0,0,0,0
20200316,706018,金可永豐93購01,,,,,,0.00,0,0,0,0,0,0,0,0,0,0,0,0,0
20200316,706019,宣德永豐93購02,,,,,,0.00,0,0,0,0,0,0,0,0,0,0,0,0,0
20200316,706020,建榮元大93購03,,,,,,0.00,0,0,0,0,0,0,0,0,0,0,0,0,0
20200316,706021,緯軟元大94購03,,,,,,0.00,0,0,0,0,0,0,0,0,0,0,0,0,0
20200316,706022,昇達科國票94購02,,,,,,0.00,0,0,0,0,0,0,0,0,0,0,0,0,0
20200316,706023,原相國票95購01,,,,,,0.00,0,0,0,0,0,0,0,0,0,0,0,0,0
20200316,706024,建榮國泰95購02,,,,,,0.00,0,0,0,0,0,0,0,0,0,0,0,0,0
20200316,706025,建榮國泰95購03,,,,,,0.00,0,0,0,0,0,0,0,0,0,0,0,0,0
20200316,706026,雙鴻國泰95購01,,,,,,0.00,0,0,0,0,0,0,0,0,0,0,0,0,0
20200316,706027,環球晶元富93購05,1.62,1.62,1.62,1.62,+0.46,39.66,77000,1,124740,0,0,0,0,0,0,77000,0,77000,77000
20200316,706028,大宇資麥證94購01,,,,,,0.00,0,0,0,0,0,0,0,0,0,0,0,0,0
20200316,706029,由田元大93購03,,,,,,0.00,0,0,0,0,0,0,0,0,0,0,0,0,0
20200316,706030,宜鼎元大93購02,,,,,,0.00,0,0,0,0,0,0,0,0,0,0,0,0,0
20200316,706031,信昌電元大93購01,,,,,,0.00,0,0,0,0,0,0,0,0,0,0,0,0,0
20200316,706032,環球晶元大93購11,,,,,,0.00,0,0,0,0,0,0,0,0,0,0,0,0,0
20200316,706033,雙美元大94購01,,,,,,0.00,0,0,0,0,0,0,0,0,0,0,0,0,0
20200316,706034,穩懋元大93購14,,,,,,0.00,0,0,0,0,0,0,0,0,0,0,0,0,0
20200316,706035,金可中信93購01,,,,,,0.00,0,0,0,0,0,0,0,0,0,0,0,0,0
20200316,706036,立端統一93購01,,,,,,0.00,0,0,0,0,0,0,0,0,0,0,0,0,0
20200316,706037,旺矽統一94購01,,,,,,0.00,0,0,0,0,0,0,0,0,0,0,0,0,0
20200316,706038,中美晶凱基93購04,0.12,0.12,0.12,0.12,-0.01,-7.69,10000,1,1200,0,0,0,0,0,0,10000,0,10000,10000
20200316,706039,佳邦凱基93購03,,,,,,0.00,0,0,0,0,0,0,0,0,0,0,0,0,0
20200316,706040,直得凱基93購03,,,,,,0.00,0,0,0,0,0,0,0,0,0,0,0,0,0
20200316,706041,原相凱基93購04,,,,,,0.00,0,0,0,0,0,0,0,0,0,0,0,0,0
20200316,706042,群聯凱基93購05,0.03,0.03,0.03,0.03,+0.02,200.0,1000,1,30,0,0,0,0,0,0,0,0,0,0
20200316,706043,環球晶凱基93購14,,,,,,0.00,0,0,0,0,0,0,0,0,0,0,0,0,0
20200316,706044,台半亞東93購01,,,,,,0.00,0,0,0,0,0,0,0,0,0,0,0,0,0
20200316,706045,大田永豐94購01,,,,,,0.00,0,0,0,0,0,0,0,0,0,0,0,0,0
20200316,706046,立端永豐93購02,,,,,,0.00,0,0,0,0,0,0,0,0,0,0,0,0,0
20200316,706047,良維永豐94購01,,,,,,0.00,0,0,0,0,0,0,0,0,0,0,0,0,0
20200316,706048,聯亞永豐93購01,,,,,,0.00,0,0,0,0,0,0,0,0,0,0,0,0,0
20200316,706049,穩懋永豐93購03,,,,,,0.00,0,0,0,0,0,0,0,0,0,0,0,0,0
20200316,706050,網龍康和93購01,,,,,,0.00,0,0,0,0,0,0,0,0,0,0,0,0,0
20200316,706051,三貝德群益93購02,,,,,,0.00,0,0,0,0,0,0,0,0,0,0,0,0,0
20200316,706052,光隆群益93購01,,,,,,0.00,0,0,0,0,0,0,0,0,0,0,0,0,0
20200316,706053,保瑞群益94購02,0.11,0.11,0.11,0.11,-0.12,-52.17,30000,1,3300,0,0,0,0,0,0,30000,0,30000,30000
20200316,706054,穩懋中信95購03,,,,,,0.00,0,0,0,0,0,0,0,0,0,0,0,0,0
20200316,706055,中美晶元富93購01,1.57,1.57,1.57,1.57,+0.34,27.64,32000,1,50240,0,0,0,0,0,0,32000,0,32000,32000
20200316,706056,穩懋元富95購01,0.22,0.22,0.22,0.22,+0.01,4.76,10000,1,2200,0,0,0,0,0,0,10000,0,10000,10000
20200316,706057,宜鼎台新93購01,,,,,,0.00,0,0,0,0,0,0,0,0,0,0,0,0,0
20200316,706058,穩懋台新93購01,,,,,,0.00,0,0,0,0,0,0,0,0,0,0,0,0,0
20200316,706059,大江元大94購01,,,,,,0.00,0,0,0,0,0,0,0,0,0,0,0,0,0
20200316,706060,世界元大93購01,,,,,,0.00,0,0,0,0,0,0,0,0,0,0,0,0,0
20200316,706061,昂寶元大93購02,,,,,,0.00,0,0,0,0,0,0,0,0,0,0,0,0,0
20200316,706062,中美晶兆豐94購02,0.96,0.96,0.96,0.96,-0.04,-4.0,5000,1,4800,0,0,0,0,0,0,5000,0,5000,5000
20200316,706063,元太兆豐93購01,,,,,,0.00,0,0,0,0,0,0,0,0,0,0,0,0,0
20200316,706064,泰博兆豐93購02,,,,,,0.00,0,0,0,0,0,0,0,0,0,0,0,0,0
20200316,706065,信昌電群益93購02,,,,,,0.00,0,0,0,0,0,0,0,0,0,0,0,0,0
20200316,706066,元太凱基93購02,,,,,,0.00,0,0,0,0,0,0,0,0,0,0,0,0,0
20200316,706067,合晶凱基93購04,,,,,,0.00,0,0,0,0,0,0,0,0,0,0,0,0,0
20200316,706068,杰力凱基93購04,,,,,,0.00,0,0,0,0,0,0,0,0,0,0,0,0,0
20200316,706069,博智凱基93購02,5.55,6.00,5.55,6.00,+1.38,29.87,60000,3,342000,0,0,0,0,0,0,50000,10000,40000,40000
20200316,706070,新普凱基93購02,,,,,,0.00,0,0,0,0,0,0,0,0,0,0,0,0,0
20200316,706071,環球晶凱基93購15,,,,,,0.00,0,0,0,0,0,0,0,0,0,0,0,0,0
20200316,706072,雙美凱基93購01,,,,,,0.00,0,0,0,0,0,0,0,0,0,0,0,0,0
20200316,706073,穩懋凱基93購18,,,,,,0.00,0,0,0,0,0,0,0,0,0,0,0,0,0
20200316,706074,大田永豐93購01,,,,,,0.00,0,0,0,0,0,0,0,0,0,0,0,0,0
20200316,706075,大江永豐93購05,,,,,,0.00,0,0,0,0,0,0,0,0,0,0,0,0,0
20200316,706076,六角永豐93購01,,,,,,0.00,0,0,0,0,0,0,0,0,0,0,0,0,0
20200316,706077,由田永豐93購02,,,,,,0.00,0,0,0,0,0,0,0,0,0,0,0,0,0
20200316,706078,旺矽永豐94購01,,,,,,0.00,0,0,0,0,0,0,0,0,0,0,0,0,0
20200316,706079,茂達永豐93購02,,,,,,0.00,0,0,0,0,0,0,0,0,0,0,0,0,0
20200316,706080,優群永豐94購01,1.49,1.64,1.46,1.56,+0.15,10.64,100000,6,159450,0,0,0,0,0,0,70000,30000,40000,40000
20200316,706081,立端國票93購01,,,,,,0.00,0,0,0,0,0,0,0,0,0,0,0,0,0
20200316,706082,美琪瑪國票94購01,,,,,,0.00,0,0,0,0,0,0,0,0,0,0,0,0,0
20200316,706083,群聯國票94購01,,,,,,0.00,0,0,0,0,0,0,0,0,0,0,0,0,0
20200316,706084,環宇國票93購02,,,,,,0.00,0,0,0,0,0,0,0,0,0,0,0,0,0
20200316,706085,穩懋國泰94購02,0.14,0.14,0.14,0.14,+0.04,40.0,37000,2,5180,0,0,0,0,0,0,37000,0,37000,37000
20200316,706086,中美晶富邦94購01,0.51,0.51,0.51,0.51,-0.24,-32.0,3000,1,1530,0,0,0,0,0,0,3000,0,3000,3000
20200316,706087,佳邦凱基93購04,,,,,,0.00,0,0,0,0,0,0,0,0,0,0,0,0,0
20200316,706088,泰博凱基93購03,0.41,0.54,0.41,0.54,+0.28,107.69,40000,4,20100,0,0,0,0,0,0,0,40000,-40000,-40000
20200316,706089,神盾凱基93購06,,,,,,0.00,0,0,0,0,0,0,0,0,0,0,0,0,0
20200316,706090,環球晶凱基93購16,0.53,0.53,0.53,0.53,-0.17,-24.29,30000,1,15900,0,0,0,0,0,0,30000,0,30000,30000
20200316,706091,晟德凱基93購02,,,,,,0.00,0,0,0,0,0,0,0,0,0,0,0,0,0
20200316,706092,原相日盛93購01,2.41,2.87,2.41,2.62,-0.02,-0.76,149000,9,395330,0,0,0,0,0,0,149000,0,149000,149000
20200316,706093,環球晶元富93購06,1.23,1.23,1.23,1.23,-0.06,-4.65,30000,2,36900,0,0,0,0,0,0,30000,0,30000,30000
20200316,706094,緯軟台新93購01,,,,,,0.00,0,0,0,0,0,0,0,0,0,0,0,0,0
20200316,706095,中美晶永豐93購02,,,,,,0.00,0,0,0,0,0,0,0,0,0,0,0,0,0
20200316,706096,波若威永豐93購01,,,,,,0.00,0,0,0,0,0,0,0,0,0,0,0,0,0
20200316,706097,信驊永豐93購02,0.08,0.08,0.08,0.08,-0.10,-55.56,25000,1,2000,0,0,0,0,0,0,25000,0,25000,25000
20200316,706098,勝麗兆豐93購01,,,,,,0.00,0,0,0,0,0,0,0,0,0,0,0,0,0
20200316,706099,雙鴻兆豐94購01,,,,,,0.00,0,0,0,0,0,0,0,0,0,0,0,0,0
20200316,706100,穩懋兆豐94購01,,,,,,0.00,0,0,0,0,0,0,0,0,0,0,0,0,0
20200316,706101,鈺太康和93購01,,,,,,0.00,0,0,0,0,0,0,0,0,0,0,0,0,0
20200316,706102,良維群益93購03,,,,,,0.00,0,0,0,0,0,0,0,0,0,0,0,0,0
20200316,706103,廣明群益93購03,,,,,,0.00,0,0,0,0,0,0,0,0,0,0,0,0,0
20200316,706104,宜鼎元大93購03,0.34,0.36,0.34,0.36,+0.06,20.0,20000,2,7000,0,0,0,0,0,0,20000,0,20000,20000
20200316,706105,宜鼎國票93購01,,,,,,0.00,0,0,0,0,0,0,0,0,0,0,0,0,0
20200316,706106,信驊國票93購01,,,,,,0.00,0,0,0,0,0,0,0,0,0,0,0,0,0
20200316,706107,網龍國票94購01,,,,,,0.00,0,0,0,0,0,0,0,0,0,0,0,0,0
20200316,706108,威剛富邦97購01,1.15,1.15,0.89,0.92,-0.02,-2.13,22000,3,22240,0,0,0,0,0,0,0,22000,-22000,-22000
20200316,706109,雙鴻富邦97購01,0.09,0.10,0.09,0.09,0.00,0.0,749000,10,67610,0,0,0,0,0,0,0,749000,-749000,-749000
20200316,706110,聯亞元富93購03,,,,,,0.00,0,0,0,0,0,0,0,0,0,0,0,0,0
20200316,706111,宣德國泰93購01,0.19,0.19,0.19,0.19,-0.13,-40.62,180000,1,34200,0,0,0,0,0,0,180000,0,180000,180000
20200316,706112,原相元大95購01,,,,,,0.00,0,0,0,0,0,0,0,0,0,0,0,0,0
20200316,706113,精華元大93購01,,,,,,0.00,0,0,0,0,0,0,0,0,0,0,0,0,0
20200316,706114,穩懋元大93購15,,,,,,0.00,0,0,0,0,0,0,0,0,0,0,0,0,0
20200316,706115,中美晶凱基93購05,0.95,0.95,0.50,0.50,-0.61,-54.95,80000,3,70600,0,0,0,0,0,0,60000,20000,40000,40000
20200316,706116,宜鼎凱基93購03,,,,,,0.00,0,0,0,0,0,0,0,0,0,0,0,0,0
20200316,706117,泰博凱基93購04,0.13,0.13,0.13,0.13,+0.01,8.33,10000,1,1300,0,0,0,0,0,0,10000,0,10000,10000
20200316,706118,緯軟凱基93購02,,,,,,0.00,0,0,0,0,0,0,0,0,0,0,0,0,0
20200316,706119,環球晶凱基93購17,,,,,,0.00,0,0,0,0,0,0,0,0,0,0,0,0,0
20200316,706120,穩懋凱基93購19,,,,,,0.00,0,0,0,0,0,0,0,0,0,0,0,0,0
20200316,706121,泰博統一93購01,,,,,,0.00,0,0,0,0,0,0,0,0,0,0,0,0,0
20200316,706122,環球晶統一93購01,,,,,,0.00,0,0,0,0,0,0,0,0,0,0,0,0,0
20200316,706123,穩懋統一93購08,,,,,,0.00,0,0,0,0,0,0,0,0,0,0,0,0,0
20200316,706124,群聯兆豐94購02,0.40,0.42,0.29,0.29,-0.13,-30.95,195000,12,68600,0,0,0,0,0,0,90000,0,90000,90000
20200316,706125,聚積兆豐94購01,,,,,,0.00,0,0,0,0,0,0,0,0,0,0,0,0,0
20200316,706126,穩懋兆豐93購04,,,,,,0.00,0,0,0,0,0,0,0,0,0,0,0,0,0
20200316,706127,博大康和93購01,,,,,,0.00,0,0,0,0,0,0,0,0,0,0,0,0,0
20200316,706128,宏觀群益93購01,,,,,,0.00,0,0,0,0,0,0,0,0,0,0,0,0,0
20200316,706129,信驊群益93購02,,,,,,0.00,0,0,0,0,0,0,0,0,0,0,0,0,0
20200316,706130,雙美群益95購01,,,,,,0.00,0,0,0,0,0,0,0,0,0,0,0,0,0
20200316,706131,聚積國票93購01,,,,,,0.00,0,0,0,0,0,0,0,0,0,0,0,0,0
20200316,706132,環球晶國票93購02,,,,,,0.00,0,0,0,0,0,0,0,0,0,0,0,0,0
20200316,706133,鈺太國票95購02,0.52,0.52,0.52,0.52,+0.02,4.0,10000,1,5200,0,0,0,0,0,0,0,10000,-10000,-10000
20200316,706134,穩懋富邦95購01,0.12,0.12,0.12,0.12,+0.02,20.0,1000,1,120,0,0,0,0,0,0,0,1000,-1000,-1000
20200316,706135,中美晶永豐93購03,,,,,,0.00,0,0,0,0,0,0,0,0,0,0,0,0,0
20200316,706136,由田永豐93購03,,,,,,0.00,0,0,0,0,0,0,0,0,0,0,0,0,0
20200316,706137,合晶永豐93購03,,,,,,0.00,0,0,0,0,0,0,0,0,0,0,0,0,0
20200316,706138,昂寶永豐93購01,,,,,,0.00,0,0,0,0,0,0,0,0,0,0,0,0,0
20200316,706139,直得永豐93購02,,,,,,0.00,0,0,0,0,0,0,0,0,0,0,0,0,0
20200316,706140,晶焱永豐93購02,,,,,,0.00,0,0,0,0,0,0,0,0,0,0,0,0,0
20200316,706141,順達永豐93購02,,,,,,0.00,0,0,0,0,0,0,0,0,0,0,0,0,0
20200316,706142,精華永豐93購02,,,,,,0.00,0,0,0,0,0,0,0,0,0,0,0,0,0
20200316,706143,聚積永豐93購01,,,,,,0.00,0,0,0,0,0,0,0,0,0,0,0,0,0
20200316,706144,先豐統一93購01,,,,,,0.00,0,0,0,0,0,0,0,0,0,0,0,0,0
20200316,706145,精華中信93購01,,,,,,0.00,0,0,0,0,0,0,0,0,0,0,0,0,0
20200316,706146,六角凱基93購01,,,,,,0.00,0,0,0,0,0,0,0,0,0,0,0,0,0
20200316,706147,金居凱基93購03,,,,,,0.00,0,0,0,0,0,0,0,0,0,0,0,0,0
20200316,706148,保瑞凱基93購01,,,,,,0.00,0,0,0,0,0,0,0,0,0,0,0,0,0
20200316,706149,群聯凱基93購06,,,,,,0.00,0,0,0,0,0,0,0,0,0,0,0,0,0
20200316,706150,聖暉凱基94購01,1.30,1.30,1.30,1.30,+0.29,28.71,13000,1,16900,0,0,0,0,0,0,13000,0,13000,13000
20200316,706151,環球晶凱基93購18,0.72,0.72,0.72,0.72,-0.20,-21.74,30000,1,21600,0,0,0,0,0,0,30000,0,30000,30000
20200316,706152,穩懋凱基93購20,,,,,,0.00,0,0,0,0,0,0,0,0,0,0,0,0,0
20200316,706153,良維永豐93購01,,,,,,0.00,0,0,0,0,0,0,0,0,0,0,0,0,0
20200316,706154,波若威永豐94購01,,,,,,0.00,0,0,0,0,0,0,0,0,0,0,0,0,0
20200316,706155,信昌電永豐93購03,,,,,,0.00,0,0,0,0,0,0,0,0,0,0,0,0,0
20200316,706156,僑威永豐93購02,,,,,,0.00,0,0,0,0,0,0,0,0,0,0,0,0,0
20200316,706157,穩懋永豐94購01,,,,,,0.00,0,0,0,0,0,0,0,0,0,0,0,0,0
20200316,706158,昂寶兆豐93購01,,,,,,0.00,0,0,0,0,0,0,0,0,0,0,0,0,0
20200316,706159,大江群益93購02,,,,,,0.00,0,0,0,0,0,0,0,0,0,0,0,0,0
20200316,706160,中美晶群益93購02,,,,,,0.00,0,0,0,0,0,0,0,0,0,0,0,0,0
20200316,706161,順達群益93購01,,,,,,0.00,0,0,0,0,0,0,0,0,0,0,0,0,0
20200316,706162,緯軟群益93購02,,,,,,0.00,0,0,0,0,0,0,0,0,0,0,0,0,0
20200316,706163,勝麗元大93購02,,,,,,0.00,0,0,0,0,0,0,0,0,0,0,0,0,0
20200316,706164,博智元大95購01,4.74,4.74,4.74,4.74,+0.76,19.1,1000,1,4740,0,0,0,0,0,0,1000,0,1000,1000
20200316,706165,順達元大93購01,,,,,,0.00,0,0,0,0,0,0,0,0,0,0,0,0,0
20200316,706166,神盾台新94購01,,,,,,0.00,0,0,0,0,0,0,0,0,0,0,0,0,0
20200316,706167,三貝德國票95購01,,,,,,0.00,0,0,0,0,0,0,0,0,0,0,0,0,0
20200316,706168,大田國票94購01,,,,,,0.00,0,0,0,0,0,0,0,0,0,0,0,0,0
20200316,706169,精華國票94購01,,,,,,0.00,0,0,0,0,0,0,0,0,0,0,0,0,0
20200316,706170,廣明國票94購01,,,,,,0.00,0,0,0,0,0,0,0,0,0,0,0,0,0
20200316,706171,鐿鈦國票95購01,,,,,,0.00,0,0,0,0,0,0,0,0,0,0,0,0,0
20200316,706172,金居國泰94購01,,,,,,0.00,0,0,0,0,0,0,0,0,0,0,0,0,0
20200316,706173,神盾國泰95購01,,,,,,0.00,0,0,0,0,0,0,0,0,0,0,0,0,0
20200316,706174,晶焱國泰94購01,,,,,,0.00,0,0,0,0,0,0,0,0,0,0,0,0,0
20200316,706175,譜瑞國泰95購01,1.57,1.63,1.57,1.63,+0.75,85.23,8000,2,12860,0,0,0,0,0,0,8000,3000,5000,5000
20200316,706176,勝麗康和93購01,,,,,,0.00,0,0,0,0,0,0,0,0,0,0,0,0,0
20200316,706177,M31群益93購03,,,,,,0.00,0,0,0,0,0,0,0,0,0,0,0,0,0
20200316,706178,建榮群益94購03,0.01,0.01,0.01,0.01,0.00,0.0,120000,2,1200,0,0,0,0,0,0,120000,0,120000,120000
20200316,706179,太醫中信93購01,,,,,,0.00,0,0,0,0,0,0,0,0,0,0,0,0,0
20200316,706180,宣德凱基93購01,0.23,0.23,0.12,0.12,-0.04,-25.0,60000,6,10600,0,0,0,0,0,0,10000,50000,-40000,-40000
20200316,706181,原相凱基93購05,1.44,1.54,1.25,1.25,-0.03,-2.34,30000,7,41430,0,0,0,0,0,0,10000,20000,-10000,-10000
20200316,706182,閎康凱基94購01,0.17,0.17,0.17,0.17,-0.09,-34.62,300000,3,51000,0,0,0,0,0,0,0,300000,-300000,-300000
20200316,706183,聚積凱基94購01,,,,,,0.00,0,0,0,0,0,0,0,0,0,0,0,0,0
20200316,706184,神盾統一94購01,,,,,,0.00,0,0,0,0,0,0,0,0,0,0,0,0,0
20200316,706185,優群統一93購01,,,,,,0.00,0,0,0,0,0,0,0,0,0,0,0,0,0
20200316,706186,中美晶元富94購02,1.11,1.24,1.11,1.24,-0.01,-0.8,115000,6,131780,0,0,0,0,0,0,115000,0,115000,115000
20200316,706187,中美晶元大93購09,1.14,1.30,1.14,1.30,+0.04,3.17,20000,2,24400,0,0,0,0,0,0,20000,0,20000,20000
20200316,706188,信驊元大93購02,,,,,,0.00,0,0,0,0,0,0,0,0,0,0,0,0,0
20200316,706189,穩懋元大93購16,,,,,,0.00,0,0,0,0,0,0,0,0,0,0,0,0,0
20200316,706190,大江國票94購01,,,,,,0.00,0,0,0,0,0,0,0,0,0,0,0,0,0
20200316,706191,台燿國票93購02,,,,,,0.00,0,0,0,0,0,0,0,0,0,0,0,0,0
20200316,706192,同致國票94購01,,,,,,0.00,0,0,0,0,0,0,0,0,0,0,0,0,0
20200316,706193,良維國票94購01,0.10,0.10,0.10,0.10,0.00,0.0,83000,1,8300,0,0,0,0,0,0,83000,0,83000,83000
20200316,706194,博智國票95購01,,,,,,0.00,0,0,0,0,0,0,0,0,0,0,0,0,0
20200316,706195,順達國票94購01,1.63,1.63,1.63,1.63,+0.10,6.54,30000,1,48900,0,0,0,0,0,0,30000,0,30000,30000
20200316,706196,新普國票93購01,,,,,,0.00,0,0,0,0,0,0,0,0,0,0,0,0,0
20200316,706197,聯亞國票94購01,0.05,0.05,0.05,0.05,+0.02,66.67,199000,1,9950,0,0,0,0,0,0,199000,0,199000,199000
20200316,706198,中美晶國泰94購01,1.11,1.16,1.11,1.16,0.00,0.0,150000,2,172500,0,0,0,0,0,0,150000,0,150000,150000
20200316,706199,昇達科國泰95購01,,,,,,0.00,0,0,0,0,0,0,0,0,0,0,0,0,0
20200316,706200,保瑞國泰95購02,0.14,0.14,0.14,0.14,-0.03,-17.65,1000,1,140,0,0,0,0,0,0,1000,0,1000,1000
20200316,706201,昂寶亞東93購02,,,,,,0.00,0,0,0,0,0,0,0,0,0,0,0,0,0
20200316,706202,宏觀永豐93購01,,,,,,0.00,0,0,0,0,0,0,0,0,0,0,0,0,0
20200316,706203,欣銓永豐93購01,,,,,,0.00,0,0,0,0,0,0,0,0,0,0,0,0,0
20200316,706204,緯軟永豐93購03,,,,,,0.00,0,0,0,0,0,0,0,0,0,0,0,0,0
20200316,706205,元太元大93購01,0.07,0.07,0.07,0.07,0.00,0.0,10000,1,700,0,0,0,0,0,0,10000,0,10000,10000
20200316,706206,佳邦元大93購01,,,,,,0.00,0,0,0,0,0,0,0,0,0,0,0,0,0
20200316,706207,直得元大94購01,0.29,0.29,0.29,0.29,-0.08,-21.62,10000,1,2900,0,0,0,0,0,0,0,10000,-10000,-10000
20200316,706208,宣德元大93購03,,,,,,0.00,0,0,0,0,0,0,0,0,0,0,0,0,0
20200316,706209,美琪瑪元大93購01,,,,,,0.00,0,0,0,0,0,0,0,0,0,0,0,0,0
20200316,706210,神盾元大94購05,,,,,,0.00,0,0,0,0,0,0,0,0,0,0,0,0,0
20200316,706211,精華元大93購02,,,,,,0.00,0,0,0,0,0,0,0,0,0,0,0,0,0
20200316,706212,廣明元大94購01,,,,,,0.00,0,0,0,0,0,0,0,0,0,0,0,0,0
20200316,706213,緯軟元大94購04,,,,,,0.00,0,0,0,0,0,0,0,0,0,0,0,0,0
20200316,706214,力旺統一93購01,,,,,,0.00,0,0,0,0,0,0,0,0,0,0,0,0,0
20200316,706215,神盾統一94購02,,,,,,0.00,0,0,0,0,0,0,0,0,0,0,0,0,0
20200316,706216,群聯統一93購02,,,,,,0.00,0,0,0,0,0,0,0,0,0,0,0,0,0
20200316,706217,中美晶凱基93購06,0.17,0.17,0.17,0.17,0.00,0.0,10000,1,1700,0,0,0,0,0,0,10000,0,10000,10000
20200316,706218,六角凱基93購02,,,,,,0.00,0,0,0,0,0,0,0,0,0,0,0,0,0
20200316,706219,美琪瑪凱基93購01,,,,,,0.00,0,0,0,0,0,0,0,0,0,0,0,0,0
20200316,706220,博智凱基93購03,4.43,4.96,4.34,4.96,+0.69,16.16,415000,42,1948060,0,0,0,0,0,0,21000,315000,-294000,-294000
20200316,706221,環球晶凱基93購19,0.17,0.17,0.17,0.17,-0.45,-72.58,30000,1,5100,0,0,0,0,0,0,30000,0,30000,30000
20200316,706222,穩懋凱基93購21,,,,,,0.00,0,0,0,0,0,0,0,0,0,0,0,0,0
20200316,706223,立端國票94購01,,,,,,0.00,0,0,0,0,0,0,0,0,0,0,0,0,0
20200316,706224,昂寶國票94購01,,,,,,0.00,0,0,0,0,0,0,0,0,0,0,0,0,0
20200316,706225,昇達科國票93購01,,,,,,0.00,0,0,0,0,0,0,0,0,0,0,0,0,0
20200316,706226,金可國票94購01,,,,,,0.00,0,0,0,0,0,0,0,0,0,0,0,0,0
20200316,706227,信昌電國票94購01,,,,,,0.00,0,0,0,0,0,0,0,0,0,0,0,0,0
20200316,706228,威剛國票94購01,1.38,1.38,1.38,1.38,+0.48,53.33,52000,1,71760,0,0,0,0,0,0,52000,0,52000,52000
20200316,706229,智擎國票94購01,,,,,,0.00,0,0,0,0,0,0,0,0,0,0,0,0,0
20200316,706230,穩懋國票93購06,0.01,0.01,0.01,0.01,0.00,0.0,200000,2,2000,0,0,0,0,0,0,200000,0,200000,200000
20200316,706231,台燿富邦93購01,,,,,,0.00,0,0,0,0,0,0,0,0,0,0,0,0,0
20200316,706232,大宇資第一93購01,0.01,0.01,0.01,0.01,0.00,0.0,108000,5,1080,0,0,0,0,0,0,108000,0,108000,108000
20200316,706233,合晶元富93購01,,,,,,0.00,0,0,0,0,0,0,0,0,0,0,0,0,0
20200316,706234,神盾元富94購01,,,,,,0.00,0,0,0,0,0,0,0,0,0,0,0,0,0
20200316,706235,環球晶元富94購02,1.18,1.18,0.63,0.63,-0.73,-53.68,153000,6,171230,0,0,0,0,0,0,153000,0,153000,153000
20200316,706236,M31永豐93購02,,,,,,0.00,0,0,0,0,0,0,0,0,0,0,0,0,0
20200316,706237,台燿永豐93購02,,,,,,0.00,0,0,0,0,0,0,0,0,0,0,0,0,0
20200316,706238,佳邦永豐93購02,,,,,,0.00,0,0,0,0,0,0,0,0,0,0,0,0,0
20200316,706239,旺矽永豐93購02,,,,,,0.00,0,0,0,0,0,0,0,0,0,0,0,0,0
20200316,706240,宣德永豐93購03,,,,,,0.00,0,0,0,0,0,0,0,0,0,0,0,0,0
20200316,706241,碩禾永豐94購01,,,,,,0.00,0,0,0,0,0,0,0,0,0,0,0,0,0
20200316,706242,宜鼎兆豐94購01,0.74,0.83,0.74,0.76,+0.29,61.7,55000,3,43150,0,0,0,0,0,0,20000,35000,-15000,-15000
20200316,706243,神盾兆豐94購01,,,,,,0.00,0,0,0,0,0,0,0,0,0,0,0,0,0
20200316,706244,網龍群益94購01,,,,,,0.00,0,0,0,0,0,0,0,0,0,0,0,0,0
20200316,706245,穩懋統一94購04,,,,,,0.00,0,0,0,0,0,0,0,0,0,0,0,0,0
20200316,706246,譜瑞統一94購01,,,,,,0.00,0,0,0,0,0,0,0,0,0,0,0,0,0
20200316,706247,由田凱基94購01,,,,,,0.00,0,0,0,0,0,0,0,0,0,0,0,0,0
20200316,706248,宜鼎凱基94購01,,,,,,0.00,0,0,0,0,0,0,0,0,0,0,0,0,0
20200316,706249,美琪瑪凱基94購01,,,,,,0.00,0,0,0,0,0,0,0,0,0,0,0,0,0
20200316,706250,廣明凱基94購05,,,,,,0.00,0,0,0,0,0,0,0,0,0,0,0,0,0
20200316,706251,環球晶凱基94購01,,,,,,0.00,0,0,0,0,0,0,0,0,0,0,0,0,0
20200316,706252,穩懋凱基94購03,,,,,,0.00,0,0,0,0,0,0,0,0,0,0,0,0,0
20200316,706253,鈺太凱基94購01,0.32,0.45,0.31,0.39,+0.07,21.88,111000,12,38790,0,0,0,0,0,0,0,111000,-111000,-111000
20200316,706254,宣德國票95購01,,,,,,0.00,0,0,0,0,0,0,0,0,0,0,0,0,0
20200316,706255,泰博國票95購01,0.32,0.51,0.32,0.50,+0.20,66.67,246000,10,101310,0,0,0,0,0,0,200000,46000,154000,154000
20200316,706256,神盾富邦96購01,,,,,,0.00,0,0,0,0,0,0,0,0,0,0,0,0,0
20200316,706257,新普富邦94購01,,,,,,0.00,0,0,0,0,0,0,0,0,0,0,0,0,0
20200316,706258,穩懋兆豐94購02,0.47,0.52,0.31,0.31,+0.09,40.91,50000,3,19200,0,0,0,0,0,0,40000,10000,30000,30000
20200316,706259,晟德兆豐95購01,0.04,0.04,0.04,0.04,-0.01,-20.0,50000,5,2000,0,0,0,0,0,0,0,50000,-50000,-50000
20200316,706260,大江群益94購02,,,,,,0.00,0,0,0,0,0,0,0,0,0,0,0,0,0
20200316,706261,神盾麥證94購01,,,,,,0.00,0,0,0,0,0,0,0,0,0,0,0,0,0
20200316,706262,美琪瑪麥證95購01,,,,,,0.00,0,0,0,0,0,0,0,0,0,0,0,0,0
20200316,706263,良維元富94購01,,,,,,0.00,0,0,0,0,0,0,0,0,0,0,0,0,0
20200316,706264,中美晶台新94購01,0.76,0.78,0.44,0.44,-0.38,-46.34,80000,8,59100,0,0,0,0,0,0,66000,14000,52000,52000
20200316,706265,合晶台新94購01,,,,,,0.00,0,0,0,0,0,0,0,0,0,0,0,0,0
20200316,706266,中美晶元大94購01,1.29,1.48,0.78,0.78,-0.62,-44.29,40000,4,45600,0,0,0,0,0,0,20000,20000,0,0
20200316,706267,合晶元大96購01,,,,,,0.00,0,0,0,0,0,0,0,0,0,0,0,0,0
20200316,706268,宏觀元大94購02,,,,,,0.00,0,0,0,0,0,0,0,0,0,0,0,0,0
20200316,706269,良維元大95購01,0.06,0.06,0.06,0.06,-0.01,-14.29,3000,1,180,0,0,0,0,0,0,3000,0,3000,3000
20200316,706270,宜鼎元大95購01,2.10,2.30,2.10,2.30,+0.21,10.05,15000,3,32020,0,0,0,0,0,0,5000,10000,-5000,-5000
20200316,706271,昇達科元大94購01,,,,,,0.00,0,0,0,0,0,0,0,0,0,0,0,0,0
20200316,706272,杰力元大95購01,,,,,,0.00,0,0,0,0,0,0,0,0,0,0,0,0,0
20200316,706273,勝麗元大94購01,0.15,0.15,0.15,0.15,+0.02,15.38,10000,1,1500,0,0,0,0,0,0,10000,0,10000,10000
20200316,706274,群聯元大95購01,,,,,,0.00,0,0,0,0,0,0,0,0,0,0,0,0,0
20200316,706275,聚積元大94購01,,,,,,0.00,0,0,0,0,0,0,0,0,0,0,0,0,0
20200316,706276,中美晶日盛94購01,,,,,,0.00,0,0,0,0,0,0,0,0,0,0,0,0,0
20200316,706277,三貝德永豐94購01,,,,,,0.00,0,0,0,0,0,0,0,0,0,0,0,0,0
20200316,706278,上詮永豐94購01,,,,,,0.00,0,0,0,0,0,0,0,0,0,0,0,0,0
20200316,706279,大宇資永豐94購01,,,,,,0.00,0,0,0,0,0,0,0,0,0,0,0,0,0
20200316,706280,信昌電永豐94購01,,,,,,0.00,0,0,0,0,0,0,0,0,0,0,0,0,0
20200316,706281,原相永豐94購02,,,,,,0.00,0,0,0,0,0,0,0,0,0,0,0,0,0
20200316,706282,勝麗永豐94購01,,,,,,0.00,0,0,0,0,0,0,0,0,0,0,0,0,0
20200316,706283,緯軟永豐94購01,,,,,,0.00,0,0,0,0,0,0,0,0,0,0,0,0,0
20200316,706284,鐿鈦永豐94購01,,,,,,0.00,0,0,0,0,0,0,0,0,0,0,0,0,0
20200316,706285,金可兆豐95購01,0.10,0.10,0.10,0.10,+0.03,42.86,35000,4,3500,0,0,0,0,0,0,10000,25000,-15000,-15000
20200316,706286,緯軟兆豐95購01,,,,,,0.00,0,0,0,0,0,0,0,0,0,0,0,0,0
20200316,706287,環球晶兆豐95購01,1.18,1.18,0.61,0.61,-0.44,-41.9,57000,7,56080,0,0,0,0,0,0,30000,27000,3000,3000
20200316,706288,譜瑞兆豐95購01,0.66,0.84,0.62,0.62,-0.06,-8.82,2346000,66,1716430,0,0,0,0,0,0,1478000,868000,610000,610000
20200316,706289,宜鼎群益94購01,0.60,0.60,0.60,0.60,+0.47,361.54,10000,1,6000,0,0,0,0,0,0,0,10000,-10000,-10000
20200316,706290,信昌電群益94購01,,,,,,0.00,0,0,0,0,0,0,0,0,0,0,0,0,0
20200316,706291,弘塑中信94購01,0.35,0.35,0.24,0.24,+0.07,41.18,35000,4,9500,0,0,0,0,0,0,10000,25000,-15000,-15000
20200316,706292,兆利中信94購01,0.07,0.07,0.07,0.07,+0.02,40.0,10000,1,700,0,0,0,0,0,0,10000,0,10000,10000
20200316,706293,杰力中信95購01,,,,,,0.00,0,0,0,0,0,0,0,0,0,0,0,0,0
20200316,706294,原相統一94購01,,,,,,0.00,0,0,0,0,0,0,0,0,0,0,0,0,0
20200316,706295,雙鴻統一94購01,,,,,,0.00,0,0,0,0,0,0,0,0,0,0,0,0,0
20200316,706296,穩懋統一96購01,,,,,,0.00,0,0,0,0,0,0,0,0,0,0,0,0,0
20200316,706297,大宇資凱基94購02,,,,,,0.00,0,0,0,0,0,0,0,0,0,0,0,0,0
20200316,706298,立端凱基94購01,,,,,,0.00,0,0,0,0,0,0,0,0,0,0,0,0,0
20200316,706299,宇峻凱基94購01,0.31,0.37,0.25,0.25,+0.06,31.58,76000,8,24520,0,0,0,0,0,0,10000,66000,-56000,-56000
20200316,706300,穩懋凱基94購04,,,,,,0.00,0,0,0,0,0,0,0,0,0,0,0,0,0
20200316,706301,譜瑞凱基94購02,0.21,0.27,0.21,0.25,+0.08,47.06,119000,16,28790,0,0,0,0,0,0,0,119000,-119000,-119000
20200316,706302,三貝德國票96購01,,,,,,0.00,0,0,0,0,0,0,0,0,0,0,0,0,0
20200316,706303,大學光國票94購01,1.60,1.60,1.60,1.60,-0.17,-9.6,10000,1,16000,0,0,0,0,0,0,10000,0,10000,10000
20200316,706304,迅得國票94購01,,,,,,0.00,0,0,0,0,0,0,0,0,0,0,0,0,0
20200316,706305,迅得國票94購02,,,,,,0.00,0,0,0,0,0,0,0,0,0,0,0,0,0
20200316,706306,昂寶國票95購01,,,,,,0.00,0,0,0,0,0,0,0,0,0,0,0,0,0
20200316,706307,勝麗國票95購01,,,,,,0.00,0,0,0,0,0,0,0,0,0,0,0,0,0
20200316,706308,新揚科國票94購01,,,,,,0.00,0,0,0,0,0,0,0,0,0,0,0,0,0
20200316,706309,新揚科國票95購01,,,,,,0.00,0,0,0,0,0,0,0,0,0,0,0,0,0
20200316,706310,聯亞國票95購01,0.21,0.21,0.21,0.21,0.00,0.0,20000,2,4200,0,0,0,0,0,0,0,20000,-20000,-20000
20200316,706311,大學光國泰94購01,,,,,,0.00,0,0,0,0,0,0,0,0,0,0,0,0,0
20200316,706312,大學光國泰95購01,1.47,1.47,0.90,0.97,-0.54,-35.76,112000,4,126430,0,0,0,0,0,0,40000,72000,-32000,-32000
20200316,706313,宇峻國泰95購01,1.16,1.16,1.12,1.12,+0.03,2.75,12000,2,13840,0,0,0,0,0,0,12000,0,12000,12000
20200316,706314,安勤國泰95購01,0.10,0.10,0.10,0.10,+0.04,66.67,34000,1,3400,0,0,0,0,0,0,0,34000,-34000,-34000
20200316,706315,晟德富邦94購01,,,,,,0.00,0,0,0,0,0,0,0,0,0,0,0,0,0
20200316,706316,大學光元大94購01,,,,,,0.00,0,0,0,0,0,0,0,0,0,0,0,0,0
20200316,706317,大學光元大94購02,,,,,,0.00,0,0,0,0,0,0,0,0,0,0,0,0,0
20200316,706318,大學光元大94購03,,,,,,0.00,0,0,0,0,0,0,0,0,0,0,0,0,0
20200316,706319,六角元大94購01,0.07,0.07,0.07,0.07,-0.01,-12.5,10000,1,700,0,0,0,0,0,0,10000,0,10000,10000
20200316,706320,光頡元大94購01,,,,,,0.00,0,0,0,0,0,0,0,0,0,0,0,0,0
20200316,706321,宇峻元大94購01,0.51,0.60,0.51,0.60,+0.14,30.43,90000,9,48200,0,0,0,0,0,0,0,90000,-90000,-90000
20200316,706322,良維元大94購01,,,,,,0.00,0,0,0,0,0,0,0,0,0,0,0,0,0
20200316,706323,迅得元大94購01,,,,,,0.00,0,0,0,0,0,0,0,0,0,0,0,0,0
20200316,706324,新揚科元大94購01,,,,,,0.00,0,0,0,0,0,0,0,0,0,0,0,0,0
20200316,706325,群聯元大95購02,0.04,0.04,0.04,0.04,-0.06,-60.0,50000,1,2000,0,0,0,0,0,0,50000,0,50000,50000
20200316,706326,網家元大94購01,,,,,,0.00,0,0,0,0,0,0,0,0,0,0,0,0,0
20200316,706327,網龍元大94購01,,,,,,0.00,0,0,0,0,0,0,0,0,0,0,0,0,0
20200316,706328,環球晶元大94購02,2.75,2.75,2.75,2.75,+0.67,32.21,10000,1,27500,0,0,0,0,0,0,10000,0,10000,10000
20200316,706329,雙美元大94購02,,,,,,0.00,0,0,0,0,0,0,0,0,0,0,0,0,0
20200316,706330,穩懋元大94購01,,,,,,0.00,0,0,0,0,0,0,0,0,0,0,0,0,0
20200316,706331,大學光永豐94購01,,,,,,0.00,0,0,0,0,0,0,0,0,0,0,0,0,0
20200316,706332,中美晶永豐94購01,,,,,,0.00,0,0,0,0,0,0,0,0,0,0,0,0,0
20200316,706333,光頡永豐94購01,,,,,,0.00,0,0,0,0,0,0,0,0,0,0,0,0,0
20200316,706334,宇峻永豐94購01,,,,,,0.00,0,0,0,0,0,0,0,0,0,0,0,0,0
20200316,706335,安勤永豐94購01,,,,,,0.00,0,0,0,0,0,0,0,0,0,0,0,0,0
20200316,706336,迅得永豐94購01,,,,,,0.00,0,0,0,0,0,0,0,0,0,0,0,0,0
20200316,706337,協益永豐94購01,,,,,,0.00,0,0,0,0,0,0,0,0,0,0,0,0,0
20200316,706338,東洋永豐94購01,,,,,,0.00,0,0,0,0,0,0,0,0,0,0,0,0,0
20200316,706339,長科*永豐94購01,,,,,,0.00,0,0,0,0,0,0,0,0,0,0,0,0,0
20200316,706340,保瑞永豐94購01,,,,,,0.00,0,0,0,0,0,0,0,0,0,0,0,0,0
20200316,706341,博智永豐94購01,3.95,4.99,3.95,4.99,+0.84,20.24,316000,37,1457500,0,0,0,0,0,0,68000,212000,-144000,-144000
20200316,706342,新揚科永豐94購01,,,,,,0.00,0,0,0,0,0,0,0,0,0,0,0,0,0
20200316,706343,碩禾永豐94購02,0.10,0.10,0.10,0.10,-0.01,-9.09,10000,1,1000,0,0,0,0,0,0,10000,0,10000,10000
20200316,706344,網家永豐94購01,,,,,,0.00,0,0,0,0,0,0,0,0,0,0,0,0,0
20200316,706345,雙鴻永豐95購01,,,,,,0.00,0,0,0,0,0,0,0,0,0,0,0,0,0
20200316,706346,弘塑康和94購01,2.06,2.06,1.29,1.29,-0.63,-32.81,44000,5,85060,0,0,0,0,0,0,20000,24000,-4000,-4000
20200316,706347,安勤康和94購01,,,,,,0.00,0,0,0,0,0,0,0,0,0,0,0,0,0
20200316,706348,江興鍛康和94購01,,,,,,0.00,0,0,0,0,0,0,0,0,0,0,0,0,0
20200316,706349,長科*康和94購01,,,,,,0.00,0,0,0,0,0,0,0,0,0,0,0,0,0
20200316,706350,威剛康和94購01,1.73,1.84,1.73,1.84,+0.26,16.46,185000,5,329900,0,0,0,0,0,0,0,185000,-185000,-185000
20200316,706351,網家康和94購01,,,,,,0.00,0,0,0,0,0,0,0,0,0,0,0,0,0
20200316,706352,穩懋日盛94購01,,,,,,0.00,0,0,0,0,0,0,0,0,0,0,0,0,0
20200316,706353,雙鴻第一94購01,,,,,,0.00,0,0,0,0,0,0,0,0,0,0,0,0,0
20200316,706354,同致元富94購01,,,,,,0.00,0,0,0,0,0,0,0,0,0,0,0,0,0
20200316,706355,新漢元富94購01,,,,,,0.00,0,0,0,0,0,0,0,0,0,0,0,0,0
20200316,706356,業強元富94購01,,,,,,0.00,0,0,0,0,0,0,0,0,0,0,0,0,0
20200316,706357,網家元富96購01,0.02,0.03,0.02,0.03,-0.03,-50.0,39000,2,970,0,0,0,0,0,0,0,0,0,0
20200316,706358,網家中信94購01,,,,,,0.00,0,0,0,0,0,0,0,0,0,0,0,0,0
20200316,706359,中美晶統一94購01,,,,,,0.00,0,0,0,0,0,0,0,0,0,0,0,0,0
20200316,706360,東洋統一95購01,,,,,,0.00,0,0,0,0,0,0,0,0,0,0,0,0,0
20200316,706361,環球晶統一94購01,,,,,,0.00,0,0,0,0,0,0,0,0,0,0,0,0,0
20200316,706362,台燿凱基94購01,,,,,,0.00,0,0,0,0,0,0,0,0,0,0,0,0,0
20200316,706363,新普凱基94購01,,,,,,0.00,0,0,0,0,0,0,0,0,0,0,0,0,0
20200316,706364,榮剛凱基94購01,,,,,,0.00,0,0,0,0,0,0,0,0,0,0,0,0,0
20200316,706365,精華凱基94購01,,,,,,0.00,0,0,0,0,0,0,0,0,0,0,0,0,0
20200316,706366,環球晶凱基94購03,,,,,,0.00,0,0,0,0,0,0,0,0,0,0,0,0,0
20200316,706367,宇峻國票94購01,,,,,,0.00,0,0,0,0,0,0,0,0,0,0,0,0,0
20200316,706368,廣明國票94購02,,,,,,0.00,0,0,0,0,0,0,0,0,0,0,0,0,0
20200316,706369,優群國票95購01,,,,,,0.00,0,0,0,0,0,0,0,0,0,0,0,0,0
20200316,706370,穩懋國票95購01,0.01,0.01,0.01,0.01,-0.02,-66.67,55000,1,550,0,0,0,0,0,0,0,0,0,0
20200316,706371,迅得國泰95購01,,,,,,0.00,0,0,0,0,0,0,0,0,0,0,0,0,0
20200316,706372,新揚科國泰95購01,,,,,,0.00,0,0,0,0,0,0,0,0,0,0,0,0,0
20200316,706373,雙鴻國泰96購01,,,,,,0.00,0,0,0,0,0,0,0,0,0,0,0,0,0
20200316,706374,中美晶富邦95購01,,,,,,0.00,0,0,0,0,0,0,0,0,0,0,0,0,0
20200316,706375,晶焱兆豐95購01,0.16,0.17,0.16,0.17,+0.04,30.77,33000,2,5310,0,0,0,0,0,0,33000,0,33000,33000
20200316,706376,合晶群益94購01,,,,,,0.00,0,0,0,0,0,0,0,0,0,0,0,0,0
20200316,706377,宇峻群益94購01,,,,,,0.00,0,0,0,0,0,0,0,0,0,0,0,0,0
20200316,706378,安勤群益94購01,,,,,,0.00,0,0,0,0,0,0,0,0,0,0,0,0,0
20200316,706379,宏觀群益95購01,,,,,,0.00,0,0,0,0,0,0,0,0,0,0,0,0,0
20200316,706380,佳邦群益94購01,,,,,,0.00,0,0,0,0,0,0,0,0,0,0,0,0,0
20200316,706381,協益群益94購01,,,,,,0.00,0,0,0,0,0,0,0,0,0,0,0,0,0
20200316,706382,皇田群益94購01,,,,,,0.00,0,0,0,0,0,0,0,0,0,0,0,0,0
20200316,706383,群聯群益96購01,0.38,0.38,0.29,0.29,-0.17,-36.96,15000,2,5250,0,0,0,0,0,0,0,15000,-15000,-15000
20200316,706384,網家群益94購01,,,,,,0.00,0,0,0,0,0,0,0,0,0,0,0,0,0
20200316,706385,大學光永豐95購01,,,,,,0.00,0,0,0,0,0,0,0,0,0,0,0,0,0
20200316,706386,迅得永豐95購01,,,,,,0.00,0,0,0,0,0,0,0,0,0,0,0,0,0
20200316,706387,新揚科永豐95購01,,,,,,0.00,0,0,0,0,0,0,0,0,0,0,0,0,0
20200316,706388,雙美永豐94購01,,,,,,0.00,0,0,0,0,0,0,0,0,0,0,0,0,0
20200316,706389,金居元富95購01,,,,,,0.00,0,0,0,0,0,0,0,0,0,0,0,0,0
20200316,706390,大江元大95購01,,,,,,0.00,0,0,0,0,0,0,0,0,0,0,0,0,0
20200316,706391,中美晶元大94購02,0.77,0.77,0.64,0.64,-0.02,-3.03,20000,2,14100,0,0,0,0,0,0,0,20000,-20000,-20000
20200316,706392,元太元大94購01,,,,,,0.00,0,0,0,0,0,0,0,0,0,0,0,0,0
20200316,706393,昇達科元大96購01,,,,,,0.00,0,0,0,0,0,0,0,0,0,0,0,0,0
20200316,706394,直得元大94購02,,,,,,0.00,0,0,0,0,0,0,0,0,0,0,0,0,0
20200316,706395,威剛元大95購01,0.72,0.82,0.41,0.41,-0.35,-46.05,185000,18,122600,0,0,0,0,0,0,60000,135000,-75000,-75000
20200316,706396,神盾元大95購02,,,,,,0.00,0,0,0,0,0,0,0,0,0,0,0,0,0
20200316,706397,順達元大94購01,1.58,1.58,1.58,1.58,+0.48,43.64,10000,1,15800,0,0,0,0,0,0,10000,0,10000,10000
20200316,706398,優群元大95購01,2.05,2.05,2.05,2.05,+0.42,25.77,10000,1,20500,0,0,0,0,0,0,10000,0,10000,10000
20200316,706399,環球晶元大94購04,1.92,2.18,1.19,1.19,-0.68,-36.36,64000,8,124100,0,0,0,0,0,0,50000,14000,36000,36000
20200316,706400,環球晶中信94購01,0.19,0.19,0.19,0.19,-0.01,-5.0,50000,1,9500,0,0,0,0,0,0,50000,0,50000,50000
20200316,706401,大學光凱基94購01,0.41,0.41,0.41,0.41,+0.06,17.14,10000,1,4100,0,0,0,0,0,0,0,10000,-10000,-10000
20200316,706402,立端凱基94購02,,,,,,0.00,0,0,0,0,0,0,0,0,0,0,0,0,0
20200316,706403,穩懋凱基94購05,,,,,,0.00,0,0,0,0,0,0,0,0,0,0,0,0,0
20200316,706404,宏捷科元富94購01,0.08,0.09,0.08,0.09,-0.06,-40.0,440000,5,37200,0,0,0,0,0,0,440000,0,440000,440000
20200316,706405,原相元富95購01,3.56,3.65,3.26,3.48,+0.26,8.07,201000,24,686380,0,0,0,0,0,0,201000,0,201000,201000
20200316,706406,大中元大94購01,,,,,,0.00,0,0,0,0,0,0,0,0,0,0,0,0,0
20200316,706407,中美晶元大94購03,0.55,0.55,0.40,0.40,0.00,0.0,30000,3,13600,0,0,0,0,0,0,10000,20000,-10000,-10000
20200316,706408,昂寶元大96購01,,,,,,0.00,0,0,0,0,0,0,0,0,0,0,0,0,0
20200316,706409,金居元大95購01,0.13,0.13,0.13,0.13,+0.01,8.33,50000,5,6500,0,0,0,0,0,0,0,50000,-50000,-50000
20200316,706410,信昌電元大96購01,0.22,0.23,0.14,0.15,-0.05,-25.0,195000,18,35550,0,0,0,0,0,0,60000,135000,-75000,-75000
20200316,706411,保瑞元大95購01,,,,,,0.00,0,0,0,0,0,0,0,0,0,0,0,0,0
20200316,706412,宣德元大95購02,0.39,0.39,0.36,0.36,-0.04,-10.0,390000,39,144700,0,0,0,0,0,0,0,390000,-390000,-390000
20200316,706413,建榮元大94購02,,,,,,0.00,0,0,0,0,0,0,0,0,0,0,0,0,0
20200316,706414,晶焱元大95購01,,,,,,0.00,0,0,0,0,0,0,0,0,0,0,0,0,0
20200316,706415,緯軟元大96購02,,,,,,0.00,0,0,0,0,0,0,0,0,0,0,0,0,0
20200316,706416,優群元大94購01,,,,,,0.00,0,0,0,0,0,0,0,0,0,0,0,0,0
20200316,706417,雙鴻元大97購01,0.10,0.10,0.10,0.10,+0.02,25.0,8000,2,800,0,0,0,0,0,0,5000,3000,2000,2000
20200316,706418,穩懋元大94購04,0.21,0.21,0.15,0.15,-0.09,-37.5,560000,56,108600,0,0,0,0,0,0,0,560000,-560000,-560000
20200316,706419,鈺太元大96購01,0.76,0.93,0.76,0.88,+0.04,4.76,230000,23,187000,0,0,0,0,0,0,10000,230000,-220000,-220000
20200316,706420,宏捷科台新94購01,,,,,,0.00,0,0,0,0,0,0,0,0,0,0,0,0,0
20200316,706421,大江兆豐94購01,,,,,,0.00,0,0,0,0,0,0,0,0,0,0,0,0,0
20200316,706422,大江群益94購04,,,,,,0.00,0,0,0,0,0,0,0,0,0,0,0,0,0
20200316,706423,宏觀群益96購01,,,,,,0.00,0,0,0,0,0,0,0,0,0,0,0,0,0
20200316,706424,泰博群益94購01,,,,,,0.00,0,0,0,0,0,0,0,0,0,0,0,0,0
20200316,706425,新揚科群益94購01,,,,,,0.00,0,0,0,0,0,0,0,0,0,0,0,0,0
20200316,706426,群聯群益94購01,,,,,,0.00,0,0,0,0,0,0,0,0,0,0,0,0,0
20200316,706427,雙鴻群益96購01,0.08,0.08,0.03,0.03,-0.04,-57.14,595000,12,36860,0,0,0,0,0,0,185000,410000,-225000,-225000
20200316,706428,鐿鈦群益95購01,,,,,,0.00,0,0,0,0,0,0,0,0,0,0,0,0,0
20200316,706429,宇峻國票95購01,0.45,0.45,0.30,0.30,-0.10,-25.0,60000,2,25500,0,0,0,0,0,0,50000,0,50000,50000
20200316,706430,建榮國票96購01,,,,,,0.00,0,0,0,0,0,0,0,0,0,0,0,0,0
20200316,706431,神盾國票94購03,,,,,,0.00,0,0,0,0,0,0,0,0,0,0,0,0,0
20200316,706432,環球晶國票95購01,2.77,2.80,1.83,1.83,-1.11,-37.76,147000,9,380070,0,0,0,0,0,0,127000,20000,107000,107000
20200316,706433,譜瑞國票94購01,,,,,,0.00,0,0,0,0,0,0,0,0,0,0,0,0,0
20200316,706434,宏捷科國泰95購01,0.47,0.56,0.25,0.26,-0.22,-45.83,729000,22,351530,0,0,0,0,0,0,380000,339000,41000,41000
20200316,706435,保瑞國泰95購03,,,,,,0.00,0,0,0,0,0,0,0,0,0,0,0,0,0
20200316,706436,穩懋富邦96購01,0.68,0.72,0.53,0.53,-0.12,-18.46,353000,17,233400,0,0,0,0,0,0,275000,78000,197000,197000
20200316,706437,新普第一94購01,,,,,,0.00,0,0,0,0,0,0,0,0,0,0,0,0,0
20200316,706438,櫃200第一94購01,,,,,,0.00,0,0,0,0,0,0,0,0,0,0,0,0,0
20200316,706439,上詮永豐94購02,,,,,,0.00,0,0,0,0,0,0,0,0,0,0,0,0,0
20200316,706440,宏捷科永豐95購01,0.15,0.16,0.08,0.08,-0.09,-52.94,309000,21,36320,0,0,0,0,0,0,112000,197000,-85000,-85000
20200316,706441,神盾永豐94購01,,,,,,0.00,0,0,0,0,0,0,0,0,0,0,0,0,0
20200316,706442,安勤中信94購01,,,,,,0.00,0,0,0,0,0,0,0,0,0,0,0,0,0
20200316,706443,璟德統一94購01,,,,,,0.00,0,0,0,0,0,0,0,0,0,0,0,0,0
20200316,706444,雙鴻統一94購02,,,,,,0.00,0,0,0,0,0,0,0,0,0,0,0,0,0
20200316,706445,緯軟麥證95購01,,,,,,0.00,0,0,0,0,0,0,0,0,0,0,0,0,0
20200316,706446,雙鴻麥證96購01,,,,,,0.00,0,0,0,0,0,0,0,0,0,0,0,0,0
20200316,706447,中美晶元富95購02,1.34,1.46,1.34,1.46,+0.09,6.57,70000,4,98600,0,0,0,0,0,0,70000,0,70000,70000
20200316,706448,威剛元富97購01,2.00,2.08,1.71,1.71,-0.11,-6.04,55000,6,108150,0,0,0,0,0,0,0,55000,-55000,-55000
20200316,706449,大江元大94購02,,,,,,0.00,0,0,0,0,0,0,0,0,0,0,0,0,0
20200316,706450,中美晶元大94購04,1.71,1.95,1.66,1.66,-0.29,-14.87,150000,10,264900,0,0,0,0,0,0,140000,10000,130000,130000
20200316,706451,中美晶元大94購05,,,,,,0.00,0,0,0,0,0,0,0,0,0,0,0,0,0
20200316,706452,保瑞元大94購01,,,,,,0.00,0,0,0,0,0,0,0,0,0,0,0,0,0
20200316,706453,美琪瑪元大95購01,,,,,,0.00,0,0,0,0,0,0,0,0,0,0,0,0,0
20200316,706454,茂達元大94購01,0.32,0.32,0.25,0.25,-0.05,-16.67,6000,2,1710,0,0,0,0,0,0,3000,3000,0,0
20200316,706455,原相元大94購03,,,,,,0.00,0,0,0,0,0,0,0,0,0,0,0,0,0
20200316,706456,神盾元大95購03,,,,,,0.00,0,0,0,0,0,0,0,0,0,0,0,0,0
20200316,706457,晶焱元大94購02,,,,,,0.00,0,0,0,0,0,0,0,0,0,0,0,0,0
20200316,706458,群聯元大95購03,0.12,0.15,0.07,0.07,-0.10,-58.82,203000,20,20990,0,0,0,0,0,0,23000,160000,-137000,-137000
20200316,706459,環球晶元大94購05,2.08,2.08,1.49,1.49,-1.92,-56.3,6000,3,10120,0,0,0,0,0,0,0,6000,-6000,-6000
20200316,706460,穩懋元大94購05,,,,,,0.00,0,0,0,0,0,0,0,0,0,0,0,0,0
20200316,706461,元太富邦96購01,0.19,0.19,0.16,0.16,-0.07,-30.43,135000,3,23350,0,0,0,0,0,0,5000,130000,-125000,-125000
20200316,706462,鐿鈦國票95購02,,,,,,0.00,0,0,0,0,0,0,0,0,0,0,0,0,0
20200316,706463,中美晶凱基94購01,0.43,0.43,0.43,0.43,+0.11,34.38,30000,1,12900,0,0,0,0,0,0,30000,0,30000,30000
20200316,706464,由田凱基94購02,,,,,,0.00,0,0,0,0,0,0,0,0,0,0,0,0,0
20200316,706465,立端凱基94購03,,,,,,0.00,0,0,0,0,0,0,0,0,0,0,0,0,0
20200316,706466,良維凱基94購01,,,,,,0.00,0,0,0,0,0,0,0,0,0,0,0,0,0
20200316,706467,迅得凱基94購01,,,,,,0.00,0,0,0,0,0,0,0,0,0,0,0,0,0
20200316,706468,波若威凱基94購01,,,,,,0.00,0,0,0,0,0,0,0,0,0,0,0,0,0
20200316,706469,宣德凱基94購01,,,,,,0.00,0,0,0,0,0,0,0,0,0,0,0,0,0
20200316,706470,博智凱基94購01,6.45,7.30,6.45,7.30,+2.57,54.33,112000,15,779300,0,0,0,0,0,0,26000,84000,-58000,-58000
20200316,706471,群聯凱基94購01,0.17,0.17,0.15,0.15,-0.17,-53.12,30000,2,4700,0,0,0,0,0,0,20000,10000,10000,10000
20200316,706472,精華凱基94購02,,,,,,0.00,0,0,0,0,0,0,0,0,0,0,0,0,0
20200316,706473,優群凱基94購01,0.79,0.94,0.79,0.89,+0.20,28.99,160000,21,140220,0,0,0,0,0,0,7000,150000,-143000,-143000
20200316,706474,聯亞凱基94購02,0.12,0.12,0.12,0.12,+0.02,20.0,1000,1,120,0,0,0,0,0,0,1000,0,1000,1000
20200316,706475,元太兆豐95購01,,,,,,0.00,0,0,0,0,0,0,0,0,0,0,0,0,0
20200316,706476,雙美兆豐94購01,,,,,,0.00,0,0,0,0,0,0,0,0,0,0,0,0,0
20200316,706477,雙鴻兆豐95購01,,,,,,0.00,0,0,0,0,0,0,0,0,0,0,0,0,0
20200316,706478,大田群益94購01,,,,,,0.00,0,0,0,0,0,0,0,0,0,0,0,0,0
20200316,706479,中美晶群益94購01,,,,,,0.00,0,0,0,0,0,0,0,0,0,0,0,0,0
20200316,706480,宏捷科群益94購01,0.03,0.03,0.03,0.03,0.00,0.0,115000,13,3450,0,0,0,0,0,0,0,115000,-115000,-115000
20200316,706481,雙鴻群益96購02,,,,,,0.00,0,0,0,0,0,0,0,0,0,0,0,0,0
20200316,706482,中美晶亞東94購01,,,,,,0.00,0,0,0,0,0,0,0,0,0,0,0,0,0
20200316,706483,元太亞東94購01,,,,,,0.00,0,0,0,0,0,0,0,0,0,0,0,0,0
20200316,706484,大江永豐94購02,,,,,,0.00,0,0,0,0,0,0,0,0,0,0,0,0,0
20200316,706485,宏觀永豐94購01,,,,,,0.00,0,0,0,0,0,0,0,0,0,0,0,0,0
20200316,706486,威剛永豐94購01,0.37,0.37,0.12,0.12,-0.06,-33.33,80000,8,18100,0,0,0,0,0,0,10000,70000,-60000,-60000
20200316,706487,雙美永豐94購02,,,,,,0.00,0,0,0,0,0,0,0,0,0,0,0,0,0
20200316,706488,雙鴻永豐95購02,,,,,,0.00,0,0,0,0,0,0,0,0,0,0,0,0,0
20200316,706489,譜瑞永豐94購01,,,,,,0.00,0,0,0,0,0,0,0,0,0,0,0,0,0
20200316,706490,鈺太中信94購01,0.18,0.32,0.18,0.25,+0.09,56.25,148000,16,36770,0,0,0,0,0,0,0,148000,-148000,-148000
20200316,706491,六角凱基94購01,,,,,,0.00,0,0,0,0,0,0,0,0,0,0,0,0,0
20200316,706492,立端凱基94購04,,,,,,0.00,0,0,0,0,0,0,0,0,0,0,0,0,0
20200316,706493,合晶凱基94購01,,,,,,0.00,0,0,0,0,0,0,0,0,0,0,0,0,0
20200316,706494,昇達科凱基94購01,,,,,,0.00,0,0,0,0,0,0,0,0,0,0,0,0,0
20200316,706495,新普凱基94購02,,,,,,0.00,0,0,0,0,0,0,0,0,0,0,0,0,0
20200316,706496,穩懋凱基94購06,0.23,0.23,0.23,0.23,+0.09,64.29,20000,2,4600,0,0,0,0,0,0,0,20000,-20000,-20000
20200316,706497,譜瑞凱基94購03,0.19,0.24,0.18,0.21,+0.11,110.0,185000,17,39780,0,0,0,0,0,0,56000,129000,-73000,-73000
20200316,706498,晟德凱基94購01,,,,,,0.00,0,0,0,0,0,0,0,0,0,0,0,0,0
20200316,706499,大中永豐94購01,,,,,,0.00,0,0,0,0,0,0,0,0,0,0,0,0,0
20200316,706500,信驊永豐94購01,0.76,0.77,0.59,0.61,+0.20,48.78,34000,7,22520,0,0,0,0,0,0,3000,31000,-28000,-28000
20200316,706501,網龍永豐95購01,,,,,,0.00,0,0,0,0,0,0,0,0,0,0,0,0,0
20200316,706502,雙鴻永豐95購03,,,,,,0.00,0,0,0,0,0,0,0,0,0,0,0,0,0
20200316,706503,鈺太永豐94購02,0.14,0.14,0.14,0.14,+0.03,27.27,18000,1,2520,0,0,0,0,0,0,0,18000,-18000,-18000
20200316,706504,精華日盛94購01,,,,,,0.00,0,0,0,0,0,0,0,0,0,0,0,0,0
20200316,706505,雙美日盛94購01,,,,,,0.00,0,0,0,0,0,0,0,0,0,0,0,0,0
20200316,706506,元太統一94購01,,,,,,0.00,0,0,0,0,0,0,0,0,0,0,0,0,0
20200316,706507,譜瑞統一94購02,0.39,0.43,0.39,0.43,+0.21,95.45,73000,2,31270,0,0,0,0,0,0,73000,0,73000,73000
20200316,706508,大江兆豐95購01,,,,,,0.00,0,0,0,0,0,0,0,0,0,0,0,0,0
20200316,706509,台燿兆豐94購02,0.03,0.03,0.02,0.02,-0.01,-33.33,149000,11,3470,0,0,0,0,0,0,0,149000,-149000,-149000
20200316,706510,新普兆豐94購01,,,,,,0.00,0,0,0,0,0,0,0,0,0,0,0,0,0
20200316,706511,精華兆豐95購01,,,,,,0.00,0,0,0,0,0,0,0,0,0,0,0,0,0
20200316,706512,直得群益94購01,,,,,,0.00,0,0,0,0,0,0,0,0,0,0,0,0,0
20200316,706513,金居群益96購01,,,,,,0.00,0,0,0,0,0,0,0,0,0,0,0,0,0
20200316,706514,鈺太元富94購01,,,,,,0.00,0,0,0,0,0,0,0,0,0,0,0,0,0
20200316,706515,保瑞台新94購01,,,,,,0.00,0,0,0,0,0,0,0,0,0,0,0,0,0
20200316,706516,大田元大96購01,,,,,,0.00,0,0,0,0,0,0,0,0,0,0,0,0,0
20200316,706517,大江元大95購02,,,,,,0.00,0,0,0,0,0,0,0,0,0,0,0,0,0
20200316,706518,杰力元大96購01,,,,,,0.00,0,0,0,0,0,0,0,0,0,0,0,0,0
20200316,706519,雙美元大94購03,,,,,,0.00,0,0,0,0,0,0,0,0,0,0,0,0,0
20200316,706520,穩懋元大94購06,0.12,0.13,0.06,0.06,+0.02,50.0,100000,10,9600,0,0,0,0,0,0,0,100000,-100000,-100000
20200316,706521,譜瑞元大94購01,0.75,1.03,0.75,0.96,+0.07,7.87,129000,14,126510,0,0,0,0,0,0,119000,124000,-5000,-5000
20200316,706522,鈺太元大94購01,0.66,0.98,0.66,0.98,+0.36,58.06,21000,3,15980,0,0,0,0,0,0,5000,16000,-11000,-11000
20200316,706523,M31國票95購01,,,,,,0.00,0,0,0,0,0,0,0,0,0,0,0,0,0
20200316,706524,中美晶國票94購02,,,,,,0.00,0,0,0,0,0,0,0,0,0,0,0,0,0
20200316,706525,信昌電國票94購02,,,,,,0.00,0,0,0,0,0,0,0,0,0,0,0,0,0
20200316,706526,是方國票94購01,0.75,1.09,0.64,0.85,+0.29,51.79,544000,43,462880,0,0,0,0,0,0,293000,168000,125000,125000
20200316,706527,晶焱國票95購01,,,,,,0.00,0,0,0,0,0,0,0,0,0,0,0,0,0
20200316,706528,廣明國票95購01,,,,,,0.00,0,0,0,0,0,0,0,0,0,0,0,0,0
20200316,706529,M31國泰96購01,,,,,,0.00,0,0,0,0,0,0,0,0,0,0,0,0,0
20200316,706530,群聯國泰96購01,,,,,,0.00,0,0,0,0,0,0,0,0,0,0,0,0,0
20200316,706531,雙鴻國泰96購02,,,,,,0.00,0,0,0,0,0,0,0,0,0,0,0,0,0
20200316,706532,勝麗凱基94購01,,,,,,0.00,0,0,0,0,0,0,0,0,0,0,0,0,0
20200316,706533,凡甲統一94購01,0.46,0.46,0.44,0.44,+0.22,100.0,500000,5,226000,0,0,0,0,0,0,500000,0,500000,500000
20200316,706534,元太統一94購02,,,,,,0.00,0,0,0,0,0,0,0,0,0,0,0,0,0
20200316,706535,東洋統一94購01,,,,,,0.00,0,0,0,0,0,0,0,0,0,0,0,0,0
20200316,706536,大中元大95購01,,,,,,0.00,0,0,0,0,0,0,0,0,0,0,0,0,0
20200316,706537,元太元大95購01,,,,,,0.00,0,0,0,0,0,0,0,0,0,0,0,0,0
20200316,706538,宏觀元大95購01,,,,,,0.00,0,0,0,0,0,0,0,0,0,0,0,0,0
20200316,706539,信昌電元大95購01,,,,,,0.00,0,0,0,0,0,0,0,0,0,0,0,0,0
20200316,706540,保瑞元大95購02,0.07,0.07,0.07,0.07,-0.03,-30.0,10000,1,700,0,0,0,0,0,0,0,10000,-10000,-10000
20200316,706541,神盾元大95購05,,,,,,0.00,0,0,0,0,0,0,0,0,0,0,0,0,0
20200316,706542,精華元大95購01,0.10,0.10,0.10,0.10,+0.02,25.0,5000,1,500,0,0,0,0,0,0,5000,0,5000,5000
20200316,706543,聯亞元大95購01,0.53,0.53,0.53,0.53,+0.20,60.61,20000,1,10600,0,0,0,0,0,0,20000,0,20000,20000
20200316,706544,譜瑞元大95購01,1.82,2.36,1.71,1.71,-0.35,-16.99,172000,14,353740,0,0,0,0,0,0,139000,57000,82000,82000
20200316,706545,元太元富94購01,,,,,,0.00,0,0,0,0,0,0,0,0,0,0,0,0,0
20200316,706546,建榮元富95購01,,,,,,0.00,0,0,0,0,0,0,0,0,0,0,0,0,0
20200316,706547,昇達科兆豐95購01,,,,,,0.00,0,0,0,0,0,0,0,0,0,0,0,0,0
20200316,706548,M31國票95購02,,,,,,0.00,0,0,0,0,0,0,0,0,0,0,0,0,0
20200316,706549,大江國票95購01,0.01,0.01,0.01,0.01,-0.01,-50.0,150000,1,1500,0,0,0,0,0,0,0,0,0,0
20200316,706550,宏捷科國票95購02,0.13,0.21,0.05,0.05,-0.12,-70.59,1156000,35,176640,0,0,0,0,0,0,792000,116000,676000,676000
20200316,706551,雙鴻國票95購01,,,,,,0.00,0,0,0,0,0,0,0,0,0,0,0,0,0
20200316,706552,同致群益94購01,,,,,,0.00,0,0,0,0,0,0,0,0,0,0,0,0,0
20200316,706553,信驊群益94購01,3.14,3.50,3.14,3.17,+0.56,21.46,14000,3,44740,0,0,0,0,0,0,10000,4000,6000,6000
20200316,706554,神盾群益96購01,,,,,,0.00,0,0,0,0,0,0,0,0,0,0,0,0,0
20200316,706555,鈺太群益94購01,1.02,1.02,0.78,0.78,+0.14,21.88,30000,2,25800,0,0,0,0,0,0,20000,10000,10000,10000
20200316,706556,由田富邦96購01,,,,,,0.00,0,0,0,0,0,0,0,0,0,0,0,0,0
20200316,706557,櫃200永昌94購01,,,,,,0.00,0,0,0,0,0,0,0,0,0,0,0,0,0
20200316,706558,櫃200永昌94購02,,,,,,0.00,0,0,0,0,0,0,0,0,0,0,0,0,0
20200316,706559,閎康永豐94購01,,,,,,0.00,0,0,0,0,0,0,0,0,0,0,0,0,0
20200316,706560,優群永豐94購02,1.67,1.67,1.67,1.67,-0.43,-20.48,1000,1,1670,0,0,0,0,0,0,1000,0,1000,1000
20200316,706561,雙美永豐95購01,,,,,,0.00,0,0,0,0,0,0,0,0,0,0,0,0,0
20200316,706562,鈺太永豐94購03,,,,,,0.00,0,0,0,0,0,0,0,0,0,0,0,0,0
20200316,706563,凡甲永豐94購01,,,,,,0.00,0,0,0,0,0,0,0,0,0,0,0,0,0
20200316,706564,元太群益95購01,,,,,,0.00,0,0,0,0,0,0,0,0,0,0,0,0,0
20200316,706565,環球晶群益94購02,0.07,0.07,0.07,0.07,-0.16,-69.57,11000,1,770,0,0,0,0,0,0,11000,0,11000,11000
20200316,706566,雙美群益94購01,,,,,,0.00,0,0,0,0,0,0,0,0,0,0,0,0,0
20200316,706567,建榮麥證94購01,,,,,,0.00,0,0,0,0,0,0,0,0,0,0,0,0,0
20200316,706568,大江台新94購01,,,,,,0.00,0,0,0,0,0,0,0,0,0,0,0,0,0
20200316,706569,金居國票95購01,,,,,,0.00,0,0,0,0,0,0,0,0,0,0,0,0,0
20200316,706570,泰博國票95購02,2.48,3.22,2.48,2.94,+0.58,24.58,65000,8,194800,0,0,0,0,0,0,9000,56000,-47000,-47000
20200316,706571,大江元大94購03,,,,,,0.00,0,0,0,0,0,0,0,0,0,0,0,0,0
20200316,706572,宏捷科元大95購01,0.14,0.14,0.07,0.07,-0.08,-53.33,100000,10,9200,0,0,0,0,0,0,0,100000,-100000,-100000
20200316,706573,金可元大94購01,,,,,,0.00,0,0,0,0,0,0,0,0,0,0,0,0,0
20200316,706574,建榮元大97購01,,,,,,0.00,0,0,0,0,0,0,0,0,0,0,0,0,0
20200316,706575,上詮凱基94購02,,,,,,0.00,0,0,0,0,0,0,0,0,0,0,0,0,0
20200316,706576,金可凱基94購01,0.04,0.04,0.03,0.03,+0.02,200.0,44000,3,1520,0,0,0,0,0,0,44000,0,44000,44000
20200316,706577,信昌電凱基94購01,,,,,,0.00,0,0,0,0,0,0,0,0,0,0,0,0,0
20200316,706578,聚積凱基94購02,,,,,,0.00,0,0,0,0,0,0,0,0,0,0,0,0,0
20200316,706579,晟德凱基94購03,,,,,,0.00,0,0,0,0,0,0,0,0,0,0,0,0,0
20200316,706580,櫃200富邦94購01,,,,,,0.00,0,0,0,0,0,0,0,0,0,0,0,0,0
20200316,706581,櫃200富邦94購02,,,,,,0.00,0,0,0,0,0,0,0,0,0,0,0,0,0
20200316,706582,櫃200富邦94購03,,,,,,0.00,0,0,0,0,0,0,0,0,0,0,0,0,0
20200316,706583,櫃200富邦94購04,,,,,,0.00,0,0,0,0,0,0,0,0,0,0,0,0,0
20200316,706584,神盾國票95購02,,,,,,0.00,0,0,0,0,0,0,0,0,0,0,0,0,0
20200316,706585,宏捷科國泰95購03,0.12,0.13,0.12,0.13,-0.08,-38.1,70000,3,9000,0,0,0,0,0,0,10000,10000,0,0
20200316,706586,凡甲統一95購01,,,,,,0.00,0,0,0,0,0,0,0,0,0,0,0,0,0
20200316,706587,凡甲統一95購02,0.30,0.30,0.30,0.30,+0.13,76.47,2000,1,600,0,0,0,0,0,0,0,0,0,0
20200316,706588,雙美統一95購01,,,,,,0.00,0,0,0,0,0,0,0,0,0,0,0,0,0
20200316,706589,VHQ凱基94購01,,,,,,0.00,0,0,0,0,0,0,0,0,0,0,0,0,0
20200316,706590,宏捷科凱基94購01,,,,,,0.00,0,0,0,0,0,0,0,0,0,0,0,0,0
20200316,706591,宏捷科凱基94購02,,,,,,0.00,0,0,0,0,0,0,0,0,0,0,0,0,0
20200316,706592,環球晶凱基94購05,,,,,,0.00,0,0,0,0,0,0,0,0,0,0,0,0,0
20200316,706593,均豪永豐94購01,,,,,,0.00,0,0,0,0,0,0,0,0,0,0,0,0,0
20200316,706594,杰力永豐94購01,,,,,,0.00,0,0,0,0,0,0,0,0,0,0,0,0,0
20200316,706595,宣德永豐94購01,,,,,,0.00,0,0,0,0,0,0,0,0,0,0,0,0,0
20200316,706596,建榮永豐96購01,,,,,,0.00,0,0,0,0,0,0,0,0,0,0,0,0,0
20200316,706597,神準永豐94購01,,,,,,0.00,0,0,0,0,0,0,0,0,0,0,0,0,0
20200316,706598,碩禾永豐95購01,0.09,0.09,0.09,0.09,-0.01,-10.0,30000,3,2700,0,0,0,0,0,0,0,30000,-30000,-30000
20200316,706599,環宇永豐94購01,,,,,,0.00,0,0,0,0,0,0,0,0,0,0,0,0,0
20200316,706600,環球晶永豐94購02,,,,,,0.00,0,0,0,0,0,0,0,0,0,0,0,0,0
20200316,706601,聯亞永豐94購02,,,,,,0.00,0,0,0,0,0,0,0,0,0,0,0,0,0
20200316,706602,大江元大96購01,0.01,0.01,0.01,0.01,-0.01,-50.0,40000,1,400,0,0,0,0,0,0,40000,0,40000,40000
20200316,706603,信驊元大94購01,3.18,3.55,2.44,2.44,-0.45,-15.57,35000,6,115050,0,0,0,0,0,0,10000,20000,-10000,-10000
20200316,706604,勝麗元大95購01,0.51,0.55,0.35,0.35,-0.10,-22.22,50000,5,22800,0,0,0,0,0,0,20000,30000,-10000,-10000
20200316,706605,環球晶元富94購03,0.95,0.95,0.80,0.80,-0.13,-13.98,121000,2,114800,0,0,0,0,0,0,121000,0,121000,121000
20200316,706606,M31兆豐94購01,,,,,,0.00,0,0,0,0,0,0,0,0,0,0,0,0,0
20200316,706607,中美晶兆豐95購02,0.35,0.35,0.25,0.25,-0.16,-39.02,105000,3,26590,0,0,0,0,0,0,0,105000,-105000,-105000
20200316,706608,六角台新94購02,,,,,,0.00,0,0,0,0,0,0,0,0,0,0,0,0,0
20200316,706609,威剛台新94購01,,,,,,0.00,0,0,0,0,0,0,0,0,0,0,0,0,0
20200316,706610,昂寶群益95購01,,,,,,0.00,0,0,0,0,0,0,0,0,0,0,0,0,0
20200316,706611,杰力群益94購01,,,,,,0.00,0,0,0,0,0,0,0,0,0,0,0,0,0
20200316,706612,原相群益97購01,,,,,,0.00,0,0,0,0,0,0,0,0,0,0,0,0,0
20200316,706613,環球晶群益94購03,0.15,0.15,0.15,0.15,+0.02,15.38,100000,1,15000,0,0,0,0,0,0,0,100000,-100000,-100000
20200316,706614,櫃200永昌96購01,,,,,,0.00,0,0,0,0,0,0,0,0,0,0,0,0,0
20200316,706615,櫃200永昌96購02,,,,,,0.00,0,0,0,0,0,0,0,0,0,0,0,0,0
20200316,706616,櫃200永昌96購03,,,,,,0.00,0,0,0,0,0,0,0,0,0,0,0,0,0
20200316,706617,M31中信95購01,0.01,0.01,0.01,0.01,0.00,0.0,10000,10,100,0,0,0,0,0,0,0,10000,-10000,-10000
20200316,706618,原相國泰96購01,,,,,,0.00,0,0,0,0,0,0,0,0,0,0,0,0,0
20200316,706619,環球晶國泰95購01,1.12,1.24,0.69,0.69,-0.51,-42.5,123000,4,127660,0,0,0,0,0,0,93000,30000,63000,63000
20200316,706620,宜鼎凱基94購02,0.75,0.83,0.73,0.83,+0.50,151.52,151000,3,113190,0,0,0,0,0,0,43000,108000,-65000,-65000
20200316,706621,泰博凱基94購01,0.85,1.16,0.85,0.93,+0.12,14.81,372000,15,361920,0,0,0,0,0,0,119000,253000,-134000,-134000
20200316,706622,優群凱基94購02,1.17,1.24,0.85,0.85,-0.03,-3.41,244000,15,266990,0,0,0,0,0,0,40000,204000,-164000,-164000
20200316,706623,雙鴻凱基94購01,,,,,,0.00,0,0,0,0,0,0,0,0,0,0,0,0,0
20200316,706624,雙鴻凱基96購01,0.02,0.02,0.02,0.02,0.00,0.0,15000,1,300,0,0,0,0,0,0,15000,0,15000,15000
20200316,706625,大宇資永豐94購02,,,,,,0.00,0,0,0,0,0,0,0,0,0,0,0,0,0
20200316,706626,立端永豐94購01,,,,,,0.00,0,0,0,0,0,0,0,0,0,0,0,0,0
20200316,706627,同致永豐94購01,,,,,,0.00,0,0,0,0,0,0,0,0,0,0,0,0,0
20200316,706628,安勤永豐94購02,,,,,,0.00,0,0,0,0,0,0,0,0,0,0,0,0,0
20200316,706629,信昌電永豐94購03,,,,,,0.00,0,0,0,0,0,0,0,0,0,0,0,0,0
20200316,706630,威剛永豐94購02,2.01,2.06,1.68,1.68,+0.38,29.23,68000,3,121340,0,0,0,0,0,0,48000,20000,28000,28000
20200316,706631,櫃200第一96購01,0.27,0.27,0.27,0.27,+0.09,50.0,10000,1,2700,0,0,0,0,0,0,10000,0,10000,10000
20200316,706632,聚積元富94購01,,,,,,0.00,0,0,0,0,0,0,0,0,0,0,0,0,0
20200316,706633,合晶台新95購01,0.21,0.21,0.14,0.14,-0.06,-30.0,350000,5,67800,0,0,0,0,0,0,50000,300000,-250000,-250000
20200316,706634,六角康和94購01,,,,,,0.00,0,0,0,0,0,0,0,0,0,0,0,0,0
20200316,706635,凡甲群益94購01,,,,,,0.00,0,0,0,0,0,0,0,0,0,0,0,0,0
20200316,706636,大宇資群益94購02,,,,,,0.00,0,0,0,0,0,0,0,0,0,0,0,0,0
20200316,706637,台燿群益94購02,,,,,,0.00,0,0,0,0,0,0,0,0,0,0,0,0,0
20200316,706638,美琪瑪群益94購01,,,,,,0.00,0,0,0,0,0,0,0,0,0,0,0,0,0
20200316,706639,群聯群益94購02,,,,,,0.00,0,0,0,0,0,0,0,0,0,0,0,0,0
20200316,706640,環球晶群益94購04,,,,,,0.00,0,0,0,0,0,0,0,0,0,0,0,0,0
20200316,706641,中美晶元大94購06,,,,,,0.00,0,0,0,0,0,0,0,0,0,0,0,0,0
20200316,706642,中美晶元大95購02,0.53,0.53,0.39,0.39,-0.18,-31.58,16000,3,7080,0,0,0,0,0,0,10000,6000,4000,4000
20200316,706643,台燿元大94購03,,,,,,0.00,0,0,0,0,0,0,0,0,0,0,0,0,0
20200316,706644,台燿元大94購04,,,,,,0.00,0,0,0,0,0,0,0,0,0,0,0,0,0
20200316,706645,昂寶元大97購01,,,,,,0.00,0,0,0,0,0,0,0,0,0,0,0,0,0
20200316,706646,昇達科元大96購02,,,,,,0.00,0,0,0,0,0,0,0,0,0,0,0,0,0
20200316,706647,金居元大95購02,0.12,0.12,0.09,0.09,-0.01,-10.0,50000,4,5100,0,0,0,0,0,0,20000,30000,-10000,-10000
20200316,706648,閎康元大94購01,,,,,,0.00,0,0,0,0,0,0,0,0,0,0,0,0,0
20200316,706649,新普元大94購01,1.11,1.11,0.76,0.76,-0.04,-5.0,30000,3,26900,0,0,0,0,0,0,20000,20000,0,0
20200316,706650,新普元大94購02,0.53,0.53,0.53,0.53,+0.04,8.16,4000,1,2120,0,0,0,0,0,0,4000,4000,0,0
20200316,706651,雙美元大96購01,,,,,,0.00,0,0,0,0,0,0,0,0,0,0,0,0,0
20200316,706652,晟德元大94購01,,,,,,0.00,0,0,0,0,0,0,0,0,0,0,0,0,0
20200316,706653,環球晶麥證95購01,,,,,,0.00,0,0,0,0,0,0,0,0,0,0,0,0,0
20200316,706654,優群元富94購01,,,,,,0.00,0,0,0,0,0,0,0,0,0,0,0,0,0
20200316,706655,環球晶元富94購04,,,,,,0.00,0,0,0,0,0,0,0,0,0,0,0,0,0
20200316,706656,緯軟兆豐95購02,,,,,,0.00,0,0,0,0,0,0,0,0,0,0,0,0,0
20200316,706657,環球晶兆豐95購02,0.27,0.27,0.27,0.27,-0.21,-43.75,3000,1,810,0,0,0,0,0,0,3000,0,3000,3000
20200316,706658,穩懋兆豐95購01,0.05,0.05,0.02,0.02,-0.04,-66.67,170000,12,7900,0,0,0,0,0,0,50000,100000,-50000,-50000
20200316,706659,中美晶台新95購01,0.89,0.96,0.88,0.96,+0.13,15.66,221000,4,201050,0,0,0,0,0,0,115000,106000,9000,9000
20200316,706660,順達康和94購01,,,,,,0.00,0,0,0,0,0,0,0,0,0,0,0,0,0
20200316,706661,雙鴻康和94購01,,,,,,0.00,0,0,0,0,0,0,0,0,0,0,0,0,0
20200316,706662,中美晶群益94購03,0.16,0.16,0.16,0.16,-0.05,-23.81,105000,1,16800,0,0,0,0,0,0,105000,0,105000,105000
20200316,706663,同致群益94購02,,,,,,0.00,0,0,0,0,0,0,0,0,0,0,0,0,0
20200316,706664,合晶群益94購02,,,,,,0.00,0,0,0,0,0,0,0,0,0,0,0,0,0
20200316,706665,璟德群益94購01,,,,,,0.00,0,0,0,0,0,0,0,0,0,0,0,0,0
20200316,706666,雙鴻群益95購02,,,,,,0.00,0,0,0,0,0,0,0,0,0,0,0,0,0
20200316,706667,安勤元大94購01,,,,,,0.00,0,0,0,0,0,0,0,0,0,0,0,0,0
20200316,706668,昂寶元大96購02,,,,,,0.00,0,0,0,0,0,0,0,0,0,0,0,0,0
20200316,706669,保瑞元大94購02,0.50,0.50,0.50,0.50,0.00,0.0,20000,1,10000,0,0,0,0,0,0,20000,0,20000,20000
20200316,706670,閎康元大94購02,,,,,,0.00,0,0,0,0,0,0,0,0,0,0,0,0,0
20200316,706671,順達元大94購02,1.21,1.21,0.97,1.01,0.00,0.0,120000,8,133500,0,0,0,0,0,0,100000,60000,40000,40000
20200316,706672,環球晶元大94購09,0.09,0.09,0.09,0.09,-0.12,-57.14,10000,2,900,0,0,0,0,0,0,0,10000,-10000,-10000
20200316,706673,環球晶元大94購10,,,,,,0.00,0,0,0,0,0,0,0,0,0,0,0,0,0
20200316,706674,穩懋元大94購07,,,,,,0.00,0,0,0,0,0,0,0,0,0,0,0,0,0
20200316,706675,穩懋元大94購08,,,,,,0.00,0,0,0,0,0,0,0,0,0,0,0,0,0
20200316,706676,環球晶統一94購02,,,,,,0.00,0,0,0,0,0,0,0,0,0,0,0,0,0
20200316,706677,凡甲凱基94購01,0.50,0.56,0.50,0.51,+0.04,8.51,120000,11,60290,0,0,0,0,0,0,18000,2000,16000,16000
20200316,706678,大中凱基94購01,,,,,,0.00,0,0,0,0,0,0,0,0,0,0,0,0,0
20200316,706679,大江凱基94購06,,,,,,0.00,0,0,0,0,0,0,0,0,0,0,0,0,0
20200316,706680,旺矽凱基94購01,,,,,,0.00,0,0,0,0,0,0,0,0,0,0,0,0,0
20200316,706681,順達凱基94購01,0.66,0.66,0.66,0.66,+0.11,20.0,10000,1,6600,0,0,0,0,0,0,10000,0,10000,10000
20200316,706682,網龍凱基94購01,,,,,,0.00,0,0,0,0,0,0,0,0,0,0,0,0,0
20200316,706683,環球晶凱基94購06,,,,,,0.00,0,0,0,0,0,0,0,0,0,0,0,0,0
20200316,706684,雙鴻凱基94購02,,,,,,0.00,0,0,0,0,0,0,0,0,0,0,0,0,0
20200316,706685,穩懋凱基94購07,,,,,,0.00,0,0,0,0,0,0,0,0,0,0,0,0,0
20200316,706686,安勤國票94購01,,,,,,0.00,0,0,0,0,0,0,0,0,0,0,0,0,0
20200316,706687,宣德國票94購01,0.55,0.55,0.55,0.55,+0.18,48.65,10000,1,5500,0,0,0,0,0,0,10000,0,10000,10000
20200316,706688,群聯國票94購02,,,,,,0.00,0,0,0,0,0,0,0,0,0,0,0,0,0
20200316,706689,雙鴻國票94購01,,,,,,0.00,0,0,0,0,0,0,0,0,0,0,0,0,0
20200316,706690,環球晶富邦98購01,0.39,0.42,0.37,0.37,-0.13,-26.0,31000,5,12160,0,0,0,0,0,0,11000,20000,-9000,-9000
20200316,706691,大宇資第一94購01,,,,,,0.00,0,0,0,0,0,0,0,0,0,0,0,0,0
20200316,706692,六角永豐94購01,,,,,,0.00,0,0,0,0,0,0,0,0,0,0,0,0,0
20200316,706693,世界永豐94購01,,,,,,0.00,0,0,0,0,0,0,0,0,0,0,0,0,0
20200316,706694,合晶永豐94購01,,,,,,0.00,0,0,0,0,0,0,0,0,0,0,0,0,0
20200316,706695,保瑞永豐94購02,,,,,,0.00,0,0,0,0,0,0,0,0,0,0,0,0,0
20200316,706696,聖暉永豐94購01,,,,,,0.00,0,0,0,0,0,0,0,0,0,0,0,0,0
20200316,706697,凡甲永豐94購02,,,,,,0.00,0,0,0,0,0,0,0,0,0,0,0,0,0
20200316,706698,大學光永豐95購02,0.61,0.61,0.61,0.61,0.00,0.0,1000,1,610,0,0,0,0,0,0,0,1000,-1000,-1000
20200316,706699,台燿永豐94購01,,,,,,0.00,0,0,0,0,0,0,0,0,0,0,0,0,0
20200316,706700,茂達永豐94購01,,,,,,0.00,0,0,0,0,0,0,0,0,0,0,0,0,0
20200316,706701,新鉅科永豐94購01,,,,,,0.00,0,0,0,0,0,0,0,0,0,0,0,0,0
20200316,706702,合晶兆豐94購01,0.04,0.04,0.04,0.04,-0.01,-20.0,50000,1,2000,0,0,0,0,0,0,50000,0,50000,50000
20200316,706703,信昌電兆豐95購01,,,,,,0.00,0,0,0,0,0,0,0,0,0,0,0,0,0
20200316,706704,保瑞兆豐95購01,0.43,0.43,0.32,0.32,-0.08,-20.0,186000,2,78880,0,0,0,0,0,0,186000,0,186000,186000
20200316,706705,建榮兆豐95購01,,,,,,0.00,0,0,0,0,0,0,0,0,0,0,0,0,0
20200316,706706,力麒康和94購01,,,,,,0.00,0,0,0,0,0,0,0,0,0,0,0,0,0
20200316,706707,台燿康和94購01,,,,,,0.00,0,0,0,0,0,0,0,0,0,0,0,0,0
20200316,706708,新鉅科康和94購01,,,,,,0.00,0,0,0,0,0,0,0,0,0,0,0,0,0
20200316,706709,茂達群益94購01,,,,,,0.00,0,0,0,0,0,0,0,0,0,0,0,0,0
20200316,706710,環球晶群益94購05,0.56,0.56,0.56,0.56,-0.07,-11.11,50000,1,28000,0,0,0,0,0,0,50000,0,50000,50000
20200316,706711,台燿統一94購01,,,,,,0.00,0,0,0,0,0,0,0,0,0,0,0,0,0
20200316,706712,台燿統一94購02,,,,,,0.00,0,0,0,0,0,0,0,0,0,0,0,0,0
20200316,706713,安勤統一94購01,,,,,,0.00,0,0,0,0,0,0,0,0,0,0,0,0,0
20200316,706714,新鉅科統一94購01,,,,,,0.00,0,0,0,0,0,0,0,0,0,0,0,0,0
20200316,706715,新鉅科統一94購02,,,,,,0.00,0,0,0,0,0,0,0,0,0,0,0,0,0
20200316,706716,環球晶統一94購03,,,,,,0.00,0,0,0,0,0,0,0,0,0,0,0,0,0
20200316,706717,中美晶凱基94購03,0.86,0.86,0.86,0.86,+0.24,38.71,10000,1,8600,0,0,0,0,0,0,10000,0,10000,10000
20200316,706718,台燿凱基94購04,0.33,0.38,0.33,0.38,-0.03,-7.32,40000,2,13700,0,0,0,0,0,0,30000,10000,20000,20000
20200316,706719,信驊凱基94購01,2.46,2.65,2.37,2.37,+0.47,24.74,15000,3,37570,0,0,0,0,0,0,0,15000,-15000,-15000
20200316,706720,威剛凱基94購02,0.49,0.49,0.49,0.49,+0.06,13.95,10000,1,4900,0,0,0,0,0,0,10000,0,10000,10000
20200316,706721,泰博凱基94購02,0.52,0.75,0.52,0.54,+0.09,20.0,429000,21,245700,0,0,0,0,0,0,322000,107000,215000,215000
20200316,706722,新鉅科凱基94購01,,,,,,0.00,0,0,0,0,0,0,0,0,0,0,0,0,0
20200316,706723,環球晶凱基94購07,,,,,,0.00,0,0,0,0,0,0,0,0,0,0,0,0,0
20200316,706724,雙鴻凱基94購03,,,,,,0.00,0,0,0,0,0,0,0,0,0,0,0,0,0
20200316,706725,穩懋凱基94購08,,,,,,0.00,0,0,0,0,0,0,0,0,0,0,0,0,0
20200316,706726,M31元大96購01,,,,,,0.00,0,0,0,0,0,0,0,0,0,0,0,0,0
20200316,706727,凡甲元大94購02,0.29,0.29,0.29,0.29,+0.01,3.57,10000,2,2900,0,0,0,0,0,0,0,10000,-10000,-10000
20200316,706728,元太元大94購03,0.17,0.17,0.12,0.12,+0.01,9.09,60000,2,7300,0,0,0,0,0,0,60000,58000,2000,2000
20200316,706729,台燿元大94購06,0.75,0.75,0.75,0.75,-0.11,-12.79,10000,1,7500,0,0,0,0,0,0,10000,0,10000,10000
20200316,706730,安勤元大94購02,,,,,,0.00,0,0,0,0,0,0,0,0,0,0,0,0,0
20200316,706731,良維元大97購01,0.11,0.11,0.11,0.11,0.00,0.0,60000,1,6600,0,0,0,0,0,0,60000,0,60000,60000
20200316,706732,杰力元大94購01,,,,,,0.00,0,0,0,0,0,0,0,0,0,0,0,0,0
20200316,706733,神盾元大96購01,0.10,0.13,0.03,0.13,+0.03,30.0,203000,4,6330,0,0,0,0,0,0,200000,1000,199000,199000
20200316,706734,精華元大94購01,,,,,,0.00,0,0,0,0,0,0,0,0,0,0,0,0,0
20200316,706735,精華元大94購02,,,,,,0.00,0,0,0,0,0,0,0,0,0,0,0,0,0
20200316,706736,環球晶元大94購11,0.10,0.10,0.06,0.06,-0.02,-25.0,60000,6,4200,0,0,0,0,0,0,0,60000,-60000,-60000
20200316,706737,環球晶元大94購13,0.23,0.23,0.13,0.13,-0.20,-60.61,420000,42,84500,0,0,0,0,0,0,0,420000,-420000,-420000
20200316,706738,緯軟國票94購01,,,,,,0.00,0,0,0,0,0,0,0,0,0,0,0,0,0
20200316,706739,新鉅科國泰95購01,,,,,,0.00,0,0,0,0,0,0,0,0,0,0,0,0,0
20200316,706740,新鉅科國泰95購02,,,,,,0.00,0,0,0,0,0,0,0,0,0,0,0,0,0
20200316,706741,精華國泰95購01,,,,,,0.00,0,0,0,0,0,0,0,0,0,0,0,0,0
20200316,706742,群聯富邦95購01,,,,,,0.00,0,0,0,0,0,0,0,0,0,0,0,0,0
20200316,706743,台燿凱基94購05,,,,,,0.00,0,0,0,0,0,0,0,0,0,0,0,0,0
20200316,706744,良維凱基94購02,,,,,,0.00,0,0,0,0,0,0,0,0,0,0,0,0,0
20200316,706745,茂達凱基94購01,,,,,,0.00,0,0,0,0,0,0,0,0,0,0,0,0,0
20200316,706746,穩懋凱基94購09,,,,,,0.00,0,0,0,0,0,0,0,0,0,0,0,0,0
20200316,706747,安勤統一95購01,,,,,,0.00,0,0,0,0,0,0,0,0,0,0,0,0,0
20200316,706748,安勤統一95購02,,,,,,0.00,0,0,0,0,0,0,0,0,0,0,0,0,0
20200316,706749,大江第一94購01,,,,,,0.00,0,0,0,0,0,0,0,0,0,0,0,0,0
20200316,706750,神盾第一94購01,0.01,0.01,0.01,0.01,0.00,0.0,370000,2,3700,0,0,0,0,0,0,370000,0,370000,370000
20200316,706751,同致國票95購01,,,,,,0.00,0,0,0,0,0,0,0,0,0,0,0,0,0
20200316,706752,波若威國票95購01,,,,,,0.00,0,0,0,0,0,0,0,0,0,0,0,0,0
20200316,706753,台燿台新94購01,,,,,,0.00,0,0,0,0,0,0,0,0,0,0,0,0,0
20200316,706754,碩禾台新96購01,0.14,0.14,0.14,0.14,-0.06,-30.0,20000,1,2800,0,0,0,0,0,0,0,20000,-20000,-20000
20200316,706755,台燿元富94購01,0.08,0.08,0.08,0.08,-0.02,-20.0,25000,1,2000,0,0,0,0,0,0,25000,0,25000,25000
20200316,706756,茂達元富94購01,,,,,,0.00,0,0,0,0,0,0,0,0,0,0,0,0,0
20200316,706757,茂達元富94購02,,,,,,0.00,0,0,0,0,0,0,0,0,0,0,0,0,0
20200316,706758,六角國泰96購01,0.29,0.30,0.25,0.26,+0.03,13.04,557000,18,149500,0,0,0,0,0,0,60000,497000,-437000,-437000
20200316,706759,雙美國泰95購01,,,,,,0.00,0,0,0,0,0,0,0,0,0,0,0,0,0
20200316,706760,鈺太國泰95購01,0.57,0.75,0.57,0.71,+0.13,22.41,775000,13,480990,0,0,0,0,0,0,50000,725000,-675000,-675000
20200316,706761,鐿鈦國泰96購01,,,,,,0.00,0,0,0,0,0,0,0,0,0,0,0,0,0
20200316,706762,大江兆豐95購02,0.02,0.02,0.02,0.02,+0.01,100.0,310000,32,6200,0,0,0,0,0,0,0,310000,-310000,-310000
20200316,706763,勝麗兆豐95購01,,,,,,0.00,0,0,0,0,0,0,0,0,0,0,0,0,0
20200316,706764,中美晶元大94購07,0.41,0.41,0.27,0.27,-0.15,-35.71,20000,3,7400,0,0,0,0,0,0,5000,15000,-10000,-10000
20200316,706765,六角元大96購01,0.29,0.35,0.24,0.24,-0.06,-20.0,70000,5,20600,0,0,0,0,0,0,40000,30000,10000,10000
20200316,706766,順達元大94購03,0.96,1.11,0.86,0.86,-0.25,-22.52,30000,3,29300,0,0,0,0,0,0,20000,10000,10000,10000
20200316,706767,群聯元大95購04,0.38,0.38,0.22,0.22,-0.04,-15.38,310000,17,87300,0,0,0,0,0,0,220000,160000,60000,60000
20200316,706768,環球晶元大94購14,,,,,,0.00,0,0,0,0,0,0,0,0,0,0,0,0,0
20200316,706769,環球晶元大95購02,0.40,0.40,0.21,0.21,-0.19,-47.5,210000,17,76200,0,0,0,0,0,0,50000,160000,-110000,-110000
20200316,706770,博智群益94購01,5.85,6.60,5.85,6.60,+1.60,32.0,71000,9,445700,0,0,0,0,0,0,71000,0,71000,71000
20200316,706771,新鉅科群益94購01,,,,,,0.00,0,0,0,0,0,0,0,0,0,0,0,0,0
20200316,706772,聖暉群益94購01,,,,,,0.00,0,0,0,0,0,0,0,0,0,0,0,0,0
20200316,706773,優群群益95購01,,,,,,0.00,0,0,0,0,0,0,0,0,0,0,0,0,0
20200316,706774,雙美群益96購01,,,,,,0.00,0,0,0,0,0,0,0,0,0,0,0,0,0
20200316,706775,元太凱基94購01,,,,,,0.00,0,0,0,0,0,0,0,0,0,0,0,0,0
20200316,706776,合晶凱基94購02,,,,,,0.00,0,0,0,0,0,0,0,0,0,0,0,0,0
20200316,706777,安勤凱基94購01,,,,,,0.00,0,0,0,0,0,0,0,0,0,0,0,0,0
20200316,706778,安勤凱基94購02,,,,,,0.00,0,0,0,0,0,0,0,0,0,0,0,0,0
20200316,706779,直得凱基94購01,,,,,,0.00,0,0,0,0,0,0,0,0,0,0,0,0,0
20200316,706780,勝麗凱基94購02,0.59,0.59,0.59,0.59,-0.14,-19.18,50000,1,29500,0,0,0,0,0,0,0,50000,-50000,-50000
20200316,706781,順達凱基94購02,0.21,0.21,0.21,0.21,-0.08,-27.59,25000,1,5250,0,0,0,0,0,0,25000,0,25000,25000
20200316,706782,環球晶凱基94購08,,,,,,0.00,0,0,0,0,0,0,0,0,0,0,0,0,0
20200316,706783,大江元富94購01,,,,,,0.00,0,0,0,0,0,0,0,0,0,0,0,0,0
20200316,706784,大學光群益94購01,0.09,0.09,0.09,0.09,-0.03,-25.0,1000,1,90,0,0,0,0,0,0,1000,0,1000,1000
20200316,706785,三貝德永豐94購02,,,,,,0.00,0,0,0,0,0,0,0,0,0,0,0,0,0
20200316,706786,勝麗永豐94購02,,,,,,0.00,0,0,0,0,0,0,0,0,0,0,0,0,0
20200316,706787,博智國票95購02,7.60,7.60,7.60,7.60,+0.80,11.76,1000,1,7600,0,0,0,0,0,0,1000,0,1000,1000
20200316,706788,大學光國泰96購01,0.83,0.84,0.55,0.55,-0.19,-25.68,93000,8,67650,0,0,0,0,0,0,23000,70000,-47000,-47000
20200316,706789,VHQ元大94購01,,,,,,0.00,0,0,0,0,0,0,0,0,0,0,0,0,0
20200316,706790,中美晶元大94購08,0.41,0.41,0.41,0.41,-0.01,-2.38,2000,2,820,0,0,0,0,0,0,2000,2000,0,0
20200316,706791,同致元大94購02,0.17,0.17,0.17,0.17,-0.13,-43.33,17000,1,2890,0,0,0,0,0,0,17000,0,17000,17000
20200316,706792,威剛元大96購01,1.60,1.95,1.38,1.43,-0.25,-14.88,209000,25,360460,0,0,0,0,0,0,124000,109000,15000,15000
20200316,706793,勝麗元大94購02,0.95,0.97,0.64,0.64,-0.18,-21.95,190000,18,175400,0,0,0,0,0,0,20000,170000,-150000,-150000
20200316,706794,環球晶元大94購15,0.18,0.18,0.12,0.12,-0.05,-29.41,300000,12,42000,0,0,0,0,0,0,200000,100000,100000,100000
20200316,706795,穩懋元大94購09,,,,,,0.00,0,0,0,0,0,0,0,0,0,0,0,0,0
20200316,706796,鈺太元大96購02,0.47,0.68,0.47,0.59,+0.13,28.26,213000,16,112630,0,0,0,0,0,0,110000,103000,7000,7000
20200316,706797,昂寶元大94購01,,,,,,0.00,0,0,0,0,0,0,0,0,0,0,0,0,0
20200316,706798,杰力元大94購02,,,,,,0.00,0,0,0,0,0,0,0,0,0,0,0,0,0
20200316,706799,茂達元大94購02,0.15,0.15,0.15,0.15,-0.07,-31.82,6000,1,900,0,0,0,0,0,0,6000,0,6000,6000
20200316,706800,原相元大96購01,1.99,1.99,1.99,1.99,-0.10,-4.78,220000,1,437800,0,0,0,0,0,0,220000,0,220000,220000
20200316,706801,環球晶元大94購16,0.25,0.26,0.16,0.16,-0.09,-36.0,77000,9,15700,0,0,0,0,0,0,0,77000,-77000,-77000
20200316,706802,環球晶統一94購04,,,,,,0.00,0,0,0,0,0,0,0,0,0,0,0,0,0
20200316,706803,環球晶中信97購01,0.17,0.21,0.12,0.12,-0.09,-42.86,841000,85,129900,0,0,0,0,0,0,53000,665000,-612000,-612000
20200316,706804,由田國泰96購01,,,,,,0.00,0,0,0,0,0,0,0,0,0,0,0,0,0
20200316,706805,宣德凱基94購02,0.49,0.49,0.41,0.41,+0.01,2.5,321000,6,149380,0,0,0,0,0,0,101000,220000,-119000,-119000
20200316,706806,雙美凱基94購01,,,,,,0.00,0,0,0,0,0,0,0,0,0,0,0,0,0
20200316,706807,精華麥證94購01,,,,,,0.00,0,0,0,0,0,0,0,0,0,0,0,0,0
20200316,706808,泰博元富94購01,,,,,,0.00,0,0,0,0,0,0,0,0,0,0,0,0,0
20200316,706809,神盾元富95購01,,,,,,0.00,0,0,0,0,0,0,0,0,0,0,0,0,0
20200316,706810,緯軟元富94購01,0.01,0.01,0.01,0.01,-0.03,-75.0,40000,1,400,0,0,0,0,0,0,40000,0,40000,40000
20200316,706811,環球晶元富95購03,0.49,0.54,0.49,0.50,-0.08,-13.79,115000,3,56700,0,0,0,0,0,0,110000,5000,105000,105000
20200316,706812,凡甲台新94購01,,,,,,0.00,0,0,0,0,0,0,0,0,0,0,0,0,0
20200316,706813,台燿第一94購01,,,,,,0.00,0,0,0,0,0,0,0,0,0,0,0,0,0
20200316,706814,由田永豐94購02,,,,,,0.00,0,0,0,0,0,0,0,0,0,0,0,0,0
20200316,706815,金居永豐94購01,,,,,,0.00,0,0,0,0,0,0,0,0,0,0,0,0,0
20200316,706816,原相永豐94購03,0.55,0.65,0.51,0.51,-0.07,-12.07,148000,17,86650,0,0,0,0,0,0,138000,10000,128000,128000
20200316,706817,廣明永豐94購01,,,,,,0.00,0,0,0,0,0,0,0,0,0,0,0,0,0
20200316,706818,廣積永豐94購01,,,,,,0.00,0,0,0,0,0,0,0,0,0,0,0,0,0
20200316,706819,優群永豐94購03,0.96,1.11,0.93,0.93,+0.03,3.33,93000,16,96800,0,0,0,0,0,0,10000,83000,-73000,-73000
20200316,706820,櫃200永豐94購01,,,,,,0.00,0,0,0,0,0,0,0,0,0,0,0,0,0
20200316,706821,雙鴻永豐95購04,,,,,,0.00,0,0,0,0,0,0,0,0,0,0,0,0,0
20200316,706822,立端群益95購01,,,,,,0.00,0,0,0,0,0,0,0,0,0,0,0,0,0
20200316,706823,勝麗群益94購01,,,,,,0.00,0,0,0,0,0,0,0,0,0,0,0,0,0
20200316,706824,群聯群益94購03,,,,,,0.00,0,0,0,0,0,0,0,0,0,0,0,0,0
20200316,706825,穩懋統一96購02,,,,,,0.00,0,0,0,0,0,0,0,0,0,0,0,0,0
20200316,706826,凡甲中信94購01,,,,,,0.00,0,0,0,0,0,0,0,0,0,0,0,0,0
20200316,706827,凡甲元大94購03,,,,,,0.00,0,0,0,0,0,0,0,0,0,0,0,0,0
20200316,706828,世界元大94購02,2.62,2.62,2.40,2.40,+0.07,3.0,118000,5,296800,0,0,0,0,0,0,118000,0,118000,118000
20200316,706829,台半元大94購01,,,,,,0.00,0,0,0,0,0,0,0,0,0,0,0,0,0
20200316,706830,迅得元大95購01,,,,,,0.00,0,0,0,0,0,0,0,0,0,0,0,0,0
20200316,706831,聖暉元大94購01,1.47,1.47,1.39,1.39,+0.03,2.21,25000,3,35650,0,0,0,0,0,0,15000,10000,5000,5000
20200316,706832,環球晶元大94購18,0.69,0.69,0.69,0.69,-0.11,-13.75,10000,1,6900,0,0,0,0,0,0,10000,0,10000,10000
20200316,706833,鈺太元大96購03,0.36,0.36,0.32,0.32,+0.03,10.34,20000,2,6800,0,0,0,0,0,0,10000,10000,0,0
20200316,706834,昇達科永豐94購02,,,,,,0.00,0,0,0,0,0,0,0,0,0,0,0,0,0
20200316,706835,東隆興永豐94購01,,,,,,0.00,0,0,0,0,0,0,0,0,0,0,0,0,0
20200316,706836,振曜永豐94購01,,,,,,0.00,0,0,0,0,0,0,0,0,0,0,0,0,0
20200316,706837,網家永豐94購02,,,,,,0.00,0,0,0,0,0,0,0,0,0,0,0,0,0
20200316,706838,聚積永豐94購01,,,,,,0.00,0,0,0,0,0,0,0,0,0,0,0,0,0
20200316,706839,鈺太永豐94購04,,,,,,0.00,0,0,0,0,0,0,0,0,0,0,0,0,0
20200316,706840,良維國票95購01,,,,,,0.00,0,0,0,0,0,0,0,0,0,0,0,0,0
20200316,706841,保瑞國票95購01,0.82,0.82,0.82,0.82,+0.08,10.81,20000,1,16400,0,0,0,0,0,0,20000,0,20000,20000
20200316,706842,群聯國票94購03,0.42,0.42,0.42,0.42,-0.05,-10.64,10000,1,4200,0,0,0,0,0,0,10000,0,10000,10000
20200316,706843,碩禾國票95購01,,,,,,0.00,0,0,0,0,0,0,0,0,0,0,0,0,0
20200316,706844,新鉅科富邦98購01,,,,,,0.00,0,0,0,0,0,0,0,0,0,0,0,0,0
20200316,706845,中美晶凱基94購06,,,,,,0.00,0,0,0,0,0,0,0,0,0,0,0,0,0
20200316,706846,金可凱基94購02,0.02,0.02,0.02,0.02,-0.08,-80.0,350000,1,7000,0,0,0,0,0,0,350000,0,350000,350000
20200316,706847,神盾凱基94購01,,,,,,0.00,0,0,0,0,0,0,0,0,0,0,0,0,0
20200316,706848,碩禾凱基94購01,,,,,,0.00,0,0,0,0,0,0,0,0,0,0,0,0,0
20200316,706849,精華凱基94購03,,,,,,0.00,0,0,0,0,0,0,0,0,0,0,0,0,0
20200316,706850,廣明凱基94購06,,,,,,0.00,0,0,0,0,0,0,0,0,0,0,0,0,0
20200316,706851,穩懋凱基94購10,0.19,0.19,0.19,0.19,+0.01,5.56,60000,1,11400,0,0,0,0,0,0,0,60000,-60000,-60000
20200316,706852,穩懋麥證94購01,,,,,,0.00,0,0,0,0,0,0,0,0,0,0,0,0,0
20200316,706853,神盾元富95購02,,,,,,0.00,0,0,0,0,0,0,0,0,0,0,0,0,0
20200316,706854,聯亞台新94購01,0.15,0.15,0.15,0.15,0.00,0.0,30000,3,4500,0,0,0,0,0,0,0,30000,-30000,-30000
20200316,706855,原相兆豐95購02,1.82,1.82,1.82,1.82,+0.82,82.0,10000,1,18200,0,0,0,0,0,0,10000,10000,0,0
20200316,706856,環球晶兆豐95購04,0.18,0.18,0.05,0.05,-0.15,-75.0,529000,30,64870,0,0,0,0,0,0,11000,508000,-497000,-497000
20200316,706857,凡甲康和94購01,,,,,,0.00,0,0,0,0,0,0,0,0,0,0,0,0,0
20200316,706858,由田群益96購01,,,,,,0.00,0,0,0,0,0,0,0,0,0,0,0,0,0
20200316,706859,環球晶群益94購07,,,,,,0.00,0,0,0,0,0,0,0,0,0,0,0,0,0
20200316,706860,原相中信94購01,,,,,,0.00,0,0,0,0,0,0,0,0,0,0,0,0,0
20200316,706861,金居凱基94購01,,,,,,0.00,0,0,0,0,0,0,0,0,0,0,0,0,0
20200316,706862,泰博凱基94購03,0.68,0.95,0.68,0.88,+0.29,49.15,121000,14,103910,0,0,0,0,0,0,20000,101000,-81000,-81000
20200316,706863,環宇凱基94購01,,,,,,0.00,0,0,0,0,0,0,0,0,0,0,0,0,0
20200316,706864,環球晶凱基94購09,0.43,0.43,0.31,0.31,-0.22,-41.51,50000,5,17200,0,0,0,0,0,0,0,50000,-50000,-50000
20200316,706865,環球晶統一94購05,,,,,,0.00,0,0,0,0,0,0,0,0,0,0,0,0,0
20200316,706866,凡甲國票95購01,0.35,0.37,0.33,0.33,+0.06,22.22,13000,6,4500,0,0,0,0,0,0,10000,3000,7000,7000
20200316,706867,中美晶國票95購01,1.45,1.45,1.45,1.45,-0.01,-0.68,80000,3,116000,0,0,0,0,0,0,80000,0,80000,80000
20200316,706868,神盾國票96購01,,,,,,0.00,0,0,0,0,0,0,0,0,0,0,0,0,0
20200316,706869,環球晶國票95購02,,,,,,0.00,0,0,0,0,0,0,0,0,0,0,0,0,0
20200316,706870,原相群益97購02,,,,,,0.00,0,0,0,0,0,0,0,0,0,0,0,0,0
20200316,706871,台半永豐94購01,,,,,,0.00,0,0,0,0,0,0,0,0,0,0,0,0,0
20200316,706872,波若威永豐95購01,,,,,,0.00,0,0,0,0,0,0,0,0,0,0,0,0,0
20200316,706873,宣德永豐94購03,0.70,0.70,0.67,0.67,+0.13,24.07,18000,3,12330,0,0,0,0,0,0,10000,8000,2000,2000
20200316,706874,閎康永豐94購02,,,,,,0.00,0,0,0,0,0,0,0,0,0,0,0,0,0
20200316,706875,環球晶永豐94購04,,,,,,0.00,0,0,0,0,0,0,0,0,0,0,0,0,0
20200316,706876,大宇資元大96購01,,,,,,0.00,0,0,0,0,0,0,0,0,0,0,0,0,0
20200316,706877,合晶元大95購01,0.17,0.17,0.16,0.16,-0.01,-5.88,43000,5,6980,0,0,0,0,0,0,0,43000,-43000,-43000
20200316,706878,邦特元大94購01,0.06,0.06,0.06,0.06,-0.05,-45.45,10000,1,600,0,0,0,0,0,0,0,10000,-10000,-10000
20200316,706879,信昌電元大95購02,0.25,0.25,0.15,0.15,-0.05,-25.0,25000,3,5200,0,0,0,0,0,0,0,25000,-25000,-25000
20200316,706880,茂達元大94購03,0.23,0.23,0.23,0.23,+0.03,15.0,5000,1,1150,0,0,0,0,0,0,5000,0,5000,5000
20200316,706881,網家元大94購02,,,,,,0.00,0,0,0,0,0,0,0,0,0,0,0,0,0
20200316,706882,緯軟元大96購03,,,,,,0.00,0,0,0,0,0,0,0,0,0,0,0,0,0
20200316,706883,環球晶元大94購19,0.52,0.52,0.52,0.52,+0.01,1.96,30000,1,15600,0,0,0,0,0,0,30000,0,30000,30000
20200316,706884,環球晶元大95購03,1.28,1.31,0.81,0.81,-0.56,-40.88,139000,14,156470,0,0,0,0,0,0,88000,51000,37000,37000
20200316,706885,環球晶台新94購02,,,,,,0.00,0,0,0,0,0,0,0,0,0,0,0,0,0
20200316,706886,台燿元富94購03,,,,,,0.00,0,0,0,0,0,0,0,0,0,0,0,0,0
20200316,706887,台燿元富94購04,,,,,,0.00,0,0,0,0,0,0,0,0,0,0,0,0,0
20200316,706888,聚積元富94購02,,,,,,0.00,0,0,0,0,0,0,0,0,0,0,0,0,0
20200316,706889,雙鴻元富96購01,,,,,,0.00,0,0,0,0,0,0,0,0,0,0,0,0,0
20200316,706890,信驊凱基95購01,2.32,2.61,1.63,1.63,-0.22,-11.89,87000,6,211510,0,0,0,0,0,0,51000,36000,15000,15000
20200316,706891,新普凱基94購03,0.46,0.46,0.41,0.41,-0.04,-8.89,12000,2,5220,0,0,0,0,0,0,6000,6000,0,0
20200316,706892,網家凱基95購01,,,,,,0.00,0,0,0,0,0,0,0,0,0,0,0,0,0
20200316,706893,環球晶凱基94購10,,,,,,0.00,0,0,0,0,0,0,0,0,0,0,0,0,0
20200316,706894,M31元大95購01,,,,,,0.00,0,0,0,0,0,0,0,0,0,0,0,0,0
20200316,706895,凡甲元大94購04,0.60,0.60,0.50,0.50,+0.23,85.19,70000,9,39600,0,0,0,0,0,0,50000,70000,-20000,-20000
20200316,706896,佳邦元大94購01,,,,,,0.00,0,0,0,0,0,0,0,0,0,0,0,0,0
20200316,706897,保瑞元大94購03,0.82,0.82,0.51,0.51,-0.23,-31.08,40000,3,28200,0,0,0,0,0,0,20000,20000,0,0
20200316,706898,勝麗元大95購02,0.70,0.70,0.53,0.53,-0.21,-28.38,45000,5,28000,0,0,0,0,0,0,5000,40000,-35000,-35000
20200316,706899,閎康元大95購01,,,,,,0.00,0,0,0,0,0,0,0,0,0,0,0,0,0
20200316,706900,環球晶元大94購20,,,,,,0.00,0,0,0,0,0,0,0,0,0,0,0,0,0
20200316,706901,穩懋元大94購10,,,,,,0.00,0,0,0,0,0,0,0,0,0,0,0,0,0
20200316,706902,迅得永豐95購02,,,,,,0.00,0,0,0,0,0,0,0,0,0,0,0,0,0
20200316,706903,長科*永豐94購02,,,,,,0.00,0,0,0,0,0,0,0,0,0,0,0,0,0
20200316,706904,群聯永豐94購01,0.24,0.24,0.22,0.24,-0.09,-27.27,52000,3,12460,0,0,0,0,0,0,50000,52000,-2000,-2000
20200316,706905,應華永豐94購01,,,,,,0.00,0,0,0,0,0,0,0,0,0,0,0,0,0
20200316,706906,大學光國票96購01,0.44,0.45,0.29,0.29,-0.18,-38.3,50000,5,19300,0,0,0,0,0,0,0,50000,-50000,-50000
20200316,706907,合晶國票95購01,,,,,,0.00,0,0,0,0,0,0,0,0,0,0,0,0,0
20200316,706908,皇田國票95購01,,,,,,0.00,0,0,0,0,0,0,0,0,0,0,0,0,0
20200316,706909,茂達國票94購01,,,,,,0.00,0,0,0,0,0,0,0,0,0,0,0,0,0
20200316,706910,閎康國票95購01,,,,,,0.00,0,0,0,0,0,0,0,0,0,0,0,0,0
20200316,706911,網龍國票94購02,0.01,0.01,0.01,0.01,-0.01,-50.0,5000,1,50,0,0,0,0,0,0,5000,0,5000,5000
20200316,706912,鐿鈦國票96購01,0.27,0.27,0.27,0.27,+0.01,3.85,80000,1,21600,0,0,0,0,0,0,80000,0,80000,80000
20200316,706913,邦特元富94購01,,,,,,0.00,0,0,0,0,0,0,0,0,0,0,0,0,0
20200316,706914,智擎元富94購01,,,,,,0.00,0,0,0,0,0,0,0,0,0,0,0,0,0
20200316,706915,台半康和94購01,,,,,,0.00,0,0,0,0,0,0,0,0,0,0,0,0,0
20200316,706916,M31元大96購02,,,,,,0.00,0,0,0,0,0,0,0,0,0,0,0,0,0
20200316,706917,力旺元大94購01,,,,,,0.00,0,0,0,0,0,0,0,0,0,0,0,0,0
20200316,706918,大學光元大96購01,0.45,0.45,0.45,0.45,+0.01,2.27,10000,1,4500,0,0,0,0,0,0,10000,0,10000,10000
20200316,706919,良維元大96購01,0.07,0.07,0.07,0.07,+0.02,40.0,50000,5,3500,0,0,0,0,0,0,0,50000,-50000,-50000
20200316,706920,宣德元大96購01,0.54,0.54,0.30,0.30,-0.10,-25.0,78000,7,38850,0,0,0,0,0,0,70000,8000,62000,62000
20200316,706921,新鉅科元大94購01,,,,,,0.00,0,0,0,0,0,0,0,0,0,0,0,0,0
20200316,706922,新鉅科元大94購02,,,,,,0.00,0,0,0,0,0,0,0,0,0,0,0,0,0
20200316,706923,聚積元大96購01,,,,,,0.00,0,0,0,0,0,0,0,0,0,0,0,0,0
20200316,706924,穩懋元大94購12,,,,,,0.00,0,0,0,0,0,0,0,0,0,0,0,0,0
20200316,706925,穩懋元大94購13,,,,,,0.00,0,0,0,0,0,0,0,0,0,0,0,0,0
20200316,706926,晟德元大94購02,,,,,,0.00,0,0,0,0,0,0,0,0,0,0,0,0,0
20200316,706927,上詮永豐94購03,,,,,,0.00,0,0,0,0,0,0,0,0,0,0,0,0,0
20200316,706928,大學光永豐96購01,,,,,,0.00,0,0,0,0,0,0,0,0,0,0,0,0,0
20200316,706929,昇達科永豐94購03,,,,,,0.00,0,0,0,0,0,0,0,0,0,0,0,0,0
20200316,706930,穩懋永豐94購03,,,,,,0.00,0,0,0,0,0,0,0,0,0,0,0,0,0
20200316,706931,穩懋統一94購06,,,,,,0.00,0,0,0,0,0,0,0,0,0,0,0,0,0
20200316,706932,穩懋統一94購07,,,,,,0.00,0,0,0,0,0,0,0,0,0,0,0,0,0
20200316,706933,神盾中信97購01,0.02,0.02,0.01,0.01,-0.01,-50.0,340000,15,4400,0,0,0,0,0,0,0,100000,-100000,-100000
20200316,706934,環宇中信97購01,,,,,,0.00,0,0,0,0,0,0,0,0,0,0,0,0,0
20200316,706935,VHQ凱基96購01,,,,,,0.00,0,0,0,0,0,0,0,0,0,0,0,0,0
20200316,706936,台燿凱基96購01,0.27,0.28,0.27,0.28,-0.02,-6.67,20000,4,5460,0,0,0,0,0,0,20000,0,20000,20000
20200316,706937,宜鼎凱基96購01,,,,,,0.00,0,0,0,0,0,0,0,0,0,0,0,0,0
20200316,706938,原相凱基94購01,1.73,1.73,1.36,1.36,+0.23,20.35,27000,3,44170,0,0,0,0,0,0,17000,10000,7000,7000
20200316,706939,環球晶凱基94購11,0.60,0.63,0.51,0.51,-0.26,-33.77,50000,5,29850,0,0,0,0,0,0,50000,0,50000,50000
20200316,706940,穩懋凱基96購01,,,,,,0.00,0,0,0,0,0,0,0,0,0,0,0,0,0
20200316,706941,譜瑞凱基96購01,1.26,1.82,1.26,1.42,-0.09,-5.96,249000,23,392630,0,0,0,0,0,0,108000,164000,-56000,-56000
20200316,706942,大中國票96購01,,,,,,0.00,0,0,0,0,0,0,0,0,0,0,0,0,0
20200316,706943,中美晶國票94購03,,,,,,0.00,0,0,0,0,0,0,0,0,0,0,0,0,0
20200316,706944,美琪瑪國票94購02,,,,,,0.00,0,0,0,0,0,0,0,0,0,0,0,0,0
20200316,706945,碩禾國票96購01,0.20,0.20,0.20,0.20,-0.05,-20.0,20000,1,4000,0,0,0,0,0,0,0,0,0,0
20200316,706946,環球晶國票96購01,,,,,,0.00,0,0,0,0,0,0,0,0,0,0,0,0,0
20200316,706947,大田國泰96購01,,,,,,0.00,0,0,0,0,0,0,0,0,0,0,0,0,0
20200316,706948,穩懋國泰94購03,,,,,,0.00,0,0,0,0,0,0,0,0,0,0,0,0,0
20200316,706949,穩懋國泰94購04,,,,,,0.00,0,0,0,0,0,0,0,0,0,0,0,0,0
20200316,706950,雙鴻富邦96購01,,,,,,0.00,0,0,0,0,0,0,0,0,0,0,0,0,0
20200316,706951,新鉅科元富94購01,,,,,,0.00,0,0,0,0,0,0,0,0,0,0,0,0,0
20200316,706952,新鉅科元富96購01,,,,,,0.00,0,0,0,0,0,0,0,0,0,0,0,0,0
20200316,706953,精華元富94購01,,,,,,0.00,0,0,0,0,0,0,0,0,0,0,0,0,0
20200316,706954,環球晶元富94購07,,,,,,0.00,0,0,0,0,0,0,0,0,0,0,0,0,0
20200316,706955,穩懋台新94購01,,,,,,0.00,0,0,0,0,0,0,0,0,0,0,0,0,0
20200316,706956,原相群益96購03,,,,,,0.00,0,0,0,0,0,0,0,0,0,0,0,0,0
20200316,706957,群聯群益94購04,,,,,,0.00,0,0,0,0,0,0,0,0,0,0,0,0,0
20200316,706958,環球晶群益94購08,,,,,,0.00,0,0,0,0,0,0,0,0,0,0,0,0,0
20200316,706959,廣明元大94購02,,,,,,0.00,0,0,0,0,0,0,0,0,0,0,0,0,0
20200316,706960,雙鴻元大96購01,,,,,,0.00,0,0,0,0,0,0,0,0,0,0,0,0,0
20200316,706961,金可中信96購01,0.04,0.05,0.04,0.05,+0.02,66.67,315000,4,15700,0,0,0,0,0,0,315000,0,315000,315000
20200316,706962,勝麗中信97購01,0.27,0.27,0.27,0.27,+0.03,12.5,5000,1,1350,0,0,0,0,0,0,0,5000,-5000,-5000
20200316,706963,群聯中信97購01,0.22,0.22,0.20,0.20,0.00,0.0,14000,3,3000,0,0,0,0,0,0,0,0,0,0
20200316,706964,碩禾中信94購01,0.03,0.03,0.02,0.02,0.00,0.0,13000,3,380,0,0,0,0,0,0,0,13000,-13000,-13000
20200316,706965,群聯統一96購01,0.44,0.44,0.37,0.37,-0.37,-50.0,22000,2,8840,0,0,0,0,0,0,22000,0,22000,22000
20200316,706966,三貝德凱基96購01,,,,,,0.00,0,0,0,0,0,0,0,0,0,0,0,0,0
20200316,706967,由田凱基94購03,,,,,,0.00,0,0,0,0,0,0,0,0,0,0,0,0,0
20200316,706968,昇達科凱基94購02,,,,,,0.00,0,0,0,0,0,0,0,0,0,0,0,0,0
20200316,706969,信驊凱基96購01,1.10,1.30,0.95,0.97,-0.09,-8.49,419000,14,458670,0,0,0,0,0,0,324000,80000,244000,244000
20200316,706970,茂達凱基96購01,0.14,0.14,0.10,0.10,-0.04,-28.57,50000,5,6100,0,0,0,0,0,0,0,50000,-50000,-50000
20200316,706971,振曜凱基94購01,,,,,,0.00,0,0,0,0,0,0,0,0,0,0,0,0,0
20200316,706972,環球晶凱基94購12,0.46,0.46,0.24,0.24,-0.14,-36.84,40000,3,13200,0,0,0,0,0,0,10000,30000,-20000,-20000
20200316,706973,穩懋凱基96購02,0.02,0.02,0.02,0.02,-0.02,-50.0,99000,1,1980,0,0,0,0,0,0,99000,0,99000,99000
20200316,706974,穩懋富邦96購03,0.05,0.05,0.05,0.05,0.00,0.0,10000,1,500,0,0,0,0,0,0,0,0,0,0
20200316,706975,穩懋富邦96購04,,,,,,0.00,0,0,0,0,0,0,0,0,0,0,0,0,0
20200316,706976,大江國泰96購01,0.05,0.06,0.05,0.05,-0.01,-16.67,115000,8,6050,0,0,0,0,0,0,0,50000,-50000,-50000
20200316,706977,神盾國泰96購01,,,,,,0.00,0,0,0,0,0,0,0,0,0,0,0,0,0
20200316,706978,中美晶元富94購03,,,,,,0.00,0,0,0,0,0,0,0,0,0,0,0,0,0
20200316,706979,神盾元富94購02,,,,,,0.00,0,0,0,0,0,0,0,0,0,0,0,0,0
20200316,706980,環球晶元富94購08,,,,,,0.00,0,0,0,0,0,0,0,0,0,0,0,0,0
20200316,706981,中美晶台新94購02,0.29,0.31,0.29,0.31,+0.06,24.0,600000,2,178000,0,0,0,0,0,0,600000,0,600000,600000
20200316,706982,穩懋台新94購02,,,,,,0.00,0,0,0,0,0,0,0,0,0,0,0,0,0
20200316,706983,元太國票94購01,,,,,,0.00,0,0,0,0,0,0,0,0,0,0,0,0,0
20200316,706984,合晶國票96購01,,,,,,0.00,0,0,0,0,0,0,0,0,0,0,0,0,0
20200316,706985,建榮國票96購02,,,,,,0.00,0,0,0,0,0,0,0,0,0,0,0,0,0
20200316,706986,網家國票96購01,,,,,,0.00,0,0,0,0,0,0,0,0,0,0,0,0,0
20200316,706987,聯亞國票94購03,,,,,,0.00,0,0,0,0,0,0,0,0,0,0,0,0,0
20200316,706988,信昌電永豐94購04,,,,,,0.00,0,0,0,0,0,0,0,0,0,0,0,0,0
20200316,706989,博智永豐94購02,1.96,2.39,1.94,2.27,+0.24,11.82,409000,46,887490,0,0,0,0,0,0,254000,155000,99000,99000
20200316,706990,中美晶中信97購01,,,,,,0.00,0,0,0,0,0,0,0,0,0,0,0,0,0
20200316,706991,弘塑中信97購01,0.43,0.47,0.34,0.34,-0.11,-24.44,392000,21,166850,0,0,0,0,0,0,161000,231000,-70000,-70000
20200316,706992,神盾中信96購01,,,,,,0.00,0,0,0,0,0,0,0,0,0,0,0,0,0
20200316,706993,環球晶中信96購01,0.17,0.19,0.10,0.11,-0.11,-50.0,120000,10,15700,0,0,0,0,0,0,30000,90000,-60000,-60000
20200316,706994,譜瑞中信95購01,0.38,0.65,0.38,0.45,-0.05,-10.0,210000,15,105500,0,0,0,0,0,0,170000,20000,150000,150000
20200316,706995,弘塑統一96購01,0.57,0.57,0.57,0.57,-0.03,-5.0,10000,1,5700,0,0,0,0,0,0,0,10000,-10000,-10000
20200316,706996,群聯統一96購02,,,,,,0.00,0,0,0,0,0,0,0,0,0,0,0,0,0
20200316,706997,環球晶統一95購01,,,,,,0.00,0,0,0,0,0,0,0,0,0,0,0,0,0
20200316,706998,M31凱基95購01,,,,,,0.00,0,0,0,0,0,0,0,0,0,0,0,0,0
20200316,706999,中美晶凱基95購01,0.40,0.40,0.40,0.40,-0.07,-14.89,40000,1,16000,0,0,0,0,0,0,40000,0,40000,40000
20200316,707000,台燿凱基96購02,,,,,,0.00,0,0,0,0,0,0,0,0,0,0,0,0,0
20200316,707001,旺矽凱基95購01,,,,,,0.00,0,0,0,0,0,0,0,0,0,0,0,0,0
20200316,707002,昂寶凱基95購01,1.68,1.68,1.68,1.68,+0.56,50.0,40000,1,67200,0,0,0,0,0,0,40000,0,40000,40000
20200316,707003,神盾凱基96購01,,,,,,0.00,0,0,0,0,0,0,0,0,0,0,0,0,0
20200316,707004,廣明凱基95購01,,,,,,0.00,0,0,0,0,0,0,0,0,0,0,0,0,0
20200316,707005,環宇凱基95購01,,,,,,0.00,0,0,0,0,0,0,0,0,0,0,0,0,0
20200316,707006,環球晶凱基95購01,,,,,,0.00,0,0,0,0,0,0,0,0,0,0,0,0,0
20200316,707007,穩懋凱基95購01,,,,,,0.00,0,0,0,0,0,0,0,0,0,0,0,0,0
20200316,707008,神盾元富95購03,,,,,,0.00,0,0,0,0,0,0,0,0,0,0,0,0,0
20200316,707009,群聯元富95購01,,,,,,0.00,0,0,0,0,0,0,0,0,0,0,0,0,0
20200316,707010,聯亞元富95購01,0.45,0.45,0.45,0.45,+0.04,9.76,10000,1,4500,0,0,0,0,0,0,10000,0,10000,10000
20200316,707011,穩懋元富95購02,,,,,,0.00,0,0,0,0,0,0,0,0,0,0,0,0,0
20200316,707012,穩懋元富95購03,,,,,,0.00,0,0,0,0,0,0,0,0,0,0,0,0,0
20200316,707013,良維兆豐96購01,,,,,,0.00,0,0,0,0,0,0,0,0,0,0,0,0,0
20200316,707014,長科*康和95購01,,,,,,0.00,0,0,0,0,0,0,0,0,0,0,0,0,0
20200316,707015,應華康和95購01,,,,,,0.00,0,0,0,0,0,0,0,0,0,0,0,0,0
20200316,707016,大田元大95購01,,,,,,0.00,0,0,0,0,0,0,0,0,0,0,0,0,0
20200316,707017,弘塑元大95購01,0.45,0.46,0.20,0.21,-0.20,-48.78,242000,14,79500,0,0,0,0,0,0,122000,120000,2000,2000
20200316,707018,合晶元大96購02,,,,,,0.00,0,0,0,0,0,0,0,0,0,0,0,0,0
20200316,707019,金居元大96購01,0.14,0.16,0.14,0.16,+0.04,33.33,38000,3,5680,0,0,0,0,0,0,30000,8000,22000,22000
20200316,707020,信昌電元大96購02,0.30,0.30,0.16,0.16,-0.08,-33.33,90000,7,23700,0,0,0,0,0,0,50000,40000,10000,10000
20200316,707021,群聯元大95購05,0.79,0.79,0.52,0.52,+0.02,4.0,89000,17,53240,0,0,0,0,0,0,69000,23000,46000,46000
20200316,707022,譜瑞元大95購02,1.15,1.21,1.07,1.21,+0.27,28.72,22000,3,25740,0,0,0,0,0,0,2000,22000,-20000,-20000
20200316,707023,晟德元大95購01,,,,,,0.00,0,0,0,0,0,0,0,0,0,0,0,0,0
20200316,707024,由田國票96購01,,,,,,0.00,0,0,0,0,0,0,0,0,0,0,0,0,0
20200316,707025,杰力國票96購01,,,,,,0.00,0,0,0,0,0,0,0,0,0,0,0,0,0
20200316,707026,晶焱國票96購01,,,,,,0.00,0,0,0,0,0,0,0,0,0,0,0,0,0
20200316,707027,網龍國票96購01,,,,,,0.00,0,0,0,0,0,0,0,0,0,0,0,0,0
20200316,707028,優群國票95購02,,,,,,0.00,0,0,0,0,0,0,0,0,0,0,0,0,0
20200316,707029,大宇資國泰97購01,,,,,,0.00,0,0,0,0,0,0,0,0,0,0,0,0,0
20200316,707030,建榮國泰97購01,,,,,,0.00,0,0,0,0,0,0,0,0,0,0,0,0,0
20200316,707031,中美晶第一95購01,,,,,,0.00,0,0,0,0,0,0,0,0,0,0,0,0,0
20200316,707032,大江永豐95購01,,,,,,0.00,0,0,0,0,0,0,0,0,0,0,0,0,0
20200316,707033,中光電永豐95購01,,,,,,0.00,0,0,0,0,0,0,0,0,0,0,0,0,0
20200316,707034,中美晶永豐95購01,0.11,0.11,0.11,0.11,+0.06,120.0,10000,1,1100,0,0,0,0,0,0,0,10000,-10000,-10000
20200316,707035,弘塑永豐95購01,0.11,0.11,0.08,0.08,-0.09,-52.94,250000,13,23600,0,0,0,0,0,0,130000,120000,10000,10000
20200316,707036,環宇永豐95購01,,,,,,0.00,0,0,0,0,0,0,0,0,0,0,0,0,0
20200316,707037,晟德永豐95購01,,,,,,0.00,0,0,0,0,0,0,0,0,0,0,0,0,0
20200316,707038,譜瑞富邦97購01,0.65,0.72,0.61,0.61,+0.01,1.67,72000,11,47690,0,0,0,0,0,0,61000,13000,48000,48000
20200316,707039,良維中信95購01,,,,,,0.00,0,0,0,0,0,0,0,0,0,0,0,0,0
20200316,707040,台半凱基95購01,,,,,,0.00,0,0,0,0,0,0,0,0,0,0,0,0,0
20200316,707041,合晶凱基95購01,,,,,,0.00,0,0,0,0,0,0,0,0,0,0,0,0,0
20200316,707042,建榮凱基95購01,,,,,,0.00,0,0,0,0,0,0,0,0,0,0,0,0,0
20200316,707043,勝麗凱基95購01,,,,,,0.00,0,0,0,0,0,0,0,0,0,0,0,0,0
20200316,707044,晟德凱基95購01,,,,,,0.00,0,0,0,0,0,0,0,0,0,0,0,0,0
20200316,707045,VHQ元大95購01,,,,,,0.00,0,0,0,0,0,0,0,0,0,0,0,0,0
20200316,707046,大宇資元大97購01,0.09,0.09,0.09,0.09,-0.06,-40.0,6000,1,540,0,0,0,0,0,0,6000,0,6000,6000
20200316,707047,台半元大95購01,,,,,,0.00,0,0,0,0,0,0,0,0,0,0,0,0,0
20200316,707048,昇達科元大96購03,,,,,,0.00,0,0,0,0,0,0,0,0,0,0,0,0,0
20200316,707049,杰力元大96購02,,,,,,0.00,0,0,0,0,0,0,0,0,0,0,0,0,0
20200316,707050,信昌電元大96購03,0.17,0.17,0.17,0.17,+0.03,21.43,10000,3,1700,0,0,0,0,0,0,10000,0,10000,10000
20200316,707051,神盾元大97購01,0.02,0.02,0.02,0.02,-0.03,-60.0,23000,1,460,0,0,0,0,0,0,23000,0,23000,23000
20200316,707052,博智元大95購02,5.90,6.30,5.90,6.30,+2.00,46.51,12000,2,71600,0,0,0,0,0,0,10000,0,10000,10000
20200316,707053,群聯元大96購01,0.82,0.82,0.56,0.56,-0.26,-31.71,477000,50,314710,0,0,0,0,0,0,159000,459000,-300000,-300000
20200316,707054,合晶國泰97購01,,,,,,0.00,0,0,0,0,0,0,0,0,0,0,0,0,0
20200316,707055,大江國票96購01,,,,,,0.00,0,0,0,0,0,0,0,0,0,0,0,0,0
20200316,707056,台半國票96購01,,,,,,0.00,0,0,0,0,0,0,0,0,0,0,0,0,0
20200316,707057,弘塑國票95購01,0.58,0.58,0.27,0.30,-0.16,-34.78,235000,27,101980,0,0,0,0,0,0,114000,121000,-7000,-7000
20200316,707058,同致國票95購02,,,,,,0.00,0,0,0,0,0,0,0,0,0,0,0,0,0
20200316,707059,聚積國票95購01,,,,,,0.00,0,0,0,0,0,0,0,0,0,0,0,0,0
20200316,707060,廣明國票95購02,,,,,,0.00,0,0,0,0,0,0,0,0,0,0,0,0,0
20200316,707061,聯亞國票96購01,0.56,0.56,0.56,0.56,+0.05,9.8,10000,1,5600,0,0,0,0,0,0,10000,0,10000,10000
20200316,707062,精華富邦95購01,,,,,,0.00,0,0,0,0,0,0,0,0,0,0,0,0,0
20200316,707063,中美晶兆豐96購01,0.27,0.27,0.18,0.18,-0.07,-28.0,487000,8,112420,0,0,0,0,0,0,98000,389000,-291000,-291000
20200316,707064,弘塑康和95購01,0.35,0.37,0.19,0.19,-0.13,-40.62,80000,12,26220,0,0,0,0,0,0,50000,30000,20000,20000
20200316,707065,新普群益97購01,0.76,0.76,0.55,0.55,-0.34,-38.2,10000,2,6550,0,0,0,0,0,0,5000,5000,0,0
20200316,707066,精華群益95購01,,,,,,0.00,0,0,0,0,0,0,0,0,0,0,0,0,0
20200316,707067,精華群益95購02,,,,,,0.00,0,0,0,0,0,0,0,0,0,0,0,0,0
20200316,707068,譜瑞群益95購01,,,,,,0.00,0,0,0,0,0,0,0,0,0,0,0,0,0
20200316,707069,中美晶元富95購04,0.48,0.48,0.48,0.48,-0.02,-4.0,50000,1,24000,0,0,0,0,0,0,50000,0,50000,50000
20200316,707070,良維元富95購01,,,,,,0.00,0,0,0,0,0,0,0,0,0,0,0,0,0
20200316,707071,環球晶元富95購04,,,,,,0.00,0,0,0,0,0,0,0,0,0,0,0,0,0
20200316,707072,鈺太台新95購01,0.24,0.24,0.24,0.24,+0.06,33.33,45000,1,10800,0,0,0,0,0,0,0,45000,-45000,-45000
20200316,707073,台半永豐95購01,,,,,,0.00,0,0,0,0,0,0,0,0,0,0,0,0,0
20200316,707074,昂寶永豐96購01,1.06,1.06,1.06,1.06,+0.28,35.9,10000,1,10600,0,0,0,0,0,0,10000,0,10000,10000
20200316,707075,廣明永豐96購01,,,,,,0.00,0,0,0,0,0,0,0,0,0,0,0,0,0
20200316,707076,東洋中信95購01,0.02,0.02,0.01,0.01,-0.01,-50.0,400000,12,5000,0,0,0,0,0,0,0,100000,-100000,-100000
20200316,707077,精華中信97購01,0.02,0.02,0.02,0.02,0.00,0.0,5000,1,100,0,0,0,0,0,0,0,5000,-5000,-5000
20200316,707078,環宇中信97購02,,,,,,0.00,0,0,0,0,0,0,0,0,0,0,0,0,0
20200316,707079,晟德中信97購01,0.02,0.02,0.02,0.02,-0.02,-50.0,20000,2,400,0,0,0,0,0,0,0,20000,-20000,-20000
20200316,707080,弘塑統一98購01,0.30,0.35,0.27,0.28,-0.11,-28.21,909000,90,255770,0,0,0,0,0,0,54000,850000,-796000,-796000
20200316,707081,世界凱基95購01,1.44,1.44,1.07,1.07,-0.03,-2.73,172000,4,225060,0,0,0,0,0,0,104000,68000,36000,36000
20200316,707082,環球晶凱基95購04,,,,,,0.00,0,0,0,0,0,0,0,0,0,0,0,0,0
20200316,707083,大江元大96購02,,,,,,0.00,0,0,0,0,0,0,0,0,0,0,0,0,0
20200316,707084,原相元大97購01,4.20,4.54,3.58,3.58,-0.72,-16.74,65000,18,275460,0,0,0,0,0,0,63000,34000,29000,29000
20200316,707085,群聯元大96購02,0.73,0.88,0.50,0.50,-0.27,-35.06,267000,18,191790,0,0,0,0,0,0,137000,95000,42000,42000
20200316,707086,網龍元大95購01,,,,,,0.00,0,0,0,0,0,0,0,0,0,0,0,0,0
20200316,707087,環宇元大95購01,,,,,,0.00,0,0,0,0,0,0,0,0,0,0,0,0,0
20200316,707088,兆利永豐95購01,,,,,,0.00,0,0,0,0,0,0,0,0,0,0,0,0,0
20200316,707089,亞泰永豐95購01,,,,,,0.00,0,0,0,0,0,0,0,0,0,0,0,0,0
20200316,707090,順達永豐95購01,0.11,0.11,0.11,0.11,+0.03,37.5,104000,1,11440,0,0,0,0,0,0,104000,0,104000,104000
20200316,707091,緯軟永豐95購01,,,,,,0.00,0,0,0,0,0,0,0,0,0,0,0,0,0
20200316,707092,環宇永豐95購02,,,,,,0.00,0,0,0,0,0,0,0,0,0,0,0,0,0
20200316,707093,廣明國泰96購01,,,,,,0.00,0,0,0,0,0,0,0,0,0,0,0,0,0
20200316,707094,中美晶國票96購01,1.50,1.50,1.50,1.50,+0.20,15.38,50000,2,75000,0,0,0,0,0,0,50000,0,50000,50000
20200316,707095,宜鼎國票96購01,2.30,2.65,2.30,2.65,+0.67,33.84,30000,2,72500,0,0,0,0,0,0,20000,10000,10000,10000
20200316,707096,環宇國票95購01,,,,,,0.00,0,0,0,0,0,0,0,0,0,0,0,0,0
20200316,707097,穩懋國票96購02,,,,,,0.00,0,0,0,0,0,0,0,0,0,0,0,0,0
20200316,707098,台燿兆豐96購01,0.28,0.28,0.28,0.28,0.00,0.0,50000,5,14000,0,0,0,0,0,0,0,50000,-50000,-50000
20200316,707099,穩懋兆豐96購01,0.21,0.23,0.21,0.23,-0.08,-25.81,51000,2,10730,0,0,0,0,0,0,0,51000,-51000,-51000
20200316,707100,台半群益95購01,,,,,,0.00,0,0,0,0,0,0,0,0,0,0,0,0,0
20200316,707101,合晶群益95購01,,,,,,0.00,0,0,0,0,0,0,0,0,0,0,0,0,0
20200316,707102,原相群益96購04,,,,,,0.00,0,0,0,0,0,0,0,0,0,0,0,0,0
20200316,707103,合晶元富95購01,,,,,,0.00,0,0,0,0,0,0,0,0,0,0,0,0,0
20200316,707104,六角兆豐96購01,,,,,,0.00,0,0,0,0,0,0,0,0,0,0,0,0,0
20200316,707105,弘塑台新95購01,0.29,0.29,0.15,0.15,-0.03,-16.67,155000,10,37940,0,0,0,0,0,0,45000,110000,-65000,-65000
20200316,707106,原相台新97購01,,,,,,0.00,0,0,0,0,0,0,0,0,0,0,0,0,0
20200316,707107,聯亞台新95購01,,,,,,0.00,0,0,0,0,0,0,0,0,0,0,0,0,0
20200316,707108,新普群益97購02,0.60,0.60,0.60,0.60,+0.21,53.85,10000,1,6000,0,0,0,0,0,0,10000,0,10000,10000
20200316,707109,環宇群益97購01,0.03,0.03,0.03,0.03,-0.01,-25.0,100000,3,3000,0,0,0,0,0,0,0,100000,-100000,-100000
20200316,707110,環球晶群益95購01,,,,,,0.00,0,0,0,0,0,0,0,0,0,0,0,0,0
20200316,707111,元太元大95購02,,,,,,0.00,0,0,0,0,0,0,0,0,0,0,0,0,0
20200316,707112,台燿元大95購01,,,,,,0.00,0,0,0,0,0,0,0,0,0,0,0,0,0
20200316,707113,金居元大96購02,0.07,0.07,0.06,0.06,-0.01,-14.29,20000,2,1300,0,0,0,0,0,0,0,20000,-20000,-20000
20200316,707114,建榮元大96購01,,,,,,0.00,0,0,0,0,0,0,0,0,0,0,0,0,0
20200316,707115,神準元大95購01,,,,,,0.00,0,0,0,0,0,0,0,0,0,0,0,0,0
20200316,707116,環宇元大95購02,,,,,,0.00,0,0,0,0,0,0,0,0,0,0,0,0,0
20200316,707117,聯亞元大96購01,0.34,0.34,0.31,0.31,+0.08,34.78,15000,2,4800,0,0,0,0,0,0,15000,0,15000,15000
20200316,707118,穩懋元大95購02,,,,,,0.00,0,0,0,0,0,0,0,0,0,0,0,0,0
20200316,707119,群聯凱基95購01,,,,,,0.00,0,0,0,0,0,0,0,0,0,0,0,0,0
20200316,707120,環球晶凱基95購06,,,,,,0.00,0,0,0,0,0,0,0,0,0,0,0,0,0
20200316,707121,大江國票97購01,,,,,,0.00,0,0,0,0,0,0,0,0,0,0,0,0,0
20200316,707122,昂寶國票96購01,,,,,,0.00,0,0,0,0,0,0,0,0,0,0,0,0,0
20200316,707123,保瑞國票96購01,1.17,1.17,0.74,0.74,-0.16,-17.78,94000,8,84400,0,0,0,0,0,0,72000,22000,50000,50000
20200316,707124,環宇國泰96購01,,,,,,0.00,0,0,0,0,0,0,0,0,0,0,0,0,0
20200316,707125,環球晶國泰96購01,1.08,1.12,0.72,0.78,-0.35,-30.97,233000,8,211610,0,0,0,0,0,0,105000,128000,-23000,-23000
20200316,707126,久元永豐95購01,0.41,0.41,0.40,0.40,-0.08,-16.67,15000,2,6100,0,0,0,0,0,0,0,15000,-15000,-15000
20200316,707127,弘塑永豐95購02,,,,,,0.00,0,0,0,0,0,0,0,0,0,0,0,0,0
20200316,707128,神準永豐95購01,,,,,,0.00,0,0,0,0,0,0,0,0,0,0,0,0,0
20200316,707129,穩懋永豐95購02,,,,,,0.00,0,0,0,0,0,0,0,0,0,0,0,0,0
20200316,707130,合晶元富95購02,,,,,,0.00,0,0,0,0,0,0,0,0,0,0,0,0,0
20200316,707131,金居台新95購01,,,,,,0.00,0,0,0,0,0,0,0,0,0,0,0,0,0
20200316,707132,晟德國泰96購01,,,,,,0.00,0,0,0,0,0,0,0,0,0,0,0,0,0
20200316,707133,中光電群益96購01,,,,,,0.00,0,0,0,0,0,0,0,0,0,0,0,0,0
20200316,707134,元太群益96購01,,,,,,0.00,0,0,0,0,0,0,0,0,0,0,0,0,0
20200316,707135,原相群益97購03,,,,,,0.00,0,0,0,0,0,0,0,0,0,0,0,0,0
20200316,707136,群聯群益97購01,0.24,0.24,0.24,0.24,+0.09,60.0,40000,1,9600,0,0,0,0,0,0,40000,0,40000,40000
20200316,707137,VHQ永豐95購01,,,,,,0.00,0,0,0,0,0,0,0,0,0,0,0,0,0
20200316,707138,大宇資永豐95購01,,,,,,0.00,0,0,0,0,0,0,0,0,0,0,0,0,0
20200316,707139,台星科永豐95購01,,,,,,0.00,0,0,0,0,0,0,0,0,0,0,0,0,0
20200316,707140,立端永豐95購01,,,,,,0.00,0,0,0,0,0,0,0,0,0,0,0,0,0
20200316,707141,合晶永豐95購02,,,,,,0.00,0,0,0,0,0,0,0,0,0,0,0,0,0
20200316,707142,直得永豐95購01,0.33,0.33,0.20,0.20,-0.11,-35.48,55000,4,15350,0,0,0,0,0,0,35000,20000,15000,15000
20200316,707143,精華永豐95購01,,,,,,0.00,0,0,0,0,0,0,0,0,0,0,0,0,0
20200316,707144,璟德永豐95購01,0.36,0.36,0.26,0.26,-0.14,-35.0,51000,4,17920,0,0,0,0,0,0,37000,14000,23000,23000
20200316,707145,環球晶永豐95購01,,,,,,0.00,0,0,0,0,0,0,0,0,0,0,0,0,0
20200316,707146,群聯凱基95購02,0.02,0.02,0.02,0.02,-0.09,-81.82,100000,1,2000,0,0,0,0,0,0,100000,0,100000,100000
20200316,707147,大江元大96購03,,,,,,0.00,0,0,0,0,0,0,0,0,0,0,0,0,0
20200316,707148,金可元大95購01,,,,,,0.00,0,0,0,0,0,0,0,0,0,0,0,0,0
20200316,707149,群聯元大96購03,,,,,,0.00,0,0,0,0,0,0,0,0,0,0,0,0,0
20200316,707150,網家元大95購01,,,,,,0.00,0,0,0,0,0,0,0,0,0,0,0,0,0
20200316,707151,環球晶元大95購04,,,,,,0.00,0,0,0,0,0,0,0,0,0,0,0,0,0
20200316,707152,環球晶元大95購05,0.32,0.32,0.15,0.15,-0.06,-28.57,120000,13,26350,0,0,0,0,0,0,0,120000,-120000,-120000
20200316,707153,櫃200元大95購01,0.01,0.01,0.01,0.01,-0.01,-50.0,1000,1,10,0,0,0,0,0,0,1000,0,1000,1000
20200316,707154,雙鴻元大97購02,0.04,0.06,0.04,0.06,+0.02,50.0,21000,2,860,0,0,0,0,0,0,20000,0,20000,20000
20200316,707155,大宇資元富95購01,,,,,,0.00,0,0,0,0,0,0,0,0,0,0,0,0,0
20200316,707156,昂寶元富95購01,1.84,1.84,1.84,1.84,+0.58,46.03,143000,1,263120,0,0,0,0,0,0,143000,0,143000,143000
20200316,707157,同致兆豐96購01,,,,,,0.00,0,0,0,0,0,0,0,0,0,0,0,0,0
20200316,707158,威剛兆豐96購01,0.80,0.84,0.53,0.56,-0.15,-21.13,220000,10,155450,0,0,0,0,0,0,50000,170000,-120000,-120000
20200316,707159,網龍兆豐96購01,0.04,0.04,0.04,0.04,+0.01,33.33,5000,1,200,0,0,0,0,0,0,0,5000,-5000,-5000
20200316,707160,環球晶群益95購02,0.15,0.15,0.15,0.15,-0.11,-42.31,30000,1,4500,0,0,0,0,0,0,0,30000,-30000,-30000
20200316,707161,元太國票96購01,,,,,,0.00,0,0,0,0,0,0,0,0,0,0,0,0,0
20200316,707162,旺矽國票96購01,,,,,,0.00,0,0,0,0,0,0,0,0,0,0,0,0,0
20200316,707163,信昌電國票96購01,,,,,,0.00,0,0,0,0,0,0,0,0,0,0,0,0,0
20200316,707164,宣德國票96購01,0.45,0.45,0.45,0.45,-0.22,-32.84,20000,2,9000,0,0,0,0,0,0,0,20000,-20000,-20000
20200316,707165,聚積國票96購01,,,,,,0.00,0,0,0,0,0,0,0,0,0,0,0,0,0
20200316,707166,譜瑞國票96購01,0.59,0.75,0.51,0.75,+0.13,20.97,424000,13,262160,0,0,0,0,0,0,404000,0,404000,404000
20200316,707167,中美晶國泰96購01,,,,,,0.00,0,0,0,0,0,0,0,0,0,0,0,0,0
20200316,707168,群聯國泰97購01,0.44,0.44,0.40,0.40,-0.13,-24.53,50000,2,21600,0,0,0,0,0,0,40000,0,40000,40000
20200316,707169,群聯富邦96購01,0.10,0.10,0.09,0.10,-0.02,-16.67,50000,5,4900,0,0,0,0,0,0,0,50000,-50000,-50000
20200316,707170,環宇富邦97購01,,,,,,0.00,0,0,0,0,0,0,0,0,0,0,0,0,0
20200316,707171,弘塑中信99購01,0.32,0.32,0.23,0.23,-0.02,-8.0,35000,5,9250,0,0,0,0,0,0,10000,25000,-15000,-15000
20200316,707172,環球晶中信99購01,0.18,0.20,0.11,0.11,-0.10,-47.62,1239000,79,189870,0,0,0,0,0,0,338000,405000,-67000,-67000
20200316,707173,鈺太中信96購01,0.16,0.22,0.15,0.19,+0.05,35.71,155000,12,28550,0,0,0,0,0,0,20000,135000,-115000,-115000
20200316,707174,凡甲凱基96購01,0.27,0.27,0.23,0.23,+0.04,21.05,35000,2,9050,0,0,0,0,0,0,35000,0,35000,35000
20200316,707175,大江凱基96購01,,,,,,0.00,0,0,0,0,0,0,0,0,0,0,0,0,0
20200316,707176,中美晶凱基95購02,0.15,0.15,0.10,0.10,-0.05,-33.33,63000,4,8300,0,0,0,0,0,0,40000,23000,17000,17000
20200316,707177,合晶凱基95購02,,,,,,0.00,0,0,0,0,0,0,0,0,0,0,0,0,0
20200316,707178,威剛凱基97購01,0.88,0.90,0.54,0.54,-0.24,-30.77,184000,16,137880,0,0,0,0,0,0,62000,82000,-20000,-20000
20200316,707179,神盾凱基95購01,,,,,,0.00,0,0,0,0,0,0,0,0,0,0,0,0,0
20200316,707180,新鉅科凱基95購01,,,,,,0.00,0,0,0,0,0,0,0,0,0,0,0,0,0
20200316,707181,由田永豐95購01,0.09,0.09,0.05,0.05,-0.08,-61.54,120000,6,8000,0,0,0,0,0,0,70000,50000,20000,20000
20200316,707182,同致永豐95購01,,,,,,0.00,0,0,0,0,0,0,0,0,0,0,0,0,0
20200316,707183,良維永豐95購02,,,,,,0.00,0,0,0,0,0,0,0,0,0,0,0,0,0
20200316,707184,昇達科永豐95購01,,,,,,0.00,0,0,0,0,0,0,0,0,0,0,0,0,0
20200316,707185,杰力永豐95購01,,,,,,0.00,0,0,0,0,0,0,0,0,0,0,0,0,0
20200316,707186,金可永豐95購01,,,,,,0.00,0,0,0,0,0,0,0,0,0,0,0,0,0
20200316,707187,中美晶元大95購04,0.29,0.29,0.27,0.27,-0.03,-10.0,100000,6,28000,0,0,0,0,0,0,50000,50000,0,0
20200316,707188,六角元大95購01,0.07,0.07,0.07,0.07,0.00,0.0,20000,1,1400,0,0,0,0,0,0,20000,0,20000,20000
20200316,707189,美琪瑪元大96購01,,,,,,0.00,0,0,0,0,0,0,0,0,0,0,0,0,0
20200316,707190,神盾元大96購02,0.08,0.08,0.08,0.08,0.00,0.0,5000,1,400,0,0,0,0,0,0,0,5000,-5000,-5000
20200316,707191,穩懋元大95購04,0.06,0.06,0.06,0.06,+0.01,20.0,300000,30,18000,0,0,0,0,0,0,0,300000,-300000,-300000
20200316,707192,穩懋元大95購06,,,,,,0.00,0,0,0,0,0,0,0,0,0,0,0,0,0
20200316,707193,穩懋元大95購07,,,,,,0.00,0,0,0,0,0,0,0,0,0,0,0,0,0
20200316,707194,廣明兆豐95購01,,,,,,0.00,0,0,0,0,0,0,0,0,0,0,0,0,0
20200316,707195,弘塑群益95購01,,,,,,0.00,0,0,0,0,0,0,0,0,0,0,0,0,0
20200316,707196,閎康群益96購01,,,,,,0.00,0,0,0,0,0,0,0,0,0,0,0,0,0
20200316,707197,順達群益96購01,,,,,,0.00,0,0,0,0,0,0,0,0,0,0,0,0,0
20200316,707198,VHQ國票96購01,0.04,0.04,0.04,0.04,-0.01,-20.0,10000,1,400,0,0,0,0,0,0,10000,0,10000,10000
20200316,707199,新鉅科國票95購01,,,,,,0.00,0,0,0,0,0,0,0,0,0,0,0,0,0
20200316,707200,網龍國票97購01,0.04,0.04,0.04,0.04,0.00,0.0,10000,1,400,0,0,0,0,0,0,10000,0,10000,10000
20200316,707201,環球晶國票96購02,0.23,0.23,0.18,0.18,-0.23,-56.1,75000,2,16000,0,0,0,0,0,0,75000,0,75000,75000
20200316,707202,聯亞國票96購02,0.42,0.42,0.42,0.42,+0.04,10.53,8000,2,3360,0,0,0,0,0,0,8000,0,8000,8000
20200316,707203,晟德國票95購01,,,,,,0.00,0,0,0,0,0,0,0,0,0,0,0,0,0
20200316,707204,弘塑麥證95購01,,,,,,0.00,0,0,0,0,0,0,0,0,0,0,0,0,0
20200316,707205,大田元大95購02,,,,,,0.00,0,0,0,0,0,0,0,0,0,0,0,0,0
20200316,707206,六角元大95購02,0.12,0.12,0.10,0.10,0.00,0.0,235000,15,26200,0,0,0,0,0,0,100000,135000,-35000,-35000
20200316,707207,宇峻元大97購01,0.44,0.53,0.42,0.42,+0.04,10.53,246000,22,115140,0,0,0,0,0,0,90000,156000,-66000,-66000
20200316,707208,東洋元大95購01,,,,,,0.00,0,0,0,0,0,0,0,0,0,0,0,0,0
20200316,707209,環球晶元大95購06,1.05,1.05,1.02,1.02,+0.08,8.51,40000,2,41700,0,0,0,0,0,0,40000,0,40000,40000
20200316,707210,聯亞元大95購03,0.72,0.72,0.70,0.70,+0.30,75.0,12000,2,8440,0,0,0,0,0,0,2000,10000,-8000,-8000
20200316,707211,晟德元大95購02,,,,,,0.00,0,0,0,0,0,0,0,0,0,0,0,0,0
20200316,707212,鈺太元大95購01,0.31,0.44,0.31,0.44,+0.14,46.67,48000,6,16480,0,0,0,0,0,0,16000,32000,-16000,-16000
20200316,707213,順達統一97購01,0.66,0.67,0.64,0.66,+0.10,17.86,11000,4,7220,0,0,0,0,0,0,11000,0,11000,11000
20200316,707214,六角永豐95購01,,,,,,0.00,0,0,0,0,0,0,0,0,0,0,0,0,0
20200316,707215,晶焱永豐95購01,,,,,,0.00,0,0,0,0,0,0,0,0,0,0,0,0,0
20200316,707216,順達永豐95購02,,,,,,0.00,0,0,0,0,0,0,0,0,0,0,0,0,0
20200316,707217,聯亞永豐95購01,,,,,,0.00,0,0,0,0,0,0,0,0,0,0,0,0,0
20200316,707218,鐿鈦永豐95購01,,,,,,0.00,0,0,0,0,0,0,0,0,0,0,0,0,0
20200316,707219,弘塑凱基95購01,0.06,0.06,0.06,0.06,-0.04,-40.0,210000,4,12600,0,0,0,0,0,0,10000,0,10000,10000
20200316,707220,合晶凱基95購03,,,,,,0.00,0,0,0,0,0,0,0,0,0,0,0,0,0
20200316,707221,原相凱基95購02,,,,,,0.00,0,0,0,0,0,0,0,0,0,0,0,0,0
20200316,707222,群聯凱基95購03,,,,,,0.00,0,0,0,0,0,0,0,0,0,0,0,0,0
20200316,707223,緯軟凱基95購01,,,,,,0.00,0,0,0,0,0,0,0,0,0,0,0,0,0
20200316,707224,環球晶凱基95購09,,,,,,0.00,0,0,0,0,0,0,0,0,0,0,0,0,0
20200316,707225,中美晶元富95購06,0.33,0.33,0.31,0.31,+0.03,10.71,432000,3,142320,0,0,0,0,0,0,422000,12000,410000,410000
20200316,707226,精華元富95購01,,,,,,0.00,0,0,0,0,0,0,0,0,0,0,0,0,0
20200316,707227,環球晶元富95購05,,,,,,0.00,0,0,0,0,0,0,0,0,0,0,0,0,0
20200316,707228,穩懋元富95購05,,,,,,0.00,0,0,0,0,0,0,0,0,0,0,0,0,0
20200316,707229,穩懋元富95購06,,,,,,0.00,0,0,0,0,0,0,0,0,0,0,0,0,0
20200316,707230,M31台新95購01,,,,,,0.00,0,0,0,0,0,0,0,0,0,0,0,0,0
20200316,707231,大宇資康和95購01,,,,,,0.00,0,0,0,0,0,0,0,0,0,0,0,0,0
20200316,707232,大學光群益95購01,0.38,0.38,0.38,0.38,-0.25,-39.68,99000,4,37620,0,0,0,0,0,0,0,99000,-99000,-99000
20200316,707233,迅得群益97購01,,,,,,0.00,0,0,0,0,0,0,0,0,0,0,0,0,0
20200316,707234,勝麗群益95購01,,,,,,0.00,0,0,0,0,0,0,0,0,0,0,0,0,0
20200316,707235,群聯群益96購02,0.23,0.23,0.23,0.23,-0.18,-43.9,80000,1,18400,0,0,0,0,0,0,80000,0,80000,80000
20200316,707236,聚積群益97購01,0.18,0.18,0.18,0.18,-0.06,-25.0,30000,1,5400,0,0,0,0,0,0,30000,0,30000,30000
20200316,707237,雙美麥證95購01,,,,,,0.00,0,0,0,0,0,0,0,0,0,0,0,0,0
20200316,707238,合晶元富95購03,,,,,,0.00,0,0,0,0,0,0,0,0,0,0,0,0,0
20200316,707239,金可元富95購01,,,,,,0.00,0,0,0,0,0,0,0,0,0,0,0,0,0
20200316,707240,昂寶國票97購01,4.06,4.06,4.01,4.01,+0.99,32.78,105000,3,422800,0,0,0,0,0,0,105000,0,105000,105000
20200316,707241,昇達科國票96購01,0.10,0.10,0.08,0.09,-0.03,-25.0,129000,13,11210,0,0,0,0,0,0,0,129000,-129000,-129000
20200316,707242,信驊國票96購01,3.13,3.13,2.02,2.02,-0.18,-8.18,52000,6,136500,0,0,0,0,0,0,22000,30000,-8000,-8000
20200316,707243,新普國票96購01,,,,,,0.00,0,0,0,0,0,0,0,0,0,0,0,0,0
20200316,707244,精華國票96購01,,,,,,0.00,0,0,0,0,0,0,0,0,0,0,0,0,0
20200316,707245,大江元大95購04,,,,,,0.00,0,0,0,0,0,0,0,0,0,0,0,0,0
20200316,707246,弘塑元大96購01,0.40,0.44,0.24,0.25,-0.15,-37.5,415000,42,120210,0,0,0,0,0,0,276000,365000,-89000,-89000
20200316,707247,安勤元大95購01,0.20,0.20,0.13,0.13,-0.01,-7.14,287000,25,47510,0,0,0,0,0,0,47000,240000,-193000,-193000
20200316,707248,建榮元大96購02,,,,,,0.00,0,0,0,0,0,0,0,0,0,0,0,0,0
20200316,707249,群聯元大95購06,,,,,,0.00,0,0,0,0,0,0,0,0,0,0,0,0,0
20200316,707250,環球晶元大95購07,1.10,1.10,0.86,0.86,-0.03,-3.37,66000,7,67600,0,0,0,0,0,0,46000,20000,26000,26000
20200316,707251,環球晶元大95購08,0.66,0.66,0.36,0.36,-0.25,-40.98,28000,3,17980,0,0,0,0,0,0,17000,11000,6000,6000
20200316,707252,鐿鈦元大96購01,,,,,,0.00,0,0,0,0,0,0,0,0,0,0,0,0,0
20200316,707253,穩懋亞東96購02,,,,,,0.00,0,0,0,0,0,0,0,0,0,0,0,0,0
20200316,707254,同致中信97購01,,,,,,0.00,0,0,0,0,0,0,0,0,0,0,0,0,0
20200316,707255,環球晶凱基95購10,0.28,0.28,0.13,0.13,-0.23,-63.89,44000,5,11720,0,0,0,0,0,0,4000,30000,-26000,-26000
20200316,707256,環球晶凱基95購11,1.05,1.05,1.05,1.05,-0.15,-12.5,10000,2,10500,0,0,0,0,0,0,10000,10000,0,0
20200316,707257,兆利永豐95購02,,,,,,0.00,0,0,0,0,0,0,0,0,0,0,0,0,0
20200316,707258,信昌電永豐95購01,,,,,,0.00,0,0,0,0,0,0,0,0,0,0,0,0,0
20200316,707259,信驊永豐95購01,0.78,0.83,0.55,0.55,-0.14,-20.29,196000,11,111280,0,0,0,0,0,0,10000,186000,-176000,-176000
20200316,707260,新揚科永豐95購02,,,,,,0.00,0,0,0,0,0,0,0,0,0,0,0,0,0
20200316,707261,新普永豐95購01,,,,,,0.00,0,0,0,0,0,0,0,0,0,0,0,0,0
20200316,707262,大宇資凱基97購01,,,,,,0.00,0,0,0,0,0,0,0,0,0,0,0,0,0
20200316,707263,神盾凱基96購02,0.10,0.10,0.10,0.10,0.00,0.0,14000,2,1400,0,0,0,0,0,0,0,14000,-14000,-14000
20200316,707264,網家凱基95購02,,,,,,0.00,0,0,0,0,0,0,0,0,0,0,0,0,0
20200316,707265,環球晶凱基95購12,0.53,0.53,0.48,0.49,-0.06,-10.91,900000,3,450000,0,0,0,0,0,0,0,900000,-900000,-900000
20200316,707266,宇峻永豐95購01,0.28,0.28,0.28,0.28,0.00,0.0,15000,1,4200,0,0,0,0,0,0,0,15000,-15000,-15000
20200316,707267,邦特永豐95購01,,,,,,0.00,0,0,0,0,0,0,0,0,0,0,0,0,0
20200316,707268,皇田永豐95購01,,,,,,0.00,0,0,0,0,0,0,0,0,0,0,0,0,0
20200316,707269,原相永豐95購02,1.07,1.20,1.04,1.04,-0.11,-9.57,421000,48,471110,0,0,0,0,0,0,391000,14000,377000,377000
20200316,707270,神盾永豐95購01,,,,,,0.00,0,0,0,0,0,0,0,0,0,0,0,0,0
20200316,707271,勝麗永豐95購01,,,,,,0.00,0,0,0,0,0,0,0,0,0,0,0,0,0
20200316,707272,廣明永豐95購01,,,,,,0.00,0,0,0,0,0,0,0,0,0,0,0,0,0
20200316,707273,環球晶永豐95購02,0.22,0.22,0.18,0.18,-0.08,-30.77,34000,3,6240,0,0,0,0,0,0,0,34000,-34000,-34000
20200316,707274,雙鴻永豐95購05,0.05,0.05,0.02,0.02,-0.03,-60.0,23000,2,760,0,0,0,0,0,0,13000,10000,3000,3000
20200316,707275,元太元大96購01,,,,,,0.00,0,0,0,0,0,0,0,0,0,0,0,0,0
20200316,707276,皇田元大95購01,,,,,,0.00,0,0,0,0,0,0,0,0,0,0,0,0,0
20200316,707277,神盾元大97購02,0.15,0.15,0.09,0.09,-0.06,-40.0,920000,93,114500,0,0,0,0,0,0,0,920000,-920000,-920000
20200316,707278,勝麗元大96購01,0.39,0.40,0.29,0.30,-0.08,-21.05,104000,7,38440,0,0,0,0,0,0,70000,34000,36000,36000
20200316,707279,新鉅科元大95購01,0.02,0.02,0.02,0.02,+0.01,100.0,26000,13,520,0,0,0,0,0,0,0,0,0,0
20200316,707280,碩禾元大96購01,0.24,0.24,0.19,0.19,-0.40,-67.8,154000,4,33010,0,0,0,0,0,0,144000,10000,134000,134000
20200316,707281,精華元大95購02,0.09,0.09,0.09,0.09,+0.01,12.5,25000,1,2250,0,0,0,0,0,0,25000,0,25000,25000
20200316,707282,環球晶元大95購09,0.86,0.87,0.72,0.72,-0.13,-15.29,14000,3,11780,0,0,0,0,0,0,12000,2000,10000,10000
20200316,707283,環球晶元大95購10,0.82,0.82,0.82,0.82,+0.01,1.23,30000,1,24600,0,0,0,0,0,0,30000,0,30000,30000
20200316,707284,晟德元大95購03,,,,,,0.00,0,0,0,0,0,0,0,0,0,0,0,0,0
20200316,707285,弘塑國泰97購01,0.75,0.75,0.75,0.75,0.00,0.0,5000,1,3750,0,0,0,0,0,0,0,0,0,0
20200316,707286,信昌電富邦95購01,,,,,,0.00,0,0,0,0,0,0,0,0,0,0,0,0,0
20200316,707287,同致國票96購01,,,,,,0.00,0,0,0,0,0,0,0,0,0,0,0,0,0
20200316,707288,良維國票97購01,,,,,,0.00,0,0,0,0,0,0,0,0,0,0,0,0,0
20200316,707289,緯軟國票97購01,,,,,,0.00,0,0,0,0,0,0,0,0,0,0,0,0,0
20200316,707290,優群國票96購01,1.76,1.76,1.57,1.67,+0.30,21.9,130000,5,223700,0,0,0,0,0,0,130000,0,130000,130000
20200316,707291,元太兆豐95購02,,,,,,0.00,0,0,0,0,0,0,0,0,0,0,0,0,0
20200316,707292,金可兆豐95購02,,,,,,0.00,0,0,0,0,0,0,0,0,0,0,0,0,0
20200316,707293,泰博兆豐96購01,,,,,,0.00,0,0,0,0,0,0,0,0,0,0,0,0,0
20200316,707294,VHQ群益96購01,,,,,,0.00,0,0,0,0,0,0,0,0,0,0,0,0,0
20200316,707295,邦特群益95購01,,,,,,0.00,0,0,0,0,0,0,0,0,0,0,0,0,0
20200316,707296,鈺太群益95購01,0.62,0.62,0.62,0.62,+0.20,47.62,100000,2,62000,0,0,0,0,0,0,100000,0,100000,100000
20200316,707297,台燿凱基96購03,0.27,0.29,0.25,0.25,-0.07,-21.88,23000,4,6410,0,0,0,0,0,0,23000,0,23000,23000
20200316,707298,晶焱凱基95購01,,,,,,0.00,0,0,0,0,0,0,0,0,0,0,0,0,0
20200316,707299,緯軟中信95購01,,,,,,0.00,0,0,0,0,0,0,0,0,0,0,0,0,0
20200316,707300,雙鴻麥證95購01,,,,,,0.00,0,0,0,0,0,0,0,0,0,0,0,0,0
20200316,707301,中美晶元富95購07,0.90,0.92,0.81,0.82,-0.12,-12.77,150000,6,125400,0,0,0,0,0,0,110000,50000,60000,60000
20200316,707302,原相亞東96購01,2.43,2.56,2.19,2.19,-0.31,-12.4,287000,47,705450,0,0,0,0,0,0,284000,3000,281000,281000
20200316,707303,群聯亞東95購01,0.09,0.09,0.09,0.09,-0.03,-25.0,30000,2,2700,0,0,0,0,0,0,0,30000,-30000,-30000
20200316,707304,杰力永豐95購02,,,,,,0.00,0,0,0,0,0,0,0,0,0,0,0,0,0
20200316,707305,波若威永豐95購02,,,,,,0.00,0,0,0,0,0,0,0,0,0,0,0,0,0
20200316,707306,保瑞永豐95購01,,,,,,0.00,0,0,0,0,0,0,0,0,0,0,0,0,0
20200316,707307,智崴永豐95購01,,,,,,0.00,0,0,0,0,0,0,0,0,0,0,0,0,0
20200316,707308,聯亞永豐95購02,,,,,,0.00,0,0,0,0,0,0,0,0,0,0,0,0,0
20200316,707309,合晶國票96購02,,,,,,0.00,0,0,0,0,0,0,0,0,0,0,0,0,0
20200316,707310,原相國票96購01,4.49,4.49,4.19,4.19,+0.05,1.21,56000,19,243160,0,0,0,0,0,0,56000,0,56000,56000
20200316,707311,昂寶國泰96購01,,,,,,0.00,0,0,0,0,0,0,0,0,0,0,0,0,0
20200316,707312,宣德兆豐95購01,0.88,0.88,0.75,0.75,-0.20,-21.05,13000,2,10140,0,0,0,0,0,0,0,13000,-13000,-13000
20200316,707313,智崴群益95購01,,,,,,0.00,0,0,0,0,0,0,0,0,0,0,0,0,0
20200316,707314,廣明群益95購01,,,,,,0.00,0,0,0,0,0,0,0,0,0,0,0,0,0
20200316,707315,大江元大96購04,,,,,,0.00,0,0,0,0,0,0,0,0,0,0,0,0,0
20200316,707316,同致元大96購01,,,,,,0.00,0,0,0,0,0,0,0,0,0,0,0,0,0
20200316,707317,良維元大95購02,,,,,,0.00,0,0,0,0,0,0,0,0,0,0,0,0,0
20200316,707318,金可元大95購02,0.01,0.01,0.01,0.01,-0.01,-50.0,300000,1,3000,0,0,0,0,0,0,300000,0,300000,300000
20200316,707319,信驊元大95購01,2.12,2.12,2.12,2.12,+0.64,43.24,10000,1,21200,0,0,0,0,0,0,0,10000,-10000,-10000
20200316,707320,智崴元大95購01,0.02,0.02,0.02,0.02,-0.04,-66.67,3000,1,60,0,0,0,0,0,0,3000,0,3000,3000
20200316,707321,智崴元大95購02,,,,,,0.00,0,0,0,0,0,0,0,0,0,0,0,0,0
20200316,707322,新普元大95購01,,,,,,0.00,0,0,0,0,0,0,0,0,0,0,0,0,0
20200316,707323,環宇元大96購01,0.18,0.19,0.10,0.10,-0.08,-44.44,191000,15,33340,0,0,0,0,0,0,71000,191000,-120000,-120000
20200316,707324,櫃200永昌96購04,,,,,,0.00,0,0,0,0,0,0,0,0,0,0,0,0,0
20200316,707325,M31中信96購01,,,,,,0.00,0,0,0,0,0,0,0,0,0,0,0,0,0
20200316,707326,穩懋中信97購01,0.44,0.44,0.44,0.44,+0.19,76.0,1000,1,440,0,0,0,0,0,0,1000,0,1000,1000
20200316,707327,鐿鈦中信95購01,,,,,,0.00,0,0,0,0,0,0,0,0,0,0,0,0,0
20200316,707328,中美晶凱基96購01,0.78,0.85,0.77,0.78,0.00,0.0,1395000,19,1103290,0,0,0,0,0,0,840000,518000,322000,322000
20200316,707329,環球晶凱基95購13,0.38,0.38,0.38,0.38,+0.18,90.0,10000,1,3800,0,0,0,0,0,0,0,10000,-10000,-10000
20200316,707330,原相第一95購01,,,,,,0.00,0,0,0,0,0,0,0,0,0,0,0,0,0
20200316,707331,中美晶永豐95購03,1.01,1.14,0.98,0.98,-0.15,-13.27,113000,6,127290,0,0,0,0,0,0,103000,20000,83000,83000
20200316,707332,亞泰永豐95購02,,,,,,0.00,0,0,0,0,0,0,0,0,0,0,0,0,0
20200316,707333,大江國票96購04,,,,,,0.00,0,0,0,0,0,0,0,0,0,0,0,0,0
20200316,707334,合晶國票97購01,,,,,,0.00,0,0,0,0,0,0,0,0,0,0,0,0,0
20200316,707335,勝麗國票97購01,0.39,0.39,0.33,0.33,-0.03,-8.33,25000,3,9030,0,0,0,0,0,0,13000,12000,1000,1000
20200316,707336,群聯國票96購01,1.20,1.20,1.18,1.18,+0.24,25.53,47000,2,56220,0,0,0,0,0,0,47000,0,47000,47000
20200316,707337,網龍國票97購02,,,,,,0.00,0,0,0,0,0,0,0,0,0,0,0,0,0
20200316,707338,環球晶國票96購03,1.28,1.30,1.20,1.20,-0.11,-8.4,100000,3,126600,0,0,0,0,0,0,100000,0,100000,100000
20200316,707339,晟德國票97購01,,,,,,0.00,0,0,0,0,0,0,0,0,0,0,0,0,0
20200316,707340,神盾國泰97購01,0.19,0.19,0.19,0.19,+0.01,5.56,42000,1,7980,0,0,0,0,0,0,0,42000,-42000,-42000
20200316,707341,博智國泰97購01,,,,,,0.00,0,0,0,0,0,0,0,0,0,0,0,0,0
20200316,707342,原相富邦99購01,2.04,2.04,1.53,1.53,-0.54,-26.09,72000,13,121520,0,0,0,0,0,0,16000,56000,-40000,-40000
20200316,707343,聯亞兆豐96購01,0.81,0.81,0.61,0.61,+0.12,24.49,160000,3,109000,0,0,0,0,0,0,100000,60000,40000,40000
20200316,707344,杰力群益95購01,,,,,,0.00,0,0,0,0,0,0,0,0,0,0,0,0,0
20200316,707345,宣德群益96購01,,,,,,0.00,0,0,0,0,0,0,0,0,0,0,0,0,0
20200316,707346,皇田群益97購01,,,,,,0.00,0,0,0,0,0,0,0,0,0,0,0,0,0
20200316,707347,金居元大96購03,0.18,0.18,0.15,0.15,-0.01,-6.25,176000,9,28200,0,0,0,0,0,0,152000,32000,120000,120000
20200316,707348,保瑞元大96購01,0.34,0.34,0.22,0.22,-0.08,-26.67,151000,8,46420,0,0,0,0,0,0,91000,40000,51000,51000
20200316,707349,茂達元大96購01,,,,,,0.00,0,0,0,0,0,0,0,0,0,0,0,0,0
20200316,707350,優群元大96購01,2.23,2.52,2.05,2.05,-0.01,-0.49,61000,11,147410,0,0,0,0,0,0,45000,10000,35000,35000
20200316,707351,環球晶元大96購01,1.11,1.19,0.80,0.80,-0.27,-25.23,127000,12,135630,0,0,0,0,0,0,67000,50000,17000,17000
20200316,707352,櫃200元大96購03,,,,,,0.00,0,0,0,0,0,0,0,0,0,0,0,0,0
20200316,707353,櫃200元大96購04,,,,,,0.00,0,0,0,0,0,0,0,0,0,0,0,0,0
20200316,707354,昇達科中信97購01,,,,,,0.00,0,0,0,0,0,0,0,0,0,0,0,0,0
20200316,707355,群聯凱基95購04,0.05,0.05,0.05,0.05,-0.05,-50.0,2000,1,100,0,0,0,0,0,0,0,0,0,0
20200316,707356,精華凱基95購01,,,,,,0.00,0,0,0,0,0,0,0,0,0,0,0,0,0
20200316,707357,大江國票97購02,,,,,,0.00,0,0,0,0,0,0,0,0,0,0,0,0,0
20200316,707358,昂寶永豐95購01,1.57,1.57,1.57,1.57,+0.35,28.69,20000,1,31400,0,0,0,0,0,0,20000,0,20000,20000
20200316,707359,宣德永豐95購01,0.89,0.90,0.53,0.53,-0.14,-20.9,110000,8,97400,0,0,0,0,0,0,49000,61000,-12000,-12000
20200316,707360,環球晶永豐95購03,,,,,,0.00,0,0,0,0,0,0,0,0,0,0,0,0,0
20200316,707361,元太元大96購02,0.22,0.23,0.14,0.14,-0.07,-33.33,192000,12,35910,0,0,0,0,0,0,131000,92000,39000,39000
20200316,707362,兆利元大95購01,0.51,0.51,0.48,0.48,+0.09,23.08,35000,3,17550,0,0,0,0,0,0,25000,10000,15000,15000
20200316,707363,合晶元大96購03,0.35,0.35,0.30,0.30,-0.01,-3.23,20000,2,6500,0,0,0,0,0,0,10000,20000,-10000,-10000
20200316,707364,邦特元大95購01,,,,,,0.00,0,0,0,0,0,0,0,0,0,0,0,0,0
20200316,707365,群聯元大97購01,,,,,,0.00,0,0,0,0,0,0,0,0,0,0,0,0,0
20200316,707366,廣明元大96購01,0.07,0.07,0.07,0.07,0.00,0.0,350000,4,24500,0,0,0,0,0,0,350000,0,350000,350000
20200316,707367,環球晶元大95購12,1.43,1.48,1.43,1.48,+0.10,7.25,28000,2,40940,0,0,0,0,0,0,28000,0,28000,28000
20200316,707368,茂達永豐96購01,,,,,,0.00,0,0,0,0,0,0,0,0,0,0,0,0,0
20200316,707369,原相永豐95購03,0.59,0.63,0.41,0.43,-0.18,-29.51,581000,54,298210,0,0,0,0,0,0,296000,251000,45000,45000
20200316,707370,杰力國票96購02,,,,,,0.00,0,0,0,0,0,0,0,0,0,0,0,0,0
20200316,707371,大江富邦97購01,,,,,,0.00,0,0,0,0,0,0,0,0,0,0,0,0,0
20200316,707372,原相凱基96購01,0.62,0.70,0.40,0.40,-0.16,-28.57,130000,22,66220,0,0,0,0,0,0,18000,98000,-80000,-80000
20200316,707373,新普凱基95購01,,,,,,0.00,0,0,0,0,0,0,0,0,0,0,0,0,0
20200316,707374,緯軟凱基95購02,,,,,,0.00,0,0,0,0,0,0,0,0,0,0,0,0,0
20200316,707375,聯亞凱基95購01,0.07,0.07,0.07,0.07,-0.03,-30.0,200000,1,14000,0,0,0,0,0,0,200000,0,200000,200000
20200316,707376,雙鴻凱基96購03,,,,,,0.00,0,0,0,0,0,0,0,0,0,0,0,0,0
20200316,707377,群聯麥證95購01,,,,,,0.00,0,0,0,0,0,0,0,0,0,0,0,0,0
20200316,707378,原相元富95購02,1.57,1.57,1.57,1.57,-0.30,-16.04,10000,1,15700,0,0,0,0,0,0,10000,0,10000,10000
20200316,707379,優群元富95購01,,,,,,0.00,0,0,0,0,0,0,0,0,0,0,0,0,0
20200316,707380,環球晶元富95購06,0.84,0.84,0.67,0.67,-0.03,-4.29,8000,2,5870,0,0,0,0,0,0,5000,3000,2000,2000
20200316,707381,兆利台新95購01,0.15,0.15,0.15,0.15,-0.04,-21.05,50000,1,7500,0,0,0,0,0,0,50000,0,50000,50000
20200316,707382,僑威台新95購01,,,,,,0.00,0,0,0,0,0,0,0,0,0,0,0,0,0
20200316,707383,先豐元大95購01,0.10,0.10,0.07,0.07,-0.07,-50.0,105000,12,9500,0,0,0,0,0,0,0,81000,-81000,-81000
20200316,707384,皇田元大95購02,,,,,,0.00,0,0,0,0,0,0,0,0,0,0,0,0,0
20200316,707385,晶焱元大96購01,1.38,1.46,1.38,1.46,+0.03,2.1,2000,2,2840,0,0,0,0,0,0,1000,1000,0,0
20200316,707386,僑威元大95購01,,,,,,0.00,0,0,0,0,0,0,0,0,0,0,0,0,0
20200316,707387,網龍元大95購02,,,,,,0.00,0,0,0,0,0,0,0,0,0,0,0,0,0
20200316,707388,鐿鈦元大95購01,,,,,,0.00,0,0,0,0,0,0,0,0,0,0,0,0,0
20200316,707389,業強康和95購01,,,,,,0.00,0,0,0,0,0,0,0,0,0,0,0,0,0
20200316,707390,環球晶元富95購07,0.68,0.68,0.68,0.68,0.00,0.0,2000,1,1360,0,0,0,0,0,0,2000,0,2000,2000
20200316,707391,順達台新95購01,,,,,,0.00,0,0,0,0,0,0,0,0,0,0,0,0,0
20200316,707392,大江凱基95購01,,,,,,0.00,0,0,0,0,0,0,0,0,0,0,0,0,0
20200316,707393,同致凱基95購01,,,,,,0.00,0,0,0,0,0,0,0,0,0,0,0,0,0
20200316,707394,聯亞凱基95購02,,,,,,0.00,0,0,0,0,0,0,0,0,0,0,0,0,0
20200316,707395,大宇資群益97購01,,,,,,0.00,0,0,0,0,0,0,0,0,0,0,0,0,0
20200316,707396,亞泰群益95購01,,,,,,0.00,0,0,0,0,0,0,0,0,0,0,0,0,0
20200316,707397,聯亞群益95購01,0.65,0.65,0.65,0.65,+0.29,80.56,40000,1,26000,0,0,0,0,0,0,40000,0,40000,40000
20200316,707398,亞泰元大95購01,,,,,,0.00,0,0,0,0,0,0,0,0,0,0,0,0,0
20200316,707399,信驊元大95購02,2.29,2.29,2.01,2.01,+0.52,34.9,5000,3,10860,0,0,0,0,0,0,4000,1000,3000,3000
20200316,707400,威剛元大96購02,0.95,1.01,0.68,0.68,-0.29,-29.9,759000,50,610940,0,0,0,0,0,0,559000,385000,174000,174000
20200316,707401,聯亞元大95購04,,,,,,0.00,0,0,0,0,0,0,0,0,0,0,0,0,0
20200316,707402,大宇資永豐96購01,0.16,0.16,0.16,0.16,0.00,0.0,1000,1,160,0,0,0,0,0,0,0,1000,-1000,-1000
20200316,707403,旺矽永豐96購01,0.36,0.36,0.36,0.36,+0.05,16.13,1000,1,360,0,0,0,0,0,0,1000,0,1000,1000
20200316,707404,信驊永豐95購02,0.53,0.53,0.39,0.39,+0.07,21.88,159000,10,62810,0,0,0,0,0,0,5000,154000,-149000,-149000
20200316,707405,優群永豐96購01,0.98,1.07,0.88,0.88,-0.09,-9.28,209000,17,204360,0,0,0,0,0,0,35000,164000,-129000,-129000
20200316,707406,M31國票96購01,,,,,,0.00,0,0,0,0,0,0,0,0,0,0,0,0,0
20200316,707407,中美晶國票96購03,1.49,1.49,1.49,1.49,-0.17,-10.24,68000,2,101320,0,0,0,0,0,0,68000,0,68000,68000
20200316,707408,兆利國票96購01,,,,,,0.00,0,0,0,0,0,0,0,0,0,0,0,0,0
20200316,707409,環球晶國票95購03,0.58,0.58,0.58,0.58,-0.14,-19.44,50000,1,29000,0,0,0,0,0,0,50000,0,50000,50000
20200316,707410,雙美國票96購01,,,,,,0.00,0,0,0,0,0,0,0,0,0,0,0,0,0
20200316,707411,金居富邦95購02,,,,,,0.00,0,0,0,0,0,0,0,0,0,0,0,0,0
20200316,707412,櫃200富邦95購01,0.09,0.09,0.09,0.09,-0.01,-10.0,1000,1,90,0,0,0,0,0,0,0,0,0,0
20200316,707413,櫃200富邦95購02,0.02,0.02,0.02,0.02,+0.01,100.0,1000,1,20,0,0,0,0,0,0,0,0,0,0
20200316,707414,櫃200富邦95購03,,,,,,0.00,0,0,0,0,0,0,0,0,0,0,0,0,0
20200316,707415,櫃200T永昌96購01,,,,,,0.00,0,0,0,0,0,0,0,0,0,0,0,0,0
20200316,707416,櫃200T永昌96購02,,,,,,0.00,0,0,0,0,0,0,0,0,0,0,0,0,0
20200316,707417,櫃200T永昌96購03,,,,,,0.00,0,0,0,0,0,0,0,0,0,0,0,0,0
20200316,707418,櫃200T永昌96購04,,,,,,0.00,0,0,0,0,0,0,0,0,0,0,0,0,0
20200316,707419,台燿凱基95購01,,,,,,0.00,0,0,0,0,0,0,0,0,0,0,0,0,0
20200316,707420,信驊凱基95購02,0.31,0.31,0.31,0.31,-0.02,-6.06,88000,1,27280,0,0,0,0,0,0,0,88000,-88000,-88000
20200316,707421,緯軟凱基96購01,,,,,,0.00,0,0,0,0,0,0,0,0,0,0,0,0,0
20200316,707422,櫃200凱基99購01,0.19,0.21,0.18,0.18,+0.07,63.64,612000,18,114340,0,0,0,0,0,0,112000,500000,-388000,-388000
20200316,707423,三貝德國票96購02,,,,,,0.00,0,0,0,0,0,0,0,0,0,0,0,0,0
20200316,707424,大學光國票96購02,0.98,0.98,0.76,0.76,-0.09,-10.59,35000,5,29980,0,0,0,0,0,0,35000,0,35000,35000
20200316,707425,台燿國票96購01,,,,,,0.00,0,0,0,0,0,0,0,0,0,0,0,0,0
20200316,707426,穩懋國票96購03,0.19,0.19,0.10,0.10,-0.02,-16.67,420000,33,59800,0,0,0,0,0,0,100000,320000,-220000,-220000
20200316,707427,新普國泰96購01,0.71,0.71,0.47,0.47,-0.26,-35.62,82000,3,46220,0,0,0,0,0,0,32000,50000,-18000,-18000
20200316,707428,譜瑞國泰97購01,1.31,1.44,1.24,1.44,+0.10,7.46,551000,9,786750,0,0,0,0,0,0,551000,37000,514000,514000
20200316,707429,信驊元富95購01,1.95,1.95,1.94,1.94,+0.11,6.01,20000,2,38900,0,0,0,0,0,0,20000,0,20000,20000
20200316,707430,信驊元富95購02,1.36,1.39,1.30,1.33,+0.21,18.75,401000,9,528830,0,0,0,0,0,0,401000,0,401000,401000
20200316,707431,雙鴻元富95購01,,,,,,0.00,0,0,0,0,0,0,0,0,0,0,0,0,0
20200316,707432,雙鴻台新96購01,,,,,,0.00,0,0,0,0,0,0,0,0,0,0,0,0,0
20200316,707433,新普元大95購02,,,,,,0.00,0,0,0,0,0,0,0,0,0,0,0,0,0
20200316,707434,環球晶元大96購02,1.89,1.93,1.31,1.31,-0.74,-36.1,161000,20,285860,0,0,0,0,0,0,83000,88000,-5000,-5000
20200316,707435,雙鴻元大95購02,0.05,0.06,0.03,0.03,-0.03,-50.0,67000,4,3160,0,0,0,0,0,0,56000,11000,45000,45000
20200316,707436,譜瑞元大95購04,0.85,0.85,0.82,0.82,+0.26,46.43,45000,2,37050,0,0,0,0,0,0,45000,5000,40000,40000
20200316,707437,群聯兆豐96購01,0.49,0.50,0.34,0.35,-0.16,-31.37,1109000,31,471120,0,0,0,0,0,0,573000,636000,-63000,-63000
20200316,707438,環球晶兆豐95購05,0.88,0.88,0.76,0.76,+0.11,16.92,52000,4,42360,0,0,0,0,0,0,22000,30000,-8000,-8000
20200316,707439,台燿群益95購01,0.25,0.28,0.25,0.28,-0.04,-12.5,61000,2,16780,0,0,0,0,0,0,61000,0,61000,61000
20200316,707440,昇達科群益97購01,,,,,,0.00,0,0,0,0,0,0,0,0,0,0,0,0,0
20200316,707441,晶焱群益96購01,,,,,,0.00,0,0,0,0,0,0,0,0,0,0,0,0,0
20200316,707442,櫃200富邦9A購01,0.26,0.26,0.26,0.26,-0.05,-16.13,3000,3,780,0,0,0,0,0,0,0,3000,-3000,-3000
20200316,707443,櫃200富邦9A購02,,,,,,0.00,0,0,0,0,0,0,0,0,0,0,0,0,0
20200316,707444,雙鴻富邦96購02,,,,,,0.00,0,0,0,0,0,0,0,0,0,0,0,0,0
20200316,707445,雙鴻第一95購01,,,,,,0.00,0,0,0,0,0,0,0,0,0,0,0,0,0
20200316,707446,大江永豐95購02,,,,,,0.00,0,0,0,0,0,0,0,0,0,0,0,0,0
20200316,707447,宜鼎永豐95購01,0.47,0.47,0.47,0.47,+0.19,67.86,27000,1,12690,0,0,0,0,0,0,0,27000,-27000,-27000
20200316,707448,保瑞永豐95購02,0.61,0.61,0.57,0.57,+0.08,16.33,16000,2,9520,0,0,0,0,0,0,10000,6000,4000,4000
20200316,707449,群聯永豐95購01,0.22,0.22,0.22,0.22,+0.03,15.79,100000,1,22000,0,0,0,0,0,0,100000,100000,0,0
20200316,707450,大江中信96購01,,,,,,0.00,0,0,0,0,0,0,0,0,0,0,0,0,0
20200316,707451,大江台新95購01,,,,,,0.00,0,0,0,0,0,0,0,0,0,0,0,0,0
20200316,707452,兆利元大96購01,0.27,0.27,0.24,0.24,-0.03,-11.11,30000,3,7800,0,0,0,0,0,0,20000,10000,10000,10000
20200316,707453,迅得元大95購02,,,,,,0.00,0,0,0,0,0,0,0,0,0,0,0,0,0
20200316,707454,博智元大95購03,3.18,3.18,3.18,3.18,+1.21,61.42,20000,1,63600,0,0,0,0,0,0,20000,0,20000,20000
20200316,707455,神盾康和95購01,,,,,,0.00,0,0,0,0,0,0,0,0,0,0,0,0,0
20200316,707456,勝麗群益95購02,0.23,0.23,0.12,0.12,-0.07,-36.84,90000,8,15750,0,0,0,0,0,0,40000,50000,-10000,-10000
20200316,707457,緯軟群益96購01,0.09,0.09,0.09,0.09,-0.01,-10.0,30000,1,2700,0,0,0,0,0,0,0,30000,-30000,-30000
20200316,707458,金居統一95購01,0.18,0.20,0.18,0.20,-0.09,-31.03,25000,2,4800,0,0,0,0,0,0,25000,0,25000,25000
20200316,707459,迅得凱基98購01,,,,,,0.00,0,0,0,0,0,0,0,0,0,0,0,0,0
20200316,707460,邦特凱基95購01,,,,,,0.00,0,0,0,0,0,0,0,0,0,0,0,0,0
20200316,707461,信昌電凱基97購01,0.47,0.49,0.47,0.49,+0.09,22.5,65000,5,31650,0,0,0,0,0,0,15000,50000,-35000,-35000
20200316,707462,茂達凱基9B購01,0.54,0.54,0.42,0.42,-0.07,-14.29,210000,4,95700,0,0,0,0,0,0,60000,150000,-90000,-90000
20200316,707463,神盾凱基9B購01,0.44,0.44,0.33,0.33,-0.11,-25.0,12000,2,4180,0,0,0,0,0,0,0,12000,-12000,-12000
20200316,707464,勝麗凱基97購01,0.26,0.26,0.19,0.19,-0.06,-24.0,90000,7,21950,0,0,0,0,0,0,0,90000,-90000,-90000
20200316,707465,閎康凱基97購01,0.21,0.21,0.21,0.21,+0.02,10.53,100000,1,21000,0,0,0,0,0,0,100000,0,100000,100000
20200316,707466,環宇凱基97購01,0.18,0.18,0.18,0.18,+0.02,12.5,10000,1,1800,0,0,0,0,0,0,10000,0,10000,10000
20200316,707467,環球晶凱基96購01,1.23,1.23,0.63,0.63,-0.66,-51.16,16000,4,12360,0,0,0,0,0,0,1000,15000,-14000,-14000
20200316,707468,穩懋凱基96購03,,,,,,0.00,0,0,0,0,0,0,0,0,0,0,0,0,0
20200316,707469,鈺太凱基97購01,0.30,0.43,0.30,0.35,+0.07,25.0,364000,20,133830,0,0,0,0,0,0,0,364000,-364000,-364000
20200316,707470,鐿鈦凱基96購01,,,,,,0.00,0,0,0,0,0,0,0,0,0,0,0,0,0
20200316,707471,信昌電國票96購02,0.35,0.35,0.28,0.28,-0.17,-37.78,204000,2,57400,0,0,0,0,0,0,204000,204000,0,0
20200316,707472,晶焱國票96購02,0.45,0.45,0.45,0.45,-0.08,-15.09,8000,1,3600,0,0,0,0,0,0,8000,0,8000,8000
20200316,707473,群聯國票96購02,0.66,0.66,0.45,0.46,+0.02,4.55,158000,4,74180,0,0,0,0,0,0,158000,10000,148000,148000
20200316,707474,穩懋富邦97購01,0.30,0.50,0.20,0.22,-0.06,-21.43,1484000,71,402580,0,0,0,0,0,0,325000,925000,-600000,-600000
20200316,707475,光洋科永豐95購01,0.20,0.20,0.16,0.16,-0.07,-30.43,129000,8,25580,0,0,0,0,0,0,79000,50000,29000,29000
20200316,707476,穩懋永豐95購03,,,,,,0.00,0,0,0,0,0,0,0,0,0,0,0,0,0
20200316,707477,網龍中信95購01,,,,,,0.00,0,0,0,0,0,0,0,0,0,0,0,0,0
20200316,707478,中美晶凱基95購03,1.13,1.13,1.13,1.13,-0.01,-0.88,10000,1,11300,0,0,0,0,0,0,10000,10000,0,0
20200316,707479,晶焱凱基96購01,,,,,,0.00,0,0,0,0,0,0,0,0,0,0,0,0,0
20200316,707480,環球晶凱基97購01,0.68,0.68,0.41,0.41,-0.31,-43.06,40000,4,21990,0,0,0,0,0,0,18000,22000,-4000,-4000
20200316,707481,三貝德永豐95購01,,,,,,0.00,0,0,0,0,0,0,0,0,0,0,0,0,0
20200316,707482,神盾永豐95購02,,,,,,0.00,0,0,0,0,0,0,0,0,0,0,0,0,0
20200316,707483,環球晶永豐95購04,1.10,1.10,0.73,0.73,-0.46,-38.66,114000,10,113700,0,0,0,0,0,0,62000,47000,15000,15000
20200316,707484,大江元大96購05,0.02,0.02,0.02,0.02,0.00,0.0,1000000,9,20000,0,0,0,0,0,0,1000000,0,1000000,1000000
20200316,707485,同致元大97購01,,,,,,0.00,0,0,0,0,0,0,0,0,0,0,0,0,0
20200316,707486,昂寶元大95購01,,,,,,0.00,0,0,0,0,0,0,0,0,0,0,0,0,0
20200316,707487,迅得國票96購01,,,,,,0.00,0,0,0,0,0,0,0,0,0,0,0,0,0
20200316,707488,宜鼎國票96購02,1.75,2.01,1.69,1.78,+0.14,8.54,169000,14,308510,0,0,0,0,0,0,59000,110000,-51000,-51000
20200316,707489,美琪瑪國票96購01,,,,,,0.00,0,0,0,0,0,0,0,0,0,0,0,0,0
20200316,707490,智崴國泰96購01,,,,,,0.00,0,0,0,0,0,0,0,0,0,0,0,0,0
20200316,707491,櫃200T永昌9C購01,,,,,,0.00,0,0,0,0,0,0,0,0,0,0,0,0,0
20200316,707492,櫃200T永昌9C購02,,,,,,0.00,0,0,0,0,0,0,0,0,0,0,0,0,0
20200316,707493,櫃200T永昌9C購03,,,,,,0.00,0,0,0,0,0,0,0,0,0,0,0,0,0
20200316,707494,櫃200T永昌9C購04,,,,,,0.00,0,0,0,0,0,0,0,0,0,0,0,0,0
20200316,707495,穩懋康和95購02,,,,,,0.00,0,0,0,0,0,0,0,0,0,0,0,0,0
20200316,707496,精華群益95購03,,,,,,0.00,0,0,0,0,0,0,0,0,0,0,0,0,0
20200316,707497,宜鼎元大95購02,0.77,0.81,0.70,0.70,-0.08,-10.26,66000,4,50720,0,0,0,0,0,0,46000,20000,26000,26000
20200316,707498,旺矽元大96購01,0.45,0.45,0.34,0.35,-0.05,-12.5,113000,14,45440,0,0,0,0,0,0,0,113000,-113000,-113000
20200316,707499,精華元大95購03,,,,,,0.00,0,0,0,0,0,0,0,0,0,0,0,0,0
20200316,707500,智崴國票96購01,,,,,,0.00,0,0,0,0,0,0,0,0,0,0,0,0,0
20200316,707501,閎康國票97購01,,,,,,0.00,0,0,0,0,0,0,0,0,0,0,0,0,0
20200316,707502,金可國泰97購01,0.08,0.08,0.08,0.08,-0.02,-20.0,100000,1,8000,0,0,0,0,0,0,100000,0,100000,100000
20200316,707503,精華國泰97購01,,,,,,0.00,0,0,0,0,0,0,0,0,0,0,0,0,0
20200316,707504,環球晶國泰96購03,1.63,1.79,1.13,1.13,-0.69,-37.91,156000,10,249380,0,0,0,0,0,0,151000,36000,115000,115000
20200316,707505,穩懋國泰96購02,0.36,0.40,0.25,0.25,-0.12,-32.43,259000,10,92710,0,0,0,0,0,0,0,259000,-259000,-259000
20200316,707506,穩懋統一96購05,,,,,,0.00,0,0,0,0,0,0,0,0,0,0,0,0,0
20200316,707507,三貝德凱基96購02,,,,,,0.00,0,0,0,0,0,0,0,0,0,0,0,0,0
20200316,707508,中美晶凱基95購04,1.85,1.85,1.80,1.82,+0.11,6.43,33000,3,59490,0,0,0,0,0,0,33000,2000,31000,31000
20200316,707509,元太凱基96購01,,,,,,0.00,0,0,0,0,0,0,0,0,0,0,0,0,0
20200316,707510,昂寶凱基96購01,1.38,1.38,1.38,1.38,+0.45,48.39,30000,1,41400,0,0,0,0,0,0,30000,0,30000,30000
20200316,707511,建榮凱基97購01,,,,,,0.00,0,0,0,0,0,0,0,0,0,0,0,0,0
20200316,707512,穩懋凱基96購04,0.13,0.13,0.11,0.11,-0.01,-8.33,85000,3,10400,0,0,0,0,0,0,30000,55000,-25000,-25000
20200316,707513,元太第一95購01,,,,,,0.00,0,0,0,0,0,0,0,0,0,0,0,0,0
20200316,707514,晶焱永豐95購02,,,,,,0.00,0,0,0,0,0,0,0,0,0,0,0,0,0
20200316,707515,精華永豐95購02,,,,,,0.00,0,0,0,0,0,0,0,0,0,0,0,0,0
20200316,707516,聚積永豐95購01,,,,,,0.00,0,0,0,0,0,0,0,0,0,0,0,0,0
20200316,707517,穩懋兆豐96購02,0.17,0.17,0.12,0.12,-0.07,-36.84,337000,7,51690,0,0,0,0,0,0,127000,210000,-83000,-83000
20200316,707518,金可康和95購01,,,,,,0.00,0,0,0,0,0,0,0,0,0,0,0,0,0
20200316,707519,金可群益95購01,,,,,,0.00,0,0,0,0,0,0,0,0,0,0,0,0,0
20200316,707520,優群群益97購01,,,,,,0.00,0,0,0,0,0,0,0,0,0,0,0,0,0
20200316,707521,環球晶群益95購04,,,,,,0.00,0,0,0,0,0,0,0,0,0,0,0,0,0
20200316,707522,聯亞群益95購02,0.91,0.91,0.91,0.91,+0.31,51.67,5000,2,4550,0,0,0,0,0,0,5000,0,5000,5000
20200316,707523,群聯元富95購02,,,,,,0.00,0,0,0,0,0,0,0,0,0,0,0,0,0
20200316,707524,鈺太兆豐95購01,0.26,0.31,0.26,0.31,+0.07,29.17,208000,7,61380,0,0,0,0,0,0,0,208000,-208000,-208000
20200316,707525,泰博中信97購01,0.63,0.76,0.60,0.64,+0.05,8.47,491000,50,334400,0,0,0,0,0,0,140000,300000,-160000,-160000
20200316,707526,建榮凱基96購01,,,,,,0.00,0,0,0,0,0,0,0,0,0,0,0,0,0
20200316,707527,新普凱基95購02,,,,,,0.00,0,0,0,0,0,0,0,0,0,0,0,0,0
20200316,707528,精華凱基96購01,,,,,,0.00,0,0,0,0,0,0,0,0,0,0,0,0,0
20200316,707529,精華統一97購01,,,,,,0.00,0,0,0,0,0,0,0,0,0,0,0,0,0
20200316,707530,精華統一97購02,0.06,0.06,0.06,0.06,-0.03,-33.33,170000,3,10200,0,0,0,0,0,0,170000,0,170000,170000
20200316,707531,神盾國票97購01,0.10,0.10,0.10,0.10,-0.02,-16.67,5000,1,500,0,0,0,0,0,0,5000,0,5000,5000
20200316,707532,群聯國票96購03,0.62,0.62,0.62,0.62,-0.07,-10.14,100000,1,62000,0,0,0,0,0,0,100000,0,100000,100000
20200316,707533,緯軟國票97購02,,,,,,0.00,0,0,0,0,0,0,0,0,0,0,0,0,0
20200316,707534,碩禾元大98購01,0.50,0.50,0.33,0.33,-0.17,-34.0,110000,11,47200,0,0,0,0,0,0,0,110000,-110000,-110000
20200316,707535,精華元大96購01,0.07,0.07,0.07,0.07,+0.02,40.0,3000,1,210,0,0,0,0,0,0,3000,0,3000,3000
20200316,707536,穩懋元大95購12,,,,,,0.00,0,0,0,0,0,0,0,0,0,0,0,0,0
20200316,707537,穩懋元大95購13,0.33,0.33,0.33,0.33,+0.15,83.33,35000,1,11550,0,0,0,0,0,0,35000,0,35000,35000
20200316,707538,世界永豐95購01,,,,,,0.00,0,0,0,0,0,0,0,0,0,0,0,0,0
20200316,707539,合晶永豐95購03,,,,,,0.00,0,0,0,0,0,0,0,0,0,0,0,0,0
20200316,707540,宇峻永豐95購02,,,,,,0.00,0,0,0,0,0,0,0,0,0,0,0,0,0
20200316,707541,佳邦永豐95購01,,,,,,0.00,0,0,0,0,0,0,0,0,0,0,0,0,0
20200316,707542,金居永豐95購01,,,,,,0.00,0,0,0,0,0,0,0,0,0,0,0,0,0
20200316,707543,泰博永豐95購01,0.61,0.70,0.55,0.55,+0.01,1.85,553000,34,350330,0,0,0,0,0,0,188000,365000,-177000,-177000
20200316,707544,勝麗永豐95購02,,,,,,0.00,0,0,0,0,0,0,0,0,0,0,0,0,0
20200316,707545,晟德永豐95購02,,,,,,0.00,0,0,0,0,0,0,0,0,0,0,0,0,0
20200316,707546,台半亞東96購01,0.26,0.26,0.26,0.26,-0.20,-43.48,10000,1,2600,0,0,0,0,0,0,10000,0,10000,10000
20200316,707547,世界中信96購01,0.72,0.74,0.72,0.73,-0.03,-3.95,30000,3,21900,0,0,0,0,0,0,30000,0,30000,30000
20200316,707548,精測中信95購01,0.07,0.07,0.06,0.06,0.00,0.0,829000,8,52040,0,0,0,0,0,0,829000,0,829000,829000
20200316,707549,精測凱基96購01,0.36,0.36,0.28,0.28,+0.05,21.74,73000,3,24440,0,0,0,0,0,0,73000,0,73000,73000
20200316,707550,聯亞凱基95購03,,,,,,0.00,0,0,0,0,0,0,0,0,0,0,0,0,0
20200316,707551,穩懋凱基95購03,,,,,,0.00,0,0,0,0,0,0,0,0,0,0,0,0,0
20200316,707552,精測統一96購01,,,,,,0.00,0,0,0,0,0,0,0,0,0,0,0,0,0
20200316,707553,安勤永豐95購01,,,,,,0.00,0,0,0,0,0,0,0,0,0,0,0,0,0
20200316,707554,金可永豐95購02,,,,,,0.00,0,0,0,0,0,0,0,0,0,0,0,0,0
20200316,707555,宣德永豐95購03,,,,,,0.00,0,0,0,0,0,0,0,0,0,0,0,0,0
20200316,707556,精測永豐96購01,,,,,,0.00,0,0,0,0,0,0,0,0,0,0,0,0,0
20200316,707557,廣明永豐95購02,,,,,,0.00,0,0,0,0,0,0,0,0,0,0,0,0,0
20200316,707558,台燿亞東95購01,,,,,,0.00,0,0,0,0,0,0,0,0,0,0,0,0,0
20200316,707559,信昌電亞東95購01,,,,,,0.00,0,0,0,0,0,0,0,0,0,0,0,0,0
20200316,707560,精測元富95購01,0.08,0.09,0.08,0.09,+0.01,12.5,475000,32,42000,0,0,0,0,0,0,475000,0,475000,475000
20200316,707561,M31國票96購02,,,,,,0.00,0,0,0,0,0,0,0,0,0,0,0,0,0
20200316,707562,由田國票97購01,,,,,,0.00,0,0,0,0,0,0,0,0,0,0,0,0,0
20200316,707563,宇峻國票96購01,0.32,0.44,0.29,0.44,+0.17,62.96,185000,7,67620,0,0,0,0,0,0,185000,0,185000,185000
20200316,707564,環球晶國票96購04,1.51,1.51,1.12,1.12,-0.43,-27.74,40000,2,48700,0,0,0,0,0,0,40000,0,40000,40000
20200316,707565,精測國泰95購01,0.16,0.17,0.12,0.12,-0.05,-29.41,762000,13,125180,0,0,0,0,0,0,690000,72000,618000,618000
20200316,707566,大江元大96購06,,,,,,0.00,0,0,0,0,0,0,0,0,0,0,0,0,0
20200316,707567,合晶元大96購04,0.39,0.39,0.27,0.27,-0.10,-27.03,80000,8,27300,0,0,0,0,0,0,10000,80000,-70000,-70000
20200316,707568,勝麗元大95購03,,,,,,0.00,0,0,0,0,0,0,0,0,0,0,0,0,0
20200316,707569,群聯元大95購07,0.43,0.43,0.31,0.31,+0.04,14.81,16000,2,6160,0,0,0,0,0,0,10000,16000,-6000,-6000
20200316,707570,精測元大95購02,0.22,0.22,0.21,0.22,-0.07,-24.14,40000,4,8700,0,0,0,0,0,0,40000,40000,0,0
20200316,707571,優群元大97購01,0.94,0.94,0.75,0.79,-0.01,-1.25,33000,6,26750,0,0,0,0,0,0,5000,28000,-23000,-23000
20200316,707572,穩懋元大95購14,0.12,0.12,0.12,0.12,+0.05,71.43,6000,1,720,0,0,0,0,0,0,6000,0,6000,6000
20200316,707573,穩懋元大96購02,0.25,0.29,0.19,0.19,-0.08,-29.63,215000,20,52600,0,0,0,0,0,0,120000,90000,30000,30000
20200316,707574,大江富邦97購03,0.10,0.10,0.08,0.08,-0.02,-20.0,54000,7,4800,0,0,0,0,0,0,0,24000,-24000,-24000
20200316,707575,雙鴻康和95購02,,,,,,0.00,0,0,0,0,0,0,0,0,0,0,0,0,0
20200316,707576,元太群益95購02,,,,,,0.00,0,0,0,0,0,0,0,0,0,0,0,0,0
20200316,707577,神盾群益97購01,,,,,,0.00,0,0,0,0,0,0,0,0,0,0,0,0,0
20200316,707578,精測群益95購01,0.20,0.20,0.20,0.20,-0.04,-16.67,20000,1,4000,0,0,0,0,0,0,20000,0,20000,20000
20200316,707579,聯亞群益95購03,,,,,,0.00,0,0,0,0,0,0,0,0,0,0,0,0,0
20200316,707580,雙鴻群益96購03,,,,,,0.00,0,0,0,0,0,0,0,0,0,0,0,0,0
20200316,707581,世界元大96購01,1.23,1.23,1.00,1.00,-0.29,-22.48,61000,6,70490,0,0,0,0,0,0,51000,21000,30000,30000
20200316,707582,金可元大96購01,,,,,,0.00,0,0,0,0,0,0,0,0,0,0,0,0,0
20200316,707583,順達元大96購01,0.91,1.07,0.91,0.92,-0.09,-8.91,50000,5,48600,0,0,0,0,0,0,20000,30000,-10000,-10000
20200316,707584,精測元大97購01,0.35,0.35,0.35,0.35,-0.09,-20.45,40000,4,14000,0,0,0,0,0,0,0,40000,-40000,-40000
20200316,707585,精華元大96購02,,,,,,0.00,0,0,0,0,0,0,0,0,0,0,0,0,0
20200316,707586,新鉅科元富96購02,,,,,,0.00,0,0,0,0,0,0,0,0,0,0,0,0,0
20200316,707587,精測元富96購01,0.12,0.13,0.10,0.12,0.00,0.0,870000,20,97800,0,0,0,0,0,0,770000,100000,670000,670000
20200316,707588,廣明元富96購01,,,,,,0.00,0,0,0,0,0,0,0,0,0,0,0,0,0
20200316,707589,宣德統一96購01,,,,,,0.00,0,0,0,0,0,0,0,0,0,0,0,0,0
20200316,707590,群聯統一96購03,,,,,,0.00,0,0,0,0,0,0,0,0,0,0,0,0,0
20200316,707591,精測統一97購01,,,,,,0.00,0,0,0,0,0,0,0,0,0,0,0,0,0
20200316,707592,穩懋統一97購01,,,,,,0.00,0,0,0,0,0,0,0,0,0,0,0,0,0
20200316,707593,穩懋統一98購01,,,,,,0.00,0,0,0,0,0,0,0,0,0,0,0,0,0
20200316,707594,昂寶凱基98購01,,,,,,0.00,0,0,0,0,0,0,0,0,0,0,0,0,0
20200316,707595,精測凱基97購01,,,,,,0.00,0,0,0,0,0,0,0,0,0,0,0,0,0
20200316,707596,精測凱基97購02,0.42,0.43,0.40,0.41,+0.12,41.38,60000,8,25000,0,0,0,0,0,0,60000,0,60000,60000
20200316,707597,雙鴻凱基96購04,,,,,,0.00,0,0,0,0,0,0,0,0,0,0,0,0,0
20200316,707598,穩懋凱基96購05,,,,,,0.00,0,0,0,0,0,0,0,0,0,0,0,0,0
20200316,707599,大江永豐96購01,,,,,,0.00,0,0,0,0,0,0,0,0,0,0,0,0,0
20200316,707600,中美晶永豐96購01,1.44,1.59,1.41,1.41,-0.16,-10.19,245000,9,376550,0,0,0,0,0,0,208000,89000,119000,119000
20200316,707601,精測永豐96購02,0.40,0.43,0.33,0.36,-0.04,-10.0,240000,20,96290,0,0,0,0,0,0,221000,19000,202000,202000
20200316,707602,精測永豐97購01,0.45,0.46,0.37,0.37,-0.05,-11.9,59000,7,24830,0,0,0,0,0,0,10000,49000,-39000,-39000
20200316,707603,邦特國票97購01,0.12,0.12,0.09,0.09,-0.04,-30.77,100000,10,10500,0,0,0,0,0,0,0,100000,-100000,-100000
20200316,707604,金可國票97購01,0.01,0.02,0.01,0.02,0.00,0.0,170000,3,1900,0,0,0,0,0,0,0,0,0,0
20200316,707605,群聯富邦97購01,0.11,0.11,0.08,0.08,-0.01,-11.11,20000,3,1730,0,0,0,0,0,0,1000,0,1000,1000
20200316,707606,精測富邦96購01,,,,,,0.00,0,0,0,0,0,0,0,0,0,0,0,0,0
20200316,707607,精測兆豐97購01,0.65,0.69,0.64,0.65,+0.02,3.17,90000,8,59360,0,0,0,0,0,0,90000,0,90000,90000
20200316,707608,東洋群益96購01,0.02,0.02,0.02,0.02,-0.01,-33.33,768000,2,15360,0,0,0,0,0,0,768000,0,768000,768000
20200316,707609,金居群益98購01,,,,,,0.00,0,0,0,0,0,0,0,0,0,0,0,0,0
20200316,707610,保瑞群益98購01,0.45,0.47,0.33,0.33,-0.12,-26.67,480000,10,196200,0,0,0,0,0,0,0,480000,-480000,-480000
20200316,707611,新鉅科群益96購01,0.03,0.03,0.03,0.03,0.00,0.0,18000,18,540,0,0,0,0,0,0,0,18000,-18000,-18000
20200316,707612,精測群益96購01,0.13,0.13,0.10,0.10,+0.03,42.86,430000,3,55000,0,0,0,0,0,0,400000,30000,370000,370000
20200316,707613,鈊象台新97購01,,,,,,0.00,0,0,0,0,0,0,0,0,0,0,0,0,0
20200316,707614,精測中信96購02,,,,,,0.00,0,0,0,0,0,0,0,0,0,0,0,0,0
20200316,707615,鈊象中信96購01,2.58,2.77,1.97,1.97,-0.10,-4.83,107000,20,285440,0,0,0,0,0,0,107000,0,107000,107000
20200316,707616,M31凱基97購01,,,,,,0.00,0,0,0,0,0,0,0,0,0,0,0,0,0
20200316,707617,宣德凱基96購01,,,,,,0.00,0,0,0,0,0,0,0,0,0,0,0,0,0
20200316,707618,精測凱基97購03,,,,,,0.00,0,0,0,0,0,0,0,0,0,0,0,0,0
20200316,707619,璟德凱基96購01,0.25,0.25,0.25,0.25,-0.01,-3.85,50000,2,12500,0,0,0,0,0,0,0,50000,-50000,-50000
20200316,707620,鐿鈦凱基96購02,,,,,,0.00,0,0,0,0,0,0,0,0,0,0,0,0,0
20200316,707621,精測統一97購02,0.36,0.36,0.36,0.36,0.00,0.0,3000,2,1080,0,0,0,0,0,0,3000,0,3000,3000
20200316,707622,鈊象統一96購01,,,,,,0.00,0,0,0,0,0,0,0,0,0,0,0,0,0
20200316,707623,勝麗兆豐96購01,,,,,,0.00,0,0,0,0,0,0,0,0,0,0,0,0,0
20200316,707624,精測康和96購02,,,,,,0.00,0,0,0,0,0,0,0,0,0,0,0,0,0
20200316,707625,鈊象康和96購01,2.87,3.20,2.40,2.40,+0.30,14.29,198000,21,586260,0,0,0,0,0,0,100000,23000,77000,77000
20200316,707626,環球晶永昌99購01,2.28,2.28,1.84,1.84,-1.10,-37.41,124000,5,254640,0,0,0,0,0,0,48000,76000,-28000,-28000
20200316,707627,迅得永豐97購01,,,,,,0.00,0,0,0,0,0,0,0,0,0,0,0,0,0
20200316,707628,旺矽永豐97購01,,,,,,0.00,0,0,0,0,0,0,0,0,0,0,0,0,0
20200316,707629,昇達科永豐97購01,,,,,,0.00,0,0,0,0,0,0,0,0,0,0,0,0,0
20200316,707630,僑威永豐96購01,,,,,,0.00,0,0,0,0,0,0,0,0,0,0,0,0,0
20200316,707631,璟德永豐96購01,,,,,,0.00,0,0,0,0,0,0,0,0,0,0,0,0,0
20200316,707632,鈊象永豐96購01,,,,,,0.00,0,0,0,0,0,0,0,0,0,0,0,0,0
20200316,707633,鈊象永豐97購01,5.60,5.65,4.95,4.95,-0.10,-1.98,20000,4,105750,0,0,0,0,0,0,15000,0,15000,15000
20200316,707634,元太元大96購03,,,,,,0.00,0,0,0,0,0,0,0,0,0,0,0,0,0
20200316,707635,宣德元大96購02,0.14,0.14,0.14,0.14,-0.13,-48.15,20000,2,2800,0,0,0,0,0,0,0,20000,-20000,-20000
20200316,707636,新普元大96購01,0.10,0.10,0.10,0.10,-0.11,-52.38,5000,1,500,0,0,0,0,0,0,0,5000,-5000,-5000
20200316,707637,群聯元大97購02,,,,,,0.00,0,0,0,0,0,0,0,0,0,0,0,0,0
20200316,707638,精測元大96購01,0.44,0.48,0.35,0.35,-0.11,-23.91,610000,14,272400,0,0,0,0,0,0,510000,100000,410000,410000
20200316,707639,鈊象元大97購01,,,,,,0.00,0,0,0,0,0,0,0,0,0,0,0,0,0
20200316,707640,波若威國票97購01,,,,,,0.00,0,0,0,0,0,0,0,0,0,0,0,0,0
20200316,707641,聯亞國票97購01,,,,,,0.00,0,0,0,0,0,0,0,0,0,0,0,0,0
20200316,707642,宣德國泰97購01,0.52,0.55,0.32,0.33,-0.19,-36.54,2304000,25,1083670,0,0,0,0,0,0,972000,1332000,-360000,-360000
20200316,707643,原相國泰98購01,,,,,,0.00,0,0,0,0,0,0,0,0,0,0,0,0,0
20200316,707644,精測國泰98購01,0.52,0.53,0.40,0.40,-0.10,-20.0,130000,5,66800,0,0,0,0,0,0,100000,30000,70000,70000
20200316,707645,鈊象國泰98購01,,,,,,0.00,0,0,0,0,0,0,0,0,0,0,0,0,0
20200316,707646,鈊象群益99購01,,,,,,0.00,0,0,0,0,0,0,0,0,0,0,0,0,0
20200316,707647,鈺太中信96購02,0.19,0.23,0.19,0.23,+0.06,35.29,100000,5,19800,0,0,0,0,0,0,0,100000,-100000,-100000
20200316,707648,雙鴻統一96購01,,,,,,0.00,0,0,0,0,0,0,0,0,0,0,0,0,0
20200316,707649,鈊象統一96購02,,,,,,0.00,0,0,0,0,0,0,0,0,0,0,0,0,0
20200316,707650,宇峻凱基98購01,0.24,0.24,0.17,0.17,-0.07,-29.17,212000,5,43660,0,0,0,0,0,0,0,10000,-10000,-10000
20200316,707651,精測凱基96購03,0.35,0.36,0.23,0.26,+0.02,8.33,135000,16,35480,0,0,0,0,0,0,60000,20000,40000,40000
20200316,707652,環球晶凱基96購03,,,,,,0.00,0,0,0,0,0,0,0,0,0,0,0,0,0
20200316,707653,櫃200凱基96購03,0.06,0.07,0.05,0.06,0.00,0.0,15000,14,920,0,0,0,0,0,0,5000,0,5000,5000
20200316,707654,雙美凱基97購01,,,,,,0.00,0,0,0,0,0,0,0,0,0,0,0,0,0
20200316,707655,穩懋凱基96購06,,,,,,0.00,0,0,0,0,0,0,0,0,0,0,0,0,0
20200316,707656,鈊象凱基96購01,4.60,4.60,4.57,4.57,+1.04,29.46,35000,2,160100,0,0,0,0,0,0,35000,0,35000,35000
20200316,707657,鈊象凱基97購01,5.30,5.40,4.66,4.66,-0.24,-4.9,72000,15,381970,0,0,0,0,0,0,70000,2000,68000,68000
20200316,707658,信昌電元富96購01,,,,,,0.00,0,0,0,0,0,0,0,0,0,0,0,0,0
20200316,707659,精測元富96購02,0.38,0.38,0.38,0.38,+0.12,46.15,50000,1,19000,0,0,0,0,0,0,0,0,0,0
20200316,707660,鈊象元富96購01,5.70,5.70,5.70,5.70,+1.45,34.12,4000,1,22800,0,0,0,0,0,0,4000,0,4000,4000
20200316,707661,宣德台新96購01,,,,,,0.00,0,0,0,0,0,0,0,0,0,0,0,0,0
20200316,707662,凡甲國票97購01,0.73,0.76,0.65,0.65,-0.03,-4.41,98000,13,71720,0,0,0,0,0,0,88000,0,88000,88000
20200316,707663,世界國票97購01,1.26,1.26,1.26,1.26,+0.10,8.62,40000,1,50400,0,0,0,0,0,0,40000,0,40000,40000
20200316,707664,杰力國票97購01,0.34,0.34,0.26,0.26,-0.08,-23.53,12000,2,3280,0,0,0,0,0,0,12000,0,12000,12000
20200316,707665,原相國票98購01,2.15,2.15,1.60,1.60,-0.06,-3.61,562000,8,1189520,0,0,0,0,0,0,552000,10000,542000,542000
20200316,707666,鈊象國票96購02,22.50,22.50,12.10,12.10,-1.60,-11.68,104000,25,2121400,0,0,0,0,0,0,100000,0,100000,100000
20200316,707667,精測國泰98購02,0.64,0.73,0.60,0.60,-0.09,-13.04,480000,19,335420,0,0,0,0,0,0,390000,65000,325000,325000
20200316,707668,合晶富邦96購01,0.17,0.17,0.17,0.17,+0.02,13.33,10000,1,1700,0,0,0,0,0,0,0,10000,-10000,-10000
20200316,707669,安勤永豐97購01,0.11,0.11,0.09,0.09,+0.01,12.5,100000,7,9300,0,0,0,0,0,0,0,100000,-100000,-100000
20200316,707670,閎康永豐96購01,,,,,,0.00,0,0,0,0,0,0,0,0,0,0,0,0,0
20200316,707671,精測永豐96購04,,,,,,0.00,0,0,0,0,0,0,0,0,0,0,0,0,0
20200316,707672,晶焱兆豐97購01,0.54,0.57,0.54,0.54,+0.05,10.2,364000,6,198810,0,0,0,0,0,0,44000,320000,-276000,-276000
20200316,707673,雙鴻兆豐97購02,0.11,0.11,0.06,0.06,-0.03,-33.33,405000,21,36430,0,0,0,0,0,0,250000,155000,95000,95000
20200316,707674,合晶元大97購01,0.29,0.29,0.20,0.20,-0.06,-23.08,70000,6,17200,0,0,0,0,0,0,30000,50000,-20000,-20000
20200316,707675,茂達元大97購01,0.12,0.12,0.12,0.12,-0.08,-40.0,20000,1,2400,0,0,0,0,0,0,20000,0,20000,20000
20200316,707676,原相元大97購02,2.19,2.36,2.17,2.21,+0.29,15.1,38000,7,86010,0,0,0,0,0,0,38000,6000,32000,32000
20200316,707677,勝麗元大96購02,,,,,,0.00,0,0,0,0,0,0,0,0,0,0,0,0,0
20200316,707678,精測元大98購01,0.41,0.48,0.35,0.35,+0.11,45.83,71000,7,29510,0,0,0,0,0,0,41000,30000,11000,11000
20200316,707679,璟德元大96購01,0.38,0.42,0.27,0.27,-0.12,-30.77,303000,29,104940,0,0,0,0,0,0,50000,250000,-200000,-200000
20200316,707680,鈊象元大98購01,9.00,10.60,9.00,9.35,0.00,0.0,27000,6,266000,0,0,0,0,0,0,16000,13000,3000,3000
20200316,707681,力麒康和96購01,,,,,,0.00,0,0,0,0,0,0,0,0,0,0,0,0,0
20200316,707682,精測康和96購03,0.25,0.25,0.25,0.25,0.00,0.0,35000,1,8750,0,0,0,0,0,0,35000,0,35000,35000
20200316,707683,東隆興群益96購01,,,,,,0.00,0,0,0,0,0,0,0,0,0,0,0,0,0
20200316,707684,金居群益98購02,0.18,0.18,0.18,0.18,+0.05,38.46,10000,1,1800,0,0,0,0,0,0,0,10000,-10000,-10000
20200316,707685,保瑞群益98購02,0.73,0.73,0.55,0.55,-0.11,-16.67,190000,8,123600,0,0,0,0,0,0,20000,170000,-150000,-150000
20200316,707686,神盾群益98購01,0.08,0.08,0.08,0.08,0.00,0.0,30000,1,2400,0,0,0,0,0,0,0,30000,-30000,-30000
20200316,707687,順達群益96購02,0.95,0.95,0.95,0.95,+0.19,25.0,1000,1,950,0,0,0,0,0,0,1000,0,1000,1000
20200316,707688,緯軟統一96購01,,,,,,0.00,0,0,0,0,0,0,0,0,0,0,0,0,0
20200316,707689,穩懋統一96購06,0.74,0.74,0.54,0.54,-0.17,-23.94,27000,4,17180,0,0,0,0,0,0,0,27000,-27000,-27000
20200316,707690,鈊象統一96購03,5.30,5.30,5.30,5.30,+1.68,46.41,1000,1,5300,0,0,0,0,0,0,1000,0,1000,1000
20200316,707691,同致元大97購02,,,,,,0.00,0,0,0,0,0,0,0,0,0,0,0,0,0
20200316,707692,迅得元大97購01,,,,,,0.00,0,0,0,0,0,0,0,0,0,0,0,0,0
20200316,707693,晶焱元大97購01,0.81,0.83,0.78,0.79,-0.04,-4.82,109000,6,86980,0,0,0,0,0,0,109000,77000,32000,32000
20200316,707694,群聯元大97購03,0.56,0.56,0.56,0.56,-0.19,-25.33,2000,1,1120,0,0,0,0,0,0,2000,0,2000,2000
20200316,707695,優群元大97購02,1.44,1.44,1.44,1.44,+0.39,37.14,10000,1,14400,0,0,0,0,0,0,0,10000,-10000,-10000
20200316,707696,聯亞元大97購01,0.94,0.98,0.74,0.74,+0.02,2.78,216000,20,190050,0,0,0,0,0,0,75000,141000,-66000,-66000
20200316,707697,穩懋元大96購03,0.83,0.89,0.66,0.66,-0.17,-20.48,415000,28,331870,0,0,0,0,0,0,281000,120000,161000,161000
20200316,707698,鈊象元大97購02,,,,,,0.00,0,0,0,0,0,0,0,0,0,0,0,0,0
20200316,707699,原相元富96購01,,,,,,0.00,0,0,0,0,0,0,0,0,0,0,0,0,0
20200316,707700,精華元富96購01,,,,,,0.00,0,0,0,0,0,0,0,0,0,0,0,0,0
20200316,707701,環球晶元富96購01,1.14,1.14,0.87,0.87,-0.15,-14.71,80000,2,88500,0,0,0,0,0,0,70000,10000,60000,60000
20200316,707702,鈊象台新98購01,,,,,,0.00,0,0,0,0,0,0,0,0,0,0,0,0,0
20200316,707703,M31凱基96購01,,,,,,0.00,0,0,0,0,0,0,0,0,0,0,0,0,0
20200316,707704,金可凱基97購01,,,,,,0.00,0,0,0,0,0,0,0,0,0,0,0,0,0
20200316,707705,金居凱基96購01,,,,,,0.00,0,0,0,0,0,0,0,0,0,0,0,0,0
20200316,707706,精華凱基96購02,,,,,,0.00,0,0,0,0,0,0,0,0,0,0,0,0,0
20200316,707707,環球晶凱基96購04,1.30,1.34,1.04,1.14,-0.29,-20.28,793000,11,1014510,0,0,0,0,0,0,140000,653000,-513000,-513000
20200316,707708,聯亞凱基96購01,0.48,0.48,0.41,0.43,+0.16,59.26,49000,4,20770,0,0,0,0,0,0,49000,0,49000,49000
20200316,707709,鐿鈦凱基97購01,,,,,,0.00,0,0,0,0,0,0,0,0,0,0,0,0,0
20200316,707710,大田國票97購01,0.17,0.18,0.16,0.16,-0.01,-5.88,350000,35,60400,0,0,0,0,0,0,0,350000,-350000,-350000
20200316,707711,六角國票98購01,,,,,,0.00,0,0,0,0,0,0,0,0,0,0,0,0,0
20200316,707712,昂寶國票97購02,,,,,,0.00,0,0,0,0,0,0,0,0,0,0,0,0,0
20200316,707713,晶焱國票97購01,,,,,,0.00,0,0,0,0,0,0,0,0,0,0,0,0,0
20200316,707714,群聯國票97購01,0.80,0.80,0.37,0.37,-0.40,-51.95,10000,2,5850,0,0,0,0,0,0,0,5000,-5000,-5000
20200316,707715,大江國泰98購01,,,,,,0.00,0,0,0,0,0,0,0,0,0,0,0,0,0
20200316,707716,晶焱國泰98購01,0.73,0.73,0.56,0.56,-0.17,-23.29,56000,7,36220,0,0,0,0,0,0,35000,51000,-16000,-16000
20200316,707717,穩懋國泰97購01,0.61,0.63,0.40,0.42,-0.14,-25.0,3175000,48,1860950,0,0,0,0,0,0,2489000,686000,1803000,1803000
20200316,707718,良維永豐96購01,0.07,0.07,0.07,0.07,+0.02,40.0,3000,1,210,0,0,0,0,0,0,3000,0,3000,3000
20200316,707719,威剛永豐96購01,1.19,1.19,1.01,1.02,+0.18,21.43,128000,4,144470,0,0,0,0,0,0,91000,44000,47000,47000
20200316,707720,宣德永豐97購01,,,,,,0.00,0,0,0,0,0,0,0,0,0,0,0,0,0
20200316,707721,鈊象永豐96購03,6.20,7.45,5.75,5.95,-0.40,-6.3,135000,30,951300,0,0,0,0,0,0,126000,1000,125000,125000
20200316,707722,三貝德群益96購01,,,,,,0.00,0,0,0,0,0,0,0,0,0,0,0,0,0
20200316,707723,宜鼎群益96購02,1.00,1.03,1.00,1.03,+0.45,77.59,20000,2,20300,0,0,0,0,0,0,0,20000,-20000,-20000
20200316,707724,長科*群益96購01,0.50,0.50,0.50,0.50,-0.08,-13.79,2000,1,1000,0,0,0,0,0,0,0,2000,-2000,-2000
20200316,707725,閎康群益97購01,,,,,,0.00,0,0,0,0,0,0,0,0,0,0,0,0,0
20200316,707726,晟德群益96購01,,,,,,0.00,0,0,0,0,0,0,0,0,0,0,0,0,0
20200316,707727,鈊象群益99購02,,,,,,0.00,0,0,0,0,0,0,0,0,0,0,0,0,0
20200316,707728,鈊象康和96購03,,,,,,0.00,0,0,0,0,0,0,0,0,0,0,0,0,0
20200316,707729,鈊象凱基98購01,5.90,6.80,4.66,4.66,-1.39,-22.98,134000,28,811590,0,0,0,0,0,0,134000,53000,81000,81000
20200316,707730,穩懋元富96購01,,,,,,0.00,0,0,0,0,0,0,0,0,0,0,0,0,0
20200316,707731,環球晶亞東97購01,1.01,1.10,0.74,0.74,-0.54,-42.19,417000,12,438580,0,0,0,0,0,0,416000,417000,-1000,-1000
20200316,707732,凡甲永豐97購01,0.45,0.50,0.42,0.42,-0.01,-2.33,46000,15,20650,0,0,0,0,0,0,46000,0,46000,46000
20200316,707733,大宇資永豐96購02,0.15,0.15,0.10,0.10,-0.06,-37.5,77000,3,9050,0,0,0,0,0,0,0,77000,-77000,-77000
20200316,707734,元太國票97購01,0.25,0.25,0.19,0.19,-0.01,-5.0,50000,5,10700,0,0,0,0,0,0,0,50000,-50000,-50000
20200316,707735,台燿國票97購01,0.42,0.42,0.42,0.42,+0.02,5.0,57000,2,23940,0,0,0,0,0,0,57000,0,57000,57000
20200316,707736,信驊國票97購01,2.06,2.06,1.47,1.47,-0.31,-17.42,22000,2,44140,0,0,0,0,0,0,22000,0,22000,22000
20200316,707737,新普國票97購01,0.21,0.21,0.21,0.21,-0.07,-25.0,100000,1,21000,0,0,0,0,0,0,100000,0,100000,100000
20200316,707738,聖暉國泰96購01,1.29,1.29,1.17,1.17,-0.10,-7.87,468000,12,569830,0,0,0,0,0,0,141000,327000,-186000,-186000
20200316,707739,網家國泰97購01,0.20,0.20,0.20,0.20,+0.09,81.82,1000,1,200,0,0,0,0,0,0,0,0,0,0
20200316,707740,金可兆豐96購01,,,,,,0.00,0,0,0,0,0,0,0,0,0,0,0,0,0
20200316,707741,胡連康和96購01,0.48,0.48,0.48,0.48,-0.03,-5.88,68000,1,32640,0,0,0,0,0,0,0,68000,-68000,-68000
20200316,707742,佳邦群益96購01,,,,,,0.00,0,0,0,0,0,0,0,0,0,0,0,0,0
20200316,707743,旺矽群益97購01,,,,,,0.00,0,0,0,0,0,0,0,0,0,0,0,0,0
20200316,707744,新普群益98購01,,,,,,0.00,0,0,0,0,0,0,0,0,0,0,0,0,0
20200316,707745,網龍群益98購01,0.16,0.16,0.12,0.12,0.00,0.0,110000,2,17200,0,0,0,0,0,0,100000,10000,90000,90000
20200316,707746,由田元大96購01,0.12,0.12,0.11,0.11,-0.01,-8.33,8000,2,930,0,0,0,0,0,0,0,8000,-8000,-8000
20200316,707747,信昌電元大97購01,0.56,0.57,0.39,0.39,-0.07,-15.22,62000,7,33020,0,0,0,0,0,0,14000,52000,-38000,-38000
20200316,707748,神盾元大99購01,0.32,0.33,0.22,0.22,-0.09,-29.03,229000,22,57820,0,0,0,0,0,0,85000,143000,-58000,-58000
20200316,707749,精華元大97購01,,,,,,0.00,0,0,0,0,0,0,0,0,0,0,0,0,0
20200316,707750,穩懋元大97購01,0.51,0.51,0.37,0.37,+0.08,27.59,255000,8,114910,0,0,0,0,0,0,218000,37000,181000,181000
20200316,707751,鈺太元大97購01,0.32,0.44,0.31,0.38,+0.05,15.15,126000,15,44210,0,0,0,0,0,0,26000,100000,-74000,-74000
20200316,707752,世界中信98購01,,,,,,0.00,0,0,0,0,0,0,0,0,0,0,0,0,0
20200316,707753,環球晶中信99購02,0.52,0.52,0.34,0.34,-0.17,-33.33,474000,25,226260,0,0,0,0,0,0,270000,174000,96000,96000
20200316,707754,環球晶統一96購01,,,,,,0.00,0,0,0,0,0,0,0,0,0,0,0,0,0
20200316,707755,穩懋統一96購07,,,,,,0.00,0,0,0,0,0,0,0,0,0,0,0,0,0
20200316,707756,世界凱基96購01,0.19,0.20,0.15,0.15,-0.05,-25.0,140000,6,26700,0,0,0,0,0,0,10000,130000,-120000,-120000
20200316,707757,網龍凱基97購01,,,,,,0.00,0,0,0,0,0,0,0,0,0,0,0,0,0
20200316,707758,穩懋凱基96購07,0.18,0.18,0.17,0.17,-0.01,-5.56,40000,3,7000,0,0,0,0,0,0,20000,20000,0,0
20200316,707759,大江元大97購01,0.07,0.07,0.07,0.07,0.00,0.0,10000,1,700,0,0,0,0,0,0,0,10000,-10000,-10000
20200316,707760,世界元大96購02,0.60,0.60,0.58,0.58,+0.13,28.89,10000,2,5940,0,0,0,0,0,0,10000,0,10000,10000
20200316,707761,迅得元大98購01,,,,,,0.00,0,0,0,0,0,0,0,0,0,0,0,0,0
20200316,707762,宣德元大96購03,,,,,,0.00,0,0,0,0,0,0,0,0,0,0,0,0,0
20200316,707763,群聯元大96購04,1.54,1.54,1.04,1.05,-0.34,-24.46,113000,10,149980,0,0,0,0,0,0,113000,103000,10000,10000
20200316,707764,鈊象元大96購03,,,,,,0.00,0,0,0,0,0,0,0,0,0,0,0,0,0
20200316,707765,原相永昌99購01,3.02,3.11,2.98,2.98,+0.19,6.81,70000,21,213220,0,0,0,0,0,0,40000,0,40000,40000
20200316,707766,大田永豐96購01,,,,,,0.00,0,0,0,0,0,0,0,0,0,0,0,0,0
20200316,707767,中美晶永豐96購02,0.63,0.65,0.59,0.59,-0.11,-15.71,62000,7,39820,0,0,0,0,0,0,62000,62000,0,0
20200316,707768,世界永豐96購02,,,,,,0.00,0,0,0,0,0,0,0,0,0,0,0,0,0
20200316,707769,光頡永豐96購01,0.11,0.11,0.11,0.11,-0.06,-35.29,2000,1,220,0,0,0,0,0,0,2000,0,2000,2000
20200316,707770,合晶永豐97購01,0.27,0.27,0.27,0.27,+0.06,28.57,27000,1,7290,0,0,0,0,0,0,0,27000,-27000,-27000
20200316,707771,精測永豐96購06,,,,,,0.00,0,0,0,0,0,0,0,0,0,0,0,0,0
20200316,707772,精測永豐96購07,,,,,,0.00,0,0,0,0,0,0,0,0,0,0,0,0,0
20200316,707773,穩懋永豐96購01,0.17,0.17,0.15,0.15,-0.03,-16.67,20000,2,3200,0,0,0,0,0,0,0,20000,-20000,-20000
20200316,707774,大宇資國票97購01,0.13,0.13,0.13,0.13,-0.02,-13.33,10000,1,1300,0,0,0,0,0,0,10000,0,10000,10000
20200316,707775,良維國票97購02,,,,,,0.00,0,0,0,0,0,0,0,0,0,0,0,0,0
20200316,707776,宜鼎國票97購01,2.33,2.53,2.30,2.53,+0.89,54.27,120000,3,278600,0,0,0,0,0,0,110000,10000,100000,100000
20200316,707777,金居國票97購01,,,,,,0.00,0,0,0,0,0,0,0,0,0,0,0,0,0
20200316,707778,信昌電國票97購01,0.39,0.39,0.27,0.27,-0.08,-22.86,28000,4,9740,0,0,0,0,0,0,8000,26000,-18000,-18000
20200316,707779,保瑞國票97購01,0.80,0.80,0.70,0.70,-0.04,-5.41,36000,3,26800,0,0,0,0,0,0,16000,20000,-4000,-4000
20200316,707780,昇達科富邦98購01,0.24,0.24,0.20,0.20,-0.04,-16.67,7000,2,1480,0,0,0,0,0,0,5000,2000,3000,3000
20200316,707781,宣德麥證96購01,,,,,,0.00,0,0,0,0,0,0,0,0,0,0,0,0,0
20200316,707782,世界台新97購01,0.57,0.59,0.55,0.59,-0.01,-1.67,128000,3,72120,0,0,0,0,0,0,128000,0,128000,128000
20200316,707783,泰博兆豐96購02,,,,,,0.00,0,0,0,0,0,0,0,0,0,0,0,0,0
20200316,707784,聚積康和96購01,,,,,,0.00,0,0,0,0,0,0,0,0,0,0,0,0,0
20200316,707785,凡甲群益98購01,,,,,,0.00,0,0,0,0,0,0,0,0,0,0,0,0,0
20200316,707786,中美晶群益96購01,1.63,1.63,1.22,1.22,-0.17,-12.23,12000,2,18740,0,0,0,0,0,0,10000,2000,8000,8000
20200316,707787,合晶群益96購01,0.21,0.21,0.17,0.17,-0.05,-22.73,47000,3,9190,0,0,0,0,0,0,0,47000,-47000,-47000
20200316,707788,晶焱群益98購01,,,,,,0.00,0,0,0,0,0,0,0,0,0,0,0,0,0
20200316,707789,精測群益96購04,0.27,0.27,0.27,0.27,-0.09,-25.0,10000,1,2700,0,0,0,0,0,0,0,10000,-10000,-10000
20200316,707790,廣明群益96購01,,,,,,0.00,0,0,0,0,0,0,0,0,0,0,0,0,0
20200316,707791,聯亞群益96購02,0.16,0.16,0.16,0.16,+0.08,100.0,10000,1,1600,0,0,0,0,0,0,10000,0,10000,10000
20200316,707792,鐿鈦群益97購01,,,,,,0.00,0,0,0,0,0,0,0,0,0,0,0,0,0
20200316,707793,中美晶元大96購02,0.40,0.40,0.40,0.40,-0.01,-2.44,1000,1,400,0,0,0,0,0,0,1000,1000,0,0
20200316,707794,世界元大96購03,0.71,0.71,0.70,0.70,+0.17,32.08,20000,3,14070,0,0,0,0,0,0,20000,0,20000,20000
20200316,707795,精測元大96購02,0.48,0.48,0.35,0.35,-0.11,-23.91,261000,17,104450,0,0,0,0,0,0,120000,141000,-21000,-21000
20200316,707796,聯亞元大96購02,0.56,0.56,0.56,0.56,+0.05,9.8,10000,1,5600,0,0,0,0,0,0,10000,0,10000,10000
20200316,707797,鈊象元大96購04,,,,,,0.00,0,0,0,0,0,0,0,0,0,0,0,0,0
20200316,707798,世界統一97購01,0.58,0.58,0.58,0.58,+0.11,23.4,18000,1,10440,0,0,0,0,0,0,18000,0,18000,18000
20200316,707799,神盾統一98購01,,,,,,0.00,0,0,0,0,0,0,0,0,0,0,0,0,0
20200316,707800,穩懋統一98購02,0.45,0.45,0.32,0.32,-0.17,-34.69,99000,4,35280,0,0,0,0,0,0,99000,0,99000,99000
20200316,707801,鈊象統一97購02,5.70,5.70,5.70,5.70,+0.40,7.55,2000,1,11400,0,0,0,0,0,0,2000,2000,0,0
20200316,707802,宣德中信9A購01,0.32,0.32,0.22,0.23,-0.10,-30.3,556000,12,142050,0,0,0,0,0,0,130000,426000,-296000,-296000
20200316,707803,中光電凱基96購01,,,,,,0.00,0,0,0,0,0,0,0,0,0,0,0,0,0
20200316,707804,世界凱基96購02,0.10,0.10,0.10,0.10,0.00,0.0,7000,1,700,0,0,0,0,0,0,0,7000,-7000,-7000
20200316,707805,旺矽凱基96購01,,,,,,0.00,0,0,0,0,0,0,0,0,0,0,0,0,0
20200316,707806,信昌電凱基97購02,0.11,0.11,0.11,0.11,-0.04,-26.67,15000,1,1650,0,0,0,0,0,0,15000,0,15000,15000
20200316,707807,佳邦國票97購01,,,,,,0.00,0,0,0,0,0,0,0,0,0,0,0,0,0
20200316,707808,優群國票98購01,0.94,0.98,0.86,0.93,+0.15,19.23,50000,4,45700,0,0,0,0,0,0,50000,0,50000,50000
20200316,707809,中美晶國泰97購01,,,,,,0.00,0,0,0,0,0,0,0,0,0,0,0,0,0
20200316,707810,穩懋麥證96購01,0.44,0.50,0.40,0.40,-0.04,-9.09,101000,3,45440,50000,50000,0,0,0,0,50000,50000,0,0
20200316,707811,世界元富96購01,,,,,,0.00,0,0,0,0,0,0,0,0,0,0,0,0,0
20200316,707812,茂達元富96購01,,,,,,0.00,0,0,0,0,0,0,0,0,0,0,0,0,0
20200316,707813,群聯元富96購02,,,,,,0.00,0,0,0,0,0,0,0,0,0,0,0,0,0
20200316,707814,穩懋富邦98購01,0.32,0.33,0.21,0.25,-0.06,-19.35,777000,22,191970,0,0,0,0,0,0,626000,132000,494000,494000
20200316,707815,中美晶台新97購01,0.55,0.61,0.55,0.57,0.00,0.0,224000,5,126570,0,0,0,0,0,0,186000,38000,148000,148000
20200316,707816,良維台新97購01,,,,,,0.00,0,0,0,0,0,0,0,0,0,0,0,0,0
20200316,707817,閎康台新96購01,,,,,,0.00,0,0,0,0,0,0,0,0,0,0,0,0,0
20200316,707818,群聯台新97購02,0.60,0.60,0.43,0.43,-0.10,-18.87,20000,2,10300,0,0,0,0,0,0,20000,0,20000,20000
20200316,707819,碩禾台新97購01,,,,,,0.00,0,0,0,0,0,0,0,0,0,0,0,0,0
20200316,707820,世界康和96購01,,,,,,0.00,0,0,0,0,0,0,0,0,0,0,0,0,0
20200316,707821,凡甲群益96購01,1.07,1.07,1.07,1.07,+0.13,13.83,45000,1,48150,0,0,0,0,0,0,45000,0,45000,45000
20200316,707822,中美晶群益96購02,,,,,,0.00,0,0,0,0,0,0,0,0,0,0,0,0,0
20200316,707823,宜鼎群益97購01,,,,,,0.00,0,0,0,0,0,0,0,0,0,0,0,0,0
20200316,707824,環球晶群益96購01,,,,,,0.00,0,0,0,0,0,0,0,0,0,0,0,0,0
20200316,707825,鈊象群益99購03,,,,,,0.00,0,0,0,0,0,0,0,0,0,0,0,0,0
20200316,707826,大江永豐96購02,,,,,,0.00,0,0,0,0,0,0,0,0,0,0,0,0,0
20200316,707827,世界永豐96購03,,,,,,0.00,0,0,0,0,0,0,0,0,0,0,0,0,0
20200316,707828,合晶永豐96購01,,,,,,0.00,0,0,0,0,0,0,0,0,0,0,0,0,0
20200316,707829,博智永豐96購01,,,,,,0.00,0,0,0,0,0,0,0,0,0,0,0,0,0
20200316,707830,網龍永豐96購01,,,,,,0.00,0,0,0,0,0,0,0,0,0,0,0,0,0
20200316,707831,雙美永豐97購01,,,,,,0.00,0,0,0,0,0,0,0,0,0,0,0,0,0
20200316,707832,精測兆豐97購02,,,,,,0.00,0,0,0,0,0,0,0,0,0,0,0,0,0
20200316,707833,網龍兆豐97購01,0.14,0.19,0.12,0.14,+0.01,7.69,567000,23,100110,0,0,0,0,0,0,245000,322000,-77000,-77000
20200316,707834,晟德兆豐97購01,0.17,0.17,0.17,0.17,-0.05,-22.73,10000,1,1700,0,0,0,0,0,0,10000,0,10000,10000
20200316,707835,原相康和96購01,1.26,1.31,1.19,1.19,-0.10,-7.75,123000,23,154360,0,0,0,0,0,0,123000,0,123000,123000
20200316,707836,力旺永豐96購01,,,,,,0.00,0,0,0,0,0,0,0,0,0,0,0,0,0
20200316,707837,良維永豐96購02,,,,,,0.00,0,0,0,0,0,0,0,0,0,0,0,0,0
20200316,707838,佳邦永豐96購01,,,,,,0.00,0,0,0,0,0,0,0,0,0,0,0,0,0
20200316,707839,建榮永豐97購01,,,,,,0.00,0,0,0,0,0,0,0,0,0,0,0,0,0
20200316,707840,晶焱永豐97購01,,,,,,0.00,0,0,0,0,0,0,0,0,0,0,0,0,0
20200316,707841,智崴永豐96購01,,,,,,0.00,0,0,0,0,0,0,0,0,0,0,0,0,0
20200316,707842,精測永豐96購08,,,,,,0.00,0,0,0,0,0,0,0,0,0,0,0,0,0
20200316,707843,鈊象永豐96購04,,,,,,0.00,0,0,0,0,0,0,0,0,0,0,0,0,0
20200316,707844,中美晶元大97購01,1.03,1.04,0.80,0.80,-0.32,-28.57,211000,24,203640,0,0,0,0,0,0,21000,201000,-180000,-180000
20200316,707845,台半元大96購01,,,,,,0.00,0,0,0,0,0,0,0,0,0,0,0,0,0
20200316,707846,杰力元大96購03,0.22,0.22,0.22,0.22,0.00,0.0,3000,1,660,0,0,0,0,0,0,0,3000,-3000,-3000
20200316,707847,宣德元大96購04,,,,,,0.00,0,0,0,0,0,0,0,0,0,0,0,0,0
20200316,707848,精測元大96購03,,,,,,0.00,0,0,0,0,0,0,0,0,0,0,0,0,0
20200316,707849,雙鴻元大99購01,0.16,0.16,0.09,0.09,-0.08,-47.06,261000,13,34720,0,0,0,0,0,0,151000,110000,41000,41000
20200316,707850,鈊象元大97購03,6.60,7.05,4.90,4.90,-1.20,-19.67,66000,11,428200,0,0,0,0,0,0,66000,32000,34000,34000
20200316,707851,群聯麥證96購01,0.32,0.38,0.19,0.19,-0.15,-44.12,443000,10,104810,393000,50000,343000,0,0,0,393000,153000,240000,240000
20200316,707852,環球晶麥證96購01,1.44,1.44,1.44,1.44,-0.10,-6.49,80000,1,115200,80000,0,80000,0,0,0,80000,0,80000,80000
20200316,707853,雙鴻麥證97購01,,,,,,0.00,0,0,0,0,0,0,0,0,0,0,0,0,0
20200316,707854,合晶台新96購01,,,,,,0.00,0,0,0,0,0,0,0,0,0,0,0,0,0
20200316,707855,良維台新97購02,0.12,0.12,0.11,0.11,0.00,0.0,10000,2,1150,0,0,0,0,0,0,0,10000,-10000,-10000
20200316,707856,神盾台新97購01,0.13,0.13,0.13,0.13,0.00,0.0,200000,20,26000,0,0,0,0,0,0,0,200000,-200000,-200000
20200316,707857,新普台新97購01,0.40,0.40,0.28,0.28,-0.09,-24.32,53000,5,19690,0,0,0,0,0,0,1000,52000,-51000,-51000
20200316,707858,穩懋台新97購01,0.67,0.67,0.67,0.67,+0.05,8.06,126000,3,84420,0,0,0,0,0,0,0,126000,-126000,-126000
20200316,707859,中美晶國票97購01,0.58,0.58,0.58,0.58,-0.08,-12.12,60000,1,34800,0,0,0,0,0,0,60000,0,60000,60000
20200316,707860,同致國票97購02,,,,,,0.00,0,0,0,0,0,0,0,0,0,0,0,0,0
20200316,707861,東隆興國票96購01,,,,,,0.00,0,0,0,0,0,0,0,0,0,0,0,0,0
20200316,707862,茂達國票97購01,,,,,,0.00,0,0,0,0,0,0,0,0,0,0,0,0,0
20200316,707863,穩懋國票97購01,0.64,0.64,0.52,0.52,+0.18,52.94,12000,2,7440,0,0,0,0,0,0,10000,2000,8000,8000
20200316,707864,M31凱基98購01,,,,,,0.00,0,0,0,0,0,0,0,0,0,0,0,0,0
20200316,707865,中美晶凱基96購03,0.23,0.23,0.15,0.15,-0.03,-16.67,115000,11,19450,0,0,0,0,0,0,15000,100000,-85000,-85000
20200316,707866,合晶凱基96購01,,,,,,0.00,0,0,0,0,0,0,0,0,0,0,0,0,0
20200316,707867,宣德凱基96購02,,,,,,0.00,0,0,0,0,0,0,0,0,0,0,0,0,0
20200316,707868,碩禾凱基97購01,,,,,,0.00,0,0,0,0,0,0,0,0,0,0,0,0,0
20200316,707869,精測凱基96購07,0.11,0.12,0.11,0.11,+0.01,10.0,10000,5,1110,0,0,0,0,0,0,10000,0,10000,10000
20200316,707870,聯亞凱基97購01,0.36,0.36,0.35,0.36,+0.06,20.0,320000,10,113300,0,0,0,0,0,0,320000,0,320000,320000
20200316,707871,精測國泰97購02,0.29,0.29,0.27,0.27,-0.01,-3.57,350000,4,98700,0,0,0,0,0,0,350000,0,350000,350000
20200316,707872,精測國泰98購03,,,,,,0.00,0,0,0,0,0,0,0,0,0,0,0,0,0
20200316,707873,鈺太國泰98購01,,,,,,0.00,0,0,0,0,0,0,0,0,0,0,0,0,0
20200316,707874,世界富邦98購01,,,,,,0.00,0,0,0,0,0,0,0,0,0,0,0,0,0
20200316,707875,世界群益98購01,,,,,,0.00,0,0,0,0,0,0,0,0,0,0,0,0,0
20200316,707876,世界群益98購02,,,,,,0.00,0,0,0,0,0,0,0,0,0,0,0,0,0
20200316,707877,迅得群益97購02,,,,,,0.00,0,0,0,0,0,0,0,0,0,0,0,0,0
20200316,707878,信昌電群益96購01,,,,,,0.00,0,0,0,0,0,0,0,0,0,0,0,0,0
20200316,707879,宣德群益96購02,,,,,,0.00,0,0,0,0,0,0,0,0,0,0,0,0,0
20200316,707880,建榮群益97購01,,,,,,0.00,0,0,0,0,0,0,0,0,0,0,0,0,0
20200316,707881,璟德群益97購01,,,,,,0.00,0,0,0,0,0,0,0,0,0,0,0,0,0
20200316,707882,環球晶群益97購01,0.32,0.32,0.32,0.32,-0.11,-25.58,8000,1,2560,0,0,0,0,0,0,8000,0,8000,8000
20200316,707883,力旺元大97購01,0.20,0.20,0.20,0.20,-0.02,-9.09,10000,1,2000,0,0,0,0,0,0,0,10000,-10000,-10000
20200316,707884,中美晶元大97購02,1.20,1.31,1.05,1.05,-0.19,-15.32,127000,9,158550,0,0,0,0,0,0,124000,4000,120000,120000
20200316,707885,台燿元大96購01,,,,,,0.00,0,0,0,0,0,0,0,0,0,0,0,0,0
20200316,707886,旺矽元大99購01,,,,,,0.00,0,0,0,0,0,0,0,0,0,0,0,0,0
20200316,707887,晶焱元大97購02,0.31,0.34,0.31,0.31,-0.02,-6.06,68000,7,22440,0,0,0,0,0,0,68000,68000,0,0
20200316,707888,精測元大97購02,0.22,0.22,0.22,0.22,+0.02,10.0,100000,1,22000,0,0,0,0,0,0,100000,0,100000,100000
20200316,707889,璟德元大96購02,0.21,0.21,0.20,0.20,-0.04,-16.67,50000,5,10300,0,0,0,0,0,0,0,50000,-50000,-50000
20200316,707890,穩懋元大96購04,0.72,0.83,0.63,0.63,-0.02,-3.08,105000,9,77250,0,0,0,0,0,0,80000,45000,35000,35000
20200316,707891,力旺凱基96購01,,,,,,0.00,0,0,0,0,0,0,0,0,0,0,0,0,0
20200316,707892,大江凱基96購02,,,,,,0.00,0,0,0,0,0,0,0,0,0,0,0,0,0
20200316,707893,保瑞凱基96購01,0.47,0.47,0.32,0.32,-0.16,-33.33,278000,8,104620,0,0,0,0,0,0,36000,237000,-201000,-201000
20200316,707894,璟德凱基96購02,0.06,0.06,0.06,0.06,-0.04,-40.0,100000,1,6000,0,0,0,0,0,0,100000,0,100000,100000
20200316,707895,穩懋凱基96購09,0.23,0.23,0.23,0.23,-0.07,-23.33,10000,1,2300,0,0,0,0,0,0,0,10000,-10000,-10000
20200316,707896,中美晶統一96購01,,,,,,0.00,0,0,0,0,0,0,0,0,0,0,0,0,0
20200316,707897,昂寶統一97購01,,,,,,0.00,0,0,0,0,0,0,0,0,0,0,0,0,0
20200316,707898,台燿兆豐97購01,0.31,0.32,0.27,0.32,+0.02,6.67,81000,4,25190,0,0,0,0,0,0,66000,15000,51000,51000
20200316,707899,威剛群益96購01,2.50,2.50,1.75,1.96,-0.68,-25.76,37000,6,83190,0,0,0,0,0,0,5000,32000,-27000,-27000
20200316,707900,宣德群益96購03,,,,,,0.00,0,0,0,0,0,0,0,0,0,0,0,0,0
20200316,707901,精測群益96購05,0.05,0.05,0.05,0.05,0.00,0.0,490000,2,24500,0,0,0,0,0,0,490000,0,490000,490000
20200316,707902,鈊象群益98購01,,,,,,0.00,0,0,0,0,0,0,0,0,0,0,0,0,0
20200316,707903,M31永豐96購01,,,,,,0.00,0,0,0,0,0,0,0,0,0,0,0,0,0
20200316,707904,金居永豐96購01,,,,,,0.00,0,0,0,0,0,0,0,0,0,0,0,0,0
20200316,707905,宣德永豐96購01,0.10,0.10,0.10,0.10,+0.02,25.0,80000,3,8000,0,0,0,0,0,0,0,80000,-80000,-80000
20200316,707906,精測永豐96購09,,,,,,0.00,0,0,0,0,0,0,0,0,0,0,0,0,0
20200316,707907,璟德永豐96購02,,,,,,0.00,0,0,0,0,0,0,0,0,0,0,0,0,0
20200316,707908,優群永豐96購02,0.62,0.66,0.48,0.52,+0.09,20.93,412000,30,250380,0,0,0,0,0,0,178000,209000,-31000,-31000
20200316,707909,凡甲台新96購01,,,,,,0.00,0,0,0,0,0,0,0,0,0,0,0,0,0
20200316,707910,力旺國票97購01,,,,,,0.00,0,0,0,0,0,0,0,0,0,0,0,0,0
20200316,707911,杰力國票97購02,0.49,0.49,0.34,0.34,-0.10,-22.73,27000,4,12460,0,0,0,0,0,0,0,27000,-27000,-27000
20200316,707912,聚積國票97購01,,,,,,0.00,0,0,0,0,0,0,0,0,0,0,0,0,0
20200316,707913,鈊象國票97購01,17.10,17.10,16.60,16.60,+4.90,41.88,58000,8,984800,0,0,0,0,0,0,58000,0,58000,58000
20200316,707914,環球晶國泰97購01,1.60,1.76,1.08,1.08,-0.72,-40.0,658000,20,1079320,0,0,0,0,0,0,610000,428000,182000,182000
20200316,707915,中美晶富邦97購02,0.32,0.34,0.25,0.25,-0.08,-24.24,72000,9,21620,0,0,0,0,0,0,0,72000,-72000,-72000
20200316,707916,聯亞富邦98購01,0.45,0.45,0.41,0.42,-0.01,-2.33,370000,14,162400,0,0,0,0,0,0,320000,25000,295000,295000
20200316,707917,中美晶麥證96購01,0.84,0.84,0.84,0.84,-0.04,-4.55,51000,1,42840,51000,0,51000,0,0,0,51000,51000,0,0
20200316,707918,合晶麥證96購01,0.11,0.11,0.11,0.11,-0.04,-26.67,10000,1,1100,10000,0,10000,0,0,0,10000,0,10000,10000
20200316,707919,櫃200第一96購03,,,,,,0.00,0,0,0,0,0,0,0,0,0,0,0,0,0
20200316,707920,櫃200第一96購04,,,,,,0.00,0,0,0,0,0,0,0,0,0,0,0,0,0
20200316,707921,譜瑞兆豐96購01,1.50,1.80,1.43,1.43,-0.18,-11.18,552000,22,925470,0,0,0,0,0,0,155000,397000,-242000,-242000
20200316,707922,雍智康和96購01,,,,,,0.00,0,0,0,0,0,0,0,0,0,0,0,0,0
20200316,707923,力旺群益97購01,0.08,0.08,0.07,0.08,-0.04,-33.33,650000,9,50000,0,0,0,0,0,0,30000,620000,-590000,-590000
20200316,707924,中美晶群益97購01,0.43,0.43,0.24,0.25,-0.17,-40.48,808000,25,242470,0,0,0,0,0,0,689000,105000,584000,584000
20200316,707925,信驊群益96購01,2.94,3.20,2.10,2.10,-0.15,-6.67,37000,5,103800,0,0,0,0,0,0,16000,21000,-5000,-5000
20200316,707926,雍智群益96購01,,,,,,0.00,0,0,0,0,0,0,0,0,0,0,0,0,0
20200316,707927,碩禾群益97購01,0.16,0.16,0.16,0.16,-0.14,-46.67,22000,1,3520,0,0,0,0,0,0,22000,22000,0,0
20200316,707928,環球晶群益97購02,1.52,1.52,0.99,0.99,-0.16,-13.91,82000,5,90980,0,0,0,0,0,0,72000,10000,62000,62000
20200316,707929,凡甲元大98購01,0.76,0.79,0.71,0.71,-0.02,-2.74,98000,9,73920,0,0,0,0,0,0,55000,43000,12000,12000
20200316,707930,雍智元大97購01,0.80,0.80,0.55,0.55,-0.14,-20.29,20000,2,13500,0,0,0,0,0,0,10000,10000,0,0
20200316,707931,力旺統一96購01,0.06,0.06,0.06,0.06,-0.14,-70.0,9000,1,540,0,0,0,0,0,0,9000,0,9000,9000
20200316,707932,雍智統一97購01,0.38,0.38,0.35,0.35,+0.02,6.06,40000,2,14300,0,0,0,0,0,0,40000,0,40000,40000
20200316,707933,新普中信96購01,,,,,,0.00,0,0,0,0,0,0,0,0,0,0,0,0,0
20200316,707934,雍智中信96購01,0.10,0.10,0.10,0.10,-0.03,-23.08,5000,1,500,0,0,0,0,0,0,0,5000,-5000,-5000
20200316,707935,大江國票97購03,,,,,,0.00,0,0,0,0,0,0,0,0,0,0,0,0,0
20200316,707936,世界國票97購02,,,,,,0.00,0,0,0,0,0,0,0,0,0,0,0,0,0
20200316,707937,雍智國票96購01,0.32,0.32,0.32,0.32,-0.10,-23.81,30000,1,9600,0,0,0,0,0,0,30000,0,30000,30000
20200316,707938,雙鴻國票97購01,0.03,0.03,0.03,0.03,-0.01,-25.0,1206000,5,36180,0,0,0,0,0,0,1206000,0,1206000,1206000
20200316,707939,鈺太國票97購01,0.27,0.28,0.27,0.28,+0.10,55.56,40000,4,11000,0,0,0,0,0,0,0,40000,-40000,-40000
20200316,707940,弘塑凱基97購01,0.22,0.22,0.22,0.22,0.00,0.0,80000,2,17600,0,0,0,0,0,0,0,0,0,0
20200316,707941,同致凱基97購01,,,,,,0.00,0,0,0,0,0,0,0,0,0,0,0,0,0
20200316,707942,神盾凱基98購01,,,,,,0.00,0,0,0,0,0,0,0,0,0,0,0,0,0
20200316,707943,雍智凱基96購01,0.17,0.17,0.17,0.17,-0.12,-41.38,5000,1,850,0,0,0,0,0,0,0,5000,-5000,-5000
20200316,707944,廣明凱基96購01,,,,,,0.00,0,0,0,0,0,0,0,0,0,0,0,0,0
20200316,707945,環球晶凱基96購05,,,,,,0.00,0,0,0,0,0,0,0,0,0,0,0,0,0
20200316,707946,鈊象凱基96購03,4.82,4.89,3.62,3.62,-0.85,-19.02,36000,17,173150,0,0,0,0,0,0,35000,1000,34000,34000
20200316,707947,力旺麥證96購01,,,,,,0.00,0,0,0,0,0,0,0,0,0,0,0,0,0
20200316,707948,威剛國泰97購01,1.32,1.32,1.32,1.32,+0.03,2.33,1000,1,1320,0,0,0,0,0,0,1000,0,1000,1000
20200316,707949,群聯國泰98購01,,,,,,0.00,0,0,0,0,0,0,0,0,0,0,0,0,0
20200316,707950,雍智國泰98購01,0.70,0.70,0.45,0.46,-0.22,-32.35,691000,10,441530,0,0,0,0,0,0,476000,215000,261000,261000
20200316,707951,精測元富99購01,0.17,0.17,0.17,0.17,+0.04,30.77,350000,1,59500,0,0,0,0,0,0,0,350000,-350000,-350000
20200316,707952,聯亞元富96購02,0.69,0.69,0.69,0.69,+0.23,50.0,10000,1,6900,0,0,0,0,0,0,10000,0,10000,10000
20200316,707953,力旺台新97購01,0.06,0.06,0.06,0.06,-0.07,-53.85,20000,1,1200,0,0,0,0,0,0,20000,0,20000,20000
20200316,707954,世界台新97購02,0.79,0.79,0.73,0.73,-0.15,-17.05,138000,3,104880,0,0,0,0,0,0,100000,38000,62000,62000
20200316,707955,櫃200永昌97購01,,,,,,0.00,0,0,0,0,0,0,0,0,0,0,0,0,0
20200316,707956,櫃200永昌99購01,,,,,,0.00,0,0,0,0,0,0,0,0,0,0,0,0,0
20200316,707957,櫃200永昌99購02,,,,,,0.00,0,0,0,0,0,0,0,0,0,0,0,0,0
20200316,707958,櫃200永昌99購03,,,,,,0.00,0,0,0,0,0,0,0,0,0,0,0,0,0
20200316,707959,久元永豐96購01,0.45,0.45,0.41,0.41,-0.13,-24.07,30000,2,12700,0,0,0,0,0,0,20000,10000,10000,10000
20200316,707960,立端永豐96購01,0.19,0.19,0.18,0.18,+0.02,12.5,73000,3,13740,0,0,0,0,0,0,73000,0,73000,73000
20200316,707961,良維永豐96購03,,,,,,0.00,0,0,0,0,0,0,0,0,0,0,0,0,0
20200316,707962,宜鼎永豐96購01,,,,,,0.00,0,0,0,0,0,0,0,0,0,0,0,0,0
20200316,707963,皇田永豐96購01,,,,,,0.00,0,0,0,0,0,0,0,0,0,0,0,0,0
20200316,707964,美琪瑪永豐96購01,,,,,,0.00,0,0,0,0,0,0,0,0,0,0,0,0,0
20200316,707965,雍智永豐96購01,,,,,,0.00,0,0,0,0,0,0,0,0,0,0,0,0,0
20200316,707966,穩懋統一96購08,0.30,0.30,0.30,0.30,-0.14,-31.82,10000,1,3000,0,0,0,0,0,0,10000,0,10000,10000
20200316,707967,穩懋統一96購09,0.47,0.47,0.47,0.47,-0.03,-6.0,5000,1,2350,0,0,0,0,0,0,5000,0,5000,5000
20200316,707968,穩懋統一96購10,0.59,0.75,0.59,0.75,+0.38,102.7,15000,2,10450,0,0,0,0,0,0,5000,10000,-5000,-5000
20200316,707969,穩懋統一97購03,,,,,,0.00,0,0,0,0,0,0,0,0,0,0,0,0,0
20200316,707970,鈊象統一97購03,5.90,5.90,5.60,5.60,+1.08,23.89,60000,4,351000,0,0,0,0,0,0,60000,0,60000,60000
20200316,707971,中美晶中信96購01,0.62,0.62,0.62,0.62,+0.22,55.0,5000,1,3100,0,0,0,0,0,0,5000,0,5000,5000
20200316,707972,同致中信98購01,0.06,0.06,0.06,0.06,-0.04,-40.0,20000,2,1200,0,0,0,0,0,0,0,20000,-20000,-20000
20200316,707973,環球晶中信9C購01,0.63,0.64,0.44,0.44,-0.24,-35.29,163000,17,93550,0,0,0,0,0,0,28000,135000,-107000,-107000
20200316,707974,世界凱基96購03,,,,,,0.00,0,0,0,0,0,0,0,0,0,0,0,0,0
20200316,707975,金居凱基96購02,,,,,,0.00,0,0,0,0,0,0,0,0,0,0,0,0,0
20200316,707976,環球晶凱基96購06,0.89,0.89,0.60,0.60,0.00,0.0,60000,5,44200,0,0,0,0,0,0,30000,30000,0,0
20200316,707977,穩懋凱基96購10,0.46,0.48,0.34,0.34,-0.04,-10.53,240000,23,104200,0,0,0,0,0,0,220000,20000,200000,200000
20200316,707978,大江群益97購01,,,,,,0.00,0,0,0,0,0,0,0,0,0,0,0,0,0
20200316,707979,原相群益98購01,1.17,1.17,0.86,0.86,-0.13,-13.13,22000,3,22150,0,0,0,0,0,0,21000,0,21000,21000
20200316,707980,弘塑國票97購01,0.35,0.35,0.20,0.20,-0.10,-33.33,75000,11,23760,0,0,0,0,0,0,65000,10000,55000,55000
20200316,707981,宜鼎國票97購02,1.82,2.05,1.69,1.69,+0.49,40.83,498000,6,902660,0,0,0,0,0,0,488000,10000,478000,478000
20200316,707982,昂寶國票97購03,,,,,,0.00,0,0,0,0,0,0,0,0,0,0,0,0,0
20200316,707983,環球晶國票97購01,1.66,1.66,1.09,1.09,-0.70,-39.11,600000,9,852000,0,0,0,0,0,0,600000,0,600000,600000
20200316,707984,緯軟國泰97購01,,,,,,0.00,0,0,0,0,0,0,0,0,0,0,0,0,0
20200316,707985,櫃200永昌9B購01,,,,,,0.00,0,0,0,0,0,0,0,0,0,0,0,0,0
20200316,707986,櫃200永昌9C購01,,,,,,0.00,0,0,0,0,0,0,0,0,0,0,0,0,0
20200316,707987,櫃200永昌9C購02,,,,,,0.00,0,0,0,0,0,0,0,0,0,0,0,0,0
20200316,707988,櫃200永昌9C購03,2.66,2.66,1.92,1.92,-0.65,-25.29,12000,4,27840,0,0,0,0,0,0,9000,3000,6000,6000
20200316,707989,大宇資第一96購01,,,,,,0.00,0,0,0,0,0,0,0,0,0,0,0,0,0
20200316,707990,凡甲永豐96購01,,,,,,0.00,0,0,0,0,0,0,0,0,0,0,0,0,0
20200316,707991,弘塑永豐96購01,,,,,,0.00,0,0,0,0,0,0,0,0,0,0,0,0,0
20200316,707992,昇達科永豐96購01,,,,,,0.00,0,0,0,0,0,0,0,0,0,0,0,0,0
20200316,707993,波若威永豐97購01,,,,,,0.00,0,0,0,0,0,0,0,0,0,0,0,0,0
20200316,707994,威剛永豐96購02,0.26,0.33,0.14,0.14,-0.14,-50.0,533000,28,123090,0,0,0,0,0,0,157000,383000,-226000,-226000
20200316,707995,原相永豐96購01,0.40,0.44,0.27,0.27,-0.18,-40.0,426000,30,168290,0,0,0,0,0,0,59000,367000,-308000,-308000
20200316,707996,神盾永豐96購01,,,,,,0.00,0,0,0,0,0,0,0,0,0,0,0,0,0
20200316,707997,網龍永豐96購02,,,,,,0.00,0,0,0,0,0,0,0,0,0,0,0,0,0
20200316,707998,廣明永豐96購02,,,,,,0.00,0,0,0,0,0,0,0,0,0,0,0,0,0
20200316,707999,聯亞永豐96購01,,,,,,0.00,0,0,0,0,0,0,0,0,0,0,0,0,0
20200316,708000,雙鴻永豐97購01,,,,,,0.00,0,0,0,0,0,0,0,0,0,0,0,0,0
20200316,708001,世界元大96購05,0.69,0.69,0.54,0.54,-0.17,-23.94,253000,17,158490,0,0,0,0,0,0,173000,188000,-15000,-15000
20200316,708002,合晶元大97購02,0.11,0.11,0.11,0.11,0.00,0.0,20000,1,2200,0,0,0,0,0,0,20000,0,20000,20000
20200316,708003,宜鼎元大96購01,0.77,0.87,0.68,0.74,-0.03,-3.9,190000,8,150200,0,0,0,0,0,0,160000,30000,130000,130000
20200316,708004,雍智元大97購02,0.53,0.55,0.37,0.37,-0.14,-27.45,70000,7,34000,0,0,0,0,0,0,50000,20000,30000,30000
20200316,708005,精測元大97購03,0.20,0.20,0.20,0.20,0.00,0.0,10000,1,2000,0,0,0,0,0,0,10000,0,10000,10000
20200316,708006,精華元大96購03,0.04,0.04,0.04,0.04,-0.02,-33.33,1000,1,40,0,0,0,0,0,0,1000,1000,0,0
20200316,708007,雍智元富96購01,0.23,0.30,0.19,0.19,-0.07,-26.92,485000,8,124800,0,0,0,0,0,0,310000,175000,135000,135000
20200316,708008,精測元富96購03,0.12,0.12,0.10,0.10,+0.04,66.67,710000,35,82000,0,0,0,0,0,0,700000,10000,690000,690000
20200316,708009,精測台新96購01,0.02,0.02,0.02,0.02,-0.01,-33.33,20000,1,400,0,0,0,0,0,0,20000,0,20000,20000
20200316,708010,璟德台新96購01,,,,,,0.00,0,0,0,0,0,0,0,0,0,0,0,0,0
20200316,708011,良維兆豐97購01,0.60,0.60,0.58,0.58,+0.08,16.0,35000,3,20700,0,0,0,0,0,0,20000,15000,5000,5000
20200316,708012,聚積兆豐97購01,,,,,,0.00,0,0,0,0,0,0,0,0,0,0,0,0,0
20200316,708013,廣明兆豐96購01,0.16,0.16,0.14,0.14,0.00,0.0,290000,3,44600,0,0,0,0,0,0,290000,0,290000,290000
20200316,708014,聯亞兆豐97購01,1.72,1.72,1.40,1.40,+0.24,20.69,11000,2,16360,0,0,0,0,0,0,0,11000,-11000,-11000
20200316,708015,鈺太康和96購01,,,,,,0.00,0,0,0,0,0,0,0,0,0,0,0,0,0
20200316,708016,新普群益98購02,,,,,,0.00,0,0,0,0,0,0,0,0,0,0,0,0,0
20200316,708017,精測群益96購06,,,,,,0.00,0,0,0,0,0,0,0,0,0,0,0,0,0
20200316,708018,雙鴻群益98購01,0.09,0.09,0.08,0.08,0.00,0.0,445000,3,36100,0,0,0,0,0,0,395000,50000,345000,345000
20200316,708019,世界麥證96購01,,,,,,0.00,0,0,0,0,0,0,0,0,0,0,0,0,0
20200316,708020,世界元富96購02,0.38,0.38,0.38,0.38,+0.03,8.57,5000,1,1900,0,0,0,0,0,0,5000,0,5000,5000
20200316,708021,勝麗元富96購01,,,,,,0.00,0,0,0,0,0,0,0,0,0,0,0,0,0
20200316,708022,璟德元富96購01,0.14,0.14,0.13,0.13,-0.03,-18.75,150000,9,20500,0,0,0,0,0,0,50000,70000,-20000,-20000
20200316,708023,鈺太元富96購01,0.16,0.18,0.16,0.18,+0.04,28.57,105000,2,18000,0,0,0,0,0,0,0,105000,-105000,-105000
20200316,708024,金居中信9C購01,0.14,0.14,0.14,0.14,+0.02,16.67,50000,3,7000,0,0,0,0,0,0,20000,30000,-10000,-10000
20200316,708025,勝麗中信9A購01,0.11,0.11,0.10,0.10,-0.02,-16.67,220000,2,24000,0,0,0,0,0,0,220000,0,220000,220000
20200316,708026,群聯永豐96購01,0.10,0.10,0.02,0.02,-0.07,-77.78,211000,11,8750,0,0,0,0,0,0,120000,91000,29000,29000
20200316,708027,精測永豐96購10,,,,,,0.00,0,0,0,0,0,0,0,0,0,0,0,0,0
20200316,708028,鈺太永豐96購01,0.12,0.12,0.12,0.12,-0.03,-20.0,5000,1,600,0,0,0,0,0,0,5000,0,5000,5000
20200316,708029,旺矽國票97購01,0.12,0.12,0.12,0.12,+0.02,20.0,100000,10,12000,0,0,0,0,0,0,0,100000,-100000,-100000
20200316,708030,精華國票97購01,,,,,,0.00,0,0,0,0,0,0,0,0,0,0,0,0,0
20200316,708031,中美晶凱基96購04,1.48,1.48,1.12,1.12,-0.02,-1.75,25000,5,30840,0,0,0,0,0,0,14000,13000,1000,1000
20200316,708032,六角凱基97購01,,,,,,0.00,0,0,0,0,0,0,0,0,0,0,0,0,0
20200316,708033,昂寶凱基97購01,,,,,,0.00,0,0,0,0,0,0,0,0,0,0,0,0,0
20200316,708034,勝麗凱基96購01,,,,,,0.00,0,0,0,0,0,0,0,0,0,0,0,0,0
20200316,708035,博智凱基96購01,4.23,4.77,4.23,4.51,+1.38,44.09,199000,22,888360,0,0,0,0,0,0,68000,131000,-63000,-63000
20200316,708036,優群凱基98購01,0.69,0.76,0.59,0.63,-0.01,-1.56,409000,38,283910,0,0,0,0,0,0,123000,399000,-276000,-276000
20200316,708037,環球晶凱基96購07,1.55,1.55,1.44,1.44,-0.35,-19.55,515000,4,759200,0,0,0,0,0,0,340000,185000,155000,155000
20200316,708038,穩懋凱基96購11,1.08,1.09,0.83,0.83,+0.38,84.44,13000,3,13810,0,0,0,0,0,0,0,13000,-13000,-13000
20200316,708039,宣德國泰98購01,0.31,0.31,0.24,0.24,-0.04,-14.29,4000,2,1170,0,0,0,0,0,0,4000,0,4000,4000
20200316,708040,雍智國泰98購02,1.01,1.11,0.71,0.71,-0.34,-32.38,215000,6,189940,0,0,0,0,0,0,91000,124000,-33000,-33000
20200316,708041,精測國泰98購04,0.24,0.24,0.19,0.19,0.00,0.0,55000,2,10700,0,0,0,0,0,0,50000,5000,45000,45000
20200316,708042,精測國泰99購01,0.21,0.23,0.21,0.23,+0.07,43.75,60000,3,12680,0,0,0,0,0,0,60000,0,60000,60000
20200316,708043,精測國泰9A購01,0.26,0.26,0.20,0.20,-0.05,-20.0,520000,13,123260,0,0,0,0,0,0,431000,0,431000,431000
20200316,708044,雙鴻富邦97購02,,,,,,0.00,0,0,0,0,0,0,0,0,0,0,0,0,0
20200316,708045,大江元大97購02,,,,,,0.00,0,0,0,0,0,0,0,0,0,0,0,0,0
20200316,708046,中美晶元大96購03,0.38,0.43,0.38,0.40,+0.01,2.56,21000,3,8680,0,0,0,0,0,0,1000,21000,-20000,-20000
20200316,708047,世界元大96購06,,,,,,0.00,0,0,0,0,0,0,0,0,0,0,0,0,0
20200316,708048,合晶元大96購05,0.24,0.24,0.18,0.18,+0.01,5.88,20000,2,4200,0,0,0,0,0,0,0,20000,-20000,-20000
20200316,708049,信驊元大96購01,1.20,1.26,0.83,0.88,-0.16,-15.38,430000,29,460080,0,0,0,0,0,0,228000,202000,26000,26000
20200316,708050,雍智元大96購01,0.35,0.35,0.35,0.35,-0.07,-16.67,1000,1,350,0,0,0,0,0,0,0,1000,-1000,-1000
20200316,708051,精測元大96購04,,,,,,0.00,0,0,0,0,0,0,0,0,0,0,0,0,0
20200316,708052,穩懋元大96購05,0.71,0.74,0.63,0.63,+0.29,85.29,130000,13,93000,0,0,0,0,0,0,90000,130000,-40000,-40000
20200316,708053,鈺太元大97購02,0.49,0.49,0.39,0.39,+0.04,11.43,35000,4,15850,0,0,0,0,0,0,5000,30000,-25000,-25000
20200316,708054,力旺元富96購01,0.05,0.05,0.05,0.05,-0.03,-37.5,98000,1,4900,0,0,0,0,0,0,98000,0,98000,98000
20200316,708055,金可中信9A購01,,,,,,0.00,0,0,0,0,0,0,0,0,0,0,0,0,0
20200316,708056,聖暉統一99購01,,,,,,0.00,0,0,0,0,0,0,0,0,0,0,0,0,0
20200316,708057,大江凱基98購01,0.10,0.10,0.10,0.10,+0.02,25.0,10000,1,1000,0,0,0,0,0,0,0,10000,-10000,-10000
20200316,708058,良維凱基98購01,,,,,,0.00,0,0,0,0,0,0,0,0,0,0,0,0,0
20200316,708059,旺矽凱基98購01,0.11,0.11,0.11,0.11,+0.07,175.0,20000,1,2200,0,0,0,0,0,0,20000,0,20000,20000
20200316,708060,信驊凱基96購02,0.73,0.73,0.55,0.55,-0.05,-8.33,1533000,11,923450,0,0,0,0,0,0,402000,1131000,-729000,-729000
20200316,708061,雍智凱基98購01,0.17,0.17,0.17,0.17,-0.10,-37.04,25000,1,4250,0,0,0,0,0,0,25000,0,25000,25000
20200316,708062,精測凱基99購01,0.15,0.15,0.15,0.15,+0.03,25.0,32000,2,4800,0,0,0,0,0,0,0,0,0,0
20200316,708063,緯軟凱基98購01,,,,,,0.00,0,0,0,0,0,0,0,0,0,0,0,0,0
20200316,708064,環球晶凱基96購08,0.48,0.48,0.48,0.48,-0.02,-4.0,10000,1,4800,0,0,0,0,0,0,0,10000,-10000,-10000
20200316,708065,力旺永豐96購02,0.08,0.08,0.07,0.07,-0.06,-46.15,76000,2,5780,0,0,0,0,0,0,46000,30000,16000,16000
20200316,708066,同致永豐96購01,,,,,,0.00,0,0,0,0,0,0,0,0,0,0,0,0,0
20200316,708067,迅得永豐97購02,,,,,,0.00,0,0,0,0,0,0,0,0,0,0,0,0,0
20200316,708068,欣銓永豐96購01,,,,,,0.00,0,0,0,0,0,0,0,0,0,0,0,0,0
20200316,708069,弘塑康和9C購01,0.37,0.37,0.31,0.31,0.00,0.0,269000,6,97030,0,0,0,0,0,0,255000,14000,241000,241000
20200316,708070,大田群益96購01,,,,,,0.00,0,0,0,0,0,0,0,0,0,0,0,0,0
20200316,708071,合晶群益96購02,,,,,,0.00,0,0,0,0,0,0,0,0,0,0,0,0,0
20200316,708072,信昌電群益96購02,0.15,0.15,0.15,0.15,-0.10,-40.0,40000,1,6000,0,0,0,0,0,0,40000,0,40000,40000
20200316,708073,茂達群益98購01,0.29,0.29,0.26,0.26,0.00,0.0,20000,2,5500,0,0,0,0,0,0,10000,10000,0,0
20200316,708074,大宇資國票97購02,0.13,0.13,0.09,0.09,-0.06,-40.0,61000,7,7190,0,0,0,0,0,0,0,61000,-61000,-61000
20200316,708075,雙鴻國票97購02,,,,,,0.00,0,0,0,0,0,0,0,0,0,0,0,0,0
20200316,708076,力旺國泰98購01,0.10,0.12,0.10,0.10,-0.06,-37.5,448000,6,46000,0,0,0,0,0,0,378000,70000,308000,308000
20200316,708077,威剛富邦98購01,0.27,0.27,0.24,0.24,-0.03,-11.11,14000,3,3720,0,0,0,0,0,0,2000,12000,-10000,-10000
20200316,708078,勝麗富邦97購01,,,,,,0.00,0,0,0,0,0,0,0,0,0,0,0,0,0
20200316,708079,群聯富邦98購01,0.22,0.22,0.17,0.17,-0.02,-10.53,68000,6,13020,0,0,0,0,0,0,0,50000,-50000,-50000
20200316,708080,精測富邦97購01,,,,,,0.00,0,0,0,0,0,0,0,0,0,0,0,0,0
20200316,708081,信驊元大96購02,1.78,1.78,1.78,1.78,-0.47,-20.89,1000,1,1780,0,0,0,0,0,0,0,1000,-1000,-1000
20200316,708082,新普元大97購01,0.71,0.71,0.47,0.47,-0.10,-17.54,224000,18,130610,0,0,0,0,0,0,130000,94000,36000,36000
20200316,708083,環球晶元大96購03,0.92,0.92,0.92,0.92,+0.06,6.98,20000,1,18400,0,0,0,0,0,0,20000,0,20000,20000
20200316,708084,環球晶元大97購01,1.34,1.45,0.86,0.86,-0.57,-39.86,132000,22,155410,0,0,0,0,0,0,37000,92000,-55000,-55000
20200316,708085,穩懋元大96購06,0.40,0.40,0.24,0.24,+0.06,33.33,14000,3,4760,0,0,0,0,0,0,10000,4000,6000,6000
20200316,708086,穩懋元大96購07,,,,,,0.00,0,0,0,0,0,0,0,0,0,0,0,0,0
20200316,708087,群聯元富96購03,0.55,0.55,0.37,0.46,-0.14,-23.33,469000,11,214030,0,0,0,0,0,0,65000,404000,-339000,-339000
20200316,708088,群聯兆豐97購01,0.78,0.78,0.78,0.78,-0.16,-17.02,20000,1,15600,0,0,0,0,0,0,20000,20000,0,0
20200316,708089,精測兆豐97購03,0.18,0.19,0.18,0.18,+0.02,12.5,40000,8,7300,0,0,0,0,0,0,40000,0,40000,40000
20200316,708090,穩懋兆豐96購04,0.45,0.45,0.45,0.45,0.00,0.0,81000,2,36450,0,0,0,0,0,0,0,81000,-81000,-81000
20200316,708091,久元康和96購01,0.48,0.48,0.48,0.48,+0.01,2.13,50000,1,24000,0,0,0,0,0,0,50000,0,50000,50000
20200316,708092,櫃200永昌98購01,0.24,0.24,0.24,0.24,0.00,0.0,1000,1,240,0,0,0,0,0,0,0,0,0,0
20200316,708093,櫃200永昌98購02,,,,,,0.00,0,0,0,0,0,0,0,0,0,0,0,0,0
20200316,708094,大學光群益98購01,,,,,,0.00,0,0,0,0,0,0,0,0,0,0,0,0,0
20200316,708095,VHQ中信96購01,0.06,0.06,0.06,0.06,-0.03,-33.33,20000,2,1200,0,0,0,0,0,0,0,20000,-20000,-20000
20200316,708096,合晶中信9A購01,0.17,0.18,0.17,0.17,0.00,0.0,310000,6,53700,0,0,0,0,0,0,100000,210000,-110000,-110000
20200316,708097,宣德中信9A購02,0.15,0.15,0.11,0.11,-0.02,-15.38,139000,5,20150,0,0,0,0,0,0,0,129000,-129000,-129000
20200316,708098,群聯中信9A購01,,,,,,0.00,0,0,0,0,0,0,0,0,0,0,0,0,0
20200316,708099,M31凱基97購02,,,,,,0.00,0,0,0,0,0,0,0,0,0,0,0,0,0
20200316,708100,大江凱基96購03,,,,,,0.00,0,0,0,0,0,0,0,0,0,0,0,0,0
20200316,708101,合晶凱基97購01,,,,,,0.00,0,0,0,0,0,0,0,0,0,0,0,0,0
20200316,708102,良維凱基97購01,,,,,,0.00,0,0,0,0,0,0,0,0,0,0,0,0,0
20200316,708103,宜鼎凱基96購02,1.05,1.05,1.05,1.05,+0.26,32.91,20000,1,21000,0,0,0,0,0,0,20000,20000,0,0
20200316,708104,晶焱凱基98購01,0.18,0.18,0.18,0.18,-0.01,-5.26,100000,1,18000,0,0,0,0,0,0,0,100000,-100000,-100000
20200316,708105,旺矽統一97購01,,,,,,0.00,0,0,0,0,0,0,0,0,0,0,0,0,0
20200316,708106,宣德統一97購02,,,,,,0.00,0,0,0,0,0,0,0,0,0,0,0,0,0
20200316,708107,大江永豐96購03,,,,,,0.00,0,0,0,0,0,0,0,0,0,0,0,0,0
20200316,708108,昂寶永豐96購02,,,,,,0.00,0,0,0,0,0,0,0,0,0,0,0,0,0
20200316,708109,昇達科永豐96購02,,,,,,0.00,0,0,0,0,0,0,0,0,0,0,0,0,0
20200316,708110,博智永豐96購02,1.28,1.51,1.25,1.37,+0.07,5.38,336000,38,471350,0,0,0,0,0,0,109000,219000,-110000,-110000
20200316,708111,新鉅科永豐96購01,,,,,,0.00,0,0,0,0,0,0,0,0,0,0,0,0,0
20200316,708112,晟德永豐96購01,,,,,,0.00,0,0,0,0,0,0,0,0,0,0,0,0,0
20200316,708113,世界元大96購07,0.59,0.59,0.58,0.58,-0.09,-13.43,22000,2,12960,0,0,0,0,0,0,20000,2000,18000,18000
20200316,708114,良維元大97購02,,,,,,0.00,0,0,0,0,0,0,0,0,0,0,0,0,0
20200316,708115,佳邦元大96購01,,,,,,0.00,0,0,0,0,0,0,0,0,0,0,0,0,0
20200316,708116,昂寶元大96購03,,,,,,0.00,0,0,0,0,0,0,0,0,0,0,0,0,0
20200316,708117,廣明元大97購01,,,,,,0.00,0,0,0,0,0,0,0,0,0,0,0,0,0
20200316,708118,環球晶元大96購04,0.77,0.77,0.77,0.77,+0.01,1.32,20000,1,15400,0,0,0,0,0,0,20000,0,20000,20000
20200316,708119,環球晶元大97購02,0.52,0.52,0.48,0.48,-0.02,-4.0,30000,3,15520,0,0,0,0,0,0,30000,0,30000,30000
20200316,708120,穩懋元大96購10,0.52,0.54,0.44,0.44,+0.19,76.0,70000,7,36100,0,0,0,0,0,0,70000,60000,10000,10000
20200316,708121,M31國票97購01,0.12,0.12,0.12,0.12,-0.01,-7.69,30000,3,3600,0,0,0,0,0,0,0,30000,-30000,-30000
20200316,708122,六角國票98購02,0.50,0.55,0.50,0.53,+0.03,6.0,50000,7,26280,0,0,0,0,0,0,40000,10000,30000,30000
20200316,708123,原相國票97購01,0.94,1.03,0.68,0.68,-0.32,-32.0,439000,9,409290,0,0,0,0,0,0,437000,0,437000,437000
20200316,708124,神盾國票97購02,,,,,,0.00,0,0,0,0,0,0,0,0,0,0,0,0,0
20200316,708125,碩禾國票97購01,0.50,0.50,0.30,0.30,-0.21,-41.18,50000,5,21300,0,0,0,0,0,0,0,50000,-50000,-50000
20200316,708126,環宇國票97購01,,,,,,0.00,0,0,0,0,0,0,0,0,0,0,0,0,0
20200316,708127,昂寶國泰98購01,,,,,,0.00,0,0,0,0,0,0,0,0,0,0,0,0,0
20200316,708128,環球晶國泰97購02,1.14,1.31,0.67,0.67,-0.67,-50.0,1040000,36,1240150,0,0,0,0,0,0,989000,531000,458000,458000
20200316,708129,力旺元大96購01,,,,,,0.00,0,0,0,0,0,0,0,0,0,0,0,0,0
20200316,708130,台燿元大96購02,0.21,0.21,0.21,0.21,-0.03,-12.5,8000,1,1680,0,0,0,0,0,0,0,8000,-8000,-8000
20200316,708131,泰博元大96購01,1.85,2.24,1.85,1.98,+0.14,7.61,139000,15,282810,0,0,0,0,0,0,85000,52000,33000,33000
20200316,708132,博智元大97購01,3.61,3.97,3.61,3.97,+0.79,24.84,42000,6,160830,0,0,0,0,0,0,7000,35000,-28000,-28000
20200316,708133,網家元大96購01,0.59,0.59,0.36,0.36,-0.11,-23.4,182000,18,92470,0,0,0,0,0,0,69000,113000,-44000,-44000
20200316,708134,穩懋元大96購11,0.60,0.60,0.60,0.60,+0.30,100.0,15000,1,9000,0,0,0,0,0,0,15000,0,15000,15000
20200316,708135,群聯群益96購04,,,,,,0.00,0,0,0,0,0,0,0,0,0,0,0,0,0
20200316,708136,宇峻凱基98購02,0.43,0.43,0.35,0.35,-0.03,-7.89,106000,2,45100,0,0,0,0,0,0,100000,6000,94000,94000
20200316,708137,旺矽凱基97購01,,,,,,0.00,0,0,0,0,0,0,0,0,0,0,0,0,0
20200316,708138,原相凱基98購01,1.17,1.19,0.94,0.94,-0.26,-21.67,39000,12,40580,0,0,0,0,0,0,7000,27000,-20000,-20000
20200316,708139,精華凱基97購01,0.10,0.10,0.10,0.10,0.00,0.0,1000,1,100,0,0,0,0,0,0,0,1000,-1000,-1000
20200316,708140,優群凱基98購02,0.64,0.73,0.56,0.60,+0.05,9.09,285000,30,189290,0,0,0,0,0,0,110000,175000,-65000,-65000
20200316,708141,鈊象凱基98購02,5.70,5.90,4.17,4.23,-1.07,-20.19,100000,34,514110,0,0,0,0,0,0,65000,78000,-13000,-13000
20200316,708142,宣德台新96購02,0.22,0.22,0.13,0.13,-0.01,-7.14,417000,5,55210,0,0,0,0,0,0,0,417000,-417000,-417000
20200316,708143,大江永豐97購01,,,,,,0.00,0,0,0,0,0,0,0,0,0,0,0,0,0
20200316,708144,杰力永豐96購01,,,,,,0.00,0,0,0,0,0,0,0,0,0,0,0,0,0
20200316,708145,直得永豐96購01,,,,,,0.00,0,0,0,0,0,0,0,0,0,0,0,0,0
20200316,708146,信昌電永豐96購02,0.53,0.53,0.53,0.53,+0.09,20.45,10000,1,5300,0,0,0,0,0,0,0,10000,-10000,-10000
20200316,708147,保瑞永豐96購01,0.70,0.74,0.64,0.64,+0.03,4.92,195000,5,137100,0,0,0,0,0,0,127000,68000,59000,59000
20200316,708148,胡連永豐96購01,,,,,,0.00,0,0,0,0,0,0,0,0,0,0,0,0,0
20200316,708149,精測永豐96購12,,,,,,0.00,0,0,0,0,0,0,0,0,0,0,0,0,0
20200316,708150,聚積永豐96購01,0.29,0.29,0.29,0.29,+0.05,20.83,2000,1,580,0,0,0,0,0,0,2000,0,2000,2000
20200316,708151,雙鴻永豐97購02,,,,,,0.00,0,0,0,0,0,0,0,0,0,0,0,0,0
20200316,708152,力旺中信96購01,0.02,0.02,0.02,0.02,-0.01,-33.33,30000,3,600,0,0,0,0,0,0,0,30000,-30000,-30000
20200316,708153,建榮統一98購01,,,,,,0.00,0,0,0,0,0,0,0,0,0,0,0,0,0
20200316,708154,大江凱基98購02,0.11,0.11,0.08,0.10,-0.01,-9.09,41000,4,3660,0,0,0,0,0,0,0,0,0,0
20200316,708155,宇峻凱基98購03,,,,,,0.00,0,0,0,0,0,0,0,0,0,0,0,0,0
20200316,708156,昂寶凱基97購02,,,,,,0.00,0,0,0,0,0,0,0,0,0,0,0,0,0
20200316,708157,金居凱基97購01,,,,,,0.00,0,0,0,0,0,0,0,0,0,0,0,0,0
20200316,708158,鐿鈦凱基96購03,,,,,,0.00,0,0,0,0,0,0,0,0,0,0,0,0,0
20200316,708159,大江元大97購03,,,,,,0.00,0,0,0,0,0,0,0,0,0,0,0,0,0
20200316,708160,合晶元大98購01,0.27,0.27,0.27,0.27,+0.05,22.73,10000,1,2700,0,0,0,0,0,0,0,10000,-10000,-10000
20200316,708161,昂寶元大96購04,,,,,,0.00,0,0,0,0,0,0,0,0,0,0,0,0,0
20200316,708162,欣銓元大96購01,0.23,0.23,0.23,0.23,-0.12,-34.29,11000,2,2530,0,0,0,0,0,0,6000,5000,1000,1000
20200316,708163,威剛元大98購01,0.38,0.39,0.30,0.30,-0.08,-21.05,118000,17,40540,0,0,0,0,0,0,11000,43000,-32000,-32000
20200316,708164,環球晶元大96購05,0.51,0.57,0.26,0.26,-0.30,-53.57,597000,63,273760,0,0,0,0,0,0,217000,350000,-133000,-133000
20200316,708165,環球晶元大97購03,0.69,0.73,0.42,0.42,-0.34,-44.74,546000,48,340090,0,0,0,0,0,0,160000,386000,-226000,-226000
20200316,708166,凡甲永豐96購02,1.07,1.17,0.98,0.98,-0.03,-2.97,375000,23,405950,0,0,0,0,0,0,253000,86000,167000,167000
20200316,708167,台燿永豐96購01,,,,,,0.00,0,0,0,0,0,0,0,0,0,0,0,0,0
20200316,708168,波若威永豐97購02,,,,,,0.00,0,0,0,0,0,0,0,0,0,0,0,0,0
20200316,708169,網家永豐96購01,0.26,0.26,0.26,0.26,+0.05,23.81,10000,1,2600,0,0,0,0,0,0,0,10000,-10000,-10000
20200316,708170,網龍永豐96購03,0.17,0.17,0.14,0.14,+0.02,16.67,40000,4,6440,0,0,0,0,0,0,20000,20000,0,0
20200316,708171,優群永豐96購03,1.35,1.53,1.35,1.48,+0.14,10.45,390000,22,571400,0,0,0,0,0,0,50000,199000,-149000,-149000
20200316,708172,緯軟兆豐97購01,,,,,,0.00,0,0,0,0,0,0,0,0,0,0,0,0,0
20200316,708173,鈺太兆豐97購01,0.14,0.14,0.14,0.14,+0.03,27.27,110000,3,15400,0,0,0,0,0,0,0,110000,-110000,-110000
20200316,708174,胡連康和96購02,,,,,,0.00,0,0,0,0,0,0,0,0,0,0,0,0,0
20200316,708175,精華群益96購02,,,,,,0.00,0,0,0,0,0,0,0,0,0,0,0,0,0
20200316,708176,中美晶國票97購02,0.64,0.64,0.35,0.35,-0.18,-33.96,70000,3,39400,0,0,0,0,0,0,60000,10000,50000,50000
20200316,708177,欣銓富邦97購01,,,,,,0.00,0,0,0,0,0,0,0,0,0,0,0,0,0
20200316,708178,鈊象富邦97購01,1.89,2.10,1.89,2.08,+0.22,11.83,4000,4,8160,0,0,0,0,0,0,3000,0,3000,3000
20200316,708179,神盾元富98購01,0.19,0.19,0.19,0.19,-0.01,-5.0,100000,1,19000,0,0,0,0,0,0,0,100000,-100000,-100000
20200316,708180,群聯元富96購04,,,,,,0.00,0,0,0,0,0,0,0,0,0,0,0,0,0
20200316,708181,VHQ統一96購01,0.11,0.11,0.11,0.11,-0.13,-54.17,55000,1,6050,0,0,0,0,0,0,55000,0,55000,55000
20200316,708182,凡甲統一96購01,0.99,0.99,0.99,0.99,+0.31,45.59,10000,1,9900,0,0,0,0,0,0,10000,0,10000,10000
20200316,708183,中美晶凱基96購05,1.30,1.30,1.27,1.27,+0.05,4.1,41000,3,52970,0,0,0,0,0,0,31000,41000,-10000,-10000
20200316,708184,建榮凱基96購02,,,,,,0.00,0,0,0,0,0,0,0,0,0,0,0,0,0
20200316,708185,原相凱基97購01,1.36,1.36,1.18,1.18,+0.07,6.31,2000,2,2540,0,0,0,0,0,0,2000,0,2000,2000
20200316,708186,神盾凱基96購03,,,,,,0.00,0,0,0,0,0,0,0,0,0,0,0,0,0
20200316,708187,金居兆豐97購01,0.25,0.27,0.21,0.21,-0.01,-4.55,93000,11,24220,0,0,0,0,0,0,88000,5000,83000,83000
20200316,708188,威剛兆豐97購01,0.78,0.78,0.49,0.49,-0.03,-5.77,56000,4,38680,0,0,0,0,0,0,30000,26000,4000,4000
20200316,708189,茂達群益98購02,,,,,,0.00,0,0,0,0,0,0,0,0,0,0,0,0,0
20200316,708190,六角元大96購02,0.31,0.32,0.24,0.24,-0.03,-11.11,105000,11,26700,0,0,0,0,0,0,5000,100000,-95000,-95000
20200316,708191,同致元大96購02,,,,,,0.00,0,0,0,0,0,0,0,0,0,0,0,0,0
20200316,708192,旺矽元大97購01,,,,,,0.00,0,0,0,0,0,0,0,0,0,0,0,0,0
20200316,708193,直得元大96購01,0.29,0.29,0.15,0.19,-0.10,-34.48,127000,9,30340,0,0,0,0,0,0,73000,53000,20000,20000
20200316,708194,宣德元大97購01,0.68,0.68,0.68,0.68,+0.10,17.24,10000,1,6800,0,0,0,0,0,0,10000,0,10000,10000
20200316,708195,精測元大96購07,,,,,,0.00,0,0,0,0,0,0,0,0,0,0,0,0,0
20200316,708196,環宇元大96購02,0.30,0.31,0.29,0.29,+0.04,16.0,32000,3,9580,0,0,0,0,0,0,12000,32000,-20000,-20000
20200316,708197,合晶亞東97購01,,,,,,0.00,0,0,0,0,0,0,0,0,0,0,0,0,0
20200316,708198,三貝德永豐96購01,0.04,0.04,0.04,0.04,+0.01,33.33,2000,1,80,0,0,0,0,0,0,0,0,0,0
20200316,708199,大田永豐96購02,,,,,,0.00,0,0,0,0,0,0,0,0,0,0,0,0,0
20200316,708200,中美晶永豐96購03,0.25,0.25,0.25,0.25,+0.11,78.57,1000,1,250,0,0,0,0,0,0,1000,0,1000,1000
20200316,708201,金居永豐96購02,0.29,0.29,0.27,0.27,+0.02,8.0,20000,2,5600,0,0,0,0,0,0,0,20000,-20000,-20000
20200316,708202,碩禾永豐96購01,,,,,,0.00,0,0,0,0,0,0,0,0,0,0,0,0,0
20200316,708203,雙鴻永豐96購02,,,,,,0.00,0,0,0,0,0,0,0,0,0,0,0,0,0
20200316,708204,昂寶元富96購01,1.49,1.49,1.49,1.49,+0.39,35.45,55000,1,81950,0,0,0,0,0,0,55000,0,55000,55000
20200316,708205,力旺台新97購02,,,,,,0.00,0,0,0,0,0,0,0,0,0,0,0,0,0
20200316,708206,大江國票97購04,,,,,,0.00,0,0,0,0,0,0,0,0,0,0,0,0,0
20200316,708207,大學光國票98購01,0.94,0.94,0.94,0.94,+0.06,6.82,10000,1,9400,0,0,0,0,0,0,10000,0,10000,10000
20200316,708208,勝麗國票97購03,,,,,,0.00,0,0,0,0,0,0,0,0,0,0,0,0,0
20200316,708209,博智國票97購01,4.43,4.93,4.43,4.93,+1.32,36.57,314000,3,1465520,0,0,0,0,0,0,314000,0,314000,314000
20200316,708210,閎康國票97購02,,,,,,0.00,0,0,0,0,0,0,0,0,0,0,0,0,0
20200316,708211,精華國票97購02,,,,,,0.00,0,0,0,0,0,0,0,0,0,0,0,0,0
20200316,708212,鈺太國泰96購01,0.21,0.30,0.21,0.25,+0.06,31.58,532000,7,139440,0,0,0,0,0,0,0,532000,-532000,-532000
20200316,708213,群聯富邦97購02,0.08,0.08,0.07,0.07,-0.07,-50.0,424000,7,33190,0,0,0,0,0,0,424000,0,424000,424000
20200316,708214,鈺太統一99購01,,,,,,0.00,0,0,0,0,0,0,0,0,0,0,0,0,0
20200316,708215,久元凱基96購01,0.35,0.35,0.30,0.30,+0.04,15.38,79000,2,24700,0,0,0,0,0,0,20000,59000,-39000,-39000
20200316,708216,勝麗凱基98購01,,,,,,0.00,0,0,0,0,0,0,0,0,0,0,0,0,0
20200316,708217,碩禾凱基98購01,0.23,0.23,0.15,0.15,-0.07,-31.82,125000,13,20500,0,0,0,0,0,0,5000,120000,-115000,-115000
20200316,708218,中美晶元富96購01,0.54,0.54,0.54,0.54,0.00,0.0,20000,1,10800,0,0,0,0,0,0,20000,20000,0,0
20200316,708219,新普元富96購01,1.68,1.77,1.56,1.56,-0.14,-8.24,80000,6,137800,0,0,0,0,0,0,50000,30000,20000,20000
20200316,708220,雙鴻台新97購01,,,,,,0.00,0,0,0,0,0,0,0,0,0,0,0,0,0
20200316,708221,VHQ康和96購01,,,,,,0.00,0,0,0,0,0,0,0,0,0,0,0,0,0
20200316,708222,網家康和96購01,,,,,,0.00,0,0,0,0,0,0,0,0,0,0,0,0,0
20200316,708223,台半群益96購01,,,,,,0.00,0,0,0,0,0,0,0,0,0,0,0,0,0
20200316,708224,良維群益96購01,,,,,,0.00,0,0,0,0,0,0,0,0,0,0,0,0,0
20200316,708225,昂寶群益98購01,,,,,,0.00,0,0,0,0,0,0,0,0,0,0,0,0,0
20200316,708226,信昌電群益96購03,,,,,,0.00,0,0,0,0,0,0,0,0,0,0,0,0,0
20200316,708227,鈊象群益99購04,,,,,,0.00,0,0,0,0,0,0,0,0,0,0,0,0,0
20200316,708228,波若威永豐96購01,,,,,,0.00,0,0,0,0,0,0,0,0,0,0,0,0,0
20200316,708229,中美晶亞東96購01,,,,,,0.00,0,0,0,0,0,0,0,0,0,0,0,0,0
20200316,708230,群聯亞東96購01,,,,,,0.00,0,0,0,0,0,0,0,0,0,0,0,0,0
20200316,708231,六角國票98購03,0.15,0.16,0.15,0.16,-0.01,-5.88,20000,4,3020,0,0,0,0,0,0,20000,0,20000,20000
20200316,708232,宜鼎國票97購03,1.01,1.17,1.01,1.05,+0.03,2.94,280000,3,292400,0,0,0,0,0,0,270000,10000,260000,260000
20200316,708233,宣德國票97購01,0.25,0.25,0.25,0.25,+0.05,25.0,20000,1,5000,0,0,0,0,0,0,20000,0,20000,20000
20200316,708234,神盾國票98購01,,,,,,0.00,0,0,0,0,0,0,0,0,0,0,0,0,0
20200316,708235,璟德國票97購01,0.37,0.37,0.24,0.24,-0.15,-38.46,40000,4,10900,0,0,0,0,0,0,40000,0,40000,40000
20200316,708236,優群國票97購01,0.93,1.09,0.85,0.85,+0.03,3.66,60000,11,59670,0,0,0,0,0,0,47000,10000,37000,37000
20200316,708237,環宇國票97購02,,,,,,0.00,0,0,0,0,0,0,0,0,0,0,0,0,0
20200316,708238,三貝德元大97購01,0.04,0.04,0.04,0.04,+0.01,33.33,27000,2,1080,0,0,0,0,0,0,0,0,0,0
20200316,708239,中美晶元大96購04,1.57,1.75,1.08,1.10,-0.53,-32.52,243000,24,361720,0,0,0,0,0,0,173000,173000,0,0
20200316,708240,宇峻元大97購02,0.80,0.97,0.69,0.69,-0.07,-9.21,1151000,97,1035270,0,0,0,0,0,0,515000,636000,-121000,-121000
20200316,708241,聯亞元大97購02,1.68,1.68,1.36,1.36,+0.06,4.62,82000,14,128600,0,0,0,0,0,0,5000,77000,-72000,-72000
20200316,708242,穩懋元大97購02,0.63,0.69,0.48,0.48,-0.05,-9.43,322000,35,207110,0,0,0,0,0,0,230000,222000,8000,8000
20200316,708243,譜瑞元大97購01,1.66,1.91,1.58,1.58,+0.07,4.64,61000,5,106360,0,0,0,0,0,0,31000,61000,-30000,-30000
20200316,708244,原相國泰98購02,,,,,,0.00,0,0,0,0,0,0,0,0,0,0,0,0,0
20200316,708245,勝麗國泰98購01,0.56,0.61,0.40,0.40,-0.17,-29.82,621000,10,341300,0,0,0,0,0,0,227000,394000,-167000,-167000
20200316,708246,網家國泰97購02,,,,,,0.00,0,0,0,0,0,0,0,0,0,0,0,0,0
20200316,708247,原相第一96購01,,,,,,0.00,0,0,0,0,0,0,0,0,0,0,0,0,0
20200316,708248,波若威凱基98購01,,,,,,0.00,0,0,0,0,0,0,0,0,0,0,0,0,0
20200316,708249,雙鴻凱基98購01,,,,,,0.00,0,0,0,0,0,0,0,0,0,0,0,0,0
20200316,708250,穩懋凱基96購12,0.18,0.18,0.18,0.18,-0.07,-28.0,4000,1,720,0,0,0,0,0,0,0,4000,-4000,-4000
20200316,708251,頎邦凱基97購01,0.46,0.46,0.42,0.42,-0.03,-6.67,100000,2,45200,0,0,0,0,0,0,80000,20000,60000,60000
20200316,708252,頎邦凱基97購02,,,,,,0.00,0,0,0,0,0,0,0,0,0,0,0,0,0
20200316,708253,大江元富96購02,,,,,,0.00,0,0,0,0,0,0,0,0,0,0,0,0,0
20200316,708254,頎邦元富96購01,,,,,,0.00,0,0,0,0,0,0,0,0,0,0,0,0,0
20200316,708255,頎邦元富96購02,,,,,,0.00,0,0,0,0,0,0,0,0,0,0,0,0,0
20200316,708256,信昌電永豐96購03,,,,,,0.00,0,0,0,0,0,0,0,0,0,0,0,0,0
20200316,708257,頎邦永豐96購02,,,,,,0.00,0,0,0,0,0,0,0,0,0,0,0,0,0
20200316,708258,頎邦永豐96購03,0.32,0.32,0.32,0.32,+0.02,6.67,10000,1,3200,0,0,0,0,0,0,10000,0,10000,10000
20200316,708259,神盾統一96購01,0.11,0.11,0.11,0.11,-0.19,-63.33,8000,1,880,0,0,0,0,0,0,8000,0,8000,8000
20200316,708260,群聯統一98購01,,,,,,0.00,0,0,0,0,0,0,0,0,0,0,0,0,0
20200316,708261,頎邦統一96購01,,,,,,0.00,0,0,0,0,0,0,0,0,0,0,0,0,0
20200316,708262,合晶國票97購02,,,,,,0.00,0,0,0,0,0,0,0,0,0,0,0,0,0
20200316,708263,威剛國票97購01,0.47,0.47,0.47,0.47,-0.02,-4.08,38000,1,17860,0,0,0,0,0,0,38000,0,38000,38000
20200316,708264,宣德國票97購02,,,,,,0.00,0,0,0,0,0,0,0,0,0,0,0,0,0
20200316,708265,聚積國票97購02,0.61,0.61,0.61,0.61,-0.19,-23.75,2000,1,1220,0,0,0,0,0,0,2000,0,2000,2000
20200316,708266,頎邦國票97購01,,,,,,0.00,0,0,0,0,0,0,0,0,0,0,0,0,0
20200316,708267,M31國泰98購01,,,,,,0.00,0,0,0,0,0,0,0,0,0,0,0,0,0
20200316,708268,聯亞國泰98購01,0.54,0.55,0.52,0.53,+0.10,23.26,125000,5,67650,0,0,0,0,0,0,120000,0,120000,120000
20200316,708269,頎邦國泰97購01,0.36,0.36,0.36,0.36,0.00,0.0,98000,1,35280,0,0,0,0,0,0,0,98000,-98000,-98000
20200316,708270,昂寶富邦98購01,,,,,,0.00,0,0,0,0,0,0,0,0,0,0,0,0,0
20200316,708271,原相富邦98購01,0.75,0.75,0.75,0.75,+0.15,25.0,70000,1,52500,0,0,0,0,0,0,70000,0,70000,70000
20200316,708272,頎邦富邦98購01,0.28,0.28,0.28,0.28,-0.01,-3.45,10000,3,2800,0,0,0,0,0,0,0,10000,-10000,-10000
20200316,708273,力旺元大96購02,0.11,0.11,0.09,0.09,-0.07,-43.75,5000,2,470,0,0,0,0,0,0,4000,1000,3000,3000
20200316,708274,中美晶元大96購05,1.20,1.20,1.13,1.14,+0.08,7.55,26000,5,30180,0,0,0,0,0,0,6000,21000,-15000,-15000
20200316,708275,六角元大98購01,0.25,0.26,0.19,0.19,-0.01,-5.0,203000,12,42970,0,0,0,0,0,0,155000,48000,107000,107000
20200316,708276,台半元大96購02,,,,,,0.00,0,0,0,0,0,0,0,0,0,0,0,0,0
20200316,708277,金居元大97購01,0.20,0.20,0.20,0.20,+0.03,17.65,30000,2,6000,0,0,0,0,0,0,30000,0,30000,30000
20200316,708278,勝麗元大96購03,0.16,0.16,0.16,0.16,-0.10,-38.46,20000,2,3200,0,0,0,0,0,0,0,20000,-20000,-20000
20200316,708279,頎邦元大96購02,,,,,,0.00,0,0,0,0,0,0,0,0,0,0,0,0,0
20200316,708280,頎邦元大96購03,,,,,,0.00,0,0,0,0,0,0,0,0,0,0,0,0,0
20200316,708281,頎邦元大97購01,0.40,0.41,0.37,0.37,-0.04,-9.76,138000,5,52260,0,0,0,0,0,0,128000,20000,108000,108000
20200316,708282,兆利群益98購01,,,,,,0.00,0,0,0,0,0,0,0,0,0,0,0,0,0
20200316,708283,頎邦群益97購01,,,,,,0.00,0,0,0,0,0,0,0,0,0,0,0,0,0
20200316,708284,頎邦群益97購02,,,,,,0.00,0,0,0,0,0,0,0,0,0,0,0,0,0
20200316,708285,頎邦群益98購01,,,,,,0.00,0,0,0,0,0,0,0,0,0,0,0,0,0
20200316,708286,三貝德康和96購01,0.36,0.36,0.36,0.36,+0.07,24.14,10000,1,3600,0,0,0,0,0,0,0,10000,-10000,-10000
20200316,708287,兆利康和9C購01,0.44,0.44,0.44,0.44,-0.01,-2.22,5000,1,2200,0,0,0,0,0,0,0,5000,-5000,-5000
20200316,708288,富喬康和96購01,,,,,,0.00,0,0,0,0,0,0,0,0,0,0,0,0,0
20200316,708289,杰力群益96購01,,,,,,0.00,0,0,0,0,0,0,0,0,0,0,0,0,0
20200316,708290,威剛群益97購01,,,,,,0.00,0,0,0,0,0,0,0,0,0,0,0,0,0
20200316,708291,環宇群益98購01,,,,,,0.00,0,0,0,0,0,0,0,0,0,0,0,0,0
20200316,708292,M31國票97購02,,,,,,0.00,0,0,0,0,0,0,0,0,0,0,0,0,0
20200316,708293,合晶國票98購01,0.49,0.49,0.49,0.49,+0.02,4.26,4000,1,1960,0,0,0,0,0,0,0,4000,-4000,-4000
20200316,708294,良維國票97購03,0.22,0.23,0.22,0.23,+0.02,9.52,15000,5,3350,0,0,0,0,0,0,14000,1000,13000,13000
20200316,708295,昂寶國票97購04,,,,,,0.00,0,0,0,0,0,0,0,0,0,0,0,0,0
20200316,708296,威剛國票97購02,,,,,,0.00,0,0,0,0,0,0,0,0,0,0,0,0,0
20200316,708297,茂達國票97購02,0.29,0.29,0.29,0.29,-0.03,-9.38,10000,1,2900,0,0,0,0,0,0,10000,0,10000,10000
20200316,708298,原相國票98購02,1.55,1.72,1.06,1.06,-0.36,-25.35,337000,31,437410,0,0,0,0,0,0,335000,82000,253000,253000
20200316,708299,穩懋國票97購02,0.70,0.72,0.70,0.72,+0.02,2.86,26000,2,18320,0,0,0,0,0,0,26000,0,26000,26000
20200316,708300,群聯日盛96購01,,,,,,0.00,0,0,0,0,0,0,0,0,0,0,0,0,0
20200316,708301,優群永豐97購01,1.09,1.18,0.84,0.84,0.00,0.0,209000,27,228770,0,0,0,0,0,0,25000,184000,-159000,-159000
20200316,708302,穩懋永豐96購02,0.13,0.14,0.08,0.08,-0.05,-38.46,118000,7,13840,0,0,0,0,0,0,40000,78000,-38000,-38000
20200316,708303,伍豐中信9A購01,0.12,0.12,0.12,0.12,+0.01,9.09,100000,1,12000,0,0,0,0,0,0,100000,0,100000,100000
20200316,708304,同致中信98購02,0.03,0.03,0.03,0.03,-0.07,-70.0,10000,1,300,0,0,0,0,0,0,0,10000,-10000,-10000
20200316,708305,宜鼎中信9A購01,0.41,0.41,0.41,0.41,+0.16,64.0,7000,1,2870,0,0,0,0,0,0,0,7000,-7000,-7000
20200316,708306,閎康統一99購01,,,,,,0.00,0,0,0,0,0,0,0,0,0,0,0,0,0
20200316,708307,頎邦統一96購02,,,,,,0.00,0,0,0,0,0,0,0,0,0,0,0,0,0
20200316,708308,大中凱基98購01,,,,,,0.00,0,0,0,0,0,0,0,0,0,0,0,0,0
20200316,708309,大江凱基97購01,,,,,,0.00,0,0,0,0,0,0,0,0,0,0,0,0,0
20200316,708310,兆利凱基98購01,0.44,0.44,0.42,0.42,+0.04,10.53,65000,3,27900,0,0,0,0,0,0,20000,45000,-25000,-25000
20200316,708311,迅得凱基97購01,0.02,0.02,0.02,0.02,-0.08,-80.0,20000,1,400,0,0,0,0,0,0,20000,0,20000,20000
20200316,708312,佳邦凱基98購01,0.22,0.22,0.22,0.22,+0.09,69.23,5000,1,1100,0,0,0,0,0,0,5000,0,5000,5000
20200316,708313,金居凱基98購01,,,,,,0.00,0,0,0,0,0,0,0,0,0,0,0,0,0
20200316,708314,聚積凱基98購01,0.30,0.30,0.30,0.30,+0.04,15.38,6000,1,1800,0,0,0,0,0,0,0,6000,-6000,-6000
20200316,708315,廣明凱基98購01,,,,,,0.00,0,0,0,0,0,0,0,0,0,0,0,0,0
20200316,708316,緯軟凱基98購02,0.13,0.13,0.13,0.13,-0.02,-13.33,10000,1,1300,0,0,0,0,0,0,0,10000,-10000,-10000
20200316,708317,環宇凱基98購01,0.18,0.18,0.18,0.18,-0.07,-28.0,10000,1,1800,0,0,0,0,0,0,0,10000,-10000,-10000
20200316,708318,聯亞凱基98購01,0.42,0.42,0.42,0.42,+0.05,13.51,2000,1,840,0,0,0,0,0,0,2000,0,2000,2000
20200316,708319,穩懋凱基96購13,,,,,,0.00,0,0,0,0,0,0,0,0,0,0,0,0,0
20200316,708320,頎邦凱基96購01,,,,,,0.00,0,0,0,0,0,0,0,0,0,0,0,0,0
20200316,708321,大學光元大97購01,,,,,,0.00,0,0,0,0,0,0,0,0,0,0,0,0,0
20200316,708322,群聯元大97購04,,,,,,0.00,0,0,0,0,0,0,0,0,0,0,0,0,0
20200316,708323,聯亞元大97購03,,,,,,0.00,0,0,0,0,0,0,0,0,0,0,0,0,0
20200316,708324,新普兆豐97購01,0.99,0.99,0.72,0.72,-0.24,-25.0,340000,6,285100,0,0,0,0,0,0,138000,202000,-64000,-64000
20200316,708325,穩懋兆豐97購02,1.10,1.15,0.81,0.81,+0.11,15.71,257000,14,283160,0,0,0,0,0,0,93000,164000,-71000,-71000
20200316,708326,大江日盛96購01,,,,,,0.00,0,0,0,0,0,0,0,0,0,0,0,0,0
20200316,708327,鈊象第一96購01,,,,,,0.00,0,0,0,0,0,0,0,0,0,0,0,0,0
20200316,708328,晶焱元大97購03,0.57,0.57,0.44,0.44,-0.14,-24.14,80000,8,42800,0,0,0,0,0,0,60000,70000,-10000,-10000
20200316,708329,頎邦康和96購01,,,,,,0.00,0,0,0,0,0,0,0,0,0,0,0,0,0
20200316,708330,M31群益98購01,,,,,,0.00,0,0,0,0,0,0,0,0,0,0,0,0,0
20200316,708331,中美晶群益96購03,0.35,0.35,0.27,0.27,-0.05,-15.62,10000,2,3100,0,0,0,0,0,0,0,10000,-10000,-10000
20200316,708332,六角群益98購01,,,,,,0.00,0,0,0,0,0,0,0,0,0,0,0,0,0
20200316,708333,宇峻群益98購01,0.38,0.45,0.30,0.30,-0.05,-14.29,1214000,35,470760,0,0,0,0,0,0,130000,1074000,-944000,-944000
20200316,708334,佳邦群益98購01,,,,,,0.00,0,0,0,0,0,0,0,0,0,0,0,0,0
20200316,708335,網龍群益96購01,,,,,,0.00,0,0,0,0,0,0,0,0,0,0,0,0,0
20200316,708336,大宇資永豐97購01,0.20,0.23,0.20,0.23,+0.01,4.55,44000,2,9610,0,0,0,0,0,0,17000,27000,-10000,-10000
20200316,708337,大學光永豐96購02,,,,,,0.00,0,0,0,0,0,0,0,0,0,0,0,0,0
20200316,708338,伍豐永豐96購01,0.07,0.07,0.07,0.07,+0.01,16.67,150000,1,10500,0,0,0,0,0,0,150000,0,150000,150000
20200316,708339,旺矽永豐97購02,,,,,,0.00,0,0,0,0,0,0,0,0,0,0,0,0,0
20200316,708340,昂寶永豐97購01,,,,,,0.00,0,0,0,0,0,0,0,0,0,0,0,0,0
20200316,708341,美琪瑪永豐96購02,,,,,,0.00,0,0,0,0,0,0,0,0,0,0,0,0,0
20200316,708342,群聯永豐96購02,,,,,,0.00,0,0,0,0,0,0,0,0,0,0,0,0,0
20200316,708343,網龍永豐96購04,,,,,,0.00,0,0,0,0,0,0,0,0,0,0,0,0,0
20200316,708344,聯亞永豐96購03,,,,,,0.00,0,0,0,0,0,0,0,0,0,0,0,0,0
20200316,708345,鈊象永豐96購05,3.50,4.30,2.49,2.49,-1.00,-28.65,285000,38,1102890,0,0,0,0,0,0,162000,43000,119000,119000
20200316,708346,M31統一97購01,,,,,,0.00,0,0,0,0,0,0,0,0,0,0,0,0,0
20200316,708347,環球晶統一96購02,,,,,,0.00,0,0,0,0,0,0,0,0,0,0,0,0,0
20200316,708348,環球晶中信96購02,0.07,0.08,0.05,0.05,-0.04,-44.44,215000,22,12150,0,0,0,0,0,0,0,215000,-215000,-215000
20200316,708349,鈺太中信97購01,0.17,0.17,0.17,0.17,+0.04,30.77,10000,1,1700,0,0,0,0,0,0,0,10000,-10000,-10000
20200316,708350,中美晶台新97購02,0.57,0.64,0.51,0.51,-0.10,-16.39,728000,55,399680,0,0,0,0,0,0,728000,510000,218000,218000
20200316,708351,穩懋台新97購02,0.48,0.48,0.29,0.32,-0.04,-11.11,2136000,148,810880,0,0,0,0,0,0,2090000,2036000,54000,54000
20200316,708352,杰力凱基98購01,,,,,,0.00,0,0,0,0,0,0,0,0,0,0,0,0,0
20200316,708353,中美晶富邦97購03,,,,,,0.00,0,0,0,0,0,0,0,0,0,0,0,0,0
20200316,708354,合晶國票99購01,,,,,,0.00,0,0,0,0,0,0,0,0,0,0,0,0,0
20200316,708355,昇達科國票97購01,,,,,,0.00,0,0,0,0,0,0,0,0,0,0,0,0,0
20200316,708356,信昌電國票97購03,0.25,0.25,0.25,0.25,+0.01,4.17,14000,2,3500,0,0,0,0,0,0,0,14000,-14000,-14000
20200316,708357,神盾國票97購03,,,,,,0.00,0,0,0,0,0,0,0,0,0,0,0,0,0
20200316,708358,群聯國票97購02,,,,,,0.00,0,0,0,0,0,0,0,0,0,0,0,0,0
20200316,708359,中美晶國泰97購02,0.75,0.75,0.75,0.75,+0.02,2.74,283000,1,212250,0,0,0,0,0,0,283000,0,283000,283000
20200316,708360,宇峻國泰97購01,0.35,0.35,0.35,0.35,+0.04,12.9,76000,2,26600,0,0,0,0,0,0,76000,0,76000,76000
20200316,708361,鈊象國泰98購02,,,,,,0.00,0,0,0,0,0,0,0,0,0,0,0,0,0
20200316,708362,環球晶統一96購04,,,,,,0.00,0,0,0,0,0,0,0,0,0,0,0,0,0
20200316,708363,台燿中信98購01,,,,,,0.00,0,0,0,0,0,0,0,0,0,0,0,0,0
20200316,708364,新普中信98購01,,,,,,0.00,0,0,0,0,0,0,0,0,0,0,0,0,0
20200316,708365,凡甲凱基97購01,0.67,0.75,0.57,0.57,-0.06,-9.52,1029000,26,686500,0,0,0,0,0,0,654000,827000,-173000,-173000
20200316,708366,中美晶凱基97購01,0.40,0.43,0.37,0.37,+0.01,2.78,1500000,7,583120,0,0,0,0,0,0,1497000,5000,1492000,1492000
20200316,708367,良維凱基97購02,,,,,,0.00,0,0,0,0,0,0,0,0,0,0,0,0,0
20200316,708368,宣德凱基97購01,0.49,0.49,0.46,0.46,+0.09,24.32,228000,3,110880,0,0,0,0,0,0,28000,228000,-200000,-200000
20200316,708369,雙美凱基98購01,,,,,,0.00,0,0,0,0,0,0,0,0,0,0,0,0,0
20200316,708370,中美晶元大96購06,1.16,1.16,1.09,1.09,-0.17,-13.49,12000,2,13780,0,0,0,0,0,0,2000,10000,-8000,-8000
20200316,708371,信昌電元大96購04,,,,,,0.00,0,0,0,0,0,0,0,0,0,0,0,0,0
20200316,708372,優群元大97購03,1.78,1.78,1.78,1.78,+0.23,14.84,7000,1,12460,0,0,0,0,0,0,7000,0,7000,7000
20200316,708373,中美晶元富96購02,0.24,0.24,0.14,0.14,-0.09,-39.13,350000,11,58250,0,0,0,0,0,0,320000,20000,300000,300000
20200316,708374,久元台新96購01,,,,,,0.00,0,0,0,0,0,0,0,0,0,0,0,0,0
20200316,708375,久元台新96購02,0.48,0.48,0.48,0.48,+0.02,4.35,10000,1,4800,0,0,0,0,0,0,0,10000,-10000,-10000
20200316,708376,台半台新96購01,,,,,,0.00,0,0,0,0,0,0,0,0,0,0,0,0,0
20200316,708377,鈊象台新96購02,,,,,,0.00,0,0,0,0,0,0,0,0,0,0,0,0,0
20200316,708378,頎邦台新97購01,,,,,,0.00,0,0,0,0,0,0,0,0,0,0,0,0,0
20200316,708379,穩懋亞東98購01,,,,,,0.00,0,0,0,0,0,0,0,0,0,0,0,0,0
20200316,708380,台半永豐96購01,,,,,,0.00,0,0,0,0,0,0,0,0,0,0,0,0,0
20200316,708381,亞泰永豐96購01,,,,,,0.00,0,0,0,0,0,0,0,0,0,0,0,0,0
20200316,708382,宜鼎永豐96購02,,,,,,0.00,0,0,0,0,0,0,0,0,0,0,0,0,0
20200316,708383,信昌電永豐96購04,,,,,,0.00,0,0,0,0,0,0,0,0,0,0,0,0,0
20200316,708384,雍智永豐97購01,,,,,,0.00,0,0,0,0,0,0,0,0,0,0,0,0,0
20200316,708385,碩禾永豐96購02,,,,,,0.00,0,0,0,0,0,0,0,0,0,0,0,0,0
20200316,708386,雙鴻永豐97購03,,,,,,0.00,0,0,0,0,0,0,0,0,0,0,0,0,0
20200316,708387,瓦城康和96購01,,,,,,0.00,0,0,0,0,0,0,0,0,0,0,0,0,0
20200316,708388,三貝德群益96購02,,,,,,0.00,0,0,0,0,0,0,0,0,0,0,0,0,0
20200316,708389,台半群益96購02,0.20,0.21,0.20,0.21,+0.06,40.0,35000,4,7050,0,0,0,0,0,0,35000,35000,0,0
20200316,708390,美琪瑪群益96購01,,,,,,0.00,0,0,0,0,0,0,0,0,0,0,0,0,0
20200316,708391,原相群益98購02,1.22,1.30,0.78,0.78,-0.12,-13.33,70000,10,78400,0,0,0,0,0,0,65000,38000,27000,27000
20200316,708392,大江國票97購05,0.07,0.07,0.07,0.07,+0.01,16.67,490000,1,34300,0,0,0,0,0,0,490000,0,490000,490000
20200316,708393,信昌電國泰98購01,,,,,,0.00,0,0,0,0,0,0,0,0,0,0,0,0,0
20200316,708394,威剛國泰98購01,0.29,0.29,0.29,0.29,+0.07,31.82,10000,1,2900,0,0,0,0,0,0,10000,0,10000,10000
20200316,708395,環球晶國泰97購03,0.91,1.08,0.64,0.64,-0.47,-42.34,272000,28,262030,0,0,0,0,0,0,267000,81000,186000,186000
20200316,708396,信昌電富邦98購01,0.12,0.12,0.11,0.11,-0.01,-8.33,74000,8,8440,0,0,0,0,0,0,44000,30000,14000,14000
20200316,708397,群聯富邦97購03,,,,,,0.00,0,0,0,0,0,0,0,0,0,0,0,0,0
20200316,708398,環球晶富邦99購01,0.69,0.70,0.50,0.50,-0.22,-30.56,157000,20,99500,0,0,0,0,0,0,7000,128000,-121000,-121000
20200316,708399,穩懋富邦97購03,0.58,0.62,0.45,0.48,-0.11,-18.64,282000,16,155440,0,0,0,0,0,0,189000,68000,121000,121000
20200316,708400,建榮國票98購01,,,,,,0.00,0,0,0,0,0,0,0,0,0,0,0,0,0
20200316,708401,威剛國泰98購02,,,,,,0.00,0,0,0,0,0,0,0,0,0,0,0,0,0
20200316,708402,優群國泰99購01,,,,,,0.00,0,0,0,0,0,0,0,0,0,0,0,0,0
20200316,708403,合晶元大98購02,0.51,0.51,0.51,0.51,+0.10,24.39,10000,1,5100,0,0,0,0,0,0,0,10000,-10000,-10000
20200316,708404,聖暉元大97購01,1.26,1.26,1.13,1.13,-0.17,-13.08,68000,7,83400,0,0,0,0,0,0,52000,16000,36000,36000
20200316,708405,頎邦元大97購02,,,,,,0.00,0,0,0,0,0,0,0,0,0,0,0,0,0
20200316,708406,昂寶元富97購01,0.82,0.82,0.82,0.82,+0.20,32.26,97000,1,79540,0,0,0,0,0,0,97000,0,97000,97000
20200316,708407,環球晶元富97購01,0.35,0.35,0.35,0.35,-0.05,-12.5,20000,2,7000,0,0,0,0,0,0,0,10000,-10000,-10000
20200316,708408,雙鴻統一97購01,,,,,,0.00,0,0,0,0,0,0,0,0,0,0,0,0,0
20200316,708409,精測中信97購01,,,,,,0.00,0,0,0,0,0,0,0,0,0,0,0,0,0
20200316,708410,頎邦中信9B購01,,,,,,0.00,0,0,0,0,0,0,0,0,0,0,0,0,0
20200316,708411,宜鼎凱基99購01,0.22,0.22,0.16,0.19,-0.02,-9.52,14000,4,2600,0,0,0,0,0,0,7000,7000,0,0
20200316,708412,直得凱基98購01,0.15,0.15,0.15,0.15,0.00,0.0,20000,1,3000,0,0,0,0,0,0,20000,0,20000,20000
20200316,708413,信昌電凱基98購01,,,,,,0.00,0,0,0,0,0,0,0,0,0,0,0,0,0
20200316,708414,群聯凱基98購01,,,,,,0.00,0,0,0,0,0,0,0,0,0,0,0,0,0
20200316,708415,VHQ永豐97購01,,,,,,0.00,0,0,0,0,0,0,0,0,0,0,0,0,0
20200316,708416,大宇資永豐99購01,0.26,0.26,0.19,0.19,-0.09,-32.14,31000,5,7670,0,0,0,0,0,0,17000,14000,3000,3000
20200316,708417,長科*永豐97購01,,,,,,0.00,0,0,0,0,0,0,0,0,0,0,0,0,0
20200316,708418,廣明永豐97購01,,,,,,0.00,0,0,0,0,0,0,0,0,0,0,0,0,0
20200316,708419,環宇永豐98購01,,,,,,0.00,0,0,0,0,0,0,0,0,0,0,0,0,0
20200316,708420,宜鼎群益98購01,,,,,,0.00,0,0,0,0,0,0,0,0,0,0,0,0,0
20200316,708421,群聯群益98購01,0.29,0.29,0.21,0.21,-0.12,-36.36,25000,3,6550,0,0,0,0,0,0,0,25000,-25000,-25000
20200316,708422,群聯群益99購01,,,,,,0.00,0,0,0,0,0,0,0,0,0,0,0,0,0
20200316,708423,世界麥證97購01,,,,,,0.00,0,0,0,0,0,0,0,0,0,0,0,0,0
20200316,708424,原相台新97購02,0.80,0.80,0.67,0.67,+0.06,9.84,10000,2,7350,0,0,0,0,0,0,0,10000,-10000,-10000
20200316,708425,新鉅科台新98購01,,,,,,0.00,0,0,0,0,0,0,0,0,0,0,0,0,0
20200316,708426,群聯台新97購03,,,,,,0.00,0,0,0,0,0,0,0,0,0,0,0,0,0
20200316,708427,聯亞台新97購01,,,,,,0.00,0,0,0,0,0,0,0,0,0,0,0,0,0
20200316,708428,鈺太台新97購01,0.15,0.15,0.15,0.15,+0.02,15.38,60000,1,9000,0,0,0,0,0,0,0,60000,-60000,-60000
20200316,708429,群聯統一97購01,,,,,,0.00,0,0,0,0,0,0,0,0,0,0,0,0,0
20200316,708430,兆利中信9A購01,0.17,0.17,0.16,0.16,-0.03,-15.79,370000,2,59400,0,0,0,0,0,0,350000,20000,330000,330000
20200316,708431,原相中信99購01,0.99,0.99,0.80,0.80,-0.16,-16.67,49000,8,43050,0,0,0,0,0,0,28000,0,28000,28000
20200316,708432,廣明中信9B購01,0.02,0.02,0.02,0.02,0.00,0.0,20000,2,400,0,0,0,0,0,0,0,20000,-20000,-20000
20200316,708433,穩懋中信99購01,0.40,0.42,0.30,0.30,-0.05,-14.29,40000,6,15560,0,0,0,0,0,0,31000,9000,22000,22000
20200316,708434,合晶凱基98購01,0.15,0.15,0.09,0.09,-0.05,-35.71,80000,2,9600,0,0,0,0,0,0,40000,40000,0,0
20200316,708435,勝麗凱基97購02,,,,,,0.00,0,0,0,0,0,0,0,0,0,0,0,0,0
20200316,708436,博智凱基97購01,3.13,3.60,3.10,3.42,+0.40,13.25,159000,21,526810,0,0,0,0,0,0,56000,93000,-37000,-37000
20200316,708437,穩懋日盛97購01,0.31,0.31,0.31,0.31,-0.02,-6.06,10000,1,3100,0,0,0,0,0,0,10000,0,10000,10000
20200316,708438,中美晶亞東97購01,,,,,,0.00,0,0,0,0,0,0,0,0,0,0,0,0,0
20200316,708439,合晶亞東97購02,,,,,,0.00,0,0,0,0,0,0,0,0,0,0,0,0,0
20200316,708440,大田元富97購01,0.14,0.14,0.14,0.14,0.00,0.0,1000000,4,140000,0,0,0,0,0,0,0,1000000,-1000000,-1000000
20200316,708441,榮剛元富97購01,,,,,,0.00,0,0,0,0,0,0,0,0,0,0,0,0,0
20200316,708442,聯亞台新99購01,0.25,0.25,0.25,0.25,-0.05,-16.67,20000,1,5000,0,0,0,0,0,0,20000,0,20000,20000
20200316,708443,昂寶元大9A購01,,,,,,0.00,0,0,0,0,0,0,0,0,0,0,0,0,0
20200316,708444,威剛元大99購01,0.34,0.38,0.24,0.24,-0.10,-29.41,437000,33,128170,0,0,0,0,0,0,213000,305000,-92000,-92000
20200316,708445,神盾元大99購02,0.15,0.15,0.08,0.08,-0.06,-42.86,70000,7,7300,0,0,0,0,0,0,0,70000,-70000,-70000
20200316,708446,聯亞元大97購04,,,,,,0.00,0,0,0,0,0,0,0,0,0,0,0,0,0
20200316,708447,鈺太元大99購01,0.26,0.27,0.26,0.27,+0.02,8.0,15000,2,4000,0,0,0,0,0,0,15000,0,15000,15000
20200316,708448,大中永豐97購01,,,,,,0.00,0,0,0,0,0,0,0,0,0,0,0,0,0
20200316,708449,大江永豐97購02,,,,,,0.00,0,0,0,0,0,0,0,0,0,0,0,0,0
20200316,708450,六角永豐97購01,,,,,,0.00,0,0,0,0,0,0,0,0,0,0,0,0,0
20200316,708451,兆利永豐97購01,,,,,,0.00,0,0,0,0,0,0,0,0,0,0,0,0,0
20200316,708452,波若威永豐98購01,,,,,,0.00,0,0,0,0,0,0,0,0,0,0,0,0,0
20200316,708453,宣德永豐97購02,0.18,0.18,0.08,0.08,-0.04,-33.33,40000,3,4200,0,0,0,0,0,0,0,40000,-40000,-40000
20200316,708454,建榮永豐99購01,0.29,0.29,0.28,0.28,+0.01,3.7,68000,2,19620,0,0,0,0,0,0,0,68000,-68000,-68000
20200316,708455,森鉅永豐97購01,,,,,,0.00,0,0,0,0,0,0,0,0,0,0,0,0,0
20200316,708456,榮剛永豐97購01,,,,,,0.00,0,0,0,0,0,0,0,0,0,0,0,0,0
20200316,708457,廣積永豐97購01,,,,,,0.00,0,0,0,0,0,0,0,0,0,0,0,0,0
20200316,708458,旺矽群益9A購01,,,,,,0.00,0,0,0,0,0,0,0,0,0,0,0,0,0
20200316,708459,昇達科群益98購01,,,,,,0.00,0,0,0,0,0,0,0,0,0,0,0,0,0
20200316,708460,櫃200群益97購01,0.07,0.08,0.04,0.04,0.00,0.0,156000,18,7460,0,0,0,0,0,0,16000,140000,-124000,-124000
20200316,708461,櫃200群益97購02,0.03,0.03,0.03,0.03,0.00,0.0,4000,4,120,0,0,0,0,0,0,0,4000,-4000,-4000
20200316,708462,中美晶元大97購03,,,,,,0.00,0,0,0,0,0,0,0,0,0,0,0,0,0
20200316,708463,宜鼎元大97購01,0.65,0.71,0.65,0.68,+0.01,1.49,230000,3,156100,0,0,0,0,0,0,230000,0,230000,230000
20200316,708464,昂寶元大98購01,,,,,,0.00,0,0,0,0,0,0,0,0,0,0,0,0,0
20200316,708465,璟德元大97購01,,,,,,0.00,0,0,0,0,0,0,0,0,0,0,0,0,0
20200316,708466,璟德元大97購02,0.19,0.21,0.19,0.21,-0.02,-8.7,100000,10,20800,0,0,0,0,0,0,0,100000,-100000,-100000
20200316,708467,優群元大97購04,,,,,,0.00,0,0,0,0,0,0,0,0,0,0,0,0,0
20200316,708468,兆利康和97購01,,,,,,0.00,0,0,0,0,0,0,0,0,0,0,0,0,0
20200316,708469,璟德康和97購01,,,,,,0.00,0,0,0,0,0,0,0,0,0,0,0,0,0
20200316,708470,璟德元富97購01,,,,,,0.00,0,0,0,0,0,0,0,0,0,0,0,0,0
20200316,708471,璟德台新97購01,,,,,,0.00,0,0,0,0,0,0,0,0,0,0,0,0,0
20200316,708472,三貝德凱基99購01,0.15,0.15,0.15,0.15,+0.05,50.0,2000,1,300,0,0,0,0,0,0,0,0,0,0
20200316,708473,大田凱基98購01,,,,,,0.00,0,0,0,0,0,0,0,0,0,0,0,0,0
20200316,708474,中美晶凱基97購02,0.75,0.76,0.70,0.74,-0.10,-11.9,112000,6,82630,0,0,0,0,0,0,112000,112000,0,0
20200316,708475,宇峻凱基9A購01,,,,,,0.00,0,0,0,0,0,0,0,0,0,0,0,0,0
20200316,708476,網龍凱基98購01,,,,,,0.00,0,0,0,0,0,0,0,0,0,0,0,0,0
20200316,708477,鈊象凱基99購01,3.83,3.83,2.52,2.52,-0.86,-25.44,207000,21,644070,0,0,0,0,0,0,45000,162000,-117000,-117000
20200316,708478,穩懋日盛97購02,,,,,,0.00,0,0,0,0,0,0,0,0,0,0,0,0,0
20200316,708479,立端永豐97購01,0.09,0.09,0.09,0.09,+0.02,28.57,20000,2,1800,0,0,0,0,0,0,0,20000,-20000,-20000
20200316,708480,宇峻永豐97購01,,,,,,0.00,0,0,0,0,0,0,0,0,0,0,0,0,0
20200316,708481,迅得永豐97購03,,,,,,0.00,0,0,0,0,0,0,0,0,0,0,0,0,0
20200316,708482,神盾永豐97購01,,,,,,0.00,0,0,0,0,0,0,0,0,0,0,0,0,0
20200316,708483,璟德永豐97購02,,,,,,0.00,0,0,0,0,0,0,0,0,0,0,0,0,0
20200316,708484,璟德國泰98購01,,,,,,0.00,0,0,0,0,0,0,0,0,0,0,0,0,0
20200316,708485,六角國票97購01,0.19,0.20,0.19,0.20,-0.02,-9.09,20000,4,3820,0,0,0,0,0,0,20000,0,20000,20000
20200316,708486,昂寶國票98購01,,,,,,0.00,0,0,0,0,0,0,0,0,0,0,0,0,0
20200316,708487,信昌電國票98購01,0.24,0.28,0.24,0.28,+0.06,27.27,66000,8,16330,0,0,0,0,0,0,0,66000,-66000,-66000
20200316,708488,威剛國票98購01,0.60,0.60,0.33,0.33,-0.22,-40.0,89000,5,36800,0,0,0,0,0,0,89000,0,89000,89000
20200316,708489,群聯國票98購01,0.17,0.17,0.17,0.17,-0.10,-37.04,100000,1,17000,0,0,0,0,0,0,100000,0,100000,100000
20200316,708490,雍智國票98購01,0.18,0.18,0.17,0.17,-0.07,-29.17,30000,4,5350,0,0,0,0,0,0,0,30000,-30000,-30000
20200316,708491,雙美國票99購01,,,,,,0.00,0,0,0,0,0,0,0,0,0,0,0,0,0
20200316,708492,雙鴻國票98購02,,,,,,0.00,0,0,0,0,0,0,0,0,0,0,0,0,0
20200316,708493,鈊象國票98購01,,,,,,0.00,0,0,0,0,0,0,0,0,0,0,0,0,0
20200316,708494,大江群益97購02,0.08,0.08,0.08,0.08,+0.02,33.33,1497000,3,119760,0,0,0,0,0,0,998000,0,998000,998000
20200316,708495,信昌電群益97購01,0.04,0.04,0.04,0.04,0.00,0.0,20000,2,800,0,0,0,0,0,0,0,20000,-20000,-20000
20200316,708496,建榮群益99購01,,,,,,0.00,0,0,0,0,0,0,0,0,0,0,0,0,0
20200316,708497,原相群益99購01,0.74,0.74,0.74,0.74,-0.07,-8.64,1000,1,740,0,0,0,0,0,0,1000,0,1000,1000
20200316,708498,勝麗群益98購01,,,,,,0.00,0,0,0,0,0,0,0,0,0,0,0,0,0
20200316,708499,璟德群益98購01,,,,,,0.00,0,0,0,0,0,0,0,0,0,0,0,0,0
20200316,708500,鈊象群益99購05,,,,,,0.00,0,0,0,0,0,0,0,0,0,0,0,0,0
20200316,708501,力致元大97購01,0.09,0.10,0.06,0.06,0.00,0.0,470000,42,35700,0,0,0,0,0,0,75000,395000,-320000,-320000
20200316,708502,中美晶元大97購04,1.10,1.10,1.10,1.10,-0.12,-9.84,1000,1,1100,0,0,0,0,0,0,1000,1000,0,0
20200316,708503,世禾元大97購01,,,,,,0.00,0,0,0,0,0,0,0,0,0,0,0,0,0
20200316,708504,尼克森元大97購01,,,,,,0.00,0,0,0,0,0,0,0,0,0,0,0,0,0
20200316,708505,宇峻元大97購03,0.47,0.51,0.47,0.47,+0.03,6.82,40000,3,19200,0,0,0,0,0,0,30000,10000,20000,20000
20200316,708506,信昌電元大98購01,0.19,0.19,0.11,0.11,-0.06,-35.29,34000,7,5710,0,0,0,0,0,0,0,34000,-34000,-34000
20200316,708507,碩禾元大98購02,,,,,,0.00,0,0,0,0,0,0,0,0,0,0,0,0,0
20200316,708508,雙鴻元大99購02,0.08,0.08,0.08,0.08,-0.04,-33.33,10000,1,800,0,0,0,0,0,0,0,10000,-10000,-10000
20200316,708509,尼克森統一99購01,,,,,,0.00,0,0,0,0,0,0,0,0,0,0,0,0,0
20200316,708510,尼克森統一99購02,,,,,,0.00,0,0,0,0,0,0,0,0,0,0,0,0,0
20200316,708511,迅得統一99購01,,,,,,0.00,0,0,0,0,0,0,0,0,0,0,0,0,0
20200316,708512,頎邦統一97購01,,,,,,0.00,0,0,0,0,0,0,0,0,0,0,0,0,0
20200316,708513,M31中信98購01,,,,,,0.00,0,0,0,0,0,0,0,0,0,0,0,0,0
20200316,708514,大中中信97購01,,,,,,0.00,0,0,0,0,0,0,0,0,0,0,0,0,0
20200316,708515,宇峻中信97購01,0.08,0.10,0.08,0.08,+0.02,33.33,110000,4,9800,0,0,0,0,0,0,60000,0,60000,60000
20200316,708516,博智中信97購01,1.68,1.68,1.68,1.68,+0.18,12.0,32000,3,53760,0,0,0,0,0,0,20000,0,20000,20000
20200316,708517,大中凱基98購02,,,,,,0.00,0,0,0,0,0,0,0,0,0,0,0,0,0
20200316,708518,同致凱基98購01,,,,,,0.00,0,0,0,0,0,0,0,0,0,0,0,0,0
20200316,708519,合晶凱基97購02,,,,,,0.00,0,0,0,0,0,0,0,0,0,0,0,0,0
20200316,708520,朋億凱基97購01,0.40,0.40,0.40,0.40,+0.05,14.29,33000,1,13200,0,0,0,0,0,0,0,33000,-33000,-33000
20200316,708521,南光凱基97購01,0.37,0.37,0.36,0.36,+0.02,5.88,420000,4,155200,0,0,0,0,0,0,410000,10000,400000,400000
20200316,708522,緯軟凱基98購03,,,,,,0.00,0,0,0,0,0,0,0,0,0,0,0,0,0
20200316,708523,大江兆豐97購01,0.04,0.04,0.03,0.03,-0.01,-25.0,190000,17,7100,0,0,0,0,0,0,0,190000,-190000,-190000
20200316,708524,中美晶兆豐98購01,,,,,,0.00,0,0,0,0,0,0,0,0,0,0,0,0,0
20200316,708525,台燿兆豐97購02,0.27,0.27,0.22,0.22,-0.04,-15.38,30000,3,7400,0,0,0,0,0,0,0,30000,-30000,-30000
20200316,708526,精華兆豐98購01,0.29,0.33,0.29,0.33,+0.05,17.86,140000,3,44200,0,0,0,0,0,0,140000,0,140000,140000
20200316,708527,中美晶群益97購03,0.17,0.17,0.17,0.17,-0.06,-26.09,90000,1,15300,0,0,0,0,0,0,90000,0,90000,90000
20200316,708528,太景*群益98購01,0.35,0.35,0.19,0.19,-0.16,-45.71,1311000,28,370440,0,0,0,0,0,0,230000,1081000,-851000,-851000
20200316,708529,立端群益97購01,0.10,0.10,0.09,0.09,0.00,0.0,147000,4,13600,0,1000,-1000,0,0,0,147000,0,147000,146000
20200316,708530,朋億群益98購01,0.67,0.67,0.67,0.67,+0.04,6.35,15000,1,10050,0,0,0,0,0,0,0,15000,-15000,-15000
20200316,708531,欣銓群益98購01,0.18,0.18,0.18,0.18,-0.01,-5.26,24000,6,4320,0,0,0,0,0,0,24000,0,24000,24000
20200316,708532,群聯群益97購02,,,,,,0.00,0,0,0,0,0,0,0,0,0,0,0,0,0
20200316,708533,緯軟群益98購01,,,,,,0.00,0,0,0,0,0,0,0,0,0,0,0,0,0
20200316,708534,環球晶群益97購03,0.42,0.42,0.18,0.18,-0.09,-33.33,15000,10,4110,0,0,0,0,0,0,0,13000,-13000,-13000
20200316,708535,譜瑞群益97購01,1.65,2.50,1.65,2.00,+0.15,8.11,111000,4,187500,0,0,0,0,0,0,99000,0,99000,99000
20200316,708536,建榮國票98購02,,,,,,0.00,0,0,0,0,0,0,0,0,0,0,0,0,0
20200316,708537,力致國泰99購01,,,,,,0.00,0,0,0,0,0,0,0,0,0,0,0,0,0
20200316,708538,凡甲國泰99購01,0.76,0.82,0.75,0.78,+0.16,25.81,318000,8,246380,0,0,0,0,0,0,298000,20000,278000,278000
20200316,708539,中菲行國泰98購01,0.38,0.38,0.38,0.38,+0.04,11.76,6000,1,2280,0,0,0,0,0,0,6000,0,6000,6000
20200316,708540,世禾國泰98購01,0.19,0.19,0.19,0.19,+0.01,5.56,262000,2,49780,0,0,0,0,0,0,202000,60000,142000,142000
20200316,708541,尼克森國泰99購01,0.28,0.28,0.18,0.18,-0.09,-33.33,460000,5,102800,0,0,0,0,0,0,460000,0,460000,460000
20200316,708542,幃翔國泰98購01,,,,,,0.00,0,0,0,0,0,0,0,0,0,0,0,0,0
20200316,708543,幃翔國泰98購02,,,,,,0.00,0,0,0,0,0,0,0,0,0,0,0,0,0
20200316,708544,群聯國泰99購01,0.22,0.24,0.14,0.14,-0.09,-39.13,335000,8,65840,0,0,0,0,0,0,320000,0,320000,320000
20200316,708545,雙鴻國泰99購01,0.22,0.24,0.21,0.21,-0.02,-8.7,110000,3,24700,0,0,0,0,0,0,60000,50000,10000,10000
20200316,708546,力致永豐97購01,0.05,0.05,0.05,0.05,+0.02,66.67,2000,1,100,0,0,0,0,0,0,0,2000,-2000,-2000
20200316,708547,世禾永豐97購01,,,,,,0.00,0,0,0,0,0,0,0,0,0,0,0,0,0
20200316,708548,尼克森永豐97購01,,,,,,0.00,0,0,0,0,0,0,0,0,0,0,0,0,0
20200316,708549,立敦永豐97購01,,,,,,0.00,0,0,0,0,0,0,0,0,0,0,0,0,0
20200316,708550,同亨永豐97購01,,,,,,0.00,0,0,0,0,0,0,0,0,0,0,0,0,0
20200316,708551,直得永豐97購01,,,,,,0.00,0,0,0,0,0,0,0,0,0,0,0,0,0
20200316,708552,南光永豐97購01,0.24,0.24,0.24,0.24,+0.01,4.35,23000,1,5520,0,0,0,0,0,0,23000,0,23000,23000
20200316,708553,威剛永豐98購01,0.45,0.45,0.39,0.39,+0.10,34.48,12000,2,4800,0,0,0,0,0,0,2000,12000,-10000,-10000
20200316,708554,幃翔永豐97購01,,,,,,0.00,0,0,0,0,0,0,0,0,0,0,0,0,0
20200316,708555,新潤永豐97購01,0.10,0.10,0.10,0.10,-0.03,-23.08,200000,4,20000,0,0,0,0,0,0,0,200000,-200000,-200000
20200316,708556,網龍永豐97購01,0.03,0.03,0.03,0.03,0.00,0.0,30000,3,900,0,0,0,0,0,0,0,30000,-30000,-30000
20200316,708557,緯軟永豐97購01,,,,,,0.00,0,0,0,0,0,0,0,0,0,0,0,0,0
20200316,708558,環球晶永豐97購01,0.16,0.16,0.12,0.12,-0.03,-20.0,140000,4,20500,0,0,0,0,0,0,110000,30000,80000,80000
20200316,708559,聯上永豐97購01,,,,,,0.00,0,0,0,0,0,0,0,0,0,0,0,0,0
20200316,708560,大中康和97購01,,,,,,0.00,0,0,0,0,0,0,0,0,0,0,0,0,0
20200316,708561,亞泰康和97購01,,,,,,0.00,0,0,0,0,0,0,0,0,0,0,0,0,0
20200316,708562,博智康和97購01,1.63,1.74,1.60,1.69,+0.12,7.64,734000,28,1211760,0,0,0,0,0,0,523000,156000,367000,367000
20200316,708563,力致元富97購01,,,,,,0.00,0,0,0,0,0,0,0,0,0,0,0,0,0
20200316,708564,中菲行元富97購01,0.23,0.23,0.22,0.22,-0.06,-21.43,20000,2,4500,0,0,0,0,0,0,0,20000,-20000,-20000
20200316,708565,太景*元富97購01,0.45,0.48,0.26,0.28,-0.24,-46.15,333000,36,129260,0,0,0,0,0,0,6000,281000,-275000,-275000
20200316,708566,世禾元富97購01,,,,,,0.00,0,0,0,0,0,0,0,0,0,0,0,0,0
20200316,708567,尼克森元富97購01,,,,,,0.00,0,0,0,0,0,0,0,0,0,0,0,0,0
20200316,708568,幃翔元富97購01,,,,,,0.00,0,0,0,0,0,0,0,0,0,0,0,0,0
20200316,708569,力致統一97購01,,,,,,0.00,0,0,0,0,0,0,0,0,0,0,0,0,0
20200316,708570,力致統一97購02,0.03,0.03,0.03,0.03,-0.03,-50.0,80000,2,2400,0,0,0,0,0,0,80000,0,80000,80000
20200316,708571,環球晶統一97購01,,,,,,0.00,0,0,0,0,0,0,0,0,0,0,0,0,0
20200316,708572,兆利凱基98購02,,,,,,0.00,0,0,0,0,0,0,0,0,0,0,0,0,0
20200316,708573,昂寶凱基98購02,,,,,,0.00,0,0,0,0,0,0,0,0,0,0,0,0,0
20200316,708574,威剛凱基99購01,0.23,0.27,0.21,0.21,+0.04,23.53,196000,21,46260,0,0,0,0,0,0,196000,0,196000,196000
20200316,708575,精測凱基98購01,,,,,,0.00,0,0,0,0,0,0,0,0,0,0,0,0,0
20200316,708576,聯亞凱基99購01,0.13,0.17,0.13,0.17,+0.04,30.77,11000,2,1470,0,0,0,0,0,0,0,1000,-1000,-1000
20200316,708577,頎邦凱基97購03,,,,,,0.00,0,0,0,0,0,0,0,0,0,0,0,0,0
20200316,708578,中美晶麥證97購01,0.58,0.61,0.57,0.57,-0.04,-6.56,50000,3,28930,47000,0,47000,0,0,0,47000,0,47000,47000
20200316,708579,原相麥證97購01,0.69,0.72,0.47,0.47,-0.23,-32.86,825000,29,511000,401000,310000,91000,0,0,0,401000,310000,91000,91000
20200316,708580,神盾元富97購01,,,,,,0.00,0,0,0,0,0,0,0,0,0,0,0,0,0
20200316,708581,神盾元富97購02,,,,,,0.00,0,0,0,0,0,0,0,0,0,0,0,0,0
20200316,708582,宇峻元大97購04,,,,,,0.00,0,0,0,0,0,0,0,0,0,0,0,0,0
20200316,708583,亞泰元大97購01,0.32,0.32,0.30,0.30,-0.07,-18.92,30000,3,9300,0,0,0,0,0,0,0,30000,-30000,-30000
20200316,708584,威剛元大98購02,0.30,0.32,0.18,0.18,-0.13,-41.94,233000,20,65390,0,0,0,0,0,0,135000,98000,37000,37000
20200316,708585,建榮元大97購02,0.04,0.04,0.04,0.04,-0.02,-33.33,10000,1,400,0,0,0,0,0,0,0,10000,-10000,-10000
20200316,708586,原相元大98購01,1.28,1.28,1.13,1.13,-0.15,-11.72,31000,4,38590,0,0,0,0,0,0,26000,5000,21000,21000
20200316,708587,原相元大99購01,1.30,1.34,1.00,1.00,-0.05,-4.76,99000,11,116710,0,0,0,0,0,0,53000,35000,18000,18000
20200316,708588,群聯元大98購01,0.23,0.23,0.10,0.10,-0.11,-52.38,843000,6,85600,0,0,0,0,0,0,833000,10000,823000,823000
20200316,708589,聯亞元大98購01,0.31,0.31,0.29,0.29,+0.08,38.1,22000,3,6680,0,0,0,0,0,0,22000,0,22000,22000
20200316,708590,雙美元大99購01,0.52,0.52,0.43,0.43,+0.05,13.16,40000,4,19000,0,0,0,0,0,0,20000,40000,-20000,-20000
20200316,708591,雙鴻元大99購03,0.15,0.15,0.10,0.10,-0.06,-37.5,32000,4,3900,0,0,0,0,0,0,0,32000,-32000,-32000
20200316,708592,穩懋元大97購03,1.02,1.04,0.74,0.74,-0.23,-23.71,235000,21,221800,0,0,0,0,0,0,175000,160000,15000,15000
20200316,708593,穩懋元大97購04,0.57,0.60,0.42,0.42,0.00,0.0,54000,8,28710,0,0,0,0,0,0,24000,30000,-6000,-6000
20200316,708594,鈊象元大99購01,3.34,3.34,2.50,2.50,0.00,0.0,94000,9,292410,0,0,0,0,0,0,92000,1000,91000,91000
20200316,708595,大江兆豐97購02,,,,,,0.00,0,0,0,0,0,0,0,0,0,0,0,0,0
20200316,708596,群聯兆豐98購01,,,,,,0.00,0,0,0,0,0,0,0,0,0,0,0,0,0
20200316,708597,迅得康和97購01,,,,,,0.00,0,0,0,0,0,0,0,0,0,0,0,0,0
20200316,708598,六角群益98購02,0.18,0.20,0.16,0.17,0.00,0.0,41000,8,7060,0,0,0,0,0,0,41000,0,41000,41000
20200316,708599,亞泰群益97購01,,,,,,0.00,0,0,0,0,0,0,0,0,0,0,0,0,0
20200316,708600,台燿亞東97購01,,,,,,0.00,0,0,0,0,0,0,0,0,0,0,0,0,0
20200316,708601,光頡永豐97購01,,,,,,0.00,0,0,0,0,0,0,0,0,0,0,0,0,0
20200316,708602,亞泰永豐97購01,,,,,,0.00,0,0,0,0,0,0,0,0,0,0,0,0,0
20200316,708603,力致元富97購02,0.08,0.08,0.06,0.06,0.00,0.0,200000,9,13500,0,0,0,0,0,0,70000,130000,-60000,-60000
20200316,708604,鈺太元富97購01,0.28,0.37,0.25,0.32,+0.08,33.33,1094000,11,328390,0,0,0,0,0,0,0,1094000,-1094000,-1094000
20200316,708605,久元台新97購01,,,,,,0.00,0,0,0,0,0,0,0,0,0,0,0,0,0
20200316,708606,大中台新97購01,0.09,0.09,0.09,0.09,-0.03,-25.0,20000,1,1800,0,0,0,0,0,0,20000,0,20000,20000
20200316,708607,晶焱台新97購01,0.36,0.36,0.36,0.36,-0.18,-33.33,1000,1,360,0,0,0,0,0,0,1000,0,1000,1000
20200316,708608,光頡統一97購01,,,,,,0.00,0,0,0,0,0,0,0,0,0,0,0,0,0
20200316,708609,光頡統一99購01,,,,,,0.00,0,0,0,0,0,0,0,0,0,0,0,0,0
20200316,708610,合晶統一97購01,,,,,,0.00,0,0,0,0,0,0,0,0,0,0,0,0,0
20200316,708611,大中中信99購01,0.09,0.09,0.08,0.08,-0.01,-11.11,20000,2,1700,0,0,0,0,0,0,0,20000,-20000,-20000
20200316,708612,亞泰中信97購01,,,,,,0.00,0,0,0,0,0,0,0,0,0,0,0,0,0
20200316,708613,博智中信99購01,,,,,,0.00,0,0,0,0,0,0,0,0,0,0,0,0,0
20200316,708614,緯軟中信97購01,,,,,,0.00,0,0,0,0,0,0,0,0,0,0,0,0,0
20200316,708615,台半凱基98購01,0.17,0.17,0.13,0.13,-0.01,-7.14,120000,2,16400,0,0,0,0,0,0,0,120000,-120000,-120000
20200316,708616,兆利凱基98購03,0.16,0.16,0.16,0.16,-0.03,-15.79,20000,1,3200,0,0,0,0,0,0,0,20000,-20000,-20000
20200316,708617,宇峻凱基99購01,,,,,,0.00,0,0,0,0,0,0,0,0,0,0,0,0,0
20200316,708618,新普凱基98購01,,,,,,0.00,0,0,0,0,0,0,0,0,0,0,0,0,0
20200316,708619,璟德凱基98購01,0.20,0.20,0.18,0.18,0.00,0.0,310000,3,58000,0,0,0,0,0,0,100000,210000,-110000,-110000
20200316,708620,環球晶凱基97購02,0.62,0.70,0.61,0.61,-0.13,-17.57,696000,6,443980,0,0,0,0,0,0,18000,696000,-678000,-678000
20200316,708621,頎邦第一97購01,,,,,,0.00,0,0,0,0,0,0,0,0,0,0,0,0,0
20200316,708622,光頡永豐97購02,0.05,0.05,0.05,0.05,-0.02,-28.57,20000,2,1000,0,0,0,0,0,0,0,20000,-20000,-20000
20200316,708623,建榮永豐98購01,,,,,,0.00,0,0,0,0,0,0,0,0,0,0,0,0,0
20200316,708624,雙美永豐98購01,0.37,0.37,0.37,0.37,+0.08,27.59,3000,1,1110,0,0,0,0,0,0,0,3000,-3000,-3000
20200316,708625,雙鴻永豐98購01,,,,,,0.00,0,0,0,0,0,0,0,0,0,0,0,0,0
20200316,708626,亞泰國票97購01,,,,,,0.00,0,0,0,0,0,0,0,0,0,0,0,0,0
20200316,708627,新普國票98購01,1.08,1.08,0.72,0.72,-0.14,-16.28,29000,3,28920,0,0,0,0,0,0,20000,9000,11000,11000
20200316,708628,廣明國票98購01,,,,,,0.00,0,0,0,0,0,0,0,0,0,0,0,0,0
20200316,708629,璟德國票98購01,,,,,,0.00,0,0,0,0,0,0,0,0,0,0,0,0,0
20200316,708630,環宇國票98購01,,,,,,0.00,0,0,0,0,0,0,0,0,0,0,0,0,0
20200316,708631,頎邦國票98購01,,,,,,0.00,0,0,0,0,0,0,0,0,0,0,0,0,0
20200316,708632,M31元大98購01,0.10,0.10,0.10,0.10,-0.10,-50.0,30000,1,3000,0,0,0,0,0,0,30000,0,30000,30000
20200316,708633,昂寶元大98購02,,,,,,0.00,0,0,0,0,0,0,0,0,0,0,0,0,0
20200316,708634,信昌電元大98購02,,,,,,0.00,0,0,0,0,0,0,0,0,0,0,0,0,0
20200316,708635,建榮元大97購03,,,,,,0.00,0,0,0,0,0,0,0,0,0,0,0,0,0
20200316,708636,原相元大98購02,1.10,1.17,0.80,0.81,-0.31,-27.68,85000,11,75930,0,0,0,0,0,0,25000,49000,-24000,-24000
20200316,708637,群聯元大98購02,0.27,0.27,0.27,0.27,+0.15,125.0,5000,1,1350,0,0,0,0,0,0,0,5000,-5000,-5000
20200316,708638,精測元大97購04,0.22,0.22,0.20,0.20,0.00,0.0,310000,2,62040,0,0,0,0,0,0,308000,2000,306000,306000
20200316,708639,網龍元大97購01,0.04,0.04,0.04,0.04,+0.01,33.33,110000,2,4400,0,0,0,0,0,0,110000,0,110000,110000
20200316,708640,璟德元大97購03,0.19,0.19,0.16,0.16,-0.05,-23.81,22000,3,3680,0,0,0,0,0,0,0,22000,-22000,-22000
20200316,708641,鈊象元大98購02,4.40,4.40,3.03,3.03,-0.84,-21.71,36000,4,139010,0,0,0,0,0,0,27000,9000,18000,18000
20200316,708642,頎邦元大97購03,0.42,0.42,0.38,0.38,+0.16,72.73,80000,8,31200,0,0,0,0,0,0,0,80000,-80000,-80000
20200316,708643,頎邦元大97購04,0.42,0.43,0.39,0.39,+0.09,30.0,50000,6,20260,0,0,0,0,0,0,44000,10000,34000,34000
20200316,708644,雙美國泰99購01,0.44,0.47,0.41,0.41,+0.03,7.89,798000,11,353720,0,0,0,0,0,0,720000,438000,282000,282000
20200316,708645,聯亞兆豐98購01,0.29,0.30,0.22,0.22,-0.03,-12.0,13000,4,3080,0,0,0,0,0,0,13000,0,13000,13000
20200316,708646,櫃200兆豐97購01,0.41,0.46,0.23,0.23,-0.18,-43.9,669000,25,268550,0,0,0,0,0,0,614000,55000,559000,559000
20200316,708647,泰博群益97購01,2.70,2.70,2.70,2.70,+0.80,42.11,1000,1,2700,0,0,0,0,0,0,0,1000,-1000,-1000
20200316,708648,VHQ中信97購01,,,,,,0.00,0,0,0,0,0,0,0,0,0,0,0,0,0
20200316,708649,鈊象中信97購01,3.02,3.39,3.02,3.02,+0.07,2.37,84000,13,269030,0,0,0,0,0,0,29000,0,29000,29000
20200316,708650,迅得麥證98購01,,,,,,0.00,0,0,0,0,0,0,0,0,0,0,0,0,0
20200316,708651,大學光元富99購01,1.01,1.01,0.96,0.96,+0.02,2.13,20000,2,19700,0,0,0,0,0,0,0,20000,-20000,-20000
20200316,708652,光頡元富97購01,,,,,,0.00,0,0,0,0,0,0,0,0,0,0,0,0,0
20200316,708653,神盾元富97購03,0.15,0.15,0.09,0.09,-0.06,-40.0,122000,5,12530,0,0,0,0,0,0,7000,115000,-108000,-108000
20200316,708654,力致統一97購03,0.02,0.02,0.02,0.02,-0.08,-80.0,30000,1,600,0,0,0,0,0,0,0,0,0,0
20200316,708655,波若威統一99購01,0.13,0.13,0.13,0.13,-0.05,-27.78,30000,1,3900,0,0,0,0,0,0,30000,0,30000,30000
20200316,708656,信昌電統一98購01,,,,,,0.00,0,0,0,0,0,0,0,0,0,0,0,0,0
20200316,708657,兆利台新97購01,0.15,0.15,0.14,0.14,-0.07,-33.33,11000,2,1550,0,0,0,0,0,0,11000,0,11000,11000
20200316,708658,神盾台新98購01,0.15,0.15,0.10,0.10,-0.05,-33.33,145000,6,18200,0,0,0,0,0,0,0,145000,-145000,-145000
20200316,708659,合晶凱基97購03,,,,,,0.00,0,0,0,0,0,0,0,0,0,0,0,0,0
20200316,708660,宇峻凱基99購02,0.16,0.16,0.16,0.16,-0.09,-36.0,383000,2,61280,0,0,0,0,0,0,383000,0,383000,383000
20200316,708661,良維凱基97購03,0.21,0.23,0.14,0.14,-0.03,-17.65,669000,20,141860,0,0,0,0,0,0,179000,490000,-311000,-311000
20200316,708662,信昌電凱基98購02,,,,,,0.00,0,0,0,0,0,0,0,0,0,0,0,0,0
20200316,708663,茂達凱基97購01,0.51,0.51,0.42,0.42,-0.06,-12.5,205000,4,95750,0,0,0,0,0,0,165000,40000,125000,125000
20200316,708664,群聯凱基98購02,0.21,0.21,0.10,0.10,-0.13,-56.52,120000,4,14200,0,0,0,0,0,0,100000,20000,80000,80000
20200316,708665,網家凱基97購01,0.82,0.82,0.57,0.57,-0.07,-10.94,32000,3,23740,0,0,0,0,0,0,22000,10000,12000,12000
20200316,708666,聚積凱基97購01,,,,,,0.00,0,0,0,0,0,0,0,0,0,0,0,0,0
20200316,708667,廣明凱基98購02,0.14,0.14,0.14,0.14,-0.01,-6.67,50000,1,7000,0,0,0,0,0,0,50000,0,50000,50000
20200316,708668,優群凱基98購03,1.01,1.09,1.00,1.08,+0.13,13.68,95000,6,101050,0,0,0,0,0,0,95000,0,95000,95000
20200316,708669,聯亞凱基99購02,0.23,0.23,0.23,0.23,+0.10,76.92,8000,1,1840,0,0,0,0,0,0,8000,0,8000,8000
20200316,708670,鈺太凱基98購01,0.22,0.23,0.22,0.23,+0.05,27.78,250000,2,56000,0,0,0,0,0,0,250000,0,250000,250000
20200316,708671,頎邦凱基97購04,0.60,0.60,0.54,0.54,-0.07,-11.48,99000,5,54710,0,0,0,0,0,0,29000,74000,-45000,-45000
20200316,708672,M31元大99購01,0.24,0.24,0.16,0.16,-0.09,-36.0,112000,8,22170,0,0,0,0,0,0,100000,12000,88000,88000
20200316,708673,凡甲元大98購02,,,,,,0.00,0,0,0,0,0,0,0,0,0,0,0,0,0
20200316,708674,大宇資元大98購01,0.18,0.20,0.15,0.15,-0.09,-37.5,83000,10,13910,0,0,0,0,0,0,2000,81000,-79000,-79000
20200316,708675,六角元大98購02,0.24,0.25,0.18,0.18,-0.04,-18.18,30000,3,6700,0,0,0,0,0,0,0,30000,-30000,-30000
20200316,708676,昂寶元大97購02,,,,,,0.00,0,0,0,0,0,0,0,0,0,0,0,0,0
20200316,708677,晶焱元大98購01,0.50,0.50,0.43,0.43,0.00,0.0,70000,7,31500,0,0,0,0,0,0,0,70000,-70000,-70000
20200316,708678,鈊象元大97購04,5.50,5.50,5.20,5.20,-0.70,-11.86,4000,3,21400,0,0,0,0,0,0,4000,4000,0,0
20200316,708679,光頡國票98購01,,,,,,0.00,0,0,0,0,0,0,0,0,0,0,0,0,0
20200316,708680,金居國票98購01,0.13,0.13,0.13,0.13,+0.02,18.18,30000,1,3900,0,0,0,0,0,0,30000,0,30000,30000
20200316,708681,建榮國票99購01,,,,,,0.00,0,0,0,0,0,0,0,0,0,0,0,0,0
20200316,708682,穩懋國票98購01,0.70,0.70,0.70,0.70,+0.13,22.81,50000,1,35000,0,0,0,0,0,0,50000,0,50000,50000
20200316,708683,鈊象國票97購03,20.50,21.30,16.50,16.50,-2.70,-14.06,90000,22,1808200,0,0,0,0,0,0,89000,0,89000,89000
20200316,708684,光頡國泰98購01,0.51,0.55,0.36,0.36,-0.19,-34.55,107000,9,55390,0,0,0,0,0,0,33000,74000,-41000,-41000
20200316,708685,亞泰國泰98購01,,,,,,0.00,0,0,0,0,0,0,0,0,0,0,0,0,0
20200316,708686,世界兆豐97購01,1.16,1.16,1.16,1.16,+0.13,12.62,30000,1,34800,0,0,0,0,0,0,30000,0,30000,30000
20200316,708687,同致兆豐98購01,0.09,0.09,0.05,0.06,-0.04,-40.0,429000,36,26730,0,0,0,0,0,0,0,429000,-429000,-429000
20200316,708688,宜鼎兆豐98購01,1.01,1.21,0.98,0.98,+0.03,3.16,182000,10,191730,0,0,0,0,0,0,127000,70000,57000,57000
20200316,708689,勝麗群益98購02,0.26,0.26,0.24,0.24,-0.12,-33.33,30000,3,7400,0,0,0,0,0,0,0,30000,-30000,-30000
20200316,708690,晟德群益97購01,0.09,0.09,0.09,0.09,-0.01,-10.0,30000,2,2700,0,0,0,0,0,0,0,30000,-30000,-30000
20200316,708691,穩懋永豐97購02,0.66,0.66,0.53,0.53,+0.09,20.45,60000,5,36000,0,0,0,0,0,0,40000,20000,20000,20000
20200316,708692,元太亞東97購01,,,,,,0.00,0,0,0,0,0,0,0,0,0,0,0,0,0
20200316,708693,台半中信99購01,,,,,,0.00,0,0,0,0,0,0,0,0,0,0,0,0,0
20200316,708694,M31統一98購01,,,,,,0.00,0,0,0,0,0,0,0,0,0,0,0,0,0
20200316,708695,波若威統一97購01,,,,,,0.00,0,0,0,0,0,0,0,0,0,0,0,0,0
20200316,708696,建榮統一9A購01,,,,,,0.00,0,0,0,0,0,0,0,0,0,0,0,0,0
20200316,708697,建榮統一9A購02,,,,,,0.00,0,0,0,0,0,0,0,0,0,0,0,0,0
20200316,708698,雙鴻統一97購02,,,,,,0.00,0,0,0,0,0,0,0,0,0,0,0,0,0
20200316,708699,雙鴻統一99購01,0.27,0.27,0.25,0.25,-0.06,-19.35,4000,2,1040,0,0,0,0,0,0,0,4000,-4000,-4000
20200316,708700,穩懋統一99購01,0.83,0.83,0.83,0.83,-0.01,-1.19,10000,1,8300,0,0,0,0,0,0,10000,0,10000,10000
20200316,708701,建榮凱基97購02,0.05,0.05,0.05,0.05,-0.05,-50.0,480000,1,24000,0,0,0,0,0,0,480000,0,480000,480000
20200316,708702,原相凱基98購02,2.20,2.33,1.50,1.50,-0.84,-35.9,223000,29,410980,0,0,0,0,0,0,33000,184000,-151000,-151000
20200316,708703,精測凱基97購04,0.39,0.41,0.39,0.41,+0.15,57.69,60000,6,23900,0,0,0,0,0,0,60000,0,60000,60000
20200316,708704,環球晶凱基97購03,0.83,0.92,0.62,0.62,-0.43,-40.95,272000,26,209500,0,0,0,0,0,0,50000,187000,-137000,-137000
20200316,708705,穩懋凱基97購01,0.73,0.75,0.49,0.49,-0.14,-22.22,2909000,12,1907600,0,0,0,0,0,0,1349000,1560000,-211000,-211000
20200316,708706,鈺太凱基98購02,0.29,0.40,0.29,0.30,+0.04,15.38,90000,9,30600,0,0,0,0,0,0,0,90000,-90000,-90000
20200316,708707,大江元大97購04,,,,,,0.00,0,0,0,0,0,0,0,0,0,0,0,0,0
20200316,708708,光頡元大98購01,,,,,,0.00,0,0,0,0,0,0,0,0,0,0,0,0,0
20200316,708709,新普元大97購02,0.81,0.81,0.53,0.53,-0.29,-35.37,59000,5,39180,0,0,0,0,0,0,29000,30000,-1000,-1000
20200316,708710,新普元大97購03,1.41,1.41,1.07,1.07,0.00,0.0,27000,4,33590,0,0,0,0,0,0,12000,17000,-5000,-5000
20200316,708711,群聯元大97購05,,,,,,0.00,0,0,0,0,0,0,0,0,0,0,0,0,0
20200316,708712,聯亞元大97購05,0.34,0.34,0.34,0.34,+0.07,25.93,20000,1,6800,0,0,0,0,0,0,20000,0,20000,20000
20200316,708713,雙鴻元大99購04,0.29,0.31,0.18,0.18,-0.10,-35.71,288000,23,69560,0,0,0,0,0,0,133000,140000,-7000,-7000
20200316,708714,聯亞元富97購01,,,,,,0.00,0,0,0,0,0,0,0,0,0,0,0,0,0
20200316,708715,台燿日盛97購01,0.28,0.32,0.27,0.27,-0.05,-15.62,289000,11,82430,0,0,0,0,0,0,289000,0,289000,289000
20200316,708716,建榮永豐97購02,,,,,,0.00,0,0,0,0,0,0,0,0,0,0,0,0,0
20200316,708717,閎康永豐97購01,,,,,,0.00,0,0,0,0,0,0,0,0,0,0,0,0,0
20200316,708718,譜瑞永豐97購01,0.82,0.92,0.74,0.74,-0.03,-3.9,62000,8,53390,0,0,0,0,0,0,3000,62000,-59000,-59000
20200316,708719,鈊象永豐98購01,,,,,,0.00,0,0,0,0,0,0,0,0,0,0,0,0,0
20200316,708720,力致國票97購01,,,,,,0.00,0,0,0,0,0,0,0,0,0,0,0,0,0
20200316,708721,光頡國票98購02,,,,,,0.00,0,0,0,0,0,0,0,0,0,0,0,0,0
20200316,708722,金居國票98購02,,,,,,0.00,0,0,0,0,0,0,0,0,0,0,0,0,0
20200316,708723,威剛國票98購02,0.73,0.73,0.73,0.73,+0.10,15.87,20000,2,14600,0,0,0,0,0,0,20000,0,20000,20000
20200316,708724,晶焱國票98購01,,,,,,0.00,0,0,0,0,0,0,0,0,0,0,0,0,0
20200316,708725,群聯國票98購02,0.21,0.21,0.16,0.16,-0.03,-15.79,19000,2,3540,0,0,0,0,0,0,19000,0,19000,19000
20200316,708726,廣明國票98購02,,,,,,0.00,0,0,0,0,0,0,0,0,0,0,0,0,0
20200316,708727,光頡國泰99購01,,,,,,0.00,0,0,0,0,0,0,0,0,0,0,0,0,0
20200316,708728,原相國泰98購03,,,,,,0.00,0,0,0,0,0,0,0,0,0,0,0,0,0
20200316,708729,大江富邦99購01,0.10,0.10,0.06,0.06,-0.01,-14.29,297000,9,24020,0,0,0,0,0,0,0,88000,-88000,-88000
20200316,708730,久元群益97購01,0.54,0.54,0.44,0.44,-0.22,-33.33,46000,2,20340,0,0,0,0,0,0,45000,1000,44000,44000
20200316,708731,聚積群益97購02,,,,,,0.00,0,0,0,0,0,0,0,0,0,0,0,0,0
20200316,708732,頎邦群益98購02,,,,,,0.00,0,0,0,0,0,0,0,0,0,0,0,0,0
20200316,708733,M31凱基99購01,0.10,0.10,0.10,0.10,-0.03,-23.08,15000,2,1500,0,0,0,0,0,0,0,15000,-15000,-15000
20200316,708734,中美晶凱基97購04,,,,,,0.00,0,0,0,0,0,0,0,0,0,0,0,0,0
20200316,708735,昇達科凱基97購01,,,,,,0.00,0,0,0,0,0,0,0,0,0,0,0,0,0
20200316,708736,聯亞凱基97購02,,,,,,0.00,0,0,0,0,0,0,0,0,0,0,0,0,0
20200316,708737,雙美凱基99購01,,,,,,0.00,0,0,0,0,0,0,0,0,0,0,0,0,0
20200316,708738,穩懋凱基97購02,1.15,1.19,1.05,1.05,+0.45,75.0,145000,8,161930,0,0,0,0,0,0,145000,0,145000,145000
20200316,708739,穩懋凱基97購03,0.98,0.98,0.98,0.98,+0.14,16.67,5000,1,4900,0,0,0,0,0,0,0,5000,-5000,-5000
20200316,708740,譜瑞凱基97購01,1.26,1.49,1.15,1.15,+0.25,27.78,100000,20,134820,0,0,0,0,0,0,24000,80000,-56000,-56000
20200316,708741,鈊象凱基98購03,5.85,6.00,3.91,3.91,-1.24,-24.08,330000,60,1636190,0,0,0,0,0,0,212000,245000,-33000,-33000
20200316,708742,新普麥證97購01,0.56,0.56,0.45,0.45,-0.12,-21.05,44000,4,21820,28000,16000,12000,0,0,0,28000,16000,12000,12000
20200316,708743,同致元富97購01,,,,,,0.00,0,0,0,0,0,0,0,0,0,0,0,0,0
20200316,708744,金居元富97購01,0.19,0.20,0.19,0.20,+0.04,25.0,110000,3,21000,0,0,0,0,0,0,110000,0,110000,110000
20200316,708745,原相元富97購01,0.51,0.51,0.46,0.46,-0.43,-48.31,24000,4,11690,0,0,0,0,0,0,8000,0,8000,8000
20200316,708746,穩懋元富97購01,0.67,0.68,0.67,0.68,+0.04,6.25,178000,3,119460,0,0,0,0,0,0,0,178000,-178000,-178000
20200316,708747,立端亞東98購01,,,,,,0.00,0,0,0,0,0,0,0,0,0,0,0,0,0
20200316,708748,合晶永豐97購03,,,,,,0.00,0,0,0,0,0,0,0,0,0,0,0,0,0
20200316,708749,旺矽永豐97購03,,,,,,0.00,0,0,0,0,0,0,0,0,0,0,0,0,0
20200316,708750,信驊永豐97購01,0.68,0.70,0.44,0.44,-0.09,-16.98,1498000,34,923550,0,0,0,0,0,0,1109000,389000,720000,720000
20200316,708751,聯亞永豐97購01,0.31,0.31,0.31,0.31,+0.11,55.0,10000,1,3100,0,0,0,0,0,0,10000,0,10000,10000
20200316,708752,原相統一97購01,0.57,0.57,0.35,0.35,-0.25,-41.67,130000,8,60200,0,0,0,0,0,0,128000,0,128000,128000
20200316,708753,廣明統一9A購01,,,,,,0.00,0,0,0,0,0,0,0,0,0,0,0,0,0
20200316,708754,聯亞統一98購01,0.21,0.21,0.21,0.21,-0.22,-51.16,12000,1,2520,0,0,0,0,0,0,12000,0,12000,12000
20200316,708755,鈊象統一99購01,,,,,,0.00,0,0,0,0,0,0,0,0,0,0,0,0,0
20200316,708756,大中國票98購01,,,,,,0.00,0,0,0,0,0,0,0,0,0,0,0,0,0
20200316,708757,大江國票97購06,,,,,,0.00,0,0,0,0,0,0,0,0,0,0,0,0,0
20200316,708758,佳邦國票98購01,,,,,,0.00,0,0,0,0,0,0,0,0,0,0,0,0,0
20200316,708759,宜鼎國票97購04,,,,,,0.00,0,0,0,0,0,0,0,0,0,0,0,0,0
20200316,708760,信昌電國票98購02,,,,,,0.00,0,0,0,0,0,0,0,0,0,0,0,0,0
20200316,708761,宣德國票98購01,,,,,,0.00,0,0,0,0,0,0,0,0,0,0,0,0,0
20200316,708762,神盾國票98購02,,,,,,0.00,0,0,0,0,0,0,0,0,0,0,0,0,0
20200316,708763,群聯國票98購03,,,,,,0.00,0,0,0,0,0,0,0,0,0,0,0,0,0
20200316,708764,緯軟國票98購01,0.10,0.10,0.06,0.06,-0.05,-45.45,170000,16,15500,0,0,0,0,0,0,20000,150000,-130000,-130000
20200316,708765,威剛國泰98購03,,,,,,0.00,0,0,0,0,0,0,0,0,0,0,0,0,0
20200316,708766,廣明國泰98購01,,,,,,0.00,0,0,0,0,0,0,0,0,0,0,0,0,0
20200316,708767,穩懋富邦99購01,0.68,0.76,0.56,0.58,-0.04,-6.45,549000,20,363450,0,0,0,0,0,0,229000,300000,-71000,-71000
20200316,708768,六角元大97購01,,,,,,0.00,0,0,0,0,0,0,0,0,0,0,0,0,0
20200316,708769,合晶元大98購03,0.40,0.45,0.40,0.45,+0.12,36.36,20000,2,8500,0,0,0,0,0,0,10000,10000,0,0
20200316,708770,泰博元大97購01,1.89,2.26,1.80,1.95,+0.22,12.72,262000,30,538920,0,0,0,0,0,0,47000,215000,-168000,-168000
20200316,708771,精測元大97購05,0.23,0.23,0.23,0.23,0.00,0.0,10000,1,2300,0,0,0,0,0,0,0,10000,-10000,-10000
20200316,708772,聚積元大98購01,0.42,0.44,0.42,0.44,+0.05,12.82,10000,2,4260,0,0,0,0,0,0,10000,0,10000,10000
20200316,708773,廣明元大97購02,,,,,,0.00,0,0,0,0,0,0,0,0,0,0,0,0,0
20200316,708774,璟德元大97購04,0.22,0.23,0.21,0.21,-0.01,-4.55,246000,5,56240,0,0,0,0,0,0,234000,236000,-2000,-2000
20200316,708775,穩懋元大97購07,0.72,0.81,0.56,0.58,-0.14,-19.44,676000,46,504250,0,0,0,0,0,0,484000,376000,108000,108000
20200316,708776,穩懋元大98購01,0.80,0.89,0.64,0.64,-0.19,-22.89,680000,68,543420,0,0,0,0,0,0,350000,411000,-61000,-61000
20200316,708777,旺矽兆豐98購01,0.20,0.20,0.20,0.20,-0.05,-20.0,50000,1,10000,0,0,0,0,0,0,50000,0,50000,50000
20200316,708778,環球晶兆豐98購01,0.55,0.57,0.37,0.37,-0.26,-41.27,1147000,31,595960,0,0,0,0,0,0,625000,738000,-113000,-113000
20200316,708779,雙鴻兆豐98購01,,,,,,0.00,0,0,0,0,0,0,0,0,0,0,0,0,0
20200316,708780,穩懋兆豐97購03,0.34,0.38,0.27,0.27,-0.10,-27.03,90000,3,32300,0,0,0,0,0,0,20000,70000,-50000,-50000
20200316,708781,信驊群益97購01,2.45,2.45,1.44,1.44,-0.72,-33.33,19000,5,38850,0,0,0,0,0,0,15000,4000,11000,11000
20200316,708782,建榮群益98購01,0.10,0.10,0.10,0.10,+0.02,25.0,100000,2,10000,0,0,0,0,0,0,100000,100000,0,0
20200316,708783,優群群益99購01,,,,,,0.00,0,0,0,0,0,0,0,0,0,0,0,0,0
20200316,708784,環宇群益97購02,,,,,,0.00,0,0,0,0,0,0,0,0,0,0,0,0,0
20200316,708785,信驊中信9B購01,0.57,0.59,0.47,0.47,-0.09,-16.07,244000,20,129820,0,0,0,0,0,0,164000,0,164000,164000
20200316,708786,中美晶凱基97購05,2.17,2.17,1.47,1.47,-0.47,-24.23,27000,3,43190,0,0,0,0,0,0,2000,27000,-25000,-25000
20200316,708787,同致凱基98購02,,,,,,0.00,0,0,0,0,0,0,0,0,0,0,0,0,0
20200316,708788,泰博凱基99購01,1.39,1.64,1.33,1.40,+0.11,8.53,171000,18,249380,0,0,0,0,0,0,80000,81000,-1000,-1000
20200316,708789,群聯凱基97購01,0.69,0.73,0.69,0.73,+0.35,92.11,10000,2,7020,0,0,0,0,0,0,10000,0,10000,10000
20200316,708790,優群凱基98購04,1.22,1.31,1.08,1.08,+0.02,1.89,231000,21,271040,0,0,0,0,0,0,225000,159000,66000,66000
20200316,708791,雙美凱基99購02,,,,,,0.00,0,0,0,0,0,0,0,0,0,0,0,0,0
20200316,708792,凡甲國票98購01,0.59,0.60,0.58,0.58,+0.03,5.45,130000,6,76000,0,0,0,0,0,0,120000,0,120000,120000
20200316,708793,迅得國票98購01,,,,,,0.00,0,0,0,0,0,0,0,0,0,0,0,0,0
20200316,708794,旺矽國票98購01,0.20,0.21,0.20,0.20,+0.03,17.65,120000,12,24100,0,0,0,0,0,0,0,120000,-120000,-120000
20200316,708795,原相國票98購03,1.24,1.34,0.81,0.81,-0.07,-7.95,70000,20,86190,0,0,0,0,0,0,65000,5000,60000,60000
20200316,708796,兆利群益97購01,,,,,,0.00,0,0,0,0,0,0,0,0,0,0,0,0,0
20200316,708797,金居群益99購01,0.28,0.28,0.27,0.27,+0.02,8.0,61000,2,16970,0,0,0,0,0,0,0,61000,-61000,-61000
20200316,708798,晶焱群益99購01,,,,,,0.00,0,0,0,0,0,0,0,0,0,0,0,0,0
20200316,708799,閎康群益97購02,0.52,0.52,0.52,0.52,+0.09,20.93,31000,1,16120,0,0,0,0,0,0,31000,0,31000,31000
20200316,708800,凡甲元富99購01,0.49,0.53,0.46,0.46,-0.01,-2.13,136000,22,67570,0,0,0,0,0,0,77000,59000,18000,18000
20200316,708801,六角元富97購01,0.20,0.21,0.18,0.20,+0.03,17.65,10000,8,1990,0,0,0,0,0,0,10000,0,10000,10000
20200316,708802,欣銓元富97購01,0.52,0.53,0.39,0.39,-0.13,-25.0,596000,17,266670,0,0,0,0,0,0,171000,425000,-254000,-254000
20200316,708803,晶焱元富99購01,,,,,,0.00,0,0,0,0,0,0,0,0,0,0,0,0,0
20200316,708804,廣明元富99購01,0.20,0.20,0.20,0.20,-0.02,-9.09,10000,1,2000,0,0,0,0,0,0,0,10000,-10000,-10000
20200316,708805,環球晶元富98購01,0.54,0.54,0.41,0.41,-0.19,-31.67,190000,9,85800,0,0,0,0,0,0,180000,50000,130000,130000
20200316,708806,環球晶元富99購01,0.64,0.64,0.41,0.41,-0.23,-35.94,870000,59,443030,0,0,0,0,0,0,290000,320000,-30000,-30000
20200316,708807,雙美元富97購01,0.13,0.13,0.11,0.11,+0.02,22.22,150000,11,17500,0,0,0,0,0,0,50000,100000,-50000,-50000
20200316,708808,雙鴻元富97購01,,,,,,0.00,0,0,0,0,0,0,0,0,0,0,0,0,0
20200316,708809,穩懋元富97購02,1.01,1.08,0.68,0.70,-0.28,-28.57,853000,25,780450,0,0,0,0,0,0,172000,681000,-509000,-509000
20200316,708810,鈊象元富97購01,3.64,4.94,3.64,4.94,+1.30,35.71,10000,3,42900,0,0,0,0,0,0,5000,0,5000,5000
20200316,708811,雙鴻國泰98購01,0.19,0.19,0.17,0.17,-0.12,-41.38,35000,2,6150,0,0,0,0,0,0,0,35000,-35000,-35000
20200316,708812,精測台新98購01,,,,,,0.00,0,0,0,0,0,0,0,0,0,0,0,0,0
20200316,708813,宇峻元大98購01,0.23,0.23,0.23,0.23,+0.06,35.29,30000,1,6900,0,0,0,0,0,0,30000,0,30000,30000
20200316,708814,建榮元大97購04,,,,,,0.00,0,0,0,0,0,0,0,0,0,0,0,0,0
20200316,708815,泰博元大97購02,1.78,2.30,1.78,1.95,+0.18,10.17,104000,13,220760,0,0,0,0,0,0,5000,99000,-94000,-94000
20200316,708816,聯亞元大97購06,,,,,,0.00,0,0,0,0,0,0,0,0,0,0,0,0,0
20200316,708817,譜瑞元大98購01,2.91,2.91,2.69,2.69,+0.21,8.47,44000,3,120220,0,0,0,0,0,0,39000,43000,-4000,-4000
20200316,708818,鈊象元大98購03,2.40,2.55,1.60,1.70,-0.60,-26.09,146000,24,299920,0,0,0,0,0,0,40000,63000,-23000,-23000
20200316,708819,合晶永豐97購04,0.33,0.34,0.33,0.34,+0.02,6.25,49000,3,16330,0,0,0,0,0,0,49000,0,49000,49000
20200316,708820,威剛永豐99購01,,,,,,0.00,0,0,0,0,0,0,0,0,0,0,0,0,0
20200316,708821,原相永豐97購02,0.37,0.42,0.25,0.25,-0.17,-40.48,882000,45,296950,0,0,0,0,0,0,456000,386000,70000,70000
20200316,708822,泰博永豐97購01,0.62,0.75,0.62,0.71,+0.13,22.41,545000,16,368600,0,0,0,0,0,0,200000,345000,-145000,-145000
20200316,708823,勝麗永豐97購01,0.05,0.05,0.05,0.05,-0.05,-50.0,10000,1,500,0,0,0,0,0,0,0,10000,-10000,-10000
20200316,708824,廣明永豐97購03,,,,,,0.00,0,0,0,0,0,0,0,0,0,0,0,0,0
20200316,708825,碩禾中信9A購01,0.08,0.08,0.06,0.06,-0.03,-33.33,28000,5,1760,0,0,0,0,0,0,0,28000,-28000,-28000
20200316,708826,威剛統一9A購01,,,,,,0.00,0,0,0,0,0,0,0,0,0,0,0,0,0
20200316,708827,群聯統一97購02,,,,,,0.00,0,0,0,0,0,0,0,0,0,0,0,0,0
20200316,708828,六角凱基99購01,,,,,,0.00,0,0,0,0,0,0,0,0,0,0,0,0,0
20200316,708829,宜鼎凱基98購01,0.36,0.38,0.31,0.34,-0.02,-5.56,73000,10,25430,0,0,0,0,0,0,42000,31000,11000,11000
20200316,708830,信昌電凱基97購03,,,,,,0.00,0,0,0,0,0,0,0,0,0,0,0,0,0
20200316,708831,廣明凱基99購01,,,,,,0.00,0,0,0,0,0,0,0,0,0,0,0,0,0
20200316,708832,群聯台新97購04,,,,,,0.00,0,0,0,0,0,0,0,0,0,0,0,0,0
20200316,708833,中美晶元大97購05,2.57,2.72,2.09,2.18,-0.52,-19.26,157000,13,400510,0,0,0,0,0,0,114000,121000,-7000,-7000
20200316,708834,中美晶元大97購06,2.13,2.28,1.57,1.57,-0.69,-30.53,111000,20,240560,0,0,0,0,0,0,101000,82000,19000,19000
20200316,708835,昂寶元大97購03,,,,,,0.00,0,0,0,0,0,0,0,0,0,0,0,0,0
20200316,708836,宣德元大97購02,0.97,0.97,0.62,0.62,-0.41,-39.81,11000,2,10320,0,0,0,0,0,0,0,11000,-11000,-11000
20200316,708837,新普元大97購04,1.07,1.19,0.80,0.81,-0.44,-35.2,162000,8,143490,0,0,0,0,0,0,141000,31000,110000,110000
20200316,708838,新普元大97購05,0.95,0.95,0.95,0.95,+0.23,31.94,10000,1,9500,0,0,0,0,0,0,10000,0,10000,10000
20200316,708839,群聯元大97購06,0.08,0.08,0.08,0.08,-0.14,-63.64,20000,1,1600,0,0,0,0,0,0,0,0,0,0
20200316,708840,雍智元大99購01,0.31,0.31,0.26,0.26,-0.09,-25.71,95000,6,26350,0,0,0,0,0,0,70000,25000,45000,45000
20200316,708841,網龍元大98購01,0.07,0.08,0.06,0.06,0.00,0.0,130000,8,8600,0,0,0,0,0,0,60000,70000,-10000,-10000
20200316,708842,環球晶元大97購04,1.36,1.36,0.84,0.84,-0.55,-39.57,35000,4,43320,10000,0,10000,0,0,0,20000,15000,5000,15000
20200316,708843,環球晶元大97購05,1.36,1.52,0.87,0.87,-0.68,-43.87,178000,15,221660,0,0,0,0,0,0,125000,58000,67000,67000
20200316,708844,聯亞元大97購07,0.96,1.00,0.87,0.87,+0.44,102.33,27000,5,25600,0,0,0,0,0,0,27000,0,27000,27000
20200316,708845,雙鴻元大97購03,0.37,0.37,0.18,0.18,-0.16,-47.06,593000,62,114380,0,0,0,0,0,0,5000,588000,-583000,-583000
20200316,708846,鈊象元大98購04,1.77,2.09,1.35,1.38,-0.50,-26.6,562000,84,941440,0,0,0,0,0,0,100000,191000,-91000,-91000
20200316,708847,群聯第一97購01,,,,,,0.00,0,0,0,0,0,0,0,0,0,0,0,0,0
20200316,708848,中美晶永豐97購01,0.40,0.44,0.40,0.44,+0.03,7.32,12000,3,5200,0,0,0,0,0,0,12000,2000,10000,10000
20200316,708849,胡連永豐97購01,,,,,,0.00,0,0,0,0,0,0,0,0,0,0,0,0,0
20200316,708850,閎康永豐97購02,,,,,,0.00,0,0,0,0,0,0,0,0,0,0,0,0,0
20200316,708851,精測永豐97購02,0.23,0.23,0.23,0.23,0.00,0.0,150000,1,34500,0,0,0,0,0,0,150000,0,150000,150000
20200316,708852,鈊象永豐97購02,2.28,3.06,1.62,1.63,-1.05,-39.18,371000,52,893630,0,0,0,0,0,0,182000,140000,42000,42000
20200316,708853,世界群益98購04,,,,,,0.00,0,0,0,0,0,0,0,0,0,0,0,0,0
20200316,708854,晶焱群益99購02,,,,,,0.00,0,0,0,0,0,0,0,0,0,0,0,0,0
20200316,708855,大江元富97購01,,,,,,0.00,0,0,0,0,0,0,0,0,0,0,0,0,0
20200316,708856,台燿元富97購01,0.38,0.44,0.35,0.39,-0.05,-11.36,211000,9,82580,0,0,0,0,0,0,171000,40000,131000,131000
20200316,708857,宜鼎元富97購01,,,,,,0.00,0,0,0,0,0,0,0,0,0,0,0,0,0
20200316,708858,昇達科元富97購01,,,,,,0.00,0,0,0,0,0,0,0,0,0,0,0,0,0
20200316,708859,信驊元富97購01,,,,,,0.00,0,0,0,0,0,0,0,0,0,0,0,0,0
20200316,708860,威剛元富97購02,0.13,0.20,0.13,0.20,-0.05,-20.0,35000,2,5250,0,0,0,0,0,0,25000,0,25000,25000
20200316,708861,新普元富97購01,,,,,,0.00,0,0,0,0,0,0,0,0,0,0,0,0,0
20200316,708862,網家元富97購01,0.37,0.37,0.27,0.28,-0.07,-20.0,70000,7,22300,0,0,0,0,0,0,0,70000,-70000,-70000
20200316,708863,聚積元富97購01,0.17,0.17,0.17,0.17,-0.05,-22.73,80000,1,13600,0,0,0,0,0,0,80000,0,80000,80000
20200316,708864,穩懋元富97購03,0.68,0.71,0.63,0.63,+0.11,21.15,142000,6,93580,0,0,0,0,0,0,30000,82000,-52000,-52000
20200316,708865,直得國票97購01,0.50,0.50,0.28,0.28,-0.22,-44.0,43000,5,14400,0,0,0,0,0,0,3000,40000,-37000,-37000
20200316,708866,原相國泰98購04,,,,,,0.00,0,0,0,0,0,0,0,0,0,0,0,0,0
20200316,708867,鈊象國泰99購01,2.25,2.50,2.05,2.05,-0.15,-6.82,74000,22,165510,0,0,0,0,0,0,42000,50000,-8000,-8000
20200316,708868,鈊象中信99購01,1.64,1.82,1.40,1.40,-0.22,-13.58,967000,67,1572250,0,0,0,0,0,0,678000,10000,668000,668000
20200316,708869,凡甲凱基98購01,0.50,0.51,0.40,0.40,+0.01,2.56,265000,8,127000,0,0,0,0,0,0,239000,155000,84000,84000
20200316,708870,大江凱基98購03,,,,,,0.00,0,0,0,0,0,0,0,0,0,0,0,0,0
20200316,708871,信驊凱基98購01,0.90,0.94,0.70,0.70,+0.06,9.38,3196000,32,2657610,0,0,0,0,0,0,1636000,1560000,76000,76000
20200316,708872,新鉅科凱基97購01,,,,,,0.00,0,0,0,0,0,0,0,0,0,0,0,0,0
20200316,708873,精測凱基98購02,,,,,,0.00,0,0,0,0,0,0,0,0,0,0,0,0,0
20200316,708874,群聯統一97購03,,,,,,0.00,0,0,0,0,0,0,0,0,0,0,0,0,0
20200316,708875,譜瑞統一97購01,1.16,1.17,1.14,1.16,+0.39,50.65,74000,5,85800,0,0,0,0,0,0,0,74000,-74000,-74000
20200316,708876,信昌電兆豐98購01,0.11,0.11,0.11,0.11,+0.01,10.0,30000,2,3300,0,0,0,0,0,0,0,30000,-30000,-30000
20200316,708877,胡連康和97購01,,,,,,0.00,0,0,0,0,0,0,0,0,0,0,0,0,0
20200316,708878,台燿群益97購01,,,,,,0.00,0,0,0,0,0,0,0,0,0,0,0,0,0
20200316,708879,博智群益97購01,4.09,4.88,4.09,4.24,+0.12,2.91,75000,19,340630,0,0,0,0,0,0,35000,33000,2000,2000
20200316,708880,雙鴻群益99購01,0.22,0.22,0.14,0.14,-0.09,-39.13,40000,3,7500,0,0,0,0,0,0,0,40000,-40000,-40000
20200316,708881,金居國泰99購01,,,,,,0.00,0,0,0,0,0,0,0,0,0,0,0,0,0
20200316,708882,威剛元富97購04,,,,,,0.00,0,0,0,0,0,0,0,0,0,0,0,0,0
20200316,708883,原相元富97購02,0.49,0.50,0.39,0.39,-0.09,-18.75,535000,38,226250,0,0,0,0,0,0,280000,224000,56000,56000
20200316,708884,聯亞元富97購03,,,,,,0.00,0,0,0,0,0,0,0,0,0,0,0,0,0
20200316,708885,穩懋元富97購04,0.96,0.96,0.68,0.68,-0.26,-27.66,356000,11,322700,0,0,0,0,0,0,319000,35000,284000,284000
20200316,708886,鈊象元富97購02,3.57,3.89,2.37,2.60,-0.41,-13.62,281000,30,859210,0,0,0,0,0,0,124000,155000,-31000,-31000
20200316,708887,鈊象台新97購02,,,,,,0.00,0,0,0,0,0,0,0,0,0,0,0,0,0
20200316,708888,中美晶元大97購07,1.53,1.53,1.53,1.53,-0.09,-5.56,10000,1,15300,0,0,0,0,0,0,0,10000,-10000,-10000
20200316,708889,台燿元大97購01,0.31,0.35,0.31,0.35,+0.02,6.06,140000,7,48120,0,0,0,0,0,0,130000,10000,120000,120000
20200316,708890,宜鼎元大97購02,0.69,0.80,0.69,0.80,+0.04,5.26,30000,2,22900,0,0,0,0,0,0,10000,0,10000,10000
20200316,708891,金居元大99購01,,,,,,0.00,0,0,0,0,0,0,0,0,0,0,0,0,0
20200316,708892,胡連元大97購01,,,,,,0.00,0,0,0,0,0,0,0,0,0,0,0,0,0
20200316,708893,泰博元大97購03,1.50,1.71,1.50,1.54,+0.14,10.0,102000,15,165110,0,0,0,0,0,0,31000,71000,-40000,-40000
20200316,708894,閎康元大97購01,0.33,0.33,0.27,0.27,-0.05,-15.62,420000,5,128000,0,0,0,0,0,0,420000,0,420000,420000
20200316,708895,環球晶元大97購06,0.80,0.85,0.59,0.59,-0.20,-25.32,59000,6,43110,0,0,0,0,0,0,20000,39000,-19000,-19000
20200316,708896,環球晶元大97購07,0.50,0.60,0.23,0.23,-0.38,-62.3,450000,34,195900,0,0,0,0,0,0,150000,290000,-140000,-140000
20200316,708897,櫃200元大99購03,,,,,,0.00,0,0,0,0,0,0,0,0,0,0,0,0,0
20200316,708898,櫃200元大99購04,,,,,,0.00,0,0,0,0,0,0,0,0,0,0,0,0,0
20200316,708899,頎邦元大97購05,0.55,0.55,0.47,0.47,-0.09,-16.07,30000,3,15100,0,0,0,0,0,0,0,30000,-30000,-30000
20200316,708900,中美晶元大97購08,1.77,1.77,1.77,1.77,-0.03,-1.67,5000,1,8850,0,0,0,0,0,0,5000,0,5000,5000
20200316,708901,台燿元大97購02,0.42,0.47,0.39,0.47,+0.02,4.44,160000,16,66260,0,0,0,0,0,0,50000,110000,-60000,-60000
20200316,708902,迅得元大99購01,,,,,,0.00,0,0,0,0,0,0,0,0,0,0,0,0,0
20200316,708903,宜鼎元大97購03,,,,,,0.00,0,0,0,0,0,0,0,0,0,0,0,0,0
20200316,708904,旺矽元大98購01,0.18,0.18,0.18,0.18,+0.01,5.88,20000,1,3600,0,0,0,0,0,0,20000,0,20000,20000
20200316,708905,威剛元大97購01,0.36,0.40,0.22,0.22,-0.14,-38.89,376000,38,110960,0,0,0,0,0,0,61000,310000,-249000,-249000
20200316,708906,泰博元大97購04,0.99,1.25,0.99,1.08,+0.11,11.34,525000,62,597130,0,0,0,0,0,0,226000,311000,-85000,-85000
20200316,708907,精測元大97購06,0.75,0.75,0.56,0.56,-0.17,-23.29,187000,6,128700,0,0,0,0,0,0,176000,27000,149000,149000
20200316,708908,廣明元大97購03,,,,,,0.00,0,0,0,0,0,0,0,0,0,0,0,0,0
20200316,708909,優群元大99購01,,,,,,0.00,0,0,0,0,0,0,0,0,0,0,0,0,0
20200316,708910,環球晶元大97購08,0.73,0.73,0.73,0.73,+0.02,2.82,40000,1,29200,0,0,0,0,0,0,40000,0,40000,40000
20200316,708911,環球晶元大97購09,0.43,0.43,0.43,0.43,-0.12,-21.82,99000,10,42570,0,0,0,0,0,0,0,99000,-99000,-99000
20200316,708912,世界麥證97購02,,,,,,0.00,0,0,0,0,0,0,0,0,0,0,0,0,0
20200316,708913,大江永豐97購03,,,,,,0.00,0,0,0,0,0,0,0,0,0,0,0,0,0
20200316,708914,旺矽永豐97購04,0.03,0.03,0.03,0.03,-0.03,-50.0,121000,1,3630,0,0,0,0,0,0,121000,0,121000,121000
20200316,708915,新普永豐97購01,,,,,,0.00,0,0,0,0,0,0,0,0,0,0,0,0,0
20200316,708916,精華永豐97購01,0.05,0.05,0.05,0.05,-0.01,-16.67,30000,3,1500,0,0,0,0,0,0,0,30000,-30000,-30000
20200316,708917,原相兆豐98購01,0.47,0.52,0.32,0.32,+0.02,6.67,155000,10,54770,0,0,0,0,0,0,133000,0,133000,133000
20200316,708918,群聯台新97購05,,,,,,0.00,0,0,0,0,0,0,0,0,0,0,0,0,0
20200316,708919,中美晶群益97購04,,,,,,0.00,0,0,0,0,0,0,0,0,0,0,0,0,0
20200316,708920,同致群益97購01,,,,,,0.00,0,0,0,0,0,0,0,0,0,0,0,0,0
20200316,708921,勝麗群益97購01,,,,,,0.00,0,0,0,0,0,0,0,0,0,0,0,0,0
20200316,708922,緯軟群益98購02,,,,,,0.00,0,0,0,0,0,0,0,0,0,0,0,0,0
20200316,708923,鈊象群益97購01,6.65,6.65,6.00,6.00,-0.25,-4.0,12000,7,73300,0,0,0,0,0,0,2000,0,2000,2000
20200316,708924,穩懋永昌9C購01,4.00,4.00,3.55,3.55,-0.14,-3.79,57000,4,225350,0,0,0,0,0,0,55000,2000,53000,53000
20200316,708925,世界統一97購02,,,,,,0.00,0,0,0,0,0,0,0,0,0,0,0,0,0
20200316,708926,胡連統一98購01,,,,,,0.00,0,0,0,0,0,0,0,0,0,0,0,0,0
20200316,708927,胡連統一99購01,,,,,,0.00,0,0,0,0,0,0,0,0,0,0,0,0,0
20200316,708928,環球晶統一97購02,,,,,,0.00,0,0,0,0,0,0,0,0,0,0,0,0,0
20200316,708929,雍智中信97購01,,,,,,0.00,0,0,0,0,0,0,0,0,0,0,0,0,0
20200316,708930,聚積中信97購01,,,,,,0.00,0,0,0,0,0,0,0,0,0,0,0,0,0
20200316,708931,VHQ凱基97購01,,,,,,0.00,0,0,0,0,0,0,0,0,0,0,0,0,0
20200316,708932,VHQ凱基98購01,,,,,,0.00,0,0,0,0,0,0,0,0,0,0,0,0,0
20200316,708933,神盾凱基98購02,0.12,0.12,0.09,0.09,-0.04,-30.77,13000,2,1470,0,0,0,0,0,0,13000,0,13000,13000
20200316,708934,晶焱凱基98購02,,,,,,0.00,0,0,0,0,0,0,0,0,0,0,0,0,0
20200316,708935,環球晶凱基97購04,,,,,,0.00,0,0,0,0,0,0,0,0,0,0,0,0,0
20200316,708936,環球晶凱基97購05,0.24,0.24,0.24,0.24,+0.01,4.35,5000,1,1200,0,0,0,0,0,0,0,0,0,0
20200316,708937,雙鴻富邦98購01,0.09,0.09,0.09,0.09,-0.03,-25.0,75000,3,6750,0,0,0,0,0,0,0,75000,-75000,-75000
20200316,708938,大宇資國票98購01,0.25,0.25,0.13,0.13,-0.11,-45.83,33000,5,6290,0,0,0,0,0,0,0,33000,-33000,-33000
20200316,708939,金居國票98購03,,,,,,0.00,0,0,0,0,0,0,0,0,0,0,0,0,0
20200316,708940,碩禾國票98購01,,,,,,0.00,0,0,0,0,0,0,0,0,0,0,0,0,0
20200316,708941,M31元富97購01,,,,,,0.00,0,0,0,0,0,0,0,0,0,0,0,0,0
20200316,708942,金居第一97購01,,,,,,0.00,0,0,0,0,0,0,0,0,0,0,0,0,0
20200316,708943,M31元富97購02,,,,,,0.00,0,0,0,0,0,0,0,0,0,0,0,0,0
20200316,708944,閎康元富97購01,,,,,,0.00,0,0,0,0,0,0,0,0,0,0,0,0,0
20200316,708945,大田永豐97購01,,,,,,0.00,0,0,0,0,0,0,0,0,0,0,0,0,0
20200316,708946,六角永豐97購02,,,,,,0.00,0,0,0,0,0,0,0,0,0,0,0,0,0
20200316,708947,群聯永豐97購01,0.03,0.04,0.03,0.03,-0.01,-25.0,900000,30,28750,0,0,0,0,0,0,0,260000,-260000,-260000
20200316,708948,雙鴻永豐97購04,,,,,,0.00,0,0,0,0,0,0,0,0,0,0,0,0,0
20200316,708949,旺矽康和97購02,,,,,,0.00,0,0,0,0,0,0,0,0,0,0,0,0,0
20200316,708950,威剛康和97購02,,,,,,0.00,0,0,0,0,0,0,0,0,0,0,0,0,0
20200316,708951,合晶群益99購01,,,,,,0.00,0,0,0,0,0,0,0,0,0,0,0,0,0
20200316,708952,迅得群益98購01,,,,,,0.00,0,0,0,0,0,0,0,0,0,0,0,0,0
20200316,708953,宜鼎群益97購02,,,,,,0.00,0,0,0,0,0,0,0,0,0,0,0,0,0
20200316,708954,胡連群益97購01,,,,,,0.00,0,0,0,0,0,0,0,0,0,0,0,0,0
20200316,708955,雙美群益98購01,,,,,,0.00,0,0,0,0,0,0,0,0,0,0,0,0,0
20200316,708956,大江凱基97購02,,,,,,0.00,0,0,0,0,0,0,0,0,0,0,0,0,0
20200316,708957,世界凱基97購01,0.69,0.69,0.61,0.61,-0.16,-20.78,73000,2,49970,0,0,0,0,0,0,5000,68000,-63000,-63000
20200316,708958,台燿凱基98購01,0.46,0.46,0.46,0.46,-0.05,-9.8,20000,1,9200,0,0,0,0,0,0,20000,0,20000,20000
20200316,708959,宣德凱基98購01,0.77,0.80,0.77,0.80,+0.02,2.56,270000,4,213770,0,0,0,0,0,0,77000,193000,-116000,-116000
20200316,708960,璟德凱基97購01,,,,,,0.00,0,0,0,0,0,0,0,0,0,0,0,0,0
20200316,708961,環球晶凱基97購06,0.75,0.81,0.73,0.81,-0.05,-5.81,50000,4,39040,0,0,0,0,0,0,50000,40000,10000,10000
20200316,708962,鈊象凱基98購04,3.26,3.26,1.94,2.00,-0.91,-31.27,337000,37,809030,0,0,0,0,0,0,85000,243000,-158000,-158000
20200316,708963,譜瑞凱基97購02,0.73,0.84,0.65,0.65,-0.08,-10.96,89000,8,68380,0,0,0,0,0,0,58000,48000,10000,10000
20200316,708964,信昌電國票98購03,,,,,,0.00,0,0,0,0,0,0,0,0,0,0,0,0,0
20200316,708965,廣明國票98購03,,,,,,0.00,0,0,0,0,0,0,0,0,0,0,0,0,0
20200316,708966,聯亞國票98購01,,,,,,0.00,0,0,0,0,0,0,0,0,0,0,0,0,0
20200316,708967,大江元大97購05,,,,,,0.00,0,0,0,0,0,0,0,0,0,0,0,0,0
20200316,708968,中美晶元大97購09,,,,,,0.00,0,0,0,0,0,0,0,0,0,0,0,0,0
20200316,708969,宣德元大97購03,0.47,0.51,0.33,0.33,-0.18,-35.29,248000,23,104890,0,0,0,0,0,0,76000,182000,-106000,-106000
20200316,708970,群聯元大97購07,0.55,0.55,0.38,0.38,-0.05,-11.63,160000,10,74300,0,0,0,0,0,0,100000,80000,20000,20000
20200316,708971,精測元大97購07,0.61,0.61,0.53,0.53,+0.13,32.5,30000,2,17500,0,0,0,0,0,0,20000,10000,10000,10000
20200316,708972,網龍元大98購02,0.07,0.08,0.07,0.07,-0.05,-41.67,45000,4,3200,0,0,0,0,0,0,20000,25000,-5000,-5000
20200316,708973,聚積元大97購01,,,,,,0.00,0,0,0,0,0,0,0,0,0,0,0,0,0
20200316,708974,環球晶元大97購10,,,,,,0.00,0,0,0,0,0,0,0,0,0,0,0,0,0
20200316,708975,環球晶元大97購11,,,,,,0.00,0,0,0,0,0,0,0,0,0,0,0,0,0
20200316,708976,環球晶元大97購12,0.57,0.62,0.43,0.43,-0.10,-18.87,90000,9,48860,0,0,0,0,0,0,40000,50000,-10000,-10000
20200316,708977,M31兆豐97購01,0.06,0.06,0.06,0.06,-0.05,-45.45,3000,1,180,0,0,0,0,0,0,3000,0,3000,3000
20200316,708978,頎邦兆豐97購01,,,,,,0.00,0,0,0,0,0,0,0,0,0,0,0,0,0
20200316,708979,VHQ統一98購01,0.16,0.16,0.16,0.16,-0.08,-33.33,4000,1,640,0,0,0,0,0,0,4000,0,4000,4000
20200316,708980,威剛統一98購01,,,,,,0.00,0,0,0,0,0,0,0,0,0,0,0,0,0
20200316,708981,光頡國票98購03,0.32,0.32,0.32,0.32,-0.04,-11.11,13000,1,4160,0,0,0,0,0,0,13000,0,13000,13000
20200316,708982,大學光國泰99購01,0.62,0.65,0.44,0.44,-0.18,-29.03,577000,22,332900,0,0,0,0,0,0,160000,441000,-281000,-281000
20200316,708983,穩懋國泰98購02,0.92,1.09,0.75,0.75,-0.26,-25.74,617000,35,596180,0,0,0,0,0,0,585000,54000,531000,531000
20200316,708984,大江凱基97購03,0.11,0.11,0.11,0.11,-0.01,-8.33,100000,1,11000,0,0,0,0,0,0,100000,0,100000,100000
20200316,708985,六角凱基99購02,,,,,,0.00,0,0,0,0,0,0,0,0,0,0,0,0,0
20200316,708986,旺矽凱基97購02,,,,,,0.00,0,0,0,0,0,0,0,0,0,0,0,0,0
20200316,708987,環球晶凱基97購07,0.63,0.63,0.60,0.60,-0.13,-17.81,16000,3,9900,0,0,0,0,0,0,10000,16000,-6000,-6000
20200316,708988,雙鴻凱基98購02,0.31,0.31,0.28,0.28,-0.02,-6.67,60000,2,17100,0,0,0,0,0,0,60000,0,60000,60000
20200316,708989,穩懋凱基97購05,,,,,,0.00,0,0,0,0,0,0,0,0,0,0,0,0,0
20200316,708990,穩懋凱基98購01,1.43,1.43,1.43,1.43,+0.05,3.62,10000,1,14300,0,0,0,0,0,0,0,10000,-10000,-10000
20200316,708991,穩懋凱基98購02,2.44,2.44,2.23,2.23,+1.12,100.9,12000,2,28860,0,0,0,0,0,0,12000,0,12000,12000
20200316,708992,M31元大98購02,,,,,,0.00,0,0,0,0,0,0,0,0,0,0,0,0,0
20200316,708993,大學光元大98購01,0.58,0.58,0.51,0.51,-0.09,-15.0,70000,7,39200,0,0,0,0,0,0,0,70000,-70000,-70000
20200316,708994,中美晶元大98購01,0.78,0.80,0.78,0.80,0.00,0.0,8000,2,6260,0,0,0,0,0,0,0,8000,-8000,-8000
20200316,708995,世界元大97購01,1.40,1.40,1.33,1.33,+0.06,4.72,45000,4,62470,0,0,0,0,0,0,45000,0,45000,45000
20200316,708996,保瑞元大97購01,2.11,2.11,1.56,1.56,-0.48,-23.53,30000,4,57800,0,0,0,0,0,0,20000,10000,10000,10000
20200316,708997,晶焱元大99購01,0.60,0.60,0.49,0.49,-0.04,-7.55,71000,8,38200,0,0,0,0,0,0,1000,70000,-69000,-69000
20200316,708998,大學光康和9B購01,,,,,,0.00,0,0,0,0,0,0,0,0,0,0,0,0,0
20200316,708999,泰博群益97購02,2.37,2.37,2.37,2.37,+0.67,39.41,1000,1,2370,0,0,0,0,0,0,0,1000,-1000,-1000
20200316,709000,環球晶群益98購01,,,,,,0.00,0,0,0,0,0,0,0,0,0,0,0,0,0
20200316,709001,鈺太群益97購01,0.19,0.22,0.19,0.19,+0.03,18.75,76000,4,14740,0,0,0,0,0,0,10000,66000,-56000,-56000
20200316,709002,環球晶日盛97購01,0.45,0.45,0.45,0.45,+0.01,2.27,28000,2,12600,0,0,0,0,0,0,28000,0,28000,28000
20200316,709003,世禾永豐97購02,,,,,,0.00,0,0,0,0,0,0,0,0,0,0,0,0,0
20200316,709004,順達永豐97購01,,,,,,0.00,0,0,0,0,0,0,0,0,0,0,0,0,0
20200316,709005,新揚科永豐97購01,,,,,,0.00,0,0,0,0,0,0,0,0,0,0,0,0,0
20200316,709006,穩懋永豐97購03,0.41,0.44,0.37,0.39,-0.02,-4.88,86000,10,35610,0,0,0,0,0,0,15000,71000,-56000,-56000
20200316,709007,勝麗台新97購01,,,,,,0.00,0,0,0,0,0,0,0,0,0,0,0,0,0
20200316,709008,中美晶元富99購01,0.60,0.60,0.45,0.47,-0.15,-24.19,304000,10,173390,0,0,0,0,0,0,246000,58000,188000,188000
20200316,709009,信昌電元富97購02,0.55,0.55,0.55,0.55,-0.45,-45.0,10000,1,5500,0,0,0,0,0,0,0,10000,-10000,-10000
20200316,709010,宣德元富97購01,0.96,0.96,0.91,0.91,+0.03,3.41,57000,3,54370,0,0,0,0,0,0,26000,31000,-5000,-5000
20200316,709011,緯軟元富97購01,,,,,,0.00,0,0,0,0,0,0,0,0,0,0,0,0,0
20200316,709012,環球晶元富97購03,,,,,,0.00,0,0,0,0,0,0,0,0,0,0,0,0,0
20200316,709013,環球晶元富97購04,0.50,0.50,0.30,0.30,-0.12,-28.57,9000,2,4100,0,0,0,0,0,0,0,9000,-9000,-9000
20200316,709014,鈊象元富97購04,5.60,5.70,4.81,4.81,-0.14,-2.83,169000,25,934370,0,0,0,0,0,0,148000,4000,144000,144000
20200316,709015,世禾統一99購01,,,,,,0.00,0,0,0,0,0,0,0,0,0,0,0,0,0
20200316,709016,世禾統一9A購01,,,,,,0.00,0,0,0,0,0,0,0,0,0,0,0,0,0
20200316,709017,金居統一98購01,,,,,,0.00,0,0,0,0,0,0,0,0,0,0,0,0,0
20200316,709018,順達統一99購01,0.61,0.61,0.54,0.54,+0.14,35.0,12000,2,6620,0,0,0,0,0,0,0,12000,-12000,-12000
20200316,709019,中美晶凱基9A購01,0.72,0.77,0.72,0.77,+0.01,1.32,11000,5,8140,0,0,0,0,0,0,3000,10000,-7000,-7000
20200316,709020,迅得凱基9A購01,0.12,0.12,0.11,0.11,+0.01,10.0,20000,2,2300,0,0,0,0,0,0,20000,0,20000,20000
20200316,709021,亞泰凱基9A購01,,,,,,0.00,0,0,0,0,0,0,0,0,0,0,0,0,0
20200316,709022,保瑞凱基98購01,1.00,1.03,0.77,0.79,-0.22,-21.78,295000,11,268440,0,0,0,0,0,0,68000,227000,-159000,-159000
20200316,709023,新普凱基98購02,0.47,0.47,0.31,0.31,-0.08,-20.51,348000,3,130280,0,0,0,0,0,0,158000,190000,-32000,-32000
20200316,709024,環球晶凱基98購01,0.99,0.99,0.99,0.99,-0.12,-10.81,10000,2,9900,0,0,0,0,0,0,10000,10000,0,0
20200316,709025,環球晶凱基99購01,0.56,0.56,0.36,0.36,-0.08,-18.18,22000,3,10220,0,0,0,0,0,0,0,22000,-22000,-22000
20200316,709026,穩懋日盛98購01,0.88,0.89,0.78,0.83,+0.01,1.22,157000,9,134310,0,0,0,0,0,0,147000,2000,145000,145000
20200316,709027,大江國票99購01,0.33,0.33,0.28,0.28,0.00,0.0,244000,8,72170,0,0,0,0,0,0,174000,0,174000,174000
20200316,709028,凡甲富邦9A購01,0.58,0.65,0.52,0.52,+0.06,13.04,356000,23,207740,0,0,0,0,0,0,266000,50000,216000,216000
20200316,709029,聯亞富邦9A購01,0.21,0.21,0.21,0.21,+0.04,23.53,35000,2,7350,0,0,0,0,0,0,35000,0,35000,35000
20200316,709030,大江元大98購01,0.23,0.23,0.19,0.19,0.00,0.0,40000,5,8250,0,0,0,0,0,0,20000,20000,0,0
20200316,709031,群聯元大99購01,0.72,0.74,0.60,0.60,-0.04,-6.25,65000,6,43900,0,0,0,0,0,0,60000,15000,45000,45000
20200316,709032,碩禾元大99購01,0.30,0.30,0.25,0.25,-0.07,-21.88,29000,3,8250,0,0,0,0,0,0,0,29000,-29000,-29000
20200316,709033,優群元大99購02,,,,,,0.00,0,0,0,0,0,0,0,0,0,0,0,0,0
20200316,709034,環球晶元大98購01,0.56,0.56,0.26,0.26,-0.21,-44.68,25000,3,10700,0,0,0,0,0,0,15000,10000,5000,5000
20200316,709035,環球晶元大98購02,0.66,0.69,0.46,0.46,-0.28,-37.84,88000,9,56640,0,0,0,0,0,0,10000,78000,-68000,-68000
20200316,709036,環球晶元大98購03,0.61,0.67,0.47,0.47,-0.18,-27.69,33000,4,20470,0,0,0,0,0,0,28000,5000,23000,23000
20200316,709037,聯亞元大99購01,0.38,0.38,0.38,0.38,+0.12,46.15,100000,1,38000,0,0,0,0,0,0,100000,0,100000,100000
20200316,709038,譜瑞元大98購02,1.73,1.98,1.69,1.80,+0.11,6.51,67000,12,124450,0,0,0,0,0,0,62000,19000,43000,43000
20200316,709039,譜瑞元富98購01,0.83,1.06,0.83,0.84,+0.03,3.7,773000,61,754070,0,0,0,0,0,0,495000,309000,186000,186000
20200316,709040,勝麗台新98購01,,,,,,0.00,0,0,0,0,0,0,0,0,0,0,0,0,0
20200316,709041,精測台新99購01,0.33,0.33,0.33,0.33,+0.16,94.12,1000,1,330,0,0,0,0,0,0,0,1000,-1000,-1000
20200316,709042,宣德兆豐98購01,0.51,0.52,0.34,0.34,-0.18,-34.62,130000,3,66640,0,0,0,0,0,0,51000,79000,-28000,-28000
20200316,709043,威剛群益9A購01,,,,,,0.00,0,0,0,0,0,0,0,0,0,0,0,0,0
20200316,709044,統新康和98購01,0.23,0.23,0.23,0.23,-0.12,-34.29,1000,1,230,0,0,0,0,0,0,1000,0,1000,1000
20200316,709045,神盾群益9A購01,1.09,1.09,0.92,0.92,-0.22,-19.3,11000,3,10990,0,0,0,0,0,0,0,11000,-11000,-11000
20200316,709046,廣明群益98購01,,,,,,0.00,0,0,0,0,0,0,0,0,0,0,0,0,0
20200316,709047,世禾永豐98購01,,,,,,0.00,0,0,0,0,0,0,0,0,0,0,0,0,0
20200316,709048,合晶永豐98購01,0.70,0.75,0.58,0.58,-0.11,-15.94,57000,6,40400,0,0,0,0,0,0,22000,35000,-13000,-13000
20200316,709049,亞泰永豐99購01,0.57,0.57,0.57,0.57,-0.13,-18.57,242000,1,137940,0,0,0,0,0,0,242000,0,242000,242000
20200316,709050,金居永豐98購01,0.83,0.83,0.74,0.81,+0.07,9.46,59000,9,47590,0,0,0,0,0,0,20000,39000,-19000,-19000
20200316,709051,統新永豐98購01,,,,,,0.00,0,0,0,0,0,0,0,0,0,0,0,0,0
20200316,709052,鈊象永豐98購02,1.82,1.82,1.07,1.12,-0.55,-32.93,391000,50,567470,0,0,0,0,0,0,213000,109000,104000,104000
20200316,709053,M31元大98購03,0.63,0.63,0.51,0.51,-0.06,-10.53,13000,2,7830,0,0,0,0,0,0,10000,3000,7000,7000
20200316,709054,凡甲元大9A購01,1.28,1.28,1.14,1.14,-0.01,-0.87,28000,4,34240,0,0,0,0,0,0,13000,25000,-12000,-12000
20200316,709055,中美晶元大99購01,1.33,1.43,1.07,1.13,-0.29,-20.42,176000,23,235730,0,0,0,0,0,0,156000,135000,21000,21000
20200316,709056,群聯元大98購03,0.83,0.83,0.72,0.72,-0.04,-5.26,75000,4,59950,0,0,0,0,0,0,75000,20000,55000,55000
20200316,709057,精測元大98購02,0.77,0.85,0.64,0.64,-0.16,-20.0,467000,40,366410,0,0,0,0,0,0,250000,247000,3000,3000
20200316,709058,緯軟元大98購01,,,,,,0.00,0,0,0,0,0,0,0,0,0,0,0,0,0
20200316,709059,鈊象元大99購02,4.43,4.77,3.21,3.21,-0.98,-23.39,327000,64,1413260,0,0,0,0,0,0,206000,156000,50000,50000
20200316,709060,大江國泰9A購01,0.71,0.75,0.68,0.68,+0.05,7.94,371000,5,259310,0,0,0,0,0,0,0,371000,-371000,-371000
20200316,709061,台燿國泰99購01,0.79,0.88,0.79,0.88,-0.02,-2.22,118000,3,94720,0,0,0,0,0,0,118000,0,118000,118000
20200316,709062,合晶國泰99購01,0.92,0.92,0.75,0.75,-0.06,-7.41,50000,3,41900,0,0,0,0,0,0,30000,20000,10000,10000
20200316,709063,雍智國票99購01,,,,,,0.00,0,0,0,0,0,0,0,0,0,0,0,0,0
20200316,709064,網龍國票99購01,,,,,,0.00,0,0,0,0,0,0,0,0,0,0,0,0,0
20200316,709065,雙鴻國票99購01,0.47,0.47,0.47,0.47,+0.06,14.63,37000,1,17390,0,0,0,0,0,0,37000,0,37000,37000
20200316,709066,中美晶統一98購01,,,,,,0.00,0,0,0,0,0,0,0,0,0,0,0,0,0
20200316,709067,統新統一01購01,0.62,0.62,0.57,0.57,-0.16,-21.92,60000,6,36400,0,0,0,0,0,0,0,60000,-60000,-60000
20200316,709068,統新統一98購01,,,,,,0.00,0,0,0,0,0,0,0,0,0,0,0,0,0
20200316,709069,統新統一9B購01,,,,,,0.00,0,0,0,0,0,0,0,0,0,0,0,0,0
20200316,709070,統新統一9C購01,,,,,,0.00,0,0,0,0,0,0,0,0,0,0,0,0,0
20200316,709071,鈊象統一9A購01,2.49,2.56,2.17,2.17,+0.04,1.88,4000,4,9520,0,0,0,0,0,0,2000,2000,0,0
20200316,709072,鈊象中信98購01,0.79,1.00,0.66,0.67,-0.21,-23.86,2969000,180,2461460,0,0,0,0,0,0,1259000,1418000,-159000,-159000
20200316,709073,大江凱基98購04,0.76,0.76,0.62,0.62,-0.02,-3.12,40000,4,27500,0,0,0,0,0,0,0,40000,-40000,-40000
20200316,709074,大學光凱基9A購01,0.28,0.28,0.22,0.22,+0.12,120.0,102000,4,26500,0,0,0,0,0,0,101000,1000,100000,100000
20200316,709075,中美晶凱基98購01,1.38,1.45,1.10,1.10,-0.38,-25.68,175000,12,237190,0,0,0,0,0,0,165000,122000,43000,43000
20200316,709076,合晶凱基98購02,0.86,0.86,0.86,0.86,+0.10,13.16,10000,1,8600,0,0,0,0,0,0,10000,0,10000,10000
20200316,709077,宜鼎凱基98購02,1.10,1.10,1.10,1.10,+0.42,61.76,3000,1,3300,0,0,0,0,0,0,3000,0,3000,3000
20200316,709078,昇達科凱基98購01,,,,,,0.00,0,0,0,0,0,0,0,0,0,0,0,0,0
20200316,709079,信昌電凱基98購03,,,,,,0.00,0,0,0,0,0,0,0,0,0,0,0,0,0
20200316,709080,宣德凱基98購02,0.99,0.99,0.99,0.99,+0.08,8.79,25000,1,24750,0,0,0,0,0,0,25000,0,25000,25000
20200316,709081,原相凱基98購03,1.66,1.66,1.16,1.16,-0.08,-6.45,120000,6,177400,0,0,0,0,0,0,80000,40000,40000,40000
20200316,709082,精測凱基98購03,0.63,0.66,0.53,0.53,+0.11,26.19,259000,25,163190,0,0,0,0,0,0,199000,50000,149000,149000
20200316,709083,廣明凱基98購03,,,,,,0.00,0,0,0,0,0,0,0,0,0,0,0,0,0
20200316,709084,優群凱基9A購01,1.28,1.40,1.17,1.17,-0.02,-1.68,248000,17,330970,0,0,0,0,0,0,225000,153000,72000,72000
20200316,709085,環球晶凱基98購02,1.66,1.80,1.18,1.18,-0.16,-11.94,198000,15,322700,0,0,0,0,0,0,130000,78000,52000,52000
20200316,709086,環球晶凱基99購02,,,,,,0.00,0,0,0,0,0,0,0,0,0,0,0,0,0
20200316,709087,聯亞凱基98購02,1.10,1.10,1.00,1.00,+0.09,9.89,120000,2,130000,0,0,0,0,0,0,120000,0,120000,120000
20200316,709088,鈊象凱基9A購01,3.94,4.02,2.42,2.52,-0.87,-25.66,102000,15,310020,0,0,0,0,0,0,30000,56000,-26000,-26000
20200316,709089,統新元富98購01,0.28,0.28,0.17,0.17,-0.10,-37.04,60000,4,14700,0,0,0,0,0,0,0,60000,-60000,-60000
20200316,709090,統新元富98購02,0.33,0.33,0.33,0.33,-0.01,-2.94,10000,1,3300,0,0,0,0,0,0,0,10000,-10000,-10000
20200316,709091,穩懋統一98購03,1.56,1.56,1.35,1.35,0.00,0.0,30000,3,43100,0,0,0,0,0,0,10000,20000,-10000,-10000
20200316,709092,鈊象中信99購02,1.33,1.46,0.91,0.91,-0.37,-28.91,527000,36,693810,0,0,0,0,0,0,428000,0,428000,428000
20200316,709093,VHQ元大99購01,1.11,1.11,0.84,0.84,-0.27,-24.32,471000,52,452820,0,0,0,0,0,0,190000,461000,-271000,-271000
20200316,709094,大江元大99購01,,,,,,0.00,0,0,0,0,0,0,0,0,0,0,0,0,0
20200316,709095,六角元大99購01,0.31,0.32,0.25,0.26,-0.02,-7.14,70000,5,18950,0,0,0,0,0,0,40000,30000,10000,10000
20200316,709096,同致元大99購01,0.19,0.19,0.16,0.16,-0.12,-42.86,130000,13,21300,0,0,0,0,0,0,0,130000,-130000,-130000
20200316,709097,建榮元大98購01,0.63,0.63,0.63,0.63,+0.07,12.5,10000,1,6300,0,0,0,0,0,0,0,10000,-10000,-10000
20200316,709098,原相元大9A購01,1.56,1.71,1.19,1.19,-0.45,-27.44,351000,42,547980,0,0,0,0,0,0,246000,213000,33000,33000
20200316,709099,鈊象元大99購03,2.49,2.58,1.65,1.66,-0.84,-33.6,1199000,111,2559620,0,0,0,0,0,0,650000,320000,330000,330000
20200316,709100,鈺太元大99購02,0.66,0.90,0.64,0.72,+0.08,12.5,129000,14,95320,0,0,0,0,0,0,10000,129000,-119000,-119000
20200316,709101,泰博元富98購01,0.94,1.16,0.94,1.11,+0.21,23.33,219000,10,217740,0,0,0,0,0,0,155000,64000,91000,91000
20200316,709102,三貝德群益98購01,0.40,0.40,0.40,0.40,-0.08,-16.67,6000,1,2400,0,0,0,0,0,0,6000,0,6000,6000
20200316,709103,中美晶群益98購01,2.28,2.28,2.28,2.28,+0.05,2.24,7000,1,15960,0,0,0,0,0,0,0,7000,-7000,-7000
20200316,709104,良維群益98購01,0.68,0.68,0.55,0.55,+0.01,1.85,35000,4,21850,0,0,0,0,0,0,30000,1000,29000,29000
20200316,709105,宣德群益98購01,1.23,1.23,1.23,1.23,+0.18,17.14,2000,1,2460,0,0,0,0,0,0,2000,0,2000,2000
20200316,709106,統新群益98購01,,,,,,0.00,0,0,0,0,0,0,0,0,0,0,0,0,0
20200316,709107,晶焱群益98購02,,,,,,0.00,0,0,0,0,0,0,0,0,0,0,0,0,0
20200316,709108,金居國票99購01,0.50,0.50,0.50,0.50,+0.02,4.17,30000,2,15000,0,0,0,0,0,0,30000,0,30000,30000
20200316,709109,統新國票98購01,,,,,,0.00,0,0,0,0,0,0,0,0,0,0,0,0,0
20200316,709110,聯亞國票99購01,,,,,,0.00,0,0,0,0,0,0,0,0,0,0,0,0,0
20200316,709111,VHQ永豐98購01,0.72,0.72,0.72,0.72,-0.11,-13.25,10000,1,7200,0,0,0,0,0,0,10000,0,10000,10000
20200316,709112,大宇資永豐98購01,0.40,0.45,0.28,0.28,-0.15,-34.88,268000,21,85810,0,0,0,0,0,0,27000,241000,-214000,-214000
20200316,709113,大學光永豐9A購01,,,,,,0.00,0,0,0,0,0,0,0,0,0,0,0,0,0
20200316,709114,波若威永豐99購01,,,,,,0.00,0,0,0,0,0,0,0,0,0,0,0,0,0
20200316,709115,金可永豐98購01,0.24,0.26,0.21,0.21,+0.02,10.53,116000,10,27090,0,0,0,0,0,0,36000,80000,-44000,-44000
20200316,709116,環球晶永豐98購01,,,,,,0.00,0,0,0,0,0,0,0,0,0,0,0,0,0
20200316,709117,大江凱基98購05,0.52,0.54,0.46,0.46,-0.01,-2.13,135000,6,70440,0,0,0,0,0,0,115000,20000,95000,95000
20200316,709118,元太凱基98購01,0.68,0.68,0.44,0.45,-0.20,-30.77,723000,16,337410,0,0,0,0,0,0,63000,720000,-657000,-657000
20200316,709119,台燿凱基98購02,0.72,0.79,0.66,0.79,+0.04,5.33,258000,4,182380,0,0,0,0,0,0,0,258000,-258000,-258000
20200316,709120,同致凱基98購03,0.19,0.19,0.10,0.10,-0.08,-44.44,112000,12,14760,0,0,0,0,0,0,23000,50000,-27000,-27000
20200316,709121,合晶凱基98購03,0.96,0.96,0.94,0.94,+0.18,23.68,33000,3,31220,0,0,0,0,0,0,23000,10000,13000,13000
20200316,709122,宜鼎凱基98購03,0.84,0.84,0.83,0.83,+0.29,53.7,281000,2,234040,0,0,0,0,0,0,281000,0,281000,281000
20200316,709123,昇達科凱基98購02,0.37,0.37,0.37,0.37,-0.02,-5.13,21000,1,7770,0,0,0,0,0,0,0,21000,-21000,-21000
20200316,709124,信昌電凱基98購04,0.32,0.32,0.32,0.32,+0.05,18.52,25000,1,8000,0,0,0,0,0,0,25000,25000,0,0
20200316,709125,原相凱基98購04,2.40,2.65,1.75,1.89,-0.46,-19.57,16000,12,37360,0,0,0,0,0,0,12000,4000,8000,8000
20200316,709126,勝麗凱基98購02,0.60,0.63,0.46,0.46,-0.12,-20.69,295000,7,170010,0,0,0,0,0,0,84000,211000,-127000,-127000
20200316,709127,群聯凱基98購03,0.80,0.80,0.65,0.65,-0.09,-12.16,30000,2,22500,0,0,0,0,0,0,30000,10000,20000,20000
20200316,709128,廣明凱基98購04,0.56,0.58,0.56,0.58,+0.06,11.54,20000,4,11400,0,0,0,0,0,0,20000,0,20000,20000
20200316,709129,璟德凱基98購02,0.58,0.58,0.38,0.38,-0.11,-22.45,334000,9,181600,0,0,0,0,0,0,174000,160000,14000,14000
20200316,709130,優群凱基9A購02,0.92,1.01,0.81,0.86,+0.02,2.38,180000,23,165980,0,0,0,0,0,0,95000,85000,10000,10000
20200316,709131,穩懋凱基98購03,0.99,0.99,0.99,0.99,+0.43,76.79,100000,1,99000,0,0,0,0,0,0,100000,0,100000,100000
20200316,709132,穩懋凱基98購04,1.07,1.07,0.95,0.95,-0.07,-6.86,103000,5,106720,0,0,0,0,0,0,93000,10000,83000,83000
20200316,709133,頎邦凱基98購01,1.03,1.09,0.96,0.96,+0.17,21.52,155000,8,152700,0,0,0,0,0,0,59000,128000,-69000,-69000
20200316,709134,環球晶統一98購01,,,,,,0.00,0,0,0,0,0,0,0,0,0,0,0,0,0
20200316,709135,原相凱基99購01,0.66,0.71,0.66,0.71,+0.05,7.58,30000,2,21200,0,0,0,0,0,0,30000,28000,2000,2000
20200316,709136,群聯凱基98購04,0.69,0.73,0.59,0.59,-0.05,-7.81,185000,8,132830,0,0,0,0,0,0,185000,0,185000,185000
20200316,709137,碩禾凱基9A購01,0.20,0.20,0.15,0.15,-0.08,-34.78,150000,6,25000,0,0,0,0,0,0,100000,50000,50000,50000
20200316,709138,M31元大99購02,,,,,,0.00,0,0,0,0,0,0,0,0,0,0,0,0,0
20200316,709139,鈊象元大99購04,3.42,3.83,2.75,2.76,-0.66,-19.3,283000,36,1007430,0,0,0,0,0,0,215000,63000,152000,152000
20200316,709140,泰博國票99購01,2.40,2.53,2.40,2.44,+0.67,37.85,18000,4,44580,0,0,0,0,0,0,8000,10000,-2000,-2000
20200316,709141,神盾國泰9A購01,0.81,0.85,0.55,0.55,-0.25,-31.25,263000,13,182560,0,0,0,0,0,0,10000,253000,-243000,-243000
20200316,709142,宣德富邦9A購01,1.39,1.40,1.01,1.01,-0.38,-27.34,108000,5,148780,0,0,0,0,0,0,0,108000,-108000,-108000
20200316,709143,環球晶富邦9A購01,0.37,0.38,0.29,0.29,-0.13,-30.95,339000,14,110200,0,0,0,0,0,0,5000,304000,-299000,-299000
20200316,709144,信昌電亞東99購01,,,,,,0.00,0,0,0,0,0,0,0,0,0,0,0,0,0
20200316,709145,大江永豐98購01,0.32,0.34,0.32,0.34,+0.09,36.0,47000,5,15740,0,0,0,0,0,0,7000,40000,-33000,-33000
20200316,709146,同致永豐98購01,0.23,0.23,0.13,0.13,-0.10,-43.48,15000,2,3150,0,0,0,0,0,0,15000,0,15000,15000
20200316,709147,合晶永豐98購02,,,,,,0.00,0,0,0,0,0,0,0,0,0,0,0,0,0
20200316,709148,良維永豐98購01,,,,,,0.00,0,0,0,0,0,0,0,0,0,0,0,0,0
20200316,709149,東隆興永豐98購01,,,,,,0.00,0,0,0,0,0,0,0,0,0,0,0,0,0
20200316,709150,南光永豐98購01,0.21,0.21,0.21,0.21,+0.01,5.0,612000,5,128520,0,0,0,0,0,0,612000,0,612000,612000
20200316,709151,茂達永豐98購01,0.65,0.65,0.42,0.42,-0.19,-31.15,616000,16,320200,0,0,0,0,0,0,250000,366000,-116000,-116000
20200316,709152,新潤永豐98購01,0.34,0.34,0.34,0.34,+0.01,3.03,10000,1,3400,0,0,0,0,0,0,0,10000,-10000,-10000
20200316,709153,大江兆豐98購01,0.40,0.40,0.33,0.34,+0.01,3.03,139000,12,49350,0,0,0,0,0,0,65000,74000,-9000,-9000
20200316,709154,VHQ康和98購01,,,,,,0.00,0,0,0,0,0,0,0,0,0,0,0,0,0
20200316,709155,世界群益9A購01,,,,,,0.00,0,0,0,0,0,0,0,0,0,0,0,0,0
20200316,709156,台燿群益99購01,0.53,0.55,0.47,0.53,+0.02,3.92,173000,7,92110,0,0,0,0,0,0,69000,100000,-31000,-31000
20200316,709157,威剛群益9A購02,0.30,0.30,0.30,0.30,-0.01,-3.23,5000,1,1500,0,0,0,0,0,0,0,5000,-5000,-5000
20200316,709158,廣明群益98購02,,,,,,0.00,0,0,0,0,0,0,0,0,0,0,0,0,0
20200316,709159,優群群益99購02,,,,,,0.00,0,0,0,0,0,0,0,0,0,0,0,0,0
20200316,709160,大江元富98購01,0.86,0.92,0.84,0.91,+0.15,19.74,106000,12,95930,0,0,0,0,0,0,10000,96000,-86000,-86000
20200316,709161,元太台新98購01,0.52,0.52,0.32,0.32,-0.17,-34.69,1378000,12,569190,0,0,0,0,0,0,290000,1088000,-798000,-798000
20200316,709162,鈊象台新98購02,1.75,1.76,1.29,1.29,-0.12,-8.51,20000,6,30170,0,0,0,0,0,0,1000,20000,-19000,-19000
20200316,709163,宇峻元大99購01,0.32,0.32,0.32,0.32,+0.04,14.29,20000,2,6400,0,0,0,0,0,0,0,20000,-20000,-20000
20200316,709164,金居元大99購02,0.83,0.83,0.74,0.74,-0.02,-2.63,24000,4,18770,0,0,0,0,0,0,14000,20000,-6000,-6000
20200316,709165,新鉅科元大98購01,,,,,,0.00,0,0,0,0,0,0,0,0,0,0,0,0,0
20200316,709166,上詮永豐98購01,0.30,0.30,0.25,0.25,0.00,0.0,102000,5,28950,0,0,0,0,0,0,57000,45000,12000,12000
20200316,709167,光頡永豐98購01,,,,,,0.00,0,0,0,0,0,0,0,0,0,0,0,0,0
20200316,709168,波若威永豐98購02,0.25,0.25,0.25,0.25,-0.04,-13.79,1000,1,250,0,0,0,0,0,0,1000,0,1000,1000
20200316,709169,建榮永豐99購02,0.35,0.35,0.28,0.28,-0.02,-6.67,12000,2,3710,0,0,0,0,0,0,5000,7000,-2000,-2000
20200316,709170,健信永豐98購01,0.20,0.20,0.20,0.20,-0.01,-4.76,60000,1,12000,0,0,0,0,0,0,60000,0,60000,60000
20200316,709171,璟德永豐98購01,,,,,,0.00,0,0,0,0,0,0,0,0,0,0,0,0,0
20200316,709172,統新國泰99購01,0.51,0.51,0.41,0.41,-0.22,-34.92,121000,2,61610,0,0,0,0,0,0,0,121000,-121000,-121000
20200316,709173,環球晶統一99購02,0.53,0.53,0.53,0.53,-0.21,-28.38,10000,1,5300,0,0,0,0,0,0,0,10000,-10000,-10000
20200316,709174,太醫中信99購01,0.54,0.56,0.47,0.47,-0.08,-14.55,825000,16,416300,0,0,0,0,0,0,410000,415000,-5000,-5000
20200316,709175,環球晶中信98購01,0.17,0.17,0.11,0.11,-0.09,-45.0,15000,2,2250,0,0,0,0,0,0,0,15000,-15000,-15000
20200316,709176,大江凱基98購06,1.04,1.09,1.04,1.06,+0.40,60.61,211000,9,224740,0,0,0,0,0,0,100000,211000,-111000,-111000
20200316,709177,宣德凱基98購03,0.92,0.92,0.67,0.67,-0.20,-22.99,65000,2,56050,0,0,0,0,0,0,50000,15000,35000,35000
20200316,709178,精測凱基98購04,0.56,0.58,0.52,0.52,+0.02,4.0,205000,24,113220,0,0,0,0,0,0,179000,0,179000,179000
20200316,709179,雙鴻兆豐99購01,0.31,0.32,0.19,0.19,-0.11,-36.67,1039000,30,278010,0,0,0,0,0,0,359000,680000,-321000,-321000
20200316,709180,統新康和98購02,,,,,,0.00,0,0,0,0,0,0,0,0,0,0,0,0,0
20200316,709181,太景*群益99購01,0.33,0.34,0.18,0.18,-0.16,-47.06,530000,13,120700,0,0,0,0,0,0,10000,520000,-510000,-510000
20200316,709182,大江富邦9A購01,0.57,0.61,0.57,0.61,+0.04,7.02,852000,6,508720,0,0,0,0,0,0,600000,252000,348000,348000
20200316,709183,原相麥證99購01,0.58,0.59,0.43,0.43,-0.15,-25.86,276000,42,142260,158000,103000,55000,0,0,0,158000,103000,55000,55000
20200316,709184,順達麥證98購01,1.22,1.31,1.15,1.20,-0.09,-6.98,81000,8,101040,71000,10000,61000,0,0,0,71000,10000,61000,61000
20200316,709185,璟德麥證98購01,0.32,0.32,0.25,0.25,-0.06,-19.35,79000,2,24580,69000,10000,59000,0,0,0,69000,10000,59000,59000
20200316,709186,鈊象台新98購03,2.33,2.33,2.33,2.33,+0.34,17.09,4000,1,9320,0,0,0,0,0,0,4000,0,4000,4000
20200316,709187,大中元富98購01,,,,,,0.00,0,0,0,0,0,0,0,0,0,0,0,0,0
20200316,709188,太景*元富98購01,0.61,0.65,0.61,0.65,+0.01,1.56,70000,3,43500,0,0,0,0,0,0,50000,20000,30000,30000
20200316,709189,台半元富98購01,0.86,0.86,0.70,0.70,0.00,0.0,30000,2,24200,0,0,0,0,0,0,20000,10000,10000,10000
20200316,709190,由田元富98購01,,,,,,0.00,0,0,0,0,0,0,0,0,0,0,0,0,0
20200316,709191,杰力元富98購01,0.88,0.88,0.88,0.88,+0.01,1.15,4000,1,3520,0,0,0,0,0,0,0,4000,-4000,-4000
20200316,709192,金居元富99購01,0.54,0.54,0.49,0.51,+0.04,8.51,184000,7,95040,0,0,0,0,0,0,82000,102000,-20000,-20000
20200316,709193,美琪瑪元富98購01,0.16,0.16,0.16,0.16,-0.01,-5.88,3000,1,480,0,0,0,0,0,0,3000,0,3000,3000
20200316,709194,統新元富98購03,0.46,0.46,0.46,0.46,-0.22,-32.35,50000,1,23000,0,0,0,0,0,0,0,50000,-50000,-50000
20200316,709195,碩禾元富9B購01,0.37,0.37,0.23,0.23,-0.10,-30.3,850000,13,242700,0,0,0,0,0,0,160000,690000,-530000,-530000
20200316,709196,群聯中信99購01,0.16,0.17,0.13,0.13,-0.05,-27.78,390000,28,61200,0,0,0,0,0,0,0,390000,-390000,-390000
20200316,709197,大學光統一99購01,0.20,0.20,0.20,0.20,-0.14,-41.18,100000,6,20000,0,0,0,0,0,0,97000,0,97000,97000
20200316,709198,原相統一99購01,,,,,,0.00,0,0,0,0,0,0,0,0,0,0,0,0,0
20200316,709199,M31凱基98購02,0.50,0.50,0.42,0.42,-0.13,-23.64,126000,4,62120,0,0,0,0,0,0,20000,106000,-86000,-86000
20200316,709200,中美晶凱基98購02,0.83,0.83,0.83,0.83,-0.02,-2.35,157000,2,130310,0,0,0,0,0,0,157000,0,157000,157000
20200316,709201,建榮凱基9A購01,0.26,0.26,0.26,0.26,-0.01,-3.7,198000,1,51480,0,0,0,0,0,0,198000,0,198000,198000
20200316,709202,神盾凱基99購01,0.29,0.29,0.18,0.19,-0.08,-29.63,213000,15,52190,0,0,0,0,0,0,40000,173000,-133000,-133000
20200316,709203,金可兆豐99購01,0.32,0.40,0.32,0.33,0.00,0.0,859000,33,309790,0,0,0,0,0,0,814000,15000,799000,799000
20200316,709204,宣德兆豐98購02,0.80,0.82,0.75,0.75,-0.02,-2.6,85000,5,68550,0,0,0,0,0,0,32000,53000,-21000,-21000
20200316,709205,環球晶兆豐98購02,,,,,,0.00,0,0,0,0,0,0,0,0,0,0,0,0,0
20200316,709206,合晶群益98購01,,,,,,0.00,0,0,0,0,0,0,0,0,0,0,0,0,0
20200316,709207,原相群益9B購01,3.14,3.14,2.21,2.21,-0.20,-8.3,65000,5,186660,0,0,0,0,0,0,62000,0,62000,62000
20200316,709208,統新群益98購02,0.47,0.47,0.47,0.47,-0.11,-18.97,10000,1,4700,0,0,0,0,0,0,0,10000,-10000,-10000
20200316,709209,廣明群益98購03,,,,,,0.00,0,0,0,0,0,0,0,0,0,0,0,0,0
20200316,709210,緯軟群益99購01,,,,,,0.00,0,0,0,0,0,0,0,0,0,0,0,0,0
20200316,709211,鈺太群益98購01,,,,,,0.00,0,0,0,0,0,0,0,0,0,0,0,0,0
20200316,709212,建榮國票99購02,,,,,,0.00,0,0,0,0,0,0,0,0,0,0,0,0,0
20200316,709213,雍智國票99購02,0.68,0.68,0.49,0.49,-0.12,-19.67,554000,10,354570,0,0,0,0,0,0,534000,20000,514000,514000
20200316,709214,中美晶元大99購02,1.21,1.21,1.21,1.21,-0.06,-4.72,13000,4,15730,0,0,0,0,0,0,13000,13000,0,0
20200316,709215,金居元大9A購01,1.90,1.90,1.69,1.69,+0.16,10.46,20000,2,35900,0,0,0,0,0,0,20000,0,20000,20000
20200316,709216,威剛元大99購02,0.31,0.32,0.21,0.21,-0.07,-25.0,57000,4,16220,0,0,0,0,0,0,54000,3000,51000,51000
20200316,709217,宣德元大99購01,1.22,1.26,0.89,0.89,-0.32,-26.45,175000,33,189640,0,0,0,0,0,0,72000,133000,-61000,-61000
20200316,709218,群聯元大98購04,0.82,0.82,0.68,0.69,-0.02,-2.82,80000,6,58500,0,0,0,0,0,0,70000,30000,40000,40000
20200316,709219,碩禾元大99購02,0.71,0.71,0.62,0.62,-0.10,-13.89,160000,3,109640,0,0,0,0,0,0,150000,10000,140000,140000
20200316,709220,網家元大99購01,0.91,0.96,0.69,0.69,-0.18,-20.69,326000,37,277920,0,0,0,0,0,0,8000,318000,-310000,-310000
20200316,709221,環球晶元大98購04,,,,,,0.00,0,0,0,0,0,0,0,0,0,0,0,0,0
20200316,709222,環球晶元大99購01,0.93,0.93,0.62,0.62,-0.30,-32.61,574000,55,450970,0,0,0,0,0,0,170000,399000,-229000,-229000
20200316,709223,雙鴻元大99購05,0.39,0.41,0.26,0.26,-0.13,-33.33,291000,23,108870,0,0,0,0,0,0,232000,249000,-17000,-17000
20200316,709224,穩懋元大98購02,1.20,1.36,0.92,0.98,-0.21,-17.65,116000,18,140540,0,0,0,0,0,0,82000,71000,11000,11000
20200316,709225,穩懋元大99購01,0.88,0.90,0.68,0.69,-0.08,-10.39,350000,27,288920,0,0,0,0,0,0,210000,208000,2000,2000
20200316,709226,泰博國泰99購01,1.78,2.05,1.69,1.75,+0.08,4.79,310000,26,593720,0,0,0,0,0,0,172000,138000,34000,34000
20200316,709227,大江富邦9A購02,0.40,0.40,0.40,0.40,+0.06,17.65,40000,2,16000,0,0,0,0,0,0,40000,0,40000,40000
20200316,709228,中美晶富邦9A購01,,,,,,0.00,0,0,0,0,0,0,0,0,0,0,0,0,0
20200316,709229,精測富邦99購01,0.18,0.18,0.16,0.16,-0.03,-15.79,520000,5,87600,0,0,0,0,0,0,0,520000,-520000,-520000
20200316,709230,環球晶富邦9B購01,0.21,0.21,0.16,0.16,-0.12,-42.86,165000,9,30700,0,0,0,0,0,0,3000,159000,-156000,-156000
20200316,709231,威剛麥證98購01,0.16,0.21,0.15,0.15,-0.04,-21.05,1250000,27,218400,1040000,210000,830000,0,0,0,1040000,210000,830000,830000
20200316,709232,群聯麥證98購01,,,,,,0.00,0,0,0,0,0,0,0,0,0,0,0,0,0
20200316,709233,聯亞麥證98購01,0.90,0.90,0.90,0.90,+0.14,18.42,10000,1,9000,0,10000,-10000,0,0,0,0,10000,-10000,-10000
20200316,709234,力旺元富98購01,0.46,0.50,0.30,0.30,+0.03,11.11,830000,12,359390,0,0,0,0,0,0,830000,0,830000,830000
20200316,709235,大江元富98購02,1.56,1.63,1.56,1.61,+0.37,29.84,166000,17,265590,0,0,0,0,0,0,5000,161000,-156000,-156000
20200316,709236,原相元富98購01,1.59,1.63,1.02,1.05,-0.53,-33.54,378000,40,568500,0,0,0,0,0,0,298000,23000,275000,275000
20200316,709237,新鉅科元富98購01,0.28,0.31,0.22,0.22,0.00,0.0,278000,12,69360,0,0,0,0,0,0,278000,0,278000,278000
20200316,709238,聚積元富98購01,0.99,1.04,0.99,1.04,+0.22,26.83,10000,2,10050,0,0,0,0,0,0,10000,0,10000,10000
20200316,709239,環球晶第一01購01,0.42,0.43,0.30,0.30,-0.12,-28.57,100000,7,37800,0,0,0,0,0,0,30000,45000,-15000,-15000
20200316,709240,M31永豐98購01,0.33,0.33,0.25,0.25,-0.13,-34.21,55000,2,14950,0,0,0,0,0,0,40000,15000,25000,25000
20200316,709241,凡甲永豐98購01,1.29,1.39,1.27,1.27,+0.07,5.83,70000,11,91700,0,0,0,0,0,0,9000,0,9000,9000
20200316,709242,大中永豐98購01,,,,,,0.00,0,0,0,0,0,0,0,0,0,0,0,0,0
20200316,709243,迅得永豐98購01,,,,,,0.00,0,0,0,0,0,0,0,0,0,0,0,0,0
20200316,709244,杰力永豐98購01,,,,,,0.00,0,0,0,0,0,0,0,0,0,0,0,0,0
20200316,709245,統新永豐98購02,,,,,,0.00,0,0,0,0,0,0,0,0,0,0,0,0,0
20200316,709246,晶焱永豐98購01,0.82,0.82,0.80,0.80,+0.06,8.11,44000,3,35680,0,0,0,0,0,0,44000,20000,24000,24000
20200316,709247,網龍永豐98購01,,,,,,0.00,0,0,0,0,0,0,0,0,0,0,0,0,0
20200316,709248,優群永豐98購01,1.79,2.00,1.71,1.71,+0.21,14.0,142000,11,263920,0,0,0,0,0,0,75000,67000,8000,8000
20200316,709249,原相台新9A購01,0.98,0.98,0.98,0.98,+0.07,7.69,5000,1,4900,0,0,0,0,0,0,0,5000,-5000,-5000
20200316,709250,聯亞台新9A購01,,,,,,0.00,0,0,0,0,0,0,0,0,0,0,0,0,0
20200316,709251,前鼎統一99購01,,,,,,0.00,0,0,0,0,0,0,0,0,0,0,0,0,0
20200316,709252,聯亞中信98購01,0.39,0.39,0.39,0.39,+0.11,39.29,20000,1,7800,0,0,0,0,0,0,20000,0,20000,20000
20200316,709253,晶焱凱基98購03,1.11,1.11,0.98,0.98,+0.01,1.03,74000,9,77350,0,0,0,0,0,0,74000,65000,9000,9000
20200316,709254,群聯凱基99購01,0.56,0.56,0.48,0.48,-0.09,-15.79,162000,5,81640,0,0,0,0,0,0,160000,12000,148000,148000
20200316,709255,神盾台新98購02,0.34,0.35,0.34,0.35,+0.04,12.9,20000,2,6900,0,0,0,0,0,0,0,20000,-20000,-20000
20200316,709256,精測台新99購02,,,,,,0.00,0,0,0,0,0,0,0,0,0,0,0,0,0
20200316,709257,VHQ元富98購01,0.57,0.57,0.49,0.49,-0.09,-15.52,1939000,13,979480,0,0,0,0,0,0,314000,1625000,-1311000,-1311000
20200316,709258,前鼎元富98購01,0.76,0.76,0.76,0.76,0.00,0.0,3000,1,2280,0,0,0,0,0,0,0,3000,-3000,-3000
20200316,709259,精測元富98購02,0.78,0.82,0.74,0.74,+0.18,32.14,293000,27,223970,0,0,0,0,0,0,273000,0,273000,273000
20200316,709260,中美晶國票98購01,,,,,,0.00,0,0,0,0,0,0,0,0,0,0,0,0,0
20200316,709261,保瑞國票98購01,2.69,2.69,2.59,2.59,+0.17,7.02,58000,2,151220,0,0,0,0,0,0,48000,10000,38000,38000
20200316,709262,前鼎國票99購01,1.53,1.61,1.53,1.61,+0.26,19.26,25000,2,38650,0,0,0,0,0,0,20000,5000,15000,15000
20200316,709263,原相國票99購01,0.83,0.83,0.78,0.78,-0.08,-9.3,60000,2,49300,0,0,0,0,0,0,50000,10000,40000,40000
20200316,709264,泰博國票99購02,2.39,2.39,2.39,2.39,+0.09,3.91,48000,2,114720,0,0,0,0,0,0,48000,0,48000,48000
20200316,709265,統新國票99購01,,,,,,0.00,0,0,0,0,0,0,0,0,0,0,0,0,0
20200316,709266,六角兆豐98購01,0.16,0.19,0.16,0.18,-0.01,-5.26,83000,19,15030,0,0,0,0,0,0,83000,0,83000,83000
20200316,709267,宇峻群益9A購01,0.22,0.22,0.17,0.17,-0.01,-5.56,75000,3,14000,0,0,0,0,0,0,0,75000,-75000,-75000
20200316,709268,博智群益98購01,4.15,4.95,4.15,4.36,+0.14,3.32,99000,17,461780,0,0,0,0,0,0,31000,68000,-37000,-37000
20200316,709269,網龍群益98購03,,,,,,0.00,0,0,0,0,0,0,0,0,0,0,0,0,0
20200316,709270,太景*國泰9A購01,0.29,0.34,0.25,0.25,-0.08,-24.24,877000,18,280310,0,0,0,0,0,0,140000,737000,-597000,-597000
20200316,709271,前鼎國泰99購01,0.67,0.72,0.57,0.57,-0.06,-9.52,473000,9,318810,0,0,0,0,0,0,229000,244000,-15000,-15000
20200316,709272,新鉅科國泰99購01,0.50,0.52,0.38,0.38,-0.02,-5.0,1117000,17,505600,0,0,0,0,0,0,218000,849000,-631000,-631000
20200316,709273,環宇富邦9A購01,0.42,0.42,0.32,0.32,-0.12,-27.27,280000,10,113800,0,0,0,0,0,0,227000,50000,177000,177000
20200316,709274,大江元大98購02,0.60,0.62,0.55,0.55,+0.01,1.85,64000,7,37440,0,0,0,0,0,0,10000,54000,-44000,-44000
20200316,709275,前鼎元大99購01,0.63,0.68,0.56,0.56,+0.09,19.15,30000,4,18550,0,0,0,0,0,0,0,30000,-30000,-30000
20200316,709276,威剛元大9A購01,0.34,0.34,0.27,0.27,-0.05,-15.62,43000,3,13220,0,0,0,0,0,0,23000,20000,3000,3000
20200316,709277,神盾元大9A購01,0.62,0.64,0.56,0.56,-0.06,-9.68,40000,5,23960,0,0,0,0,0,0,6000,34000,-28000,-28000
20200316,709278,群聯元大99購02,0.62,0.62,0.47,0.47,-0.18,-27.69,692000,34,351210,0,0,0,0,0,0,492000,250000,242000,242000
20200316,709279,緯軟元大98購02,,,,,,0.00,0,0,0,0,0,0,0,0,0,0,0,0,0
20200316,709280,璟德元大98購01,0.91,0.91,0.70,0.70,-0.04,-5.41,20000,2,16100,0,0,0,0,0,0,0,20000,-20000,-20000
20200316,709281,中美晶日盛9A購01,1.07,1.09,0.75,0.83,-0.24,-22.43,150000,9,154300,0,0,0,0,0,0,150000,0,150000,150000
20200316,709282,伍豐永豐98購01,0.34,0.34,0.31,0.31,+0.04,14.81,56000,2,18560,0,0,0,0,0,0,40000,16000,24000,24000
20200316,709283,兆利永豐98購01,0.54,0.56,0.47,0.48,-0.05,-9.43,68000,7,33840,0,0,0,0,0,0,68000,0,68000,68000
20200316,709284,宜鼎永豐98購01,,,,,,0.00,0,0,0,0,0,0,0,0,0,0,0,0,0
20200316,709285,前鼎永豐98購01,0.31,0.31,0.31,0.31,+0.10,47.62,27000,1,8370,0,0,0,0,0,0,0,27000,-27000,-27000
20200316,709286,建榮永豐9A購01,,,,,,0.00,0,0,0,0,0,0,0,0,0,0,0,0,0
20200316,709287,新鉅科永豐98購01,0.13,0.13,0.10,0.10,+0.01,11.11,29000,3,3370,0,0,0,0,0,0,29000,0,29000,29000
20200316,709288,聯亞永豐98購01,0.65,0.65,0.51,0.51,+0.10,24.39,20000,2,11600,0,0,0,0,0,0,10000,10000,0,0
20200316,709289,雙鴻永豐99購01,0.46,0.46,0.29,0.29,-0.16,-35.56,191000,8,78850,0,0,0,0,0,0,77000,114000,-37000,-37000
20200316,709290,金居凱基98購02,1.05,1.13,0.88,0.88,-0.13,-12.87,263000,18,255910,0,0,0,0,0,0,140000,123000,17000,17000
20200316,709291,威剛凱基9A購01,0.15,0.33,0.15,0.25,-0.04,-13.79,117000,15,34960,0,0,0,0,0,0,5000,111000,-106000,-106000
20200316,709292,環球晶凱基98購04,1.13,1.13,1.13,1.13,-0.14,-11.02,10000,2,11300,0,0,0,0,0,0,10000,10000,0,0
20200316,709293,環球晶康和98購01,0.76,0.76,0.76,0.76,-0.08,-9.52,40000,4,30400,0,0,0,0,0,0,40000,40000,0,0
20200316,709294,大江群益98購01,,,,,,0.00,0,0,0,0,0,0,0,0,0,0,0,0,0
20200316,709295,宇峻群益9A購02,0.18,0.18,0.14,0.14,+0.01,7.69,22000,2,3880,0,0,0,0,0,0,20000,2000,18000,18000
20200316,709296,神盾群益9A購02,,,,,,0.00,0,0,0,0,0,0,0,0,0,0,0,0,0
20200316,709297,宣德國票99購01,0.72,0.72,0.72,0.72,-0.89,-55.28,60000,1,43200,0,0,0,0,0,0,0,0,0,0
20200316,709298,群聯國票99購01,0.44,0.44,0.44,0.44,+0.03,7.32,4000,1,1760,0,0,0,0,0,0,4000,0,4000,4000
20200316,709299,VHQ國泰99購01,0.80,0.80,0.57,0.58,-0.21,-26.58,1199000,73,796010,0,0,0,0,0,0,757000,1196000,-439000,-439000
20200316,709300,宣德國泰9A購01,1.09,1.10,1.06,1.06,-0.03,-2.75,95000,3,103300,0,0,0,0,0,0,80000,15000,65000,65000
20200316,709301,大宇資永豐98購02,0.20,0.20,0.13,0.13,-0.07,-35.0,8000,5,1370,0,0,0,0,0,0,0,6000,-6000,-6000
20200316,709302,六角永豐98購01,,,,,,0.00,0,0,0,0,0,0,0,0,0,0,0,0,0
20200316,709303,亞泰永豐98購01,,,,,,0.00,0,0,0,0,0,0,0,0,0,0,0,0,0
20200316,709304,信昌電永豐98購01,,,,,,0.00,0,0,0,0,0,0,0,0,0,0,0,0,0
20200316,709305,宣德永豐98購01,0.68,0.68,0.68,0.68,+0.01,1.49,50000,1,34000,0,0,0,0,0,0,50000,0,50000,50000
20200316,709306,原相永豐98購02,0.33,0.37,0.23,0.23,-0.04,-14.81,373000,19,118980,0,0,0,0,0,0,247000,20000,227000,227000
20200316,709307,神盾永豐99購01,,,,,,0.00,0,0,0,0,0,0,0,0,0,0,0,0,0
20200316,709308,雙美永豐99購01,0.59,0.59,0.59,0.59,+0.11,22.92,13000,1,7670,0,0,0,0,0,0,0,13000,-13000,-13000
20200316,709309,譜瑞永豐98購01,0.51,0.54,0.44,0.44,-0.06,-12.0,66000,3,34460,0,0,0,0,0,0,50000,16000,34000,34000
20200316,709310,合晶元富98購01,,,,,,0.00,0,0,0,0,0,0,0,0,0,0,0,0,0
20200316,709311,前鼎元富98購02,0.85,0.90,0.82,0.88,+0.27,44.26,138000,5,118300,0,0,0,0,0,0,98000,40000,58000,58000
20200316,709312,大學光元大99購01,0.35,0.35,0.25,0.25,-0.09,-26.47,60000,3,18800,0,0,0,0,0,0,40000,20000,20000,20000
20200316,709313,保瑞元大98購01,1.54,1.54,1.09,1.09,-0.40,-26.85,35000,4,47000,0,0,0,0,0,0,15000,20000,-5000,-5000
20200316,709314,前鼎元大99購02,0.59,0.59,0.59,0.59,+0.16,37.21,3000,1,1770,0,0,0,0,0,0,0,3000,-3000,-3000
20200316,709315,胡連元大98購01,0.41,0.41,0.34,0.34,-0.01,-2.86,40000,2,14300,0,0,0,0,0,0,30000,10000,20000,20000
20200316,709316,神盾元大9A購02,0.48,0.51,0.35,0.35,-0.14,-28.57,34000,5,15050,0,0,0,0,0,0,5000,29000,-24000,-24000
20200316,709317,群聯元大98購05,0.30,0.30,0.22,0.22,-0.07,-24.14,195000,11,49750,0,0,0,0,0,0,170000,65000,105000,105000
20200316,709318,環球晶元大98購09,1.11,1.11,1.11,1.11,0.00,0.0,30000,1,33300,0,0,0,0,0,0,30000,0,30000,30000
20200316,709319,環球晶元大98購10,0.89,0.89,0.59,0.59,-0.27,-31.4,282000,24,187180,0,0,0,0,0,0,62000,220000,-158000,-158000
20200316,709320,雙鴻元大9A購01,0.50,0.50,0.32,0.32,-0.13,-28.89,166000,15,72640,0,0,0,0,0,0,55000,111000,-56000,-56000
20200316,709321,譜瑞元大98購03,1.96,2.16,1.96,1.97,+0.28,16.57,47000,9,95100,0,0,0,0,0,0,22000,47000,-25000,-25000
20200316,709322,六角台新98購01,0.32,0.34,0.31,0.33,+0.02,6.45,45000,7,14660,0,0,0,0,0,0,45000,0,45000,45000
20200316,709323,群聯麥證98購02,,,,,,0.00,0,0,0,0,0,0,0,0,0,0,0,0,0
20200316,709324,同致元富98購01,0.12,0.12,0.09,0.09,-0.09,-50.0,200000,4,21000,0,0,0,0,0,0,0,200000,-200000,-200000
20200316,709325,神盾元富99購01,,,,,,0.00,0,0,0,0,0,0,0,0,0,0,0,0,0
20200316,709326,群聯元富98購01,0.70,0.70,0.70,0.70,+0.13,22.81,10000,1,7000,0,0,0,0,0,0,0,10000,-10000,-10000
20200316,709327,碩禾元富9B購02,0.26,0.26,0.19,0.19,-0.13,-40.62,267000,16,60620,0,0,0,0,0,0,267000,0,267000,267000
20200316,709328,三貝德凱基98購01,0.49,0.68,0.49,0.55,+0.14,34.15,570000,56,337530,0,0,0,0,0,0,41000,529000,-488000,-488000
20200316,709329,大江凱基98購07,0.75,0.84,0.73,0.77,+0.05,6.94,234000,25,188450,0,0,0,0,0,0,16000,197000,-181000,-181000
20200316,709330,威剛凱基9A購02,0.32,0.36,0.23,0.23,-0.05,-17.86,495000,19,132150,0,0,0,0,0,0,495000,60000,435000,435000
20200316,709331,雍智凱基99購01,0.62,0.62,0.47,0.47,-0.21,-30.88,11000,2,5320,0,0,0,0,0,0,1000,10000,-9000,-9000
20200316,709332,環球晶凱基98購05,1.35,1.35,0.88,0.88,-0.17,-16.19,235000,6,287600,0,0,0,0,0,0,20000,215000,-195000,-195000
20200316,709333,聯亞凱基99購03,1.13,1.13,1.09,1.12,+0.15,15.46,30000,4,33550,0,0,0,0,0,0,30000,0,30000,30000
20200316,709334,穩懋凱基98購06,0.62,0.75,0.49,0.58,-0.07,-10.77,3719000,17,2251250,0,0,0,0,0,0,1159000,2560000,-1401000,-1401000
20200316,709335,泰博永豐98購01,0.91,1.00,0.85,0.89,+0.06,7.23,742000,34,685120,0,0,0,0,0,0,332000,485000,-153000,-153000
20200316,709336,博智永豐98購01,1.28,1.55,1.28,1.35,+0.02,1.5,198000,22,282780,0,0,0,0,0,0,71000,127000,-56000,-56000
20200316,709337,緯軟永豐98購01,0.27,0.28,0.27,0.28,-0.04,-12.5,20000,2,5500,0,0,0,0,0,0,10000,10000,0,0
20200316,709338,環宇永豐98購02,0.19,0.19,0.19,0.19,-0.09,-32.14,2000,1,380,0,0,0,0,0,0,0,2000,-2000,-2000
20200316,709339,VHQ統一99購01,0.66,0.66,0.60,0.60,-0.09,-13.04,11000,2,7200,0,0,0,0,0,0,0,11000,-11000,-11000
20200316,709340,大學光統一9A購01,,,,,,0.00,0,0,0,0,0,0,0,0,0,0,0,0,0
20200316,709341,廣明統一99購01,,,,,,0.00,0,0,0,0,0,0,0,0,0,0,0,0,0
20200316,709342,穩懋統一98購04,,,,,,0.00,0,0,0,0,0,0,0,0,0,0,0,0,0
20200316,709343,凡甲元大98購03,1.72,1.82,1.57,1.63,-0.01,-0.61,464000,38,788140,0,0,0,0,0,0,414000,380000,34000,34000
20200316,709344,中美晶元大98購03,0.90,0.96,0.89,0.89,-0.03,-3.26,32000,6,28680,0,0,0,0,0,0,32000,12000,20000,20000
20200316,709345,宇峻元大99購02,0.33,0.35,0.30,0.30,0.00,0.0,1740000,19,572930,0,0,0,0,0,0,1600000,140000,1460000,1460000
20200316,709346,博智元大98購01,3.55,4.02,3.52,3.62,+0.33,10.03,48000,8,187520,0,0,0,0,0,0,27000,42000,-15000,-15000
20200316,709347,群聯元大98購06,0.61,0.61,0.41,0.42,-0.15,-26.32,168000,5,74670,0,0,0,0,0,0,168000,10000,158000,158000
20200316,709348,網家元大98購01,,,,,,0.00,0,0,0,0,0,0,0,0,0,0,0,0,0
20200316,709349,廣明元大98購01,,,,,,0.00,0,0,0,0,0,0,0,0,0,0,0,0,0
20200316,709350,中美晶兆豐99購01,0.72,0.76,0.63,0.63,-0.09,-12.5,114000,11,81450,0,0,0,0,0,0,64000,50000,14000,14000
20200316,709351,泰博兆豐98購01,1.14,1.35,1.13,1.16,+0.10,9.43,1363000,21,1689360,0,0,0,0,0,0,180000,1135000,-955000,-955000
20200316,709352,精華兆豐99購01,0.42,0.44,0.41,0.41,-0.02,-4.65,150000,5,63300,0,0,0,0,0,0,50000,100000,-50000,-50000
20200316,709353,頎邦兆豐98購01,0.44,0.44,0.44,0.44,+0.04,10.0,58000,1,25520,0,0,0,0,0,0,58000,0,58000,58000
20200316,709354,M31群益9A購01,0.34,0.34,0.22,0.23,-0.14,-37.84,325000,7,87700,0,0,0,0,0,0,65000,260000,-195000,-195000
20200316,709355,中美晶群益98購02,0.31,0.33,0.25,0.25,-0.10,-28.57,432000,9,126320,0,0,0,0,0,0,222000,210000,12000,12000
20200316,709356,宜鼎群益98購02,,,,,,0.00,0,0,0,0,0,0,0,0,0,0,0,0,0
20200316,709357,原相群益98購03,0.49,0.54,0.39,0.39,-0.11,-22.0,54000,18,24880,0,0,0,0,0,0,19000,0,19000,19000
20200316,709358,譜瑞群益98購01,1.45,1.45,1.45,1.45,+0.45,45.0,10000,1,14500,0,0,0,0,0,0,10000,0,10000,10000
20200316,709359,璟德國泰99購01,0.39,0.41,0.39,0.41,-0.02,-4.65,283000,3,111350,0,0,0,0,0,0,233000,50000,183000,183000
20200316,709360,神盾富邦9A購01,,,,,,0.00,0,0,0,0,0,0,0,0,0,0,0,0,0
20200316,709361,群聯凱基98購05,0.92,0.92,0.92,0.92,-0.27,-22.69,150000,1,138000,0,0,0,0,0,0,0,150000,-150000,-150000
20200316,709362,網家凱基99購01,,,,,,0.00,0,0,0,0,0,0,0,0,0,0,0,0,0
20200316,709363,晟德凱基98購01,0.48,0.48,0.36,0.36,-0.11,-23.4,90000,5,35140,0,0,0,0,0,0,10000,90000,-80000,-80000
20200316,709364,神盾統一98購02,0.24,0.24,0.21,0.21,-0.09,-30.0,7000,2,1590,0,0,0,0,0,0,0,7000,-7000,-7000
20200316,709365,VHQ元大99購02,0.88,0.88,0.88,0.88,-0.09,-9.28,51000,6,44880,0,0,0,0,0,0,10000,41000,-31000,-31000
20200316,709366,中美晶元大98購04,0.93,0.98,0.73,0.73,-0.20,-21.51,69000,10,60100,0,0,0,0,0,0,49000,34000,15000,15000
20200316,709367,兆利元大99購01,0.70,0.70,0.65,0.65,-0.21,-24.42,21000,2,14150,0,0,0,0,0,0,21000,0,21000,21000
20200316,709368,原相元大9A購02,1.52,1.58,1.13,1.13,-0.39,-25.66,370000,37,529560,0,0,0,0,0,0,269000,315000,-46000,-46000
20200316,709369,群聯元大98購07,0.41,0.41,0.35,0.35,-0.03,-7.89,83000,8,30980,0,0,0,0,0,0,53000,50000,3000,3000
20200316,709370,碩禾元大99購03,0.44,0.44,0.44,0.44,-0.20,-31.25,10000,1,4400,0,0,0,0,0,0,10000,0,10000,10000
20200316,709371,廣明元大98購02,0.56,0.56,0.56,0.56,-0.04,-6.67,20000,2,11200,0,0,0,0,0,0,0,20000,-20000,-20000
20200316,709372,神盾第一9C購01,,,,,,0.00,0,0,0,0,0,0,0,0,0,0,0,0,0
20200316,709373,三貝德永豐99購01,0.25,0.32,0.24,0.25,+0.02,8.7,474000,25,134360,0,0,0,0,0,0,41000,433000,-392000,-392000
20200316,709374,大田永豐98購01,0.18,0.20,0.17,0.18,0.00,0.0,944000,29,170140,0,0,0,0,0,0,0,944000,-944000,-944000
20200316,709375,大江永豐98購03,0.65,0.66,0.64,0.65,+0.41,170.83,78000,4,50550,0,0,0,0,0,0,0,78000,-78000,-78000
20200316,709376,旺矽永豐98購01,0.36,0.36,0.29,0.29,-0.01,-3.33,13000,2,4470,0,0,0,0,0,0,10000,3000,7000,7000
20200316,709377,勝麗永豐98購01,,,,,,0.00,0,0,0,0,0,0,0,0,0,0,0,0,0
20200316,709378,宜鼎兆豐99購01,0.36,0.36,0.32,0.34,+0.12,54.55,32000,6,10450,0,0,0,0,0,0,29000,3000,26000,26000
20200316,709379,神盾兆豐99購01,,,,,,0.00,0,0,0,0,0,0,0,0,0,0,0,0,0
20200316,709380,穩懋兆豐99購01,0.39,0.40,0.29,0.31,-0.06,-16.22,10000,7,3550,0,0,0,0,0,0,2000,8000,-6000,-6000
20200316,709381,網家康和98購01,,,,,,0.00,0,0,0,0,0,0,0,0,0,0,0,0,0
20200316,709382,大學光群益99購01,0.37,0.37,0.25,0.25,-0.11,-30.56,15000,3,4650,0,0,0,0,0,0,0,15000,-15000,-15000
20200316,709383,六角群益98購03,0.25,0.25,0.25,0.25,-0.01,-3.85,10000,1,2500,0,0,0,0,0,0,10000,0,10000,10000
20200316,709384,迅得群益9A購01,,,,,,0.00,0,0,0,0,0,0,0,0,0,0,0,0,0
20200316,709385,環宇群益99購01,0.50,0.50,0.50,0.50,+0.04,8.7,10000,1,5000,0,0,0,0,0,0,0,10000,-10000,-10000
20200316,709386,鈺太群益98購02,,,,,,0.00,0,0,0,0,0,0,0,0,0,0,0,0,0
20200316,709387,大學光統一99購02,0.16,0.16,0.16,0.16,-0.17,-51.52,12000,1,1920,0,0,0,0,0,0,12000,0,12000,12000
20200316,709388,穩懋統一98購05,,,,,,0.00,0,0,0,0,0,0,0,0,0,0,0,0,0
20200316,709389,原相中信9A購01,,,,,,0.00,0,0,0,0,0,0,0,0,0,0,0,0,0
20200316,709390,大學光凱基98購01,,,,,,0.00,0,0,0,0,0,0,0,0,0,0,0,0,0
20200316,709391,六角凱基98購01,,,,,,0.00,0,0,0,0,0,0,0,0,0,0,0,0,0
20200316,709392,穩懋凱基98購07,0.44,0.44,0.35,0.35,-0.07,-16.67,68000,3,29740,0,0,0,0,0,0,0,68000,-68000,-68000
20200316,709393,宜鼎元富98購01,0.56,0.60,0.56,0.60,+0.04,7.14,115000,3,66960,0,0,0,0,0,0,74000,41000,33000,33000
20200316,709394,群聯元富98購02,0.82,0.82,0.77,0.77,-0.10,-11.49,8000,2,6410,0,0,0,0,0,0,0,8000,-8000,-8000
20200316,709395,譜瑞元富98購02,0.98,1.22,0.98,1.19,+0.24,25.26,186000,16,209630,0,0,0,0,0,0,26000,160000,-134000,-134000
20200316,709396,台燿元大98購01,0.95,1.00,0.89,1.00,-0.05,-4.76,56000,6,53000,0,0,0,0,0,0,26000,30000,-4000,-4000
20200316,709397,神盾元大99購03,0.39,0.41,0.26,0.26,+0.06,30.0,56000,5,21220,0,0,0,0,0,0,33000,23000,10000,10000
20200316,709398,精測元大99購01,0.55,0.55,0.45,0.45,-0.02,-4.26,340000,21,178600,0,0,0,0,0,0,180000,160000,20000,20000
20200316,709399,穩懋元大98購05,1.03,1.03,0.69,0.69,-0.20,-22.47,64000,7,56940,0,0,0,0,0,0,34000,44000,-10000,-10000
20200316,709400,穩懋元大98購06,0.88,1.02,0.80,0.80,-0.15,-15.79,101000,13,97420,0,0,0,0,0,0,81000,100000,-19000,-19000
20200316,709401,穩懋元大98購07,0.97,1.05,0.78,0.78,-0.13,-14.29,150000,17,143240,0,0,0,0,0,0,120000,140000,-20000,-20000
20200316,709402,前鼎國票99購02,,,,,,0.00,0,0,0,0,0,0,0,0,0,0,0,0,0
20200316,709403,雙美國票9B購01,,,,,,0.00,0,0,0,0,0,0,0,0,0,0,0,0,0
20200316,709404,雙鴻國票9A購01,,,,,,0.00,0,0,0,0,0,0,0,0,0,0,0,0,0
20200316,709405,譜瑞國票99購01,1.72,1.85,1.62,1.85,+0.28,17.83,28000,8,48300,0,0,0,0,0,0,28000,0,28000,28000
20200316,709406,博智國泰9A購01,,,,,,0.00,0,0,0,0,0,0,0,0,0,0,0,0,0
20200316,709407,大學光富邦9C購01,,,,,,0.00,0,0,0,0,0,0,0,0,0,0,0,0,0
20200316,709408,VHQ永豐99購01,0.32,0.32,0.32,0.32,-0.03,-8.57,6000,1,1920,0,0,0,0,0,0,0,6000,-6000,-6000
20200316,709409,力致永豐99購01,0.20,0.20,0.15,0.15,-0.04,-21.05,51000,4,8480,0,0,0,0,0,0,0,51000,-51000,-51000
20200316,709410,大學光永豐98購01,,,,,,0.00,0,0,0,0,0,0,0,0,0,0,0,0,0
20200316,709411,台燿永豐98購01,,,,,,0.00,0,0,0,0,0,0,0,0,0,0,0,0,0
20200316,709412,立端永豐98購01,0.18,0.18,0.18,0.18,-0.03,-14.29,5000,1,900,0,0,0,0,0,0,5000,0,5000,5000
20200316,709413,合晶永豐98購03,,,,,,0.00,0,0,0,0,0,0,0,0,0,0,0,0,0
20200316,709414,東隆興永豐98購02,,,,,,0.00,0,0,0,0,0,0,0,0,0,0,0,0,0
20200316,709415,群聯永豐98購01,0.14,0.14,0.14,0.14,-0.04,-22.22,100000,1,14000,0,0,0,0,0,0,100000,100000,0,0
20200316,709416,緯軟永豐98購02,,,,,,0.00,0,0,0,0,0,0,0,0,0,0,0,0,0
20200316,709417,穩懋永豐98購01,,,,,,0.00,0,0,0,0,0,0,0,0,0,0,0,0,0
20200316,709418,頎邦永豐98購01,0.52,0.52,0.47,0.47,-0.04,-7.84,162000,4,77870,0,0,0,0,0,0,89000,73000,16000,16000
20200316,709419,泰博兆豐98購02,1.06,1.22,1.01,1.07,+0.08,8.08,1497000,24,1646910,0,0,0,0,0,0,688000,808000,-120000,-120000
20200316,709420,群聯兆豐99購01,,,,,,0.00,0,0,0,0,0,0,0,0,0,0,0,0,0
20200316,709421,大江群益98購02,0.19,0.20,0.19,0.20,+0.05,33.33,20000,2,3900,0,0,0,0,0,0,20000,0,20000,20000
20200316,709422,中美晶群益99購01,0.43,0.43,0.32,0.35,-0.10,-22.22,108000,7,39690,0,0,0,0,0,0,38000,73000,-35000,-35000
20200316,709423,亞泰群益98購01,,,,,,0.00,0,0,0,0,0,0,0,0,0,0,0,0,0
20200316,709424,南光群益98購01,,,,,,0.00,0,0,0,0,0,0,0,0,0,0,0,0,0
20200316,709425,璟德群益98購02,,,,,,0.00,0,0,0,0,0,0,0,0,0,0,0,0,0
20200316,709426,智擎中信98購01,,,,,,0.00,0,0,0,0,0,0,0,0,0,0,0,0,0
20200316,709427,力旺凱基98購01,0.14,0.14,0.13,0.13,-0.07,-35.0,150000,2,20500,0,0,0,0,0,0,0,150000,-150000,-150000
20200316,709428,三貝德凱基99購02,0.28,0.31,0.28,0.30,+0.07,30.43,12000,3,3550,0,0,0,0,0,0,7000,5000,2000,2000
20200316,709429,環球晶凱基99購03,,,,,,0.00,0,0,0,0,0,0,0,0,0,0,0,0,0
20200316,709430,穩懋凱基99購01,,,,,,0.00,0,0,0,0,0,0,0,0,0,0,0,0,0
20200316,709431,M31永豐99購01,,,,,,0.00,0,0,0,0,0,0,0,0,0,0,0,0,0
20200316,709432,力旺永豐98購01,,,,,,0.00,0,0,0,0,0,0,0,0,0,0,0,0,0
20200316,709433,大學光永豐98購02,0.24,0.24,0.17,0.17,-0.09,-34.62,80000,3,16300,0,0,0,0,0,0,30000,50000,-20000,-20000
20200316,709434,宣德永豐98購02,0.46,0.49,0.46,0.47,-0.02,-4.08,50000,5,23700,0,0,0,0,0,0,0,50000,-50000,-50000
20200316,709435,元太亞東99購01,1.50,1.50,1.35,1.35,-0.05,-3.57,92000,3,130000,0,0,0,0,0,0,82000,10000,72000,72000
20200316,709436,穩懋麥證98購01,0.64,0.64,0.64,0.64,+0.36,128.57,10000,1,6400,0,10000,-10000,0,0,0,0,10000,-10000,-10000
20200316,709437,M31元富98購01,,,,,,0.00,0,0,0,0,0,0,0,0,0,0,0,0,0
20200316,709438,光頡元富98購01,,,,,,0.00,0,0,0,0,0,0,0,0,0,0,0,0,0
20200316,709439,優群元富98購01,2.54,3.03,2.22,2.40,+0.05,2.13,107000,20,293200,0,0,0,0,0,0,49000,53000,-4000,-4000
20200316,709440,三貝德元大99購01,0.38,0.50,0.36,0.44,+0.07,18.92,816000,72,364630,0,0,0,0,0,0,169000,647000,-478000,-478000
20200316,709441,神盾元大9A購03,0.34,0.34,0.25,0.25,-0.10,-28.57,40000,4,12500,0,0,0,0,0,0,0,40000,-40000,-40000
20200316,709442,神準元大98購01,0.57,0.57,0.47,0.47,-0.05,-9.62,23000,4,11090,0,0,0,0,0,0,12000,11000,1000,1000
20200316,709443,統新元大99購01,0.57,0.59,0.47,0.47,-0.10,-17.54,43000,5,23110,0,0,0,0,0,0,10000,33000,-23000,-23000
20200316,709444,博智元大98購02,4.78,5.45,4.78,4.93,+0.91,22.64,42000,7,223820,0,0,0,0,0,0,22000,41000,-19000,-19000
20200316,709445,雍智元大98購01,0.71,0.71,0.55,0.56,-0.09,-13.85,32000,4,19560,0,0,0,0,0,0,12000,20000,-8000,-8000
20200316,709446,網家元大98購02,0.53,0.53,0.53,0.53,+0.05,10.42,10000,1,5300,0,0,0,0,0,0,0,10000,-10000,-10000
20200316,709447,緯軟元大99購01,,,,,,0.00,0,0,0,0,0,0,0,0,0,0,0,0,0
20200316,709448,環球晶元大98購13,0.74,0.74,0.54,0.54,-0.15,-21.74,120000,12,72600,0,0,0,0,0,0,10000,110000,-100000,-100000
20200316,709449,穩懋元大98購08,0.80,0.89,0.68,0.68,-0.09,-11.69,136000,11,109720,0,0,0,0,0,0,116000,26000,90000,90000
20200316,709450,宇峻國票99購01,0.30,0.30,0.30,0.30,+0.05,20.0,5000,1,1500,0,0,0,0,0,0,5000,0,5000,5000
20200316,709451,大學光兆豐99購01,,,,,,0.00,0,0,0,0,0,0,0,0,0,0,0,0,0
20200316,709452,原相兆豐99購01,0.36,0.36,0.36,0.36,-0.13,-26.53,30000,1,10800,0,0,0,0,0,0,0,0,0,0
20200316,709453,穩懋兆豐98購02,0.18,0.18,0.12,0.12,-0.04,-25.0,85000,13,14000,0,0,0,0,0,0,0,85000,-85000,-85000
20200316,709454,網家群益98購01,0.27,0.27,0.27,0.27,-0.01,-3.57,120000,2,32400,0,0,0,0,0,0,120000,0,120000,120000
20200316,709455,網家群益98購02,0.32,0.32,0.32,0.32,-0.19,-37.25,12000,1,3840,0,0,0,0,0,0,12000,0,12000,12000
20200316,709456,穩懋統一9A購01,0.40,0.40,0.40,0.40,+0.01,2.56,11000,2,4400,0,0,0,0,0,0,11000,0,11000,11000
20200316,709457,譜瑞中信9A購01,0.71,0.78,0.68,0.75,+0.04,5.63,70000,6,51150,0,0,0,0,0,0,70000,0,70000,70000
20200316,709458,大江凱基99購01,0.32,0.35,0.31,0.35,+0.04,12.9,146000,7,46110,0,0,0,0,0,0,136000,10000,126000,126000
20200316,709459,中美晶凱基99購01,0.79,0.80,0.79,0.80,+0.06,8.11,81000,5,64600,0,0,0,0,0,0,81000,0,81000,81000
20200316,709460,穩懋凱基99購02,0.44,0.46,0.34,0.37,-0.07,-15.91,1600000,22,676650,0,0,0,0,0,0,1220000,355000,865000,865000
20200316,709461,譜瑞麥證98購01,,,,,,0.00,0,0,0,0,0,0,0,0,0,0,0,0,0
20200316,709462,環球晶元富98購02,,,,,,0.00,0,0,0,0,0,0,0,0,0,0,0,0,0
20200316,709463,環球晶元富98購03,0.35,0.35,0.28,0.28,-0.08,-22.22,10000,2,3150,0,0,0,0,0,0,0,10000,-10000,-10000
20200316,709464,中美晶元大98購05,1.05,1.09,1.05,1.05,-0.10,-8.7,35000,7,37090,0,0,0,0,0,0,35000,15000,20000,20000
20200316,709465,精測元大99購02,0.91,0.95,0.74,0.74,+0.11,17.46,26000,5,23910,0,0,0,0,0,0,24000,2000,22000,22000
20200316,709466,環球晶元大98購14,0.69,0.69,0.66,0.66,0.00,0.0,30000,3,20100,0,0,0,0,0,0,0,30000,-30000,-30000
20200316,709467,譜瑞元大98購04,1.07,1.48,1.07,1.48,+0.56,60.87,181000,19,252780,0,0,0,0,0,0,149000,179000,-30000,-30000
20200316,709468,穩懋日盛99購01,,,,,,0.00,0,0,0,0,0,0,0,0,0,0,0,0,0
20200316,709469,久元永豐98購01,0.49,0.49,0.45,0.45,-0.08,-15.09,4000,3,1910,0,0,0,0,0,0,1000,3000,-2000,-2000
20200316,709470,原相永豐99購01,0.31,0.35,0.23,0.23,-0.12,-34.29,1070000,49,302890,0,0,0,0,0,0,143000,904000,-761000,-761000
20200316,709471,環球晶永豐98購02,0.14,0.16,0.07,0.10,-0.08,-44.44,162000,15,20600,0,0,0,0,0,0,10000,152000,-142000,-142000
20200316,709472,譜瑞永豐98購02,0.26,0.27,0.25,0.27,+0.03,12.5,36000,4,9500,0,0,0,0,0,0,0,36000,-36000,-36000
20200316,709473,網家台新98購01,,,,,,0.00,0,0,0,0,0,0,0,0,0,0,0,0,0
20200316,709474,台燿兆豐98購01,0.34,0.38,0.34,0.38,+0.02,5.56,157000,6,57280,0,0,0,0,0,0,157000,0,157000,157000
20200316,709475,晟德兆豐99購01,0.38,0.38,0.32,0.32,-0.09,-21.95,120000,2,39600,0,0,0,0,0,0,0,120000,-120000,-120000
20200316,709476,旺矽國票99購01,,,,,,0.00,0,0,0,0,0,0,0,0,0,0,0,0,0
20200316,709477,璟德國票99購01,,,,,,0.00,0,0,0,0,0,0,0,0,0,0,0,0,0
20200316,709478,聯亞國票99購02,,,,,,0.00,0,0,0,0,0,0,0,0,0,0,0,0,0
20200316,709479,譜瑞國票99購02,0.86,0.91,0.86,0.86,+0.04,4.88,40000,8,34940,0,0,0,0,0,0,40000,0,40000,40000
20200316,709480,宇峻康和98購01,0.36,0.42,0.36,0.42,+0.07,20.0,300000,3,119000,0,0,0,0,0,0,100000,200000,-100000,-100000
20200316,709481,凡甲群益98購02,1.47,1.59,1.39,1.39,-0.03,-2.11,168000,15,246680,0,0,0,0,0,0,126000,42000,84000,84000
20200316,709482,大宇資群益9A購01,0.38,0.42,0.28,0.28,-0.12,-30.0,209000,8,69520,0,0,0,0,0,0,120000,89000,31000,31000
20200316,709483,迅得群益9A購02,,,,,,0.00,0,0,0,0,0,0,0,0,0,0,0,0,0
20200316,709484,金居群益9A購01,,,,,,0.00,0,0,0,0,0,0,0,0,0,0,0,0,0
20200316,709485,晶焱群益9A購01,,,,,,0.00,0,0,0,0,0,0,0,0,0,0,0,0,0
20200316,709486,群聯群益98購02,,,,,,0.00,0,0,0,0,0,0,0,0,0,0,0,0,0
20200316,709487,環球晶群益98購02,0.26,0.29,0.22,0.22,-0.11,-33.33,200000,3,54300,0,0,0,0,0,0,190000,0,190000,190000
20200316,709488,大江國泰9A購02,0.38,0.39,0.33,0.33,+0.01,3.12,506000,9,179720,0,0,0,0,0,0,0,506000,-506000,-506000
20200316,709489,譜瑞國泰9A購01,0.68,0.74,0.68,0.74,+0.24,48.0,36000,3,26160,0,0,0,0,0,0,36000,11000,25000,25000
20200316,709490,穩懋富邦9A購01,0.33,0.38,0.33,0.38,+0.04,11.76,42000,4,14410,0,0,0,0,0,0,40000,2000,38000,38000
20200316,709491,譜瑞富邦9A購01,0.28,0.36,0.28,0.31,-0.02,-6.06,82000,17,25100,0,0,0,0,0,0,20000,52000,-32000,-32000
20200316,709492,同致元富9B購01,0.37,0.37,0.23,0.23,-0.13,-36.11,15000,2,4850,0,0,0,0,0,0,10000,5000,5000,5000
20200316,709493,博智元富98購01,1.63,1.95,1.56,1.78,+0.15,9.2,1083000,50,1918890,0,0,0,0,0,0,232000,824000,-592000,-592000
20200316,709494,威剛統一9A購02,,,,,,0.00,0,0,0,0,0,0,0,0,0,0,0,0,0
20200316,709495,譜瑞統一99購01,0.33,0.34,0.29,0.29,0.00,0.0,614000,7,199420,0,0,0,0,0,0,317000,0,317000,317000
20200316,709496,中美晶凱基99購02,0.30,0.30,0.30,0.30,-0.02,-6.25,12000,1,3600,0,0,0,0,0,0,12000,0,12000,12000
20200316,709497,網家凱基98購01,0.24,0.26,0.23,0.26,+0.05,23.81,42000,3,9820,0,0,0,0,0,0,30000,12000,18000,18000
20200316,709498,網龍凱基98購02,,,,,,0.00,0,0,0,0,0,0,0,0,0,0,0,0,0
20200316,709499,環球晶凱基98購07,,,,,,0.00,0,0,0,0,0,0,0,0,0,0,0,0,0
20200316,709500,環球晶凱基99購04,0.13,0.13,0.13,0.13,-0.09,-40.91,4000,1,520,0,0,0,0,0,0,4000,0,4000,4000
20200316,709501,譜瑞凱基98購01,0.31,0.36,0.25,0.25,-0.01,-3.85,665000,9,220590,0,0,0,0,0,0,660000,5000,655000,655000
20200316,709502,譜瑞凱基99購01,,,,,,0.00,0,0,0,0,0,0,0,0,0,0,0,0,0
20200316,709503,譜瑞凱基9A購01,0.44,0.49,0.44,0.46,+0.12,35.29,36000,8,16860,0,0,0,0,0,0,36000,6000,30000,30000
20200316,709504,合晶兆豐98購01,,,,,,0.00,0,0,0,0,0,0,0,0,0,0,0,0,0
20200316,709505,威剛兆豐99購01,0.23,0.23,0.23,0.23,+0.03,15.0,1000,1,230,0,0,0,0,0,0,1000,0,1000,1000
20200316,709506,聚積兆豐99購01,,,,,,0.00,0,0,0,0,0,0,0,0,0,0,0,0,0
20200316,709507,中美晶永豐98購02,,,,,,0.00,0,0,0,0,0,0,0,0,0,0,0,0,0
20200316,709508,尼克森永豐98購01,,,,,,0.00,0,0,0,0,0,0,0,0,0,0,0,0,0
20200316,709509,安勤永豐98購01,0.27,0.27,0.27,0.27,+0.03,12.5,110000,2,29700,0,0,0,0,0,0,0,110000,-110000,-110000
20200316,709510,信驊永豐98購01,1.57,1.61,1.07,1.07,-0.22,-17.05,225000,27,296090,0,0,0,0,0,0,48000,177000,-129000,-129000
20200316,709511,博智永豐98購02,0.84,1.01,0.84,1.01,-0.42,-29.37,36000,7,31860,0,0,0,0,0,0,34000,0,34000,34000
20200316,709512,網家永豐98購01,,,,,,0.00,0,0,0,0,0,0,0,0,0,0,0,0,0
20200316,709513,中美晶國票98購02,0.52,0.54,0.52,0.54,+0.03,5.88,2000,2,1060,0,0,0,0,0,0,2000,0,2000,2000
20200316,709514,網家國票99購01,,,,,,0.00,0,0,0,0,0,0,0,0,0,0,0,0,0
20200316,709515,穩懋國票99購01,1.27,1.27,1.18,1.24,+0.08,6.9,71000,4,88640,0,0,0,0,0,0,70000,1000,69000,69000
20200316,709516,中美晶國泰9A購01,0.61,0.62,0.61,0.62,-0.06,-8.82,10000,3,6110,0,0,0,0,0,0,10000,10000,0,0
20200316,709517,太景*國泰9A購02,0.54,0.60,0.54,0.60,0.00,0.0,140000,7,83200,0,0,0,0,0,0,0,140000,-140000,-140000
20200316,709518,宇峻國泰9A購01,0.54,0.59,0.54,0.59,+0.09,18.0,285000,2,158150,0,0,0,0,0,0,85000,200000,-115000,-115000
20200316,709519,威剛國泰99購01,,,,,,0.00,0,0,0,0,0,0,0,0,0,0,0,0,0
20200316,709520,原相國泰99購01,0.53,0.53,0.49,0.49,-0.20,-28.99,20000,2,10200,0,0,0,0,0,0,20000,0,20000,20000
20200316,709521,博智國泰9A購02,2.20,2.20,2.20,2.20,+0.23,11.68,1000,1,2200,0,0,0,0,0,0,1000,0,1000,1000
20200316,709522,環球晶國泰99購02,0.63,0.70,0.44,0.44,-0.28,-38.89,560000,19,364850,0,0,0,0,0,0,290000,310000,-20000,-20000
20200316,709523,環球晶國泰9A購01,0.59,0.66,0.46,0.46,-0.22,-32.35,554000,11,336490,0,0,0,0,0,0,514000,77000,437000,437000
20200316,709524,鈊象國泰9A購01,2.25,2.25,1.76,1.76,-0.45,-20.36,419000,22,863120,0,0,0,0,0,0,302000,0,302000,302000
20200316,709525,譜瑞台新98購01,0.55,0.63,0.51,0.63,+0.08,14.55,456000,23,262850,0,0,0,0,0,0,146000,310000,-164000,-164000
20200316,709526,大學光富邦98購01,,,,,,0.00,0,0,0,0,0,0,0,0,0,0,0,0,0
20200316,709527,力旺群益99購01,0.25,0.26,0.23,0.23,-0.10,-30.3,114000,6,28870,0,0,0,0,0,0,61000,53000,8000,8000
20200316,709528,中美晶群益99購02,0.44,0.44,0.44,0.44,-0.03,-6.38,5000,1,2200,0,0,0,0,0,0,5000,5000,0,0
20200316,709529,宜鼎群益98購03,0.49,0.49,0.46,0.46,+0.10,27.78,201000,3,98460,0,0,0,0,0,0,201000,0,201000,201000
20200316,709530,神盾群益9A購03,0.23,0.23,0.22,0.22,-0.06,-21.43,10000,2,2250,0,0,0,0,0,0,0,10000,-10000,-10000
20200316,709531,碩禾群益98購01,,,,,,0.00,0,0,0,0,0,0,0,0,0,0,0,0,0
20200316,709532,精測群益98購01,0.50,0.51,0.38,0.38,+0.06,18.75,241000,9,113690,0,0,0,0,0,0,211000,30000,181000,181000
20200316,709533,譜瑞群益98購02,,,,,,0.00,0,0,0,0,0,0,0,0,0,0,0,0,0
20200316,709534,M31元大9A購01,0.33,0.33,0.23,0.23,-0.10,-30.3,380000,38,104900,0,0,0,0,0,0,0,380000,-380000,-380000
20200316,709535,宣德元大99購02,1.67,1.67,1.41,1.42,-0.20,-12.35,70000,7,107800,0,0,0,0,0,0,50000,60000,-10000,-10000
20200316,709536,網家元大98購03,,,,,,0.00,0,0,0,0,0,0,0,0,0,0,0,0,0
20200316,709537,環球晶元大9A購01,0.65,0.65,0.64,0.64,0.00,0.0,40000,2,25900,0,0,0,0,0,0,30000,10000,20000,20000
20200316,709538,穩懋元大98購09,1.55,1.60,1.23,1.23,-0.13,-9.56,113000,16,172890,0,0,0,0,0,0,113000,93000,20000,20000
20200316,709539,鈺太元大99購03,0.59,0.83,0.58,0.77,+0.16,26.23,125000,9,85150,0,0,0,0,0,0,65000,60000,5000,5000
20200316,709540,雍智元富98購01,0.67,0.74,0.52,0.52,-0.26,-33.33,60000,3,33120,0,0,0,0,0,0,10000,50000,-40000,-40000
20200316,709541,環球晶中信99購03,,,,,,0.00,0,0,0,0,0,0,0,0,0,0,0,0,0
20200316,709542,大江凱基9A購01,0.18,0.23,0.18,0.19,+0.01,5.56,92000,9,18100,0,0,0,0,0,0,32000,60000,-28000,-28000
20200316,709543,中美晶凱基9A購02,0.27,0.27,0.25,0.25,-0.05,-16.67,105000,2,28250,0,0,0,0,0,0,100000,5000,95000,95000
20200316,709544,台半凱基98購02,0.54,0.54,0.37,0.37,-0.03,-7.5,89000,4,36030,0,0,0,0,0,0,20000,69000,-49000,-49000
20200316,709545,安勤凱基98購01,0.38,0.41,0.38,0.41,+0.11,36.67,136000,2,52760,0,0,0,0,0,0,36000,100000,-64000,-64000
20200316,709546,環球晶凱基99購05,0.23,0.23,0.21,0.21,-0.10,-32.26,9000,3,2010,0,0,0,0,0,0,9000,0,9000,9000
20200316,709547,穩懋凱基98購09,0.65,0.65,0.65,0.65,+0.27,71.05,10000,1,6500,0,0,0,0,0,0,10000,0,10000,10000
20200316,709548,威剛統一99購01,,,,,,0.00,0,0,0,0,0,0,0,0,0,0,0,0,0
20200316,709549,網家統一9A購01,,,,,,0.00,0,0,0,0,0,0,0,0,0,0,0,0,0
20200316,709550,環球晶統一99購03,,,,,,0.00,0,0,0,0,0,0,0,0,0,0,0,0,0
20200316,709551,大江元大99購02,0.73,0.73,0.72,0.72,+0.10,16.13,20000,2,14500,0,0,0,0,0,0,0,20000,-20000,-20000
20200316,709552,神盾元大99購04,0.48,0.49,0.38,0.38,-0.11,-22.45,23000,3,10840,0,0,0,0,0,0,0,23000,-23000,-23000
20200316,709553,博智元大98購03,2.15,2.54,2.15,2.27,+0.26,12.94,90000,17,214050,0,0,0,0,0,0,34000,75000,-41000,-41000
20200316,709554,群聯元大99購03,0.67,0.70,0.55,0.56,-0.17,-23.29,385000,42,245950,0,0,0,0,0,0,95000,345000,-250000,-250000
20200316,709555,譜瑞元大98購06,1.01,1.43,1.01,1.43,+0.49,52.13,46000,4,58980,0,0,0,0,0,0,20000,46000,-26000,-26000
20200316,709556,威剛國票99購01,,,,,,0.00,0,0,0,0,0,0,0,0,0,0,0,0,0
20200316,709557,神盾國票99購01,0.61,0.61,0.43,0.43,-0.15,-25.86,36000,5,18710,0,0,0,0,0,0,10000,26000,-16000,-16000
20200316,709558,廣明國票99購01,0.49,0.49,0.49,0.49,+0.09,22.5,1000,1,490,0,0,0,0,0,0,0,1000,-1000,-1000
20200316,709559,環球晶國票99購01,,,,,,0.00,0,0,0,0,0,0,0,0,0,0,0,0,0
20200316,709560,雙美國票99購02,,,,,,0.00,0,0,0,0,0,0,0,0,0,0,0,0,0
20200316,709561,聚積國泰99購01,0.52,0.55,0.52,0.55,-0.02,-3.51,47000,3,24900,0,0,0,0,0,0,47000,0,47000,47000
20200316,709562,中美晶群益98購03,0.28,0.28,0.20,0.20,-0.05,-20.0,210000,5,43600,0,0,0,0,0,0,190000,20000,170000,170000
20200316,709563,合晶群益98購02,0.30,0.31,0.30,0.31,+0.01,3.33,11000,3,3370,0,0,0,0,0,0,11000,0,11000,11000
20200316,709564,旺矽群益99購01,,,,,,0.00,0,0,0,0,0,0,0,0,0,0,0,0,0
20200316,709565,宣德群益98購02,,,,,,0.00,0,0,0,0,0,0,0,0,0,0,0,0,0
20200316,709566,鈺太群益98購03,,,,,,0.00,0,0,0,0,0,0,0,0,0,0,0,0,0
20200316,709567,穩懋台新98購02,0.65,0.72,0.52,0.52,+0.12,30.0,1320000,13,756000,0,0,0,0,0,0,1220000,1000000,220000,220000
20200316,709568,原相亞東99購02,0.71,0.71,0.71,0.71,+0.17,31.48,50000,1,35500,0,0,0,0,0,0,50000,0,50000,50000
20200316,709569,群聯亞東98購01,,,,,,0.00,0,0,0,0,0,0,0,0,0,0,0,0,0
20200316,709570,直得永豐98購01,0.15,0.15,0.15,0.15,0.00,0.0,5000,1,750,0,0,0,0,0,0,0,5000,-5000,-5000
20200316,709571,網龍永豐98購02,,,,,,0.00,0,0,0,0,0,0,0,0,0,0,0,0,0
20200316,709572,聚積永豐98購01,,,,,,0.00,0,0,0,0,0,0,0,0,0,0,0,0,0
20200316,709573,鈺太永豐98購01,,,,,,0.00,0,0,0,0,0,0,0,0,0,0,0,0,0
20200316,709574,元太台新98購02,0.49,0.49,0.38,0.38,-0.03,-7.32,48000,2,19340,0,0,0,0,0,0,38000,10000,28000,28000
20200316,709575,中美晶元大98購06,0.47,0.47,0.47,0.47,-0.01,-2.08,5000,1,2350,0,0,0,0,0,0,5000,5000,0,0
20200316,709576,原相元大9A購03,1.78,1.94,1.72,1.72,-0.19,-9.95,123000,20,223710,0,0,0,0,0,0,103000,55000,48000,48000
20200316,709577,泰博元大98購01,1.42,1.63,1.38,1.42,+0.11,8.4,439000,50,680460,0,0,0,0,0,0,95000,334000,-239000,-239000
20200316,709578,聚積元大9A購01,0.46,0.48,0.46,0.48,+0.08,20.0,10000,2,4660,0,0,0,0,0,0,10000,0,10000,10000
20200316,709579,環球晶元大98購15,0.40,0.40,0.40,0.40,+0.02,5.26,10000,1,4000,0,0,0,0,0,0,10000,0,10000,10000
20200316,709580,宇峻中信98購01,0.28,0.30,0.24,0.24,-0.01,-4.0,105000,10,29500,0,0,0,0,0,0,0,105000,-105000,-105000
20200316,709581,原相統一99購02,0.29,0.34,0.23,0.24,-0.06,-20.0,1010000,22,264770,1000,0,1000,0,0,0,966000,0,966000,967000
20200316,709582,雙鴻統一99購02,,,,,,0.00,0,0,0,0,0,0,0,0,0,0,0,0,0
20200316,709583,大宇資凱基99購01,0.28,0.28,0.18,0.18,-0.09,-33.33,462000,14,107390,0,0,0,0,0,0,0,462000,-462000,-462000
20200316,709584,威剛凱基98購01,,,,,,0.00,0,0,0,0,0,0,0,0,0,0,0,0,0
20200316,709585,博智凱基9A購01,0.67,0.82,0.66,0.79,+0.08,11.27,443000,57,330820,10000,0,10000,0,0,0,159000,191000,-32000,-22000
20200316,709586,精測凱基99購02,0.63,0.66,0.60,0.60,+0.03,5.26,441000,31,279420,0,0,0,0,0,0,109000,275000,-166000,-166000
20200316,709587,譜瑞凱基98購02,0.48,0.49,0.36,0.36,-0.03,-7.69,440000,9,187700,0,0,0,0,0,0,430000,10000,420000,420000
20200316,709588,中美晶群益98購04,,,,,,0.00,0,0,0,0,0,0,0,0,0,0,0,0,0
20200316,709589,元太群益99購01,0.46,0.46,0.46,0.46,+0.01,2.22,11000,1,5060,0,0,0,0,0,0,11000,0,11000,11000
20200316,709590,網家群益98購03,,,,,,0.00,0,0,0,0,0,0,0,0,0,0,0,0,0
20200316,709591,譜瑞群益98購03,,,,,,0.00,0,0,0,0,0,0,0,0,0,0,0,0,0
20200316,709592,泰博國票99購03,0.77,0.96,0.77,0.85,+0.10,13.33,195000,5,162650,0,0,0,0,0,0,170000,0,170000,170000
20200316,709593,合晶國泰99購02,0.65,0.65,0.50,0.50,-0.04,-7.41,110000,3,64900,0,0,0,0,0,0,70000,40000,30000,30000
20200316,709594,保瑞國泰9A購01,1.08,1.08,0.96,0.96,-0.07,-6.8,103000,3,110040,0,0,0,0,0,0,103000,0,103000,103000
20200316,709595,璟德兆豐99購01,0.18,0.18,0.13,0.13,-0.07,-35.0,310000,4,41200,0,0,0,0,0,0,280000,30000,250000,250000
20200316,709596,亞泰永豐99購02,0.36,0.36,0.36,0.36,-0.02,-5.26,14000,2,5040,0,0,0,0,0,0,0,14000,-14000,-14000
20200316,709597,保瑞永豐98購01,0.50,0.50,0.47,0.47,+0.07,17.5,29000,2,14380,0,0,0,0,0,0,29000,0,29000,29000
20200316,709598,建榮永豐99購03,0.38,0.38,0.38,0.38,+0.02,5.56,58000,1,22040,0,0,0,0,0,0,0,58000,-58000,-58000
20200316,709599,神盾永豐98購01,,,,,,0.00,0,0,0,0,0,0,0,0,0,0,0,0,0
20200316,709600,新鉅科永豐98購02,0.07,0.07,0.07,0.07,-0.02,-22.22,10000,1,700,0,0,0,0,0,0,10000,0,10000,10000
20200316,709601,雙美永豐99購02,0.44,0.44,0.44,0.44,+0.01,2.33,42000,1,18480,0,0,0,0,0,0,0,42000,-42000,-42000
20200316,709602,穩懋永豐98購03,0.74,0.74,0.59,0.59,-0.10,-14.49,11000,2,7990,0,0,0,0,0,0,10000,11000,-1000,-1000
20200316,709603,晟德永豐98購01,,,,,,0.00,0,0,0,0,0,0,0,0,0,0,0,0,0
20200316,709604,鈊象永豐98購03,1.05,1.08,0.63,0.65,-0.35,-35.0,1596000,155,1428200,0,0,0,0,0,0,739000,513000,226000,226000
20200316,709605,中美晶元富99購02,0.44,0.44,0.44,0.44,-0.01,-2.22,371000,3,163240,0,0,0,0,0,0,371000,0,371000,371000
20200316,709606,尼克森元富98購01,0.59,0.61,0.53,0.53,+0.06,12.77,79000,9,43090,0,0,0,0,0,0,19000,60000,-41000,-41000
20200316,709607,博智元富98購02,1.61,1.86,1.50,1.58,+0.04,2.6,711000,77,1189030,0,0,0,0,0,0,385000,301000,84000,84000
20200316,709608,網龍元富98購01,,,,,,0.00,0,0,0,0,0,0,0,0,0,0,0,0,0
20200316,709609,穩懋元富02購01,1.09,1.12,0.88,0.88,-0.18,-16.98,1579000,44,1651700,0,0,0,0,0,0,536000,1036000,-500000,-500000
20200316,709610,穩懋元富02購02,1.06,1.06,1.05,1.05,+0.16,17.98,94000,3,99200,0,0,0,0,0,0,94000,0,94000,94000
20200316,709611,穩懋元富02購03,1.07,1.09,1.06,1.09,+0.20,22.47,120000,4,128300,0,0,0,0,0,0,100000,20000,80000,80000
20200316,709612,穩懋元富02購04,1.17,1.17,1.12,1.12,-0.03,-2.61,20000,2,23150,0,0,0,0,0,0,20000,0,20000,20000
20200316,709613,凡甲凱基98購02,1.45,1.57,1.32,1.32,-0.17,-11.41,640000,56,930390,0,0,0,0,0,0,503000,562000,-59000,-59000
20200316,709614,中美晶凱基99購03,,,,,,0.00,0,0,0,0,0,0,0,0,0,0,0,0,0
20200316,709615,緯軟凱基98購04,,,,,,0.00,0,0,0,0,0,0,0,0,0,0,0,0,0
20200316,709616,大江兆豐99購01,0.29,0.29,0.28,0.28,+0.05,21.74,70000,2,20100,0,0,0,0,0,0,0,70000,-70000,-70000
20200316,709617,大江群益98購03,0.26,0.28,0.23,0.23,+0.02,9.52,578000,11,150730,0,0,0,0,0,0,0,578000,-578000,-578000
20200316,709618,安勤群益98購01,0.44,0.44,0.43,0.43,+0.05,13.16,150000,2,65500,0,0,0,0,0,0,0,150000,-150000,-150000
20200316,709619,杰力群益98購01,,,,,,0.00,0,0,0,0,0,0,0,0,0,0,0,0,0
20200316,709620,群聯群益98購03,,,,,,0.00,0,0,0,0,0,0,0,0,0,0,0,0,0
20200316,709621,環球晶群益98購04,0.47,0.47,0.33,0.33,-0.27,-45.0,15000,3,6000,0,0,0,0,0,0,0,15000,-15000,-15000
20200316,709622,M31永豐98購02,,,,,,0.00,0,0,0,0,0,0,0,0,0,0,0,0,0
20200316,709623,尼克森永豐98購02,,,,,,0.00,0,0,0,0,0,0,0,0,0,0,0,0,0
20200316,709624,泰博永豐99購01,0.46,0.52,0.45,0.51,+0.09,21.43,191000,11,95110,0,0,0,0,0,0,51000,140000,-89000,-89000
20200316,709625,力旺國票99購01,,,,,,0.00,0,0,0,0,0,0,0,0,0,0,0,0,0
20200316,709626,建榮國票9A購01,0.46,0.46,0.32,0.32,-0.07,-17.95,30000,3,11700,0,0,0,0,0,0,20000,30000,-10000,-10000
20200316,709627,博智國票99購01,1.91,2.10,1.86,2.10,+0.26,14.13,125000,11,248800,0,0,0,0,0,0,95000,0,95000,95000
20200316,709628,優群國票99購01,3.11,3.51,3.11,3.47,+0.99,39.92,71000,10,245760,0,0,0,0,0,0,71000,0,71000,71000
20200316,709629,環球晶國票99購02,,,,,,0.00,0,0,0,0,0,0,0,0,0,0,0,0,0
20200316,709630,聯亞國票99購03,1.71,1.71,1.71,1.71,+0.18,11.76,10000,1,17100,0,0,0,0,0,0,10000,0,10000,10000
20200316,709631,大中元大98購01,0.68,0.68,0.68,0.68,-0.26,-27.66,3000,1,2040,0,0,0,0,0,0,0,3000,-3000,-3000
20200316,709632,合晶元大99購01,0.66,0.66,0.58,0.58,-0.01,-1.69,60000,6,36800,0,0,0,0,0,0,10000,50000,-40000,-40000
20200316,709633,宜鼎元大99購01,0.55,0.56,0.55,0.56,+0.07,14.29,230000,4,128600,0,0,0,0,0,0,220000,10000,210000,210000
20200316,709634,保瑞元大98購02,1.47,1.56,1.14,1.14,-0.34,-22.97,174000,10,254730,0,0,0,0,0,0,164000,10000,154000,154000
20200316,709635,譜瑞元大98購07,0.81,0.88,0.77,0.88,+0.26,41.94,380000,25,311810,0,0,0,0,0,0,378000,209000,169000,169000
20200316,709636,晟德元大98購01,0.70,0.70,0.56,0.56,-0.22,-28.21,20000,2,12600,0,0,0,0,0,0,0,20000,-20000,-20000
20200316,709637,安勤元富98購01,0.58,0.59,0.45,0.45,-0.05,-10.0,252000,4,146920,0,0,0,0,0,0,98000,154000,-56000,-56000
20200316,709638,威剛富邦9A購01,0.26,0.26,0.26,0.26,-0.02,-7.14,2000,1,520,0,0,0,0,0,0,2000,0,2000,2000
20200316,709639,雙鴻富邦99購01,,,,,,0.00,0,0,0,0,0,0,0,0,0,0,0,0,0
20200316,709640,博智台新98購01,0.87,1.01,0.85,0.88,+0.02,2.33,118000,27,106090,0,0,0,0,0,0,69000,47000,22000,22000
20200316,709641,久元群益98購01,,,,,,0.00,0,0,0,0,0,0,0,0,0,0,0,0,0
20200316,709642,群聯群益98購04,,,,,,0.00,0,0,0,0,0,0,0,0,0,0,0,0,0
20200316,709643,聖暉群益98購01,1.90,1.90,1.72,1.72,+0.05,2.99,15000,3,27480,0,0,0,0,0,0,15000,0,15000,15000
20200316,709644,璟德中信98購01,1.04,1.08,0.81,0.81,-0.28,-25.69,30000,3,29300,0,0,0,0,0,0,20000,10000,10000,10000
20200316,709645,合晶統一9A購01,,,,,,0.00,0,0,0,0,0,0,0,0,0,0,0,0,0
20200316,709646,神盾統一99購01,,,,,,0.00,0,0,0,0,0,0,0,0,0,0,0,0,0
20200316,709647,環球晶統一99購04,,,,,,0.00,0,0,0,0,0,0,0,0,0,0,0,0,0
20200316,709648,穩懋統一98購06,,,,,,0.00,0,0,0,0,0,0,0,0,0,0,0,0,0
20200316,709649,中美晶凱基99購04,,,,,,0.00,0,0,0,0,0,0,0,0,0,0,0,0,0
20200316,709650,精測凱基98購05,0.74,0.76,0.62,0.65,+0.08,14.04,820000,26,575270,0,0,0,0,0,0,697000,123000,574000,574000
20200316,709651,聯亞凱基99購04,0.54,0.78,0.45,0.45,+0.01,2.27,319000,26,167340,0,0,0,0,0,0,108000,155000,-47000,-47000
20200316,709652,大學光國票99購01,0.67,0.67,0.67,0.67,+0.05,8.06,60000,1,40200,0,0,0,0,0,0,60000,0,60000,60000
20200316,709653,原相國票99購02,0.68,0.76,0.49,0.49,-0.11,-18.33,540000,24,366540,0,0,0,0,0,0,507000,0,507000,507000
20200316,709654,安勤國泰99購01,0.52,0.57,0.47,0.47,-0.04,-7.84,457000,13,254790,0,0,0,0,0,0,16000,441000,-425000,-425000
20200316,709655,大江元大98購03,0.84,0.94,0.83,0.83,+0.03,3.75,41000,5,36100,0,0,0,0,0,0,10000,31000,-21000,-21000
20200316,709656,中美晶元大99購03,0.88,0.89,0.88,0.89,-0.05,-5.32,15000,4,13230,0,0,0,0,0,0,15000,15000,0,0
20200316,709657,宇峻元大99購03,0.69,0.75,0.69,0.75,+0.12,19.05,100000,10,73100,0,0,0,0,0,0,0,100000,-100000,-100000
20200316,709658,博智元大99購01,2.13,2.50,2.11,2.18,-0.01,-0.46,55000,11,127210,0,0,0,0,0,0,22000,49000,-27000,-27000
20200316,709659,網家元大99購02,0.79,0.79,0.79,0.79,+0.07,9.72,10000,1,7900,0,0,0,0,0,0,0,10000,-10000,-10000
20200316,709660,環球晶元大98購16,0.53,0.53,0.45,0.45,-0.07,-13.46,25000,2,11650,0,0,0,0,0,0,20000,5000,15000,15000
20200316,709661,環球晶元大99購02,0.55,0.55,0.47,0.47,-0.07,-12.96,35000,3,17050,0,0,0,0,0,0,30000,5000,25000,25000
20200316,709662,穩懋元大98購10,1.21,1.37,1.01,1.01,-0.23,-18.55,124000,17,156570,0,0,0,0,0,0,104000,65000,39000,39000
20200316,709663,譜瑞元大98購08,0.76,1.13,0.76,0.87,-0.05,-5.43,68000,16,68420,0,0,0,0,0,0,36000,46000,-10000,-10000
20200316,709664,神盾第一9C購02,,,,,,0.00,0,0,0,0,0,0,0,0,0,0,0,0,0
20200316,709665,台半永豐98購01,,,,,,0.00,0,0,0,0,0,0,0,0,0,0,0,0,0
20200316,709666,兆利永豐98購02,,,,,,0.00,0,0,0,0,0,0,0,0,0,0,0,0,0
20200316,709667,金居永豐98購02,0.33,0.33,0.26,0.26,-0.05,-16.13,30000,3,8800,0,0,0,0,0,0,0,30000,-30000,-30000
20200316,709668,宣德永豐98購03,0.34,0.34,0.34,0.34,+0.05,17.24,10000,1,3400,0,0,0,0,0,0,10000,0,10000,10000
20200316,709669,博智永豐99購01,0.70,0.81,0.68,0.75,+0.07,10.29,509000,40,385870,0,0,0,0,0,0,199000,305000,-106000,-106000
20200316,709670,晶焱永豐98購03,,,,,,0.00,0,0,0,0,0,0,0,0,0,0,0,0,0
20200316,709671,雍智永豐99購01,0.38,0.38,0.38,0.38,+0.02,5.56,300000,1,114000,0,0,0,0,0,0,300000,0,300000,300000
20200316,709672,環宇永豐98購03,,,,,,0.00,0,0,0,0,0,0,0,0,0,0,0,0,0
20200316,709673,環球晶元富98購04,,,,,,0.00,0,0,0,0,0,0,0,0,0,0,0,0,0
20200316,709674,力旺元大98購01,0.57,0.57,0.57,0.57,-0.27,-32.14,10000,1,5700,0,0,0,0,0,0,0,10000,-10000,-10000
20200316,709675,力旺元大98購02,0.71,0.71,0.71,0.71,-0.05,-6.58,6000,1,4260,0,0,0,0,0,0,0,6000,-6000,-6000
20200316,709676,中美晶元大98購08,0.89,0.95,0.89,0.95,0.00,0.0,15000,4,13630,0,0,0,0,0,0,15000,15000,0,0
20200316,709677,聚積元大99購01,,,,,,0.00,0,0,0,0,0,0,0,0,0,0,0,0,0
20200316,709678,聯亞元大98購05,0.85,0.85,0.80,0.80,+0.05,6.67,38000,3,30700,0,0,0,0,0,0,38000,0,38000,38000
20200316,709679,譜瑞元大98購09,0.90,0.92,0.90,0.92,+0.09,10.84,42000,2,38400,0,0,0,0,0,0,42000,12000,30000,30000
20200316,709680,中美晶國票99購01,0.70,0.70,0.70,0.70,+0.11,18.64,2000,1,1400,0,0,0,0,0,0,0,2000,-2000,-2000
20200316,709681,宣德國票98購02,1.56,1.56,1.49,1.49,-0.07,-4.49,40000,2,61700,0,0,0,0,0,0,40000,0,40000,40000
20200316,709682,建榮國票9A購02,,,,,,0.00,0,0,0,0,0,0,0,0,0,0,0,0,0
20200316,709683,網家國票99購02,,,,,,0.00,0,0,0,0,0,0,0,0,0,0,0,0,0
20200316,709684,雍智國泰9A購01,0.70,0.73,0.55,0.55,-0.10,-15.38,831000,9,547050,0,0,0,0,0,0,618000,213000,405000,405000
20200316,709685,安勤統一98購01,,,,,,0.00,0,0,0,0,0,0,0,0,0,0,0,0,0
20200316,709686,元太中信9A購01,,,,,,0.00,0,0,0,0,0,0,0,0,0,0,0,0,0
20200316,709687,台燿中信9A購01,,,,,,0.00,0,0,0,0,0,0,0,0,0,0,0,0,0
20200316,709688,合晶中信9A購02,,,,,,0.00,0,0,0,0,0,0,0,0,0,0,0,0,0
20200316,709689,中美晶凱基99購05,0.64,0.65,0.58,0.61,-0.05,-7.58,165000,7,101150,0,0,0,0,0,0,130000,35000,95000,95000
20200316,709690,六角凱基99購03,0.45,0.50,0.45,0.50,-0.05,-9.09,30000,3,14400,0,0,0,0,0,0,10000,20000,-10000,-10000
20200316,709691,智崴凱基98購01,0.28,0.28,0.20,0.22,0.00,0.0,421000,7,110320,0,0,0,0,0,0,0,421000,-421000,-421000
20200316,709692,昇達科永豐98購01,,,,,,0.00,0,0,0,0,0,0,0,0,0,0,0,0,0
20200316,709693,建榮永豐99購04,0.66,0.66,0.55,0.55,-0.05,-8.33,100000,3,62170,0,0,0,0,0,0,73000,27000,46000,46000
20200316,709694,順達永豐98購01,0.99,1.10,0.99,1.00,+0.07,7.53,35000,3,36950,0,0,0,0,0,0,25000,10000,15000,15000
20200316,709695,精測永豐98購01,,,,,,0.00,0,0,0,0,0,0,0,0,0,0,0,0,0
20200316,709696,穩懋永豐98購04,1.12,1.12,0.91,0.92,+0.43,87.76,236000,5,221020,0,0,0,0,0,0,30000,236000,-206000,-206000
20200316,709697,鈊象永豐99購01,0.71,0.72,0.43,0.45,-0.22,-32.84,1535000,120,914870,0,0,0,0,0,0,526000,502000,24000,24000
20200316,709698,力旺中信99購01,0.63,0.68,0.45,0.45,-0.21,-31.82,1027000,59,577380,0,0,0,0,0,0,147000,880000,-733000,-733000
20200316,709699,凡甲元大9A購02,1.01,1.08,0.95,0.95,-0.06,-5.94,254000,30,265500,0,0,0,0,0,0,90000,228000,-138000,-138000
20200316,709700,安勤元大99購01,0.75,0.75,0.75,0.75,+0.12,19.05,10000,1,7500,0,0,0,0,0,0,10000,0,10000,10000
20200316,709701,宏捷科元大99購01,2.30,2.30,1.51,1.51,-0.61,-28.77,36000,5,76050,0,0,0,0,0,0,31000,5000,26000,26000
20200316,709702,宜鼎元大9A購01,0.57,0.57,0.57,0.57,0.00,0.0,240000,4,136800,0,0,0,0,0,0,230000,10000,220000,220000
20200316,709703,直得元大99購01,0.88,0.88,0.67,0.67,-0.24,-26.37,12000,8,9700,0,0,0,0,0,0,0,12000,-12000,-12000
20200316,709704,南光元大99購01,0.92,0.92,0.80,0.80,-0.05,-5.88,140000,14,120700,0,0,0,0,0,0,10000,130000,-120000,-120000
20200316,709705,原相元大99購03,0.60,0.66,0.45,0.45,-0.19,-29.69,212000,29,121830,0,0,0,0,0,0,130000,82000,48000,48000
20200316,709706,新鉅科元大99購01,0.62,0.62,0.56,0.56,+0.10,21.74,101000,7,61390,0,0,0,0,0,0,101000,0,101000,101000
20200316,709707,穩懋元大99購02,1.84,2.01,1.57,1.60,-0.33,-17.1,898000,89,1634020,0,0,0,0,0,0,536000,572000,-36000,-36000
20200316,709708,晟德元大99購01,0.76,0.78,0.76,0.78,+0.04,5.41,15000,2,11500,0,0,0,0,0,0,0,15000,-15000,-15000
20200316,709709,大宇資國票9A購01,,,,,,0.00,0,0,0,0,0,0,0,0,0,0,0,0,0
20200316,709710,宏捷科國票9A購01,3.80,3.80,3.05,3.05,-0.39,-11.34,61000,3,203300,0,0,0,0,0,0,61000,0,61000,61000
20200316,709711,穩懋國泰9A購01,1.23,1.36,1.01,1.14,-0.07,-5.79,897000,26,1111550,0,0,0,0,0,0,150000,787000,-637000,-637000
20200316,709712,穩懋國泰9B購01,1.27,1.32,0.97,1.01,-0.21,-17.21,494000,35,590750,0,0,0,0,0,0,135000,414000,-279000,-279000
20200316,709713,亞泰元富99購01,0.83,0.83,0.83,0.83,+0.06,7.79,50000,1,41500,0,0,0,0,0,0,0,50000,-50000,-50000
20200316,709714,合晶統一9A購02,,,,,,0.00,0,0,0,0,0,0,0,0,0,0,0,0,0
20200316,709715,宏捷科統一9A購01,0.57,0.57,0.55,0.55,+0.05,10.0,21000,2,11950,0,0,0,0,0,0,21000,0,21000,21000
20200316,709716,泰博統一9A購01,0.85,0.85,0.85,0.85,+0.05,6.25,330000,1,280500,0,0,0,0,0,0,330000,0,330000,330000
20200316,709717,神盾統一9A購01,,,,,,0.00,0,0,0,0,0,0,0,0,0,0,0,0,0
20200316,709718,雙鴻統一9A購01,,,,,,0.00,0,0,0,0,0,0,0,0,0,0,0,0,0
20200316,709719,宏捷科日盛99購01,0.91,0.91,0.80,0.80,+0.06,8.11,30000,3,26700,0,0,0,0,0,0,25000,5000,20000,20000
20200316,709720,VHQ凱基9A購01,1.03,1.05,0.89,0.89,-0.01,-1.11,689000,26,626340,0,0,0,0,0,0,30000,659000,-629000,-629000
20200316,709721,三貝德凱基9A購01,0.22,0.22,0.17,0.17,+0.01,6.25,15000,2,2800,0,0,0,0,0,0,0,15000,-15000,-15000
20200316,709722,太景*凱基99購01,0.29,0.29,0.18,0.18,-0.13,-41.94,19000,2,4410,0,0,0,0,0,0,19000,0,19000,19000
20200316,709723,宏捷科凱基99購01,0.81,0.82,0.53,0.53,-0.21,-28.38,356000,15,268790,0,0,0,0,0,0,314000,42000,272000,272000
20200316,709724,晶焱凱基99購01,0.79,0.79,0.79,0.79,+0.06,8.22,10000,1,7900,0,0,0,0,0,0,10000,0,10000,10000
20200316,709725,大學光永豐99購01,,,,,,0.00,0,0,0,0,0,0,0,0,0,0,0,0,0
20200316,709726,宏捷科永豐99購01,0.89,0.89,0.89,0.89,+0.11,14.1,10000,1,8900,0,0,0,0,0,0,10000,0,10000,10000
20200316,709727,信驊永豐99購01,1.22,1.31,0.89,0.99,-0.23,-18.85,1425000,43,1733010,0,0,0,0,0,0,1115000,200000,915000,915000
20200316,709728,威剛永豐99購02,0.47,0.47,0.43,0.43,+0.02,4.88,140000,2,62920,0,0,0,0,0,0,72000,68000,4000,4000
20200316,709729,環球晶永豐99購01,,,,,,0.00,0,0,0,0,0,0,0,0,0,0,0,0,0
20200316,709730,宏捷科康和99購01,0.84,0.84,0.84,0.84,+0.10,13.51,65000,1,54600,0,0,0,0,0,0,65000,0,65000,65000
20200316,709731,宏捷科群益99購01,,,,,,0.00,0,0,0,0,0,0,0,0,0,0,0,0,0
20200316,709732,宏捷科元富99購01,1.03,1.04,0.71,0.71,-0.40,-36.04,327000,6,332670,0,0,0,0,0,0,297000,30000,267000,267000
20200316,709733,智擎元富99購01,0.47,0.47,0.47,0.47,-0.06,-11.32,98000,1,46060,0,0,0,0,0,0,0,98000,-98000,-98000
20200316,709734,中美晶統一9B購02,,,,,,0.00,0,0,0,0,0,0,0,0,0,0,0,0,0
20200316,709735,宏捷科統一9B購01,0.66,0.66,0.57,0.57,+0.02,3.64,12000,2,7290,0,0,0,0,0,0,12000,0,12000,12000
20200316,709736,宏捷科凱基9B購01,,,,,,0.00,0,0,0,0,0,0,0,0,0,0,0,0,0
20200316,709737,威剛凱基9B購01,,,,,,0.00,0,0,0,0,0,0,0,0,0,0,0,0,0
20200316,709738,建榮凱基9A購02,,,,,,0.00,0,0,0,0,0,0,0,0,0,0,0,0,0
20200316,709739,神盾凱基9A購01,,,,,,0.00,0,0,0,0,0,0,0,0,0,0,0,0,0
20200316,709740,新鉅科凱基99購01,0.32,0.34,0.31,0.34,+0.10,41.67,100000,7,32880,0,0,0,0,0,0,100000,0,100000,100000
20200316,709741,聚積凱基9A購01,0.55,0.57,0.55,0.57,+0.05,9.62,50000,4,27960,0,0,0,0,0,0,50000,0,50000,50000
20200316,709742,久元元大99購01,,,,,,0.00,0,0,0,0,0,0,0,0,0,0,0,0,0
20200316,709743,久元元大99購02,0.74,0.74,0.74,0.74,-0.09,-10.84,4000,1,2960,0,0,0,0,0,0,0,4000,-4000,-4000
20200316,709744,光頡元大99購01,,,,,,0.00,0,0,0,0,0,0,0,0,0,0,0,0,0
20200316,709745,合晶元大99購02,0.42,0.42,0.42,0.42,+0.04,10.53,10000,1,4200,0,0,0,0,0,0,0,10000,-10000,-10000
20200316,709746,宏捷科元大99購03,2.69,2.69,1.81,1.84,-0.76,-29.23,372000,10,688270,0,0,0,0,0,0,355000,17000,338000,338000
20200316,709747,迅得元大9B購01,0.33,0.33,0.33,0.33,+0.02,6.45,10000,1,3300,0,0,0,0,0,0,0,10000,-10000,-10000
20200316,709748,勝麗元大99購01,0.59,0.59,0.59,0.59,-0.09,-13.24,10000,1,5900,0,0,0,0,0,0,0,10000,-10000,-10000
20200316,709749,宏捷科群益99購02,0.58,0.58,0.44,0.44,-0.19,-30.16,22000,3,10960,0,0,0,0,0,0,2000,20000,-18000,-18000
20200316,709750,信昌電群益99購01,,,,,,0.00,0,0,0,0,0,0,0,0,0,0,0,0,0
20200316,709751,安勤國票99購01,0.98,0.98,0.76,0.76,-0.09,-10.59,370000,29,318200,0,0,0,0,0,0,100000,270000,-170000,-170000
20200316,709752,中美晶富邦9B購01,0.31,0.31,0.27,0.27,-0.02,-6.9,23000,3,6630,0,0,0,0,0,0,13000,10000,3000,3000
20200316,709753,宏捷科富邦9B購01,0.62,0.62,0.45,0.47,-0.13,-21.67,238000,17,134660,0,0,0,0,0,0,171000,114000,57000,57000
20200316,709754,穩懋富邦9B購01,0.64,0.64,0.50,0.51,+0.08,18.6,395000,16,244490,0,0,0,0,0,0,392000,3000,389000,389000
20200316,709755,力致永豐99購02,,,,,,0.00,0,0,0,0,0,0,0,0,0,0,0,0,0
20200316,709756,大學光永豐99購02,,,,,,0.00,0,0,0,0,0,0,0,0,0,0,0,0,0
20200316,709757,宏捷科永豐99購02,,,,,,0.00,0,0,0,0,0,0,0,0,0,0,0,0,0
20200316,709758,精華永豐99購01,0.24,0.24,0.23,0.23,+0.03,15.0,5000,2,1160,0,0,0,0,0,0,5000,1000,4000,4000
20200316,709759,鈺太永豐99購01,0.42,0.42,0.40,0.40,+0.09,29.03,36000,3,14660,0,0,0,0,0,0,0,36000,-36000,-36000
20200316,709760,合晶凱基9A購01,0.53,0.60,0.52,0.52,+0.15,40.54,113000,3,66860,0,0,0,0,0,0,10000,103000,-93000,-93000
20200316,709761,雙鴻凱基9A購01,0.42,0.42,0.42,0.42,+0.01,2.44,110000,1,46200,0,0,0,0,0,0,110000,0,110000,110000
20200316,709762,宏捷科統一9B購02,1.01,1.01,0.88,0.88,-0.11,-11.11,70000,4,69000,0,0,0,0,0,0,40000,30000,10000,10000
20200316,709763,宣德統一99購01,,,,,,0.00,0,0,0,0,0,0,0,0,0,0,0,0,0
20200316,709764,建榮統一9B購01,,,,,,0.00,0,0,0,0,0,0,0,0,0,0,0,0,0
20200316,709765,海韻電永豐99購01,,,,,,0.00,0,0,0,0,0,0,0,0,0,0,0,0,0
20200316,709766,優群永豐99購01,1.34,1.41,1.06,1.06,-0.09,-7.83,209000,12,285530,0,0,0,0,0,0,133000,76000,57000,57000
20200316,709767,穩懋永豐9A購01,1.05,1.05,0.80,0.81,-0.06,-6.9,69000,5,64740,0,0,0,0,0,0,69000,59000,10000,10000
20200316,709768,海韻電元富99購01,1.33,1.33,1.29,1.29,+0.03,2.38,30000,2,39500,0,0,0,0,0,0,30000,0,30000,30000
20200316,709769,宏捷科國票99購02,3.34,3.34,2.69,2.69,-0.32,-10.63,79000,3,232660,0,0,0,0,0,0,79000,0,79000,79000
20200316,709770,威剛國票9A購01,,,,,,0.00,0,0,0,0,0,0,0,0,0,0,0,0,0
20200316,709771,宏捷科元大99購04,1.96,1.96,1.74,1.74,-0.03,-1.69,25000,3,47400,0,0,0,0,0,0,15000,10000,5000,5000
20200316,709772,穩懋元大99購03,1.84,1.84,1.46,1.46,-0.17,-10.43,193000,28,331730,0,0,0,0,0,0,168000,183000,-15000,-15000
20200316,709773,宏捷科國泰9A購01,1.01,1.06,0.69,0.71,-0.29,-29.0,452000,26,415360,0,0,0,0,0,0,102000,350000,-248000,-248000
20200316,709774,海韻電國泰9B購01,1.62,1.62,1.43,1.43,+0.03,2.14,125000,7,195350,0,0,0,0,0,0,10000,65000,-55000,-55000
20200316,709775,原相富邦9B購01,0.32,0.34,0.26,0.26,-0.11,-29.73,130000,6,38100,0,0,0,0,0,0,110000,20000,90000,90000
20200316,709776,環球晶富邦9B購02,0.37,0.37,0.31,0.32,-0.12,-27.27,225000,6,77150,0,0,0,0,0,0,115000,110000,5000,5000
20200316,709777,神盾群益9B購01,,,,,,0.00,0,0,0,0,0,0,0,0,0,0,0,0,0
20200316,709778,波若威永豐99購02,0.39,0.39,0.31,0.31,-0.12,-27.91,85000,3,30250,0,0,0,0,0,0,0,85000,-85000,-85000
20200316,709779,信昌電永豐99購01,0.48,0.51,0.48,0.51,+0.12,30.77,15000,2,7350,0,0,0,0,0,0,0,15000,-15000,-15000
20200316,709780,晶焱永豐99購01,,,,,,0.00,0,0,0,0,0,0,0,0,0,0,0,0,0
20200316,709781,緯軟永豐99購01,,,,,,0.00,0,0,0,0,0,0,0,0,0,0,0,0,0
20200316,709782,雙鴻永豐99購02,0.38,0.39,0.23,0.23,-0.09,-28.12,121000,5,38770,0,0,0,0,0,0,13000,108000,-95000,-95000
20200316,709783,宏捷科元富9C購01,0.94,0.94,0.94,0.94,+0.07,8.05,10000,2,9400,0,0,0,0,0,0,10000,0,10000,10000
20200316,709784,閎康中信99購01,0.69,0.69,0.60,0.60,-0.02,-3.23,19000,2,12210,0,0,0,0,0,0,9000,10000,-1000,-1000
20200316,709785,合晶凱基9A購02,0.55,0.55,0.55,0.55,+0.04,7.84,20000,1,11000,0,0,0,0,0,0,20000,0,20000,20000
20200316,709786,金居凱基99購01,,,,,,0.00,0,0,0,0,0,0,0,0,0,0,0,0,0
20200316,709787,金居凱基9A購01,0.47,0.47,0.47,0.47,+0.07,17.5,100000,1,47000,0,0,0,0,0,0,100000,0,100000,100000
20200316,709788,泰博凱基9A購01,0.63,0.75,0.61,0.65,+0.05,8.33,1208000,42,824660,0,0,0,0,0,0,338000,1110000,-772000,-772000
20200316,709789,神盾凱基99購02,0.75,0.75,0.48,0.50,-0.27,-35.06,274000,18,165790,0,0,0,0,0,0,25000,249000,-224000,-224000
20200316,709790,網龍凱基9A購01,0.71,0.71,0.60,0.60,+0.20,50.0,45000,4,30350,0,0,0,0,0,0,25000,20000,5000,5000
20200316,709791,雙鴻凱基99購01,0.64,0.68,0.56,0.58,0.00,0.0,233000,14,140840,0,0,0,0,0,0,233000,88000,145000,145000
20200316,709792,穩懋凱基99購03,1.37,1.38,1.18,1.18,-0.07,-5.6,419000,15,553440,0,0,0,0,0,0,336000,248000,88000,88000
20200316,709793,威剛統一9B購01,0.42,0.43,0.42,0.43,-0.15,-25.86,35000,3,14950,0,0,0,0,0,0,35000,0,35000,35000
20200316,709794,原相統一9B購01,0.48,0.48,0.41,0.41,-0.11,-21.15,45000,4,19700,0,0,0,0,0,0,35000,0,35000,35000
20200316,709795,穩懋統一9B購01,0.60,0.60,0.57,0.58,-0.02,-3.33,35000,3,20090,0,0,0,0,0,0,33000,0,33000,33000
20200316,709796,三貝德國票9A購01,,,,,,0.00,0,0,0,0,0,0,0,0,0,0,0,0,0
20200316,709797,群聯國票9A購01,0.38,0.41,0.22,0.22,-0.14,-38.89,374000,11,117590,0,0,0,0,0,0,309000,3000,306000,306000
20200316,709798,優群國票9A購01,2.15,2.37,2.15,2.19,+0.22,11.17,127000,8,279300,0,0,0,0,0,0,127000,0,127000,127000
20200316,709799,鈺太國泰9C購01,0.48,0.65,0.48,0.61,+0.10,19.61,1108000,13,557380,0,0,0,0,0,0,20000,1088000,-1068000,-1068000
20200316,709800,建榮富邦9B購01,0.37,0.37,0.37,0.37,-0.11,-22.92,50000,1,18500,0,0,0,0,0,0,0,50000,-50000,-50000
20200316,709801,凡甲兆豐99購01,1.12,1.22,1.10,1.10,+0.04,3.77,306000,23,346400,0,0,0,0,0,0,266000,40000,226000,226000
20200316,709802,中美晶兆豐9A購01,,,,,,0.00,0,0,0,0,0,0,0,0,0,0,0,0,0
20200316,709803,穩懋兆豐99購02,1.00,1.09,0.78,0.81,-0.26,-24.3,805000,43,829400,0,0,0,0,0,0,313000,502000,-189000,-189000
20200316,709804,譜瑞兆豐99購01,1.00,1.00,1.00,1.00,+0.17,20.48,4000,1,4000,0,0,0,0,0,0,4000,0,4000,4000
20200316,709805,VHQ群益9B購01,0.52,0.52,0.45,0.45,-0.01,-2.17,100000,7,48500,0,0,0,0,0,0,50000,50000,0,0
20200316,709806,建榮群益9B購01,0.49,0.49,0.38,0.38,-0.09,-19.15,145000,4,68250,0,0,0,0,0,0,0,145000,-145000,-145000
20200316,709807,博智群益99購01,1.73,1.88,1.60,1.66,-0.01,-0.6,24000,4,42680,0,0,0,0,0,0,4000,24000,-20000,-20000
20200316,709808,聚積群益99購01,,,,,,0.00,0,0,0,0,0,0,0,0,0,0,0,0,0
20200316,709809,力致元大9A購01,0.38,0.40,0.28,0.28,-0.07,-20.0,350000,32,124800,0,0,0,0,0,0,70000,280000,-210000,-210000
20200316,709810,大宇資元大99購01,,,,,,0.00,0,0,0,0,0,0,0,0,0,0,0,0,0
20200316,709811,大江元大99購03,1.21,1.24,1.12,1.12,+0.04,3.7,80000,8,94910,0,0,0,0,0,0,31000,59000,-28000,-28000
20200316,709812,光頡元大99購02,,,,,,0.00,0,0,0,0,0,0,0,0,0,0,0,0,0
20200316,709813,迅得元大99購02,0.77,0.77,0.77,0.77,-0.03,-3.75,4000,1,3080,0,0,0,0,0,0,0,4000,-4000,-4000
20200316,709814,建榮元大99購01,1.20,1.20,0.87,0.87,-0.22,-20.18,20000,2,20700,0,0,0,0,0,0,0,20000,-20000,-20000
20200316,709815,網龍元大9A購01,0.37,0.37,0.32,0.32,+0.04,14.29,25000,3,8900,0,0,0,0,0,0,0,25000,-25000,-25000
20200316,709816,環宇元大99購01,0.48,0.50,0.48,0.49,+0.05,11.36,117000,6,57180,0,0,0,0,0,0,72000,117000,-45000,-45000
20200316,709817,網家群益99購01,,,,,,0.00,0,0,0,0,0,0,0,0,0,0,0,0,0
20200316,709818,安勤永豐9A購01,,,,,,0.00,0,0,0,0,0,0,0,0,0,0,0,0,0
20200316,709819,宏捷科永豐99購03,,,,,,0.00,0,0,0,0,0,0,0,0,0,0,0,0,0
20200316,709820,迅得永豐99購01,0.37,0.37,0.32,0.32,-0.01,-3.03,91000,2,30170,0,0,0,0,0,0,70000,21000,49000,49000
20200316,709821,宣德永豐99購01,0.80,0.80,0.80,0.80,-0.04,-4.76,55000,1,44000,0,0,0,0,0,0,0,55000,-55000,-55000
20200316,709822,原相永豐9A購01,0.30,0.30,0.21,0.21,-0.11,-34.38,163000,6,41510,0,0,0,0,0,0,0,163000,-163000,-163000
20200316,709823,博智永豐9A購01,0.59,0.66,0.56,0.61,+0.05,8.93,467000,22,291260,0,0,0,0,0,0,0,467000,-467000,-467000
20200316,709824,新普永豐99購01,0.46,0.46,0.46,0.46,-0.09,-16.36,12000,1,5520,0,0,0,0,0,0,12000,0,12000,12000
20200316,709825,聖暉永豐99購01,0.72,0.72,0.69,0.69,-0.08,-10.39,61000,5,42120,0,0,0,0,0,0,1000,60000,-59000,-59000
20200316,709826,優群永豐9A購01,0.59,0.64,0.45,0.47,-0.01,-2.08,231000,19,131560,0,0,0,0,0,0,63000,168000,-105000,-105000
20200316,709827,穩懋永豐99購01,1.47,1.47,1.14,1.14,+0.35,44.3,82000,2,111630,0,0,0,0,0,0,27000,82000,-55000,-55000
20200316,709828,信驊國票9A購01,3.64,3.64,3.64,3.64,+0.95,35.32,10000,1,36400,0,0,0,0,0,0,10000,0,10000,10000
20200316,709829,聖暉國票9A購01,2.96,2.96,2.74,2.74,+0.01,0.37,64000,4,185940,0,0,0,0,0,0,64000,0,64000,64000
20200316,709830,信驊國泰9B購01,1.32,1.36,1.32,1.32,-0.09,-6.38,514000,4,678800,0,0,0,0,0,0,514000,0,514000,514000
20200316,709831,原相富邦9C購01,0.25,0.30,0.22,0.22,-0.03,-12.0,110000,7,29700,0,0,0,0,0,0,10000,100000,-90000,-90000
20200316,709832,宏捷科元富9C購02,0.98,0.98,0.76,0.76,-0.26,-25.49,6000,2,5660,0,0,0,0,0,0,1000,5000,-4000,-4000
20200316,709833,聖暉元富99購01,1.80,1.82,1.65,1.65,-0.13,-7.3,107000,7,191560,0,0,0,0,0,0,87000,20000,67000,67000
20200316,709834,建榮統一9B購02,,,,,,0.00,0,0,0,0,0,0,0,0,0,0,0,0,0
20200316,709835,台半元大99購01,1.07,1.07,0.75,0.75,-0.10,-11.76,450000,4,456900,0,0,0,0,0,0,440000,10000,430000,430000
20200316,709836,金居元大99購03,0.61,0.61,0.56,0.56,-0.03,-5.08,20000,2,11700,0,0,0,0,0,0,10000,20000,-10000,-10000
20200316,709837,博智元大99購02,1.14,1.25,1.07,1.13,+0.05,4.63,80000,13,93120,0,0,0,0,0,0,17000,72000,-55000,-55000
20200316,709838,網龍元大9A購02,0.34,0.34,0.28,0.28,+0.02,7.69,35000,4,11300,0,0,0,0,0,0,0,35000,-35000,-35000
20200316,709839,力旺凱基99購01,0.47,0.47,0.35,0.35,-0.14,-28.57,128000,7,50330,0,0,0,0,0,0,5000,123000,-118000,-118000
20200316,709840,合晶凱基9A購03,0.60,0.60,0.57,0.57,-0.03,-5.0,95000,2,54750,0,0,0,0,0,0,75000,20000,55000,55000
20200316,709841,聯亞凱基9A購01,1.22,1.22,1.18,1.18,+0.28,31.11,60000,2,72000,0,0,0,0,0,0,60000,0,60000,60000
20200316,709842,譜瑞凱基9A購02,1.11,1.17,1.01,1.01,+0.28,38.36,188000,6,216560,0,0,0,0,0,0,168000,37000,131000,131000
20200316,709843,雙鴻中信9B購01,,,,,,0.00,0,0,0,0,0,0,0,0,0,0,0,0,0
20200316,709844,宏捷科凱基9A購01,1.22,1.22,1.22,1.22,+0.15,14.02,10000,1,12200,0,0,0,0,0,0,10000,0,10000,10000
20200316,709845,金可凱基9A購01,0.45,0.45,0.37,0.39,+0.01,2.63,1868000,44,765410,0,0,0,0,0,0,1264000,582000,682000,682000
20200316,709846,凡甲元大99購01,2.32,2.32,2.20,2.22,+0.13,6.22,40000,3,89400,0,0,0,0,0,0,30000,20000,10000,10000
20200316,709847,宇峻元大9C購01,0.43,0.43,0.43,0.43,+0.04,10.26,10000,1,4300,0,0,0,0,0,0,0,10000,-10000,-10000
20200316,709848,金可元大99購01,0.50,0.60,0.50,0.51,0.00,0.0,1802000,35,1021300,0,0,0,0,0,0,1306000,51000,1255000,1255000
20200316,709849,保瑞元大9A購01,1.01,1.02,0.79,0.79,-0.21,-21.0,38000,5,37870,0,0,0,0,0,0,7000,31000,-24000,-24000
20200316,709850,建榮元大99購02,0.86,0.86,0.86,0.86,+0.08,10.26,10000,1,8600,0,0,0,0,0,0,0,10000,-10000,-10000
20200316,709851,晶焱元大9A購01,0.54,0.54,0.54,0.54,+0.03,5.88,10000,1,5400,0,0,0,0,0,0,10000,0,10000,10000
20200316,709852,群聯元大99購04,0.46,0.46,0.36,0.36,-0.10,-21.74,108000,13,44120,0,0,0,0,0,0,65000,93000,-28000,-28000
20200316,709853,大江國票9A購01,,,,,,0.00,0,0,0,0,0,0,0,0,0,0,0,0,0
20200316,709854,穩懋國票99購02,3.60,3.60,3.30,3.30,+1.31,65.83,110000,2,366000,0,0,0,0,0,0,110000,0,110000,110000
20200316,709855,穩懋富邦9B購02,,,,,,0.00,0,0,0,0,0,0,0,0,0,0,0,0,0
20200316,709856,晶焱兆豐9A購01,0.55,0.55,0.48,0.48,-0.07,-12.73,40000,3,21000,0,0,0,0,0,0,0,40000,-40000,-40000
20200316,709857,環球晶兆豐99購01,0.55,0.56,0.37,0.37,-0.11,-22.92,173000,5,90190,0,0,0,0,0,0,48000,125000,-77000,-77000
20200316,709858,穩懋兆豐9A購01,0.94,0.97,0.72,0.77,+0.06,8.45,441000,16,408240,0,0,0,0,0,0,68000,373000,-305000,-305000
20200316,709859,安勤群益99購01,,,,,,0.00,0,0,0,0,0,0,0,0,0,0,0,0,0
20200316,709860,新鉅科群益9A購01,0.63,0.63,0.63,0.63,-0.02,-3.08,100000,1,63000,0,0,0,0,0,0,0,100000,-100000,-100000
20200316,709861,環球晶群益99購01,,,,,,0.00,0,0,0,0,0,0,0,0,0,0,0,0,0
20200316,709862,碩禾永豐99購01,,,,,,0.00,0,0,0,0,0,0,0,0,0,0,0,0,0
20200316,709863,網龍永豐9A購01,0.37,0.39,0.33,0.34,+0.06,21.43,155000,6,55600,0,0,0,0,0,0,0,155000,-155000,-155000
20200316,709864,璟德元富99購01,0.69,0.69,0.46,0.48,-0.13,-21.31,71000,7,39910,0,0,0,0,0,0,21000,50000,-29000,-29000
20200316,709865,鈺太元富99購01,0.82,1.13,0.82,1.13,+0.31,37.8,150000,15,134800,0,0,0,0,0,0,0,150000,-150000,-150000
20200316,709866,凡甲永豐9A購01,0.78,0.79,0.71,0.71,0.00,0.0,160000,9,119660,0,0,0,0,0,0,60000,90000,-30000,-30000
20200316,709867,兆利永豐99購01,,,,,,0.00,0,0,0,0,0,0,0,0,0,0,0,0,0
20200316,709868,欣銓永豐99購01,,,,,,0.00,0,0,0,0,0,0,0,0,0,0,0,0,0
20200316,709869,信驊永豐99購02,0.58,0.58,0.48,0.48,0.00,0.0,119000,10,68060,0,0,0,0,0,0,0,111000,-111000,-111000
20200316,709870,群聯永豐99購01,0.14,0.14,0.14,0.14,0.00,0.0,44000,2,6160,0,0,0,0,0,0,44000,38000,6000,6000
20200316,709871,聚積永豐99購01,,,,,,0.00,0,0,0,0,0,0,0,0,0,0,0,0,0
20200316,709872,環球晶永豐99購02,0.78,0.85,0.68,0.68,-0.20,-22.73,23000,5,17610,0,0,0,0,0,0,10000,23000,-13000,-13000
20200316,709873,東洋統一9B購01,,,,,,0.00,0,0,0,0,0,0,0,0,0,0,0,0,0
20200316,709874,建榮凱基9A購03,0.79,0.79,0.77,0.77,+0.04,5.48,40000,2,31200,0,0,0,0,0,0,20000,20000,0,0
20200316,709875,大中國票9A購01,,,,,,0.00,0,0,0,0,0,0,0,0,0,0,0,0,0
20200316,709876,台燿國票9A購01,,,,,,0.00,0,0,0,0,0,0,0,0,0,0,0,0,0
20200316,709877,泰博國泰9A購01,0.93,1.02,0.91,0.91,+0.07,8.33,57000,8,56170,0,0,0,0,0,0,1000,56000,-55000,-55000
20200316,709878,大江元大99購04,0.62,0.62,0.62,0.62,+0.04,6.9,14000,2,8680,0,0,0,0,0,0,0,14000,-14000,-14000
20200316,709879,安勤元大99購02,,,,,,0.00,0,0,0,0,0,0,0,0,0,0,0,0,0
20200316,709880,宏捷科元大99購06,,,,,,0.00,0,0,0,0,0,0,0,0,0,0,0,0,0
20200316,709881,聖暉元大99購01,1.53,1.53,1.39,1.39,-0.13,-8.55,39000,5,58210,0,0,0,0,0,0,39000,0,39000,39000
20200316,709882,優群元大99購03,0.71,0.71,0.61,0.61,+0.07,12.96,164000,17,110960,0,0,0,0,0,0,0,164000,-164000,-164000
20200316,709883,優群元大9B購01,0.76,0.76,0.59,0.63,-0.01,-1.56,229000,26,163280,0,0,0,0,0,0,0,229000,-229000,-229000
20200316,709884,穩懋元大99購05,1.67,1.67,1.30,1.30,-0.18,-12.16,140000,21,213260,0,0,0,0,0,0,134000,140000,-6000,-6000
20200316,709885,信驊兆豐99購01,,,,,,0.00,0,0,0,0,0,0,0,0,0,0,0,0,0
20200316,709886,中美晶群益9A購01,0.83,0.83,0.83,0.83,-0.04,-4.6,5000,2,4150,0,0,0,0,0,0,5000,5000,0,0
20200316,709887,神盾群益9B購02,,,,,,0.00,0,0,0,0,0,0,0,0,0,0,0,0,0
20200316,709888,聯亞群益99購01,,,,,,0.00,0,0,0,0,0,0,0,0,0,0,0,0,0
20200316,709889,台燿元富9C購01,1.14,1.21,1.09,1.21,+0.03,2.54,168000,6,194440,0,0,0,0,0,0,48000,120000,-72000,-72000
20200316,709890,原相統一9A購01,,,,,,0.00,0,0,0,0,0,0,0,0,0,0,0,0,0
20200316,709891,大宇資凱基9B購01,0.38,0.38,0.30,0.30,-0.10,-25.0,211000,8,64100,0,0,0,0,0,0,0,211000,-211000,-211000
20200316,709892,宇峻凱基9B購01,0.56,0.56,0.43,0.43,-0.03,-6.52,97000,17,44860,0,0,0,0,0,0,18000,79000,-61000,-61000
20200316,709893,信驊凱基9A購01,0.85,0.85,0.79,0.79,+0.04,5.33,2400000,11,1920000,0,0,0,0,0,0,400000,2000000,-1600000,-1600000
20200316,709894,統新凱基9B購01,0.40,0.40,0.32,0.32,-0.14,-30.43,100000,6,35050,0,0,0,0,0,0,0,100000,-100000,-100000
20200316,709895,順達凱基99購01,0.83,0.83,0.83,0.83,-0.06,-6.74,2000,1,1660,0,0,0,0,0,0,0,2000,-2000,-2000
20200316,709896,雙美凱基9B購01,,,,,,0.00,0,0,0,0,0,0,0,0,0,0,0,0,0
20200316,709897,雙鴻元大99購06,0.59,0.60,0.38,0.38,-0.20,-34.48,325000,27,158400,0,0,0,0,0,0,195000,305000,-110000,-110000
20200316,709898,穩懋元大99購06,1.48,1.65,1.25,1.25,-0.15,-10.71,80000,16,123030,0,0,0,0,0,0,70000,77000,-7000,-7000
20200316,709899,穩懋元大99購07,0.88,0.93,0.85,0.85,+0.02,2.41,110000,11,98960,0,0,0,0,0,0,110000,80000,30000,30000
20200316,709900,力致永豐99購03,,,,,,0.00,0,0,0,0,0,0,0,0,0,0,0,0,0
20200316,709901,光頡永豐99購01,0.38,0.38,0.38,0.38,-0.08,-17.39,1000,1,380,0,0,0,0,0,0,0,1000,-1000,-1000
20200316,709902,新鉅科永豐99購01,,,,,,0.00,0,0,0,0,0,0,0,0,0,0,0,0,0
20200316,709903,精測永豐9A購01,1.22,1.22,1.22,1.22,+0.15,14.02,27000,1,32940,0,0,0,0,0,0,27000,27000,0,0
20200316,709904,璟德永豐99購01,,,,,,0.00,0,0,0,0,0,0,0,0,0,0,0,0,0
20200316,709905,環球晶永豐99購03,,,,,,0.00,0,0,0,0,0,0,0,0,0,0,0,0,0
20200316,709906,兆利國票99購01,,,,,,0.00,0,0,0,0,0,0,0,0,0,0,0,0,0
20200316,709907,金居國票9A購01,0.63,0.63,0.63,0.63,+0.05,8.62,40000,1,25200,0,0,0,0,0,0,40000,0,40000,40000
20200316,709908,信驊國票9A購02,2.21,2.21,2.21,2.21,+0.30,15.71,200000,1,442000,0,0,0,0,0,0,200000,0,200000,200000
20200316,709909,兆利國泰9A購01,0.73,0.73,0.73,0.73,-0.08,-9.88,55000,1,40150,0,0,0,0,0,0,0,55000,-55000,-55000
20200316,709910,宏捷科國泰9B購01,0.91,0.91,0.67,0.67,-0.14,-17.28,20000,2,15800,0,0,0,0,0,0,10000,10000,0,0
20200316,709911,精測國泰9C購01,1.25,1.32,1.13,1.13,-0.14,-11.02,1036000,38,1296010,0,0,0,0,0,0,663000,493000,170000,170000
20200316,709912,威剛富邦9C購01,0.20,0.20,0.20,0.20,+0.01,5.26,2000,1,400,0,0,0,0,0,0,0,2000,-2000,-2000
20200316,709913,M31群益99購01,0.24,0.24,0.24,0.24,-0.04,-14.29,5000,2,1200,0,0,0,0,0,0,5000,0,5000,5000
20200316,709914,中美晶群益9B購01,0.82,0.82,0.69,0.69,-0.03,-4.17,70000,11,54500,0,0,0,0,0,0,5000,65000,-60000,-60000
20200316,709915,台燿群益99購02,,,,,,0.00,0,0,0,0,0,0,0,0,0,0,0,0,0
20200316,709916,合晶群益9A購01,,,,,,0.00,0,0,0,0,0,0,0,0,0,0,0,0,0
20200316,709917,緯軟群益9A購01,,,,,,0.00,0,0,0,0,0,0,0,0,0,0,0,0,0
20200316,709918,璟德群益99購01,0.59,0.59,0.43,0.43,-0.08,-15.69,170000,3,89100,0,0,0,0,0,0,100000,70000,30000,30000
20200316,709919,環球晶群益99購02,1.35,1.35,1.35,1.35,+0.19,16.38,50000,1,67500,0,0,0,0,0,0,50000,0,50000,50000
20200316,709920,原相日盛9B購01,0.51,0.51,0.46,0.46,-0.04,-8.0,62000,10,29570,0,0,0,0,0,0,21000,27000,-6000,-6000
20200316,709921,雍智國泰9C購01,0.39,0.39,0.37,0.37,-0.12,-24.49,200000,2,76000,0,0,0,0,0,0,0,200000,-200000,-200000
20200316,709922,璟德國泰9A購01,0.77,0.77,0.58,0.58,-0.05,-7.94,426000,6,307030,0,0,0,0,0,0,70000,356000,-286000,-286000
20200316,709923,VHQ群益99購01,,,,,,0.00,0,0,0,0,0,0,0,0,0,0,0,0,0
20200316,709924,中美晶群益99購03,,,,,,0.00,0,0,0,0,0,0,0,0,0,0,0,0,0
20200316,709925,精測群益99購01,1.53,1.53,1.53,1.53,+0.42,37.84,10000,1,15300,0,0,0,0,0,0,10000,0,10000,10000
20200316,709926,精測富邦9A購01,0.42,0.42,0.42,0.42,-0.04,-8.7,5000,1,2100,0,0,0,0,0,0,0,5000,-5000,-5000
20200316,709927,聯亞國票9A購01,,,,,,0.00,0,0,0,0,0,0,0,0,0,0,0,0,0
20200316,709928,穩懋國票99購03,,,,,,0.00,0,0,0,0,0,0,0,0,0,0,0,0,0
20200316,709929,大江永豐99購01,0.67,0.68,0.66,0.67,+0.07,11.67,50000,5,33600,0,0,0,0,0,0,0,50000,-50000,-50000
20200316,709930,精測永豐99購01,0.96,0.96,0.96,0.96,-0.10,-9.43,10000,1,9600,0,0,0,0,0,0,10000,10000,0,0
20200316,709931,建榮統一9B購03,,,,,,0.00,0,0,0,0,0,0,0,0,0,0,0,0,0
20200316,709932,中美晶凱基99購07,0.97,0.99,0.94,0.96,-0.09,-8.57,300000,7,289850,0,0,0,0,0,0,300000,300000,0,0
20200316,709933,碩禾凱基9B購01,,,,,,0.00,0,0,0,0,0,0,0,0,0,0,0,0,0
20200316,709934,精測元富99購02,,,,,,0.00,0,0,0,0,0,0,0,0,0,0,0,0,0
20200316,709935,鈺太元富99購02,1.07,1.46,1.07,1.25,+0.19,17.92,191000,18,226890,0,0,0,0,0,0,0,191000,-191000,-191000
20200316,709936,元太元大99購01,1.11,1.11,0.95,0.95,-0.15,-13.64,20000,2,20600,0,0,0,0,0,0,20000,10000,10000,10000
20200316,709937,兆利元大9B購01,,,,,,0.00,0,0,0,0,0,0,0,0,0,0,0,0,0
20200316,709938,宏捷科元大99購07,0.70,0.70,0.50,0.51,-0.17,-25.0,113000,12,69130,0,0,0,0,0,0,52000,61000,-9000,-9000
20200316,709939,良維元大99購01,1.00,1.00,0.95,0.95,+0.13,15.85,30000,3,29100,0,0,0,0,0,0,0,30000,-30000,-30000
20200316,709940,信驊元大99購01,,,,,,0.00,0,0,0,0,0,0,0,0,0,0,0,0,0
20200316,709941,信驊元大99購02,2.50,2.84,2.10,2.12,-0.19,-8.23,427000,27,1024500,0,0,0,0,0,0,247000,180000,67000,67000
20200316,709942,威剛元大9A購02,0.57,0.57,0.57,0.57,+0.08,16.33,20000,1,11400,0,0,0,0,0,0,20000,0,20000,20000
20200316,709943,泰博元大99購01,0.73,0.86,0.73,0.77,+0.11,16.67,286000,22,226420,0,0,0,0,0,0,160000,126000,34000,34000
20200316,709944,順達元大99購01,1.62,1.62,1.41,1.41,-0.15,-9.62,14000,3,22080,0,0,0,0,0,0,0,14000,-14000,-14000
20200316,709945,群聯元大99購05,0.94,0.94,0.72,0.72,-0.08,-10.0,136000,10,112930,0,0,0,0,0,0,86000,50000,36000,36000
20200316,709946,精華元大99購01,0.86,0.90,0.86,0.89,+0.15,20.27,230000,23,204600,0,0,0,0,0,0,0,230000,-230000,-230000
20200316,709947,神盾永豐99購02,,,,,,0.00,0,0,0,0,0,0,0,0,0,0,0,0,0
20200316,709948,穩懋永豐99購02,1.79,1.80,1.68,1.73,+0.07,4.22,207000,13,354000,0,0,0,0,0,0,142000,71000,71000,71000
20200316,709949,中美晶日盛99購01,,,,,,0.00,0,0,0,0,0,0,0,0,0,0,0,0,0
20200316,709950,大學光元大99購02,,,,,,0.00,0,0,0,0,0,0,0,0,0,0,0,0,0
20200316,709951,台燿元大99購01,,,,,,0.00,0,0,0,0,0,0,0,0,0,0,0,0,0
20200316,709952,良維元大99購02,1.46,1.47,1.46,1.47,+0.18,13.95,3000,2,4390,0,0,0,0,0,0,0,3000,-3000,-3000
20200316,709953,建榮元大9B購01,0.61,0.61,0.55,0.55,+0.01,1.85,56000,5,32500,0,0,0,0,0,0,20000,36000,-16000,-16000
20200316,709954,M31國票9A購01,,,,,,0.00,0,0,0,0,0,0,0,0,0,0,0,0,0
20200316,709955,大江國票9A購02,,,,,,0.00,0,0,0,0,0,0,0,0,0,0,0,0,0
20200316,709956,群聯統一9B購01,0.42,0.42,0.42,0.42,-0.07,-14.29,10000,1,4200,0,0,0,0,0,0,0,10000,-10000,-10000
20200316,709957,璟德兆豐99購02,,,,,,0.00,0,0,0,0,0,0,0,0,0,0,0,0,0
20200316,709958,迅得凱基99購01,0.74,0.74,0.74,0.74,-0.04,-5.13,5000,1,3700,0,0,0,0,0,0,0,5000,-5000,-5000
20200316,709959,保瑞凱基9B購01,,,,,,0.00,0,0,0,0,0,0,0,0,0,0,0,0,0
20200316,709960,原相凱基9A購01,,,,,,0.00,0,0,0,0,0,0,0,0,0,0,0,0,0
20200316,709961,雍智凱基9B購01,0.68,0.68,0.68,0.68,+0.04,6.25,240000,1,163200,0,0,0,0,0,0,240000,0,240000,240000
20200316,709962,精測凱基99購03,1.15,1.15,0.97,0.97,+0.18,22.78,115000,4,126160,0,0,0,0,0,0,115000,100000,15000,15000
20200316,709963,廣明凱基99購02,1.02,1.02,1.02,1.02,-0.05,-4.67,30000,2,30600,0,0,0,0,0,0,0,30000,-30000,-30000
20200316,709964,璟德凱基99購01,1.32,1.32,1.32,1.32,-0.05,-3.65,40000,1,52800,0,0,0,0,0,0,0,40000,-40000,-40000
20200316,709965,環球晶凱基99購07,1.32,1.32,1.01,1.01,-0.43,-29.86,170000,5,189300,0,0,0,0,0,0,10000,170000,-160000,-160000
20200316,709966,金居群益9B購01,,,,,,0.00,0,0,0,0,0,0,0,0,0,0,0,0,0
20200316,709967,信驊群益99購01,0.55,0.55,0.50,0.53,-0.33,-38.37,17000,3,9000,0,0,0,0,0,0,0,17000,-17000,-17000
20200316,709968,聯亞群益99購02,,,,,,0.00,0,0,0,0,0,0,0,0,0,0,0,0,0
20200316,709969,譜瑞兆豐99購02,,,,,,0.00,0,0,0,0,0,0,0,0,0,0,0,0,0
20200316,709970,宏捷科元大9A購01,,,,,,0.00,0,0,0,0,0,0,0,0,0,0,0,0,0
20200316,709971,邦特元大99購01,0.73,0.73,0.72,0.72,-0.26,-26.53,30000,3,21700,0,0,0,0,0,0,0,30000,-30000,-30000
20200316,709972,旺矽元大9B購01,0.63,0.63,0.63,0.63,-0.18,-22.22,10000,1,6300,0,0,0,0,0,0,0,10000,-10000,-10000
20200316,709973,中美晶國票9A購01,,,,,,0.00,0,0,0,0,0,0,0,0,0,0,0,0,0
20200316,709974,旺矽國票99購02,,,,,,0.00,0,0,0,0,0,0,0,0,0,0,0,0,0
20200316,709975,宣德國票9A購01,,,,,,0.00,0,0,0,0,0,0,0,0,0,0,0,0,0
20200316,709976,鈺太國票9A購01,,,,,,0.00,0,0,0,0,0,0,0,0,0,0,0,0,0
20200316,709977,M31永豐99購02,,,,,,0.00,0,0,0,0,0,0,0,0,0,0,0,0,0
20200316,709978,建榮永豐9A購02,,,,,,0.00,0,0,0,0,0,0,0,0,0,0,0,0,0
20200316,709979,晶焱永豐9A購01,,,,,,0.00,0,0,0,0,0,0,0,0,0,0,0,0,0
20200316,709980,鈊象永豐9A購01,1.76,1.80,1.45,1.45,+0.40,38.1,141000,8,249130,0,0,0,0,0,0,6000,141000,-135000,-135000
20200316,709981,M31凱基99購02,,,,,,0.00,0,0,0,0,0,0,0,0,0,0,0,0,0
20200316,709982,穩懋凱基99購05,1.70,1.70,1.62,1.62,-0.14,-7.95,11000,2,18300,0,0,0,0,0,0,0,11000,-11000,-11000
